team,displayName,Disposals,Kicks,Marks,Handballs,Goals,Behinds,Hit Outs,Tackles
Adelaide,"Berry, Sam",8,6,1,2,0,1,0,7
Adelaide,"Brown, Luke",5,2,0,3,0,0,0,2
Adelaide,"Butts, Jordon",10,5,3,5,0,0,0,0
Adelaide,"Doedee, Tom",13,9,4,4,0,0,0,4
Adelaide,"Frampton, Billy",14,10,8,4,2,2,7,0
Adelaide,"Hamill, Will",6,5,0,1,0,0,0,5
Adelaide,"Hinge, Mitch",7,6,3,1,0,0,0,0
Adelaide,"Keays, Ben",23,15,4,8,0,1,0,4
Adelaide,"Kelly, Jake",4,2,0,2,0,0,0,2
Adelaide,"Laird, Rory",27,18,7,9,0,2,0,6
Adelaide,"Lynch, Tom",17,12,8,5,1,0,0,2
Adelaide,"McAdam, Shane",7,3,4,4,1,0,0,1
Adelaide,"McHenry, Ned",12,7,1,5,2,1,0,3
Adelaide,"McPherson, Andrew",10,7,2,3,0,0,0,4
Adelaide,"Murphy, Lachlan",11,6,0,5,1,1,0,4
Adelaide,"OBrien, Reilly",8,3,2,5,0,0,22,1
Adelaide,"Rowe, James",16,11,5,5,2,0,0,3
Adelaide,"Schoenberg, Harry",16,6,3,10,1,1,0,3
Adelaide,"Seedsman, Paul",21,14,8,7,0,1,0,1
Adelaide,"Sholl, Lachlan",23,16,9,7,0,0,0,3
Adelaide,"Sloane, Rory",20,11,5,9,0,0,0,4
Adelaide,"Smith, Brodie",21,14,6,7,0,1,0,0
Adelaide,"Walker, Taylor",18,11,7,7,5,2,2,1
Adelaide,"Berry, Sam",7,5,1,2,0,4,0,10
Adelaide,"Butts, Jordon",9,4,2,5,0,0,0,0
Adelaide,"Doedee, Tom",21,12,3,9,0,0,0,4
Adelaide,"Frampton, Billy",7,2,2,5,0,0,5,3
Adelaide,"Hamill, Will",11,5,0,6,0,0,0,2
Adelaide,"Jones, Chayce",0,0,0,0,0,0,0,0
Adelaide,"Keays, Ben",28,19,2,9,1,0,0,2
Adelaide,"Laird, Rory",30,15,2,15,0,2,0,4
Adelaide,"Lynch, Tom",15,11,4,4,0,4,0,1
Adelaide,"Mackay, David",14,10,2,4,0,0,0,1
Adelaide,"McAdam, Shane",11,7,4,4,4,2,0,1
Adelaide,"McHenry, Ned",13,7,3,6,0,1,0,1
Adelaide,"McPherson, Andrew",6,3,2,3,0,0,0,1
Adelaide,"Murphy, Lachlan",12,7,2,5,0,2,0,3
Adelaide,"Murray, Nick",10,5,3,5,0,0,0,1
Adelaide,"OBrien, Reilly",10,5,1,5,0,0,24,0
Adelaide,"Rowe, James",8,4,3,4,0,0,0,2
Adelaide,"Schoenberg, Harry",14,8,4,6,0,1,0,4
Adelaide,"Seedsman, Paul",21,10,6,11,0,0,0,1
Adelaide,"Sholl, Lachlan",16,9,2,7,0,0,0,0
Adelaide,"Sloane, Rory",21,12,3,9,0,0,0,5
Adelaide,"Smith, Brodie",16,11,2,5,0,0,0,0
Adelaide,"Walker, Taylor",15,13,6,2,6,3,3,4
Adelaide,"Berry, Sam",11,4,2,7,1,1,0,4
Adelaide,"Brown, Luke",13,10,2,3,0,0,0,2
Adelaide,"Butts, Jordon",10,9,4,1,0,0,0,2
Adelaide,"Doedee, Tom",15,8,3,7,0,0,0,2
Adelaide,"Frampton, Billy",5,4,3,1,0,1,2,1
Adelaide,"Hamill, Will",9,5,4,4,0,0,0,3
Adelaide,"Keays, Ben",26,16,5,10,1,1,0,3
Adelaide,"Kelly, Jake",21,9,6,12,0,0,0,2
Adelaide,"Laird, Rory",28,11,2,17,0,0,0,9
Adelaide,"Lynch, Tom",15,11,5,4,0,0,0,3
Adelaide,"McAdam, Shane",8,3,2,5,2,0,0,0
Adelaide,"McHenry, Ned",12,4,1,8,1,0,0,3
Adelaide,"McPherson, Andrew",14,11,2,3,0,0,0,1
Adelaide,"Murphy, Lachlan",10,5,1,5,0,1,0,5
Adelaide,"Murray, Nick",0,0,0,0,0,0,0,0
Adelaide,"OBrien, Reilly",19,5,3,14,0,0,34,3
Adelaide,"Rowe, James",14,7,1,7,2,1,0,0
Adelaide,"Schoenberg, Harry",12,9,1,3,1,0,0,2
Adelaide,"Seedsman, Paul",27,17,5,10,0,1,0,2
Adelaide,"Sholl, Lachlan",18,13,9,5,0,1,0,0
Adelaide,"Sloane, Rory",34,15,7,19,0,0,0,3
Adelaide,"Smith, Brodie",26,19,4,7,0,0,0,4
Adelaide,"Walker, Taylor",24,15,9,9,6,3,0,3
Adelaide,"Berry, Sam",8,2,3,6,0,0,0,7
Adelaide,"Brown, Luke",15,8,4,7,0,0,0,4
Adelaide,"Butts, Jordon",8,3,2,5,0,0,0,1
Adelaide,"Doedee, Tom",18,11,9,7,0,0,0,3
Adelaide,"Fogarty, Darcy",5,5,5,0,3,0,0,1
Adelaide,"Frampton, Billy",9,6,5,3,0,2,1,0
Adelaide,"Hamill, Will",15,7,4,8,0,0,0,0
Adelaide,"Keays, Ben",24,12,3,12,0,0,0,8
Adelaide,"Kelly, Jake",18,11,6,7,0,0,0,4
Adelaide,"Laird, Rory",31,12,4,19,0,0,0,3
Adelaide,"Lynch, Tom",17,12,5,5,0,2,0,1
Adelaide,"Mackay, David",0,0,0,0,0,0,0,0
Adelaide,"McAdam, Shane",7,6,4,1,3,0,0,1
Adelaide,"McHenry, Ned",13,5,4,8,0,0,0,4
Adelaide,"McPherson, Andrew",23,14,4,9,0,0,0,1
Adelaide,"Murphy, Lachlan",11,6,1,5,1,0,0,7
Adelaide,"OBrien, Reilly",24,7,8,17,1,0,30,4
Adelaide,"Rowe, James",9,6,2,3,1,1,0,3
Adelaide,"Schoenberg, Harry",20,15,6,5,2,0,0,4
Adelaide,"Seedsman, Paul",25,17,4,8,1,1,0,4
Adelaide,"Sholl, Lachlan",31,25,8,6,1,2,0,2
Adelaide,"Smith, Brodie",22,19,7,3,0,1,0,3
Adelaide,"Walker, Taylor",17,12,7,5,3,2,0,3
Adelaide,"Berry, Sam",13,3,1,10,0,0,0,1
Adelaide,"Brown, Luke",15,9,4,6,0,0,0,5
Adelaide,"Butts, Jordon",17,14,9,3,0,0,0,2
Adelaide,"Doedee, Tom",23,12,6,11,0,0,0,1
Adelaide,"Fogarty, Darcy",11,7,2,4,1,0,0,2
Adelaide,"Frampton, Billy",10,7,4,3,0,1,3,0
Adelaide,"Hamill, Will",13,6,1,7,0,0,0,3
Adelaide,"Keays, Ben",31,17,4,14,0,1,0,1
Adelaide,"Kelly, Jake",19,14,8,5,0,0,0,3
Adelaide,"Laird, Rory",29,11,4,18,0,0,0,7
Adelaide,"Lynch, Tom",14,8,5,6,1,1,0,2
Adelaide,"McAdam, Shane",4,4,3,0,1,0,0,4
Adelaide,"McHenry, Ned",12,4,2,8,1,0,0,3
Adelaide,"McPherson, Andrew",12,5,3,7,0,0,0,0
Adelaide,"Murphy, Lachlan",15,9,2,6,1,0,0,3
Adelaide,"Murray, Nick",0,0,0,0,0,0,0,0
Adelaide,"OBrien, Reilly",17,7,4,10,0,0,32,3
Adelaide,"Rowe, James",12,7,1,5,2,0,0,3
Adelaide,"Schoenberg, Harry",16,10,2,6,0,0,0,1
Adelaide,"Seedsman, Paul",28,13,8,15,1,0,0,1
Adelaide,"Sholl, Lachlan",23,15,8,8,1,0,0,3
Adelaide,"Smith, Brodie",27,21,7,6,0,0,0,2
Adelaide,"Walker, Taylor",13,10,6,3,2,3,2,1
Adelaide,"Brown, Luke",7,5,4,2,0,0,0,2
Adelaide,"Butts, Jordon",11,7,5,4,0,0,0,0
Adelaide,"Doedee, Tom",16,11,5,5,0,0,0,0
Adelaide,"Fogarty, Darcy",9,5,1,4,0,0,0,2
Adelaide,"Hamill, Will",16,6,1,10,0,0,0,2
Adelaide,"Hately, Jackson",17,8,3,9,0,0,0,6
Adelaide,"Himmelberg, Elliott",9,6,5,3,2,0,2,0
Adelaide,"Keays, Ben",31,15,8,16,1,0,0,13
Adelaide,"Kelly, Jake",12,7,5,5,0,0,0,4
Adelaide,"Laird, Rory",32,15,5,17,0,0,0,5
Adelaide,"Lynch, Tom",3,2,1,1,0,0,0,0
Adelaide,"McAdam, Shane",6,4,2,2,2,1,0,4
Adelaide,"McHenry, Ned",8,2,1,6,1,0,0,2
Adelaide,"McPherson, Andrew",14,8,3,6,0,0,0,3
Adelaide,"Murphy, Lachlan",10,4,0,6,0,1,0,0
Adelaide,"OBrien, Reilly",20,8,5,12,0,0,39,1
Adelaide,"Rowe, James",8,6,3,2,0,0,0,2
Adelaide,"Schoenberg, Harry",11,8,1,3,1,0,0,5
Adelaide,"Seedsman, Paul",27,20,5,7,1,1,0,3
Adelaide,"Sholl, Lachlan",21,13,2,8,0,0,0,0
Adelaide,"Smith, Brodie",20,17,5,3,0,0,0,1
Adelaide,"Thilthorpe, Riley",16,10,5,6,5,0,0,2
Adelaide,"Walker, Taylor",14,10,5,4,3,0,2,1
Adelaide,"Berry, Sam",11,4,3,7,0,1,0,3
Adelaide,"Butts, Jordon",16,6,1,10,0,0,0,3
Adelaide,"Doedee, Tom",22,12,9,10,0,0,0,1
Adelaide,"Fogarty, Darcy",0,0,0,0,0,0,0,0
Adelaide,"Hately, Jackson",11,6,3,5,0,0,0,5
Adelaide,"Himmelberg, Elliott",7,3,1,4,0,1,4,0
Adelaide,"Keays, Ben",28,14,5,14,0,0,0,7
Adelaide,"Kelly, Jake",23,15,4,8,0,0,0,2
Adelaide,"Laird, Rory",25,9,2,16,0,0,0,6
Adelaide,"Mackay, David",23,13,3,10,0,0,0,0
Adelaide,"McAdam, Shane",7,5,4,2,0,2,0,1
Adelaide,"McHenry, Ned",13,8,4,5,0,0,0,5
Adelaide,"McPherson, Andrew",16,14,8,2,0,0,0,0
Adelaide,"Murphy, Lachlan",16,8,2,8,1,0,0,0
Adelaide,"Murray, Nick",8,7,6,1,1,1,0,0
Adelaide,"OBrien, Reilly",12,2,2,10,0,0,19,1
Adelaide,"Rowe, James",12,7,3,5,0,1,0,0
Adelaide,"Schoenberg, Harry",19,10,1,9,0,1,0,1
Adelaide,"Seedsman, Paul",27,16,8,11,0,2,0,2
Adelaide,"Sholl, Lachlan",21,14,4,7,0,0,0,0
Adelaide,"Smith, Brodie",14,11,6,3,0,0,0,1
Adelaide,"Thilthorpe, Riley",10,8,3,2,0,0,4,2
Adelaide,"Walker, Taylor",8,5,3,3,2,0,1,1
Adelaide,"Berry, Sam",7,3,0,4,0,1,0,7
Adelaide,"Brown, Luke",20,14,7,6,0,0,0,3
Adelaide,"Butts, Jordon",9,7,1,2,0,0,0,3
Adelaide,"Doedee, Tom",14,7,2,7,0,0,0,4
Adelaide,"Fogarty, Darcy",10,6,0,4,1,0,0,3
Adelaide,"Hamill, Will",12,9,0,3,0,0,0,0
Adelaide,"Himmelberg, Elliott",10,4,2,6,0,1,4,3
Adelaide,"Keays, Ben",20,11,2,9,0,0,0,8
Adelaide,"Kelly, Jake",17,13,5,4,0,0,0,2
Adelaide,"Laird, Rory",36,16,0,20,0,0,0,5
Adelaide,"Mackay, David",12,6,2,6,0,0,0,3
Adelaide,"McHenry, Ned",1,0,0,1,0,0,0,0
Adelaide,"McPherson, Andrew",14,5,5,9,0,0,0,2
Adelaide,"Murphy, Lachlan",2,2,0,0,0,0,0,1
Adelaide,"OBrien, Reilly",6,3,0,3,0,0,28,8
Adelaide,"Rowe, James",13,6,0,7,1,1,0,3
Adelaide,"Schoenberg, Harry",19,10,2,9,0,1,0,5
Adelaide,"Seedsman, Paul",29,22,4,7,0,1,0,2
Adelaide,"Sholl, Lachlan",21,16,2,5,0,0,0,2
Adelaide,"Sloane, Rory",20,13,4,7,1,2,0,11
Adelaide,"Smith, Brodie",18,16,3,2,0,0,0,1
Adelaide,"Thilthorpe, Riley",6,5,3,1,2,0,0,0
Adelaide,"Walker, Taylor",6,3,2,3,0,1,0,1
Adelaide,"Berry, Sam",10,4,3,6,2,0,0,2
Adelaide,"Brown, Luke",16,12,5,4,0,0,0,2
Adelaide,"Butts, Jordon",11,8,5,3,0,0,0,1
Adelaide,"Doedee, Tom",20,11,7,9,0,0,0,1
Adelaide,"Fogarty, Darcy",12,7,4,5,1,2,0,0
Adelaide,"Frampton, Billy",5,4,3,1,0,1,5,0
Adelaide,"Hamill, Will",12,6,1,6,0,0,0,2
Adelaide,"Jones, Chayce",19,12,1,7,0,1,0,0
Adelaide,"Keays, Ben",32,16,5,16,0,1,0,3
Adelaide,"Kelly, Jake",13,8,4,5,0,0,0,3
Adelaide,"Laird, Rory",36,16,6,20,1,0,0,5
Adelaide,"Mackay, David",14,11,1,3,0,0,0,2
Adelaide,"McAdam, Shane",10,7,5,3,3,2,0,1
Adelaide,"McPherson, Andrew",0,0,0,0,0,0,0,0
Adelaide,"OBrien, Reilly",10,5,2,5,0,0,15,5
Adelaide,"OConnor, Ronin",8,1,0,7,0,0,0,8
Adelaide,"Rowe, James",22,10,4,12,1,0,0,1
Adelaide,"Schoenberg, Harry",21,12,5,9,1,2,0,1
Adelaide,"Seedsman, Paul",22,10,5,12,0,0,0,3
Adelaide,"Sholl, Lachlan",24,9,3,15,0,0,0,1
Adelaide,"Sloane, Rory",22,9,4,13,0,0,0,6
Adelaide,"Smith, Brodie",22,17,5,5,0,0,0,0
Adelaide,"Thilthorpe, Riley",11,6,4,5,2,1,0,0
Adelaide,"Berry, Sam",11,3,3,8,1,0,0,1
Adelaide,"Brown, Luke",18,13,6,5,0,0,0,1
Adelaide,"Butts, Jordon",10,9,6,1,0,0,0,1
Adelaide,"Doedee, Tom",15,9,6,6,0,0,0,3
Adelaide,"Fogarty, Darcy",7,5,3,2,2,0,0,0
Adelaide,"Jones, Chayce",12,9,2,3,0,0,0,2
Adelaide,"Keays, Ben",34,17,3,17,2,0,0,7
Adelaide,"Kelly, Jake",15,13,9,2,0,0,0,0
Adelaide,"Laird, Rory",35,14,3,21,0,0,0,7
Adelaide,"Mackay, David",21,12,6,9,1,0,0,5
Adelaide,"McAdam, Shane",9,5,3,4,1,2,0,6
Adelaide,"McHenry, Ned",15,7,2,8,0,0,0,6
Adelaide,"Murray, Nick",9,5,2,4,0,0,0,1
Adelaide,"OBrien, Reilly",10,0,3,10,0,0,24,3
Adelaide,"OConnor, Ronin",0,0,0,0,0,0,0,0
Adelaide,"Rowe, James",18,8,3,10,2,0,0,1
Adelaide,"Schoenberg, Harry",12,5,1,7,0,0,0,3
Adelaide,"Seedsman, Paul",35,22,7,13,1,0,0,4
Adelaide,"Sholl, Lachlan",17,14,5,3,0,2,0,2
Adelaide,"Sloane, Rory",19,8,0,11,0,0,0,5
Adelaide,"Smith, Brodie",22,15,4,7,0,0,0,4
Adelaide,"Thilthorpe, Riley",10,6,1,4,2,1,3,1
Adelaide,"Walker, Taylor",16,8,9,8,3,0,0,2
Adelaide,"Berry, Sam",7,3,1,4,1,0,0,2
Adelaide,"Brown, Luke",7,6,1,1,0,0,0,2
Adelaide,"Butts, Jordon",10,6,4,4,0,0,0,2
Adelaide,"Doedee, Tom",18,12,6,6,0,0,0,1
Adelaide,"Fogarty, Darcy",6,3,3,3,3,0,0,0
Adelaide,"Hamill, Will",5,3,0,2,0,0,0,1
Adelaide,"Jones, Chayce",9,7,1,2,0,1,0,0
Adelaide,"Keays, Ben",31,21,3,10,0,0,0,9
Adelaide,"Kelly, Jake",9,7,3,2,0,0,0,2
Adelaide,"Laird, Rory",25,11,1,14,0,0,0,6
Adelaide,"Mackay, David",16,6,1,10,0,1,0,2
Adelaide,"McAdam, Shane",3,0,0,3,0,0,0,3
Adelaide,"McHenry, Ned",19,11,4,8,0,0,0,4
Adelaide,"Murray, Nick",7,6,2,1,0,0,0,0
Adelaide,"OBrien, Reilly",14,8,4,6,1,0,34,2
Adelaide,"Rowe, James",13,7,0,6,1,1,0,3
Adelaide,"Schoenberg, Harry",19,7,3,12,0,1,0,3
Adelaide,"Seedsman, Paul",18,9,1,9,0,1,0,1
Adelaide,"Sholl, Lachlan",11,7,2,4,1,0,0,1
Adelaide,"Sloane, Rory",29,16,3,13,0,0,0,4
Adelaide,"Smith, Brodie",15,9,1,6,0,0,0,3
Adelaide,"Thilthorpe, Riley",10,6,5,4,1,1,1,1
Adelaide,"Walker, Taylor",16,10,6,6,4,3,2,1
Adelaide,"Butts, Jordon",7,5,0,2,0,0,0,2
Adelaide,"Doedee, Tom",16,11,4,5,0,0,0,0
Adelaide,"Fogarty, Darcy",10,8,4,2,2,2,0,0
Adelaide,"Hamill, Will",7,4,0,3,0,0,0,1
Adelaide,"Jones, Chayce",15,8,1,7,0,0,0,3
Adelaide,"Keays, Ben",33,17,3,16,0,1,0,6
Adelaide,"Kelly, Jake",7,5,4,2,0,0,0,2
Adelaide,"Laird, Rory",40,15,6,25,0,0,0,5
Adelaide,"Mackay, David",10,6,0,4,0,0,0,2
Adelaide,"McAdam, Shane",12,9,6,3,2,0,0,4
Adelaide,"McHenry, Ned",14,3,2,11,1,0,0,7
Adelaide,"McPherson, Andrew",7,3,2,4,0,0,0,1
Adelaide,"Murray, Nick",0,0,0,0,0,0,0,0
Adelaide,"OBrien, Reilly",19,10,7,9,0,0,27,4
Adelaide,"OConnor, Ronin",9,2,2,7,0,0,0,0
Adelaide,"Rowe, James",11,5,2,6,0,0,0,1
Adelaide,"Schoenberg, Harry",19,13,1,6,0,0,0,1
Adelaide,"Seedsman, Paul",27,18,7,9,2,0,0,4
Adelaide,"Sholl, Lachlan",14,7,2,7,0,0,0,2
Adelaide,"Sloane, Rory",23,13,4,10,0,0,0,5
Adelaide,"Smith, Brodie",26,21,8,5,0,0,0,1
Adelaide,"Thilthorpe, Riley",9,6,4,3,1,2,4,0
Adelaide,"Walker, Taylor",22,13,6,9,2,6,6,1
Adelaide,"Berry, Sam",15,7,2,8,0,1,0,4
Adelaide,"Butts, Jordon",11,7,1,4,0,0,0,2
Adelaide,"Doedee, Tom",20,10,1,10,0,0,0,2
Adelaide,"Fogarty, Darcy",9,6,2,3,0,0,0,0
Adelaide,"Hamill, Will",11,6,3,5,0,0,0,3
Adelaide,"Jones, Chayce",13,11,2,2,0,0,0,1
Adelaide,"Keays, Ben",31,21,2,10,0,0,0,10
Adelaide,"Kelly, Jake",12,7,2,5,0,0,0,3
Adelaide,"Laird, Rory",33,20,1,13,0,1,0,8
Adelaide,"Mackay, David",14,11,2,3,1,0,0,0
Adelaide,"McAdam, Shane",11,6,3,5,1,2,0,3
Adelaide,"McHenry, Ned",11,1,0,10,0,1,0,1
Adelaide,"McPherson, Andrew",16,11,1,5,0,0,0,1
Adelaide,"OBrien, Reilly",16,12,2,4,0,0,30,2
Adelaide,"Rowe, James",18,8,0,10,1,3,0,1
Adelaide,"Schoenberg, Harry",18,10,3,8,0,0,0,2
Adelaide,"Seedsman, Paul",31,20,4,11,0,0,0,6
Adelaide,"Sholl, Lachlan",0,0,0,0,0,0,0,0
Adelaide,"Sloane, Rory",19,12,3,7,1,0,0,4
Adelaide,"Smith, Brodie",18,16,4,2,1,0,0,0
Adelaide,"Thilthorpe, Riley",16,12,2,4,3,0,1,1
Adelaide,"Walker, Taylor",11,7,3,4,1,1,4,1
Adelaide,"Worrell, Josh",3,2,0,1,0,0,0,2
Adelaide,"Berry, Sam",7,1,0,6,0,0,0,3
Adelaide,"Brown, Luke",15,11,4,4,0,0,0,1
Adelaide,"Butts, Jordon",5,5,4,0,0,0,0,0
Adelaide,"Doedee, Tom",9,4,4,5,0,0,0,1
Adelaide,"Fogarty, Darcy",3,3,1,0,2,0,0,1
Adelaide,"Hamill, Will",7,4,2,3,0,0,0,3
Adelaide,"Jones, Chayce",15,9,7,6,0,0,0,3
Adelaide,"Keays, Ben",30,17,4,13,1,2,0,4
Adelaide,"Kelly, Jake",20,16,7,4,0,0,0,0
Adelaide,"Laird, Rory",33,20,4,13,0,0,0,4
Adelaide,"Mackay, David",14,7,5,7,0,0,0,3
Adelaide,"McAdam, Shane",8,5,4,3,0,0,0,1
Adelaide,"McHenry, Ned",11,8,4,3,1,1,0,2
Adelaide,"McPherson, Andrew",0,0,0,0,0,0,0,0
Adelaide,"OBrien, Reilly",13,7,4,6,0,0,27,5
Adelaide,"Rowe, James",13,6,2,7,1,0,0,5
Adelaide,"Schoenberg, Harry",13,7,0,6,0,1,0,3
Adelaide,"Seedsman, Paul",24,17,3,7,2,0,0,0
Adelaide,"Sholl, Lachlan",14,10,6,4,0,1,0,1
Adelaide,"Sloane, Rory",23,6,2,17,0,0,0,4
Adelaide,"Smith, Brodie",23,19,8,4,0,0,0,3
Adelaide,"Thilthorpe, Riley",12,7,3,5,0,0,1,2
Adelaide,"Walker, Taylor",14,10,5,4,3,4,6,3
Adelaide,"Berry, Sam",14,2,1,12,0,0,0,4
Adelaide,"Brown, Luke",11,9,2,2,0,0,0,2
Adelaide,"Butts, Jordon",12,6,2,6,0,0,0,1
Adelaide,"Doedee, Tom",14,8,3,6,1,1,0,1
Adelaide,"Frampton, Billy",9,6,2,3,0,2,0,2
Adelaide,"Hately, Jackson",7,4,1,3,0,2,0,1
Adelaide,"Jones, Chayce",11,7,2,4,0,0,0,1
Adelaide,"Keays, Ben",28,17,1,11,0,0,0,5
Adelaide,"Kelly, Jake",19,10,4,9,0,0,0,2
Adelaide,"Laird, Rory",37,17,5,20,0,0,0,3
Adelaide,"Mackay, David",14,10,2,4,1,0,0,5
Adelaide,"McHenry, Ned",12,9,2,3,0,0,0,9
Adelaide,"Murray, Nick",5,4,0,1,0,0,0,1
Adelaide,"OBrien, Reilly",16,12,2,4,0,0,36,1
Adelaide,"Pedlar, Luke",13,10,3,3,0,0,0,1
Adelaide,"Rowe, James",14,8,2,6,0,2,0,2
Adelaide,"Schoenberg, Harry",16,12,1,4,1,0,0,6
Adelaide,"Seedsman, Paul",21,13,3,8,2,2,0,2
Adelaide,"Sholl, Lachlan",28,14,5,14,0,0,0,0
Adelaide,"Sloane, Rory",18,11,4,7,1,0,0,6
Adelaide,"Smith, Brodie",22,13,1,9,0,0,0,5
Adelaide,"Thilthorpe, Riley",9,5,5,4,1,1,3,1
Adelaide,"Walker, Taylor",6,5,1,1,1,0,6,0
Adelaide,"Berry, Sam",3,2,1,1,0,0,0,3
Adelaide,"Butts, Jordon",12,11,10,1,0,0,0,1
Adelaide,"Davis, Ben",7,5,4,2,0,0,0,1
Adelaide,"Doedee, Tom",7,5,4,2,0,0,0,1
Adelaide,"Frampton, Billy",17,11,11,6,0,2,0,0
Adelaide,"Hamill, Will",14,4,3,10,0,0,0,0
Adelaide,"Jones, Chayce",11,9,4,2,0,0,0,0
Adelaide,"Keays, Ben",25,13,7,12,0,0,0,5
Adelaide,"Kelly, Jake",19,18,12,1,0,0,0,3
Adelaide,"Laird, Rory",33,12,7,21,0,0,0,5
Adelaide,"Mackay, David",14,10,4,4,0,0,0,3
Adelaide,"McHenry, Ned",4,4,0,0,0,0,0,2
Adelaide,"Murphy, Lachlan",10,7,2,3,1,2,0,0
Adelaide,"Murray, Nick",10,9,7,1,0,0,1,3
Adelaide,"OBrien, Reilly",10,6,1,4,0,0,40,1
Adelaide,"Pedlar, Luke",6,4,1,2,0,0,0,0
Adelaide,"Rowe, James",13,6,3,7,0,1,0,1
Adelaide,"Schoenberg, Harry",20,13,2,7,1,0,0,7
Adelaide,"Seedsman, Paul",27,15,10,12,0,1,0,3
Adelaide,"Sholl, Lachlan",15,7,1,8,0,0,0,0
Adelaide,"Sloane, Rory",17,8,5,9,0,0,0,4
Adelaide,"Smith, Brodie",28,24,8,4,0,0,0,1
Adelaide,"Thilthorpe, Riley",8,5,1,3,0,2,2,1
Adelaide,"Berry, Sam",12,6,3,6,0,0,0,2
Adelaide,"Butts, Jordon",8,5,2,3,0,0,0,2
Adelaide,"Fogarty, Darcy",10,7,4,3,2,1,0,1
Adelaide,"Hamill, Will",11,9,2,2,0,0,0,1
Adelaide,"Himmelberg, Elliott",10,5,2,5,1,1,0,1
Adelaide,"Jones, Chayce",15,11,4,4,0,0,0,1
Adelaide,"Keays, Ben",30,17,6,13,2,0,0,6
Adelaide,"Kelly, Jake",23,16,8,7,0,0,0,4
Adelaide,"Laird, Rory",34,15,8,19,0,0,0,4
Adelaide,"Lynch, Tom",25,15,6,10,1,0,0,0
Adelaide,"Mackay, David",18,11,2,7,0,0,0,3
Adelaide,"McHenry, Ned",10,4,2,6,0,0,0,3
Adelaide,"McPherson, Andrew",19,12,5,7,0,0,0,3
Adelaide,"Murphy, Lachlan",16,10,3,6,0,1,0,1
Adelaide,"Murray, Nick",6,5,3,1,0,0,0,4
Adelaide,"OBrien, Reilly",11,7,6,4,0,0,27,4
Adelaide,"Rowe, James",15,4,5,11,0,0,0,3
Adelaide,"Schoenberg, Harry",24,15,8,9,1,0,0,6
Adelaide,"Seedsman, Paul",27,16,7,11,0,1,0,3
Adelaide,"Sholl, Lachlan",4,1,0,3,0,0,0,1
Adelaide,"Sloane, Rory",25,7,4,18,0,0,0,2
Adelaide,"Smith, Brodie",27,21,8,6,0,1,0,3
Adelaide,"Walker, Taylor",13,9,7,4,1,1,0,0
Adelaide,"Berry, Sam",3,1,1,2,0,0,0,5
Adelaide,"Butts, Jordon",9,5,3,4,0,0,0,2
Adelaide,"Doedee, Tom",22,13,6,9,0,0,0,1
Adelaide,"Fogarty, Darcy",13,8,5,5,2,1,1,2
Adelaide,"Frampton, Billy",10,8,7,2,0,0,1,1
Adelaide,"Hamill, Will",12,8,3,4,0,0,0,3
Adelaide,"Himmelberg, Elliott",11,11,9,0,2,1,1,3
Adelaide,"Jones, Chayce",18,10,5,8,0,0,0,0
Adelaide,"Keays, Ben",23,15,6,8,1,1,0,7
Adelaide,"Kelly, Jake",13,11,5,2,0,0,0,0
Adelaide,"Laird, Rory",36,22,6,14,2,0,0,5
Adelaide,"Lynch, Tom",17,11,7,6,1,0,0,0
Adelaide,"Mackay, David",2,1,2,1,0,0,0,0
Adelaide,"McHenry, Ned",12,8,4,4,1,0,0,0
Adelaide,"McPherson, Andrew",15,11,4,4,0,0,0,2
Adelaide,"Murphy, Lachlan",13,7,3,6,2,1,0,2
Adelaide,"OBrien, Reilly",23,15,7,8,0,0,24,0
Adelaide,"Schoenberg, Harry",24,14,5,10,0,0,0,6
Adelaide,"Seedsman, Paul",25,17,8,8,0,0,0,1
Adelaide,"Sholl, Lachlan",14,7,4,7,0,0,0,2
Adelaide,"Sloane, Rory",15,10,4,5,0,0,0,5
Adelaide,"Smith, Brodie",14,12,7,2,1,0,0,2
Adelaide,"Walker, Taylor",9,9,6,0,4,0,2,0
Adelaide,"Berry, Sam",7,4,1,3,0,0,0,4
Adelaide,"Butts, Jordon",7,5,3,2,0,0,0,2
Adelaide,"Doedee, Tom",20,11,7,9,0,0,0,1
Adelaide,"Fogarty, Darcy",7,7,5,0,1,3,0,2
Adelaide,"Hamill, Will",6,3,1,3,0,0,0,5
Adelaide,"Himmelberg, Elliott",11,6,5,5,2,1,1,0
Adelaide,"Jones, Chayce",4,3,1,1,0,0,0,1
Adelaide,"Keays, Ben",22,11,2,11,0,0,0,4
Adelaide,"Kelly, Jake",13,10,2,3,0,0,0,3
Adelaide,"Laird, Rory",25,10,1,15,0,0,0,10
Adelaide,"Lynch, Tom",18,9,4,9,1,0,0,3
Adelaide,"Mackay, David",4,2,0,2,0,0,0,1
Adelaide,"McHenry, Ned",13,5,2,8,0,0,0,5
Adelaide,"McPherson, Andrew",21,15,3,6,0,0,0,1
Adelaide,"Murphy, Lachlan",17,8,5,9,1,2,0,2
Adelaide,"Murray, Nick",8,7,2,1,0,0,0,2
Adelaide,"OBrien, Reilly",19,7,6,12,0,0,44,6
Adelaide,"Rowe, James",12,7,2,5,1,0,0,1
Adelaide,"Schoenberg, Harry",21,10,2,11,0,0,0,4
Adelaide,"Seedsman, Paul",22,13,5,9,0,0,0,1
Adelaide,"Sloane, Rory",26,12,2,14,0,0,0,0
Adelaide,"Smith, Brodie",23,15,5,8,0,0,0,1
Adelaide,"Walker, Taylor",5,5,2,0,2,0,4,0
Adelaide,"Butts, Jordon",16,8,4,8,0,0,0,1
Adelaide,"Cook, Brayden",17,10,3,7,0,0,0,1
Adelaide,"Davis, Ben",4,1,0,3,0,0,0,2
Adelaide,"Doedee, Tom",18,11,4,7,0,0,0,9
Adelaide,"Fogarty, Darcy",7,6,4,1,1,1,0,1
Adelaide,"Hamill, Will",6,4,2,2,0,0,0,1
Adelaide,"Himmelberg, Elliott",12,6,0,6,1,0,2,1
Adelaide,"Jones, Chayce",19,14,4,5,0,0,0,5
Adelaide,"Keays, Ben",22,15,0,7,1,0,0,4
Adelaide,"Kelly, Jake",11,8,1,3,0,0,0,0
Adelaide,"Laird, Rory",31,9,3,22,0,2,0,8
Adelaide,"Lynch, Tom",22,10,6,12,1,2,0,1
Adelaide,"Mackay, David",18,11,2,7,1,1,0,5
Adelaide,"McHenry, Ned",7,4,2,3,2,0,0,3
Adelaide,"McPherson, Andrew",18,12,3,6,0,0,0,3
Adelaide,"Murphy, Lachlan",9,6,2,3,0,0,0,1
Adelaide,"Murray, Nick",14,12,2,2,0,0,0,5
Adelaide,"OBrien, Reilly",17,9,2,8,0,0,29,1
Adelaide,"Schoenberg, Harry",31,19,4,12,0,0,0,2
Adelaide,"Seedsman, Paul",31,17,2,14,0,0,0,4
Adelaide,"Sloane, Rory",19,8,2,11,0,0,0,3
Adelaide,"Smith, Brodie",4,2,1,2,0,0,0,2
Adelaide,"Thilthorpe, Riley",6,3,1,3,0,1,0,1
Adelaide,"Butts, Jordon",14,9,7,5,0,0,0,1
Adelaide,"Cook, Brayden",6,4,1,2,0,0,0,2
Adelaide,"Davis, Ben",14,11,5,3,0,0,0,0
Adelaide,"Doedee, Tom",14,7,5,7,0,0,0,4
Adelaide,"Fogarty, Darcy",12,9,7,3,3,1,0,4
Adelaide,"Himmelberg, Elliott",1,1,1,0,0,1,0,0
Adelaide,"Jones, Chayce",14,10,6,4,0,0,0,0
Adelaide,"Keays, Ben",29,14,3,15,0,0,0,11
Adelaide,"Kelly, Jake",21,14,7,7,0,0,0,1
Adelaide,"Laird, Rory",28,12,1,16,0,1,0,7
Adelaide,"Lynch, Tom",29,16,7,13,1,0,0,0
Adelaide,"Mackay, David",13,7,4,6,1,1,0,3
Adelaide,"McAdam, Shane",10,5,4,5,2,0,0,1
Adelaide,"McHenry, Ned",22,8,8,14,0,0,0,1
Adelaide,"McPherson, Andrew",17,9,2,8,0,0,0,4
Adelaide,"Murphy, Lachlan",11,7,0,4,1,0,0,2
Adelaide,"Murray, Nick",13,10,2,3,0,0,0,1
Adelaide,"Schoenberg, Harry",16,6,3,10,0,0,0,2
Adelaide,"Seedsman, Paul",36,20,3,16,1,1,0,1
Adelaide,"Sholl, Lachlan",19,11,6,8,0,1,0,1
Adelaide,"Sloane, Rory",25,16,7,9,0,0,0,9
Adelaide,"Strachan, Kieran",11,8,5,3,0,1,25,2
Adelaide,"Thilthorpe, Riley",11,6,3,5,0,0,3,6
Adelaide,"Butts, Jordon",9,7,6,2,0,0,0,1
Adelaide,"Cook, Brayden",19,8,2,11,0,0,0,0
Adelaide,"Davis, Ben",10,3,1,7,0,0,0,0
Adelaide,"Doedee, Tom",13,9,2,4,0,0,0,3
Adelaide,"Fogarty, Darcy",6,3,3,3,0,1,0,2
Adelaide,"Frampton, Billy",11,6,5,5,0,0,0,1
Adelaide,"Gollant, Lachlan",11,7,3,4,1,1,0,1
Adelaide,"Jones, Chayce",11,8,3,3,1,1,0,2
Adelaide,"Keays, Ben",38,20,4,18,2,0,0,6
Adelaide,"Laird, Rory",40,14,4,26,0,0,0,8
Adelaide,"Lynch, Tom",23,12,6,11,1,0,0,2
Adelaide,"Mackay, David",19,13,4,6,1,3,0,2
Adelaide,"McAdam, Shane",14,10,8,4,3,0,0,3
Adelaide,"McHenry, Ned",24,11,6,13,1,3,0,1
Adelaide,"McPherson, Andrew",22,16,5,6,0,0,0,2
Adelaide,"Murphy, Lachlan",13,8,2,5,0,4,0,3
Adelaide,"Rowe, James",0,0,0,0,0,0,0,0
Adelaide,"Schoenberg, Harry",24,11,4,13,1,1,0,8
Adelaide,"Seedsman, Paul",23,11,5,12,1,0,0,2
Adelaide,"Sloane, Rory",27,11,4,16,0,0,0,7
Adelaide,"Smith, Brodie",25,20,7,5,0,1,0,1
Adelaide,"Strachan, Kieran",18,5,2,13,0,1,34,1
Adelaide,"Thilthorpe, Riley",18,9,4,9,1,1,3,1
Brisbane Lions,"Ah Chee, Callum",12,6,0,6,0,0,0,3
Brisbane Lions,"Andrews, Harris",11,8,4,3,0,0,0,1
Brisbane Lions,"Bailey, Zac",16,13,0,3,3,0,0,2
Brisbane Lions,"Berry, Jarrod",16,10,3,6,1,0,0,2
Brisbane Lions,"Birchall, Grant",11,8,5,3,0,0,0,1
Brisbane Lions,"Cameron, Charlie",10,7,2,3,0,0,0,1
Brisbane Lions,"Coleman, Keidean",8,4,1,4,1,1,0,4
Brisbane Lions,"Daniher, Joe",10,8,2,2,2,2,1,0
Brisbane Lions,"Fullarton, Tom",8,4,1,4,0,0,1,0
Brisbane Lions,"Hipwood, Eric",9,4,3,5,1,0,0,1
Brisbane Lions,"Lester, Ryan",9,5,3,4,0,0,0,1
Brisbane Lions,"Lyons, Jarryd",28,14,4,14,1,0,0,2
Brisbane Lions,"Mathieson, Rhys",0,0,0,0,0,0,0,0
Brisbane Lions,"McCarthy, Lincoln",16,11,2,5,2,0,0,3
Brisbane Lions,"McCluggage, Hugh",18,14,5,4,1,0,0,3
Brisbane Lions,"McInerney, Oscar",12,7,3,5,1,1,24,2
Brisbane Lions,"Neale, Lachie",24,8,4,16,0,0,0,0
Brisbane Lions,"Payne, Jack",12,6,3,6,0,0,0,0
Brisbane Lions,"Rich, Daniel",23,21,8,2,0,0,0,1
Brisbane Lions,"Robinson, Mitch",10,8,2,2,0,0,0,5
Brisbane Lions,"Sharp, Harry",11,8,1,3,0,0,0,3
Brisbane Lions,"Starcevich, Brandon",9,6,2,3,0,0,0,0
Brisbane Lions,"Zorko, Dayne",22,15,6,7,1,2,0,6
Brisbane Lions,"Ah Chee, Callum",7,4,1,3,0,0,0,3
Brisbane Lions,"Andrews, Harris",11,7,7,4,0,0,0,1
Brisbane Lions,"Bailey, Zac",16,9,2,7,0,0,0,7
Brisbane Lions,"Berry, Tom",7,4,1,3,1,1,0,6
Brisbane Lions,"Birchall, Grant",17,15,7,2,0,0,0,1
Brisbane Lions,"Cameron, Charlie",7,6,1,1,2,1,0,2
Brisbane Lions,"Coleman, Keidean",2,1,0,1,0,0,0,1
Brisbane Lions,"Daniher, Joe",14,13,9,1,1,2,2,3
Brisbane Lions,"Fullarton, Tom",8,2,1,6,0,0,6,2
Brisbane Lions,"Hipwood, Eric",12,11,4,1,4,3,0,0
Brisbane Lions,"Lester, Ryan",12,6,3,6,0,0,0,2
Brisbane Lions,"Lyons, Jarryd",20,13,6,7,1,0,0,6
Brisbane Lions,"McCarthy, Lincoln",7,5,1,2,1,0,0,6
Brisbane Lions,"McCluggage, Hugh",18,10,2,8,1,2,0,4
Brisbane Lions,"McInerney, Oscar",6,2,2,4,0,0,17,2
Brisbane Lions,"Neale, Lachie",16,7,1,9,0,0,0,2
Brisbane Lions,"Payne, Jack",9,5,6,4,0,0,0,1
Brisbane Lions,"Prior, Jaxon",9,6,4,3,0,1,0,1
Brisbane Lions,"Rich, Daniel",25,20,3,5,0,0,0,2
Brisbane Lions,"Robinson, Mitch",12,9,2,3,0,0,0,1
Brisbane Lions,"Sharp, Harry",4,4,2,0,0,0,0,1
Brisbane Lions,"Starcevich, Brandon",9,7,2,2,0,0,0,1
Brisbane Lions,"Zorko, Dayne",22,20,5,2,0,1,0,2
Brisbane Lions,"Adams, Marcus",12,8,5,4,0,0,0,1
Brisbane Lions,"Ah Chee, Callum",10,9,1,1,0,0,0,5
Brisbane Lions,"Andrews, Harris",21,11,10,10,0,0,0,2
Brisbane Lions,"Bailey, Zac",18,7,4,11,1,0,0,4
Brisbane Lions,"Ballenden, Connor",4,3,2,1,0,0,1,0
Brisbane Lions,"Berry, Tom",10,4,3,6,1,0,0,3
Brisbane Lions,"Birchall, Grant",22,14,12,8,0,0,0,0
Brisbane Lions,"Cameron, Charlie",8,6,3,2,2,1,0,1
Brisbane Lions,"Daniher, Joe",18,15,8,3,3,3,0,0
Brisbane Lions,"Fullarton, Tom",17,9,2,8,0,0,3,0
Brisbane Lions,"Hipwood, Eric",14,10,7,4,1,0,0,0
Brisbane Lions,"Lester, Ryan",16,9,9,7,0,0,0,6
Brisbane Lions,"Lyons, Jarryd",29,20,8,9,0,0,0,10
Brisbane Lions,"McCarthy, Lincoln",18,9,3,9,0,0,0,4
Brisbane Lions,"McCluggage, Hugh",28,23,8,5,1,1,0,2
Brisbane Lions,"Neale, Lachie",21,14,5,7,1,0,0,6
Brisbane Lions,"Payne, Jack",10,9,6,1,0,0,0,1
Brisbane Lions,"Prior, Jaxon",0,0,0,0,0,0,0,0
Brisbane Lions,"Rich, Daniel",28,22,5,6,1,0,0,4
Brisbane Lions,"Robertson, Deven",17,8,7,9,0,0,0,7
Brisbane Lions,"Robinson, Mitch",23,15,8,8,0,0,0,3
Brisbane Lions,"Starcevich, Brandon",13,12,4,1,0,0,0,3
Brisbane Lions,"Zorko, Dayne",24,21,11,3,0,1,0,8
Brisbane Lions,"Adams, Marcus",13,8,3,5,0,0,0,4
Brisbane Lions,"Ah Chee, Callum",0,0,0,0,0,0,0,0
Brisbane Lions,"Andrews, Harris",23,13,12,10,1,0,0,2
Brisbane Lions,"Bailey, Zac",13,5,3,8,1,0,0,1
Brisbane Lions,"Berry, Jarrod",17,9,3,8,0,0,0,3
Brisbane Lions,"Berry, Tom",4,2,1,2,0,0,0,6
Brisbane Lions,"Birchall, Grant",21,18,7,3,0,0,0,0
Brisbane Lions,"Cameron, Charlie",12,7,4,5,0,2,0,1
Brisbane Lions,"Daniher, Joe",8,3,1,5,1,0,4,0
Brisbane Lions,"Fullarton, Tom",7,2,2,5,1,0,2,1
Brisbane Lions,"Gardiner, Darcy",22,14,6,8,0,0,0,0
Brisbane Lions,"Hipwood, Eric",14,11,11,3,2,1,0,0
Brisbane Lions,"Lester, Ryan",14,11,8,3,0,0,0,0
Brisbane Lions,"Lyons, Jarryd",24,15,5,9,1,0,0,5
Brisbane Lions,"McCarthy, Lincoln",12,7,2,5,0,1,0,2
Brisbane Lions,"McCluggage, Hugh",25,19,12,6,1,0,0,1
Brisbane Lions,"McInerney, Oscar",14,9,5,5,0,0,29,2
Brisbane Lions,"Neale, Lachie",27,15,5,12,0,0,0,3
Brisbane Lions,"Rich, Daniel",29,22,5,7,0,0,0,1
Brisbane Lions,"Robertson, Deven",8,6,5,2,0,1,0,2
Brisbane Lions,"Robinson, Mitch",17,11,3,6,0,0,0,9
Brisbane Lions,"Starcevich, Brandon",14,9,3,5,0,0,0,4
Brisbane Lions,"Zorko, Dayne",23,16,4,7,0,0,0,3
Brisbane Lions,"Adams, Marcus",17,15,7,2,0,0,0,2
Brisbane Lions,"Ah Chee, Callum",10,3,0,7,0,0,0,4
Brisbane Lions,"Andrews, Harris",12,9,6,3,0,0,0,2
Brisbane Lions,"Bailey, Zac",10,6,1,4,0,1,0,4
Brisbane Lions,"Berry, Jarrod",8,4,0,4,0,1,0,4
Brisbane Lions,"Berry, Tom",7,3,0,4,0,0,0,2
Brisbane Lions,"Birchall, Grant",18,15,7,3,0,0,0,2
Brisbane Lions,"Cameron, Charlie",11,5,2,6,1,1,0,1
Brisbane Lions,"Daniher, Joe",25,21,8,4,2,1,6,3
Brisbane Lions,"Gardiner, Darcy",15,10,6,5,0,0,0,1
Brisbane Lions,"Hipwood, Eric",7,7,5,0,3,0,0,3
Brisbane Lions,"Lester, Ryan",12,7,3,5,0,0,0,1
Brisbane Lions,"Lyons, Jarryd",35,19,5,16,0,0,0,7
Brisbane Lions,"McCarthy, Lincoln",20,7,4,13,2,1,0,11
Brisbane Lions,"McCluggage, Hugh",32,21,6,11,1,2,0,4
Brisbane Lions,"McInerney, Oscar",8,0,1,8,0,0,31,0
Brisbane Lions,"McStay, Daniel",6,5,3,1,2,0,1,0
Brisbane Lions,"Neale, Lachie",37,19,7,18,2,0,0,4
Brisbane Lions,"Prior, Jaxon",10,9,3,1,2,0,0,0
Brisbane Lions,"Rich, Daniel",31,28,6,3,0,2,0,1
Brisbane Lions,"Robinson, Mitch",20,14,4,6,0,1,0,0
Brisbane Lions,"Starcevich, Brandon",7,6,3,1,0,0,0,1
Brisbane Lions,"Zorko, Dayne",26,19,5,7,0,0,0,6
Brisbane Lions,"Adams, Marcus",14,11,2,3,0,0,0,2
Brisbane Lions,"Ah Chee, Callum",9,5,1,4,1,0,0,4
Brisbane Lions,"Andrews, Harris",12,9,6,3,0,0,0,1
Brisbane Lions,"Bailey, Zac",18,12,3,6,0,1,0,5
Brisbane Lions,"Berry, Tom",8,1,1,7,0,0,0,2
Brisbane Lions,"Birchall, Grant",16,9,6,7,0,0,0,0
Brisbane Lions,"Cameron, Charlie",9,5,2,4,3,0,0,1
Brisbane Lions,"Daniher, Joe",15,12,7,3,1,1,5,1
Brisbane Lions,"Gardiner, Darcy",2,0,1,2,0,0,0,0
Brisbane Lions,"Hipwood, Eric",14,9,4,5,3,2,0,2
Brisbane Lions,"Lester, Ryan",17,9,5,8,0,0,0,2
Brisbane Lions,"Lyons, Jarryd",24,13,4,11,1,1,0,4
Brisbane Lions,"McCarthy, Lincoln",11,9,2,2,1,0,0,6
Brisbane Lions,"McCluggage, Hugh",33,22,6,11,0,2,0,3
Brisbane Lions,"McInerney, Oscar",11,8,2,3,1,0,35,1
Brisbane Lions,"McStay, Daniel",10,5,4,5,1,1,2,6
Brisbane Lions,"Neale, Lachie",24,8,1,16,0,0,0,5
Brisbane Lions,"Prior, Jaxon",12,9,3,3,0,1,0,2
Brisbane Lions,"Rich, Daniel",28,23,5,5,0,0,0,1
Brisbane Lions,"Robertson, Deven",18,7,1,11,2,1,0,6
Brisbane Lions,"Robinson, Mitch",18,14,1,4,0,0,0,2
Brisbane Lions,"Starcevich, Brandon",10,8,2,2,0,0,0,4
Brisbane Lions,"Zorko, Dayne",20,14,3,6,1,1,0,11
Brisbane Lions,"Adams, Marcus",16,11,5,5,0,0,0,1
Brisbane Lions,"Ah Chee, Callum",13,6,0,7,1,0,0,6
Brisbane Lions,"Andrews, Harris",15,7,10,8,0,0,0,1
Brisbane Lions,"Bailey, Zac",21,12,4,9,1,1,0,4
Brisbane Lions,"Berry, Tom",0,0,0,0,0,0,0,0
Brisbane Lions,"Birchall, Grant",25,18,10,7,0,0,0,2
Brisbane Lions,"Cameron, Charlie",13,11,6,2,4,4,0,4
Brisbane Lions,"Daniher, Joe",17,15,7,2,2,0,3,0
Brisbane Lions,"Hipwood, Eric",8,3,3,5,0,0,0,1
Brisbane Lions,"Lester, Ryan",8,3,1,5,0,0,0,1
Brisbane Lions,"Lyons, Jarryd",28,18,5,10,0,0,0,4
Brisbane Lions,"Madden, James",11,4,0,7,0,0,0,2
Brisbane Lions,"Mathieson, Rhys",14,6,3,8,0,0,0,5
Brisbane Lions,"McCarthy, Lincoln",18,13,3,5,1,2,0,1
Brisbane Lions,"McCluggage, Hugh",30,23,5,7,1,3,0,3
Brisbane Lions,"McInerney, Oscar",11,4,1,7,0,1,20,2
Brisbane Lions,"McStay, Daniel",8,4,2,4,1,0,1,5
Brisbane Lions,"Prior, Jaxon",13,9,5,4,1,0,0,1
Brisbane Lions,"Rich, Daniel",21,19,5,2,0,0,0,1
Brisbane Lions,"Robertson, Deven",14,5,2,9,0,0,0,2
Brisbane Lions,"Robinson, Mitch",22,18,4,4,0,1,0,4
Brisbane Lions,"Starcevich, Brandon",14,11,7,3,0,0,0,0
Brisbane Lions,"Zorko, Dayne",19,14,5,5,1,0,0,6
Brisbane Lions,"Adams, Marcus",15,12,5,3,0,0,0,2
Brisbane Lions,"Ah Chee, Callum",12,4,3,8,1,0,0,0
Brisbane Lions,"Andrews, Harris",17,13,10,4,0,0,0,1
Brisbane Lions,"Bailey, Zac",26,14,7,12,0,1,0,1
Brisbane Lions,"Birchall, Grant",21,14,9,7,0,0,0,0
Brisbane Lions,"Cameron, Charlie",14,12,11,2,3,5,0,1
Brisbane Lions,"Coleman, Keidean",0,0,0,0,0,0,0,0
Brisbane Lions,"Daniher, Joe",16,13,7,3,2,0,3,1
Brisbane Lions,"Gardiner, Darcy",12,9,5,3,0,0,0,1
Brisbane Lions,"Hipwood, Eric",9,7,3,2,1,1,0,0
Brisbane Lions,"Lester, Ryan",11,6,4,5,0,0,0,1
Brisbane Lions,"Lyons, Jarryd",29,21,9,8,1,0,0,2
Brisbane Lions,"Mathieson, Rhys",18,11,1,7,1,0,0,3
Brisbane Lions,"McCarthy, Lincoln",10,7,1,3,1,1,0,2
Brisbane Lions,"McCluggage, Hugh",27,17,6,10,1,0,0,5
Brisbane Lions,"McInerney, Oscar",8,4,4,4,1,0,15,3
Brisbane Lions,"McStay, Daniel",8,5,5,3,1,0,0,2
Brisbane Lions,"Prior, Jaxon",10,9,5,1,1,0,0,3
Brisbane Lions,"Rich, Daniel",31,28,10,3,0,1,0,3
Brisbane Lions,"Robertson, Deven",9,3,2,6,0,0,0,3
Brisbane Lions,"Robinson, Mitch",24,15,3,9,0,0,0,2
Brisbane Lions,"Starcevich, Brandon",12,7,6,5,0,0,0,3
Brisbane Lions,"Zorko, Dayne",21,12,3,9,0,1,0,5
Brisbane Lions,"Adams, Marcus",19,12,7,7,0,0,0,2
Brisbane Lions,"Ah Chee, Callum",11,5,2,6,0,0,0,0
Brisbane Lions,"Andrews, Harris",17,13,11,4,0,0,0,1
Brisbane Lions,"Bailey, Zac",19,11,4,8,2,1,0,0
Brisbane Lions,"Birchall, Grant",26,19,13,7,0,0,0,0
Brisbane Lions,"Cameron, Charlie",9,7,5,2,3,0,0,1
Brisbane Lions,"Coleman, Keidean",12,7,3,5,1,0,0,0
Brisbane Lions,"Daniher, Joe",14,9,3,5,2,2,9,0
Brisbane Lions,"Gardiner, Darcy",17,13,7,4,0,0,0,1
Brisbane Lions,"Hipwood, Eric",16,8,7,8,2,2,0,2
Brisbane Lions,"Lester, Ryan",2,2,2,0,0,0,0,0
Brisbane Lions,"Lyons, Jarryd",37,13,6,24,0,0,0,9
Brisbane Lions,"Mathieson, Rhys",20,11,6,9,0,0,0,3
Brisbane Lions,"McCarthy, Lincoln",13,9,5,4,2,0,0,4
Brisbane Lions,"McCluggage, Hugh",24,16,8,8,1,0,0,6
Brisbane Lions,"McInerney, Oscar",10,7,2,3,0,0,33,1
Brisbane Lions,"McStay, Daniel",14,9,8,5,4,0,0,2
Brisbane Lions,"Prior, Jaxon",10,7,2,3,1,0,0,1
Brisbane Lions,"Rich, Daniel",25,21,5,4,0,0,0,0
Brisbane Lions,"Robertson, Deven",18,7,5,11,0,0,0,3
Brisbane Lions,"Robinson, Mitch",27,19,8,8,0,0,0,0
Brisbane Lions,"Starcevich, Brandon",20,15,10,5,0,0,0,1
Brisbane Lions,"Zorko, Dayne",34,23,9,11,1,2,0,2
Brisbane Lions,"Adams, Marcus",12,9,8,3,0,0,0,1
Brisbane Lions,"Ah Chee, Callum",10,3,1,7,0,0,0,5
Brisbane Lions,"Andrews, Harris",15,12,7,3,0,0,0,0
Brisbane Lions,"Bailey, Zac",15,10,2,5,4,0,0,1
Brisbane Lions,"Berry, Tom",0,0,0,0,0,0,0,0
Brisbane Lions,"Birchall, Grant",15,13,5,2,0,0,0,2
Brisbane Lions,"Cameron, Charlie",8,5,1,3,1,1,0,1
Brisbane Lions,"Coleman, Keidean",16,7,4,9,1,1,0,1
Brisbane Lions,"Daniher, Joe",18,13,3,5,1,4,6,2
Brisbane Lions,"Hipwood, Eric",13,10,7,3,4,0,0,3
Brisbane Lions,"Lyons, Jarryd",26,21,4,5,1,0,0,6
Brisbane Lions,"Madden, James",13,7,4,6,1,0,0,1
Brisbane Lions,"Mathieson, Rhys",20,12,4,8,1,0,0,5
Brisbane Lions,"McCarthy, Lincoln",10,1,1,9,0,0,0,2
Brisbane Lions,"McCluggage, Hugh",27,18,3,9,0,2,0,3
Brisbane Lions,"McInerney, Oscar",6,3,0,3,0,0,35,7
Brisbane Lions,"McStay, Daniel",10,5,5,5,0,1,1,6
Brisbane Lions,"Prior, Jaxon",6,5,2,1,0,0,0,1
Brisbane Lions,"Rich, Daniel",26,22,7,4,0,0,0,1
Brisbane Lions,"Robertson, Deven",16,8,2,8,0,0,0,6
Brisbane Lions,"Robinson, Mitch",22,14,6,8,0,0,0,3
Brisbane Lions,"Starcevich, Brandon",17,14,3,3,0,0,0,1
Brisbane Lions,"Zorko, Dayne",28,17,4,11,1,1,0,2
Brisbane Lions,"Adams, Marcus",16,7,8,9,0,0,0,1
Brisbane Lions,"Ah Chee, Callum",13,10,5,3,0,0,0,0
Brisbane Lions,"Andrews, Harris",15,10,10,5,0,0,0,0
Brisbane Lions,"Bailey, Zac",18,11,5,7,1,0,0,2
Brisbane Lions,"Berry, Tom",0,0,0,0,0,0,0,0
Brisbane Lions,"Birchall, Grant",9,9,5,0,0,0,0,1
Brisbane Lions,"Cameron, Charlie",13,7,3,6,1,1,0,4
Brisbane Lions,"Coleman, Keidean",13,9,5,4,1,1,0,3
Brisbane Lions,"Daniher, Joe",7,4,2,3,1,1,3,3
Brisbane Lions,"Hipwood, Eric",12,9,6,3,1,2,0,2
Brisbane Lions,"Lyons, Jarryd",25,12,3,13,0,1,0,3
Brisbane Lions,"Madden, James",15,11,5,4,0,0,0,0
Brisbane Lions,"Mathieson, Rhys",20,8,6,12,0,0,0,6
Brisbane Lions,"McCarthy, Lincoln",13,8,4,5,2,0,0,4
Brisbane Lions,"McCluggage, Hugh",15,13,2,2,1,1,0,7
Brisbane Lions,"McInerney, Oscar",20,9,4,11,1,2,30,2
Brisbane Lions,"McStay, Daniel",11,6,5,5,2,0,0,0
Brisbane Lions,"Prior, Jaxon",16,12,5,4,1,0,0,1
Brisbane Lions,"Rich, Daniel",22,17,6,5,1,2,0,4
Brisbane Lions,"Robertson, Deven",19,11,5,8,0,0,0,4
Brisbane Lions,"Robinson, Mitch",30,24,12,6,4,1,0,1
Brisbane Lions,"Starcevich, Brandon",16,12,8,4,0,0,0,1
Brisbane Lions,"Zorko, Dayne",35,23,6,12,2,0,0,1
Brisbane Lions,"Adams, Marcus",9,6,6,3,0,0,0,0
Brisbane Lions,"Ah Chee, Callum",11,6,1,5,0,0,0,2
Brisbane Lions,"Andrews, Harris",21,14,14,7,0,0,0,0
Brisbane Lions,"Bailey, Zac",19,16,5,3,4,0,0,1
Brisbane Lions,"Birchall, Grant",18,16,10,2,0,0,0,2
Brisbane Lions,"Cameron, Charlie",10,8,3,2,2,0,0,4
Brisbane Lions,"Coleman, Keidean",10,4,1,6,1,0,0,2
Brisbane Lions,"Daniher, Joe",17,10,5,7,1,0,2,3
Brisbane Lions,"Hipwood, Eric",13,9,6,4,1,4,0,3
Brisbane Lions,"Lester, Ryan",11,7,6,4,0,0,0,2
Brisbane Lions,"Lyons, Jarryd",28,18,1,10,0,0,0,8
Brisbane Lions,"Mathieson, Rhys",4,4,1,0,0,0,0,0
Brisbane Lions,"McCarthy, Lincoln",11,9,4,2,1,1,0,2
Brisbane Lions,"McCluggage, Hugh",23,16,7,7,0,0,0,3
Brisbane Lions,"McInerney, Oscar",8,4,2,4,0,1,18,0
Brisbane Lions,"McStay, Daniel",7,4,2,3,0,0,0,0
Brisbane Lions,"Neale, Lachie",25,11,3,14,0,0,0,1
Brisbane Lions,"Prior, Jaxon",14,10,4,4,0,0,0,2
Brisbane Lions,"Rich, Daniel",26,21,4,5,0,0,0,1
Brisbane Lions,"Robertson, Deven",12,8,5,4,0,0,0,8
Brisbane Lions,"Robinson, Mitch",13,8,4,5,0,0,0,4
Brisbane Lions,"Starcevich, Brandon",14,11,5,3,0,0,0,2
Brisbane Lions,"Zorko, Dayne",22,13,6,9,1,1,0,10
Brisbane Lions,"Adams, Marcus",14,7,4,7,0,0,0,1
Brisbane Lions,"Ah Chee, Callum",9,6,2,3,0,0,0,1
Brisbane Lions,"Andrews, Harris",11,9,7,2,0,0,0,0
Brisbane Lions,"Bailey, Zac",29,15,4,14,1,0,0,3
Brisbane Lions,"Berry, Tom",0,0,0,0,0,0,0,0
Brisbane Lions,"Birchall, Grant",22,15,4,7,0,0,0,0
Brisbane Lions,"Cameron, Charlie",5,5,3,0,2,3,0,3
Brisbane Lions,"Coleman, Keidean",6,4,3,2,0,1,0,1
Brisbane Lions,"Daniher, Joe",17,12,2,5,1,1,1,1
Brisbane Lions,"Hipwood, Eric",10,8,6,2,1,2,0,1
Brisbane Lions,"Lyons, Jarryd",36,22,6,14,0,0,0,12
Brisbane Lions,"Madden, James",13,9,4,4,0,0,0,2
Brisbane Lions,"Mathieson, Rhys",20,9,4,11,0,1,0,5
Brisbane Lions,"McCarthy, Lincoln",13,9,3,4,2,0,0,5
Brisbane Lions,"McCluggage, Hugh",31,24,4,7,0,3,0,5
Brisbane Lions,"McInerney, Oscar",12,6,2,6,0,0,33,3
Brisbane Lions,"McStay, Daniel",10,8,5,2,0,1,0,1
Brisbane Lions,"Neale, Lachie",30,10,1,20,1,0,0,10
Brisbane Lions,"Prior, Jaxon",11,9,2,2,0,1,0,2
Brisbane Lions,"Rich, Daniel",18,16,1,2,0,0,0,4
Brisbane Lions,"Robertson, Deven",14,7,1,7,1,0,0,4
Brisbane Lions,"Robinson, Mitch",12,8,2,4,0,0,0,4
Brisbane Lions,"Starcevich, Brandon",12,8,3,4,0,0,0,1
Brisbane Lions,"Adams, Marcus",13,8,5,5,0,0,0,3
Brisbane Lions,"Ah Chee, Callum",2,1,0,1,0,0,0,2
Brisbane Lions,"Andrews, Harris",13,8,4,5,0,0,0,3
Brisbane Lions,"Bailey, Zac",15,11,4,4,0,1,0,5
Brisbane Lions,"Cameron, Charlie",14,13,6,1,3,3,0,2
Brisbane Lions,"Coleman, Keidean",6,6,4,0,1,0,0,1
Brisbane Lions,"Daniher, Joe",14,13,6,1,4,1,1,1
Brisbane Lions,"Hipwood, Eric",7,7,4,0,2,2,0,0
Brisbane Lions,"Lyons, Jarryd",24,13,5,11,1,0,0,3
Brisbane Lions,"Madden, James",7,2,0,5,0,0,0,4
Brisbane Lions,"Mathieson, Rhys",0,0,0,0,0,0,0,0
Brisbane Lions,"McCarthy, Lincoln",14,12,6,2,2,2,0,2
Brisbane Lions,"McCluggage, Hugh",17,11,3,6,0,0,0,3
Brisbane Lions,"McInerney, Oscar",18,12,6,6,0,0,35,4
Brisbane Lions,"McStay, Daniel",6,4,1,2,0,1,0,2
Brisbane Lions,"Neale, Lachie",24,15,7,9,0,0,0,6
Brisbane Lions,"Payne, Jack",8,6,2,2,0,0,0,2
Brisbane Lions,"Prior, Jaxon",5,4,2,1,0,0,0,3
Brisbane Lions,"Rich, Daniel",25,23,7,2,0,1,0,2
Brisbane Lions,"Robertson, Deven",16,10,4,6,0,0,0,4
Brisbane Lions,"Robinson, Mitch",14,7,6,7,0,0,0,1
Brisbane Lions,"Starcevich, Brandon",9,8,0,1,0,0,0,2
Brisbane Lions,"Zorko, Dayne",24,18,10,6,0,0,0,12
Brisbane Lions,"Adams, Marcus",18,12,8,6,0,0,0,4
Brisbane Lions,"Ah Chee, Callum",8,5,2,3,0,0,0,3
Brisbane Lions,"Andrews, Harris",16,8,3,8,0,0,0,2
Brisbane Lions,"Bailey, Zac",26,16,2,10,3,1,0,2
Brisbane Lions,"Berry, Jarrod",4,4,0,0,0,0,0,1
Brisbane Lions,"Birchall, Grant",25,14,4,11,0,0,0,2
Brisbane Lions,"Cameron, Charlie",9,8,3,1,3,2,0,2
Brisbane Lions,"Coleman, Keidean",6,3,1,3,0,1,0,1
Brisbane Lions,"Daniher, Joe",13,12,2,1,2,1,1,1
Brisbane Lions,"Hipwood, Eric",8,4,2,4,0,0,0,2
Brisbane Lions,"Lyons, Jarryd",31,18,4,13,0,0,0,10
Brisbane Lions,"Mathieson, Rhys",19,6,4,13,0,0,0,1
Brisbane Lions,"McCarthy, Lincoln",16,11,6,5,4,0,0,3
Brisbane Lions,"McCluggage, Hugh",23,13,2,10,1,0,0,3
Brisbane Lions,"McInerney, Oscar",16,8,3,8,0,0,30,2
Brisbane Lions,"McStay, Daniel",13,8,5,5,2,0,0,7
Brisbane Lions,"Payne, Jack",11,6,6,5,0,0,0,2
Brisbane Lions,"Prior, Jaxon",0,0,0,0,0,0,0,0
Brisbane Lions,"Rich, Daniel",25,20,4,5,0,1,0,0
Brisbane Lions,"Robertson, Deven",15,10,2,5,0,0,0,8
Brisbane Lions,"Robinson, Mitch",27,16,2,11,0,1,0,4
Brisbane Lions,"Starcevich, Brandon",9,6,3,3,0,0,0,5
Brisbane Lions,"Zorko, Dayne",12,9,2,3,2,0,0,12
Brisbane Lions,"Adams, Marcus",15,12,7,3,0,0,0,0
Brisbane Lions,"Ah Chee, Callum",6,3,0,3,1,0,0,2
Brisbane Lions,"Andrews, Harris",15,9,8,6,0,0,0,0
Brisbane Lions,"Bailey, Zac",12,7,1,5,1,0,0,3
Brisbane Lions,"Birchall, Grant",18,14,7,4,1,0,0,1
Brisbane Lions,"Cameron, Charlie",5,3,1,2,0,2,0,1
Brisbane Lions,"Coleman, Keidean",8,5,2,3,0,0,0,4
Brisbane Lions,"Daniher, Joe",10,7,4,3,1,1,0,1
Brisbane Lions,"Hipwood, Eric",3,1,1,2,0,1,0,0
Brisbane Lions,"Lyons, Jarryd",21,8,4,13,0,1,0,5
Brisbane Lions,"Madden, James",13,5,4,8,0,0,0,1
Brisbane Lions,"Mathieson, Rhys",4,3,2,1,0,0,0,1
Brisbane Lions,"McCarthy, Lincoln",10,6,4,4,0,1,0,1
Brisbane Lions,"McCluggage, Hugh",26,16,6,10,0,0,0,4
Brisbane Lions,"McInerney, Oscar",16,7,3,9,0,0,24,0
Brisbane Lions,"McStay, Daniel",8,7,5,1,1,2,0,3
Brisbane Lions,"Neale, Lachie",31,13,4,18,0,1,0,7
Brisbane Lions,"Payne, Jack",16,5,3,11,0,0,0,0
Brisbane Lions,"Rich, Daniel",27,23,8,4,0,1,0,0
Brisbane Lions,"Robertson, Deven",7,4,3,3,0,0,0,0
Brisbane Lions,"Robinson, Mitch",13,10,2,3,0,2,0,1
Brisbane Lions,"Starcevich, Brandon",10,6,2,4,0,0,0,1
Brisbane Lions,"Zorko, Dayne",17,12,3,5,3,1,0,5
Brisbane Lions,"Andrews, Harris",15,10,8,5,0,0,0,1
Brisbane Lions,"Bailey, Zac",16,13,4,3,2,2,0,0
Brisbane Lions,"Berry, Tom",0,0,0,0,0,0,0,0
Brisbane Lions,"Birchall, Grant",17,12,6,5,0,0,0,2
Brisbane Lions,"Cameron, Charlie",11,11,5,0,2,1,0,0
Brisbane Lions,"Coleman, Keidean",7,4,3,3,0,0,0,3
Brisbane Lions,"Daniher, Joe",14,8,3,6,3,1,0,1
Brisbane Lions,"Fullarton, Tom",9,1,1,8,0,0,8,2
Brisbane Lions,"Lester, Ryan",11,9,5,2,0,0,0,0
Brisbane Lions,"Lyons, Jarryd",27,11,4,16,0,0,0,6
Brisbane Lions,"Madden, James",8,1,2,7,0,0,0,0
Brisbane Lions,"McCarthy, Lincoln",9,7,3,2,2,0,0,3
Brisbane Lions,"McCluggage, Hugh",30,18,5,12,1,0,0,1
Brisbane Lions,"McInerney, Oscar",12,7,0,5,0,0,29,1
Brisbane Lions,"McStay, Daniel",5,3,4,2,2,0,1,6
Brisbane Lions,"Neale, Lachie",26,12,4,14,0,0,0,3
Brisbane Lions,"Payne, Jack",16,12,9,4,0,0,0,5
Brisbane Lions,"Prior, Jaxon",10,8,1,2,0,0,0,1
Brisbane Lions,"Rich, Daniel",23,19,3,4,0,0,0,4
Brisbane Lions,"Robertson, Deven",9,6,5,3,1,0,0,3
Brisbane Lions,"Robinson, Mitch",26,19,8,7,0,0,0,3
Brisbane Lions,"Starcevich, Brandon",17,11,5,6,0,0,0,1
Brisbane Lions,"Zorko, Dayne",24,21,7,3,0,3,0,3
Brisbane Lions,"Ah Chee, Callum",7,2,3,5,2,0,0,5
Brisbane Lions,"Andrews, Harris",15,11,9,4,0,0,0,2
Brisbane Lions,"Bailey, Zac",21,14,4,7,0,2,0,1
Brisbane Lions,"Berry, Jarrod",12,6,2,6,0,0,0,2
Brisbane Lions,"Birchall, Grant",18,13,9,5,0,0,0,1
Brisbane Lions,"Cameron, Charlie",12,9,6,3,3,2,0,2
Brisbane Lions,"Cockatoo, Nakia",0,0,0,0,0,0,0,0
Brisbane Lions,"Daniher, Joe",19,15,6,4,3,4,0,0
Brisbane Lions,"Fullarton, Tom",14,5,4,9,0,1,6,2
Brisbane Lions,"Lester, Ryan",16,7,5,9,0,0,0,2
Brisbane Lions,"Lyons, Jarryd",33,24,6,9,0,1,0,6
Brisbane Lions,"Madden, James",12,7,4,5,0,0,0,1
Brisbane Lions,"McCarthy, Lincoln",14,9,3,5,4,2,0,2
Brisbane Lions,"McCluggage, Hugh",23,17,6,6,0,2,0,2
Brisbane Lions,"McInerney, Oscar",18,11,2,7,0,0,39,1
Brisbane Lions,"McStay, Daniel",14,11,6,3,1,1,1,3
Brisbane Lions,"Neale, Lachie",19,11,3,8,1,0,0,3
Brisbane Lions,"Payne, Jack",12,7,4,5,0,0,0,1
Brisbane Lions,"Rich, Daniel",29,25,6,4,0,0,0,0
Brisbane Lions,"Robertson, Deven",10,7,2,3,0,0,0,4
Brisbane Lions,"Robinson, Mitch",23,19,8,4,2,1,0,4
Brisbane Lions,"Starcevich, Brandon",11,9,3,2,0,0,0,1
Brisbane Lions,"Zorko, Dayne",21,15,7,6,1,0,0,5
Brisbane Lions,"Ah Chee, Callum",15,5,5,10,0,0,0,3
Brisbane Lions,"Andrews, Harris",15,9,9,6,0,0,0,4
Brisbane Lions,"Bailey, Zac",16,11,2,5,1,0,0,2
Brisbane Lions,"Berry, Jarrod",15,8,2,7,0,0,0,3
Brisbane Lions,"Birchall, Grant",18,10,8,8,0,0,0,0
Brisbane Lions,"Cameron, Charlie",12,9,2,3,1,1,0,1
Brisbane Lions,"Cockatoo, Nakia",8,6,3,2,1,0,0,5
Brisbane Lions,"Coleman, Keidean",0,0,0,0,0,0,0,0
Brisbane Lions,"Daniher, Joe",11,8,5,3,1,1,0,0
Brisbane Lions,"Fullarton, Tom",15,7,5,8,1,0,4,1
Brisbane Lions,"Lester, Ryan",14,7,4,7,0,0,0,3
Brisbane Lions,"Lyons, Jarryd",38,23,9,15,1,1,0,5
Brisbane Lions,"Madden, James",7,3,2,4,0,0,0,5
Brisbane Lions,"McCarthy, Lincoln",13,4,4,9,0,0,0,3
Brisbane Lions,"McCluggage, Hugh",20,11,5,9,0,1,0,11
Brisbane Lions,"McInerney, Oscar",13,8,1,5,0,0,46,4
Brisbane Lions,"McStay, Daniel",16,8,8,8,4,0,0,2
Brisbane Lions,"Neale, Lachie",21,10,3,11,1,0,0,2
Brisbane Lions,"Payne, Jack",22,15,9,7,0,0,0,2
Brisbane Lions,"Rich, Daniel",32,24,9,8,0,0,0,0
Brisbane Lions,"Robinson, Mitch",15,12,4,3,0,0,0,4
Brisbane Lions,"Starcevich, Brandon",14,10,3,4,0,0,0,5
Brisbane Lions,"Zorko, Dayne",29,22,9,7,1,2,0,5
Brisbane Lions,"Ah Chee, Callum",11,5,2,6,0,0,0,1
Brisbane Lions,"Andrews, Harris",20,11,9,9,0,0,0,1
Brisbane Lions,"Bailey, Zac",19,14,3,5,2,2,0,5
Brisbane Lions,"Berry, Jarrod",14,6,4,8,0,0,0,4
Brisbane Lions,"Berry, Tom",1,0,0,1,0,0,0,1
Brisbane Lions,"Birchall, Grant",21,10,4,11,0,0,0,1
Brisbane Lions,"Cameron, Charlie",17,13,6,4,2,0,0,5
Brisbane Lions,"Cockatoo, Nakia",8,5,0,3,2,0,0,6
Brisbane Lions,"Coleman, Keidean",7,2,3,5,0,0,0,2
Brisbane Lions,"Daniher, Joe",17,10,7,7,4,1,1,1
Brisbane Lions,"Fullarton, Tom",14,6,1,8,0,0,2,2
Brisbane Lions,"Lester, Ryan",11,6,6,5,0,0,0,1
Brisbane Lions,"Lyons, Jarryd",29,16,3,13,0,0,0,7
Brisbane Lions,"Mathieson, Rhys",17,5,2,12,0,1,0,5
Brisbane Lions,"McCarthy, Lincoln",11,8,4,3,3,2,0,0
Brisbane Lions,"McCluggage, Hugh",29,19,3,10,0,1,0,6
Brisbane Lions,"McInerney, Oscar",17,8,3,9,2,0,23,2
Brisbane Lions,"McStay, Daniel",15,11,8,4,2,1,0,5
Brisbane Lions,"Prior, Jaxon",7,4,3,3,0,0,0,1
Brisbane Lions,"Rich, Daniel",28,20,11,8,0,0,0,0
Brisbane Lions,"Robinson, Mitch",13,9,2,4,0,0,0,3
Brisbane Lions,"Starcevich, Brandon",12,10,4,2,0,0,0,2
Brisbane Lions,"Zorko, Dayne",34,24,0,10,1,1,0,10
Brisbane Lions,"Ah Chee, Callum",15,10,5,5,1,0,0,6
Brisbane Lions,"Andrews, Harris",14,7,6,7,0,0,0,1
Brisbane Lions,"Bailey, Zac",27,13,6,14,1,1,0,3
Brisbane Lions,"Berry, Jarrod",16,8,0,8,0,0,0,4
Brisbane Lions,"Birchall, Grant",17,13,5,4,1,0,0,1
Brisbane Lions,"Cameron, Charlie",12,10,6,2,6,0,0,2
Brisbane Lions,"Cockatoo, Nakia",10,2,1,8,2,0,0,2
Brisbane Lions,"Coleman, Keidean",14,5,1,9,0,0,0,2
Brisbane Lions,"Daniher, Joe",15,13,8,2,3,2,0,0
Brisbane Lions,"Fullarton, Tom",8,4,1,4,0,0,4,3
Brisbane Lions,"Gardiner, Darcy",10,5,3,5,0,0,0,0
Brisbane Lions,"Lester, Ryan",16,8,2,8,0,0,0,4
Brisbane Lions,"Lyons, Jarryd",29,19,6,10,1,1,0,9
Brisbane Lions,"Mathieson, Rhys",0,0,0,0,0,0,0,0
Brisbane Lions,"McCarthy, Lincoln",12,6,3,6,2,0,0,1
Brisbane Lions,"McCluggage, Hugh",30,20,7,10,1,0,0,3
Brisbane Lions,"McInerney, Oscar",16,7,2,9,0,0,32,3
Brisbane Lions,"McStay, Daniel",15,9,7,6,3,1,1,4
Brisbane Lions,"Neale, Lachie",31,19,6,12,1,3,0,3
Brisbane Lions,"Prior, Jaxon",5,2,1,3,0,0,0,2
Brisbane Lions,"Rich, Daniel",24,17,4,7,0,0,0,3
Brisbane Lions,"Starcevich, Brandon",12,6,1,6,0,0,0,0
Brisbane Lions,"Zorko, Dayne",27,17,5,10,0,1,0,9
Brisbane Lions,"Adams, Marcus",15,14,5,1,0,0,0,1
Brisbane Lions,"Ah Chee, Callum",8,5,1,3,0,0,0,3
Brisbane Lions,"Bailey, Zac",19,11,2,8,0,1,0,5
Brisbane Lions,"Berry, Jarrod",15,8,3,7,3,1,0,3
Brisbane Lions,"Birchall, Grant",17,13,6,4,0,0,0,3
Brisbane Lions,"Cameron, Charlie",14,10,6,4,3,1,0,6
Brisbane Lions,"Cockatoo, Nakia",7,1,1,6,0,0,0,6
Brisbane Lions,"Coleman, Keidean",14,9,5,5,0,0,0,2
Brisbane Lions,"Daniher, Joe",12,10,5,2,4,2,0,0
Brisbane Lions,"Fullarton, Tom",6,4,2,2,0,0,1,2
Brisbane Lions,"Gardiner, Darcy",6,3,2,3,0,0,0,0
Brisbane Lions,"Lester, Ryan",12,5,4,7,0,0,0,4
Brisbane Lions,"Lyons, Jarryd",19,11,5,8,1,0,0,14
Brisbane Lions,"Mathieson, Rhys",0,0,0,0,0,0,0,0
Brisbane Lions,"McCarthy, Lincoln",14,7,3,7,2,1,0,5
Brisbane Lions,"McCluggage, Hugh",19,12,2,7,1,0,0,0
Brisbane Lions,"McInerney, Oscar",15,7,3,8,0,0,24,4
Brisbane Lions,"McStay, Daniel",15,8,5,7,2,1,0,4
Brisbane Lions,"Neale, Lachie",29,12,1,17,1,1,0,8
Brisbane Lions,"Prior, Jaxon",14,8,2,6,0,0,0,2
Brisbane Lions,"Rich, Daniel",29,24,6,5,1,1,0,2
Brisbane Lions,"Starcevich, Brandon",14,7,3,7,0,0,0,0
Brisbane Lions,"Zorko, Dayne",27,15,3,12,1,0,0,8
Brisbane Lions,"Adams, Marcus",10,6,3,4,0,0,0,3
Brisbane Lions,"Andrews, Harris",10,5,4,5,0,0,0,0
Brisbane Lions,"Bailey, Zac",14,10,1,4,1,1,0,5
Brisbane Lions,"Berry, Jarrod",11,7,5,4,1,0,0,6
Brisbane Lions,"Birchall, Grant",15,13,6,2,0,0,0,0
Brisbane Lions,"Cameron, Charlie",13,12,4,1,5,1,0,2
Brisbane Lions,"Cockatoo, Nakia",4,1,0,3,0,0,0,0
Brisbane Lions,"Coleman, Keidean",18,10,6,8,0,0,0,2
Brisbane Lions,"Daniher, Joe",15,10,5,5,0,1,0,2
Brisbane Lions,"Fullarton, Tom",6,3,0,3,0,0,1,2
Brisbane Lions,"Gardiner, Darcy",3,0,1,3,0,0,0,0
Brisbane Lions,"Lyons, Jarryd",27,18,3,9,0,1,0,6
Brisbane Lions,"Mathieson, Rhys",13,9,3,4,0,0,0,5
Brisbane Lions,"McCarthy, Lincoln",6,3,1,3,1,0,0,2
Brisbane Lions,"McCluggage, Hugh",24,15,3,9,1,0,0,5
Brisbane Lions,"McInerney, Oscar",17,8,0,9,0,0,30,5
Brisbane Lions,"McStay, Daniel",0,0,0,0,0,0,0,0
Brisbane Lions,"Neale, Lachie",46,22,5,24,0,0,0,3
Brisbane Lions,"Prior, Jaxon",8,5,1,3,0,1,0,1
Brisbane Lions,"Rich, Daniel",27,20,7,7,0,0,0,2
Brisbane Lions,"Robinson, Mitch",25,15,4,10,0,0,0,1
Brisbane Lions,"Starcevich, Brandon",9,6,3,3,0,0,0,1
Brisbane Lions,"Zorko, Dayne",20,14,3,6,0,0,0,4
Brisbane Lions,"Adams, Marcus",9,8,4,1,0,0,0,2
Brisbane Lions,"Andrews, Harris",17,6,7,11,0,1,0,3
Brisbane Lions,"Bailey, Zac",17,12,4,5,2,2,0,2
Brisbane Lions,"Berry, Jarrod",10,5,2,5,0,0,0,2
Brisbane Lions,"Birchall, Grant",18,12,4,6,0,0,0,1
Brisbane Lions,"Cameron, Charlie",13,10,4,3,3,1,0,5
Brisbane Lions,"Cockatoo, Nakia",5,3,0,2,0,1,0,3
Brisbane Lions,"Coleman, Keidean",15,9,2,6,0,0,0,3
Brisbane Lions,"Daniher, Joe",6,5,2,1,1,0,1,1
Brisbane Lions,"Fullarton, Tom",13,5,2,8,1,0,4,4
Brisbane Lions,"Gardiner, Darcy",12,7,3,5,0,0,0,1
Brisbane Lions,"Lester, Ryan",6,5,2,1,1,0,0,2
Brisbane Lions,"Lyons, Jarryd",27,15,4,12,0,0,0,5
Brisbane Lions,"McCarthy, Lincoln",15,6,5,9,1,1,0,6
Brisbane Lions,"McCluggage, Hugh",28,19,7,9,1,2,0,2
Brisbane Lions,"McInerney, Oscar",17,10,2,7,0,0,40,0
Brisbane Lions,"Neale, Lachie",28,14,6,14,0,1,0,4
Brisbane Lions,"Payne, Jack",3,2,1,1,0,0,0,2
Brisbane Lions,"Rich, Daniel",22,19,2,3,0,1,0,5
Brisbane Lions,"Robertson, Deven",8,3,2,5,0,0,0,3
Brisbane Lions,"Robinson, Mitch",24,13,3,11,1,0,0,5
Brisbane Lions,"Starcevich, Brandon",14,11,5,3,0,0,0,1
Brisbane Lions,"Zorko, Dayne",24,12,6,12,0,0,0,5
Carlton,"Casboult, Levi",8,7,3,1,1,0,1,1
Carlton,"Cripps, Patrick",28,8,2,20,0,1,0,3
Carlton,"Curnow, Ed",29,16,8,13,0,0,0,1
Carlton,"Docherty, Sam",24,23,5,1,0,0,0,1
Carlton,"Dow, Paddy",18,10,0,8,1,1,0,3
Carlton,"Fisher, Zac",20,10,3,10,0,2,0,1
Carlton,"Fogarty, Lachie",20,12,4,8,0,1,0,2
Carlton,"Gibbons, Michael",15,8,7,7,2,0,0,1
Carlton,"Jones, Liam",10,9,2,1,0,0,0,0
Carlton,"McDonald, Oscar",9,8,3,1,2,1,0,2
Carlton,"McKay, Harry",10,7,6,3,2,3,0,0
Carlton,"Murphy, Marc",11,8,4,3,0,0,0,3
Carlton,"Newnes, Jack",27,14,10,13,0,0,0,1
Carlton,"OBrien, Lochie",9,7,1,2,1,0,0,4
Carlton,"Petrevski-Seton, Sam",15,12,3,3,0,0,0,1
Carlton,"Pittonet, Marc",9,4,3,5,0,0,33,0
Carlton,"Plowman, Lachie",9,8,3,1,1,0,0,1
Carlton,"Saad, Adam",25,16,4,9,0,0,0,4
Carlton,"Setterfield, Will",17,11,6,6,0,2,0,2
Carlton,"Silvagni, Jack",7,6,2,1,1,0,0,2
Carlton,"Walsh, Sam",31,12,6,19,0,1,0,3
Carlton,"Weitering, Jacob",14,11,5,3,0,0,0,1
Carlton,"Williamson, Tom",12,8,3,4,0,0,0,0
Carlton,"Casboult, Levi",7,6,3,1,0,0,0,1
Carlton,"Cripps, Patrick",21,8,3,13,0,0,0,5
Carlton,"Curnow, Ed",21,13,3,8,0,0,0,5
Carlton,"Docherty, Sam",24,17,9,7,0,0,0,0
Carlton,"Dow, Paddy",13,6,1,7,0,0,0,2
Carlton,"Fisher, Zac",16,8,4,8,1,0,0,0
Carlton,"Fogarty, Lachie",21,10,5,11,1,0,0,4
Carlton,"Gibbons, Michael",15,12,3,3,3,1,0,0
Carlton,"Jones, Liam",7,5,4,2,0,0,0,2
Carlton,"Martin, Jack",12,10,7,2,3,0,0,2
Carlton,"McDonald, Oscar",0,0,0,0,0,0,0,0
Carlton,"McKay, Harry",10,8,6,2,4,0,0,2
Carlton,"Murphy, Marc",18,8,3,10,0,1,0,1
Carlton,"Newnes, Jack",16,9,5,7,0,1,0,0
Carlton,"Petrevski-Seton, Sam",19,14,5,5,0,0,0,1
Carlton,"Pittonet, Marc",8,7,3,1,1,1,21,2
Carlton,"Plowman, Lachie",16,15,10,1,0,0,0,2
Carlton,"Saad, Adam",23,18,2,5,0,0,0,1
Carlton,"Setterfield, Will",9,3,2,6,0,0,0,2
Carlton,"Walsh, Sam",29,8,4,21,0,0,0,3
Carlton,"Weitering, Jacob",16,12,5,4,0,1,0,1
Carlton,"Williams, Zac",20,15,2,5,0,0,0,4
Carlton,"Williamson, Tom",5,2,2,3,0,0,0,1
Carlton,"Betts, Eddie",4,3,1,1,1,1,0,2
Carlton,"Casboult, Levi",9,5,4,4,0,1,7,2
Carlton,"Cottrell, Matthew",14,8,3,6,0,0,0,3
Carlton,"Cripps, Patrick",34,15,6,19,2,0,0,3
Carlton,"Curnow, Ed",25,12,3,13,1,0,0,3
Carlton,"Docherty, Sam",28,19,12,9,0,0,0,0
Carlton,"Dow, Paddy",11,5,1,6,0,0,0,3
Carlton,"Fogarty, Lachie",25,16,7,9,1,0,0,7
Carlton,"Gibbons, Michael",24,16,8,8,1,0,0,2
Carlton,"Jones, Liam",20,16,9,4,0,0,0,1
Carlton,"McDonald, Oscar",0,0,0,0,0,0,0,0
Carlton,"McKay, Harry",17,14,10,3,7,5,0,3
Carlton,"Murphy, Marc",13,10,7,3,1,1,0,2
Carlton,"Newnes, Jack",23,14,8,9,1,0,0,1
Carlton,"Parks, Luke",13,11,3,2,0,0,0,3
Carlton,"Petrevski-Seton, Sam",20,14,4,6,0,0,0,1
Carlton,"Pittonet, Marc",16,7,1,9,0,1,27,0
Carlton,"Plowman, Lachie",21,15,10,6,0,0,0,0
Carlton,"Saad, Adam",21,13,2,8,0,0,0,0
Carlton,"Silvagni, Jack",18,11,4,7,1,2,0,2
Carlton,"Walsh, Sam",37,15,3,22,0,0,0,4
Carlton,"Weitering, Jacob",16,12,8,4,0,0,0,0
Carlton,"Williams, Zac",19,11,4,8,0,0,0,4
Carlton,"Betts, Eddie",12,9,5,3,1,3,0,2
Carlton,"Casboult, Levi",6,5,3,1,1,0,6,2
Carlton,"Cottrell, Matthew",19,12,5,7,1,0,0,3
Carlton,"Cripps, Patrick",21,10,2,11,1,1,1,9
Carlton,"Curnow, Ed",32,23,5,9,1,0,0,5
Carlton,"Docherty, Sam",28,25,8,3,0,0,0,2
Carlton,"Dow, Paddy",8,1,1,7,0,0,0,3
Carlton,"Fogarty, Lachie",11,10,1,1,0,0,0,8
Carlton,"Gibbons, Michael",19,14,2,5,0,2,0,3
Carlton,"Jones, Liam",21,16,11,5,0,1,0,0
Carlton,"Kennedy, Matthew",4,4,2,0,0,0,0,1
Carlton,"McKay, Harry",9,8,4,1,2,2,0,2
Carlton,"Murphy, Marc",17,12,5,5,2,1,0,2
Carlton,"Newnes, Jack",22,16,5,6,0,3,0,0
Carlton,"Parks, Luke",3,2,1,1,0,0,0,3
Carlton,"Petrevski-Seton, Sam",23,15,10,8,0,0,0,2
Carlton,"Pittonet, Marc",10,7,0,3,0,1,57,2
Carlton,"Plowman, Lachie",16,12,4,4,0,0,0,2
Carlton,"Saad, Adam",21,15,2,6,0,1,0,2
Carlton,"Setterfield, Will",15,4,1,11,0,0,0,0
Carlton,"Silvagni, Jack",6,2,1,4,0,0,0,2
Carlton,"Walsh, Sam",24,10,5,14,0,0,0,7
Carlton,"Weitering, Jacob",21,20,5,1,0,0,0,0
Carlton,"Betts, Eddie",12,6,2,6,0,0,0,3
Carlton,"Casboult, Levi",10,10,4,0,2,1,7,2
Carlton,"Cottrell, Matthew",12,9,3,3,1,0,0,0
Carlton,"Cripps, Patrick",27,14,4,13,0,1,0,3
Carlton,"Curnow, Ed",18,13,4,5,0,0,0,7
Carlton,"Docherty, Sam",25,18,8,7,0,0,0,1
Carlton,"Dow, Paddy",0,0,0,0,0,0,0,0
Carlton,"Fogarty, Lachie",16,8,5,8,1,0,0,4
Carlton,"Gibbons, Michael",18,9,2,9,0,1,0,2
Carlton,"Jones, Liam",6,5,1,1,0,0,0,0
Carlton,"Kennedy, Matthew",12,9,3,3,0,0,0,1
Carlton,"McGovern, Mitch",13,11,5,2,1,1,0,2
Carlton,"McKay, Harry",5,5,5,0,1,2,0,3
Carlton,"Murphy, Marc",15,7,7,8,0,0,0,2
Carlton,"Newnes, Jack",16,9,8,7,1,1,0,3
Carlton,"Petrevski-Seton, Sam",11,7,3,4,0,0,0,2
Carlton,"Pittonet, Marc",10,6,2,4,1,0,18,3
Carlton,"Plowman, Lachie",15,10,6,5,0,0,0,0
Carlton,"Saad, Adam",18,14,5,4,0,0,0,5
Carlton,"Walsh, Sam",29,12,5,17,1,0,0,6
Carlton,"Weitering, Jacob",14,12,4,2,0,0,0,4
Carlton,"Williams, Zac",22,13,4,9,0,2,0,4
Carlton,"Williamson, Tom",9,6,4,3,0,1,0,0
Carlton,"Betts, Eddie",11,6,1,5,0,4,0,0
Carlton,"Casboult, Levi",8,3,0,5,0,0,16,4
Carlton,"Cottrell, Matthew",13,11,4,2,0,0,0,2
Carlton,"Cripps, Patrick",25,4,2,21,0,2,0,4
Carlton,"Cuningham, David",17,8,2,9,0,0,0,2
Carlton,"Curnow, Ed",30,24,4,6,1,0,0,7
Carlton,"Docherty, Sam",28,21,7,7,0,0,0,7
Carlton,"Fogarty, Lachie",13,8,2,5,0,1,0,3
Carlton,"Gibbons, Michael",5,4,2,1,0,1,0,3
Carlton,"Jones, Liam",17,11,8,6,0,0,0,1
Carlton,"Kennedy, Matthew",0,0,0,0,0,0,0,0
Carlton,"McGovern, Mitch",9,6,2,3,2,1,0,2
Carlton,"McKay, Harry",15,12,9,3,6,2,0,3
Carlton,"Murphy, Marc",19,11,6,8,2,0,0,1
Carlton,"Newnes, Jack",12,6,4,6,0,0,0,3
Carlton,"Petrevski-Seton, Sam",19,15,7,4,0,0,0,2
Carlton,"Pittonet, Marc",10,5,1,5,0,0,31,2
Carlton,"Plowman, Lachie",10,9,5,1,0,0,0,2
Carlton,"Saad, Adam",11,8,1,3,0,0,0,3
Carlton,"Stocker, Liam",10,6,1,4,0,0,0,2
Carlton,"Walsh, Sam",33,15,9,18,1,1,0,4
Carlton,"Weitering, Jacob",21,17,7,4,0,0,0,4
Carlton,"Williams, Zac",20,13,6,7,0,0,0,3
Carlton,"Betts, Eddie",13,12,4,1,3,0,0,1
Carlton,"Casboult, Levi",11,6,4,5,0,0,6,0
Carlton,"Cottrell, Matthew",16,11,2,5,0,0,0,6
Carlton,"Cripps, Patrick",24,13,5,11,1,1,0,2
Carlton,"Cuningham, David",25,12,4,13,2,1,0,0
Carlton,"Curnow, Ed",26,15,3,11,1,1,0,6
Carlton,"Docherty, Sam",19,15,5,4,0,0,0,2
Carlton,"Dow, Paddy",6,3,0,3,0,0,0,2
Carlton,"Fogarty, Lachie",14,9,4,5,2,0,0,1
Carlton,"Gibbons, Michael",17,12,3,5,0,0,0,5
Carlton,"Jones, Liam",9,8,2,1,0,0,0,2
Carlton,"McGovern, Mitch",9,5,5,4,1,0,0,4
Carlton,"McKay, Harry",12,7,6,5,4,2,0,2
Carlton,"Newnes, Jack",16,8,5,8,0,1,0,3
Carlton,"Owies, Matthew",7,3,4,4,3,0,0,4
Carlton,"Parks, Luke",9,6,3,3,0,0,0,4
Carlton,"Petrevski-Seton, Sam",14,8,2,6,0,0,0,1
Carlton,"Pittonet, Marc",15,4,0,11,0,0,35,4
Carlton,"Plowman, Lachie",7,3,1,4,0,0,0,1
Carlton,"Saad, Adam",21,16,2,5,1,0,0,1
Carlton,"Stocker, Liam",10,7,2,3,0,0,0,6
Carlton,"Walsh, Sam",33,21,6,12,1,1,0,5
Carlton,"Weitering, Jacob",19,14,11,5,0,0,0,5
Carlton,"Betts, Eddie",13,7,2,6,5,0,0,1
Carlton,"Casboult, Levi",11,8,5,3,0,2,8,3
Carlton,"Cottrell, Matthew",14,12,4,2,0,0,0,4
Carlton,"Cripps, Patrick",15,4,1,11,1,0,0,5
Carlton,"Cuningham, David",12,6,3,6,1,1,0,4
Carlton,"Curnow, Ed",27,17,5,10,0,0,0,2
Carlton,"Docherty, Sam",31,24,9,7,0,0,0,2
Carlton,"Fogarty, Lachie",13,6,0,7,0,2,0,1
Carlton,"Gibbons, Michael",11,4,1,7,0,0,0,4
Carlton,"Jones, Liam",9,9,6,0,0,0,0,0
Carlton,"McKay, Harry",7,5,7,2,4,1,1,1
Carlton,"Newnes, Jack",15,7,3,8,0,1,0,1
Carlton,"Owies, Matthew",9,7,2,2,2,2,0,2
Carlton,"Parks, Luke",12,6,3,6,0,0,0,2
Carlton,"Petrevski-Seton, Sam",3,3,3,0,0,0,0,0
Carlton,"Pittonet, Marc",17,9,0,8,0,0,33,2
Carlton,"Plowman, Lachie",14,9,5,5,0,0,0,2
Carlton,"Saad, Adam",12,10,2,2,0,0,0,1
Carlton,"Silvagni, Jack",5,4,2,1,0,2,0,0
Carlton,"Stocker, Liam",14,8,1,6,0,0,0,0
Carlton,"Walsh, Sam",24,8,5,16,0,0,0,5
Carlton,"Weitering, Jacob",23,21,13,2,0,0,0,3
Carlton,"Williams, Zac",9,5,1,4,0,1,0,1
Carlton,"Betts, Eddie",12,10,2,2,1,3,0,4
Carlton,"Casboult, Levi",7,5,4,2,1,0,3,3
Carlton,"Cottrell, Matthew",15,9,4,6,0,0,0,2
Carlton,"Cripps, Patrick",27,9,2,18,0,0,0,10
Carlton,"Cuningham, David",0,0,0,0,0,0,0,0
Carlton,"Curnow, Ed",27,18,4,9,0,0,0,4
Carlton,"Docherty, Sam",27,12,4,15,0,0,0,6
Carlton,"Fogarty, Lachie",23,14,4,9,0,0,0,6
Carlton,"Gibbons, Michael",9,5,4,4,1,0,0,4
Carlton,"Jones, Liam",5,5,5,0,0,0,0,0
Carlton,"McKay, Harry",8,7,4,1,3,0,0,2
Carlton,"Murphy, Marc",19,11,3,8,1,0,0,2
Carlton,"Newman, Nic",20,14,4,6,0,0,0,5
Carlton,"Owies, Matthew",6,4,0,2,1,2,0,7
Carlton,"Parks, Luke",5,3,1,2,0,0,0,0
Carlton,"Pittonet, Marc",9,2,2,7,1,0,23,3
Carlton,"Plowman, Lachie",9,6,2,3,0,0,0,0
Carlton,"Saad, Adam",21,19,2,2,0,0,0,4
Carlton,"Setterfield, Will",19,13,4,6,0,1,0,4
Carlton,"Stocker, Liam",15,9,2,6,1,0,0,3
Carlton,"Walsh, Sam",30,14,9,16,0,0,0,5
Carlton,"Weitering, Jacob",8,6,0,2,0,0,0,1
Carlton,"Williams, Zac",19,15,3,4,0,1,0,2
Carlton,"Betts, Eddie",11,7,4,4,2,1,0,0
Carlton,"Cottrell, Matthew",11,7,1,4,0,1,0,2
Carlton,"Cripps, Patrick",25,7,4,18,0,0,0,10
Carlton,"Curnow, Ed",28,17,3,11,0,1,0,9
Carlton,"De Koning, Tom",14,9,5,5,1,0,12,1
Carlton,"Docherty, Sam",26,16,6,10,0,0,0,5
Carlton,"Fogarty, Lachie",12,7,5,5,0,0,0,8
Carlton,"Gibbons, Michael",17,11,6,6,1,0,0,1
Carlton,"Honey, Josh",0,0,0,0,0,0,0,0
Carlton,"Jones, Liam",12,11,5,1,0,0,0,1
Carlton,"McKay, Harry",6,5,4,1,2,0,0,0
Carlton,"Murphy, Marc",18,11,2,7,1,0,0,3
Carlton,"Newman, Nic",21,12,5,9,0,0,0,5
Carlton,"Owies, Matthew",9,6,6,3,2,0,0,2
Carlton,"Pittonet, Marc",13,3,4,10,1,0,30,0
Carlton,"Plowman, Lachie",11,5,2,6,0,0,0,2
Carlton,"Saad, Adam",26,20,8,6,0,1,0,1
Carlton,"Setterfield, Will",21,13,8,8,0,2,0,3
Carlton,"Silvagni, Jack",10,8,5,2,1,0,0,3
Carlton,"Stocker, Liam",16,11,6,5,0,1,0,0
Carlton,"Walsh, Sam",30,13,4,17,1,0,0,6
Carlton,"Weitering, Jacob",14,12,6,2,0,0,0,0
Carlton,"Williams, Zac",26,20,4,6,1,0,0,2
Carlton,"Betts, Eddie",9,7,1,2,2,1,0,3
Carlton,"Casboult, Levi",6,4,3,2,0,0,0,1
Carlton,"Cottrell, Matthew",10,10,2,0,0,0,0,3
Carlton,"Cripps, Patrick",27,15,3,12,3,0,0,6
Carlton,"Curnow, Ed",17,12,3,5,0,0,0,5
Carlton,"De Koning, Tom",7,6,0,1,1,1,13,1
Carlton,"Docherty, Sam",21,15,8,6,0,0,0,0
Carlton,"Fogarty, Lachie",14,5,2,9,0,0,0,1
Carlton,"Gibbons, Michael",6,3,1,3,0,0,0,2
Carlton,"Jones, Liam",6,5,3,1,0,0,0,2
Carlton,"Martin, Jack",12,7,4,5,0,0,0,3
Carlton,"McKay, Harry",11,10,8,1,3,5,0,2
Carlton,"Murphy, Marc",5,4,0,1,0,0,0,0
Carlton,"Newman, Nic",18,13,5,5,0,0,0,4
Carlton,"Owies, Matthew",9,5,3,4,0,1,0,5
Carlton,"Pittonet, Marc",6,2,1,4,0,0,31,1
Carlton,"Saad, Adam",15,10,3,5,0,0,0,4
Carlton,"Setterfield, Will",16,12,4,4,0,0,0,2
Carlton,"Silvagni, Jack",15,10,5,5,1,1,0,3
Carlton,"Stocker, Liam",11,5,2,6,0,0,0,2
Carlton,"Walsh, Sam",33,15,3,18,0,0,0,3
Carlton,"Weitering, Jacob",12,10,6,2,0,0,0,0
Carlton,"Williams, Zac",17,14,2,3,1,0,0,0
Carlton,"Betts, Eddie",12,7,3,5,2,0,0,0
Carlton,"Cottrell, Matthew",13,9,3,4,1,1,0,1
Carlton,"Cripps, Patrick",22,7,6,15,0,1,0,1
Carlton,"Curnow, Ed",10,6,3,4,0,0,0,3
Carlton,"De Koning, Tom",7,5,4,2,2,1,1,0
Carlton,"Docherty, Sam",22,19,9,3,0,0,0,2
Carlton,"Dow, Paddy",19,7,1,12,0,0,0,0
Carlton,"Fisher, Zac",14,9,2,5,0,0,0,2
Carlton,"Jones, Liam",16,13,10,3,0,0,0,1
Carlton,"Martin, Jack",14,8,4,6,0,0,0,4
Carlton,"McKay, Harry",1,1,1,0,0,1,0,0
Carlton,"Murphy, Marc",16,10,5,6,0,0,0,3
Carlton,"Newman, Nic",17,15,6,2,0,0,0,2
Carlton,"Newnes, Jack",14,10,7,4,0,0,0,1
Carlton,"Owies, Matthew",8,6,5,2,2,1,0,4
Carlton,"Pittonet, Marc",12,5,4,7,0,2,13,6
Carlton,"Saad, Adam",22,14,7,8,0,1,0,0
Carlton,"Setterfield, Will",17,13,9,4,1,1,0,3
Carlton,"Silvagni, Jack",15,12,5,3,0,2,0,2
Carlton,"Stocker, Liam",16,9,6,7,0,0,0,1
Carlton,"Walsh, Sam",30,18,11,12,1,0,0,4
Carlton,"Weitering, Jacob",16,13,10,3,0,0,0,2
Carlton,"Williams, Zac",24,22,6,2,1,0,0,1
Carlton,"Betts, Eddie",6,5,3,1,0,1,0,1
Carlton,"Cripps, Patrick",24,9,4,15,0,1,0,5
Carlton,"Curnow, Ed",13,8,5,5,0,0,0,3
Carlton,"De Koning, Tom",8,7,3,1,1,0,10,0
Carlton,"Docherty, Sam",21,15,8,6,0,0,0,2
Carlton,"Dow, Paddy",13,3,0,10,0,0,0,5
Carlton,"Fisher, Zac",16,7,3,9,1,0,0,1
Carlton,"Fogarty, Lachie",9,5,1,4,1,0,0,4
Carlton,"Jones, Liam",16,13,4,3,0,0,0,0
Carlton,"Kennedy, Matthew",27,16,8,11,0,0,0,4
Carlton,"Martin, Jack",11,5,1,6,0,0,0,2
Carlton,"McKay, Harry",13,11,8,2,3,2,0,0
Carlton,"Newman, Nic",14,9,4,5,0,1,0,0
Carlton,"Newnes, Jack",2,2,1,0,0,0,0,0
Carlton,"Owies, Matthew",10,9,4,1,2,2,0,1
Carlton,"Parks, Luke",3,2,1,1,0,0,0,0
Carlton,"Pittonet, Marc",12,6,5,6,1,0,27,3
Carlton,"Saad, Adam",19,17,3,2,0,1,0,1
Carlton,"Silvagni, Jack",10,4,2,6,0,2,0,4
Carlton,"Stocker, Liam",18,13,6,5,0,0,0,1
Carlton,"Walsh, Sam",20,6,1,14,0,0,0,2
Carlton,"Weitering, Jacob",14,12,10,2,0,0,0,1
Carlton,"Williams, Zac",11,9,4,2,0,0,0,1
Carlton,"Betts, Eddie",9,9,2,0,3,0,0,0
Carlton,"Cripps, Patrick",20,6,1,14,1,0,0,4
Carlton,"Curnow, Ed",22,12,5,10,0,0,0,1
Carlton,"De Koning, Tom",6,4,1,2,0,0,27,3
Carlton,"Docherty, Sam",16,13,9,3,0,0,0,1
Carlton,"Dow, Paddy",20,9,4,11,1,0,0,3
Carlton,"Fogarty, Lachie",14,7,5,7,0,2,0,1
Carlton,"Jones, Liam",11,10,8,1,0,0,0,1
Carlton,"Kennedy, Matthew",24,12,7,12,0,0,0,3
Carlton,"Martin, Jack",13,10,6,3,2,2,0,0
Carlton,"McKay, Harry",8,8,6,0,2,2,0,0
Carlton,"Murphy, Marc",2,1,0,1,0,0,0,0
Carlton,"Newman, Nic",21,15,11,6,0,0,0,5
Carlton,"Newnes, Jack",16,11,5,5,0,0,0,4
Carlton,"Owies, Matthew",17,9,8,8,1,3,0,1
Carlton,"Petrevski-Seton, Sam",14,8,3,6,0,1,0,5
Carlton,"Plowman, Lachie",17,14,7,3,0,0,0,1
Carlton,"Saad, Adam",19,13,1,6,1,0,0,2
Carlton,"Silvagni, Jack",8,3,5,5,0,1,1,3
Carlton,"Stocker, Liam",17,11,7,6,0,0,0,1
Carlton,"Walsh, Sam",38,19,7,19,0,0,0,4
Carlton,"Weitering, Jacob",22,18,16,4,0,0,2,0
Carlton,"Williams, Zac",26,22,4,4,1,0,0,2
Carlton,"Betts, Eddie",11,10,3,1,2,0,0,4
Carlton,"Casboult, Levi",8,5,4,3,0,0,9,1
Carlton,"Cottrell, Matthew",0,0,0,0,0,0,0,0
Carlton,"Cripps, Patrick",23,5,6,18,0,0,0,2
Carlton,"Curnow, Ed",19,12,3,7,0,0,0,2
Carlton,"De Koning, Tom",6,4,1,2,1,0,20,5
Carlton,"Dow, Paddy",22,9,1,13,1,0,0,2
Carlton,"Fogarty, Lachie",14,7,5,7,0,0,0,1
Carlton,"Jones, Liam",13,10,8,3,0,0,0,2
Carlton,"Kennedy, Matthew",22,13,4,9,1,0,0,6
Carlton,"Martin, Jack",12,11,6,1,0,2,0,0
Carlton,"McKay, Harry",8,6,4,2,3,1,0,1
Carlton,"Newman, Nic",24,23,11,1,0,0,0,4
Carlton,"Newnes, Jack",14,7,2,7,0,0,0,3
Carlton,"Owies, Matthew",9,3,2,6,1,1,0,1
Carlton,"Petrevski-Seton, Sam",15,11,4,4,0,0,0,0
Carlton,"Plowman, Lachie",9,7,5,2,0,0,0,0
Carlton,"Saad, Adam",19,14,4,5,0,1,0,2
Carlton,"Silvagni, Jack",19,13,9,6,2,1,0,0
Carlton,"Stocker, Liam",13,9,2,4,0,0,0,5
Carlton,"Walsh, Sam",25,15,8,10,1,0,0,8
Carlton,"Weitering, Jacob",20,18,10,2,0,0,0,0
Carlton,"Williamson, Tom",10,8,2,2,0,1,0,2
Carlton,"Betts, Eddie",8,4,1,4,0,0,0,3
Carlton,"Cottrell, Matthew",0,0,0,0,0,0,0,0
Carlton,"Cripps, Patrick",19,4,2,15,0,1,1,1
Carlton,"Curnow, Ed",22,13,8,9,0,1,0,2
Carlton,"De Koning, Tom",15,10,6,5,0,0,14,4
Carlton,"Dow, Paddy",17,8,2,9,0,0,0,3
Carlton,"Fogarty, Lachie",7,3,0,4,0,0,0,7
Carlton,"Kennedy, Matthew",18,8,5,10,0,1,0,5
Carlton,"Martin, Jack",10,8,5,2,0,0,0,1
Carlton,"McKay, Harry",11,9,4,2,2,3,0,3
Carlton,"Newman, Nic",21,10,4,11,0,0,0,3
Carlton,"Newnes, Jack",24,13,4,11,0,1,0,5
Carlton,"Owies, Matthew",10,6,4,4,0,2,0,4
Carlton,"Petrevski-Seton, Sam",17,11,4,6,1,1,0,2
Carlton,"Plowman, Lachie",11,8,4,3,0,0,0,0
Carlton,"Saad, Adam",25,17,2,8,0,0,0,2
Carlton,"Setterfield, Will",10,5,1,5,0,0,0,1
Carlton,"Silvagni, Jack",17,11,6,6,0,0,3,1
Carlton,"Stocker, Liam",13,11,3,2,0,0,0,1
Carlton,"Walsh, Sam",36,14,8,22,2,1,0,2
Carlton,"Weitering, Jacob",14,10,7,4,0,0,0,2
Carlton,"Williams, Zac",22,17,5,5,0,0,0,1
Carlton,"Williamson, Tom",15,7,4,8,0,0,0,0
Carlton,"Betts, Eddie",12,8,3,4,2,2,0,4
Carlton,"Cottrell, Matthew",18,13,5,5,0,0,0,1
Carlton,"Curnow, Ed",21,16,7,5,0,0,0,0
Carlton,"De Koning, Tom",8,5,2,3,1,0,20,4
Carlton,"Dow, Paddy",17,4,3,13,0,0,0,0
Carlton,"Fisher, Zac",19,11,2,8,0,2,0,3
Carlton,"Fogarty, Lachie",0,0,0,0,0,0,0,0
Carlton,"Jones, Liam",9,6,6,3,0,0,0,0
Carlton,"Kennedy, Matthew",26,16,7,10,1,0,0,7
Carlton,"Martin, Jack",18,12,11,6,1,1,0,5
Carlton,"McKay, Harry",10,8,6,2,4,0,1,0
Carlton,"Newman, Nic",16,10,5,6,0,0,0,1
Carlton,"Newnes, Jack",11,8,4,3,0,0,0,0
Carlton,"Owies, Matthew",9,6,1,3,0,2,0,2
Carlton,"Petrevski-Seton, Sam",14,7,3,7,0,1,0,4
Carlton,"Plowman, Lachie",7,5,4,2,0,0,0,1
Carlton,"Saad, Adam",17,9,4,8,0,0,0,1
Carlton,"Silvagni, Jack",15,10,7,5,1,0,3,0
Carlton,"Stocker, Liam",17,12,4,5,1,0,0,1
Carlton,"Walsh, Sam",39,23,9,16,1,1,0,5
Carlton,"Weitering, Jacob",18,18,12,0,0,0,0,2
Carlton,"Williams, Zac",16,14,6,2,1,0,0,0
Carlton,"Williamson, Tom",13,9,4,4,0,1,0,1
Carlton,"Betts, Eddie",2,1,0,1,0,0,0,1
Carlton,"Cottrell, Matthew",10,7,1,3,0,0,0,4
Carlton,"Cripps, Patrick",21,11,4,10,3,1,0,2
Carlton,"Curnow, Ed",20,12,6,8,1,0,0,2
Carlton,"De Koning, Tom",17,10,6,7,0,0,22,1
Carlton,"Dow, Paddy",24,11,4,13,0,0,0,3
Carlton,"Fisher, Zac",13,8,3,5,1,3,0,0
Carlton,"Jones, Liam",10,7,4,3,0,0,0,1
Carlton,"Kennedy, Matthew",11,5,1,6,2,0,0,0
Carlton,"Martin, Jack",13,7,5,6,1,1,0,2
Carlton,"Murphy, Marc",10,5,1,5,0,1,0,0
Carlton,"Newman, Nic",17,9,4,8,0,0,0,8
Carlton,"Newnes, Jack",21,17,7,4,2,1,0,0
Carlton,"Owies, Matthew",6,4,4,2,1,1,0,1
Carlton,"Petrevski-Seton, Sam",14,9,5,5,0,0,0,5
Carlton,"Plowman, Lachie",13,8,4,5,0,0,0,1
Carlton,"Saad, Adam",21,14,5,7,0,0,0,1
Carlton,"Silvagni, Jack",21,16,9,5,0,1,1,4
Carlton,"Stocker, Liam",8,7,3,1,0,0,0,2
Carlton,"Walsh, Sam",27,12,3,15,0,0,0,3
Carlton,"Weitering, Jacob",18,12,6,6,0,0,0,0
Carlton,"Williams, Zac",13,11,4,2,0,0,0,1
Carlton,"Williamson, Tom",12,9,7,3,0,0,0,2
Carlton,"Cripps, Patrick",26,8,2,18,1,1,0,6
Carlton,"Curnow, Charlie",8,6,0,2,1,0,0,2
Carlton,"Curnow, Ed",17,14,3,3,0,0,0,8
Carlton,"De Koning, Tom",2,0,0,2,0,0,5,1
Carlton,"Dow, Paddy",22,10,5,12,1,0,0,3
Carlton,"Fisher, Zac",18,9,2,9,0,0,0,5
Carlton,"Honey, Josh",13,7,2,6,2,1,0,2
Carlton,"Jones, Liam",11,10,5,1,0,0,0,2
Carlton,"Kennedy, Matthew",23,10,3,13,1,0,0,10
Carlton,"Martin, Jack",14,6,6,8,0,0,0,4
Carlton,"McKay, Harry",11,11,7,0,5,2,1,1
Carlton,"Murphy, Marc",4,3,0,1,1,0,0,0
Carlton,"Newman, Nic",17,15,6,2,0,0,0,5
Carlton,"Newnes, Jack",19,9,3,10,0,0,0,1
Carlton,"OBrien, Lochie",21,11,5,10,0,0,0,2
Carlton,"Owies, Matthew",6,1,0,5,0,0,0,4
Carlton,"Plowman, Lachie",5,5,2,0,0,0,0,2
Carlton,"Saad, Adam",17,13,4,4,0,0,0,0
Carlton,"Silvagni, Jack",25,13,5,12,1,0,5,9
Carlton,"Stocker, Liam",7,4,4,3,0,0,0,2
Carlton,"Walsh, Sam",26,13,3,13,3,0,0,4
Carlton,"Weitering, Jacob",21,17,10,4,0,0,0,0
Carlton,"Williamson, Tom",13,9,4,4,2,0,0,6
Carlton,"Betts, Eddie",5,2,1,3,1,0,0,1
Carlton,"Cripps, Patrick",22,6,3,16,0,0,1,3
Carlton,"Curnow, Charlie",12,11,5,1,1,2,0,3
Carlton,"Curnow, Ed",25,18,8,7,1,0,0,1
Carlton,"De Koning, Tom",8,4,3,4,0,1,20,1
Carlton,"Dow, Paddy",8,1,1,7,0,0,0,5
Carlton,"Fisher, Zac",12,5,1,7,0,1,0,0
Carlton,"Honey, Josh",9,8,7,1,2,1,0,2
Carlton,"Jones, Liam",11,9,4,2,0,0,0,3
Carlton,"Kennedy, Matthew",23,14,5,9,0,0,0,5
Carlton,"Martin, Jack",11,10,6,1,1,0,0,3
Carlton,"McKay, Harry",13,12,8,1,1,0,3,2
Carlton,"Murphy, Marc",0,0,0,0,0,0,0,0
Carlton,"Newman, Nic",25,20,8,5,0,0,0,5
Carlton,"Newnes, Jack",17,12,5,5,0,0,0,4
Carlton,"OBrien, Lochie",14,7,4,7,0,0,0,3
Carlton,"Plowman, Lachie",10,9,5,1,0,0,0,0
Carlton,"Saad, Adam",14,9,3,5,0,0,0,2
Carlton,"Silvagni, Jack",9,7,3,2,1,1,4,3
Carlton,"Stocker, Liam",14,11,1,3,0,0,0,6
Carlton,"Walsh, Sam",23,16,5,7,0,0,0,8
Carlton,"Weitering, Jacob",16,14,6,2,0,0,0,0
Carlton,"Williamson, Tom",12,7,6,5,0,0,0,1
Carlton,"Betts, Eddie",9,4,2,5,0,0,0,0
Carlton,"Casboult, Levi",12,9,6,3,1,1,6,4
Carlton,"Curnow, Charlie",14,9,5,5,0,2,0,1
Carlton,"Curnow, Ed",22,11,5,11,0,0,0,2
Carlton,"De Koning, Tom",15,10,5,5,0,1,23,1
Carlton,"Dow, Paddy",18,7,3,11,0,0,0,2
Carlton,"Durdin, Corey",5,1,1,4,0,0,0,3
Carlton,"Fisher, Zac",17,11,2,6,0,0,0,7
Carlton,"Honey, Josh",9,6,3,3,2,1,0,1
Carlton,"Kemp, Brodie",5,3,2,2,0,0,0,3
Carlton,"Kennedy, Matthew",28,15,8,13,1,1,0,7
Carlton,"McGovern, Mitch",12,8,7,4,1,2,0,3
Carlton,"Murphy, Marc",24,14,4,10,0,0,0,5
Carlton,"Newman, Nic",17,13,4,4,0,0,0,4
Carlton,"Newnes, Jack",17,10,5,7,0,0,0,3
Carlton,"OBrien, Lochie",19,10,6,9,0,1,0,0
Carlton,"Petrevski-Seton, Sam",0,0,0,0,0,0,0,0
Carlton,"Plowman, Lachie",8,6,3,2,0,0,0,2
Carlton,"Saad, Adam",18,17,1,1,0,0,0,1
Carlton,"Stocker, Liam",16,12,4,4,0,0,0,3
Carlton,"Walsh, Sam",30,10,5,20,0,0,0,6
Carlton,"Weitering, Jacob",10,9,2,1,0,0,0,1
Carlton,"Williamson, Tom",11,8,5,3,0,0,0,1
Carlton,"Betts, Eddie",9,4,2,5,2,0,0,1
Carlton,"Casboult, Levi",8,4,4,4,2,0,10,1
Carlton,"Cripps, Patrick",17,0,1,17,0,0,0,1
Carlton,"Curnow, Charlie",15,9,6,6,0,1,0,0
Carlton,"Curnow, Ed",25,16,8,9,4,0,0,2
Carlton,"De Koning, Tom",10,7,4,3,0,0,32,5
Carlton,"Dow, Paddy",6,1,1,5,0,1,0,0
Carlton,"Durdin, Corey",3,3,1,0,1,0,0,1
Carlton,"Fisher, Zac",14,7,1,7,1,0,0,5
Carlton,"Fogarty, Lachie",20,12,7,8,0,0,0,4
Carlton,"Honey, Josh",5,3,1,2,0,0,0,1
Carlton,"Kemp, Brodie",14,11,6,3,0,0,0,0
Carlton,"Kennedy, Matthew",21,16,7,5,0,0,0,5
Carlton,"McGovern, Mitch",13,12,5,1,1,0,0,2
Carlton,"Newman, Nic",27,21,9,6,0,0,0,3
Carlton,"Newnes, Jack",10,6,2,4,0,0,0,1
Carlton,"OBrien, Lochie",17,14,4,3,0,2,0,0
Carlton,"Plowman, Lachie",11,6,3,5,0,0,0,1
Carlton,"Saad, Adam",19,15,5,4,0,1,0,1
Carlton,"Stocker, Liam",23,18,4,5,0,0,0,1
Carlton,"Walsh, Sam",29,9,8,20,0,1,0,3
Carlton,"Weitering, Jacob",14,13,8,1,0,0,0,2
Carlton,"Williamson, Tom",12,10,2,2,0,0,0,2
Collingwood,"Adams, Taylor",20,8,2,12,0,0,0,4
Collingwood,"Brown, Callum",0,0,0,0,0,0,0,0
Collingwood,"Brown, Tyler",13,6,5,7,0,0,0,2
Collingwood,"Cox, Mason",15,11,6,4,2,1,7,0
Collingwood,"Crisp, Jack",23,17,7,6,1,0,0,2
Collingwood,"Daicos, Josh",9,2,1,7,0,0,0,1
Collingwood,"Elliott, Jamie",12,7,3,5,2,0,0,2
Collingwood,"Grundy, Brodie",11,8,3,3,0,0,39,3
Collingwood,"Henry, Oliver",4,4,1,0,0,0,0,0
Collingwood,"Hoskin-Elliott, Will",12,4,2,8,0,0,0,4
Collingwood,"Howe, Jeremy",13,11,6,2,0,0,0,3
Collingwood,"Madgen, Jack",19,8,7,11,0,0,0,3
Collingwood,"Maynard, Brayden",21,18,4,3,0,0,0,4
Collingwood,"Mihocek, Brody",11,7,6,4,2,2,0,2
Collingwood,"Moore, Darcy",18,14,12,4,0,0,0,1
Collingwood,"Noble, John",22,18,5,4,0,0,0,2
Collingwood,"Pendlebury, Scott",25,15,4,10,0,1,0,5
Collingwood,"Quaynor, Isaac",12,9,4,3,0,0,0,3
Collingwood,"Roughead, Jordan",14,9,6,5,0,0,0,1
Collingwood,"Ruscoe, Trey",3,2,2,1,0,0,0,2
Collingwood,"Sier, Brayden",9,1,0,8,0,0,0,4
Collingwood,"Thomas, Josh",13,8,4,5,0,3,0,0
Collingwood,"de Goey, Jordan",16,10,1,6,0,3,0,4
Collingwood,"Adams, Taylor",29,18,3,11,1,0,0,7
Collingwood,"Brown, Callum",11,7,6,4,0,1,0,3
Collingwood,"Brown, Tyler",16,5,4,11,0,0,0,0
Collingwood,"Cox, Mason",10,6,3,4,2,3,4,3
Collingwood,"Crisp, Jack",36,24,7,12,0,0,0,3
Collingwood,"Daicos, Josh",16,10,2,6,1,0,0,5
Collingwood,"Elliott, Jamie",5,4,4,1,2,0,0,1
Collingwood,"Grundy, Brodie",16,7,3,9,0,0,51,6
Collingwood,"Hoskin-Elliott, Will",12,11,7,1,1,0,0,3
Collingwood,"Howe, Jeremy",22,15,6,7,0,0,0,3
Collingwood,"Madgen, Jack",16,11,5,5,0,0,0,0
Collingwood,"Maynard, Brayden",13,10,2,3,0,0,0,3
Collingwood,"Mihocek, Brody",9,8,6,1,3,0,0,1
Collingwood,"Moore, Darcy",22,14,6,8,0,0,0,2
Collingwood,"Noble, John",23,13,5,10,0,0,0,2
Collingwood,"Pendlebury, Scott",30,16,5,14,0,1,0,5
Collingwood,"Quaynor, Isaac",16,12,3,4,0,0,0,4
Collingwood,"Roughead, Jordan",8,5,4,3,0,0,0,4
Collingwood,"Ruscoe, Trey",2,1,1,1,1,0,0,1
Collingwood,"Sidebottom, Steele",20,14,5,6,1,0,0,2
Collingwood,"Sier, Brayden",16,4,1,12,0,0,0,3
Collingwood,"Thomas, Josh",7,5,3,2,0,0,0,3
Collingwood,"de Goey, Jordan",16,11,6,5,4,3,0,1
Collingwood,"Adams, Taylor",25,16,2,9,0,0,0,3
Collingwood,"Brown, Callum",12,7,5,5,0,1,0,6
Collingwood,"Brown, Tyler",16,9,2,7,0,0,0,1
Collingwood,"Cox, Mason",12,9,4,3,2,1,9,1
Collingwood,"Crisp, Jack",21,14,4,7,0,0,0,1
Collingwood,"Daicos, Josh",15,9,2,6,2,2,0,2
Collingwood,"Grundy, Brodie",28,11,5,17,0,1,54,6
Collingwood,"Hoskin-Elliott, Will",6,4,2,2,0,0,0,1
Collingwood,"Howe, Jeremy",22,17,8,5,1,0,0,7
Collingwood,"Madgen, Jack",12,7,4,5,0,0,0,0
Collingwood,"Maynard, Brayden",15,12,5,3,0,0,0,4
Collingwood,"Mayne, Chris",15,6,3,9,0,0,0,4
Collingwood,"McCreery, Beau",0,0,0,0,0,0,0,0
Collingwood,"Mihocek, Brody",13,11,6,2,2,0,0,2
Collingwood,"Moore, Darcy",14,11,7,3,0,0,0,2
Collingwood,"Noble, John",20,16,5,4,0,0,0,2
Collingwood,"Pendlebury, Scott",30,13,8,17,0,0,0,4
Collingwood,"Quaynor, Isaac",24,14,9,10,0,0,0,2
Collingwood,"Roughead, Jordan",20,17,17,3,0,0,0,2
Collingwood,"Sidebottom, Steele",28,13,4,15,1,0,0,1
Collingwood,"Sier, Brayden",20,9,2,11,1,0,0,2
Collingwood,"Thomas, Josh",12,5,0,7,1,0,0,3
Collingwood,"de Goey, Jordan",18,12,4,6,1,0,0,0
Collingwood,"Adams, Taylor",12,8,3,4,0,1,0,6
Collingwood,"Brown, Callum",13,5,2,8,0,1,0,4
Collingwood,"Cox, Mason",10,5,2,5,0,0,2,0
Collingwood,"Crisp, Jack",30,19,6,11,0,1,0,1
Collingwood,"Daicos, Josh",19,14,3,5,1,0,0,2
Collingwood,"Greenwood, Levi",6,3,1,3,0,0,0,2
Collingwood,"Grundy, Brodie",20,9,2,11,0,0,42,2
Collingwood,"Hoskin-Elliott, Will",14,10,5,4,2,0,0,2
Collingwood,"Howe, Jeremy",20,15,6,5,0,0,0,0
Collingwood,"Madgen, Jack",25,15,3,10,1,1,0,2
Collingwood,"Maynard, Brayden",18,13,4,5,0,0,0,1
Collingwood,"Mayne, Chris",20,11,9,9,0,0,0,4
Collingwood,"McCreery, Beau",7,5,2,2,1,0,0,8
Collingwood,"Mihocek, Brody",7,5,3,2,1,2,0,2
Collingwood,"Moore, Darcy",14,8,7,6,0,0,0,0
Collingwood,"Noble, John",15,8,7,7,0,0,0,3
Collingwood,"Pendlebury, Scott",20,9,2,11,0,0,0,7
Collingwood,"Quaynor, Isaac",14,8,3,6,0,0,0,0
Collingwood,"Roughead, Jordan",14,8,4,6,0,0,0,2
Collingwood,"Sidebottom, Steele",30,21,8,9,0,0,0,2
Collingwood,"Sier, Brayden",6,2,0,4,0,0,0,3
Collingwood,"Thomas, Josh",10,5,0,5,1,0,0,6
Collingwood,"de Goey, Jordan",9,6,1,3,2,0,0,2
Collingwood,"Brown, Callum",11,3,1,8,1,0,0,0
Collingwood,"Cameron, Darcy",10,9,4,1,1,0,4,1
Collingwood,"Crisp, Jack",32,21,7,11,0,0,0,5
Collingwood,"Daicos, Josh",12,10,3,2,0,1,0,2
Collingwood,"Greenwood, Levi",19,13,2,6,0,0,0,5
Collingwood,"Grundy, Brodie",20,11,3,9,2,0,25,7
Collingwood,"Howe, Jeremy",2,2,1,0,0,0,0,1
Collingwood,"Keane, Mark",9,6,4,3,0,0,0,0
Collingwood,"Macrae, Finlay",18,9,4,9,0,0,0,0
Collingwood,"Madgen, Jack",19,6,6,13,0,0,0,0
Collingwood,"Maynard, Brayden",27,15,4,12,0,0,0,0
Collingwood,"Mayne, Chris",19,10,4,9,0,0,0,1
Collingwood,"McCreery, Beau",11,7,4,4,2,0,0,3
Collingwood,"Mihocek, Brody",11,10,4,1,2,5,0,2
Collingwood,"Moore, Darcy",9,9,8,0,3,0,0,1
Collingwood,"Noble, John",14,7,5,7,0,0,0,1
Collingwood,"Pendlebury, Scott",24,11,4,13,0,1,0,2
Collingwood,"Quaynor, Isaac",16,8,1,8,0,0,0,0
Collingwood,"Roughead, Jordan",7,5,3,2,0,0,0,1
Collingwood,"Sidebottom, Steele",22,10,3,12,0,1,0,3
Collingwood,"Sier, Brayden",10,4,3,6,0,0,0,0
Collingwood,"Thomas, Josh",15,7,3,8,0,0,0,1
Collingwood,"de Goey, Jordan",2,1,0,1,0,0,0,0
Collingwood,"Brown, Callum",14,4,4,10,1,0,0,2
Collingwood,"Brown, Tyler",0,0,0,0,0,0,0,0
Collingwood,"Cameron, Darcy",22,15,10,7,3,1,9,1
Collingwood,"Crisp, Jack",30,14,5,16,1,0,0,3
Collingwood,"Daicos, Josh",26,9,2,17,0,0,0,3
Collingwood,"Grundy, Brodie",19,12,1,7,1,1,40,7
Collingwood,"Hoskin-Elliott, Will",18,14,9,4,1,1,0,3
Collingwood,"Kelly, Will",6,4,2,2,0,0,0,0
Collingwood,"Macrae, Finlay",9,1,1,8,0,0,0,1
Collingwood,"Madgen, Jack",16,7,1,9,0,0,0,1
Collingwood,"Maynard, Brayden",18,12,3,6,0,0,0,4
Collingwood,"McCreery, Beau",6,5,1,1,3,0,0,3
Collingwood,"Mihocek, Brody",6,6,4,0,1,2,0,1
Collingwood,"Moore, Darcy",12,5,4,7,1,0,0,1
Collingwood,"Murphy, Nathan",14,6,5,8,0,0,0,0
Collingwood,"Noble, John",17,9,6,8,0,0,0,6
Collingwood,"Pendlebury, Scott",30,16,3,14,0,0,0,2
Collingwood,"Quaynor, Isaac",21,18,5,3,0,1,0,2
Collingwood,"Rantall, Jay",8,3,2,5,0,0,0,1
Collingwood,"Roughead, Jordan",12,8,6,4,0,0,0,1
Collingwood,"Ruscoe, Trey",4,3,1,1,1,0,0,1
Collingwood,"Sidebottom, Steele",30,18,3,12,0,0,0,12
Collingwood,"Thomas, Josh",18,11,3,7,0,0,0,1
Collingwood,"Brown, Callum",14,6,3,8,0,1,0,3
Collingwood,"Cameron, Darcy",15,11,6,4,0,2,13,2
Collingwood,"Crisp, Jack",17,13,5,4,0,0,0,3
Collingwood,"Daicos, Josh",27,11,4,16,1,1,0,5
Collingwood,"Grundy, Brodie",21,10,3,11,1,0,37,4
Collingwood,"Hoskin-Elliott, Will",17,6,6,11,0,0,0,3
Collingwood,"Keane, Mark",13,9,7,4,0,0,0,0
Collingwood,"Macrae, Finlay",11,4,2,7,0,0,0,1
Collingwood,"Maynard, Brayden",16,11,5,5,0,0,0,1
Collingwood,"Mayne, Chris",17,11,4,6,0,0,0,2
Collingwood,"McCreery, Beau",10,4,1,6,0,1,0,9
Collingwood,"Mihocek, Brody",24,20,12,4,4,2,0,1
Collingwood,"Moore, Darcy",5,4,4,1,0,1,0,0
Collingwood,"Murphy, Nathan",15,10,7,5,0,0,0,0
Collingwood,"Noble, John",20,18,4,2,1,0,0,0
Collingwood,"Pendlebury, Scott",26,15,5,11,0,0,0,4
Collingwood,"Poulter, Caleb",15,7,5,8,0,0,0,1
Collingwood,"Quaynor, Isaac",21,15,4,6,0,1,0,1
Collingwood,"Rantall, Jay",0,0,0,0,0,0,0,0
Collingwood,"Roughead, Jordan",14,10,5,4,0,0,0,1
Collingwood,"Sidebottom, Steele",21,12,6,9,0,1,0,2
Collingwood,"Thomas, Josh",15,6,1,9,0,0,0,7
Collingwood,"de Goey, Jordan",16,8,0,8,0,1,0,1
Collingwood,"Brown, Callum",6,2,2,4,0,0,0,1
Collingwood,"Brown, Tyler",18,7,2,11,0,0,0,3
Collingwood,"Cameron, Darcy",14,10,5,4,3,1,2,1
Collingwood,"Crisp, Jack",31,20,9,11,0,0,0,4
Collingwood,"Daicos, Josh",24,9,1,15,0,1,0,3
Collingwood,"Grundy, Brodie",25,10,5,15,0,1,23,5
Collingwood,"Henry, Oliver",10,5,3,5,0,0,0,0
Collingwood,"Hoskin-Elliott, Will",11,8,5,3,1,0,0,0
Collingwood,"Keane, Mark",21,6,5,15,0,1,0,1
Collingwood,"Maynard, Brayden",32,20,10,12,0,0,0,2
Collingwood,"Mayne, Chris",28,16,7,12,0,0,0,3
Collingwood,"McCreery, Beau",4,2,0,2,0,0,0,6
Collingwood,"Mihocek, Brody",8,6,4,2,2,0,0,2
Collingwood,"Moore, Darcy",28,19,19,9,0,0,0,2
Collingwood,"Murphy, Nathan",13,8,2,5,0,0,0,0
Collingwood,"Noble, John",31,19,4,12,0,0,0,3
Collingwood,"Pendlebury, Scott",21,11,5,10,2,0,0,2
Collingwood,"Poulter, Caleb",18,12,4,6,0,0,0,1
Collingwood,"Quaynor, Isaac",23,16,10,7,0,0,0,1
Collingwood,"Roughead, Jordan",8,2,1,6,0,0,0,0
Collingwood,"Sidebottom, Steele",22,14,2,8,0,0,0,5
Collingwood,"Thomas, Josh",14,6,1,8,0,0,0,3
Collingwood,"de Goey, Jordan",17,12,6,5,6,3,0,1
Collingwood,"Brown, Callum",14,6,3,8,0,1,0,3
Collingwood,"Brown, Tyler",19,6,1,13,0,0,0,2
Collingwood,"Cameron, Darcy",13,7,5,6,1,0,7,3
Collingwood,"Crisp, Jack",24,8,4,16,0,0,0,8
Collingwood,"Daicos, Josh",28,11,1,17,0,0,0,5
Collingwood,"Grundy, Brodie",17,8,2,9,0,0,27,3
Collingwood,"Henry, Oliver",5,3,1,2,0,0,0,1
Collingwood,"Hoskin-Elliott, Will",23,14,10,9,1,0,0,4
Collingwood,"Keane, Mark",13,10,7,3,0,0,0,0
Collingwood,"Madgen, Jack",0,0,0,0,0,0,0,0
Collingwood,"Maynard, Brayden",29,19,4,10,0,0,0,2
Collingwood,"Mayne, Chris",24,11,7,13,0,0,0,4
Collingwood,"McCreery, Beau",9,6,3,3,1,2,0,2
Collingwood,"Mihocek, Brody",6,2,0,4,0,1,0,4
Collingwood,"Moore, Darcy",17,8,3,9,0,0,0,1
Collingwood,"Noble, John",15,7,1,8,0,0,0,4
Collingwood,"Pendlebury, Scott",23,11,2,12,0,1,0,4
Collingwood,"Poulter, Caleb",18,11,2,7,0,1,0,1
Collingwood,"Quaynor, Isaac",12,6,4,6,0,0,0,4
Collingwood,"Sidebottom, Steele",25,13,2,12,0,0,0,6
Collingwood,"Thomas, Josh",13,8,4,5,0,0,0,4
Collingwood,"Wilson, Tom",8,6,0,2,0,0,0,4
Collingwood,"de Goey, Jordan",15,8,3,7,2,2,0,0
Collingwood,"Adams, Taylor",29,16,6,13,0,1,0,3
Collingwood,"Brown, Callum",13,4,0,9,0,1,0,3
Collingwood,"Brown, Tyler",13,2,0,11,0,0,0,3
Collingwood,"Cameron, Darcy",9,5,4,4,1,0,9,1
Collingwood,"Crisp, Jack",26,13,7,13,0,2,0,7
Collingwood,"Daicos, Josh",19,13,4,6,1,0,0,4
Collingwood,"Grundy, Brodie",23,14,5,9,2,1,33,5
Collingwood,"Hoskin-Elliott, Will",21,14,7,7,0,0,0,4
Collingwood,"Maynard, Brayden",20,15,8,5,0,0,0,0
Collingwood,"Mayne, Chris",25,21,13,4,0,0,0,2
Collingwood,"McCreery, Beau",8,6,4,2,3,1,0,2
Collingwood,"Mihocek, Brody",11,8,4,3,0,0,0,0
Collingwood,"Moore, Darcy",25,20,15,5,0,0,0,1
Collingwood,"Murphy, Nathan",0,0,0,0,0,0,0,0
Collingwood,"Noble, John",23,15,6,8,0,0,0,1
Collingwood,"Pendlebury, Scott",18,8,4,10,0,0,0,0
Collingwood,"Poulter, Caleb",22,17,12,5,1,1,0,1
Collingwood,"Quaynor, Isaac",26,14,5,12,0,0,0,0
Collingwood,"Roughead, Jordan",21,16,15,5,0,0,0,4
Collingwood,"Sidebottom, Steele",27,17,9,10,0,0,0,2
Collingwood,"Thomas, Josh",13,7,4,6,0,0,0,4
Collingwood,"Wilson, Tom",17,7,2,10,0,0,0,1
Collingwood,"de Goey, Jordan",9,7,4,2,0,2,0,1
Collingwood,"Bianco, Trent",19,11,3,8,0,1,0,3
Collingwood,"Brown, Callum",9,5,3,4,0,0,0,3
Collingwood,"Cameron, Darcy",19,14,8,5,0,1,9,4
Collingwood,"Crisp, Jack",26,15,6,11,0,1,0,6
Collingwood,"Daicos, Josh",15,7,3,8,0,0,0,2
Collingwood,"Grundy, Brodie",12,5,3,7,1,0,18,3
Collingwood,"Hoskin-Elliott, Will",7,7,5,0,1,1,0,2
Collingwood,"Macrae, Finlay",2,2,2,0,0,0,0,0
Collingwood,"Madgen, Jack",7,3,1,4,0,0,0,0
Collingwood,"Maynard, Brayden",21,15,6,6,1,0,0,1
Collingwood,"Mayne, Chris",32,21,11,11,0,0,0,2
Collingwood,"Mihocek, Brody",9,8,5,1,1,3,0,2
Collingwood,"Moore, Darcy",21,15,8,6,0,0,0,1
Collingwood,"Murphy, Nathan",10,6,5,4,0,1,0,4
Collingwood,"Noble, John",15,6,5,9,0,0,0,5
Collingwood,"Pendlebury, Scott",13,6,5,7,0,0,0,3
Collingwood,"Poulter, Caleb",15,8,5,7,0,0,0,3
Collingwood,"Quaynor, Isaac",28,16,6,12,0,0,0,2
Collingwood,"Roughead, Jordan",14,9,5,5,0,0,1,1
Collingwood,"Sidebottom, Steele",25,16,10,9,0,1,0,2
Collingwood,"Sier, Brayden",21,10,9,11,0,0,0,3
Collingwood,"Wilson, Tom",11,6,4,5,0,0,0,1
Collingwood,"de Goey, Jordan",26,15,11,11,2,0,0,0
Collingwood,"Bianco, Trent",16,11,4,5,1,0,0,4
Collingwood,"Brown, Callum",11,4,2,7,0,0,0,7
Collingwood,"Cameron, Darcy",8,5,3,3,0,0,8,2
Collingwood,"Crisp, Jack",31,21,9,10,0,0,0,3
Collingwood,"Daicos, Josh",18,13,4,5,1,0,0,4
Collingwood,"Elliott, Jamie",14,10,6,4,6,0,0,3
Collingwood,"Hoskin-Elliott, Will",21,16,7,5,0,0,0,4
Collingwood,"Lynch, Max",8,5,1,3,0,0,18,4
Collingwood,"Madgen, Jack",9,8,5,1,0,0,0,2
Collingwood,"Maynard, Brayden",19,15,4,4,0,0,0,3
Collingwood,"Mihocek, Brody",6,4,6,2,0,0,0,4
Collingwood,"Moore, Darcy",18,13,7,5,0,0,0,0
Collingwood,"Murphy, Nathan",9,6,2,3,0,1,0,1
Collingwood,"Noble, John",15,8,3,7,0,0,0,5
Collingwood,"Pendlebury, Scott",21,11,5,10,0,0,0,9
Collingwood,"Poulter, Caleb",20,16,10,4,1,1,0,3
Collingwood,"Quaynor, Isaac",17,13,8,4,0,0,0,5
Collingwood,"Rantall, Jay",8,1,2,7,0,0,0,1
Collingwood,"Roughead, Jordan",13,9,9,4,0,0,3,0
Collingwood,"Sidebottom, Steele",22,14,5,8,1,1,0,3
Collingwood,"Sier, Brayden",4,2,1,2,0,0,0,4
Collingwood,"Thomas, Josh",11,8,3,3,1,1,0,4
Collingwood,"de Goey, Jordan",15,12,9,3,1,1,0,1
Collingwood,"Bianco, Trent",7,5,2,2,0,0,0,2
Collingwood,"Cameron, Darcy",9,8,6,1,4,0,5,5
Collingwood,"Crisp, Jack",21,12,4,9,0,0,0,3
Collingwood,"Daicos, Josh",17,9,3,8,0,0,0,3
Collingwood,"Elliott, Jamie",19,9,5,10,0,1,0,2
Collingwood,"Hoskin-Elliott, Will",21,15,13,6,1,0,0,1
Collingwood,"Lynch, Max",15,4,3,11,0,0,23,1
Collingwood,"Madgen, Jack",19,12,9,7,0,1,0,1
Collingwood,"Maynard, Brayden",32,26,13,6,0,0,0,4
Collingwood,"Mayne, Chris",25,14,8,11,0,0,0,2
Collingwood,"McCreery, Beau",11,6,2,5,1,1,0,5
Collingwood,"Mihocek, Brody",12,10,7,2,3,1,0,1
Collingwood,"Moore, Darcy",18,13,7,5,0,0,0,0
Collingwood,"Murphy, Nathan",3,2,1,1,0,0,0,0
Collingwood,"Noble, John",19,11,5,8,0,0,0,3
Collingwood,"Pendlebury, Scott",31,11,2,20,1,0,0,3
Collingwood,"Poulter, Caleb",16,10,4,6,0,2,0,4
Collingwood,"Quaynor, Isaac",15,9,4,6,0,0,0,3
Collingwood,"Rantall, Jay",5,3,1,2,0,0,0,0
Collingwood,"Roughead, Jordan",11,9,9,2,0,0,5,2
Collingwood,"Sidebottom, Steele",21,12,7,9,1,0,0,1
Collingwood,"Thomas, Josh",16,10,5,6,0,0,0,3
Collingwood,"de Goey, Jordan",32,17,4,15,0,2,0,4
Collingwood,"Adams, Taylor",32,19,4,13,0,0,0,6
Collingwood,"Bianco, Trent",12,7,5,5,2,1,0,0
Collingwood,"Brown, Callum",8,2,2,6,1,0,0,3
Collingwood,"Cameron, Darcy",15,9,7,6,1,0,2,4
Collingwood,"Cox, Mason",6,4,4,2,0,2,0,1
Collingwood,"Crisp, Jack",30,18,9,12,0,0,0,3
Collingwood,"Daicos, Josh",18,8,5,10,0,0,0,2
Collingwood,"Elliott, Jamie",15,8,3,7,1,0,0,1
Collingwood,"Grundy, Brodie",22,8,7,14,2,0,27,3
Collingwood,"Hoskin-Elliott, Will",17,13,3,4,1,0,0,1
Collingwood,"Madgen, Jack",19,11,7,8,0,0,0,0
Collingwood,"Maynard, Brayden",27,22,8,5,0,0,0,6
Collingwood,"Mayne, Chris",25,16,10,9,0,0,0,2
Collingwood,"McCreery, Beau",0,0,0,0,0,0,0,0
Collingwood,"Mihocek, Brody",13,10,7,3,1,4,0,1
Collingwood,"Murphy, Nathan",15,8,8,7,0,0,0,2
Collingwood,"Noble, John",18,11,5,7,0,0,0,2
Collingwood,"Pendlebury, Scott",29,10,2,19,0,0,0,3
Collingwood,"Poulter, Caleb",9,5,2,4,0,0,0,4
Collingwood,"Quaynor, Isaac",13,11,5,2,0,0,0,4
Collingwood,"Roughead, Jordan",19,15,13,4,0,0,0,1
Collingwood,"Sidebottom, Steele",25,13,10,12,1,0,0,2
Collingwood,"Thomas, Josh",14,10,4,4,2,0,0,5
Collingwood,"Adams, Taylor",34,15,1,19,0,0,0,6
Collingwood,"Bianco, Trent",12,6,7,6,0,1,0,4
Collingwood,"Cameron, Darcy",10,6,3,4,0,2,4,0
Collingwood,"Cox, Mason",8,4,6,4,1,0,1,2
Collingwood,"Crisp, Jack",23,17,4,6,0,0,0,7
Collingwood,"Daicos, Josh",20,11,4,9,1,2,0,6
Collingwood,"Elliott, Jamie",15,9,3,6,1,1,0,0
Collingwood,"Grundy, Brodie",19,8,2,11,0,0,33,5
Collingwood,"Hoskin-Elliott, Will",16,11,5,5,1,0,0,3
Collingwood,"Macrae, Finlay",2,1,0,1,0,0,0,0
Collingwood,"Madgen, Jack",13,5,4,8,0,0,0,1
Collingwood,"Maynard, Brayden",11,8,2,3,0,0,0,3
Collingwood,"Mayne, Chris",26,15,8,11,0,0,0,5
Collingwood,"Mihocek, Brody",8,6,6,2,2,1,0,0
Collingwood,"Murphy, Nathan",8,6,3,2,0,0,0,0
Collingwood,"Noble, John",15,10,3,5,0,0,0,4
Collingwood,"Pendlebury, Scott",28,10,4,18,0,0,0,6
Collingwood,"Poulter, Caleb",14,10,2,4,0,0,0,2
Collingwood,"Quaynor, Isaac",18,10,3,8,0,0,0,1
Collingwood,"Roughead, Jordan",14,11,5,3,0,0,0,1
Collingwood,"Sidebottom, Steele",14,6,3,8,0,0,0,1
Collingwood,"Thomas, Josh",17,11,7,6,1,2,0,1
Collingwood,"de Goey, Jordan",32,17,9,15,1,2,0,2
Collingwood,"Adams, Taylor",31,16,2,15,1,0,0,10
Collingwood,"Bianco, Trent",11,6,4,5,0,1,0,1
Collingwood,"Brown, Callum",24,8,6,16,0,0,0,2
Collingwood,"Cameron, Darcy",13,10,7,3,2,0,5,2
Collingwood,"Crisp, Jack",33,17,10,16,0,1,0,1
Collingwood,"Elliott, Jamie",21,13,6,8,3,0,0,5
Collingwood,"Grundy, Brodie",22,12,5,10,1,1,40,5
Collingwood,"Henry, Oliver",8,6,7,2,0,2,0,0
Collingwood,"Hoskin-Elliott, Will",26,15,5,11,0,0,0,0
Collingwood,"Kelly, Will",5,2,2,3,0,0,0,0
Collingwood,"Madgen, Jack",25,12,5,13,0,0,0,0
Collingwood,"Maynard, Brayden",21,16,7,5,0,0,0,2
Collingwood,"Mayne, Chris",24,13,6,11,0,0,0,1
Collingwood,"Mihocek, Brody",15,9,5,6,1,3,0,3
Collingwood,"Murphy, Nathan",9,7,2,2,1,0,0,3
Collingwood,"Noble, John",21,14,8,7,0,0,0,1
Collingwood,"Pendlebury, Scott",24,10,3,14,1,0,0,3
Collingwood,"Quaynor, Isaac",14,9,3,5,0,0,0,4
Collingwood,"Roughead, Jordan",15,10,6,5,0,0,0,4
Collingwood,"Ruscoe, Trey",10,4,2,6,0,0,0,1
Collingwood,"Sidebottom, Steele",20,5,6,15,0,0,0,3
Collingwood,"Thomas, Josh",19,8,5,11,2,0,0,2
Collingwood,"de Goey, Jordan",29,18,10,11,1,0,0,2
Collingwood,"Adams, Taylor",24,10,1,14,0,0,0,8
Collingwood,"Bianco, Trent",16,11,7,5,1,0,0,1
Collingwood,"Brown, Callum",13,3,2,10,0,0,0,4
Collingwood,"Cameron, Darcy",7,5,3,2,1,0,5,1
Collingwood,"Crisp, Jack",17,7,5,10,0,0,0,3
Collingwood,"Elliott, Jamie",19,11,6,8,1,1,0,3
Collingwood,"Grundy, Brodie",16,9,3,7,0,1,26,2
Collingwood,"Henry, Oliver",12,8,7,4,3,1,0,1
Collingwood,"Hoskin-Elliott, Will",10,9,5,1,1,0,0,2
Collingwood,"Madgen, Jack",14,9,6,5,0,0,0,2
Collingwood,"Maynard, Brayden",13,10,2,3,0,0,0,5
Collingwood,"Mayne, Chris",26,18,10,8,0,0,0,3
Collingwood,"Mihocek, Brody",14,11,9,3,1,1,0,3
Collingwood,"Murphy, Nathan",10,7,4,3,0,0,0,3
Collingwood,"Noble, John",25,16,11,9,0,0,0,4
Collingwood,"Pendlebury, Scott",18,11,4,7,0,0,0,5
Collingwood,"Poulter, Caleb",2,1,1,1,0,0,0,1
Collingwood,"Quaynor, Isaac",22,10,7,12,0,0,0,3
Collingwood,"Roughead, Jordan",8,4,2,4,0,0,0,3
Collingwood,"Ruscoe, Trey",23,12,5,11,0,0,0,1
Collingwood,"Sidebottom, Steele",16,13,5,3,1,0,0,2
Collingwood,"Thomas, Josh",0,0,0,0,0,0,0,0
Collingwood,"de Goey, Jordan",31,19,12,12,0,1,0,2
Collingwood,"Adams, Taylor",24,11,2,13,0,0,0,8
Collingwood,"Bianco, Trent",12,11,5,1,1,0,0,3
Collingwood,"Cameron, Darcy",9,5,4,4,1,0,4,1
Collingwood,"Cox, Mason",5,2,1,3,1,1,0,0
Collingwood,"Crisp, Jack",30,17,13,13,0,0,0,6
Collingwood,"Elliott, Jamie",11,6,2,5,1,1,0,2
Collingwood,"Ginnivan, Jack",7,6,3,1,0,0,0,1
Collingwood,"Grundy, Brodie",27,16,3,11,0,0,23,2
Collingwood,"Henry, Oliver",15,9,7,6,2,3,0,1
Collingwood,"Macrae, Finlay",21,9,5,12,0,0,0,1
Collingwood,"Madgen, Jack",24,10,3,14,0,0,0,2
Collingwood,"Maynard, Brayden",26,15,1,11,0,0,0,1
Collingwood,"Mihocek, Brody",11,10,8,1,3,3,0,2
Collingwood,"Murphy, Nathan",12,6,4,6,0,0,0,2
Collingwood,"Noble, John",17,13,5,4,0,0,0,3
Collingwood,"Pendlebury, Scott",6,3,0,3,0,0,0,2
Collingwood,"Poulter, Caleb",16,10,8,6,0,0,0,1
Collingwood,"Quaynor, Isaac",12,6,4,6,0,0,0,2
Collingwood,"Roughead, Jordan",14,5,2,9,0,0,0,3
Collingwood,"Ruscoe, Trey",20,17,2,3,0,0,0,3
Collingwood,"Sidebottom, Steele",26,12,5,14,0,0,0,3
Collingwood,"Tohill, Anton",9,4,3,5,0,0,0,0
Collingwood,"de Goey, Jordan",25,11,4,14,1,0,0,4
Collingwood,"Adams, Taylor",34,13,6,21,0,0,0,3
Collingwood,"Bianco, Trent",15,12,9,3,2,1,0,1
Collingwood,"Cameron, Darcy",9,6,5,3,1,0,5,0
Collingwood,"Crisp, Jack",36,18,9,18,0,0,0,2
Collingwood,"Elliott, Jamie",14,11,7,3,2,2,0,5
Collingwood,"Ginnivan, Jack",10,8,5,2,1,0,0,0
Collingwood,"Grundy, Brodie",22,11,10,11,1,0,18,6
Collingwood,"Henry, Oliver",11,6,5,5,0,1,0,1
Collingwood,"Hoskin-Elliott, Will",23,17,12,6,1,0,0,1
Collingwood,"Howe, Jeremy",24,15,10,9,0,0,0,0
Collingwood,"Macrae, Finlay",15,6,4,9,0,0,0,2
Collingwood,"Madgen, Jack",18,9,3,9,0,0,0,2
Collingwood,"Maynard, Brayden",30,25,11,5,0,0,0,0
Collingwood,"Mayne, Chris",26,13,10,13,0,0,0,1
Collingwood,"Mihocek, Brody",15,12,11,3,2,0,0,0
Collingwood,"Murphy, Nathan",0,0,0,0,0,0,0,0
Collingwood,"Noble, John",22,14,10,8,1,0,0,2
Collingwood,"Quaynor, Isaac",19,8,3,11,1,0,0,3
Collingwood,"Roughead, Jordan",15,10,7,5,0,0,0,1
Collingwood,"Ruscoe, Trey",22,19,9,3,0,0,0,3
Collingwood,"Sidebottom, Steele",33,13,7,20,1,0,0,2
Collingwood,"Thomas, Josh",14,11,6,3,1,1,0,0
Collingwood,"de Goey, Jordan",34,23,7,11,0,0,0,4
Collingwood,"Adams, Taylor",30,18,6,12,0,0,0,4
Collingwood,"Bianco, Trent",0,0,0,0,0,0,0,0
Collingwood,"Cameron, Darcy",11,8,5,3,1,1,10,1
Collingwood,"Crisp, Jack",28,13,7,15,0,0,0,3
Collingwood,"Elliott, Jamie",14,10,4,4,2,1,0,0
Collingwood,"Ginnivan, Jack",7,6,3,1,3,0,0,1
Collingwood,"Grundy, Brodie",16,9,6,7,1,0,31,6
Collingwood,"Henry, Oliver",11,11,7,0,1,0,0,3
Collingwood,"Hoskin-Elliott, Will",16,11,7,5,0,0,0,3
Collingwood,"Howe, Jeremy",16,11,5,5,0,0,0,3
Collingwood,"Macrae, Finlay",20,8,4,12,1,0,0,2
Collingwood,"Madgen, Jack",15,7,4,8,0,0,0,1
Collingwood,"Maynard, Brayden",21,16,9,5,0,0,0,5
Collingwood,"Mayne, Chris",26,9,7,17,0,0,0,3
Collingwood,"McCreery, Beau",10,6,5,4,0,1,0,1
Collingwood,"Mihocek, Brody",8,7,6,1,2,0,0,1
Collingwood,"Noble, John",18,12,4,6,0,0,0,2
Collingwood,"Quaynor, Isaac",18,9,4,9,0,0,0,1
Collingwood,"Roughead, Jordan",10,8,4,2,0,0,0,3
Collingwood,"Ruscoe, Trey",12,9,3,3,0,0,0,2
Collingwood,"Sidebottom, Steele",22,10,2,12,1,0,0,6
Collingwood,"Thomas, Josh",18,8,5,10,0,1,0,0
Collingwood,"de Goey, Jordan",28,14,6,14,0,0,0,2
Collingwood,"Adams, Taylor",27,8,2,19,0,0,0,4
Collingwood,"Bianco, Trent",10,9,2,1,0,0,0,2
Collingwood,"Cameron, Darcy",12,5,5,7,1,0,16,3
Collingwood,"Crisp, Jack",30,14,7,16,0,0,0,4
Collingwood,"Daicos, Josh",22,16,3,6,0,0,0,0
Collingwood,"Elliott, Jamie",23,14,4,9,0,0,0,4
Collingwood,"Ginnivan, Jack",9,8,2,1,2,1,0,1
Collingwood,"Grundy, Brodie",15,4,0,11,0,0,37,1
Collingwood,"Henry, Oliver",10,6,4,4,1,0,0,1
Collingwood,"Hoskin-Elliott, Will",14,10,4,4,0,0,0,3
Collingwood,"Macrae, Finlay",16,5,4,11,0,0,0,2
Collingwood,"Madgen, Jack",17,9,7,8,0,0,0,1
Collingwood,"Maynard, Brayden",18,13,7,5,0,0,0,4
Collingwood,"Mayne, Chris",23,14,6,9,0,0,0,2
Collingwood,"McCreery, Beau",6,5,2,1,0,0,0,4
Collingwood,"Mihocek, Brody",11,8,4,3,1,4,0,1
Collingwood,"Murphy, Nathan",12,7,3,5,0,0,0,1
Collingwood,"Noble, John",6,4,1,2,0,0,0,1
Collingwood,"Roughead, Jordan",15,11,7,4,0,0,0,0
Collingwood,"Ruscoe, Trey",10,6,2,4,0,0,0,1
Collingwood,"Sidebottom, Steele",29,14,4,15,0,1,0,1
Collingwood,"Thomas, Josh",11,5,3,6,2,0,0,2
Collingwood,"de Goey, Jordan",27,14,3,13,1,2,0,4
Collingwood,"Adams, Taylor",31,19,6,12,0,0,0,6
Collingwood,"Bianco, Trent",17,11,5,6,0,0,0,0
Collingwood,"Cameron, Darcy",14,9,9,5,1,1,4,0
Collingwood,"Crisp, Jack",19,9,4,10,0,0,0,2
Collingwood,"Daicos, Josh",17,11,3,6,1,2,0,4
Collingwood,"Elliott, Jamie",18,15,8,3,4,1,0,4
Collingwood,"Ginnivan, Jack",12,10,5,2,0,2,0,1
Collingwood,"Grundy, Brodie",11,3,1,8,0,0,23,3
Collingwood,"Henry, Oliver",5,3,2,2,0,1,0,1
Collingwood,"Hoskin-Elliott, Will",9,4,5,5,1,0,0,1
Collingwood,"Howe, Jeremy",20,12,4,8,0,0,0,2
Collingwood,"Madgen, Jack",17,10,8,7,0,0,0,1
Collingwood,"Maynard, Brayden",13,9,2,4,0,0,0,2
Collingwood,"Mayne, Chris",23,6,5,17,0,0,0,3
Collingwood,"McCreery, Beau",0,0,0,0,0,0,0,0
Collingwood,"Murphy, Nathan",14,9,4,5,0,1,0,0
Collingwood,"Noble, John",18,11,6,7,0,0,0,1
Collingwood,"Rantall, Jay",8,3,5,5,0,0,0,1
Collingwood,"Roughead, Jordan",11,9,7,2,0,0,0,0
Collingwood,"Sidebottom, Steele",22,12,8,10,0,0,0,1
Collingwood,"Thomas, Josh",16,9,5,7,1,1,0,2
Collingwood,"Wilson, Tom",12,6,1,6,0,0,0,1
Collingwood,"de Goey, Jordan",23,16,8,7,1,1,0,4
Essendon,"Cahill, Ned",10,6,1,4,0,0,0,2
Essendon,"Caldwell, Jye",22,9,4,13,0,1,0,9
Essendon,"Cox, Nik",9,5,3,4,0,0,0,1
Essendon,"Cutler, Tom",0,0,0,0,0,0,0,0
Essendon,"Draper, Sam",10,5,2,5,1,1,24,5
Essendon,"Francis, Aaron",14,5,3,9,0,0,0,1
Essendon,"Ham, Brayden",17,7,2,10,0,0,0,4
Essendon,"Heppell, Dyson",25,13,6,12,0,0,0,0
Essendon,"Hind, Nick",25,18,6,7,0,0,0,4
Essendon,"Hooker, Cale",8,3,3,5,1,1,1,1
Essendon,"Jones, Harry",13,9,5,4,0,3,0,2
Essendon,"Langford, Kyle",19,10,5,9,0,0,0,3
Essendon,"Laverde, Jayden",12,4,2,8,0,0,0,2
Essendon,"McDonald-Tipungwuti, Anthony",16,9,4,7,2,1,0,1
Essendon,"McGrath, Andrew",33,17,2,16,1,1,0,11
Essendon,"Merrett, Zach",31,18,4,13,1,0,0,3
Essendon,"Parish, Darcy",18,9,4,9,1,1,0,4
Essendon,"Redman, Mason",15,9,4,6,0,1,0,0
Essendon,"Ridley, Jordan",21,16,6,5,0,0,0,3
Essendon,"Shiel, Dylan",17,8,2,9,2,0,0,4
Essendon,"Smith, Devon",12,7,2,5,2,1,0,4
Essendon,"Snelling, Will",14,5,2,9,1,0,0,5
Essendon,"Wright, Peter",16,9,3,7,1,0,6,0
Essendon,"Cahill, Ned",7,2,2,5,0,0,0,0
Essendon,"Caldwell, Jye",10,9,2,1,0,0,0,3
Essendon,"Cox, Nik",13,7,3,6,1,0,0,3
Essendon,"Cutler, Tom",10,8,3,2,0,0,0,2
Essendon,"Draper, Sam",3,2,0,1,0,0,17,3
Essendon,"Francis, Aaron",9,6,5,3,0,0,0,1
Essendon,"Gleeson, Martin",19,9,5,10,0,0,0,2
Essendon,"Ham, Brayden",15,13,4,2,0,1,0,3
Essendon,"Hind, Nick",21,13,5,8,0,0,0,3
Essendon,"Hooker, Cale",8,5,2,3,3,1,0,1
Essendon,"Jones, Harry",4,2,1,2,0,0,2,0
Essendon,"Langford, Kyle",17,8,5,9,1,0,0,1
Essendon,"Laverde, Jayden",11,8,6,3,0,0,0,3
Essendon,"McDonald-Tipungwuti, Anthony",15,10,2,5,3,1,0,3
Essendon,"McGrath, Andrew",24,10,3,14,0,0,0,5
Essendon,"Merrett, Zach",28,13,6,15,0,0,0,4
Essendon,"Parish, Darcy",16,6,1,10,0,0,0,4
Essendon,"Redman, Mason",24,14,8,10,0,0,0,3
Essendon,"Ridley, Jordan",32,23,7,9,0,0,0,0
Essendon,"Shiel, Dylan",18,10,0,8,0,2,0,2
Essendon,"Smith, Devon",13,9,5,4,0,1,0,3
Essendon,"Snelling, Will",11,7,4,4,1,0,0,5
Essendon,"Wright, Peter",13,4,3,9,0,1,7,1
Essendon,"Cox, Nik",17,8,4,9,1,1,1,3
Essendon,"Cutler, Tom",13,11,6,2,0,0,0,1
Essendon,"Francis, Aaron",20,12,10,8,0,0,0,4
Essendon,"Guelfi, Matt",18,9,5,9,0,0,0,2
Essendon,"Ham, Brayden",25,12,9,13,0,0,0,1
Essendon,"Hind, Nick",25,19,9,6,0,0,0,1
Essendon,"Hooker, Cale",13,9,6,4,5,2,0,1
Essendon,"Jones, Harry",9,6,5,3,2,0,0,2
Essendon,"Langford, Kyle",22,11,8,11,0,0,1,1
Essendon,"Laverde, Jayden",16,8,5,8,0,0,0,2
Essendon,"McDonald-Tipungwuti, Anthony",13,9,5,4,3,1,0,3
Essendon,"McGrath, Andrew",23,12,6,11,1,0,0,2
Essendon,"Merrett, Zach",34,18,7,16,0,0,0,4
Essendon,"Parish, Darcy",34,17,9,17,0,0,0,2
Essendon,"Perkins, Archie",14,8,1,6,0,1,0,3
Essendon,"Redman, Mason",10,8,2,2,1,0,0,2
Essendon,"Ridley, Jordan",35,22,10,13,0,0,0,2
Essendon,"Smith, Devon",26,12,8,14,1,1,0,5
Essendon,"Snelling, Will",23,9,6,14,2,1,0,6
Essendon,"Stringer, Jake",12,10,4,2,4,0,0,2
Essendon,"Waterman, Alec",12,9,4,3,2,2,0,2
Essendon,"Wright, Peter",14,8,4,6,0,1,19,2
Essendon,"Zerk-Thatcher, Brandon",15,8,3,7,0,0,1,1
Essendon,"Cox, Nik",18,11,7,7,1,2,4,3
Essendon,"Francis, Aaron",11,6,3,5,0,0,0,2
Essendon,"Guelfi, Matt",12,3,1,9,0,0,0,3
Essendon,"Ham, Brayden",16,6,4,10,0,0,0,2
Essendon,"Heppell, Dyson",23,13,8,10,0,0,0,2
Essendon,"Hind, Nick",19,13,2,6,0,0,0,5
Essendon,"Hooker, Cale",14,7,3,7,3,1,0,1
Essendon,"Jones, Harry",6,5,3,1,1,0,0,2
Essendon,"Langford, Kyle",19,13,6,6,0,0,0,3
Essendon,"Laverde, Jayden",12,8,5,4,0,0,0,2
Essendon,"McDonald-Tipungwuti, Anthony",12,6,3,6,0,1,0,5
Essendon,"McGrath, Andrew",20,8,3,12,0,0,0,5
Essendon,"Merrett, Zach",27,16,2,11,0,0,0,9
Essendon,"Parish, Darcy",25,7,3,18,1,0,0,5
Essendon,"Perkins, Archie",11,5,3,6,0,0,0,1
Essendon,"Ridley, Jordan",28,22,8,6,0,0,0,2
Essendon,"Smith, Devon",16,8,4,8,1,1,0,3
Essendon,"Snelling, Will",13,8,3,5,0,0,0,11
Essendon,"Stringer, Jake",10,9,3,1,3,1,0,5
Essendon,"Waterman, Alec",10,6,3,4,2,0,0,1
Essendon,"Wright, Peter",8,6,0,2,0,0,23,2
Essendon,"Zaharakis, David",0,0,0,0,0,0,0,0
Essendon,"Zerk-Thatcher, Brandon",6,3,1,3,0,0,0,4
Essendon,"Cox, Nik",10,8,2,2,0,2,3,2
Essendon,"Francis, Aaron",14,6,3,8,0,0,0,0
Essendon,"Guelfi, Matt",9,7,3,2,0,0,0,1
Essendon,"Ham, Brayden",10,7,1,3,0,0,0,2
Essendon,"Heppell, Dyson",24,13,4,11,0,0,0,4
Essendon,"Hind, Nick",23,17,2,6,0,0,0,2
Essendon,"Hooker, Cale",13,9,2,4,4,1,1,2
Essendon,"Jones, Harry",7,2,0,5,0,0,0,1
Essendon,"Langford, Kyle",27,15,5,12,0,0,0,5
Essendon,"Laverde, Jayden",16,7,3,9,0,0,0,2
Essendon,"McDonald-Tipungwuti, Anthony",10,7,3,3,1,1,0,3
Essendon,"McGrath, Andrew",30,18,1,12,0,1,0,12
Essendon,"Merrett, Zach",35,15,3,20,0,0,0,3
Essendon,"Parish, Darcy",26,15,2,11,0,0,0,4
Essendon,"Perkins, Archie",20,11,5,9,0,0,0,4
Essendon,"Redman, Mason",17,8,4,9,0,0,0,5
Essendon,"Reid, Zach",10,5,1,5,0,0,0,5
Essendon,"Ridley, Jordan",2,2,0,0,0,0,0,2
Essendon,"Smith, Devon",14,4,2,10,0,1,0,5
Essendon,"Snelling, Will",19,5,1,14,0,0,0,5
Essendon,"Stringer, Jake",9,6,0,3,1,1,0,2
Essendon,"Waterman, Alec",5,5,1,0,0,0,0,5
Essendon,"Wright, Peter",8,7,2,1,0,0,27,5
Essendon,"Cox, Nik",15,10,8,5,0,0,0,1
Essendon,"Francis, Aaron",5,5,4,0,0,0,0,0
Essendon,"Guelfi, Matt",13,10,8,3,0,1,0,2
Essendon,"Ham, Brayden",22,12,7,10,0,2,0,2
Essendon,"Heppell, Dyson",29,20,13,9,0,0,0,7
Essendon,"Hind, Nick",23,18,8,5,0,0,0,2
Essendon,"Hooker, Cale",6,3,1,3,0,2,1,2
Essendon,"Jones, Harry",6,4,4,2,0,1,0,2
Essendon,"Langford, Kyle",21,9,3,12,0,0,0,2
Essendon,"Laverde, Jayden",21,17,13,4,1,0,0,0
Essendon,"McDonald-Tipungwuti, Anthony",10,7,1,3,5,0,0,6
Essendon,"McGrath, Andrew",21,11,1,10,0,2,0,7
Essendon,"Merrett, Zach",34,16,6,18,0,1,0,6
Essendon,"Parish, Darcy",42,24,6,18,2,0,0,3
Essendon,"Perkins, Archie",12,8,3,4,0,1,0,4
Essendon,"Phillips, Andrew",12,3,2,9,1,0,19,5
Essendon,"Redman, Mason",13,10,4,3,1,0,0,4
Essendon,"Smith, Devon",11,7,5,4,1,0,0,10
Essendon,"Snelling, Will",14,6,1,8,2,1,0,2
Essendon,"Stringer, Jake",17,11,0,6,1,1,0,8
Essendon,"Wright, Peter",16,10,10,6,2,0,11,6
Essendon,"Zaharakis, David",4,3,0,1,0,0,0,3
Essendon,"Zerk-Thatcher, Brandon",9,9,6,0,0,0,0,2
Essendon,"Bryan, Nick",12,5,3,7,0,0,18,3
Essendon,"Cox, Nik",14,8,3,6,0,0,0,2
Essendon,"Guelfi, Matt",13,8,5,5,0,0,0,2
Essendon,"Ham, Brayden",11,5,5,6,0,0,0,1
Essendon,"Heppell, Dyson",23,13,3,10,0,0,0,4
Essendon,"Hind, Nick",21,13,5,8,0,1,0,3
Essendon,"Hooker, Cale",15,10,7,5,5,1,2,2
Essendon,"Jones, Harry",10,7,8,3,3,0,0,2
Essendon,"Langford, Kyle",19,11,5,8,0,1,0,3
Essendon,"Laverde, Jayden",17,12,7,5,0,0,0,2
Essendon,"McDonald-Tipungwuti, Anthony",10,9,3,1,4,1,0,6
Essendon,"McGrath, Andrew",28,19,2,9,0,0,0,5
Essendon,"Merrett, Zach",25,16,3,9,0,0,0,7
Essendon,"Parish, Darcy",26,17,4,9,0,0,0,7
Essendon,"Perkins, Archie",18,7,6,11,0,2,0,4
Essendon,"Redman, Mason",10,7,3,3,0,0,0,0
Essendon,"Ridley, Jordan",18,13,5,5,0,0,0,1
Essendon,"Smith, Devon",12,5,4,7,1,0,0,9
Essendon,"Snelling, Will",18,6,7,12,0,0,0,3
Essendon,"Stewart, James",9,5,2,4,0,0,0,1
Essendon,"Stringer, Jake",18,13,2,5,3,2,0,3
Essendon,"Wright, Peter",15,10,5,5,0,1,10,4
Essendon,"Zaharakis, David",0,0,0,0,0,0,0,0
Essendon,"Cox, Nik",11,6,2,5,1,1,0,5
Essendon,"Francis, Aaron",14,8,5,6,0,0,0,1
Essendon,"Guelfi, Matt",8,5,2,3,1,0,0,6
Essendon,"Ham, Brayden",17,8,4,9,0,1,0,0
Essendon,"Heppell, Dyson",27,14,8,13,0,0,0,0
Essendon,"Hind, Nick",29,22,5,7,0,0,0,1
Essendon,"Hooker, Cale",7,4,2,3,1,1,0,0
Essendon,"Jones, Harry",8,6,5,2,2,0,0,1
Essendon,"Langford, Kyle",20,10,9,10,3,0,0,2
Essendon,"Laverde, Jayden",16,10,10,6,0,0,0,1
Essendon,"McDonald-Tipungwuti, Anthony",11,6,2,5,2,0,0,1
Essendon,"McGrath, Andrew",25,11,3,14,0,0,0,1
Essendon,"Merrett, Zach",37,22,6,15,0,2,0,3
Essendon,"Parish, Darcy",35,17,5,18,0,1,0,4
Essendon,"Perkins, Archie",13,5,2,8,1,1,0,4
Essendon,"Phillips, Andrew",13,8,6,5,0,0,26,4
Essendon,"Redman, Mason",23,16,5,7,1,0,0,0
Essendon,"Ridley, Jordan",21,17,5,4,0,0,0,2
Essendon,"Smith, Devon",14,6,3,8,0,0,0,3
Essendon,"Snelling, Will",19,9,5,10,2,0,0,3
Essendon,"Stewart, James",12,9,5,3,0,0,0,0
Essendon,"Stringer, Jake",5,4,2,1,0,2,0,2
Essendon,"Wright, Peter",8,4,2,4,2,0,10,0
Essendon,"Cox, Nik",5,4,2,1,0,0,0,2
Essendon,"Francis, Aaron",15,8,5,7,0,0,0,1
Essendon,"Guelfi, Matt",13,10,8,3,0,1,0,4
Essendon,"Ham, Brayden",10,9,4,1,1,2,0,2
Essendon,"Heppell, Dyson",27,16,9,11,0,0,0,0
Essendon,"Hind, Nick",31,24,8,7,0,0,0,3
Essendon,"Hooker, Cale",15,2,6,13,0,1,0,2
Essendon,"Jones, Harry",6,5,2,1,2,0,0,3
Essendon,"Langford, Kyle",13,7,4,6,1,0,0,5
Essendon,"Laverde, Jayden",11,6,6,5,0,0,0,0
Essendon,"McDonald-Tipungwuti, Anthony",17,10,4,7,2,0,0,1
Essendon,"McGrath, Andrew",27,15,3,12,0,0,0,8
Essendon,"Merrett, Zach",22,10,0,12,0,1,0,4
Essendon,"Parish, Darcy",39,18,4,21,1,0,0,4
Essendon,"Perkins, Archie",12,6,2,6,0,0,0,1
Essendon,"Phillips, Andrew",6,3,1,3,1,0,20,5
Essendon,"Redman, Mason",24,14,4,10,1,0,0,4
Essendon,"Ridley, Jordan",27,17,7,10,0,0,0,2
Essendon,"Smith, Devon",7,6,2,1,0,1,0,2
Essendon,"Snelling, Will",18,8,4,10,0,0,0,7
Essendon,"Stewart, James",8,5,3,3,0,0,0,2
Essendon,"Wright, Peter",9,5,4,4,1,0,8,2
Essendon,"Zaharakis, David",16,6,4,10,0,1,0,4
Essendon,"Cox, Nik",14,11,9,3,2,0,0,2
Essendon,"Francis, Aaron",13,4,6,9,0,0,0,0
Essendon,"Guelfi, Matt",10,5,2,5,0,0,0,3
Essendon,"Ham, Brayden",0,0,0,0,0,0,0,0
Essendon,"Heppell, Dyson",26,16,11,10,0,0,0,1
Essendon,"Hind, Nick",21,17,5,4,1,0,0,4
Essendon,"Hooker, Cale",12,8,8,4,2,3,0,1
Essendon,"Jones, Harry",6,5,3,1,3,0,0,0
Essendon,"Langford, Kyle",22,16,6,6,2,1,0,4
Essendon,"Laverde, Jayden",15,12,7,3,0,0,0,1
Essendon,"McDonald-Tipungwuti, Anthony",10,8,3,2,3,2,0,3
Essendon,"McGrath, Andrew",31,9,4,22,0,0,0,1
Essendon,"Merrett, Zach",31,19,6,12,0,0,0,3
Essendon,"Parish, Darcy",36,19,12,17,0,0,0,4
Essendon,"Perkins, Archie",11,5,3,6,1,0,0,3
Essendon,"Phillips, Andrew",10,4,2,6,1,0,22,4
Essendon,"Redman, Mason",23,12,8,11,0,0,0,1
Essendon,"Ridley, Jordan",21,15,6,6,0,0,0,1
Essendon,"Snelling, Will",25,8,5,17,1,0,0,2
Essendon,"Stewart, James",14,10,7,4,0,0,0,2
Essendon,"Waterman, Alec",11,7,5,4,2,0,0,0
Essendon,"Wright, Peter",16,13,10,3,3,2,6,1
Essendon,"Zaharakis, David",22,12,6,10,1,1,0,3
Essendon,"Cox, Nik",9,6,4,3,1,1,1,1
Essendon,"Guelfi, Matt",17,8,5,9,0,0,0,2
Essendon,"Ham, Brayden",0,0,0,0,0,0,0,0
Essendon,"Heppell, Dyson",22,15,9,7,0,0,0,6
Essendon,"Hind, Nick",20,17,5,3,0,1,0,1
Essendon,"Hooker, Cale",16,12,7,4,2,3,1,1
Essendon,"Jones, Harry",10,6,5,4,1,0,0,0
Essendon,"Langford, Kyle",28,16,9,12,1,1,1,4
Essendon,"Laverde, Jayden",15,10,5,5,0,0,0,4
Essendon,"McDonald-Tipungwuti, Anthony",12,11,1,1,2,1,0,3
Essendon,"McGrath, Andrew",24,12,3,12,0,0,0,1
Essendon,"Merrett, Zach",37,20,5,17,0,1,0,5
Essendon,"Parish, Darcy",36,19,4,17,0,1,0,4
Essendon,"Perkins, Archie",16,9,4,7,0,1,0,3
Essendon,"Phillips, Andrew",11,8,7,3,0,0,11,3
Essendon,"Redman, Mason",15,10,4,5,0,0,0,3
Essendon,"Ridley, Jordan",16,10,4,6,0,0,0,0
Essendon,"Snelling, Will",12,7,2,5,1,0,0,3
Essendon,"Stewart, James",10,7,2,3,0,0,0,2
Essendon,"Stringer, Jake",12,8,3,4,3,2,0,2
Essendon,"Waterman, Alec",11,5,4,6,1,1,0,3
Essendon,"Zaharakis, David",19,15,5,4,0,0,0,2
Essendon,"Zerk-Thatcher, Brandon",8,5,2,3,0,0,0,2
Essendon,"Ambrose, Patrick",5,1,0,4,0,1,0,2
Essendon,"Cox, Nik",23,14,8,9,1,1,2,2
Essendon,"Francis, Aaron",3,2,2,1,0,0,0,1
Essendon,"Guelfi, Matt",6,0,1,6,0,0,0,2
Essendon,"Ham, Brayden",13,6,2,7,3,0,0,1
Essendon,"Heppell, Dyson",22,14,5,8,0,0,0,1
Essendon,"Hind, Nick",21,15,3,6,0,0,0,2
Essendon,"Hooker, Cale",17,6,3,11,3,0,0,0
Essendon,"Jones, Harry",4,2,2,2,0,1,0,0
Essendon,"Langford, Kyle",28,18,10,10,1,0,0,1
Essendon,"Laverde, Jayden",15,11,6,4,0,0,0,2
Essendon,"McDonald-Tipungwuti, Anthony",11,2,0,9,0,0,0,3
Essendon,"McGrath, Andrew",3,3,2,0,0,0,0,0
Essendon,"Merrett, Zach",32,13,5,19,0,0,0,7
Essendon,"Parish, Darcy",44,25,8,19,0,2,0,5
Essendon,"Perkins, Archie",13,6,3,7,0,2,0,0
Essendon,"Phillips, Andrew",10,6,6,4,1,1,25,2
Essendon,"Redman, Mason",19,11,5,8,0,0,0,2
Essendon,"Ridley, Jordan",17,12,7,5,0,0,0,2
Essendon,"Stewart, James",12,9,5,3,0,0,0,1
Essendon,"Stringer, Jake",13,9,2,4,1,0,0,3
Essendon,"Waterman, Alec",7,4,3,3,2,1,0,2
Essendon,"Zaharakis, David",10,7,3,3,0,0,0,2
Essendon,"Cahill, Ned",5,1,0,4,1,0,0,1
Essendon,"Cox, Nik",15,5,0,10,0,0,0,3
Essendon,"Cutler, Tom",0,0,0,0,0,0,0,0
Essendon,"Draper, Sam",15,12,6,3,0,0,18,2
Essendon,"Guelfi, Matt",13,8,4,5,1,0,0,1
Essendon,"Ham, Brayden",12,6,2,6,0,0,0,1
Essendon,"Heppell, Dyson",24,18,8,6,0,1,0,3
Essendon,"Hind, Nick",25,18,2,7,1,0,0,1
Essendon,"Hooker, Cale",9,4,1,5,0,0,0,3
Essendon,"Jones, Harry",14,10,8,4,2,1,1,1
Essendon,"Langford, Kyle",19,9,2,10,1,0,0,7
Essendon,"Laverde, Jayden",7,5,4,2,0,0,0,1
Essendon,"McDonald-Tipungwuti, Anthony",7,4,2,3,2,1,0,2
Essendon,"Merrett, Zach",27,11,4,16,0,0,0,3
Essendon,"Parish, Darcy",24,13,3,11,1,0,0,2
Essendon,"Perkins, Archie",7,0,0,7,0,0,0,1
Essendon,"Redman, Mason",17,12,5,5,0,0,0,1
Essendon,"Ridley, Jordan",25,19,4,6,0,0,0,2
Essendon,"Smith, Devon",13,9,2,4,0,0,0,1
Essendon,"Stewart, James",17,11,7,6,0,0,0,1
Essendon,"Stringer, Jake",29,17,3,12,4,1,0,7
Essendon,"Wright, Peter",5,3,3,2,0,0,4,1
Essendon,"Zerk-Thatcher, Brandon",9,5,4,4,0,0,0,2
Essendon,"Cox, Nik",7,4,4,3,0,0,1,5
Essendon,"Draper, Sam",10,6,1,4,0,0,10,1
Essendon,"Guelfi, Matt",15,3,3,12,0,0,0,9
Essendon,"Ham, Brayden",20,9,5,11,0,1,0,0
Essendon,"Heppell, Dyson",26,15,10,11,1,0,0,1
Essendon,"Hind, Nick",17,11,1,6,0,0,0,2
Essendon,"Hooker, Cale",13,4,3,9,1,0,1,0
Essendon,"Jones, Harry",4,3,1,1,2,0,0,0
Essendon,"Langford, Kyle",29,16,6,13,0,0,0,6
Essendon,"Laverde, Jayden",17,7,5,10,0,0,0,2
Essendon,"McDonald-Tipungwuti, Anthony",10,6,3,4,0,2,0,5
Essendon,"Merrett, Zach",41,23,5,18,0,1,0,8
Essendon,"Parish, Darcy",37,13,5,24,0,0,0,4
Essendon,"Perkins, Archie",16,7,4,9,0,1,0,0
Essendon,"Redman, Mason",21,14,2,7,0,0,0,4
Essendon,"Ridley, Jordan",28,19,6,9,0,0,0,0
Essendon,"Smith, Devon",14,7,4,7,1,0,0,4
Essendon,"Stewart, James",14,9,6,5,0,0,0,2
Essendon,"Stringer, Jake",24,12,5,12,1,2,0,5
Essendon,"Waterman, Alec",13,7,5,6,0,0,0,2
Essendon,"Wright, Peter",8,4,3,4,2,0,11,1
Essendon,"Zaharakis, David",0,0,0,0,0,0,0,0
Essendon,"Zerk-Thatcher, Brandon",13,6,6,7,0,0,0,0
Essendon,"Cox, Nik",8,6,3,2,0,0,0,2
Essendon,"Cutler, Tom",13,5,1,8,0,0,0,1
Essendon,"Draper, Sam",7,5,1,2,0,0,34,0
Essendon,"Guelfi, Matt",0,0,0,0,0,0,0,0
Essendon,"Ham, Brayden",8,5,3,3,0,1,0,3
Essendon,"Heppell, Dyson",25,11,3,14,0,0,0,2
Essendon,"Hind, Nick",21,14,7,7,0,0,0,2
Essendon,"Hooker, Cale",5,0,0,5,0,0,0,3
Essendon,"Jones, Harry",5,2,2,3,1,0,0,4
Essendon,"Langford, Kyle",17,10,3,7,0,0,0,4
Essendon,"Laverde, Jayden",12,7,4,5,0,0,0,2
Essendon,"McDonald-Tipungwuti, Anthony",7,6,2,1,2,0,0,4
Essendon,"Merrett, Zach",36,21,5,15,1,0,0,7
Essendon,"Parish, Darcy",43,23,5,20,1,0,0,3
Essendon,"Perkins, Archie",8,3,3,5,0,0,0,4
Essendon,"Redman, Mason",12,8,0,4,0,0,0,0
Essendon,"Ridley, Jordan",17,13,6,4,0,0,0,3
Essendon,"Smith, Devon",12,9,2,3,0,2,0,4
Essendon,"Snelling, Will",24,13,2,11,0,0,0,7
Essendon,"Stewart, James",13,10,8,3,0,0,0,1
Essendon,"Stringer, Jake",25,14,4,11,3,1,0,5
Essendon,"Waterman, Alec",9,4,1,5,0,1,0,3
Essendon,"Wright, Peter",12,5,1,7,0,1,8,2
Essendon,"Cox, Nik",19,9,5,10,0,0,0,4
Essendon,"Cutler, Tom",18,9,9,9,0,1,0,1
Essendon,"Draper, Sam",10,5,2,5,0,0,17,3
Essendon,"Gleeson, Martin",11,8,7,3,0,0,0,2
Essendon,"Guelfi, Matt",12,3,4,9,0,0,0,4
Essendon,"Ham, Brayden",7,3,0,4,0,1,0,3
Essendon,"Hind, Nick",24,23,10,1,0,0,0,2
Essendon,"Hooker, Cale",11,4,1,7,1,3,1,1
Essendon,"Jones, Harry",5,3,3,2,1,0,1,1
Essendon,"Langford, Kyle",17,10,5,7,0,0,0,3
Essendon,"Laverde, Jayden",15,12,11,3,0,0,0,1
Essendon,"McDonald-Tipungwuti, Anthony",10,4,1,6,1,0,0,3
Essendon,"Merrett, Zach",35,18,4,17,0,0,0,3
Essendon,"Parish, Darcy",19,7,0,12,0,0,0,6
Essendon,"Perkins, Archie",18,12,4,6,3,3,0,2
Essendon,"Redman, Mason",25,18,11,7,0,1,0,0
Essendon,"Ridley, Jordan",23,19,11,4,0,0,0,1
Essendon,"Smith, Devon",17,9,3,8,0,1,0,3
Essendon,"Snelling, Will",24,12,4,12,1,1,0,2
Essendon,"Stewart, James",8,6,4,2,0,0,0,2
Essendon,"Stringer, Jake",23,14,3,9,1,1,0,6
Essendon,"Waterman, Alec",18,9,6,9,1,1,0,1
Essendon,"Wright, Peter",12,7,4,5,2,2,7,3
Essendon,"Cox, Nik",15,6,3,9,0,0,0,0
Essendon,"Cutler, Tom",19,9,1,10,0,0,0,2
Essendon,"Draper, Sam",8,4,2,4,0,1,19,1
Essendon,"Durham, Sam",11,7,5,4,0,1,0,1
Essendon,"Gleeson, Martin",0,0,0,0,0,0,0,0
Essendon,"Guelfi, Matt",17,9,8,8,1,0,0,3
Essendon,"Ham, Brayden",15,8,4,7,1,1,0,1
Essendon,"Heppell, Dyson",27,17,3,10,1,0,0,1
Essendon,"Hind, Nick",21,15,6,6,0,0,0,1
Essendon,"Hooker, Cale",12,8,6,4,1,2,1,5
Essendon,"Laverde, Jayden",9,3,3,6,0,0,0,0
Essendon,"McDonald-Tipungwuti, Anthony",5,4,2,1,0,1,0,2
Essendon,"Merrett, Zach",39,14,3,25,0,0,0,3
Essendon,"Parish, Darcy",34,17,6,17,0,0,0,6
Essendon,"Perkins, Archie",9,5,2,4,1,1,0,2
Essendon,"Redman, Mason",20,9,4,11,0,0,0,3
Essendon,"Ridley, Jordan",21,16,7,5,0,0,0,0
Essendon,"Smith, Devon",6,4,2,2,1,1,0,3
Essendon,"Snelling, Will",22,8,5,14,0,1,0,2
Essendon,"Stewart, James",13,9,8,4,0,0,0,0
Essendon,"Stringer, Jake",17,10,4,7,4,1,0,3
Essendon,"Waterman, Alec",9,3,1,6,0,0,0,2
Essendon,"Wright, Peter",20,11,7,9,3,1,10,1
Essendon,"Cox, Nik",15,10,5,5,1,1,0,2
Essendon,"Cutler, Tom",11,6,5,5,0,0,0,1
Essendon,"Draper, Sam",11,6,1,5,0,0,27,1
Essendon,"Durham, Sam",15,10,7,5,0,0,0,1
Essendon,"Guelfi, Matt",0,0,0,0,0,0,0,0
Essendon,"Ham, Brayden",9,2,1,7,0,0,0,4
Essendon,"Heppell, Dyson",28,17,6,11,0,0,0,4
Essendon,"Hind, Nick",14,10,3,4,0,0,0,1
Essendon,"Hooker, Cale",12,8,4,4,1,2,1,1
Essendon,"Laverde, Jayden",14,10,8,4,0,0,0,0
Essendon,"McDonald-Tipungwuti, Anthony",5,4,3,1,0,1,0,0
Essendon,"Merrett, Zach",20,7,1,13,0,0,0,7
Essendon,"Parish, Darcy",15,6,2,9,1,0,0,6
Essendon,"Perkins, Archie",8,3,4,5,1,0,0,1
Essendon,"Redman, Mason",11,8,4,3,0,0,0,2
Essendon,"Ridley, Jordan",25,19,6,6,0,0,0,0
Essendon,"Shiel, Dylan",13,6,1,7,0,1,0,4
Essendon,"Smith, Devon",16,8,3,8,1,2,0,2
Essendon,"Snelling, Will",20,10,6,10,0,0,0,6
Essendon,"Stewart, James",15,10,8,5,0,0,0,1
Essendon,"Stringer, Jake",14,13,3,1,1,0,0,2
Essendon,"Wright, Peter",13,9,6,4,0,3,5,1
Essendon,"Zaharakis, David",10,8,3,2,1,0,0,2
Essendon,"Clarke, Dylan",13,5,4,8,1,0,0,1
Essendon,"Cox, Nik",13,8,2,5,0,0,0,2
Essendon,"Cutler, Tom",11,7,2,4,1,0,0,1
Essendon,"Draper, Sam",11,7,4,4,0,1,23,1
Essendon,"Durham, Sam",11,6,1,5,0,0,0,1
Essendon,"Francis, Aaron",10,7,4,3,0,1,0,1
Essendon,"Ham, Brayden",0,0,0,0,0,0,0,0
Essendon,"Heppell, Dyson",25,17,5,8,0,0,0,3
Essendon,"Hind, Nick",15,10,1,5,1,0,0,1
Essendon,"Langford, Kyle",17,13,7,4,3,0,0,3
Essendon,"Laverde, Jayden",5,4,3,1,0,0,0,2
Essendon,"McDonald-Tipungwuti, Anthony",5,4,2,1,1,0,0,1
Essendon,"Merrett, Zach",35,20,7,15,2,0,0,5
Essendon,"Parish, Darcy",34,12,1,22,0,0,0,4
Essendon,"Perkins, Archie",4,2,2,2,0,0,0,1
Essendon,"Redman, Mason",8,5,3,3,0,0,0,1
Essendon,"Ridley, Jordan",10,9,3,1,0,0,0,0
Essendon,"Shiel, Dylan",22,12,2,10,1,1,0,2
Essendon,"Smith, Devon",16,6,4,10,2,1,0,1
Essendon,"Snelling, Will",17,9,3,8,0,0,0,3
Essendon,"Stewart, James",8,3,3,5,0,0,0,0
Essendon,"Stringer, Jake",19,13,3,6,2,0,0,5
Essendon,"Wright, Peter",15,7,4,8,2,1,5,0
Essendon,"Clarke, Dylan",19,10,5,9,0,0,0,4
Essendon,"Cox, Nik",9,6,4,3,0,0,0,2
Essendon,"Cutler, Tom",22,17,8,5,0,1,0,3
Essendon,"Draper, Sam",11,7,3,4,1,0,39,1
Essendon,"Durham, Sam",15,5,3,10,0,0,0,1
Essendon,"Francis, Aaron",8,8,7,0,2,0,0,1
Essendon,"Gleeson, Martin",12,5,3,7,0,0,0,6
Essendon,"Guelfi, Matt",7,4,3,3,1,0,0,3
Essendon,"Hind, Nick",23,15,5,8,0,0,0,1
Essendon,"Laverde, Jayden",15,11,5,4,0,0,0,1
Essendon,"McDonald-Tipungwuti, Anthony",5,3,3,2,1,0,0,1
Essendon,"Merrett, Zach",30,14,6,16,0,0,0,4
Essendon,"Parish, Darcy",28,12,1,16,1,0,0,1
Essendon,"Perkins, Archie",0,0,0,0,0,0,0,0
Essendon,"Redman, Mason",11,9,1,2,0,0,0,2
Essendon,"Ridley, Jordan",17,13,5,4,0,0,0,2
Essendon,"Shiel, Dylan",19,7,1,12,0,0,0,2
Essendon,"Smith, Devon",15,10,0,5,1,2,0,3
Essendon,"Snelling, Will",12,4,2,8,0,1,0,10
Essendon,"Stewart, James",13,7,5,6,0,0,0,0
Essendon,"Stringer, Jake",13,7,2,6,0,0,0,6
Essendon,"Waterman, Alec",7,4,2,3,1,1,0,0
Essendon,"Wright, Peter",10,9,7,1,7,0,9,1
Essendon,"Clarke, Dylan",15,4,4,11,1,0,0,2
Essendon,"Cutler, Tom",16,12,4,4,0,0,0,0
Essendon,"Draper, Sam",10,8,3,2,0,0,24,0
Essendon,"Durham, Sam",20,8,6,12,1,1,0,1
Essendon,"Francis, Aaron",15,9,5,6,0,2,0,0
Essendon,"Gleeson, Martin",0,0,0,0,0,0,0,0
Essendon,"Guelfi, Matt",15,9,4,6,2,1,0,2
Essendon,"Heppell, Dyson",21,9,6,12,0,0,0,2
Essendon,"Hind, Nick",30,21,8,9,1,0,0,1
Essendon,"Laverde, Jayden",17,9,4,8,0,0,0,1
Essendon,"McGrath, Andrew",13,6,3,7,0,0,0,3
Essendon,"Merrett, Zach",31,12,2,19,0,0,0,1
Essendon,"Parish, Darcy",34,17,7,17,0,1,0,1
Essendon,"Perkins, Archie",10,5,3,5,1,1,0,2
Essendon,"Redman, Mason",30,16,6,14,0,0,0,2
Essendon,"Ridley, Jordan",24,16,3,8,0,0,0,0
Essendon,"Shiel, Dylan",21,8,2,13,0,0,0,3
Essendon,"Smith, Devon",13,7,4,6,1,2,0,3
Essendon,"Snelling, Will",20,11,7,9,0,0,0,4
Essendon,"Stewart, James",16,8,3,8,0,0,0,1
Essendon,"Stringer, Jake",19,14,4,5,5,1,0,1
Essendon,"Waterman, Alec",7,7,2,0,2,1,0,3
Essendon,"Wright, Peter",8,6,4,2,0,1,10,2
Essendon,"Clarke, Dylan",14,6,4,8,0,0,0,2
Essendon,"Cox, Nik",0,0,0,0,0,0,0,0
Essendon,"Cutler, Tom",24,18,9,6,0,0,0,0
Essendon,"Draper, Sam",7,6,1,1,0,0,20,1
Essendon,"Durham, Sam",10,4,4,6,0,0,0,2
Essendon,"Francis, Aaron",9,6,5,3,0,1,1,0
Essendon,"Guelfi, Matt",20,14,4,6,0,1,0,2
Essendon,"Heppell, Dyson",22,13,8,9,0,0,0,5
Essendon,"Hind, Nick",23,22,8,1,0,0,0,2
Essendon,"Laverde, Jayden",18,11,6,7,0,0,0,1
Essendon,"McGrath, Andrew",21,11,4,10,0,0,0,2
Essendon,"Merrett, Zach",27,9,4,18,0,0,0,4
Essendon,"Parish, Darcy",21,6,1,15,0,1,0,3
Essendon,"Perkins, Archie",12,7,3,5,1,0,0,1
Essendon,"Redman, Mason",21,16,10,5,2,0,0,1
Essendon,"Ridley, Jordan",19,16,9,3,0,0,0,1
Essendon,"Shiel, Dylan",21,7,5,14,0,0,0,3
Essendon,"Smith, Devon",23,14,7,9,2,2,0,4
Essendon,"Snelling, Will",14,5,4,9,1,0,0,6
Essendon,"Stewart, James",15,9,6,6,0,0,0,1
Essendon,"Stringer, Jake",24,17,6,7,2,1,0,1
Essendon,"Waterman, Alec",13,7,5,6,4,0,0,2
Essendon,"Wright, Peter",13,9,8,4,4,0,3,1
Essendon,"Caldwell, Jye",14,9,2,5,0,0,0,4
Essendon,"Cox, Nik",0,0,0,0,0,0,0,0
Essendon,"Cutler, Tom",21,11,3,10,0,2,0,4
Essendon,"Draper, Sam",18,12,5,6,0,2,44,4
Essendon,"Durham, Sam",17,7,5,10,0,0,0,2
Essendon,"Francis, Aaron",9,7,3,2,0,2,0,4
Essendon,"Gleeson, Martin",18,11,6,7,0,0,0,1
Essendon,"Guelfi, Matt",18,9,4,9,0,0,0,3
Essendon,"Heppell, Dyson",24,12,7,12,0,0,0,1
Essendon,"Laverde, Jayden",12,10,6,2,0,0,0,3
Essendon,"McGrath, Andrew",15,9,3,6,0,0,0,3
Essendon,"Merrett, Zach",31,16,3,15,0,1,0,9
Essendon,"Parish, Darcy",35,22,3,13,1,1,0,4
Essendon,"Perkins, Archie",6,2,1,4,0,0,0,1
Essendon,"Redman, Mason",18,11,4,7,0,0,0,4
Essendon,"Ridley, Jordan",17,12,6,5,0,0,0,3
Essendon,"Shiel, Dylan",24,16,3,8,0,0,0,4
Essendon,"Smith, Devon",13,8,2,5,1,0,0,6
Essendon,"Snelling, Will",15,5,1,10,0,2,0,7
Essendon,"Stewart, James",16,9,7,7,0,0,0,2
Essendon,"Stringer, Jake",9,9,2,0,2,1,0,8
Essendon,"Waterman, Alec",10,5,1,5,0,0,0,2
Essendon,"Wright, Peter",7,0,0,7,0,0,9,1
Fremantle,"Acres, Blake",12,6,2,6,0,0,1,2
Fremantle,"Aish, James",17,14,2,3,0,1,0,1
Fremantle,"Blakely, Connor",14,5,2,9,1,0,0,2
Fremantle,"Brayshaw, Andrew",29,13,5,16,1,0,0,4
Fremantle,"Cerra, Adam",24,14,7,10,0,1,0,5
Fremantle,"Colyer, Travis",13,9,3,4,0,1,0,2
Fremantle,"Conca, Reece",16,6,3,10,0,0,0,0
Fremantle,"Cox, Brennan",10,4,6,6,0,0,1,0
Fremantle,"Fyfe, Nat",27,10,5,17,0,0,0,5
Fremantle,"Giro, Stefan",8,5,2,3,0,0,0,1
Fremantle,"Hamling, Joel",10,3,0,7,0,0,2,1
Fremantle,"Henry, Liam",8,7,1,1,1,1,0,0
Fremantle,"Hughes, Ethan",16,9,4,7,0,0,0,2
Fremantle,"Meek, Lloyd",6,0,0,6,0,0,13,1
Fremantle,"Mundy, David",19,9,5,10,0,1,0,3
Fremantle,"Pearce, Alex",2,1,0,1,0,1,0,0
Fremantle,"Ryan, Luke",21,15,4,6,0,0,0,5
Fremantle,"Schultz, Lachie",10,9,0,1,1,0,0,5
Fremantle,"Serong, Caleb",26,13,2,13,0,1,0,3
Fremantle,"Switkowski, Sam",15,5,3,10,1,1,0,5
Fremantle,"Taberner, Matthew",13,10,4,3,3,1,0,0
Fremantle,"Watson, Tobe",8,4,3,4,0,0,0,2
Fremantle,"Young, Hayden",19,17,6,2,0,0,0,0
Fremantle,"Acres, Blake",21,10,2,11,0,0,0,0
Fremantle,"Aish, James",17,8,4,9,0,0,0,3
Fremantle,"Blakely, Connor",7,4,4,3,0,0,0,1
Fremantle,"Brayshaw, Andrew",32,13,5,19,2,1,0,6
Fremantle,"Cerra, Adam",28,17,7,11,0,1,0,1
Fremantle,"Chapman, Heath",12,8,3,4,0,0,0,1
Fremantle,"Colyer, Travis",15,12,6,3,0,0,0,3
Fremantle,"Conca, Reece",18,5,4,13,0,0,0,1
Fremantle,"Cox, Brennan",10,7,3,3,0,0,0,2
Fremantle,"Darcy, Sean",19,6,6,13,0,1,10,1
Fremantle,"Frederick, Michael",13,12,8,1,1,2,0,1
Fremantle,"Fyfe, Nat",15,10,7,5,1,2,0,3
Fremantle,"Giro, Stefan",15,10,3,5,0,0,0,2
Fremantle,"Hughes, Ethan",24,14,6,10,0,1,0,1
Fremantle,"Meek, Lloyd",13,5,2,8,0,0,17,1
Fremantle,"Mundy, David",35,17,4,18,0,1,0,5
Fremantle,"Ryan, Luke",19,16,10,3,0,0,0,0
Fremantle,"Schultz, Lachie",20,12,8,8,3,2,0,6
Fremantle,"Serong, Caleb",22,12,1,10,0,1,0,4
Fremantle,"Switkowski, Sam",16,12,8,4,2,3,0,3
Fremantle,"Taberner, Matthew",12,9,8,3,2,2,0,0
Fremantle,"Wilson, Nathan",19,13,2,6,0,0,0,1
Fremantle,"Young, Hayden",17,9,3,8,0,0,0,2
Fremantle,"Acres, Blake",15,10,3,5,0,0,0,3
Fremantle,"Aish, James",13,9,6,4,0,0,0,1
Fremantle,"Brayshaw, Andrew",19,9,3,10,0,0,0,4
Fremantle,"Cerra, Adam",19,14,3,5,0,0,0,3
Fremantle,"Chapman, Heath",18,10,4,8,0,0,0,6
Fremantle,"Colyer, Travis",9,6,1,3,1,0,0,3
Fremantle,"Conca, Reece",14,7,3,7,0,0,0,2
Fremantle,"Cox, Brennan",6,2,0,4,0,0,0,1
Fremantle,"Darcy, Sean",13,6,3,7,1,0,19,5
Fremantle,"Frederick, Michael",14,10,8,4,1,4,0,1
Fremantle,"Giro, Stefan",20,16,8,4,1,0,0,0
Fremantle,"Henry, Liam",3,3,2,0,0,0,0,2
Fremantle,"Hughes, Ethan",16,9,4,7,0,0,0,2
Fremantle,"Meek, Lloyd",10,3,1,7,0,0,16,4
Fremantle,"Mundy, David",16,5,1,11,0,0,0,11
Fremantle,"Ryan, Luke",24,20,6,4,0,0,0,1
Fremantle,"Schultz, Lachie",2,2,0,0,0,0,0,1
Fremantle,"Serong, Caleb",22,11,3,11,0,0,0,2
Fremantle,"Switkowski, Sam",15,10,4,5,1,2,0,1
Fremantle,"Taberner, Matthew",13,10,8,3,2,2,0,1
Fremantle,"Walters, Michael",13,9,1,4,2,0,0,4
Fremantle,"Wilson, Nathan",20,12,5,8,0,0,0,1
Fremantle,"Young, Hayden",3,3,1,0,0,0,0,3
Fremantle,"Acres, Blake",18,13,7,5,1,0,0,2
Fremantle,"Aish, James",14,8,5,6,0,0,0,2
Fremantle,"Brayshaw, Andrew",15,6,0,9,0,0,0,5
Fremantle,"Cerra, Adam",23,17,7,6,0,0,0,6
Fremantle,"Chapman, Heath",18,7,4,11,1,0,0,2
Fremantle,"Colyer, Travis",11,10,3,1,2,1,0,2
Fremantle,"Conca, Reece",15,7,3,8,0,0,0,0
Fremantle,"Cox, Brennan",11,6,5,5,0,0,0,1
Fremantle,"Darcy, Sean",14,7,5,7,3,2,18,1
Fremantle,"Frederick, Michael",10,7,3,3,1,0,0,0
Fremantle,"Fyfe, Nat",30,14,3,16,0,6,0,5
Fremantle,"Giro, Stefan",0,0,0,0,0,0,0,0
Fremantle,"Hughes, Ethan",20,8,5,12,0,0,0,1
Fremantle,"Meek, Lloyd",7,0,1,7,0,0,9,0
Fremantle,"Mundy, David",25,14,5,11,1,0,0,2
Fremantle,"Ryan, Luke",17,6,1,11,0,0,0,3
Fremantle,"Serong, Caleb",23,12,0,11,0,0,0,3
Fremantle,"Sturt, Sam",5,3,2,2,1,1,0,0
Fremantle,"Taberner, Matthew",14,12,9,2,2,2,0,0
Fremantle,"Treacy, Josh",10,8,5,2,0,1,3,3
Fremantle,"Walters, Michael",13,10,6,3,1,2,0,1
Fremantle,"Watson, Tobe",14,10,7,4,0,0,0,1
Fremantle,"Wilson, Nathan",11,11,4,0,0,1,0,1
Fremantle,"Acres, Blake",19,14,2,5,0,0,0,5
Fremantle,"Aish, James",22,10,4,12,1,1,0,4
Fremantle,"Brayshaw, Andrew",33,18,4,15,0,0,0,4
Fremantle,"Cerra, Adam",4,1,1,3,0,0,0,1
Fremantle,"Chapman, Heath",15,8,6,7,0,0,0,1
Fremantle,"Colyer, Travis",13,10,5,3,2,0,0,0
Fremantle,"Conca, Reece",12,6,3,6,0,0,0,0
Fremantle,"Cox, Brennan",11,9,4,2,0,0,0,1
Fremantle,"Crowden, Mitch",7,3,1,4,0,1,0,2
Fremantle,"Darcy, Sean",14,5,3,9,1,0,35,5
Fremantle,"Frederick, Michael",12,10,5,2,1,2,0,0
Fremantle,"Fyfe, Nat",24,7,2,17,0,0,0,9
Fremantle,"Hughes, Ethan",16,9,4,7,0,0,0,3
Fremantle,"Lobb, Rory",11,8,3,3,0,3,4,2
Fremantle,"Logue, Griffin",10,6,6,4,0,0,0,1
Fremantle,"Mundy, David",28,15,4,13,1,0,0,8
Fremantle,"Ryan, Luke",24,21,10,3,0,0,0,3
Fremantle,"Schultz, Lachie",13,11,9,2,2,0,0,2
Fremantle,"Serong, Caleb",20,9,5,11,0,0,0,1
Fremantle,"Taberner, Matthew",15,11,8,4,4,1,0,0
Fremantle,"Treacy, Josh",5,3,2,2,0,0,0,1
Fremantle,"Walters, Michael",14,10,6,4,0,0,0,2
Fremantle,"Wilson, Nathan",17,14,5,3,0,0,0,2
Fremantle,"Acres, Blake",24,15,5,9,0,0,0,1
Fremantle,"Aish, James",17,11,6,6,0,2,0,1
Fremantle,"Blakely, Connor",4,1,1,3,0,0,0,0
Fremantle,"Brayshaw, Andrew",31,14,8,17,0,0,0,6
Fremantle,"Chapman, Heath",11,9,7,2,0,0,0,0
Fremantle,"Colyer, Travis",15,10,2,5,1,2,0,3
Fremantle,"Conca, Reece",13,9,4,4,0,0,0,5
Fremantle,"Cox, Brennan",12,7,3,5,0,0,0,0
Fremantle,"Crowden, Mitch",12,5,3,7,0,1,0,2
Fremantle,"Darcy, Sean",15,6,3,9,1,0,27,8
Fremantle,"Frederick, Michael",11,7,5,4,0,2,0,4
Fremantle,"Fyfe, Nat",34,16,7,18,0,4,0,3
Fremantle,"Hughes, Ethan",27,16,5,11,0,0,0,3
Fremantle,"Lobb, Rory",18,8,5,10,0,1,3,0
Fremantle,"Logue, Griffin",6,3,2,3,0,0,0,2
Fremantle,"Mundy, David",30,13,4,17,3,0,0,3
Fremantle,"Ryan, Luke",23,17,8,6,0,0,0,2
Fremantle,"Schultz, Lachie",12,9,3,3,4,0,0,1
Fremantle,"Serong, Caleb",35,24,7,11,0,2,0,7
Fremantle,"Taberner, Matthew",10,7,5,3,4,1,0,1
Fremantle,"Treacy, Josh",5,1,2,4,0,0,0,2
Fremantle,"Walters, Michael",12,7,2,5,1,0,0,4
Fremantle,"Wilson, Nathan",15,12,3,3,0,0,0,0
Fremantle,"Acres, Blake",24,10,6,14,0,0,0,4
Fremantle,"Aish, James",21,8,4,13,0,0,0,2
Fremantle,"Brayshaw, Andrew",32,11,3,21,0,0,0,4
Fremantle,"Chapman, Heath",11,8,3,3,0,0,0,0
Fremantle,"Colyer, Travis",17,10,7,7,1,1,0,1
Fremantle,"Conca, Reece",20,11,5,9,0,0,0,3
Fremantle,"Cox, Brennan",16,10,5,6,0,0,0,2
Fremantle,"Crowden, Mitch",6,1,0,5,0,0,0,4
Fremantle,"Darcy, Sean",15,3,2,12,0,0,25,1
Fremantle,"Duman, Taylin",12,5,3,7,0,0,0,1
Fremantle,"Frederick, Michael",7,5,5,2,1,0,0,1
Fremantle,"Fyfe, Nat",27,8,3,19,0,0,0,4
Fremantle,"Hughes, Ethan",7,3,0,4,0,0,0,0
Fremantle,"Lobb, Rory",9,6,4,3,2,0,8,2
Fremantle,"Logue, Griffin",7,4,2,3,0,0,0,1
Fremantle,"Mundy, David",29,15,1,14,1,0,0,5
Fremantle,"Schultz, Lachie",12,7,3,5,0,2,0,3
Fremantle,"Serong, Caleb",18,12,2,6,1,2,0,3
Fremantle,"Taberner, Matthew",10,8,5,2,3,1,0,1
Fremantle,"Tucker, Darcy",20,8,3,12,0,0,0,3
Fremantle,"Walters, Michael",21,11,6,10,1,0,0,0
Fremantle,"Watson, Tobe",16,10,8,6,1,0,0,0
Fremantle,"Wilson, Nathan",19,16,4,3,0,1,0,0
Fremantle,"Acres, Blake",13,9,3,4,0,0,0,0
Fremantle,"Aish, James",21,13,4,8,0,1,0,4
Fremantle,"Blakely, Connor",16,2,1,14,0,0,0,2
Fremantle,"Brayshaw, Andrew",28,10,2,18,0,1,0,4
Fremantle,"Colyer, Travis",15,8,1,7,0,0,0,4
Fremantle,"Conca, Reece",10,5,2,5,0,0,0,2
Fremantle,"Cox, Brennan",10,9,4,1,0,0,0,1
Fremantle,"Crowden, Mitch",12,5,1,7,0,0,0,2
Fremantle,"Darcy, Sean",17,9,4,8,1,0,39,3
Fremantle,"Duman, Taylin",15,7,3,8,0,0,0,2
Fremantle,"Frederick, Michael",1,1,1,0,0,1,0,0
Fremantle,"Fyfe, Nat",27,9,5,18,1,3,0,5
Fremantle,"Henry, Liam",9,5,2,4,1,1,0,1
Fremantle,"Lobb, Rory",17,8,8,9,1,1,13,1
Fremantle,"Logue, Griffin",10,7,4,3,0,0,0,2
Fremantle,"Mundy, David",27,12,4,15,1,0,0,2
Fremantle,"Schultz, Lachie",10,5,2,5,0,0,0,1
Fremantle,"Serong, Caleb",19,12,3,7,2,0,0,1
Fremantle,"Taberner, Matthew",9,8,6,1,2,1,0,1
Fremantle,"Tucker, Darcy",18,12,3,6,0,0,0,0
Fremantle,"Walters, Michael",8,6,5,2,1,0,0,1
Fremantle,"Watson, Tobe",7,3,3,4,0,0,0,1
Fremantle,"Wilson, Nathan",24,19,3,5,0,0,0,0
Fremantle,"Acres, Blake",18,12,8,6,0,0,0,3
Fremantle,"Aish, James",19,11,4,8,0,1,0,4
Fremantle,"Brayshaw, Andrew",33,14,8,19,0,0,0,8
Fremantle,"Cerra, Adam",28,14,4,14,1,0,0,0
Fremantle,"Colyer, Travis",10,6,0,4,0,0,0,3
Fremantle,"Conca, Reece",0,0,0,0,0,0,0,0
Fremantle,"Cox, Brennan",19,12,9,7,0,0,0,1
Fremantle,"Crowden, Mitch",9,0,1,9,0,0,0,0
Fremantle,"Darcy, Sean",22,9,4,13,0,0,39,8
Fremantle,"Duman, Taylin",18,10,6,8,0,0,0,2
Fremantle,"Fyfe, Nat",28,16,6,12,0,1,0,3
Fremantle,"Henry, Liam",8,2,3,6,0,1,0,2
Fremantle,"Lobb, Rory",12,10,6,2,1,2,5,2
Fremantle,"Logue, Griffin",16,9,5,7,0,0,0,6
Fremantle,"Mundy, David",22,7,1,15,1,0,0,5
Fremantle,"Schultz, Lachie",14,10,6,4,0,1,0,2
Fremantle,"Serong, Caleb",19,8,1,11,0,1,0,5
Fremantle,"Switkowski, Sam",10,5,2,5,0,0,0,5
Fremantle,"Taberner, Matthew",16,13,7,3,4,3,0,1
Fremantle,"Tucker, Darcy",17,11,5,6,0,0,0,4
Fremantle,"Walters, Michael",13,7,6,6,1,1,0,4
Fremantle,"Watson, Tobe",13,8,6,5,0,0,0,2
Fremantle,"Wilson, Nathan",17,15,4,2,0,0,0,0
Fremantle,"Acres, Blake",18,9,4,9,0,0,0,3
Fremantle,"Aish, James",14,11,3,3,0,1,0,2
Fremantle,"Blakely, Connor",8,3,2,5,0,0,0,2
Fremantle,"Cerra, Adam",25,15,6,10,1,0,0,0
Fremantle,"Colyer, Travis",13,9,2,4,0,1,0,4
Fremantle,"Cox, Brennan",9,6,6,3,0,0,0,0
Fremantle,"Crowden, Mitch",12,7,5,5,0,1,0,3
Fremantle,"Darcy, Sean",12,5,3,7,0,0,51,3
Fremantle,"Fyfe, Nat",27,11,3,16,1,0,0,5
Fremantle,"Henry, Liam",10,6,3,4,0,1,0,2
Fremantle,"Lobb, Rory",18,12,9,6,4,0,7,3
Fremantle,"Logue, Griffin",19,15,7,4,0,0,0,1
Fremantle,"Mundy, David",29,13,0,16,0,2,0,3
Fremantle,"Ryan, Luke",19,15,9,4,0,0,0,3
Fremantle,"Schultz, Lachie",16,13,8,3,2,3,0,5
Fremantle,"Serong, Caleb",19,13,1,6,1,0,0,3
Fremantle,"Switkowski, Sam",15,10,4,5,0,1,0,5
Fremantle,"Taberner, Matthew",5,4,1,1,1,1,0,0
Fremantle,"Treacy, Josh",8,6,4,2,1,1,0,1
Fremantle,"Tucker, Darcy",19,13,5,6,0,0,0,1
Fremantle,"Walters, Michael",23,17,8,6,1,0,0,1
Fremantle,"Watson, Tobe",11,8,2,3,0,0,0,0
Fremantle,"Wilson, Nathan",15,14,8,1,0,0,0,1
Fremantle,"Acres, Blake",16,8,1,8,0,0,1,4
Fremantle,"Aish, James",25,11,6,14,0,1,0,3
Fremantle,"Blakely, Connor",11,3,1,8,0,0,0,0
Fremantle,"Brayshaw, Andrew",28,14,4,14,0,0,0,3
Fremantle,"Cerra, Adam",27,13,6,14,0,1,0,0
Fremantle,"Colyer, Travis",12,9,3,3,1,2,0,1
Fremantle,"Cox, Brennan",15,8,4,7,0,0,0,1
Fremantle,"Crowden, Mitch",11,4,2,7,1,0,0,4
Fremantle,"Darcy, Sean",17,6,4,11,0,0,24,4
Fremantle,"Duman, Taylin",10,4,3,6,0,0,0,4
Fremantle,"Fyfe, Nat",20,9,3,11,2,1,0,6
Fremantle,"Henry, Liam",9,7,2,2,1,1,0,0
Fremantle,"Lobb, Rory",10,7,2,3,1,2,3,0
Fremantle,"Mundy, David",25,10,3,15,1,1,0,3
Fremantle,"Ryan, Luke",21,15,3,6,0,0,0,0
Fremantle,"Schultz, Lachie",11,8,5,3,1,0,0,1
Fremantle,"Serong, Caleb",16,5,1,11,0,0,0,1
Fremantle,"Switkowski, Sam",6,3,0,3,0,0,0,1
Fremantle,"Treacy, Josh",7,6,3,1,0,0,3,2
Fremantle,"Tucker, Darcy",20,9,4,11,0,0,0,1
Fremantle,"Walters, Michael",13,10,3,3,1,2,0,3
Fremantle,"Watson, Tobe",10,6,4,4,0,0,0,0
Fremantle,"Wilson, Nathan",12,7,2,5,0,0,0,0
Fremantle,"Acres, Blake",17,8,2,9,0,0,5,3
Fremantle,"Aish, James",21,13,5,8,0,0,0,1
Fremantle,"Blakely, Connor",10,5,3,5,0,0,0,1
Fremantle,"Brayshaw, Andrew",27,18,4,9,1,1,0,3
Fremantle,"Cerra, Adam",21,13,5,8,0,0,0,2
Fremantle,"Colyer, Travis",10,8,4,2,0,0,0,5
Fremantle,"Cox, Brennan",13,7,7,6,0,0,0,1
Fremantle,"Crowden, Mitch",13,8,3,5,1,1,0,1
Fremantle,"Darcy, Sean",13,6,6,7,0,0,36,2
Fremantle,"Duman, Taylin",14,9,4,5,0,0,0,2
Fremantle,"Fyfe, Nat",17,7,3,10,0,0,0,0
Fremantle,"Henry, Liam",8,6,1,2,1,0,0,2
Fremantle,"Lobb, Rory",10,8,5,2,1,2,5,1
Fremantle,"Logue, Griffin",10,7,5,3,0,0,0,0
Fremantle,"Mundy, David",30,13,7,17,0,1,0,4
Fremantle,"Ryan, Luke",25,23,10,2,0,0,0,1
Fremantle,"Schultz, Lachie",11,8,4,3,0,0,0,1
Fremantle,"Serong, Caleb",18,11,1,7,1,0,0,9
Fremantle,"Treacy, Josh",10,6,4,4,3,1,0,2
Fremantle,"Tucker, Darcy",21,10,4,11,0,1,0,3
Fremantle,"Walters, Michael",10,5,2,5,1,3,0,3
Fremantle,"Watson, Tobe",4,1,1,3,0,0,0,0
Fremantle,"Wilson, Nathan",20,15,6,5,0,0,0,3
Fremantle,"Acres, Blake",27,14,8,13,0,0,1,4
Fremantle,"Aish, James",31,18,7,13,0,0,0,4
Fremantle,"Bewley, Brett",16,10,4,6,0,0,0,5
Fremantle,"Blakely, Connor",0,0,0,0,0,0,0,0
Fremantle,"Brayshaw, Andrew",29,16,9,13,0,1,0,5
Fremantle,"Cerra, Adam",21,10,4,11,0,1,0,6
Fremantle,"Colyer, Travis",16,11,6,5,1,1,0,2
Fremantle,"Conca, Reece",17,12,8,5,0,0,0,5
Fremantle,"Crowden, Mitch",4,3,2,1,0,0,0,2
Fremantle,"Darcy, Sean",17,13,5,4,1,1,40,6
Fremantle,"Duman, Taylin",22,14,9,8,0,0,0,1
Fremantle,"Henry, Liam",8,7,3,1,1,0,0,2
Fremantle,"Lobb, Rory",17,12,9,5,2,1,0,1
Fremantle,"Mundy, David",20,11,4,9,2,0,0,3
Fremantle,"Pearce, Alex",16,10,7,6,0,0,0,0
Fremantle,"Ryan, Luke",29,21,10,8,0,0,0,2
Fremantle,"Schultz, Lachie",11,7,4,4,1,0,0,1
Fremantle,"Serong, Caleb",19,11,6,8,0,0,0,5
Fremantle,"Treacy, Josh",15,9,7,6,2,3,0,2
Fremantle,"Tucker, Darcy",25,19,13,6,0,0,0,2
Fremantle,"Walker, Brandon",13,8,4,5,0,0,0,3
Fremantle,"Walters, Michael",15,7,3,8,1,1,0,3
Fremantle,"Western, Joel",4,3,1,1,0,0,0,2
Fremantle,"Acres, Blake",21,11,4,10,0,0,0,5
Fremantle,"Aish, James",21,14,6,7,0,0,0,0
Fremantle,"Bewley, Brett",17,10,3,7,2,0,0,1
Fremantle,"Brayshaw, Andrew",24,13,5,11,1,0,0,2
Fremantle,"Cerra, Adam",19,11,2,8,0,0,0,1
Fremantle,"Colyer, Travis",19,10,4,9,0,1,0,2
Fremantle,"Crowden, Mitch",7,4,2,3,1,0,0,0
Fremantle,"Darcy, Sean",18,7,3,11,0,1,19,0
Fremantle,"Henry, Liam",8,6,1,2,2,0,0,2
Fremantle,"Lobb, Rory",17,11,8,6,3,2,1,0
Fremantle,"Logue, Griffin",12,7,6,5,0,0,0,0
Fremantle,"Mundy, David",28,8,4,20,0,0,0,6
Fremantle,"Pearce, Alex",11,7,2,4,0,0,0,0
Fremantle,"Ryan, Luke",17,15,9,2,0,0,0,3
Fremantle,"Schultz, Lachie",13,10,7,3,3,1,0,3
Fremantle,"Serong, Caleb",16,8,1,8,0,0,0,0
Fremantle,"Switkowski, Sam",14,6,1,8,1,0,0,1
Fremantle,"Taberner, Matthew",4,1,1,3,0,0,0,0
Fremantle,"Treacy, Josh",4,3,2,1,1,1,0,3
Fremantle,"Tucker, Darcy",14,8,3,6,0,0,0,1
Fremantle,"Walker, Brandon",10,8,4,2,0,1,0,0
Fremantle,"Walters, Michael",12,6,1,6,0,0,0,2
Fremantle,"Wilson, Nathan",20,14,6,6,0,0,0,2
Fremantle,"Acres, Blake",16,9,1,7,0,0,1,1
Fremantle,"Aish, James",14,9,6,5,0,0,0,1
Fremantle,"Bewley, Brett",10,5,1,5,0,0,0,2
Fremantle,"Brayshaw, Andrew",28,15,8,13,2,0,0,5
Fremantle,"Cerra, Adam",24,15,5,9,0,2,0,4
Fremantle,"Colyer, Travis",4,4,1,0,0,1,0,0
Fremantle,"Crowden, Mitch",0,0,0,0,0,0,0,0
Fremantle,"Darcy, Sean",20,11,8,9,1,1,40,0
Fremantle,"Fyfe, Nat",20,10,3,10,0,1,0,4
Fremantle,"Henry, Liam",10,8,2,2,1,2,0,0
Fremantle,"Lobb, Rory",10,5,4,5,1,1,0,1
Fremantle,"Logue, Griffin",11,5,5,6,0,0,0,1
Fremantle,"Mundy, David",21,11,4,10,0,0,0,4
Fremantle,"Pearce, Alex",14,8,5,6,0,0,0,0
Fremantle,"Ryan, Luke",25,20,9,5,0,0,0,0
Fremantle,"Schultz, Lachie",4,4,2,0,0,2,0,2
Fremantle,"Serong, Caleb",19,15,1,4,0,1,0,2
Fremantle,"Switkowski, Sam",9,6,2,3,1,1,0,4
Fremantle,"Treacy, Josh",6,3,3,3,1,0,0,1
Fremantle,"Tucker, Darcy",21,12,6,9,0,0,0,0
Fremantle,"Walker, Brandon",11,9,5,2,0,0,0,1
Fremantle,"Walters, Michael",9,8,2,1,1,1,0,2
Fremantle,"Wilson, Nathan",17,14,5,3,0,0,0,1
Fremantle,"Acres, Blake",14,8,3,6,1,0,0,1
Fremantle,"Aish, James",16,11,1,5,0,0,0,2
Fremantle,"Banfield, Bailey",13,8,3,5,3,0,0,2
Fremantle,"Blakely, Connor",0,0,0,0,0,0,0,0
Fremantle,"Brayshaw, Andrew",32,12,9,20,0,0,0,3
Fremantle,"Cerra, Adam",26,16,4,10,0,1,0,0
Fremantle,"Colyer, Travis",8,7,3,1,0,0,0,0
Fremantle,"Darcy, Sean",25,11,9,14,0,0,26,2
Fremantle,"Fyfe, Nat",31,12,6,19,1,1,0,3
Fremantle,"Henry, Liam",9,9,1,0,0,1,0,1
Fremantle,"Lobb, Rory",13,10,8,3,4,3,5,2
Fremantle,"Logue, Griffin",13,8,9,5,0,0,0,3
Fremantle,"Mundy, David",30,18,4,12,2,0,0,3
Fremantle,"Pearce, Alex",10,4,1,6,0,0,0,1
Fremantle,"Ryan, Luke",23,19,6,4,0,0,0,1
Fremantle,"Schultz, Lachie",15,7,4,8,0,1,0,4
Fremantle,"Serong, Caleb",30,15,3,15,0,0,0,4
Fremantle,"Switkowski, Sam",14,9,6,5,2,0,0,0
Fremantle,"Treacy, Josh",11,8,7,3,2,2,0,6
Fremantle,"Tucker, Darcy",9,5,1,4,0,0,0,1
Fremantle,"Walker, Brandon",9,4,2,5,0,0,0,1
Fremantle,"Walters, Michael",21,13,4,8,1,0,0,1
Fremantle,"Wilson, Nathan",16,9,2,7,0,1,0,1
Fremantle,"Acres, Blake",13,7,4,6,0,0,1,4
Fremantle,"Aish, James",17,10,2,7,0,0,0,2
Fremantle,"Banfield, Bailey",2,1,0,1,0,0,0,4
Fremantle,"Brayshaw, Andrew",21,14,8,7,1,0,0,3
Fremantle,"Cerra, Adam",18,11,5,7,0,1,0,3
Fremantle,"Colyer, Travis",14,11,4,3,1,1,0,1
Fremantle,"Darcy, Sean",18,8,2,10,0,0,37,4
Fremantle,"Fyfe, Nat",19,11,1,8,0,1,0,5
Fremantle,"Henry, Liam",7,4,1,3,0,0,0,0
Fremantle,"Hughes, Ethan",13,7,1,6,0,0,0,0
Fremantle,"Lobb, Rory",6,3,2,3,0,1,0,0
Fremantle,"Logue, Griffin",9,4,1,5,0,0,0,0
Fremantle,"Mundy, David",13,6,1,7,0,1,0,1
Fremantle,"Pearce, Alex",6,4,0,2,0,0,1,1
Fremantle,"Ryan, Luke",19,16,6,3,0,0,0,3
Fremantle,"Schultz, Lachie",11,4,2,7,0,0,0,3
Fremantle,"Serong, Caleb",20,10,4,10,0,1,0,1
Fremantle,"Switkowski, Sam",14,7,5,7,0,1,0,0
Fremantle,"Treacy, Josh",6,3,1,3,0,1,0,3
Fremantle,"Tucker, Darcy",15,9,8,6,0,0,0,3
Fremantle,"Walker, Brandon",5,4,1,1,0,0,0,1
Fremantle,"Walters, Michael",17,13,3,4,1,1,0,0
Fremantle,"Wilson, Nathan",16,11,3,5,0,0,0,1
Fremantle,"Aish, James",16,9,5,7,0,0,0,1
Fremantle,"Banfield, Bailey",8,6,3,2,0,1,0,2
Fremantle,"Blakely, Connor",9,6,3,3,0,1,0,0
Fremantle,"Brayshaw, Andrew",34,14,6,20,0,0,0,5
Fremantle,"Cerra, Adam",30,19,9,11,2,0,0,3
Fremantle,"Colyer, Travis",11,9,5,2,0,0,0,1
Fremantle,"Crowden, Mitch",16,7,7,9,1,1,0,0
Fremantle,"Darcy, Sean",19,10,6,9,1,3,22,1
Fremantle,"Fyfe, Nat",15,4,1,11,0,1,0,1
Fremantle,"Henry, Liam",10,5,0,5,0,0,0,0
Fremantle,"Logue, Griffin",15,8,4,7,0,0,0,2
Fremantle,"Meek, Lloyd",9,3,2,6,0,0,17,1
Fremantle,"Mundy, David",17,7,2,10,1,0,0,0
Fremantle,"Pearce, Alex",4,2,2,2,0,0,0,2
Fremantle,"Ryan, Luke",15,13,5,2,0,0,0,2
Fremantle,"Schultz, Lachie",7,5,1,2,1,2,0,4
Fremantle,"Serong, Caleb",26,15,5,11,0,0,0,3
Fremantle,"Taberner, Matthew",8,7,4,1,2,0,0,1
Fremantle,"Tucker, Darcy",20,9,1,11,0,0,0,1
Fremantle,"Walker, Brandon",9,5,3,4,0,0,0,2
Fremantle,"Walters, Michael",9,8,5,1,0,0,0,2
Fremantle,"Wilson, Nathan",24,20,7,4,0,0,0,1
Fremantle,"Young, Hayden",13,8,6,5,0,0,0,1
Fremantle,"Aish, James",19,11,4,8,0,0,0,4
Fremantle,"Banfield, Bailey",3,1,1,2,0,1,0,1
Fremantle,"Blakely, Connor",17,9,7,8,0,0,0,1
Fremantle,"Brayshaw, Andrew",39,17,5,22,0,0,0,12
Fremantle,"Cerra, Adam",33,21,8,12,0,1,0,6
Fremantle,"Colyer, Travis",14,12,5,2,1,3,0,0
Fremantle,"Crowden, Mitch",13,5,2,8,0,0,0,4
Fremantle,"Darcy, Sean",17,8,4,9,0,2,18,4
Fremantle,"Henry, Liam",13,11,5,2,0,0,0,1
Fremantle,"Logue, Griffin",10,8,3,2,0,0,0,1
Fremantle,"Meek, Lloyd",6,2,1,4,0,1,9,1
Fremantle,"Mundy, David",29,11,2,18,0,0,0,3
Fremantle,"Ryan, Luke",27,26,7,1,0,0,0,1
Fremantle,"Schultz, Lachie",10,5,3,5,2,0,0,3
Fremantle,"Serong, Caleb",20,13,1,7,1,0,0,3
Fremantle,"Taberner, Matthew",12,11,5,1,3,1,0,1
Fremantle,"Treacy, Josh",6,2,1,4,0,0,1,0
Fremantle,"Tucker, Darcy",13,6,2,7,0,1,0,2
Fremantle,"Walker, Brandon",5,3,2,2,0,0,0,1
Fremantle,"Watson, Tobe",12,8,5,4,0,0,0,0
Fremantle,"Western, Joel",10,3,1,7,0,0,0,3
Fremantle,"Wilson, Nathan",16,12,3,4,0,1,0,2
Fremantle,"Young, Hayden",23,11,3,12,0,0,0,1
Fremantle,"Aish, James",20,9,4,11,0,0,0,2
Fremantle,"Bewley, Brett",9,6,1,3,0,0,0,0
Fremantle,"Blakely, Connor",14,8,3,6,0,0,0,2
Fremantle,"Brayshaw, Andrew",25,8,3,17,0,0,0,1
Fremantle,"Cerra, Adam",24,15,6,9,0,0,0,4
Fremantle,"Colyer, Travis",16,11,4,5,3,1,0,2
Fremantle,"Crowden, Mitch",8,3,3,5,0,0,0,1
Fremantle,"Darcy, Sean",17,7,6,10,1,1,29,1
Fremantle,"Henry, Liam",10,8,4,2,1,0,0,1
Fremantle,"Logue, Griffin",6,4,3,2,0,0,0,0
Fremantle,"Meek, Lloyd",10,2,2,8,1,0,13,1
Fremantle,"Mundy, David",28,11,3,17,0,0,0,3
Fremantle,"Pearce, Alex",12,8,5,4,0,0,0,0
Fremantle,"Ryan, Luke",17,15,6,2,0,0,0,0
Fremantle,"Schultz, Lachie",8,5,3,3,0,1,0,2
Fremantle,"Serong, Caleb",30,17,7,13,0,0,0,5
Fremantle,"Taberner, Matthew",11,10,5,1,1,0,0,2
Fremantle,"Treacy, Josh",13,6,6,7,1,0,0,1
Fremantle,"Tucker, Darcy",16,5,3,11,0,0,0,1
Fremantle,"Walker, Brandon",15,10,6,5,0,0,0,3
Fremantle,"Western, Joel",4,2,0,2,0,0,0,0
Fremantle,"Wilson, Nathan",6,5,2,1,0,0,0,1
Fremantle,"Young, Hayden",19,16,10,3,0,0,0,2
Fremantle,"Aish, James",20,11,3,9,0,0,0,5
Fremantle,"Banfield, Bailey",19,10,5,9,0,0,0,3
Fremantle,"Bewley, Brett",9,6,4,3,0,0,0,4
Fremantle,"Blakely, Connor",6,4,3,2,0,1,0,0
Fremantle,"Cerra, Adam",21,14,4,7,1,1,0,2
Fremantle,"Colyer, Travis",9,6,3,3,1,1,0,4
Fremantle,"Crowden, Mitch",16,6,0,10,0,1,0,1
Fremantle,"Darcy, Sean",17,10,3,7,1,0,29,4
Fremantle,"Henry, Liam",8,4,2,4,0,0,0,1
Fremantle,"Logue, Griffin",12,10,7,2,0,0,0,1
Fremantle,"Meek, Lloyd",7,2,2,5,0,0,8,2
Fremantle,"Mundy, David",28,11,3,17,1,0,0,6
Fremantle,"Pearce, Alex",9,4,2,5,0,0,0,4
Fremantle,"Ryan, Luke",26,22,10,4,0,0,0,2
Fremantle,"Schultz, Lachie",10,7,6,3,2,2,0,4
Fremantle,"Serong, Caleb",31,18,2,13,2,0,0,5
Fremantle,"Switkowski, Sam",13,5,1,8,0,0,0,2
Fremantle,"Taberner, Matthew",13,7,7,6,3,0,0,1
Fremantle,"Treacy, Josh",5,3,2,2,1,0,0,2
Fremantle,"Tucker, Darcy",17,11,2,6,0,0,0,3
Fremantle,"Walker, Brandon",13,10,5,3,0,1,0,1
Fremantle,"Watson, Tobe",13,9,8,4,0,0,0,3
Fremantle,"Young, Hayden",16,13,11,3,0,0,0,2
Fremantle,"Acres, Blake",16,11,2,5,0,0,0,0
Fremantle,"Aish, James",19,7,1,12,0,0,0,0
Fremantle,"Banfield, Bailey",11,3,0,8,1,0,0,2
Fremantle,"Bewley, Brett",14,6,3,8,0,0,0,0
Fremantle,"Brayshaw, Andrew",29,16,2,13,0,1,0,6
Fremantle,"Colyer, Travis",14,7,3,7,0,2,0,1
Fremantle,"Crowden, Mitch",21,9,2,12,1,1,0,3
Fremantle,"Darcy, Sean",10,3,1,7,0,0,16,1
Fremantle,"Henry, Liam",15,8,4,7,1,1,0,1
Fremantle,"Logue, Griffin",18,8,7,10,0,0,0,1
Fremantle,"Meek, Lloyd",11,4,1,7,0,1,27,3
Fremantle,"Mundy, David",24,11,2,13,0,0,0,4
Fremantle,"Pearce, Alex",12,8,3,4,0,0,0,2
Fremantle,"Ryan, Luke",23,17,7,6,0,0,0,2
Fremantle,"Serong, Caleb",35,15,7,20,0,1,0,2
Fremantle,"Switkowski, Sam",5,1,0,4,1,0,0,5
Fremantle,"Taberner, Matthew",12,7,6,5,1,1,0,0
Fremantle,"Treacy, Josh",4,3,2,1,1,0,0,2
Fremantle,"Tucker, Darcy",7,5,1,2,0,0,0,3
Fremantle,"Walker, Brandon",14,11,4,3,0,1,0,4
Fremantle,"Watson, Tobe",16,6,4,10,0,0,0,3
Fremantle,"Western, Joel",7,6,3,1,0,0,0,1
Fremantle,"Young, Hayden",17,8,5,9,0,0,0,8
Gold Coast,"Anderson, Noah",19,13,3,6,0,0,0,3
Gold Coast,"Ballard, Charlie",21,17,12,4,0,0,0,0
Gold Coast,"Bowes, Jack",30,28,14,2,0,0,0,2
Gold Coast,"Brodie, Will",18,9,2,9,0,1,0,0
Gold Coast,"Budarick, Connor",12,7,6,5,0,0,0,1
Gold Coast,"Collins, Sam",18,15,10,3,0,0,0,2
Gold Coast,"Day, Sam",10,3,2,7,0,2,0,1
Gold Coast,"Ellis, Brandon",19,14,9,5,0,0,0,2
Gold Coast,"Greenwood, Hugh",10,7,2,3,0,0,0,5
Gold Coast,"Holman, Nick",9,4,3,5,1,0,0,1
Gold Coast,"King, Ben",12,9,7,3,3,1,0,0
Gold Coast,"Lemmens, Sean",16,11,7,5,0,0,0,2
Gold Coast,"Lukosius, Jack",23,20,11,3,0,2,0,1
Gold Coast,"Macpherson, Darcy",17,11,6,6,0,0,0,0
Gold Coast,"Markov, Oleg",20,17,14,3,0,0,0,2
Gold Coast,"Miller, Touk",20,11,1,9,1,1,0,2
Gold Coast,"Powell, Wil",18,11,5,7,0,0,0,2
Gold Coast,"Rankine, Izak",11,4,3,7,0,1,0,1
Gold Coast,"Rowell, Matt",4,3,0,1,0,0,0,1
Gold Coast,"Sexton, Alex",12,9,6,3,1,1,0,1
Gold Coast,"Swallow, David",29,14,5,15,1,1,0,3
Gold Coast,"Weller, Lachie",21,13,6,8,1,0,0,3
Gold Coast,"Witts, Jarrod",12,6,3,6,0,0,31,4
Gold Coast,"Ainsworth, Ben",18,14,4,4,1,2,0,0
Gold Coast,"Anderson, Noah",35,21,9,14,0,1,0,0
Gold Coast,"Ballard, Charlie",16,12,7,4,0,0,0,1
Gold Coast,"Bowes, Jack",31,22,3,9,0,0,0,1
Gold Coast,"Brodie, Will",18,7,2,11,0,0,0,2
Gold Coast,"Budarick, Connor",16,12,5,4,0,0,0,3
Gold Coast,"Collins, Sam",14,8,5,6,0,0,0,3
Gold Coast,"Day, Sam",7,5,4,2,1,0,2,0
Gold Coast,"Ellis, Brandon",33,22,8,11,0,1,0,3
Gold Coast,"Greenwood, Hugh",20,13,0,7,0,1,2,10
Gold Coast,"Holman, Nick",15,10,7,5,0,1,0,4
Gold Coast,"King, Ben",8,7,4,1,3,1,0,2
Gold Coast,"Lemmens, Sean",15,13,4,2,0,0,0,3
Gold Coast,"Lukosius, Jack",21,16,8,5,1,0,0,1
Gold Coast,"Macpherson, Darcy",24,14,5,10,0,2,0,6
Gold Coast,"Markov, Oleg",20,13,7,7,1,0,0,0
Gold Coast,"Miller, Touk",31,22,5,9,0,1,0,8
Gold Coast,"Powell, Wil",8,8,5,0,0,0,0,4
Gold Coast,"Rankine, Izak",16,10,6,6,3,2,0,2
Gold Coast,"Sexton, Alex",8,5,4,3,2,1,0,1
Gold Coast,"Swallow, David",22,9,4,13,1,0,0,7
Gold Coast,"Weller, Lachie",25,19,6,6,1,0,0,4
Gold Coast,"Witts, Jarrod",19,10,3,9,0,0,30,4
Gold Coast,"Ainsworth, Ben",7,4,1,3,0,2,0,3
Gold Coast,"Anderson, Noah",26,13,3,13,0,0,0,0
Gold Coast,"Ballard, Charlie",17,14,10,3,0,0,0,2
Gold Coast,"Bowes, Jack",24,20,8,4,0,0,0,3
Gold Coast,"Brodie, Will",8,3,1,5,0,0,0,2
Gold Coast,"Burgess, Chris",9,7,5,2,2,1,8,4
Gold Coast,"Collins, Sam",10,8,6,2,0,0,0,2
Gold Coast,"Ellis, Brandon",25,16,7,9,1,0,0,4
Gold Coast,"Greenwood, Hugh",23,16,2,7,0,1,0,13
Gold Coast,"Harbrow, Jarrod",16,14,8,2,0,0,0,1
Gold Coast,"Holman, Nick",3,3,1,0,2,0,0,0
Gold Coast,"King, Ben",6,6,4,0,4,0,0,1
Gold Coast,"Lemmens, Sean",15,11,5,4,0,0,0,3
Gold Coast,"Lukosius, Jack",19,18,9,1,0,1,0,2
Gold Coast,"Macpherson, Darcy",18,11,5,7,1,1,0,5
Gold Coast,"Markov, Oleg",15,13,7,2,0,1,0,1
Gold Coast,"Miller, Touk",22,10,2,12,0,0,0,9
Gold Coast,"Powell, Wil",14,9,4,5,0,0,0,2
Gold Coast,"Rankine, Izak",13,6,1,7,1,2,0,1
Gold Coast,"Sexton, Alex",5,5,2,0,0,1,0,0
Gold Coast,"Swallow, David",12,8,4,4,0,0,0,3
Gold Coast,"Weller, Lachie",12,7,6,5,1,0,0,9
Gold Coast,"Witts, Jarrod",10,8,3,2,0,1,26,0
Gold Coast,"Ainsworth, Ben",14,12,6,2,1,0,0,4
Gold Coast,"Anderson, Noah",30,19,7,11,0,0,0,4
Gold Coast,"Ballard, Charlie",7,6,2,1,0,0,0,4
Gold Coast,"Bowes, Jack",34,31,9,3,0,0,0,1
Gold Coast,"Burgess, Chris",10,5,1,5,1,0,5,3
Gold Coast,"Collins, Sam",7,4,1,3,0,0,0,1
Gold Coast,"Ellis, Brandon",26,20,8,6,1,0,0,2
Gold Coast,"Flanders, Sam",4,3,3,1,0,0,0,2
Gold Coast,"Graham, Caleb",4,1,1,3,0,0,12,0
Gold Coast,"Greenwood, Hugh",27,18,0,9,1,1,2,10
Gold Coast,"Harbrow, Jarrod",5,4,2,1,0,0,0,1
Gold Coast,"Holman, Nick",13,8,3,5,0,1,0,3
Gold Coast,"King, Ben",8,5,4,3,1,1,0,2
Gold Coast,"Lemmens, Sean",7,6,0,1,0,0,0,1
Gold Coast,"Lukosius, Jack",13,11,5,2,0,0,0,1
Gold Coast,"Macpherson, Darcy",15,12,3,3,0,0,0,9
Gold Coast,"Markov, Oleg",15,11,3,4,0,0,0,4
Gold Coast,"Miller, Touk",28,14,5,14,0,0,1,13
Gold Coast,"Powell, Wil",21,12,3,9,0,0,0,1
Gold Coast,"Rankine, Izak",14,9,8,5,0,0,0,3
Gold Coast,"Sexton, Alex",11,8,3,3,2,0,0,0
Gold Coast,"Swallow, David",23,16,8,7,0,1,0,6
Gold Coast,"Weller, Lachie",25,15,9,10,1,1,0,3
Gold Coast,"Ainsworth, Ben",17,12,7,5,0,1,0,2
Gold Coast,"Anderson, Noah",18,13,5,5,0,0,0,3
Gold Coast,"Bowes, Jack",22,16,6,6,0,0,0,1
Gold Coast,"Burgess, Chris",6,4,1,2,0,0,2,2
Gold Coast,"Collins, Sam",14,9,10,5,0,0,0,1
Gold Coast,"Corbett, Josh",14,11,8,3,3,2,0,0
Gold Coast,"Ellis, Brandon",27,19,14,8,0,0,0,1
Gold Coast,"Farrar, Jy",21,15,8,6,0,0,0,2
Gold Coast,"Flanders, Sam",0,0,0,0,0,0,0,0
Gold Coast,"Graham, Caleb",8,7,4,1,0,0,14,2
Gold Coast,"Greenwood, Hugh",13,11,3,2,0,0,3,9
Gold Coast,"Harbrow, Jarrod",18,16,9,2,0,0,0,3
Gold Coast,"Holman, Nick",19,10,5,9,0,0,0,5
Gold Coast,"King, Ben",7,4,4,3,2,2,1,0
Gold Coast,"Lukosius, Jack",18,16,8,2,1,0,0,2
Gold Coast,"Macpherson, Darcy",12,8,7,4,0,1,0,1
Gold Coast,"Markov, Oleg",22,14,8,8,0,0,0,5
Gold Coast,"Miller, Touk",27,11,8,16,0,0,0,5
Gold Coast,"Powell, Wil",17,10,8,7,0,0,0,4
Gold Coast,"Rankine, Izak",11,6,2,5,1,0,0,3
Gold Coast,"Sexton, Alex",9,7,5,2,1,1,0,1
Gold Coast,"Swallow, David",17,6,7,11,0,1,0,1
Gold Coast,"Weller, Lachie",18,13,7,5,0,0,0,2
Gold Coast,"Ainsworth, Ben",20,14,9,6,3,1,0,2
Gold Coast,"Anderson, Noah",34,18,7,16,0,1,0,3
Gold Coast,"Ballard, Charlie",10,8,5,2,0,0,0,0
Gold Coast,"Bowes, Jack",18,13,4,5,0,0,0,5
Gold Coast,"Burgess, Chris",11,8,5,3,0,1,7,2
Gold Coast,"Collins, Sam",7,5,3,2,0,0,0,1
Gold Coast,"Corbett, Josh",10,8,5,2,2,0,1,1
Gold Coast,"Ellis, Brandon",24,18,8,6,0,0,0,4
Gold Coast,"Farrar, Jy",14,9,7,5,0,0,0,4
Gold Coast,"Flanders, Sam",17,7,3,10,0,1,0,3
Gold Coast,"Graham, Caleb",7,3,2,4,0,0,11,0
Gold Coast,"Greenwood, Hugh",19,12,2,7,1,1,0,7
Gold Coast,"Holman, Nick",23,14,7,9,1,0,0,13
Gold Coast,"King, Ben",14,9,7,5,5,1,1,1
Gold Coast,"Lemmens, Sean",16,12,1,4,0,0,0,4
Gold Coast,"Lukosius, Jack",21,19,8,2,0,0,0,1
Gold Coast,"Markov, Oleg",15,7,5,8,0,0,0,3
Gold Coast,"Miller, Touk",36,19,4,17,0,0,0,9
Gold Coast,"Powell, Wil",14,10,5,4,0,0,0,4
Gold Coast,"Rankine, Izak",18,9,3,9,2,0,0,5
Gold Coast,"Sexton, Alex",0,0,0,0,0,0,0,0
Gold Coast,"Swallow, David",31,18,7,13,0,1,0,3
Gold Coast,"Weller, Lachie",17,6,7,11,1,0,0,4
Gold Coast,"Ainsworth, Ben",12,8,6,4,0,0,0,0
Gold Coast,"Anderson, Noah",16,12,4,4,0,0,0,6
Gold Coast,"Ballard, Charlie",18,13,7,5,0,0,0,2
Gold Coast,"Bowes, Jack",30,19,7,11,0,0,0,3
Gold Coast,"Burgess, Chris",11,7,4,4,1,0,7,1
Gold Coast,"Collins, Sam",23,15,12,8,0,0,0,0
Gold Coast,"Corbett, Josh",16,14,11,2,4,2,1,1
Gold Coast,"Ellis, Brandon",35,26,16,9,1,0,0,5
Gold Coast,"Farrar, Jy",13,6,3,7,0,0,0,0
Gold Coast,"Flanders, Sam",11,6,6,5,0,0,0,5
Gold Coast,"Graham, Caleb",10,9,4,1,0,1,6,1
Gold Coast,"Greenwood, Hugh",26,14,5,12,1,0,0,10
Gold Coast,"Holman, Nick",12,5,0,7,0,0,0,3
Gold Coast,"King, Ben",10,8,8,2,2,1,0,1
Gold Coast,"Lemmens, Sean",22,16,6,6,0,0,0,2
Gold Coast,"Lukosius, Jack",17,13,5,4,0,0,0,1
Gold Coast,"Markov, Oleg",20,14,8,6,0,0,0,0
Gold Coast,"Miller, Touk",34,18,8,16,0,0,0,5
Gold Coast,"Powell, Wil",22,14,10,8,0,0,0,0
Gold Coast,"Rankine, Izak",11,7,3,4,1,0,0,4
Gold Coast,"Sexton, Alex",0,0,0,0,0,0,0,0
Gold Coast,"Swallow, David",15,8,4,7,2,0,0,5
Gold Coast,"Weller, Lachie",19,11,9,8,0,1,0,3
Gold Coast,"Ainsworth, Ben",16,11,7,5,0,1,0,2
Gold Coast,"Anderson, Noah",21,10,3,11,0,0,0,1
Gold Coast,"Ballard, Charlie",13,11,6,2,0,0,0,1
Gold Coast,"Bowes, Jack",23,17,5,6,0,1,0,1
Gold Coast,"Burgess, Chris",11,7,7,4,0,1,5,0
Gold Coast,"Collins, Sam",10,8,6,2,0,0,0,4
Gold Coast,"Corbett, Josh",8,4,5,4,1,0,2,1
Gold Coast,"Ellis, Brandon",19,14,6,5,0,1,0,1
Gold Coast,"Farrar, Jy",15,10,8,5,0,0,0,1
Gold Coast,"Flanders, Sam",14,6,2,8,0,0,0,4
Gold Coast,"Graham, Caleb",6,2,3,4,0,0,8,1
Gold Coast,"Greenwood, Hugh",20,10,3,10,0,1,0,6
Gold Coast,"Holman, Nick",14,8,6,6,1,0,0,6
Gold Coast,"King, Ben",9,5,3,4,3,1,0,1
Gold Coast,"Lemmens, Sean",19,13,4,6,0,0,0,1
Gold Coast,"Lukosius, Jack",18,16,12,2,0,1,0,0
Gold Coast,"Markov, Oleg",23,16,6,7,0,2,0,5
Gold Coast,"Miller, Touk",33,20,7,13,0,0,0,3
Gold Coast,"Powell, Wil",24,15,9,9,0,0,0,2
Gold Coast,"Rankine, Izak",16,6,2,10,1,0,0,3
Gold Coast,"Sexton, Alex",0,0,0,0,0,0,0,0
Gold Coast,"Swallow, David",28,15,5,13,0,1,0,13
Gold Coast,"Weller, Lachie",15,7,5,8,1,1,0,3
Gold Coast,"Ainsworth, Ben",12,7,2,5,1,1,0,2
Gold Coast,"Anderson, Noah",26,9,5,17,0,0,0,2
Gold Coast,"Atkins, Rory",11,4,1,7,1,0,0,2
Gold Coast,"Ballard, Charlie",15,11,6,4,0,0,0,1
Gold Coast,"Bowes, Jack",9,9,3,0,0,0,0,2
Gold Coast,"Burgess, Chris",6,4,3,2,0,0,6,0
Gold Coast,"Collins, Sam",7,7,4,0,0,0,0,1
Gold Coast,"Corbett, Josh",8,7,5,1,1,0,0,1
Gold Coast,"Ellis, Brandon",23,11,6,12,0,0,0,1
Gold Coast,"Farrar, Jy",6,4,3,2,0,0,0,4
Gold Coast,"Flanders, Sam",16,6,4,10,1,0,0,4
Gold Coast,"Graham, Caleb",10,7,5,3,0,0,10,0
Gold Coast,"Greenwood, Hugh",20,8,2,12,1,0,0,3
Gold Coast,"King, Ben",8,6,5,2,2,3,1,1
Gold Coast,"Lemmens, Sean",8,7,1,1,0,0,0,1
Gold Coast,"Lukosius, Jack",18,16,7,2,0,1,0,1
Gold Coast,"Macpherson, Darcy",4,3,1,1,0,0,0,1
Gold Coast,"Markov, Oleg",19,11,4,8,0,1,0,3
Gold Coast,"Powell, Wil",9,8,3,1,0,0,0,3
Gold Coast,"Rankine, Izak",5,4,3,1,0,0,0,3
Gold Coast,"Rosas, Malcolm",6,5,2,1,0,1,0,0
Gold Coast,"Swallow, David",29,13,2,16,0,0,0,4
Gold Coast,"Weller, Lachie",20,10,4,10,0,0,0,3
Gold Coast,"Anderson, Noah",14,9,2,5,0,1,0,6
Gold Coast,"Atkins, Rory",9,8,3,1,0,0,0,0
Gold Coast,"Ballard, Charlie",12,9,2,3,0,0,0,0
Gold Coast,"Burgess, Chris",9,4,5,5,1,1,2,3
Gold Coast,"Collins, Sam",13,11,9,2,0,0,0,4
Gold Coast,"Corbett, Josh",2,2,1,0,1,1,0,1
Gold Coast,"Ellis, Brandon",17,12,3,5,0,0,0,4
Gold Coast,"Flanders, Sam",10,5,2,5,0,1,0,3
Gold Coast,"Graham, Caleb",6,5,4,1,0,0,5,0
Gold Coast,"Greenwood, Hugh",18,12,0,6,1,0,0,16
Gold Coast,"Holman, Nick",11,4,2,7,0,0,0,4
Gold Coast,"King, Ben",8,7,4,1,3,2,1,2
Gold Coast,"Lemmens, Sean",7,7,4,0,0,0,0,1
Gold Coast,"Lukosius, Jack",23,20,8,3,0,1,0,3
Gold Coast,"Markov, Oleg",15,8,5,7,0,0,0,1
Gold Coast,"Miller, Touk",30,14,3,16,1,1,0,5
Gold Coast,"Powell, Wil",20,11,6,9,0,0,0,3
Gold Coast,"Rankine, Izak",9,6,2,3,0,1,0,4
Gold Coast,"Rosas, Malcolm",0,0,0,0,0,0,0,0
Gold Coast,"Sexton, Alex",12,10,4,2,0,0,0,3
Gold Coast,"Smith, Zac",9,1,0,8,1,0,22,1
Gold Coast,"Swallow, David",21,9,3,12,0,0,0,6
Gold Coast,"Weller, Lachie",16,8,2,8,0,0,0,6
Gold Coast,"Anderson, Noah",15,8,4,7,0,0,0,4
Gold Coast,"Atkins, Rory",13,9,2,4,0,0,0,3
Gold Coast,"Ballard, Charlie",11,8,6,3,0,0,0,0
Gold Coast,"Burgess, Chris",8,8,4,0,1,1,5,2
Gold Coast,"Collins, Sam",10,5,3,5,0,0,0,2
Gold Coast,"Corbett, Josh",0,0,0,0,0,0,0,0
Gold Coast,"Ellis, Brandon",28,22,10,6,1,0,0,4
Gold Coast,"Farrar, Jy",7,4,3,3,0,0,0,0
Gold Coast,"Flanders, Sam",19,11,5,8,0,0,0,5
Gold Coast,"Greenwood, Hugh",18,9,2,9,0,0,0,6
Gold Coast,"Holman, Nick",12,4,4,8,1,1,0,2
Gold Coast,"King, Ben",14,9,8,5,4,1,0,2
Gold Coast,"Lemmens, Sean",20,12,4,8,0,0,0,0
Gold Coast,"Lukosius, Jack",27,23,14,4,1,1,0,2
Gold Coast,"Markov, Oleg",21,15,7,6,0,0,0,3
Gold Coast,"Miller, Touk",37,24,9,13,1,0,0,7
Gold Coast,"Powell, Wil",19,13,4,6,0,0,0,1
Gold Coast,"Rankine, Izak",19,12,6,7,4,0,0,3
Gold Coast,"Rosas, Malcolm",11,7,2,4,0,1,0,2
Gold Coast,"Sexton, Alex",19,16,10,3,3,2,0,3
Gold Coast,"Smith, Zac",8,3,1,5,0,0,23,2
Gold Coast,"Swallow, David",25,14,1,11,0,0,0,7
Gold Coast,"Weller, Lachie",19,10,2,9,1,0,0,2
Gold Coast,"Anderson, Noah",12,6,1,6,0,0,0,2
Gold Coast,"Ballard, Charlie",15,13,9,2,0,0,0,1
Gold Coast,"Bowes, Jack",16,10,2,6,0,0,0,3
Gold Coast,"Burgess, Chris",11,7,6,4,2,2,4,0
Gold Coast,"Corbett, Josh",0,0,0,0,0,0,0,0
Gold Coast,"Ellis, Brandon",25,14,6,11,0,0,0,4
Gold Coast,"Flanders, Sam",14,8,2,6,1,2,0,2
Gold Coast,"Graham, Caleb",3,1,2,2,0,0,0,0
Gold Coast,"Greenwood, Hugh",16,6,1,10,0,0,1,10
Gold Coast,"Holman, Nick",8,5,5,3,0,1,0,7
Gold Coast,"King, Ben",7,6,3,1,0,2,0,1
Gold Coast,"Lemmens, Sean",18,12,7,6,0,0,0,0
Gold Coast,"Lukosius, Jack",19,13,4,6,0,1,0,2
Gold Coast,"Markov, Oleg",15,11,7,4,0,0,0,2
Gold Coast,"Miller, Touk",31,16,7,15,1,1,0,6
Gold Coast,"Powell, Wil",26,20,7,6,0,1,0,0
Gold Coast,"Rankine, Izak",8,5,1,3,2,0,0,2
Gold Coast,"Rosas, Malcolm",2,2,1,0,0,2,0,4
Gold Coast,"Rowell, Matt",14,5,2,9,0,0,0,2
Gold Coast,"Sexton, Alex",6,3,0,3,0,0,0,4
Gold Coast,"Smith, Zac",10,5,2,5,0,0,18,4
Gold Coast,"Swallow, David",23,14,9,9,0,0,0,5
Gold Coast,"Weller, Lachie",19,12,5,7,0,0,0,0
Gold Coast,"Anderson, Noah",30,20,3,10,0,0,0,3
Gold Coast,"Ballard, Charlie",17,13,6,4,0,0,0,1
Gold Coast,"Bowes, Jack",16,10,2,6,1,1,0,2
Gold Coast,"Burgess, Chris",9,6,6,3,0,0,7,2
Gold Coast,"Day, Sam",10,4,4,6,0,0,0,2
Gold Coast,"Ellis, Brandon",16,8,3,8,0,0,0,3
Gold Coast,"Fiorini, Brayden",15,10,6,5,0,0,0,3
Gold Coast,"Flanders, Sam",16,7,3,9,0,1,0,4
Gold Coast,"Graham, Caleb",5,3,4,2,0,0,0,2
Gold Coast,"Greenwood, Hugh",16,8,3,8,0,0,0,14
Gold Coast,"Holman, Nick",12,5,4,7,0,1,0,2
Gold Coast,"King, Ben",3,3,1,0,2,0,0,0
Gold Coast,"Lemmens, Sean",12,8,2,4,0,0,0,2
Gold Coast,"Lukosius, Jack",22,21,9,1,0,0,0,3
Gold Coast,"Markov, Oleg",16,13,7,3,0,0,0,3
Gold Coast,"Miller, Touk",31,14,2,17,0,0,0,9
Gold Coast,"Powell, Wil",20,11,9,9,0,0,0,0
Gold Coast,"Rankine, Izak",17,10,2,7,0,1,0,1
Gold Coast,"Rowell, Matt",21,8,2,13,0,0,0,2
Gold Coast,"Sexton, Alex",15,12,8,3,1,0,0,1
Gold Coast,"Smith, Zac",11,2,0,9,0,0,21,4
Gold Coast,"Swallow, David",8,1,0,7,0,0,0,1
Gold Coast,"Weller, Lachie",15,6,3,9,0,0,0,2
Gold Coast,"Ainsworth, Ben",13,12,2,1,1,0,0,4
Gold Coast,"Anderson, Noah",13,7,2,6,0,0,0,3
Gold Coast,"Ballard, Charlie",8,6,4,2,0,0,0,1
Gold Coast,"Bowes, Jack",19,11,1,8,0,0,0,1
Gold Coast,"Corbett, Josh",10,8,7,2,3,0,0,1
Gold Coast,"Day, Sam",11,4,5,7,0,0,4,1
Gold Coast,"Ellis, Brandon",27,19,6,8,0,0,0,3
Gold Coast,"Fiorini, Brayden",0,0,0,0,0,0,0,0
Gold Coast,"Flanders, Sam",20,9,4,11,1,0,0,5
Gold Coast,"Graham, Caleb",11,4,3,7,0,0,0,0
Gold Coast,"Greenwood, Hugh",17,9,0,8,1,1,0,11
Gold Coast,"Holman, Nick",14,5,8,9,1,0,0,0
Gold Coast,"King, Ben",5,2,2,3,0,0,0,1
Gold Coast,"Lemmens, Sean",6,5,1,1,0,0,0,6
Gold Coast,"Lukosius, Jack",14,13,3,1,0,0,0,2
Gold Coast,"Markov, Oleg",19,12,7,7,0,0,0,2
Gold Coast,"Miller, Touk",32,19,6,13,0,0,0,5
Gold Coast,"Powell, Wil",18,11,3,7,0,0,0,5
Gold Coast,"Rankine, Izak",7,6,2,1,0,1,0,2
Gold Coast,"Rowell, Matt",14,5,1,9,0,0,0,7
Gold Coast,"Sexton, Alex",13,8,5,5,1,1,0,1
Gold Coast,"Sharp, Jeremy",20,17,8,3,0,1,0,0
Gold Coast,"Smith, Zac",13,5,3,8,1,0,14,4
Gold Coast,"Ainsworth, Ben",20,16,8,4,1,4,0,4
Gold Coast,"Ballard, Charlie",17,16,9,1,0,0,0,0
Gold Coast,"Bowes, Jack",21,20,8,1,0,0,0,3
Gold Coast,"Burgess, Chris",13,8,5,5,0,2,24,3
Gold Coast,"Collins, Sam",10,6,4,4,0,0,0,1
Gold Coast,"Corbett, Josh",7,5,5,2,1,0,0,0
Gold Coast,"Day, Sam",9,5,3,4,0,1,5,6
Gold Coast,"Ellis, Brandon",28,19,8,9,0,0,0,1
Gold Coast,"Fiorini, Brayden",25,17,7,8,0,0,0,4
Gold Coast,"Flanders, Sam",9,3,3,6,0,0,0,5
Gold Coast,"Holman, Nick",13,7,1,6,0,0,0,6
Gold Coast,"King, Ben",13,8,7,5,4,1,0,0
Gold Coast,"Lemmens, Sean",12,8,4,4,0,0,0,6
Gold Coast,"Lukosius, Jack",24,23,10,1,0,0,0,0
Gold Coast,"Macpherson, Darcy",6,4,2,2,0,0,0,1
Gold Coast,"Markov, Oleg",14,11,8,3,0,0,0,4
Gold Coast,"Miller, Touk",36,19,7,17,0,0,0,7
Gold Coast,"Powell, Wil",12,8,4,4,0,0,0,2
Gold Coast,"Rankine, Izak",9,7,1,2,1,2,0,1
Gold Coast,"Rowell, Matt",17,10,3,7,0,0,0,4
Gold Coast,"Sexton, Alex",10,6,4,4,1,1,0,0
Gold Coast,"Sharp, Jeremy",15,10,3,5,1,2,0,1
Gold Coast,"Swallow, David",21,16,6,5,1,1,0,7
Gold Coast,"Ainsworth, Ben",16,7,4,9,0,1,0,2
Gold Coast,"Atkins, Rory",9,3,1,6,1,0,0,1
Gold Coast,"Ballard, Charlie",19,18,9,1,0,0,0,1
Gold Coast,"Bowes, Jack",26,20,6,6,0,0,0,1
Gold Coast,"Burgess, Chris",17,16,4,1,1,0,38,4
Gold Coast,"Collins, Sam",9,6,5,3,0,0,0,2
Gold Coast,"Day, Sam",6,5,5,1,2,1,12,7
Gold Coast,"Ellis, Brandon",41,12,6,29,0,0,0,4
Gold Coast,"Fiorini, Brayden",25,17,3,8,0,1,0,9
Gold Coast,"Flanders, Sam",10,8,1,2,0,0,0,6
Gold Coast,"Greenwood, Hugh",0,0,0,0,0,0,0,0
Gold Coast,"Holman, Nick",11,6,5,5,0,0,0,12
Gold Coast,"King, Ben",4,2,1,2,0,0,0,0
Gold Coast,"Lemmens, Sean",7,7,1,0,0,0,0,3
Gold Coast,"Lukosius, Jack",24,22,8,2,0,0,0,3
Gold Coast,"Markov, Oleg",12,7,3,5,0,0,0,0
Gold Coast,"Miller, Touk",35,13,2,22,2,0,0,14
Gold Coast,"Powell, Wil",17,9,7,8,0,0,0,0
Gold Coast,"Rankine, Izak",11,5,2,6,0,1,0,3
Gold Coast,"Rowell, Matt",7,3,0,4,1,0,0,9
Gold Coast,"Sexton, Alex",16,13,5,3,2,1,0,2
Gold Coast,"Sharp, Jeremy",20,11,4,9,0,0,0,0
Gold Coast,"Swallow, David",27,14,4,13,1,0,0,9
Gold Coast,"Ainsworth, Ben",13,13,7,0,3,1,0,2
Gold Coast,"Anderson, Noah",23,9,1,14,0,2,0,5
Gold Coast,"Atkins, Rory",16,12,4,4,0,1,0,0
Gold Coast,"Ballard, Charlie",10,9,7,1,0,0,0,0
Gold Coast,"Bowes, Jack",22,16,3,6,0,0,0,2
Gold Coast,"Burgess, Chris",7,3,1,4,0,0,24,1
Gold Coast,"Collins, Sam",14,10,8,4,0,0,0,3
Gold Coast,"Corbett, Josh",10,9,7,1,0,2,0,2
Gold Coast,"Ellis, Brandon",3,1,1,2,0,0,0,0
Gold Coast,"Fiorini, Brayden",32,13,4,19,0,0,0,6
Gold Coast,"Flanders, Sam",9,5,0,4,0,0,0,5
Gold Coast,"Graham, Caleb",9,5,7,4,0,0,9,1
Gold Coast,"Holman, Nick",16,13,6,3,3,0,0,4
Gold Coast,"King, Ben",8,6,5,2,2,2,0,1
Gold Coast,"Lemmens, Sean",13,9,5,4,0,0,0,2
Gold Coast,"Lukosius, Jack",22,16,6,6,0,1,0,1
Gold Coast,"Miller, Touk",38,11,2,27,0,0,0,7
Gold Coast,"Powell, Wil",20,13,2,7,0,0,0,4
Gold Coast,"Rankine, Izak",10,4,3,6,0,0,0,2
Gold Coast,"Rowell, Matt",16,3,1,13,0,0,0,4
Gold Coast,"Sexton, Alex",17,14,4,3,3,4,0,2
Gold Coast,"Sharp, Jeremy",30,24,10,6,0,0,0,2
Gold Coast,"Swallow, David",20,12,5,8,0,0,0,3
Gold Coast,"Ainsworth, Ben",15,10,4,5,1,1,0,2
Gold Coast,"Anderson, Noah",15,8,4,7,0,1,0,4
Gold Coast,"Atkins, Rory",9,3,1,6,0,0,0,2
Gold Coast,"Ballard, Charlie",9,7,7,2,0,0,0,3
Gold Coast,"Bowes, Jack",20,14,4,6,0,0,0,2
Gold Coast,"Brodie, Will",20,6,2,14,0,0,0,4
Gold Coast,"Burgess, Chris",7,4,2,3,0,1,13,3
Gold Coast,"Collins, Sam",8,3,3,5,0,0,0,0
Gold Coast,"Corbett, Josh",16,8,7,8,3,0,0,2
Gold Coast,"Fiorini, Brayden",41,19,8,22,0,0,0,4
Gold Coast,"Flanders, Sam",12,6,4,6,0,0,0,3
Gold Coast,"Graham, Caleb",6,5,3,1,0,0,7,1
Gold Coast,"King, Ben",12,10,4,2,3,3,0,0
Gold Coast,"Lemmens, Sean",7,5,3,2,0,0,0,3
Gold Coast,"Lukosius, Jack",27,22,13,5,0,2,0,0
Gold Coast,"Markov, Oleg",2,0,1,2,0,0,0,0
Gold Coast,"Miller, Touk",32,16,5,16,0,2,0,9
Gold Coast,"Powell, Wil",22,17,6,5,0,0,0,1
Gold Coast,"Rankine, Izak",7,4,1,3,0,0,0,3
Gold Coast,"Rowell, Matt",14,8,3,6,1,0,0,6
Gold Coast,"Sexton, Alex",8,7,4,1,1,0,0,0
Gold Coast,"Sharp, Jeremy",31,17,9,14,1,0,0,0
Gold Coast,"Swallow, David",24,16,7,8,0,0,0,3
Gold Coast,"Ainsworth, Ben",11,8,4,3,0,0,0,2
Gold Coast,"Anderson, Noah",23,14,2,9,0,0,0,4
Gold Coast,"Ballard, Charlie",18,14,10,4,0,0,0,2
Gold Coast,"Bowes, Jack",13,10,5,3,0,0,0,1
Gold Coast,"Brodie, Will",0,0,0,0,0,0,0,0
Gold Coast,"Burgess, Chris",10,4,3,6,1,0,6,3
Gold Coast,"Collins, Sam",15,8,4,7,0,0,0,1
Gold Coast,"Corbett, Josh",9,7,2,2,1,2,0,0
Gold Coast,"Farrar, Jy",19,9,7,10,0,0,0,0
Gold Coast,"Fiorini, Brayden",23,15,11,8,0,0,0,6
Gold Coast,"Flanders, Sam",8,6,4,2,1,0,0,6
Gold Coast,"Jeffrey, Joel",5,3,1,2,0,1,0,3
Gold Coast,"King, Ben",3,0,0,3,0,0,0,0
Gold Coast,"Lemmens, Sean",14,11,4,3,0,0,0,1
Gold Coast,"Lukosius, Jack",21,19,4,2,0,0,0,2
Gold Coast,"Macpherson, Darcy",10,4,3,6,0,0,0,7
Gold Coast,"Miller, Touk",34,19,2,15,0,1,0,10
Gold Coast,"Powell, Wil",9,7,3,2,0,0,0,2
Gold Coast,"Rowell, Matt",19,5,2,14,0,0,0,6
Gold Coast,"Sexton, Alex",14,10,5,4,1,0,0,1
Gold Coast,"Sharp, Jeremy",9,7,4,2,0,0,0,0
Gold Coast,"Smith, Zac",7,1,0,6,0,0,19,1
Gold Coast,"Swallow, David",26,17,9,9,0,1,0,3
Gold Coast,"Ainsworth, Ben",20,15,10,5,0,1,0,2
Gold Coast,"Anderson, Noah",30,21,8,9,0,0,0,3
Gold Coast,"Ballard, Charlie",15,10,5,5,0,0,0,2
Gold Coast,"Bowes, Jack",15,11,5,4,0,0,0,3
Gold Coast,"Burgess, Chris",7,3,3,4,0,0,0,3
Gold Coast,"Collins, Sam",11,7,6,4,0,0,0,1
Gold Coast,"Corbett, Josh",17,9,9,8,1,0,0,0
Gold Coast,"Ellis, Brandon",7,6,5,1,1,0,0,1
Gold Coast,"Farrar, Jy",18,13,4,5,0,0,0,1
Gold Coast,"Fiorini, Brayden",23,15,4,8,1,0,0,11
Gold Coast,"Jeffrey, Joel",6,5,3,1,1,2,0,1
Gold Coast,"King, Ben",7,3,2,4,0,2,0,0
Gold Coast,"Lemmens, Sean",13,11,5,2,0,0,0,3
Gold Coast,"Lukosius, Jack",16,14,7,2,0,0,0,0
Gold Coast,"Macpherson, Darcy",21,10,6,11,0,1,0,5
Gold Coast,"Miller, Touk",34,21,7,13,2,0,0,4
Gold Coast,"Powell, Wil",28,21,8,7,1,0,0,7
Gold Coast,"Rowell, Matt",13,4,3,9,0,0,0,3
Gold Coast,"Sexton, Alex",20,16,10,4,1,0,0,2
Gold Coast,"Sharp, Jeremy",19,12,9,7,0,0,0,3
Gold Coast,"Smith, Zac",10,7,2,3,1,0,31,1
Gold Coast,"Swallow, David",16,12,5,4,0,0,0,5
Gold Coast,"Townsend, Jacob",10,8,5,2,2,0,3,4
Gold Coast,"Ainsworth, Ben",16,9,4,7,0,0,0,2
Gold Coast,"Anderson, Noah",25,18,5,7,0,0,0,0
Gold Coast,"Atkins, Rory",3,2,1,1,0,0,0,1
Gold Coast,"Ballard, Charlie",11,8,6,3,0,0,0,0
Gold Coast,"Bowes, Jack",15,10,2,5,0,0,0,1
Gold Coast,"Burgess, Chris",6,3,0,3,0,0,5,1
Gold Coast,"Collins, Sam",19,9,13,10,0,0,0,2
Gold Coast,"Corbett, Josh",6,5,4,1,1,1,0,2
Gold Coast,"Farrar, Jy",17,12,7,5,0,0,0,0
Gold Coast,"Fiorini, Brayden",30,15,6,15,1,0,0,1
Gold Coast,"Jeffrey, Joel",8,6,2,2,1,1,0,0
Gold Coast,"King, Ben",6,4,2,2,0,0,0,1
Gold Coast,"Lemmens, Sean",10,5,5,5,0,0,0,0
Gold Coast,"Lukosius, Jack",19,17,7,2,0,0,0,3
Gold Coast,"Macpherson, Darcy",16,10,5,6,0,0,0,4
Gold Coast,"Miller, Touk",30,9,0,21,0,0,0,3
Gold Coast,"Powell, Wil",20,13,0,7,0,0,0,3
Gold Coast,"Rowell, Matt",13,2,2,11,0,0,0,1
Gold Coast,"Sexton, Alex",14,12,5,2,0,1,0,1
Gold Coast,"Sharp, Jeremy",19,14,6,5,0,0,0,1
Gold Coast,"Smith, Zac",5,0,0,5,0,0,18,1
Gold Coast,"Swallow, David",23,15,7,8,0,0,0,3
Gold Coast,"Townsend, Jacob",14,7,3,7,1,0,0,1
Gold Coast,"Ainsworth, Ben",21,15,5,6,0,2,0,0
Gold Coast,"Anderson, Noah",28,16,5,12,0,0,0,4
Gold Coast,"Atkins, Rory",18,6,3,12,0,1,0,0
Gold Coast,"Ballard, Charlie",9,4,5,5,0,0,0,3
Gold Coast,"Burgess, Chris",6,4,2,2,0,0,9,5
Gold Coast,"Collins, Sam",11,8,7,3,0,0,0,1
Gold Coast,"Corbett, Josh",9,4,2,5,1,1,0,0
Gold Coast,"Davies, Alex",16,5,2,11,0,2,0,6
Gold Coast,"Farrar, Jy",15,8,6,7,0,0,0,2
Gold Coast,"Fiorini, Brayden",20,12,3,8,0,1,0,3
Gold Coast,"Harbrow, Jarrod",21,16,8,5,0,1,0,2
Gold Coast,"Jeffrey, Joel",6,5,0,1,0,0,0,0
Gold Coast,"King, Ben",8,7,5,1,4,1,0,0
Gold Coast,"Lemmens, Sean",11,7,3,4,0,0,0,0
Gold Coast,"Lukosius, Jack",16,14,6,2,0,0,0,1
Gold Coast,"Macpherson, Darcy",15,11,5,4,0,1,0,4
Gold Coast,"Miller, Touk",37,14,3,23,0,1,0,9
Gold Coast,"Powell, Wil",13,8,4,5,0,0,0,4
Gold Coast,"Rowell, Matt",17,10,3,7,0,0,0,4
Gold Coast,"Sexton, Alex",8,6,3,2,1,0,0,0
Gold Coast,"Sharp, Jeremy",2,1,0,1,0,0,0,0
Gold Coast,"Smith, Zac",8,3,2,5,0,0,25,5
Gold Coast,"Swallow, David",20,11,4,9,0,0,0,2
Geelong,"Atkins, Tom",19,9,1,10,0,0,0,4
Geelong,"Bews, Jed",8,6,2,2,0,0,0,2
Geelong,"Blicavs, Mark",17,8,5,9,1,0,6,2
Geelong,"Clark, Jordan",18,10,1,8,0,0,0,2
Geelong,"Constable, Charlie",6,4,3,2,0,0,0,0
Geelong,"Dahlhaus, Luke",13,7,2,6,1,1,0,0
Geelong,"Dangerfield, Patrick",26,17,6,9,0,0,0,2
Geelong,"Guthrie, Cameron",23,11,3,12,1,1,0,5
Geelong,"Guthrie, Zach",11,6,3,5,0,1,0,3
Geelong,"Hawkins, Tom",8,5,3,3,2,2,1,4
Geelong,"Henderson, Lachie",11,7,6,4,0,0,0,2
Geelong,"Higgins, Shaun",22,9,3,13,0,2,0,2
Geelong,"Jenkins, Josh",8,5,2,3,0,2,3,2
Geelong,"Kolodjashnij, Jake",13,4,7,9,0,0,0,5
Geelong,"Menegola, Sam",14,7,5,7,1,0,0,3
Geelong,"Miers, Gryan",16,8,3,8,1,0,0,2
Geelong,"OConnor, Mark",18,8,2,10,0,0,0,0
Geelong,"Parfitt, Brandan",18,11,1,7,2,0,0,9
Geelong,"Rohan, Gary",6,5,3,1,1,1,0,1
Geelong,"Selwood, Joel",18,13,4,5,0,0,0,5
Geelong,"Smith, Isaac",21,15,6,6,2,1,0,2
Geelong,"Stanley, Rhys",14,3,2,11,1,0,21,1
Geelong,"Stewart, Tom",21,17,5,4,0,0,0,1
Geelong,"Atkins, Tom",22,14,6,8,0,0,0,6
Geelong,"Bews, Jed",13,10,5,3,0,0,0,3
Geelong,"Blicavs, Mark",16,9,6,7,0,0,7,1
Geelong,"Clark, Jordan",16,12,5,4,1,0,0,5
Geelong,"Constable, Charlie",17,10,5,7,0,0,0,3
Geelong,"Dahlhaus, Luke",7,3,2,4,0,0,0,3
Geelong,"Evans, Francis",7,7,4,0,2,1,0,1
Geelong,"Guthrie, Cameron",28,19,9,9,0,0,0,5
Geelong,"Guthrie, Zach",0,0,0,0,0,0,0,0
Geelong,"Hawkins, Tom",17,10,5,7,3,4,4,0
Geelong,"Henderson, Lachie",17,13,8,4,0,0,0,3
Geelong,"Henry, Jack",16,9,7,7,0,0,0,0
Geelong,"Higgins, Shaun",20,8,3,12,0,0,0,1
Geelong,"Kolodjashnij, Jake",12,9,9,3,0,0,0,2
Geelong,"Miers, Gryan",10,4,3,6,1,0,0,2
Geelong,"OConnor, Mark",15,9,2,6,0,0,0,7
Geelong,"Parfitt, Brandan",17,11,3,6,0,0,0,4
Geelong,"Rohan, Gary",5,4,3,1,0,0,0,2
Geelong,"Selwood, Joel",27,11,3,16,2,0,0,4
Geelong,"Smith, Isaac",26,20,11,6,1,0,0,1
Geelong,"Stanley, Rhys",22,12,7,10,0,2,24,1
Geelong,"Stewart, Tom",22,18,7,4,0,1,0,0
Geelong,"Tuohy, Zach",27,15,5,12,2,1,0,2
Geelong,"Atkins, Tom",17,11,2,6,0,0,0,4
Geelong,"Bews, Jed",11,7,5,4,0,0,0,1
Geelong,"Blicavs, Mark",10,6,6,4,1,0,13,3
Geelong,"Clark, Jordan",15,7,2,8,1,0,0,2
Geelong,"Constable, Charlie",14,7,5,7,1,0,0,0
Geelong,"Dahlhaus, Luke",11,3,4,8,0,1,0,3
Geelong,"Duncan, Mitch",37,21,10,16,0,0,0,1
Geelong,"Evans, Francis",1,1,0,0,0,0,0,0
Geelong,"Guthrie, Cameron",43,20,11,23,0,1,0,3
Geelong,"Hawkins, Tom",14,10,9,4,2,4,5,1
Geelong,"Henderson, Lachie",15,9,5,6,0,0,0,3
Geelong,"Henry, Jack",10,5,2,5,2,0,0,4
Geelong,"Higgins, Shaun",12,7,3,5,0,0,0,0
Geelong,"Holmes, Max",16,10,4,6,0,1,0,1
Geelong,"Kolodjashnij, Jake",13,11,8,2,0,0,0,2
Geelong,"Miers, Gryan",18,12,7,6,1,2,0,1
Geelong,"OConnor, Mark",26,12,7,14,0,0,0,8
Geelong,"Parfitt, Brandan",17,11,4,6,1,0,0,4
Geelong,"Selwood, Joel",21,11,3,10,0,0,0,7
Geelong,"Smith, Isaac",15,11,6,4,0,0,0,4
Geelong,"Stanley, Rhys",15,7,3,8,0,0,8,1
Geelong,"Stewart, Tom",25,21,12,4,0,0,0,0
Geelong,"Tuohy, Zach",17,10,5,7,1,0,0,0
Geelong,"Atkins, Tom",25,13,5,12,0,0,0,4
Geelong,"Bews, Jed",11,5,3,6,0,0,0,4
Geelong,"Blicavs, Mark",9,4,1,5,0,0,14,6
Geelong,"Clark, Jordan",10,6,5,4,1,0,0,4
Geelong,"Close, Brad",19,7,3,12,0,1,0,4
Geelong,"Dahlhaus, Luke",11,6,3,5,0,0,0,5
Geelong,"Duncan, Mitch",21,16,4,5,0,0,0,6
Geelong,"Guthrie, Cameron",27,16,6,11,0,0,0,4
Geelong,"Guthrie, Zach",11,8,2,3,0,0,0,4
Geelong,"Hawkins, Tom",12,9,5,3,2,2,0,3
Geelong,"Henderson, Lachie",14,11,5,3,0,0,0,1
Geelong,"Henry, Jack",8,4,1,4,2,0,0,3
Geelong,"Holmes, Max",0,0,0,0,0,0,0,0
Geelong,"Kolodjashnij, Jake",16,10,6,6,0,0,0,3
Geelong,"Menegola, Sam",26,11,2,15,0,0,0,0
Geelong,"Miers, Gryan",17,10,5,7,1,1,0,2
Geelong,"Narkle, Quinton",16,5,4,11,0,0,0,3
Geelong,"OConnor, Mark",10,3,0,7,0,0,0,2
Geelong,"Selwood, Joel",30,16,5,14,0,1,0,8
Geelong,"Smith, Isaac",21,16,2,5,2,0,0,2
Geelong,"Stanley, Rhys",10,6,3,4,1,1,10,2
Geelong,"Stewart, Tom",25,20,9,5,0,0,0,1
Geelong,"Tuohy, Zach",13,7,2,6,0,0,0,3
Geelong,"Atkins, Tom",15,7,4,8,0,0,0,1
Geelong,"Bews, Jed",14,9,5,5,1,0,0,0
Geelong,"Blicavs, Mark",20,10,7,10,0,0,0,2
Geelong,"Clark, Jordan",0,0,0,0,0,0,0,0
Geelong,"Close, Brad",15,10,4,5,1,2,0,2
Geelong,"Dahlhaus, Luke",13,8,3,5,1,2,0,4
Geelong,"Dangerfield, Patrick",22,12,4,10,0,0,0,1
Geelong,"De Koning, Sam",8,7,3,1,0,2,1,0
Geelong,"Duncan, Mitch",27,18,7,9,0,0,0,3
Geelong,"Guthrie, Cameron",24,12,4,12,0,0,0,2
Geelong,"Hawkins, Tom",13,6,5,7,1,3,4,1
Geelong,"Henderson, Lachie",14,11,5,3,0,1,0,0
Geelong,"Henry, Jack",16,8,4,8,0,0,2,0
Geelong,"Kolodjashnij, Jake",15,5,5,10,0,0,0,2
Geelong,"Menegola, Sam",28,15,5,13,2,1,0,1
Geelong,"Miers, Gryan",22,10,6,12,1,0,0,3
Geelong,"Parfitt, Brandan",34,12,1,22,0,1,0,7
Geelong,"Rohan, Gary",12,6,1,6,2,1,0,2
Geelong,"Selwood, Joel",18,5,2,13,0,0,0,5
Geelong,"Smith, Isaac",31,21,4,10,0,0,0,1
Geelong,"Stanley, Rhys",24,9,4,15,0,0,8,2
Geelong,"Stewart, Tom",30,20,11,10,0,0,0,1
Geelong,"Tuohy, Zach",26,8,4,18,1,1,0,0
Geelong,"Atkins, Tom",22,14,9,8,0,0,0,6
Geelong,"Bews, Jed",17,12,6,5,0,0,0,1
Geelong,"Blicavs, Mark",12,8,5,4,0,0,0,3
Geelong,"Cameron, Jeremy",9,8,6,1,3,2,0,0
Geelong,"Clark, Jordan",6,4,3,2,0,0,0,0
Geelong,"Close, Brad",9,5,2,4,1,0,0,3
Geelong,"Dahlhaus, Luke",15,7,2,8,0,1,0,3
Geelong,"Duncan, Mitch",26,20,13,6,4,1,0,2
Geelong,"Guthrie, Cameron",35,11,5,24,0,0,0,3
Geelong,"Hawkins, Tom",14,10,4,4,3,1,4,1
Geelong,"Henderson, Lachie",19,13,11,6,2,0,0,0
Geelong,"Henry, Jack",19,15,10,4,1,0,2,2
Geelong,"Kolodjashnij, Jake",9,3,1,6,0,0,0,1
Geelong,"Menegola, Sam",20,11,3,9,1,0,0,2
Geelong,"Miers, Gryan",17,11,5,6,1,2,0,1
Geelong,"OConnor, Mark",15,11,4,4,1,0,0,7
Geelong,"Parfitt, Brandan",16,8,0,8,0,0,0,4
Geelong,"Rohan, Gary",13,10,6,3,3,1,0,1
Geelong,"Selwood, Joel",29,13,4,16,0,0,0,2
Geelong,"Smith, Isaac",23,16,7,7,0,0,0,6
Geelong,"Stanley, Rhys",15,9,4,6,1,0,22,3
Geelong,"Stewart, Tom",27,18,8,9,0,0,0,2
Geelong,"Tuohy, Zach",11,6,2,5,0,0,0,4
Geelong,"Atkins, Tom",15,7,4,8,0,0,0,3
Geelong,"Bews, Jed",12,5,2,7,0,0,0,3
Geelong,"Blicavs, Mark",14,8,2,6,0,0,7,1
Geelong,"Cameron, Jeremy",9,7,1,2,3,0,0,1
Geelong,"Clark, Jordan",18,8,5,10,0,1,0,2
Geelong,"Close, Brad",18,9,4,9,2,0,0,1
Geelong,"Dahlhaus, Luke",21,10,3,11,1,2,0,4
Geelong,"Duncan, Mitch",29,21,7,8,1,1,0,2
Geelong,"Guthrie, Cameron",30,17,4,13,0,1,0,7
Geelong,"Guthrie, Zach",6,5,2,1,0,0,0,1
Geelong,"Hawkins, Tom",10,6,5,4,1,1,4,3
Geelong,"Henderson, Lachie",18,9,6,9,0,1,0,1
Geelong,"Henry, Jack",23,12,8,11,0,0,5,2
Geelong,"Menegola, Sam",21,14,4,7,1,2,0,1
Geelong,"Miers, Gryan",11,6,4,5,1,0,0,0
Geelong,"Narkle, Quinton",15,3,2,12,0,0,0,3
Geelong,"Parfitt, Brandan",20,9,1,11,0,0,0,7
Geelong,"Rohan, Gary",10,8,2,2,2,2,0,2
Geelong,"Selwood, Joel",29,14,3,15,0,0,0,7
Geelong,"Smith, Isaac",22,16,10,6,0,1,0,2
Geelong,"Stanley, Rhys",10,6,2,4,0,0,16,0
Geelong,"Stewart, Tom",25,19,9,6,0,1,0,1
Geelong,"Tuohy, Zach",18,13,7,5,0,0,0,3
Geelong,"Atkins, Tom",16,9,4,7,0,0,0,5
Geelong,"Bews, Jed",11,6,2,5,0,0,0,5
Geelong,"Blicavs, Mark",24,10,5,14,0,0,16,4
Geelong,"Cameron, Jeremy",22,18,8,4,6,2,0,0
Geelong,"Close, Brad",13,7,3,6,1,0,0,5
Geelong,"Dahlhaus, Luke",7,2,0,5,0,0,0,3
Geelong,"Duncan, Mitch",30,15,10,15,0,0,0,7
Geelong,"Guthrie, Cameron",36,20,11,16,0,1,0,4
Geelong,"Guthrie, Zach",14,11,8,3,0,0,0,5
Geelong,"Hawkins, Tom",20,12,7,8,4,1,1,2
Geelong,"Henderson, Lachie",17,9,8,8,0,0,0,1
Geelong,"Henry, Jack",14,7,5,7,0,0,0,3
Geelong,"Higgins, Shaun",23,9,3,14,1,0,0,2
Geelong,"Menegola, Sam",26,14,10,12,0,1,0,3
Geelong,"Narkle, Quinton",13,7,3,6,0,1,0,2
Geelong,"Parfitt, Brandan",21,13,2,8,0,0,0,4
Geelong,"Ratugolea, Esava",10,4,3,6,0,1,8,3
Geelong,"Rohan, Gary",16,9,6,7,5,0,0,3
Geelong,"Selwood, Joel",21,10,2,11,0,0,0,5
Geelong,"Simpson, Sam",12,5,2,7,0,1,0,2
Geelong,"Smith, Isaac",21,12,10,9,2,0,0,3
Geelong,"Stewart, Tom",26,20,7,6,0,0,0,3
Geelong,"Tuohy, Zach",26,19,3,7,0,1,0,1
Geelong,"Atkins, Tom",23,9,1,14,0,0,0,2
Geelong,"Bews, Jed",12,8,7,4,0,0,0,2
Geelong,"Blicavs, Mark",11,3,0,8,0,0,17,4
Geelong,"Cameron, Jeremy",10,6,3,4,1,1,0,1
Geelong,"Clark, Jordan",12,4,1,8,0,0,0,2
Geelong,"Close, Brad",12,6,1,6,2,1,0,4
Geelong,"Duncan, Mitch",30,17,15,13,0,0,0,3
Geelong,"Guthrie, Cameron",36,16,6,20,1,0,0,7
Geelong,"Guthrie, Zach",14,11,2,3,0,0,0,1
Geelong,"Hawkins, Tom",11,8,7,3,2,0,2,2
Geelong,"Henderson, Lachie",17,12,10,5,0,0,0,2
Geelong,"Henry, Jack",12,6,4,6,0,0,0,3
Geelong,"Higgins, Shaun",20,10,5,10,0,3,0,5
Geelong,"Holmes, Max",0,0,0,0,0,0,0,0
Geelong,"Menegola, Sam",21,11,6,10,1,0,0,0
Geelong,"Narkle, Quinton",12,7,1,5,1,1,0,5
Geelong,"Parfitt, Brandan",19,8,0,11,0,0,0,7
Geelong,"Ratugolea, Esava",13,7,5,6,0,0,4,4
Geelong,"Rohan, Gary",13,11,6,2,2,0,0,2
Geelong,"Selwood, Joel",19,10,2,9,0,0,0,3
Geelong,"Smith, Isaac",27,20,11,7,0,1,0,0
Geelong,"Stewart, Tom",23,17,4,6,0,0,0,3
Geelong,"Tuohy, Zach",31,19,6,12,0,0,0,0
Geelong,"Atkins, Tom",14,10,3,4,0,0,0,5
Geelong,"Bews, Jed",17,12,4,5,1,0,0,2
Geelong,"Blicavs, Mark",18,8,6,10,1,0,34,6
Geelong,"Cameron, Jeremy",11,6,3,5,3,0,0,2
Geelong,"Close, Brad",12,7,4,5,1,0,0,2
Geelong,"Dahlhaus, Luke",13,4,2,9,0,0,0,5
Geelong,"Duncan, Mitch",15,9,3,6,2,0,0,1
Geelong,"Guthrie, Cameron",29,15,4,14,0,1,0,4
Geelong,"Guthrie, Zach",12,6,3,6,0,0,0,2
Geelong,"Hawkins, Tom",13,5,3,8,2,1,6,5
Geelong,"Henderson, Lachie",24,18,11,6,0,0,0,1
Geelong,"Henry, Jack",19,8,6,11,0,0,0,1
Geelong,"Higgins, Shaun",25,13,6,12,1,1,0,8
Geelong,"Kolodjashnij, Jake",10,9,7,1,0,0,0,0
Geelong,"Menegola, Sam",31,15,5,16,0,1,0,1
Geelong,"Narkle, Quinton",34,14,8,20,0,1,0,2
Geelong,"Parfitt, Brandan",21,7,2,14,0,0,0,10
Geelong,"Ratugolea, Esava",11,4,1,7,0,0,19,2
Geelong,"Rohan, Gary",13,9,4,4,2,0,0,1
Geelong,"Selwood, Joel",39,13,4,26,0,1,0,7
Geelong,"Smith, Isaac",21,10,3,11,0,0,0,0
Geelong,"Stewart, Tom",25,19,7,6,0,0,0,1
Geelong,"Tuohy, Zach",25,17,5,8,1,0,0,0
Geelong,"Atkins, Tom",17,11,7,6,0,1,0,1
Geelong,"Bews, Jed",12,9,6,3,0,0,0,0
Geelong,"Cameron, Jeremy",12,9,3,3,2,2,0,3
Geelong,"Clark, Jordan",0,0,0,0,0,0,0,0
Geelong,"Close, Brad",12,7,5,5,0,1,0,3
Geelong,"Dahlhaus, Luke",6,2,1,4,1,0,0,3
Geelong,"Guthrie, Zach",9,3,3,6,0,0,0,2
Geelong,"Hawkins, Tom",21,14,7,7,3,2,5,2
Geelong,"Henderson, Lachie",15,10,6,5,0,0,0,1
Geelong,"Henry, Jack",11,10,8,1,0,1,0,4
Geelong,"Higgins, Shaun",24,15,11,9,0,1,0,5
Geelong,"Holmes, Max",15,6,4,9,0,1,0,2
Geelong,"Kolodjashnij, Jake",15,8,8,7,0,0,0,0
Geelong,"Menegola, Sam",17,8,3,9,0,0,0,3
Geelong,"Narkle, Quinton",25,7,3,18,0,0,0,0
Geelong,"Parfitt, Brandan",30,16,4,14,0,1,0,1
Geelong,"Ratugolea, Esava",4,2,0,2,1,0,8,1
Geelong,"Rohan, Gary",13,6,5,7,0,0,0,2
Geelong,"Selwood, Joel",26,16,4,10,0,1,0,4
Geelong,"Smith, Isaac",20,12,7,8,0,0,0,1
Geelong,"Stanley, Rhys",16,11,7,5,1,0,15,2
Geelong,"Stewart, Tom",23,17,11,6,0,0,0,0
Geelong,"Tuohy, Zach",27,25,8,2,0,1,0,2
Geelong,"Atkins, Tom",8,3,3,5,0,0,0,2
Geelong,"Bews, Jed",14,12,6,2,0,0,0,0
Geelong,"Blicavs, Mark",17,7,5,10,0,0,18,1
Geelong,"Cameron, Jeremy",19,10,5,9,5,0,0,3
Geelong,"Close, Brad",12,6,0,6,0,0,0,2
Geelong,"Dahlhaus, Luke",8,3,1,5,0,0,0,5
Geelong,"Dangerfield, Patrick",18,11,0,7,0,1,0,2
Geelong,"Duncan, Mitch",20,12,3,8,1,0,0,1
Geelong,"Hawkins, Tom",14,11,8,3,4,4,8,0
Geelong,"Henderson, Lachie",6,6,2,0,1,0,0,0
Geelong,"Henry, Jack",17,11,6,6,0,0,0,1
Geelong,"Higgins, Shaun",13,8,2,5,0,1,0,2
Geelong,"Kolodjashnij, Jake",8,5,3,3,0,0,0,0
Geelong,"Menegola, Sam",16,9,5,7,0,0,0,2
Geelong,"Narkle, Quinton",0,0,0,0,0,0,0,0
Geelong,"OConnor, Mark",13,4,0,9,0,0,0,4
Geelong,"Parfitt, Brandan",17,8,3,9,2,0,0,2
Geelong,"Ratugolea, Esava",13,8,4,5,0,1,10,2
Geelong,"Rohan, Gary",18,15,10,3,3,2,0,1
Geelong,"Selwood, Joel",16,9,1,7,0,0,0,1
Geelong,"Smith, Isaac",17,13,7,4,1,1,0,2
Geelong,"Stewart, Tom",23,19,5,4,0,0,0,2
Geelong,"Tuohy, Zach",14,11,4,3,0,0,0,2
Geelong,"Atkins, Tom",19,13,3,6,0,0,0,7
Geelong,"Bews, Jed",15,10,5,5,0,1,0,2
Geelong,"Blicavs, Mark",19,6,2,13,0,0,26,3
Geelong,"Cameron, Jeremy",15,6,3,9,2,2,0,0
Geelong,"Close, Brad",18,7,3,11,1,0,0,5
Geelong,"Dahlhaus, Luke",21,11,1,10,1,1,0,6
Geelong,"Dangerfield, Patrick",26,13,4,13,0,3,0,1
Geelong,"Duncan, Mitch",2,0,0,2,0,0,0,1
Geelong,"Guthrie, Cameron",22,10,4,12,0,0,0,5
Geelong,"Hawkins, Tom",13,4,1,9,1,0,9,1
Geelong,"Henry, Jack",12,11,9,1,0,0,0,2
Geelong,"Higgins, Shaun",16,5,1,11,0,0,0,3
Geelong,"Kolodjashnij, Jake",7,2,3,5,0,0,0,0
Geelong,"Menegola, Sam",27,18,8,9,2,0,0,2
Geelong,"Narkle, Quinton",16,6,1,10,0,0,0,2
Geelong,"OConnor, Mark",11,2,1,9,0,0,0,3
Geelong,"Parfitt, Brandan",22,15,2,7,1,0,0,9
Geelong,"Ratugolea, Esava",9,3,1,6,1,0,13,3
Geelong,"Rohan, Gary",11,9,5,2,2,1,0,3
Geelong,"Selwood, Joel",29,15,2,14,1,0,0,6
Geelong,"Smith, Isaac",30,19,7,11,0,0,0,0
Geelong,"Stewart, Tom",27,24,13,3,0,0,0,1
Geelong,"Tuohy, Zach",27,22,2,5,0,0,0,2
Geelong,"Atkins, Tom",16,3,6,13,0,0,0,3
Geelong,"Bews, Jed",9,3,3,6,0,0,0,0
Geelong,"Blicavs, Mark",15,5,3,10,0,0,24,2
Geelong,"Cameron, Jeremy",13,8,3,5,0,1,0,3
Geelong,"Close, Brad",10,3,1,7,0,1,0,2
Geelong,"Dahlhaus, Luke",7,0,1,7,0,0,0,3
Geelong,"Dangerfield, Patrick",23,17,6,6,1,1,0,1
Geelong,"Guthrie, Cameron",34,20,6,14,0,0,0,2
Geelong,"Hawkins, Tom",12,5,3,7,1,1,6,3
Geelong,"Henderson, Lachie",17,14,9,3,0,0,0,1
Geelong,"Henry, Jack",13,11,7,2,0,1,0,2
Geelong,"Higgins, Shaun",20,5,1,15,0,0,0,6
Geelong,"Kolodjashnij, Jake",11,6,2,5,0,0,0,0
Geelong,"Menegola, Sam",16,9,4,7,0,0,0,2
Geelong,"Narkle, Quinton",0,0,0,0,0,0,0,0
Geelong,"OConnor, Mark",16,8,4,8,0,0,0,2
Geelong,"Parfitt, Brandan",24,15,3,9,0,1,0,5
Geelong,"Ratugolea, Esava",8,5,0,3,0,0,8,1
Geelong,"Rohan, Gary",11,8,1,3,1,0,0,5
Geelong,"Selwood, Joel",13,6,1,7,0,0,0,3
Geelong,"Smith, Isaac",21,15,7,6,2,0,0,1
Geelong,"Stewart, Tom",17,13,4,4,0,0,0,0
Geelong,"Tuohy, Zach",21,19,6,2,2,1,0,0
Geelong,"Atkins, Tom",29,14,5,15,0,0,0,6
Geelong,"Bews, Jed",20,15,8,5,0,0,0,0
Geelong,"Blicavs, Mark",8,6,3,2,0,0,17,6
Geelong,"Cameron, Jeremy",4,3,2,1,3,0,0,0
Geelong,"Close, Brad",10,5,1,5,0,0,0,5
Geelong,"Dahlhaus, Luke",8,4,0,4,0,1,0,1
Geelong,"Dangerfield, Patrick",37,24,11,13,1,0,0,4
Geelong,"Guthrie, Cameron",16,11,3,5,0,0,0,2
Geelong,"Hawkins, Tom",15,9,6,6,6,1,2,1
Geelong,"Henderson, Lachie",9,8,4,1,0,0,0,1
Geelong,"Henry, Jack",10,8,7,2,0,0,0,1
Geelong,"Holmes, Max",8,3,3,5,0,1,0,1
Geelong,"Kolodjashnij, Jake",7,3,1,4,0,0,0,4
Geelong,"Menegola, Sam",21,16,5,5,0,0,0,2
Geelong,"Miers, Gryan",12,6,3,6,2,0,0,1
Geelong,"Narkle, Quinton",18,9,1,9,0,0,0,2
Geelong,"Parfitt, Brandan",16,11,2,5,0,0,0,6
Geelong,"Rohan, Gary",6,4,1,2,1,1,0,2
Geelong,"Selwood, Joel",28,13,4,15,0,0,0,3
Geelong,"Smith, Isaac",25,17,6,8,1,1,0,2
Geelong,"Stanley, Rhys",11,7,2,4,0,0,22,1
Geelong,"Stewart, Tom",25,20,13,5,0,0,0,0
Geelong,"Tuohy, Zach",26,19,8,7,1,1,0,1
Geelong,"Atkins, Tom",16,13,5,3,0,0,0,2
Geelong,"Bews, Jed",13,8,4,5,1,0,0,4
Geelong,"Blicavs, Mark",10,3,1,7,0,0,8,0
Geelong,"Close, Brad",15,7,7,8,0,1,0,3
Geelong,"Dangerfield, Patrick",18,11,4,7,0,0,0,7
Geelong,"Guthrie, Cameron",28,13,5,15,0,0,0,5
Geelong,"Hawkins, Tom",14,12,6,2,0,0,3,3
Geelong,"Henderson, Lachie",20,17,11,3,0,0,0,0
Geelong,"Henry, Jack",9,7,5,2,0,0,0,1
Geelong,"Higgins, Shaun",25,13,7,12,1,0,0,3
Geelong,"Holmes, Max",12,5,1,7,1,2,0,3
Geelong,"Kolodjashnij, Jake",14,8,4,6,0,0,0,0
Geelong,"Menegola, Sam",24,16,4,8,0,0,0,1
Geelong,"Miers, Gryan",19,11,5,8,0,0,0,0
Geelong,"Narkle, Quinton",0,0,0,0,0,0,0,0
Geelong,"OConnor, Mark",13,8,1,5,0,0,0,4
Geelong,"Parfitt, Brandan",16,11,0,5,1,0,0,7
Geelong,"Ratugolea, Esava",7,5,3,2,1,1,2,2
Geelong,"Rohan, Gary",11,9,7,2,1,3,0,1
Geelong,"Smith, Isaac",19,10,4,9,1,0,0,2
Geelong,"Stanley, Rhys",14,8,4,6,1,0,14,3
Geelong,"Stewart, Tom",25,21,12,4,0,0,0,0
Geelong,"Tuohy, Zach",24,16,8,8,2,0,0,0
Geelong,"Atkins, Tom",14,7,1,7,0,0,0,2
Geelong,"Bews, Jed",14,12,6,2,0,1,0,3
Geelong,"Blicavs, Mark",12,5,5,7,0,0,8,3
Geelong,"Close, Brad",12,7,5,5,1,0,0,5
Geelong,"Dahlhaus, Luke",17,7,3,10,1,1,0,8
Geelong,"Dangerfield, Patrick",22,11,7,11,3,1,0,4
Geelong,"Guthrie, Cameron",35,20,7,15,0,2,0,2
Geelong,"Hawkins, Tom",14,9,6,5,4,1,3,2
Geelong,"Henry, Jack",13,9,9,4,0,0,0,1
Geelong,"Higgins, Shaun",20,8,8,12,0,2,0,3
Geelong,"Holmes, Max",0,0,0,0,0,0,0,0
Geelong,"Kolodjashnij, Jake",12,11,11,1,0,0,0,0
Geelong,"Menegola, Sam",30,24,9,6,1,1,0,3
Geelong,"Miers, Gryan",19,11,3,8,1,0,0,2
Geelong,"Narkle, Quinton",26,12,9,14,1,0,0,0
Geelong,"OConnor, Mark",20,14,8,6,0,0,0,0
Geelong,"Parfitt, Brandan",22,11,2,11,0,1,0,10
Geelong,"Ratugolea, Esava",9,5,5,4,1,0,0,2
Geelong,"Selwood, Joel",24,11,3,13,1,0,0,2
Geelong,"Smith, Isaac",21,15,10,6,0,0,0,1
Geelong,"Stanley, Rhys",16,9,4,7,0,1,18,1
Geelong,"Stewart, Tom",20,17,9,3,0,0,0,0
Geelong,"Tuohy, Zach",30,23,7,7,0,2,0,1
Geelong,"Atkins, Tom",16,12,5,4,0,0,0,2
Geelong,"Bews, Jed",15,7,4,8,0,0,0,2
Geelong,"Blicavs, Mark",14,8,4,6,0,0,15,2
Geelong,"Close, Brad",14,4,0,10,1,0,0,2
Geelong,"Dahlhaus, Luke",15,5,3,10,0,1,0,4
Geelong,"Dangerfield, Patrick",28,14,6,14,1,0,0,7
Geelong,"Guthrie, Cameron",34,17,7,17,0,0,0,3
Geelong,"Hawkins, Tom",13,11,6,2,4,2,1,3
Geelong,"Henderson, Lachie",15,8,6,7,0,0,0,2
Geelong,"Henry, Jack",16,10,6,6,0,0,1,0
Geelong,"Kolodjashnij, Jake",14,9,6,5,0,0,0,1
Geelong,"Menegola, Sam",22,13,5,9,0,0,0,2
Geelong,"Miers, Gryan",16,10,3,6,1,0,0,4
Geelong,"Narkle, Quinton",12,3,0,9,1,0,0,2
Geelong,"OConnor, Mark",15,10,7,5,0,0,0,2
Geelong,"Parfitt, Brandan",15,7,0,8,1,0,0,5
Geelong,"Ratugolea, Esava",6,5,3,1,4,0,2,2
Geelong,"Rohan, Gary",12,6,2,6,1,1,0,3
Geelong,"Selwood, Joel",8,3,0,5,0,0,0,3
Geelong,"Smith, Isaac",25,18,9,7,0,0,0,1
Geelong,"Stanley, Rhys",14,5,1,9,1,0,25,0
Geelong,"Stewart, Tom",25,20,9,5,0,0,0,1
Geelong,"Tuohy, Zach",22,15,6,7,0,0,0,3
Geelong,"Bews, Jed",24,17,12,7,0,0,0,2
Geelong,"Blicavs, Mark",15,9,8,6,1,0,14,1
Geelong,"Clark, Jordan",0,0,0,0,0,0,0,0
Geelong,"Close, Brad",20,8,2,12,0,1,0,4
Geelong,"Dahlhaus, Luke",11,4,1,7,0,1,0,2
Geelong,"Dangerfield, Patrick",21,8,4,13,0,0,0,1
Geelong,"Guthrie, Cameron",29,13,6,16,2,1,0,4
Geelong,"Guthrie, Zach",28,24,13,4,0,0,0,2
Geelong,"Hawkins, Tom",14,9,6,5,1,1,5,0
Geelong,"Henry, Jack",13,11,7,2,0,0,0,4
Geelong,"Higgins, Shaun",23,13,7,10,1,1,0,0
Geelong,"Kolodjashnij, Jake",15,13,7,2,0,0,0,0
Geelong,"Kreuger, Nathan",7,5,4,2,0,0,0,2
Geelong,"Menegola, Sam",20,9,6,11,0,2,0,3
Geelong,"Narkle, Quinton",17,6,3,11,1,1,0,2
Geelong,"Parfitt, Brandan",11,3,1,8,0,0,0,0
Geelong,"Ratugolea, Esava",6,5,2,1,0,1,0,2
Geelong,"Rohan, Gary",8,4,2,4,2,2,0,1
Geelong,"Selwood, Joel",21,12,8,9,0,0,0,5
Geelong,"Smith, Isaac",26,20,9,6,0,0,0,3
Geelong,"Stanley, Rhys",15,8,7,7,0,0,12,1
Geelong,"Stewart, Tom",24,20,13,4,0,0,0,1
Geelong,"Tuohy, Zach",26,16,8,10,0,0,0,0
Geelong,"Bews, Jed",23,17,7,6,0,0,0,3
Geelong,"Blicavs, Mark",11,6,2,5,1,0,10,6
Geelong,"Clark, Jordan",18,10,4,8,0,1,0,5
Geelong,"Close, Brad",3,2,2,1,0,1,0,4
Geelong,"Dahlhaus, Luke",12,4,4,8,0,0,0,3
Geelong,"Dangerfield, Patrick",3,1,1,2,0,0,0,1
Geelong,"Guthrie, Cameron",24,10,2,14,0,0,0,9
Geelong,"Guthrie, Zach",15,12,4,3,0,0,0,5
Geelong,"Hawkins, Tom",10,6,5,4,1,1,3,3
Geelong,"Henry, Jack",16,9,7,7,2,0,0,0
Geelong,"Higgins, Shaun",21,12,6,9,0,1,0,1
Geelong,"Holmes, Max",12,10,4,2,0,2,0,4
Geelong,"Kolodjashnij, Jake",20,14,10,6,1,0,0,2
Geelong,"Kreuger, Nathan",8,6,3,2,0,0,0,6
Geelong,"Menegola, Sam",22,18,7,4,0,1,0,5
Geelong,"Narkle, Quinton",11,7,2,4,0,0,0,2
Geelong,"Parfitt, Brandan",20,12,1,8,0,1,0,5
Geelong,"Ratugolea, Esava",6,4,3,2,2,0,5,2
Geelong,"Rohan, Gary",2,1,1,1,0,0,0,1
Geelong,"Selwood, Joel",27,18,4,9,0,1,0,5
Geelong,"Stanley, Rhys",20,13,7,7,0,1,31,1
Geelong,"Stewart, Tom",22,18,10,4,0,1,0,3
Geelong,"Tuohy, Zach",18,13,7,5,1,0,0,1
Geelong,"Bews, Jed",15,7,2,8,0,0,0,0
Geelong,"Blicavs, Mark",11,8,6,3,0,0,0,1
Geelong,"Cameron, Jeremy",13,9,7,4,4,0,0,0
Geelong,"Close, Brad",9,1,1,8,1,0,0,4
Geelong,"Dahlhaus, Luke",18,4,1,14,0,0,0,9
Geelong,"Dangerfield, Patrick",31,18,6,13,1,1,0,6
Geelong,"Guthrie, Cameron",36,20,9,16,0,0,0,3
Geelong,"Guthrie, Zach",16,14,6,2,0,0,0,0
Geelong,"Hawkins, Tom",14,10,4,4,3,1,8,2
Geelong,"Henderson, Lachie",22,15,9,7,0,0,0,2
Geelong,"Henry, Jack",17,10,8,7,0,0,0,1
Geelong,"Higgins, Shaun",26,13,9,13,0,0,0,5
Geelong,"Holmes, Max",17,7,3,10,0,0,0,3
Geelong,"Kolodjashnij, Jake",9,5,5,4,0,0,0,0
Geelong,"Menegola, Sam",35,24,9,11,1,1,0,2
Geelong,"Narkle, Quinton",0,0,0,0,0,0,0,0
Geelong,"OConnor, Mark",16,9,5,7,0,0,0,1
Geelong,"Parfitt, Brandan",10,3,0,7,0,0,0,5
Geelong,"Ratugolea, Esava",3,2,0,1,0,0,6,0
Geelong,"Selwood, Joel",26,17,5,9,0,0,0,4
Geelong,"Simpson, Sam",18,9,5,9,1,1,0,1
Geelong,"Smith, Isaac",22,16,7,6,1,1,0,1
Geelong,"Stanley, Rhys",16,7,4,9,1,0,31,5
Geelong,"Atkins, Tom",16,8,4,8,0,0,0,4
Geelong,"Bews, Jed",15,8,6,7,0,0,0,2
Geelong,"Blicavs, Mark",14,8,4,6,0,0,5,5
Geelong,"Cameron, Jeremy",10,7,4,3,2,2,0,0
Geelong,"Close, Brad",13,7,5,6,1,0,0,2
Geelong,"Dahlhaus, Luke",13,6,3,7,1,2,0,3
Geelong,"Dangerfield, Patrick",23,8,3,15,1,0,0,3
Geelong,"Guthrie, Cameron",30,16,8,14,0,0,0,2
Geelong,"Hawkins, Tom",12,9,5,3,4,0,1,2
Geelong,"Henderson, Lachie",24,21,15,3,0,0,0,1
Geelong,"Henry, Jack",14,8,6,6,0,0,0,4
Geelong,"Higgins, Shaun",0,0,0,0,0,0,0,0
Geelong,"Holmes, Max",18,4,2,14,0,0,0,7
Geelong,"Kolodjashnij, Jake",15,12,7,3,0,0,0,0
Geelong,"Menegola, Sam",25,20,7,5,0,0,0,2
Geelong,"Miers, Gryan",13,8,1,5,0,0,0,1
Geelong,"OConnor, Mark",15,10,6,5,0,0,0,0
Geelong,"Parfitt, Brandan",22,12,0,10,0,0,0,8
Geelong,"Rohan, Gary",8,3,2,5,2,1,0,3
Geelong,"Selwood, Joel",28,17,4,11,1,0,0,6
Geelong,"Simpson, Sam",12,8,2,4,0,0,0,2
Geelong,"Smith, Isaac",24,20,11,4,0,0,0,1
Geelong,"Stanley, Rhys",13,9,1,4,0,0,33,3
Geelong,"Atkins, Tom",11,5,3,6,0,0,0,3
Geelong,"Bews, Jed",7,3,2,4,0,0,0,2
Geelong,"Blicavs, Mark",8,6,2,2,0,0,15,2
Geelong,"Cameron, Jeremy",10,8,4,2,1,2,0,1
Geelong,"Close, Brad",17,7,4,10,0,1,0,4
Geelong,"Dahlhaus, Luke",6,3,1,3,0,1,0,2
Geelong,"Dangerfield, Patrick",23,17,3,6,0,0,0,5
Geelong,"Duncan, Mitch",33,24,13,9,0,0,0,1
Geelong,"Guthrie, Cameron",17,6,2,11,0,0,0,3
Geelong,"Hawkins, Tom",10,7,3,3,2,1,1,1
Geelong,"Henderson, Lachie",11,6,3,5,0,0,0,1
Geelong,"Henry, Jack",15,14,9,1,0,0,0,1
Geelong,"Higgins, Shaun",10,3,3,7,0,0,0,2
Geelong,"Kolodjashnij, Jake",10,5,3,5,0,0,0,3
Geelong,"Menegola, Sam",22,11,3,11,0,1,0,2
Geelong,"Miers, Gryan",12,8,3,4,0,1,0,2
Geelong,"OConnor, Mark",3,3,1,0,0,0,0,0
Geelong,"Parfitt, Brandan",21,11,0,10,0,2,0,8
Geelong,"Rohan, Gary",12,9,4,3,0,0,0,1
Geelong,"Selwood, Joel",17,9,2,8,1,0,0,2
Geelong,"Simpson, Sam",11,6,4,5,1,0,0,3
Geelong,"Smith, Isaac",23,18,2,5,0,1,0,1
Geelong,"Stanley, Rhys",6,4,2,2,0,0,20,0
Geelong,"Atkins, Tom",11,6,2,5,0,0,0,0
Geelong,"Bews, Jed",14,6,3,8,0,0,0,1
Geelong,"Blicavs, Mark",9,5,4,4,0,0,0,2
Geelong,"Cameron, Jeremy",14,10,4,4,2,2,0,2
Geelong,"Close, Brad",13,7,2,6,2,0,0,2
Geelong,"Dangerfield, Patrick",20,11,3,9,0,0,0,4
Geelong,"Duncan, Mitch",22,13,8,9,0,0,0,2
Geelong,"Guthrie, Cameron",25,16,3,9,0,0,0,4
Geelong,"Guthrie, Zach",7,5,2,2,0,0,0,3
Geelong,"Hawkins, Tom",19,9,8,10,5,1,2,1
Geelong,"Henderson, Lachie",9,9,4,0,0,0,0,2
Geelong,"Henry, Jack",11,9,6,2,0,0,0,2
Geelong,"Holmes, Max",10,6,1,4,0,0,0,8
Geelong,"Kolodjashnij, Jake",16,9,5,7,0,0,0,1
Geelong,"Menegola, Sam",29,19,8,10,2,1,0,5
Geelong,"Miers, Gryan",18,10,6,8,0,1,0,2
Geelong,"Parfitt, Brandan",3,0,0,3,0,0,0,1
Geelong,"Ratugolea, Esava",5,3,1,2,1,1,4,1
Geelong,"Rohan, Gary",13,10,3,3,2,2,0,3
Geelong,"Selwood, Joel",14,8,2,6,0,0,0,8
Geelong,"Smith, Isaac",23,20,5,3,1,2,0,1
Geelong,"Stanley, Rhys",19,15,7,4,0,0,35,3
Geelong,"Tuohy, Zach",31,17,5,14,0,0,0,1
Geelong,"Atkins, Tom",15,9,1,6,0,0,0,3
Geelong,"Bews, Jed",8,5,1,3,0,0,0,6
Geelong,"Blicavs, Mark",16,8,2,8,0,0,9,1
Geelong,"Cameron, Jeremy",4,3,1,1,2,0,0,0
Geelong,"Close, Brad",15,3,2,12,0,0,0,4
Geelong,"Dangerfield, Patrick",30,19,3,11,0,0,0,4
Geelong,"Duncan, Mitch",23,14,5,9,0,0,0,3
Geelong,"Guthrie, Cameron",26,13,4,13,0,0,0,4
Geelong,"Guthrie, Zach",17,15,3,2,0,0,0,4
Geelong,"Hawkins, Tom",15,9,2,6,1,2,4,4
Geelong,"Henderson, Lachie",8,4,2,4,0,0,0,1
Geelong,"Henry, Jack",12,5,3,7,0,0,0,1
Geelong,"Higgins, Shaun",14,6,2,8,0,0,0,1
Geelong,"Holmes, Max",10,3,2,7,0,0,0,3
Geelong,"Kolodjashnij, Jake",8,4,2,4,0,0,0,1
Geelong,"Menegola, Sam",20,12,2,8,0,0,0,5
Geelong,"Miers, Gryan",12,5,1,7,1,0,0,0
Geelong,"Ratugolea, Esava",5,1,1,4,0,0,4,3
Geelong,"Rohan, Gary",1,1,1,0,0,0,0,1
Geelong,"Selwood, Joel",24,8,5,16,0,0,0,8
Geelong,"Smith, Isaac",26,13,5,13,1,0,0,0
Geelong,"Stanley, Rhys",11,4,3,7,1,0,26,3
Geelong,"Tuohy, Zach",21,16,4,5,0,0,0,0
Greater Western Sydney,"Ash, Lachie",21,16,3,5,0,0,0,0
Greater Western Sydney,"Bruhn, Tanner",9,2,0,7,0,0,0,2
Greater Western Sydney,"Buckley, Jack",10,6,1,4,0,1,0,4
Greater Western Sydney,"Coniglio, Stephen",24,19,0,5,1,0,0,2
Greater Western Sydney,"Cumming, Isaac",22,13,3,9,0,0,0,3
Greater Western Sydney,"Davis, Phil",10,7,4,3,0,0,0,0
Greater Western Sydney,"Flynn, Matt",17,7,5,10,0,0,34,0
Greater Western Sydney,"Green, Tom",16,3,2,13,1,0,0,2
Greater Western Sydney,"Greene, Toby",19,13,2,6,1,3,0,1
Greater Western Sydney,"Haynes, Nick",19,16,7,3,0,0,0,0
Greater Western Sydney,"Hill, Bobby",8,6,2,2,1,0,0,6
Greater Western Sydney,"Himmelberg, Harry",12,9,3,3,3,1,1,2
Greater Western Sydney,"Hopper, Jacob",28,13,1,15,1,0,0,4
Greater Western Sydney,"Idun, Connor",10,7,3,3,0,0,0,1
Greater Western Sydney,"Keeffe, Lachlan",11,7,3,4,1,0,11,1
Greater Western Sydney,"Kelly, Josh",26,15,3,11,0,0,0,4
Greater Western Sydney,"OHalloran, Xavier",0,0,0,0,0,0,0,0
Greater Western Sydney,"Perryman, Harry",26,15,7,11,0,1,0,3
Greater Western Sydney,"Reid, Sam",4,4,1,0,0,1,0,2
Greater Western Sydney,"Taranto, Tim",26,19,3,7,1,2,0,4
Greater Western Sydney,"Taylor, Sam",14,3,1,11,0,0,0,1
Greater Western Sydney,"Ward, Callan",25,12,3,13,1,0,1,2
Greater Western Sydney,"de Boer, Matt",14,6,2,8,0,0,0,3
Greater Western Sydney,"Ash, Lachie",17,12,6,5,0,0,0,1
Greater Western Sydney,"Bruhn, Tanner",7,4,1,3,0,1,0,2
Greater Western Sydney,"Buckley, Jack",8,4,2,4,0,1,1,0
Greater Western Sydney,"Coniglio, Stephen",22,12,6,10,0,1,0,4
Greater Western Sydney,"Cumming, Isaac",24,22,5,2,0,0,0,4
Greater Western Sydney,"Daniels, Brent",14,8,1,6,0,0,0,0
Greater Western Sydney,"Davis, Phil",15,9,8,6,0,0,0,3
Greater Western Sydney,"Flynn, Matt",12,3,3,9,0,0,18,4
Greater Western Sydney,"Greene, Toby",20,13,6,7,2,3,0,2
Greater Western Sydney,"Haynes, Nick",18,14,4,4,0,0,0,0
Greater Western Sydney,"Hill, Bobby",12,9,4,3,0,2,0,3
Greater Western Sydney,"Himmelberg, Harry",15,12,6,3,2,0,0,0
Greater Western Sydney,"Hopper, Jacob",18,6,1,12,1,0,0,3
Greater Western Sydney,"Keeffe, Lachlan",13,8,6,5,0,0,0,0
Greater Western Sydney,"Kelly, Josh",20,13,6,7,0,2,0,4
Greater Western Sydney,"Perryman, Harry",26,18,1,8,0,0,0,1
Greater Western Sydney,"Reid, Sam",9,3,2,6,0,1,0,3
Greater Western Sydney,"Shipley, Nick",0,0,0,0,0,0,0,0
Greater Western Sydney,"Sproule, Zach",7,6,1,1,2,0,0,1
Greater Western Sydney,"Taranto, Tim",23,13,2,10,0,1,0,6
Greater Western Sydney,"Taylor, Sam",8,2,3,6,0,0,0,0
Greater Western Sydney,"Ward, Callan",17,7,3,10,0,1,0,1
Greater Western Sydney,"de Boer, Matt",20,9,4,11,0,1,0,6
Greater Western Sydney,"Ash, Lachie",24,17,6,7,0,0,0,2
Greater Western Sydney,"Buckley, Jack",16,8,5,8,0,0,0,4
Greater Western Sydney,"Buntine, Matt",12,9,5,3,0,0,0,2
Greater Western Sydney,"Coniglio, Stephen",7,4,1,3,0,0,0,1
Greater Western Sydney,"Cumming, Isaac",29,17,5,12,0,0,0,0
Greater Western Sydney,"Daniels, Brent",13,8,0,5,0,0,0,1
Greater Western Sydney,"Davis, Phil",2,1,1,1,0,0,0,0
Greater Western Sydney,"Flynn, Matt",13,4,4,9,0,0,24,3
Greater Western Sydney,"Green, Tom",15,3,2,12,1,0,0,3
Greater Western Sydney,"Greene, Toby",17,13,4,4,5,2,0,3
Greater Western Sydney,"Haynes, Nick",18,14,4,4,0,0,0,1
Greater Western Sydney,"Hill, Bobby",7,6,1,1,0,0,0,1
Greater Western Sydney,"Himmelberg, Harry",13,8,5,5,1,0,0,1
Greater Western Sydney,"Hopper, Jacob",25,12,0,13,1,0,0,6
Greater Western Sydney,"Idun, Connor",16,9,8,7,0,0,0,2
Greater Western Sydney,"Keeffe, Lachlan",5,2,2,3,0,0,8,3
Greater Western Sydney,"Kelly, Josh",23,10,3,13,2,0,0,3
Greater Western Sydney,"OHalloran, Xavier",12,8,2,4,1,0,0,2
Greater Western Sydney,"Shipley, Nick",12,7,5,5,0,0,0,2
Greater Western Sydney,"Taranto, Tim",32,23,5,9,0,0,0,6
Greater Western Sydney,"Taylor, Sam",18,12,7,6,0,0,0,3
Greater Western Sydney,"Ward, Callan",20,7,3,13,0,0,0,1
Greater Western Sydney,"de Boer, Matt",10,6,2,4,0,0,0,3
Greater Western Sydney,"Ash, Lachie",28,20,11,8,0,0,0,4
Greater Western Sydney,"Buckley, Jack",14,10,5,4,0,0,0,3
Greater Western Sydney,"Buntine, Matt",14,11,5,3,0,0,0,1
Greater Western Sydney,"Cumming, Isaac",18,15,7,3,0,0,0,3
Greater Western Sydney,"Daniels, Brent",17,11,4,6,0,0,0,2
Greater Western Sydney,"Finlayson, Jeremy",13,12,4,1,4,2,2,0
Greater Western Sydney,"Green, Tom",19,8,3,11,0,0,0,5
Greater Western Sydney,"Greene, Toby",18,14,4,4,5,1,0,4
Greater Western Sydney,"Haynes, Nick",18,13,8,5,0,0,0,1
Greater Western Sydney,"Hill, Bobby",11,9,2,2,1,0,0,3
Greater Western Sydney,"Himmelberg, Harry",20,12,5,8,1,1,0,2
Greater Western Sydney,"Hopper, Jacob",32,9,5,23,0,0,0,2
Greater Western Sydney,"Idun, Connor",14,5,5,9,0,0,0,4
Greater Western Sydney,"Keeffe, Lachlan",15,14,10,1,0,0,0,4
Greater Western Sydney,"Kelly, Josh",22,7,0,15,2,0,0,3
Greater Western Sydney,"Mumford, Shane",17,4,3,13,0,0,16,6
Greater Western Sydney,"OHalloran, Xavier",11,8,3,3,0,0,0,2
Greater Western Sydney,"Riccardi, Jake",10,6,3,4,1,0,0,0
Greater Western Sydney,"Shipley, Nick",0,0,0,0,0,0,0,0
Greater Western Sydney,"Stone, Conor",11,7,2,4,0,0,0,2
Greater Western Sydney,"Taranto, Tim",34,19,8,15,0,0,0,6
Greater Western Sydney,"Taylor, Sam",14,7,4,7,0,0,0,3
Greater Western Sydney,"Ward, Callan",37,16,6,21,0,0,0,3
Greater Western Sydney,"Ash, Lachie",18,14,4,4,0,0,0,1
Greater Western Sydney,"Buckley, Jack",16,8,4,8,0,0,0,3
Greater Western Sydney,"Buntine, Matt",6,4,2,2,0,0,0,0
Greater Western Sydney,"Cumming, Isaac",22,13,1,9,0,0,0,1
Greater Western Sydney,"Daniels, Brent",18,12,5,6,1,1,0,3
Greater Western Sydney,"Finlayson, Jeremy",11,10,1,1,2,0,1,1
Greater Western Sydney,"Green, Tom",24,10,3,14,0,0,0,3
Greater Western Sydney,"Greene, Toby",18,15,4,3,1,7,0,0
Greater Western Sydney,"Haynes, Nick",18,11,1,7,0,0,0,0
Greater Western Sydney,"Hill, Bobby",11,9,2,2,0,2,0,4
Greater Western Sydney,"Himmelberg, Harry",11,8,5,3,2,2,0,2
Greater Western Sydney,"Hopper, Jacob",26,10,1,16,0,0,0,3
Greater Western Sydney,"Idun, Connor",10,3,4,7,0,0,0,1
Greater Western Sydney,"Keeffe, Lachlan",10,7,3,3,0,0,0,1
Greater Western Sydney,"Kelly, Josh",26,14,4,12,1,1,0,1
Greater Western Sydney,"Mumford, Shane",15,5,3,10,0,0,28,6
Greater Western Sydney,"OHalloran, Xavier",15,12,5,3,1,0,0,1
Greater Western Sydney,"Reid, Sam",4,3,2,1,0,0,0,0
Greater Western Sydney,"Riccardi, Jake",12,6,3,6,1,0,0,0
Greater Western Sydney,"Stone, Conor",13,6,4,7,0,0,0,1
Greater Western Sydney,"Taranto, Tim",27,12,4,15,0,0,0,4
Greater Western Sydney,"Taylor, Sam",18,6,4,12,0,0,0,3
Greater Western Sydney,"Ward, Callan",26,10,2,16,0,0,0,3
Greater Western Sydney,"Ash, Lachie",35,23,15,12,0,0,0,2
Greater Western Sydney,"Bruhn, Tanner",5,4,2,1,0,1,0,0
Greater Western Sydney,"Buckley, Jack",13,10,7,3,0,0,0,0
Greater Western Sydney,"Cumming, Isaac",23,15,7,8,0,0,0,6
Greater Western Sydney,"Daniels, Brent",13,3,0,10,0,0,0,4
Greater Western Sydney,"Finlayson, Jeremy",10,9,2,1,0,2,4,1
Greater Western Sydney,"Flynn, Matt",10,4,6,6,0,0,22,1
Greater Western Sydney,"Green, Tom",17,2,1,15,0,0,0,1
Greater Western Sydney,"Greene, Toby",19,15,6,4,4,1,0,0
Greater Western Sydney,"Haynes, Nick",3,3,1,0,0,0,0,0
Greater Western Sydney,"Hill, Bobby",6,5,2,1,0,0,0,3
Greater Western Sydney,"Himmelberg, Harry",9,6,4,3,1,0,0,4
Greater Western Sydney,"Hopper, Jacob",26,20,2,6,1,0,0,4
Greater Western Sydney,"Idun, Connor",13,7,6,6,0,0,0,5
Greater Western Sydney,"Keeffe, Lachlan",9,6,4,3,0,0,0,4
Greater Western Sydney,"Kelly, Josh",17,10,4,7,0,1,0,6
Greater Western Sydney,"OHalloran, Xavier",15,12,4,3,0,0,0,1
Greater Western Sydney,"Perryman, Harry",19,14,8,5,0,0,0,2
Greater Western Sydney,"Riccardi, Jake",4,3,1,1,0,1,0,0
Greater Western Sydney,"Stone, Conor",3,2,1,1,1,0,0,2
Greater Western Sydney,"Taranto, Tim",28,18,6,10,1,1,0,2
Greater Western Sydney,"Taylor, Sam",17,14,8,3,0,0,0,1
Greater Western Sydney,"Ward, Callan",15,9,2,6,1,1,0,3
Greater Western Sydney,"Ash, Lachie",22,16,7,6,0,0,0,1
Greater Western Sydney,"Buckley, Jack",17,12,7,5,0,0,0,4
Greater Western Sydney,"Buntine, Matt",6,5,0,1,0,0,0,1
Greater Western Sydney,"Cumming, Isaac",25,15,5,10,0,1,0,3
Greater Western Sydney,"Daniels, Brent",3,2,1,1,0,1,0,0
Greater Western Sydney,"Finlayson, Jeremy",13,6,4,7,0,0,3,1
Greater Western Sydney,"Green, Tom",22,7,2,15,2,1,0,2
Greater Western Sydney,"Greene, Toby",19,12,7,7,1,3,0,2
Greater Western Sydney,"Hill, Bobby",8,6,0,2,1,3,0,5
Greater Western Sydney,"Himmelberg, Harry",13,10,5,3,3,1,0,1
Greater Western Sydney,"Hogan, Jesse",15,7,5,8,4,1,0,1
Greater Western Sydney,"Hopper, Jacob",30,14,9,16,0,1,0,1
Greater Western Sydney,"Idun, Connor",16,10,7,6,0,0,0,2
Greater Western Sydney,"Keeffe, Lachlan",10,7,6,3,0,0,0,3
Greater Western Sydney,"Kelly, Josh",27,16,10,11,1,1,0,4
Greater Western Sydney,"Mumford, Shane",15,4,0,11,0,0,21,4
Greater Western Sydney,"OHalloran, Xavier",16,12,4,4,1,0,0,2
Greater Western Sydney,"Perryman, Harry",26,18,6,8,0,0,0,3
Greater Western Sydney,"Reid, Sam",6,4,0,2,2,0,0,2
Greater Western Sydney,"Taranto, Tim",35,21,6,14,0,0,0,7
Greater Western Sydney,"Taylor, Sam",14,13,9,1,0,0,0,3
Greater Western Sydney,"Ward, Callan",22,8,3,14,0,0,0,7
Greater Western Sydney,"Whitfield, Lachie",30,21,8,9,0,1,0,1
Greater Western Sydney,"Ash, Lachie",23,9,5,14,0,0,0,2
Greater Western Sydney,"Bruhn, Tanner",6,4,0,2,2,0,0,3
Greater Western Sydney,"Buckley, Jack",9,7,2,2,0,0,0,1
Greater Western Sydney,"Cumming, Isaac",20,15,3,5,0,0,0,2
Greater Western Sydney,"Finlayson, Jeremy",13,9,2,4,3,1,4,1
Greater Western Sydney,"Green, Tom",28,14,7,14,0,0,0,3
Greater Western Sydney,"Greene, Toby",21,17,6,4,2,2,0,5
Greater Western Sydney,"Hill, Bobby",11,8,2,3,1,1,0,1
Greater Western Sydney,"Himmelberg, Harry",12,9,5,3,1,2,0,2
Greater Western Sydney,"Hopper, Jacob",23,11,4,12,1,0,0,0
Greater Western Sydney,"Idun, Connor",15,11,4,4,0,0,0,2
Greater Western Sydney,"Keeffe, Lachlan",6,6,3,0,0,0,0,0
Greater Western Sydney,"Kelly, Josh",30,14,4,16,2,0,0,3
Greater Western Sydney,"Lloyd, Daniel",17,11,4,6,1,1,0,1
Greater Western Sydney,"Mumford, Shane",10,3,0,7,0,0,24,1
Greater Western Sydney,"OHalloran, Xavier",15,11,3,4,0,0,0,2
Greater Western Sydney,"Perryman, Harry",24,14,6,10,0,0,0,1
Greater Western Sydney,"Sproule, Zach",10,5,2,5,2,1,0,0
Greater Western Sydney,"Stone, Conor",0,0,0,0,0,0,0,0
Greater Western Sydney,"Taranto, Tim",29,17,5,12,1,0,0,8
Greater Western Sydney,"Taylor, Sam",16,11,8,5,0,0,0,1
Greater Western Sydney,"Ward, Callan",23,11,4,12,0,0,0,2
Greater Western Sydney,"Whitfield, Lachie",19,9,9,10,0,0,0,2
Greater Western Sydney,"Ash, Lachie",14,5,2,9,0,0,0,2
Greater Western Sydney,"Briggs, Kieren",7,3,3,4,0,0,15,2
Greater Western Sydney,"Bruhn, Tanner",6,2,1,4,0,1,0,2
Greater Western Sydney,"Buckley, Jack",10,7,6,3,0,0,0,3
Greater Western Sydney,"Buntine, Matt",14,9,2,5,0,0,0,3
Greater Western Sydney,"Cumming, Isaac",20,13,4,7,0,0,0,4
Greater Western Sydney,"Flynn, Matt",12,7,4,5,0,1,30,9
Greater Western Sydney,"Green, Tom",24,9,2,15,1,0,0,4
Greater Western Sydney,"Greene, Toby",17,15,4,2,1,1,0,2
Greater Western Sydney,"Hill, Bobby",9,9,3,0,1,1,0,3
Greater Western Sydney,"Himmelberg, Harry",4,1,2,3,0,0,0,0
Greater Western Sydney,"Hogan, Jesse",16,12,9,4,4,1,0,2
Greater Western Sydney,"Hopper, Jacob",35,16,5,19,1,0,0,7
Greater Western Sydney,"Idun, Connor",12,8,5,4,0,0,0,2
Greater Western Sydney,"Kelly, Josh",27,14,3,13,1,1,0,8
Greater Western Sydney,"Lloyd, Daniel",15,11,7,4,1,1,0,5
Greater Western Sydney,"OHalloran, Xavier",10,5,3,5,1,1,0,0
Greater Western Sydney,"Perryman, Harry",15,10,4,5,0,0,0,4
Greater Western Sydney,"Riccardi, Jake",17,9,4,8,0,0,0,0
Greater Western Sydney,"Taranto, Tim",32,14,4,18,0,0,0,4
Greater Western Sydney,"Taylor, Sam",8,4,2,4,0,0,0,1
Greater Western Sydney,"Ward, Callan",25,10,3,15,1,0,0,8
Greater Western Sydney,"Whitfield, Lachie",24,17,7,7,0,0,0,2
Greater Western Sydney,"Ash, Lachie",20,17,8,3,0,0,0,3
Greater Western Sydney,"Buckley, Jack",13,10,5,3,0,0,0,4
Greater Western Sydney,"Buntine, Matt",12,9,5,3,0,0,0,4
Greater Western Sydney,"Cumming, Isaac",20,13,4,7,0,0,0,2
Greater Western Sydney,"Finlayson, Jeremy",15,11,6,4,3,1,0,0
Greater Western Sydney,"Flynn, Matt",13,7,6,6,2,0,11,0
Greater Western Sydney,"Green, Tom",27,13,7,14,2,2,0,3
Greater Western Sydney,"Haynes, Nick",17,12,10,5,0,0,0,0
Greater Western Sydney,"Hill, Bobby",15,8,3,7,2,2,0,4
Greater Western Sydney,"Himmelberg, Harry",20,11,5,9,0,2,0,2
Greater Western Sydney,"Hopper, Jacob",28,15,2,13,0,1,0,6
Greater Western Sydney,"Idun, Connor",18,10,7,8,0,0,0,1
Greater Western Sydney,"Kelly, Josh",25,19,5,6,0,0,0,8
Greater Western Sydney,"Lloyd, Daniel",17,13,6,4,1,1,0,8
Greater Western Sydney,"Mumford, Shane",8,3,3,5,0,0,10,7
Greater Western Sydney,"OHalloran, Xavier",0,0,0,0,0,0,0,0
Greater Western Sydney,"Reid, Sam",7,3,2,4,0,1,0,3
Greater Western Sydney,"Riccardi, Jake",14,8,7,6,0,0,0,1
Greater Western Sydney,"Sproule, Zach",11,8,3,3,2,1,0,3
Greater Western Sydney,"Taranto, Tim",25,15,5,10,0,0,0,8
Greater Western Sydney,"Taylor, Sam",21,13,9,8,0,0,0,4
Greater Western Sydney,"Ward, Callan",29,14,3,15,0,0,0,6
Greater Western Sydney,"Whitfield, Lachie",29,16,10,13,1,0,0,2
Greater Western Sydney,"Ash, Lachie",26,19,8,7,0,0,0,4
Greater Western Sydney,"Brown, Callum",0,0,0,0,0,0,0,0
Greater Western Sydney,"Buckley, Jack",13,8,7,5,0,0,0,3
Greater Western Sydney,"Buntine, Matt",8,5,2,3,0,0,0,4
Greater Western Sydney,"Cumming, Isaac",28,20,12,8,0,0,0,1
Greater Western Sydney,"Finlayson, Jeremy",8,7,1,1,1,1,0,0
Greater Western Sydney,"Flynn, Matt",10,5,2,5,1,0,17,3
Greater Western Sydney,"Green, Tom",15,8,1,7,0,1,0,2
Greater Western Sydney,"Haynes, Nick",16,11,7,5,0,0,0,3
Greater Western Sydney,"Hill, Bobby",7,5,3,2,2,1,0,2
Greater Western Sydney,"Himmelberg, Harry",13,9,7,4,0,1,0,3
Greater Western Sydney,"Hopper, Jacob",31,18,5,13,1,0,0,3
Greater Western Sydney,"Idun, Connor",12,6,7,6,0,0,0,2
Greater Western Sydney,"Kelly, Josh",26,11,3,15,2,0,0,6
Greater Western Sydney,"Lloyd, Daniel",13,6,4,7,0,0,0,3
Greater Western Sydney,"Mumford, Shane",5,0,1,5,0,0,21,2
Greater Western Sydney,"OHalloran, Xavier",11,6,1,5,0,0,0,3
Greater Western Sydney,"Reid, Sam",8,4,0,4,0,0,0,1
Greater Western Sydney,"Riccardi, Jake",15,8,3,7,0,0,0,1
Greater Western Sydney,"Sproule, Zach",6,5,1,1,1,0,0,3
Greater Western Sydney,"Taranto, Tim",36,23,8,13,0,0,0,6
Greater Western Sydney,"Ward, Callan",32,17,8,15,2,0,0,1
Greater Western Sydney,"Whitfield, Lachie",30,22,11,8,0,0,0,1
Greater Western Sydney,"Ash, Lachie",16,15,6,1,0,0,0,3
Greater Western Sydney,"Buckley, Jack",12,10,7,2,0,0,0,2
Greater Western Sydney,"Cumming, Isaac",24,22,1,2,0,0,0,4
Greater Western Sydney,"Finlayson, Jeremy",9,7,2,2,2,0,0,1
Greater Western Sydney,"Flynn, Matt",12,3,6,9,2,0,5,2
Greater Western Sydney,"Green, Tom",18,7,5,11,0,1,0,2
Greater Western Sydney,"Greene, Toby",16,13,4,3,1,4,0,5
Greater Western Sydney,"Haynes, Nick",26,16,14,10,0,0,0,0
Greater Western Sydney,"Hill, Bobby",5,5,1,0,1,0,0,2
Greater Western Sydney,"Himmelberg, Harry",16,12,4,4,2,1,0,1
Greater Western Sydney,"Hopper, Jacob",22,14,1,8,0,0,0,0
Greater Western Sydney,"Idun, Connor",14,8,5,6,0,0,0,4
Greater Western Sydney,"Kelly, Josh",39,23,5,16,2,1,0,6
Greater Western Sydney,"Kennedy, Adam",11,6,3,5,0,0,0,2
Greater Western Sydney,"Lloyd, Daniel",14,10,3,4,2,0,0,0
Greater Western Sydney,"Mumford, Shane",7,1,1,6,0,0,23,4
Greater Western Sydney,"OHalloran, Xavier",0,0,0,0,0,0,0,0
Greater Western Sydney,"Reid, Sam",15,8,4,7,0,0,0,3
Greater Western Sydney,"Stein, Jake",4,4,3,0,0,0,0,0
Greater Western Sydney,"Taranto, Tim",26,18,5,8,1,0,0,4
Greater Western Sydney,"Ward, Callan",19,11,4,8,1,0,0,4
Greater Western Sydney,"Whitfield, Lachie",21,15,6,6,0,0,0,1
Greater Western Sydney,"de Boer, Matt",10,4,2,6,0,0,0,4
Greater Western Sydney,"Ash, Lachie",0,0,0,0,0,0,0,0
Greater Western Sydney,"Briggs, Kieren",6,2,1,4,1,0,15,6
Greater Western Sydney,"Buckley, Jack",11,7,4,4,0,0,0,1
Greater Western Sydney,"Cumming, Isaac",23,21,12,2,1,0,0,4
Greater Western Sydney,"Davis, Phil",9,5,5,4,0,0,0,3
Greater Western Sydney,"Finlayson, Jeremy",13,11,10,2,5,0,0,2
Greater Western Sydney,"Flynn, Matt",10,5,3,5,0,0,18,3
Greater Western Sydney,"Green, Tom",11,7,2,4,0,0,0,3
Greater Western Sydney,"Greene, Toby",20,16,8,4,4,2,0,1
Greater Western Sydney,"Haynes, Nick",22,14,10,8,0,1,0,1
Greater Western Sydney,"Hill, Bobby",6,6,3,0,0,0,0,5
Greater Western Sydney,"Himmelberg, Harry",17,11,6,6,2,1,0,3
Greater Western Sydney,"Hopper, Jacob",27,15,5,12,1,0,0,4
Greater Western Sydney,"Idun, Connor",13,12,10,1,0,0,0,4
Greater Western Sydney,"Kelly, Josh",25,15,7,10,1,1,0,3
Greater Western Sydney,"Kennedy, Adam",10,7,4,3,0,0,0,3
Greater Western Sydney,"Lloyd, Daniel",14,11,6,3,1,0,0,1
Greater Western Sydney,"Perryman, Harry",17,13,9,4,0,0,0,2
Greater Western Sydney,"Reid, Sam",13,8,4,5,0,0,0,2
Greater Western Sydney,"Taranto, Tim",24,18,11,6,0,0,0,12
Greater Western Sydney,"Ward, Callan",16,10,3,6,0,0,0,0
Greater Western Sydney,"Whitfield, Lachie",26,20,10,6,0,0,0,4
Greater Western Sydney,"de Boer, Matt",16,8,5,8,0,0,0,12
Greater Western Sydney,"Ash, Lachie",0,0,0,0,0,0,0,0
Greater Western Sydney,"Briggs, Kieren",14,4,2,10,1,0,9,2
Greater Western Sydney,"Buckley, Jack",7,5,6,2,0,0,0,2
Greater Western Sydney,"Cumming, Isaac",27,22,8,5,0,0,0,2
Greater Western Sydney,"Daniels, Brent",10,2,1,8,0,0,0,3
Greater Western Sydney,"Davis, Phil",8,3,4,5,0,0,0,0
Greater Western Sydney,"Finlayson, Jeremy",7,5,4,2,1,0,2,5
Greater Western Sydney,"Flynn, Matt",14,3,6,11,0,1,15,0
Greater Western Sydney,"Greene, Toby",16,9,2,7,2,1,0,3
Greater Western Sydney,"Haynes, Nick",18,13,13,5,0,0,0,2
Greater Western Sydney,"Hill, Bobby",12,7,2,5,2,0,0,1
Greater Western Sydney,"Himmelberg, Harry",10,7,3,3,0,0,0,3
Greater Western Sydney,"Hopper, Jacob",24,13,2,11,0,0,0,2
Greater Western Sydney,"Idun, Connor",10,8,6,2,0,0,0,2
Greater Western Sydney,"Kelly, Josh",25,13,1,12,0,2,0,8
Greater Western Sydney,"Kennedy, Adam",17,9,5,8,0,1,0,2
Greater Western Sydney,"Lloyd, Daniel",12,10,6,2,2,0,0,3
Greater Western Sydney,"Perryman, Harry",29,21,5,8,1,0,0,2
Greater Western Sydney,"Reid, Sam",11,6,0,5,0,0,0,6
Greater Western Sydney,"Taranto, Tim",25,10,5,15,0,0,0,5
Greater Western Sydney,"Ward, Callan",20,14,5,6,2,0,0,1
Greater Western Sydney,"Whitfield, Lachie",32,20,6,12,0,0,0,6
Greater Western Sydney,"de Boer, Matt",12,3,2,9,0,0,0,1
Greater Western Sydney,"Ash, Lachie",13,11,5,2,0,1,0,3
Greater Western Sydney,"Buckley, Jack",0,0,0,0,0,0,0,0
Greater Western Sydney,"Cumming, Isaac",16,9,2,7,0,0,0,5
Greater Western Sydney,"Daniels, Brent",10,4,2,6,0,1,0,3
Greater Western Sydney,"Davis, Phil",12,7,7,5,0,0,0,3
Greater Western Sydney,"Finlayson, Jeremy",7,7,2,0,0,1,0,1
Greater Western Sydney,"Flynn, Matt",7,1,0,6,0,0,6,1
Greater Western Sydney,"Green, Tom",25,9,6,16,0,0,0,3
Greater Western Sydney,"Greene, Toby",7,7,2,0,3,0,0,0
Greater Western Sydney,"Haynes, Nick",16,10,9,6,0,0,0,1
Greater Western Sydney,"Hill, Bobby",13,5,1,8,0,0,0,3
Greater Western Sydney,"Himmelberg, Harry",16,9,4,7,1,1,0,1
Greater Western Sydney,"Hopper, Jacob",21,15,3,6,0,1,0,2
Greater Western Sydney,"Idun, Connor",5,3,2,2,0,0,0,1
Greater Western Sydney,"Kelly, Josh",29,18,2,11,1,1,0,7
Greater Western Sydney,"Kennedy, Adam",18,13,9,5,0,0,0,2
Greater Western Sydney,"Lloyd, Daniel",15,11,4,4,0,0,0,6
Greater Western Sydney,"Mumford, Shane",10,3,2,7,0,0,26,5
Greater Western Sydney,"Perryman, Harry",23,15,3,8,0,0,0,1
Greater Western Sydney,"Reid, Sam",9,2,0,7,1,0,0,1
Greater Western Sydney,"Taranto, Tim",28,18,6,10,1,0,0,4
Greater Western Sydney,"Ward, Callan",24,18,7,6,1,1,0,4
Greater Western Sydney,"Whitfield, Lachie",20,14,6,6,1,0,0,3
Greater Western Sydney,"Ash, Lachie",5,3,1,2,0,0,0,5
Greater Western Sydney,"Cumming, Isaac",17,10,4,7,0,0,0,1
Greater Western Sydney,"Daniels, Brent",20,9,1,11,0,0,0,6
Greater Western Sydney,"Davis, Phil",12,8,4,4,0,0,0,3
Greater Western Sydney,"Finlayson, Jeremy",9,3,0,6,1,1,0,1
Greater Western Sydney,"Green, Tom",25,5,2,20,0,0,0,6
Greater Western Sydney,"Greene, Toby",21,14,2,7,3,2,0,4
Greater Western Sydney,"Haynes, Nick",21,13,4,8,0,0,0,0
Greater Western Sydney,"Hill, Bobby",7,5,1,2,1,0,0,0
Greater Western Sydney,"Himmelberg, Harry",19,10,5,9,2,1,0,4
Greater Western Sydney,"Hogan, Jesse",17,8,8,9,0,2,0,2
Greater Western Sydney,"Hopper, Jacob",41,27,3,14,0,0,0,5
Greater Western Sydney,"Idun, Connor",10,3,1,7,0,0,0,0
Greater Western Sydney,"Kelly, Josh",27,15,1,12,0,0,0,9
Greater Western Sydney,"Kennedy, Adam",16,11,1,5,0,0,0,1
Greater Western Sydney,"Lloyd, Daniel",14,8,3,6,1,0,0,4
Greater Western Sydney,"Mumford, Shane",7,1,0,6,0,0,53,6
Greater Western Sydney,"Perryman, Harry",26,15,3,11,0,0,0,4
Greater Western Sydney,"Reid, Sam",7,4,2,3,0,0,0,2
Greater Western Sydney,"Taranto, Tim",18,10,2,8,0,0,0,12
Greater Western Sydney,"Taylor, Sam",14,10,2,4,0,0,0,2
Greater Western Sydney,"Ward, Callan",21,12,1,9,0,1,4,4
Greater Western Sydney,"Whitfield, Lachie",3,3,1,0,1,0,0,3
Greater Western Sydney,"Bruhn, Tanner",11,6,3,5,1,0,0,2
Greater Western Sydney,"Coniglio, Stephen",19,6,1,13,0,0,0,5
Greater Western Sydney,"Cumming, Isaac",19,12,1,7,0,1,0,3
Greater Western Sydney,"Daniels, Brent",18,11,2,7,0,1,0,2
Greater Western Sydney,"Davis, Phil",12,6,1,6,0,0,0,0
Greater Western Sydney,"Finlayson, Jeremy",13,9,2,4,1,0,8,1
Greater Western Sydney,"Flynn, Matt",12,6,1,6,0,0,22,4
Greater Western Sydney,"Green, Tom",22,8,1,14,0,0,0,4
Greater Western Sydney,"Haynes, Nick",14,6,4,8,0,0,0,0
Greater Western Sydney,"Himmelberg, Harry",8,6,3,2,3,0,2,2
Greater Western Sydney,"Hogan, Jesse",12,8,7,4,2,0,0,0
Greater Western Sydney,"Hopper, Jacob",23,13,5,10,0,0,0,9
Greater Western Sydney,"Idun, Connor",13,10,6,3,0,0,0,1
Greater Western Sydney,"Kelly, Josh",19,12,2,7,0,1,0,7
Greater Western Sydney,"Kennedy, Adam",16,6,2,10,1,0,0,4
Greater Western Sydney,"Lloyd, Daniel",10,7,5,3,2,0,0,2
Greater Western Sydney,"OHalloran, Xavier",8,6,2,2,0,0,0,3
Greater Western Sydney,"Perryman, Harry",23,11,3,12,1,0,0,3
Greater Western Sydney,"Reid, Sam",6,2,1,4,0,0,0,2
Greater Western Sydney,"Sproule, Zach",3,1,1,2,0,1,3,1
Greater Western Sydney,"Taranto, Tim",27,18,4,9,0,0,0,7
Greater Western Sydney,"Taylor, Sam",12,7,7,5,0,0,0,1
Greater Western Sydney,"Ward, Callan",24,9,5,15,0,0,0,3
Greater Western Sydney,"Ash, Lachie",13,9,6,4,1,0,0,4
Greater Western Sydney,"Bruhn, Tanner",6,4,1,2,0,0,0,2
Greater Western Sydney,"Cumming, Isaac",22,17,11,5,0,0,0,1
Greater Western Sydney,"Daniels, Brent",17,10,3,7,1,0,0,5
Greater Western Sydney,"Davis, Phil",14,11,8,3,0,0,0,1
Greater Western Sydney,"Green, Tom",29,18,7,11,0,1,0,1
Greater Western Sydney,"Haynes, Nick",13,9,8,4,0,0,0,0
Greater Western Sydney,"Himmelberg, Harry",9,7,7,2,1,3,0,1
Greater Western Sydney,"Hogan, Jesse",13,10,7,3,2,1,0,1
Greater Western Sydney,"Hopper, Jacob",22,10,1,12,0,0,0,0
Greater Western Sydney,"Idun, Connor",16,11,9,5,0,0,0,0
Greater Western Sydney,"Kelly, Josh",23,13,6,10,0,0,0,5
Greater Western Sydney,"Kennedy, Adam",18,8,9,10,0,0,0,0
Greater Western Sydney,"Lloyd, Daniel",9,8,4,1,1,2,0,4
Greater Western Sydney,"Mumford, Shane",11,5,2,6,1,0,20,2
Greater Western Sydney,"OHalloran, Xavier",12,9,4,3,0,0,0,2
Greater Western Sydney,"Perryman, Harry",25,16,9,9,0,0,0,2
Greater Western Sydney,"Reid, Sam",8,6,6,2,1,1,0,2
Greater Western Sydney,"Riccardi, Jake",0,0,0,0,0,0,0,0
Greater Western Sydney,"Taranto, Tim",21,9,6,12,0,3,0,0
Greater Western Sydney,"Taylor, Sam",21,15,11,6,0,0,0,3
Greater Western Sydney,"Ward, Callan",17,14,4,3,1,0,0,1
Greater Western Sydney,"Whitfield, Lachie",35,25,10,10,0,0,0,2
Greater Western Sydney,"Ash, Lachie",15,6,2,9,0,0,0,3
Greater Western Sydney,"Bruhn, Tanner",6,1,2,5,0,0,0,2
Greater Western Sydney,"Cumming, Isaac",17,11,4,6,0,0,0,0
Greater Western Sydney,"Daniels, Brent",13,8,1,5,0,0,0,2
Greater Western Sydney,"Davis, Phil",8,4,1,4,0,0,0,1
Greater Western Sydney,"Green, Tom",11,6,0,5,0,0,1,5
Greater Western Sydney,"Greene, Toby",15,9,4,6,2,4,0,1
Greater Western Sydney,"Haynes, Nick",28,17,10,11,0,0,0,2
Greater Western Sydney,"Himmelberg, Harry",9,4,3,5,1,0,0,0
Greater Western Sydney,"Hogan, Jesse",13,7,5,6,2,1,0,0
Greater Western Sydney,"Hopper, Jacob",29,11,2,18,0,0,0,2
Greater Western Sydney,"Idun, Connor",11,7,5,4,0,0,0,1
Greater Western Sydney,"Kelly, Josh",31,17,3,14,0,0,0,4
Greater Western Sydney,"Lloyd, Daniel",15,12,3,3,3,0,0,0
Greater Western Sydney,"Mumford, Shane",8,3,0,5,1,0,23,10
Greater Western Sydney,"OHalloran, Xavier",14,8,2,6,0,0,0,1
Greater Western Sydney,"Peatling, James",19,14,7,5,0,0,0,3
Greater Western Sydney,"Perryman, Harry",20,13,8,7,0,1,0,2
Greater Western Sydney,"Reid, Sam",6,3,1,3,0,0,0,4
Greater Western Sydney,"Taranto, Tim",15,6,4,9,1,0,0,0
Greater Western Sydney,"Taylor, Sam",14,6,6,8,0,0,0,2
Greater Western Sydney,"Ward, Callan",18,10,4,8,1,0,0,1
Greater Western Sydney,"Whitfield, Lachie",25,15,3,10,0,0,0,1
Greater Western Sydney,"Ash, Lachie",16,9,2,7,0,0,0,8
Greater Western Sydney,"Briggs, Kieren",9,6,1,3,0,0,20,9
Greater Western Sydney,"Brown, Callum",6,4,2,2,2,0,0,1
Greater Western Sydney,"Bruhn, Tanner",12,8,4,4,1,0,0,5
Greater Western Sydney,"Buntine, Matt",6,3,0,3,1,1,0,2
Greater Western Sydney,"Cumming, Isaac",34,26,4,8,0,1,0,3
Greater Western Sydney,"Daniels, Brent",11,3,1,8,0,0,0,4
Greater Western Sydney,"Greene, Toby",16,13,1,3,4,1,1,1
Greater Western Sydney,"Haynes, Nick",19,12,6,7,0,0,0,1
Greater Western Sydney,"Himmelberg, Harry",18,8,6,10,2,1,0,1
Greater Western Sydney,"Idun, Connor",13,8,4,5,0,0,0,2
Greater Western Sydney,"OHalloran, Xavier",15,8,2,7,0,1,0,1
Greater Western Sydney,"Peatling, James",11,8,4,3,0,0,0,1
Greater Western Sydney,"Perryman, Harry",19,12,3,7,0,1,0,3
Greater Western Sydney,"Riccardi, Jake",9,4,3,5,0,0,2,1
Greater Western Sydney,"Shipley, Nick",2,1,1,1,0,0,0,0
Greater Western Sydney,"Sproule, Zach",11,7,4,4,1,0,3,7
Greater Western Sydney,"Stein, Jake",2,1,0,1,0,0,0,3
Greater Western Sydney,"Taranto, Tim",34,12,3,22,2,0,0,9
Greater Western Sydney,"Taylor, Sam",21,12,12,9,0,0,0,3
Greater Western Sydney,"Ward, Callan",24,11,2,13,0,0,0,3
Greater Western Sydney,"Whitfield, Lachie",34,23,5,11,0,0,0,1
Greater Western Sydney,"de Boer, Matt",17,8,4,9,0,0,0,2
Greater Western Sydney,"Ash, Lachie",12,10,3,2,0,0,0,7
Greater Western Sydney,"Bruhn, Tanner",14,8,0,6,0,1,0,2
Greater Western Sydney,"Cumming, Isaac",24,16,9,8,0,1,0,1
Greater Western Sydney,"Haynes, Nick",19,13,7,6,0,0,0,1
Greater Western Sydney,"Himmelberg, Harry",9,8,6,1,3,0,0,1
Greater Western Sydney,"Hogan, Jesse",9,6,4,3,1,0,0,0
Greater Western Sydney,"Hopper, Jacob",25,14,7,11,1,1,0,2
Greater Western Sydney,"Idun, Connor",7,4,3,3,0,0,0,3
Greater Western Sydney,"Kelly, Josh",32,16,5,16,0,1,0,11
Greater Western Sydney,"Kennedy, Adam",14,5,1,9,0,0,0,4
Greater Western Sydney,"Lloyd, Daniel",10,4,3,6,2,0,0,2
Greater Western Sydney,"Mumford, Shane",5,2,0,3,1,0,28,4
Greater Western Sydney,"OHalloran, Xavier",17,14,5,3,0,1,0,1
Greater Western Sydney,"Peatling, James",9,5,4,4,0,0,0,2
Greater Western Sydney,"Perryman, Harry",17,14,6,3,1,2,0,3
Greater Western Sydney,"Riccardi, Jake",0,0,0,0,0,0,0,0
Greater Western Sydney,"Sproule, Zach",14,8,3,6,0,1,1,3
Greater Western Sydney,"Stein, Jake",7,4,4,3,0,0,0,0
Greater Western Sydney,"Taranto, Tim",18,13,3,5,4,2,0,3
Greater Western Sydney,"Taylor, Sam",12,6,6,6,0,0,0,2
Greater Western Sydney,"Ward, Callan",22,12,8,10,1,0,0,2
Greater Western Sydney,"Whitfield, Lachie",21,14,4,7,0,0,0,3
Greater Western Sydney,"de Boer, Matt",13,7,6,6,2,0,0,3
Greater Western Sydney,"Ash, Lachie",15,8,5,7,0,0,0,3
Greater Western Sydney,"Briggs, Kieren",13,8,2,5,0,0,26,3
Greater Western Sydney,"Bruhn, Tanner",9,6,1,3,0,0,0,7
Greater Western Sydney,"Coniglio, Stephen",6,4,2,2,0,2,0,1
Greater Western Sydney,"Cumming, Isaac",19,16,12,3,0,0,0,1
Greater Western Sydney,"Greene, Toby",20,15,11,5,1,3,1,2
Greater Western Sydney,"Haynes, Nick",12,9,9,3,0,0,0,1
Greater Western Sydney,"Himmelberg, Harry",10,7,4,3,1,0,2,5
Greater Western Sydney,"Hogan, Jesse",10,7,4,3,3,1,0,3
Greater Western Sydney,"Hopper, Jacob",21,13,2,8,1,1,0,7
Greater Western Sydney,"Idun, Connor",17,8,5,9,0,0,0,0
Greater Western Sydney,"Kelly, Josh",29,19,1,10,0,1,0,5
Greater Western Sydney,"Kennedy, Adam",11,7,1,4,0,0,0,2
Greater Western Sydney,"Lloyd, Daniel",10,5,3,5,1,1,0,4
Greater Western Sydney,"OHalloran, Xavier",9,5,2,4,1,0,0,1
Greater Western Sydney,"Perryman, Harry",21,15,4,6,1,0,0,0
Greater Western Sydney,"Sproule, Zach",9,6,3,3,1,0,4,4
Greater Western Sydney,"Stein, Jake",6,6,3,0,0,0,0,0
Greater Western Sydney,"Taranto, Tim",29,16,5,13,0,4,0,2
Greater Western Sydney,"Taylor, Sam",13,9,8,4,0,0,0,1
Greater Western Sydney,"Ward, Callan",28,15,2,13,2,1,0,5
Greater Western Sydney,"Whitfield, Lachie",21,13,2,8,0,0,0,1
Greater Western Sydney,"de Boer, Matt",16,3,2,13,0,0,0,3
Greater Western Sydney,"Ash, Lachie",18,11,4,7,0,0,0,0
Greater Western Sydney,"Bruhn, Tanner",1,1,0,0,0,0,0,2
Greater Western Sydney,"Coniglio, Stephen",11,9,2,2,0,0,0,6
Greater Western Sydney,"Cumming, Isaac",16,11,2,5,0,0,0,2
Greater Western Sydney,"Green, Tom",12,2,2,10,0,0,0,1
Greater Western Sydney,"Greene, Toby",10,9,1,1,3,1,0,3
Greater Western Sydney,"Haynes, Nick",17,14,11,3,0,0,0,2
Greater Western Sydney,"Himmelberg, Harry",10,5,3,5,2,0,0,1
Greater Western Sydney,"Hogan, Jesse",10,9,8,1,2,2,0,2
Greater Western Sydney,"Hopper, Jacob",23,11,2,12,0,1,0,9
Greater Western Sydney,"Idun, Connor",11,9,8,2,0,0,0,1
Greater Western Sydney,"Kelly, Josh",28,15,1,13,0,1,0,6
Greater Western Sydney,"Lloyd, Daniel",13,10,6,3,1,1,0,1
Greater Western Sydney,"Mumford, Shane",14,6,2,8,0,0,36,3
Greater Western Sydney,"Perryman, Harry",29,22,5,7,0,0,0,1
Greater Western Sydney,"Reid, Sam",9,4,0,5,0,0,0,2
Greater Western Sydney,"Sproule, Zach",11,6,7,5,2,0,3,4
Greater Western Sydney,"Stein, Jake",13,9,6,4,0,0,0,3
Greater Western Sydney,"Taranto, Tim",25,16,5,9,1,0,0,5
Greater Western Sydney,"Taylor, Sam",12,10,6,2,0,0,0,4
Greater Western Sydney,"Ward, Callan",19,11,5,8,0,0,0,1
Greater Western Sydney,"Whitfield, Lachie",21,14,4,7,0,0,0,4
Greater Western Sydney,"de Boer, Matt",9,3,0,6,0,1,0,1
Greater Western Sydney,"Ash, Lachie",21,15,2,6,0,0,0,5
Greater Western Sydney,"Bruhn, Tanner",9,6,1,3,0,0,0,2
Greater Western Sydney,"Coniglio, Stephen",14,7,2,7,0,1,0,8
Greater Western Sydney,"Cumming, Isaac",16,8,5,8,0,0,0,0
Greater Western Sydney,"Davis, Phil",9,3,4,6,0,0,0,2
Greater Western Sydney,"Haynes, Nick",21,13,9,8,1,0,0,1
Greater Western Sydney,"Hill, Bobby",6,5,1,1,1,0,0,2
Greater Western Sydney,"Himmelberg, Harry",8,5,2,3,2,1,0,4
Greater Western Sydney,"Hopper, Jacob",27,11,4,16,0,1,0,7
Greater Western Sydney,"Idun, Connor",11,6,4,5,0,0,0,0
Greater Western Sydney,"Kelly, Josh",25,14,3,11,1,0,0,7
Greater Western Sydney,"Lloyd, Daniel",5,3,1,2,1,1,0,1
Greater Western Sydney,"Mumford, Shane",10,4,2,6,1,0,35,8
Greater Western Sydney,"Peatling, James",3,0,0,3,0,0,0,0
Greater Western Sydney,"Perryman, Harry",15,12,2,3,0,0,0,2
Greater Western Sydney,"Sproule, Zach",4,3,2,1,0,1,0,0
Greater Western Sydney,"Stein, Jake",8,5,4,3,0,0,0,1
Greater Western Sydney,"Stone, Conor",8,6,1,2,2,1,0,2
Greater Western Sydney,"Taranto, Tim",20,14,3,6,0,0,0,4
Greater Western Sydney,"Taylor, Sam",6,4,3,2,0,0,0,1
Greater Western Sydney,"Ward, Callan",22,10,0,12,1,0,0,5
Greater Western Sydney,"Whitfield, Lachie",34,22,5,12,0,0,0,4
Greater Western Sydney,"de Boer, Matt",23,9,5,14,0,0,0,2
Hawthorn,"Breust, Luke",18,7,4,11,1,2,0,2
Hawthorn,"Brockman, Tyler",9,5,3,4,2,0,0,1
Hawthorn,"Burgoyne, Shaun",17,11,1,6,0,0,0,3
Hawthorn,"Ceglar, Jonathon",16,10,5,6,1,0,14,2
Hawthorn,"Day, Will",28,17,8,11,0,0,0,3
Hawthorn,"Downie, Connor",0,0,0,0,0,0,0,0
Hawthorn,"Frost, Sam",17,7,4,10,0,0,0,1
Hawthorn,"Hanrahan, Oliver",12,8,4,4,1,1,0,2
Hawthorn,"Hardwick, Blake",21,14,7,7,0,0,0,4
Hawthorn,"Hartigan, Kyle",9,5,4,4,0,0,0,0
Hawthorn,"Howe, Daniel",19,11,7,8,0,0,0,1
Hawthorn,"Impey, Jarman",20,15,5,5,0,0,0,1
Hawthorn,"Jiath, Changkuoth",22,7,4,15,0,1,0,2
Hawthorn,"Koschitzke, Jacob",7,3,3,4,0,1,0,4
Hawthorn,"McEvoy, Ben",14,8,7,6,1,0,14,4
Hawthorn,"Mitchell, Tom",39,11,1,28,0,0,0,5
Hawthorn,"Moore, Dylan",19,7,3,12,3,0,0,3
Hawthorn,"Morrison, Harry",20,13,5,7,2,0,0,2
Hawthorn,"OBrien, Tim",8,7,6,1,2,0,0,2
Hawthorn,"OMeara, Jaeger",30,11,2,19,0,1,0,4
Hawthorn,"Phillips, Tom",21,10,7,11,1,0,0,2
Hawthorn,"Shiels, Liam",19,8,2,11,0,0,0,6
Hawthorn,"Worpel, James",17,12,4,5,0,0,0,3
Hawthorn,"Breust, Luke",10,5,2,5,2,0,0,2
Hawthorn,"Brockman, Tyler",12,7,8,5,2,1,0,1
Hawthorn,"Burgoyne, Shaun",15,8,5,7,0,0,0,3
Hawthorn,"Ceglar, Jonathon",16,6,7,10,0,0,11,0
Hawthorn,"Day, Will",12,8,3,4,0,0,0,1
Hawthorn,"Frost, Sam",16,9,6,7,0,0,0,2
Hawthorn,"Hanrahan, Oliver",13,9,5,4,0,1,0,0
Hawthorn,"Hardwick, Blake",31,27,15,4,0,0,0,0
Hawthorn,"Hartigan, Kyle",15,8,8,7,0,0,0,1
Hawthorn,"Howe, Daniel",21,15,11,6,0,1,0,1
Hawthorn,"Impey, Jarman",22,13,5,9,0,0,0,3
Hawthorn,"Jiath, Changkuoth",25,17,8,8,0,0,0,1
Hawthorn,"Koschitzke, Jacob",9,5,6,4,1,1,0,1
Hawthorn,"McEvoy, Ben",10,1,3,9,0,0,14,1
Hawthorn,"Mitchell, Tom",37,12,7,25,0,0,0,2
Hawthorn,"Moore, Dylan",14,8,4,6,0,1,0,5
Hawthorn,"Morrison, Harry",20,13,11,7,1,1,0,1
Hawthorn,"OBrien, Tim",9,7,6,2,1,0,0,0
Hawthorn,"OMeara, Jaeger",21,10,2,11,0,0,0,4
Hawthorn,"Phillips, Tom",24,15,4,9,0,0,0,2
Hawthorn,"Scrimshaw, Jack",9,7,1,2,0,0,0,0
Hawthorn,"Shiels, Liam",21,11,5,10,0,0,0,4
Hawthorn,"Worpel, James",16,10,5,6,0,0,0,1
Hawthorn,"Breust, Luke",17,11,3,6,2,0,0,5
Hawthorn,"Brockman, Tyler",7,3,1,4,1,0,0,3
Hawthorn,"Burgoyne, Shaun",11,5,1,6,0,0,0,5
Hawthorn,"Ceglar, Jonathon",7,0,0,7,0,0,15,2
Hawthorn,"Frost, Sam",14,9,6,5,0,0,0,3
Hawthorn,"Hardwick, Blake",18,12,2,6,0,0,0,1
Hawthorn,"Hartigan, Kyle",10,5,2,5,0,0,0,1
Hawthorn,"Howe, Daniel",19,15,7,4,0,0,0,1
Hawthorn,"Impey, Jarman",24,19,10,5,0,0,0,0
Hawthorn,"Jiath, Changkuoth",23,15,10,8,0,0,0,2
Hawthorn,"Koschitzke, Jacob",4,4,3,0,1,1,0,1
Hawthorn,"Lewis, Mitch",11,8,3,3,2,1,0,3
Hawthorn,"McEvoy, Ben",14,5,4,9,1,0,21,6
Hawthorn,"Mitchell, Tom",24,6,3,18,0,0,0,3
Hawthorn,"Moore, Dylan",13,5,2,8,1,2,0,1
Hawthorn,"Morrison, Harry",19,12,3,7,0,0,0,4
Hawthorn,"OBrien, Tim",0,0,0,0,0,0,0,0
Hawthorn,"OMeara, Jaeger",34,17,8,17,0,0,0,5
Hawthorn,"Phillips, Tom",21,12,5,9,0,0,0,3
Hawthorn,"Scrimshaw, Jack",22,12,10,10,0,0,0,2
Hawthorn,"Shiels, Liam",26,13,5,13,0,1,0,6
Hawthorn,"Wingard, Chad",22,15,6,7,1,3,0,3
Hawthorn,"Worpel, James",16,7,1,9,0,1,0,4
Hawthorn,"Breust, Luke",8,4,0,4,0,0,0,1
Hawthorn,"Brockman, Tyler",8,5,3,3,1,1,0,3
Hawthorn,"Burgoyne, Shaun",0,0,0,0,0,0,0,0
Hawthorn,"Ceglar, Jonathon",7,2,4,5,0,0,14,3
Hawthorn,"Frost, Sam",18,8,6,10,0,0,0,2
Hawthorn,"Hardwick, Blake",22,12,3,10,0,0,0,2
Hawthorn,"Hartigan, Kyle",13,6,4,7,0,0,0,2
Hawthorn,"Hartley, Michael",26,20,4,6,1,1,0,1
Hawthorn,"Howe, Daniel",18,14,9,4,1,0,0,0
Hawthorn,"Impey, Jarman",28,20,5,8,0,0,0,1
Hawthorn,"Jiath, Changkuoth",24,17,12,7,0,0,0,1
Hawthorn,"Lewis, Mitch",14,9,8,5,1,1,0,1
Hawthorn,"McEvoy, Ben",14,8,8,6,0,1,19,3
Hawthorn,"Mitchell, Tom",38,14,5,24,1,0,0,2
Hawthorn,"Moore, Dylan",16,9,6,7,3,1,0,1
Hawthorn,"Morrison, Harry",22,12,7,10,1,0,0,1
Hawthorn,"OBrien, Tim",6,4,1,2,1,0,0,0
Hawthorn,"OMeara, Jaeger",28,13,6,15,0,0,0,2
Hawthorn,"Phillips, Tom",19,12,6,7,1,1,0,1
Hawthorn,"Scrimshaw, Jack",23,11,2,12,0,0,0,2
Hawthorn,"Shiels, Liam",23,12,5,11,0,0,0,1
Hawthorn,"Wingard, Chad",26,13,7,13,1,1,0,5
Hawthorn,"Worpel, James",22,13,7,9,0,0,0,6
Hawthorn,"Breust, Luke",13,7,0,6,2,1,0,5
Hawthorn,"Burgoyne, Shaun",16,9,2,7,0,0,0,0
Hawthorn,"Cousins, James",0,0,0,0,0,0,0,0
Hawthorn,"Frost, Sam",16,8,4,8,0,0,1,0
Hawthorn,"Hanrahan, Oliver",14,7,6,7,2,0,0,2
Hawthorn,"Hardwick, Blake",19,13,1,6,0,0,0,2
Hawthorn,"Hartigan, Kyle",10,4,1,6,0,0,2,1
Hawthorn,"Howe, Daniel",11,9,2,2,0,1,0,1
Hawthorn,"Impey, Jarman",24,18,5,6,0,0,0,3
Hawthorn,"Jiath, Changkuoth",13,7,3,6,0,0,0,1
Hawthorn,"Koschitzke, Jacob",9,6,4,3,0,0,0,3
Hawthorn,"McEvoy, Ben",11,6,4,5,1,0,17,1
Hawthorn,"Mitchell, Tom",32,15,3,17,0,0,0,4
Hawthorn,"Moore, Dylan",10,4,3,6,1,0,0,3
Hawthorn,"Morrison, Harry",17,10,5,7,0,0,0,5
Hawthorn,"Nash, Conor",5,4,3,1,0,0,0,1
Hawthorn,"OBrien, Tim",7,5,3,2,2,0,1,1
Hawthorn,"OMeara, Jaeger",27,13,7,14,0,0,0,6
Hawthorn,"Phillips, Tom",14,7,3,7,0,0,0,3
Hawthorn,"Scrimshaw, Jack",17,11,9,6,0,0,0,3
Hawthorn,"Shiels, Liam",21,12,7,9,0,0,0,5
Hawthorn,"Wingard, Chad",20,10,2,10,0,0,0,2
Hawthorn,"Worpel, James",16,4,1,12,0,0,0,4
Hawthorn,"Breust, Luke",15,10,1,5,3,1,0,4
Hawthorn,"Burgoyne, Shaun",8,6,1,2,0,0,0,0
Hawthorn,"Cousins, James",17,11,5,6,0,0,0,2
Hawthorn,"Frost, Sam",13,8,7,5,0,0,0,1
Hawthorn,"Hanrahan, Oliver",15,7,2,8,0,0,0,0
Hawthorn,"Hardwick, Blake",20,14,4,6,0,1,0,1
Hawthorn,"Hartigan, Kyle",14,8,4,6,0,0,0,0
Hawthorn,"Impey, Jarman",19,14,6,5,1,0,0,1
Hawthorn,"Jiath, Changkuoth",26,15,5,11,0,0,0,1
Hawthorn,"Koschitzke, Jacob",14,11,9,3,5,3,0,1
Hawthorn,"Lewis, Mitch",14,7,5,7,2,1,1,1
Hawthorn,"Maginness, Finn",3,0,0,3,0,0,0,0
Hawthorn,"McEvoy, Ben",13,7,5,6,0,0,25,4
Hawthorn,"Mitchell, Tom",25,9,5,16,0,0,0,6
Hawthorn,"Moore, Dylan",7,4,2,3,0,0,0,2
Hawthorn,"Morrison, Harry",12,7,3,5,0,0,0,2
Hawthorn,"OBrien, Tim",18,12,5,6,1,0,2,1
Hawthorn,"OMeara, Jaeger",31,13,6,18,1,1,0,5
Hawthorn,"Phillips, Tom",23,12,5,11,1,0,0,1
Hawthorn,"Scrimshaw, Jack",13,8,3,5,1,0,0,0
Hawthorn,"Shiels, Liam",17,6,2,11,0,2,0,7
Hawthorn,"Wingard, Chad",14,8,1,6,0,0,0,6
Hawthorn,"Worpel, James",18,10,0,8,0,0,0,5
Hawthorn,"Breust, Luke",12,3,3,9,2,0,0,7
Hawthorn,"Cousins, James",27,19,3,8,0,0,0,4
Hawthorn,"Frost, Sam",16,7,3,9,0,0,0,1
Hawthorn,"Greaves, Damon",0,0,0,0,0,0,0,0
Hawthorn,"Gunston, Jack",7,6,1,1,0,0,0,2
Hawthorn,"Hanrahan, Oliver",14,4,2,10,1,1,0,0
Hawthorn,"Hardwick, Blake",23,18,2,5,0,0,0,1
Hawthorn,"Hartigan, Kyle",14,7,3,7,0,0,0,0
Hawthorn,"Impey, Jarman",23,13,6,10,0,0,0,7
Hawthorn,"Jeka, Emerson",2,2,2,0,0,1,0,3
Hawthorn,"Jiath, Changkuoth",13,7,5,6,0,0,0,1
Hawthorn,"Koschitzke, Jacob",11,5,3,6,2,0,1,1
Hawthorn,"Lewis, Mitch",4,2,1,2,1,0,3,3
Hawthorn,"Maginness, Finn",12,5,1,7,0,0,0,5
Hawthorn,"McEvoy, Ben",15,3,7,12,1,0,23,3
Hawthorn,"Mitchell, Tom",38,13,7,25,0,1,0,5
Hawthorn,"Moore, Dylan",18,13,9,5,1,0,0,2
Hawthorn,"Morrison, Harry",16,10,7,6,0,0,0,0
Hawthorn,"OBrien, Tim",13,8,3,5,0,0,0,2
Hawthorn,"Phillips, Tom",20,8,3,12,0,0,0,3
Hawthorn,"Scrimshaw, Jack",33,17,8,16,0,0,0,1
Hawthorn,"Shiels, Liam",23,15,7,8,1,1,0,8
Hawthorn,"Worpel, James",33,20,3,13,0,0,0,7
Hawthorn,"Breust, Luke",18,10,5,8,0,0,0,5
Hawthorn,"Cousins, James",16,9,6,7,0,1,0,4
Hawthorn,"Frost, Sam",11,5,2,6,0,0,0,4
Hawthorn,"Hanrahan, Oliver",7,4,0,3,2,1,0,2
Hawthorn,"Hardwick, Blake",23,18,3,5,0,0,0,2
Hawthorn,"Hartigan, Kyle",9,4,5,5,0,0,0,0
Hawthorn,"Hartley, Michael",17,12,5,5,0,0,0,3
Hawthorn,"Howe, Daniel",18,12,5,6,1,0,0,5
Hawthorn,"Impey, Jarman",32,14,4,18,1,0,0,2
Hawthorn,"Jeka, Emerson",8,4,2,4,0,1,0,1
Hawthorn,"Jiath, Changkuoth",25,12,7,13,0,0,0,2
Hawthorn,"Koschitzke, Jacob",8,3,5,5,0,1,0,1
Hawthorn,"Lewis, Mitch",10,7,4,3,2,2,6,1
Hawthorn,"McEvoy, Ben",11,5,5,6,0,0,19,6
Hawthorn,"Mitchell, Tom",41,10,5,31,0,0,0,4
Hawthorn,"Moore, Dylan",9,5,3,4,0,0,0,4
Hawthorn,"Morris, Josh",0,0,0,0,0,0,0,0
Hawthorn,"Morrison, Harry",20,9,6,11,0,0,0,3
Hawthorn,"Phillips, Tom",22,15,6,7,0,0,0,1
Hawthorn,"Scrimshaw, Jack",27,15,6,12,0,1,0,4
Hawthorn,"Shiels, Liam",23,14,5,9,0,0,0,2
Hawthorn,"Wingard, Chad",19,7,5,12,0,0,0,3
Hawthorn,"Worpel, James",27,13,5,14,2,0,0,4
Hawthorn,"Breust, Luke",13,5,1,8,2,1,0,3
Hawthorn,"Cousins, James",23,8,4,15,2,2,0,6
Hawthorn,"Frost, Sam",19,10,7,9,0,0,2,2
Hawthorn,"Hanrahan, Oliver",9,3,3,6,0,0,0,1
Hawthorn,"Hardwick, Blake",28,21,7,7,0,0,0,5
Hawthorn,"Hartigan, Kyle",11,6,3,5,0,0,0,0
Hawthorn,"Hartley, Michael",13,7,5,6,0,0,0,1
Hawthorn,"Howe, Daniel",0,0,0,0,0,0,0,0
Hawthorn,"Impey, Jarman",20,7,4,13,0,0,0,2
Hawthorn,"Jiath, Changkuoth",17,8,4,9,0,0,0,1
Hawthorn,"Koschitzke, Jacob",15,7,3,8,2,0,0,0
Hawthorn,"Lewis, Mitch",6,3,3,3,1,0,0,1
Hawthorn,"McEvoy, Ben",12,6,3,6,0,0,26,3
Hawthorn,"Mitchell, Tom",28,13,3,15,0,0,0,3
Hawthorn,"Moore, Dylan",16,8,3,8,1,1,0,1
Hawthorn,"Morrison, Harry",19,7,1,12,0,1,0,3
Hawthorn,"OBrien, Tim",6,3,3,3,0,0,5,4
Hawthorn,"OMeara, Jaeger",22,8,3,14,0,0,0,5
Hawthorn,"Phillips, Tom",19,11,7,8,0,1,0,2
Hawthorn,"Scrimshaw, Jack",20,13,6,7,1,0,0,4
Hawthorn,"Shiels, Liam",24,17,7,7,1,0,0,5
Hawthorn,"Wingard, Chad",21,12,2,9,2,0,0,2
Hawthorn,"Worpel, James",16,9,0,7,0,1,0,6
Hawthorn,"Breust, Luke",13,8,3,5,3,0,0,3
Hawthorn,"Cousins, James",22,7,3,15,0,0,0,6
Hawthorn,"Frost, Sam",17,11,4,6,0,0,0,3
Hawthorn,"Greaves, Damon",11,7,2,4,0,0,0,3
Hawthorn,"Hanrahan, Oliver",15,9,2,6,0,2,0,3
Hawthorn,"Hardwick, Blake",21,15,4,6,0,0,0,2
Hawthorn,"Hartigan, Kyle",4,2,0,2,0,0,0,1
Hawthorn,"Howe, Daniel",15,9,1,6,1,0,0,1
Hawthorn,"Impey, Jarman",24,14,5,10,0,0,0,6
Hawthorn,"Jiath, Changkuoth",16,6,4,10,0,0,0,3
Hawthorn,"Koschitzke, Jacob",10,6,5,4,1,2,0,2
Hawthorn,"Lewis, Mitch",8,3,3,5,1,0,0,1
Hawthorn,"McEvoy, Ben",11,4,3,7,0,0,14,3
Hawthorn,"Mitchell, Tom",44,22,4,22,0,0,0,4
Hawthorn,"Moore, Dylan",19,7,5,12,1,0,0,5
Hawthorn,"Morris, Josh",0,0,0,0,0,0,0,0
Hawthorn,"Morrison, Harry",15,9,1,6,2,0,0,3
Hawthorn,"OMeara, Jaeger",22,13,2,9,0,0,0,11
Hawthorn,"Phillips, Tom",17,14,2,3,0,0,0,1
Hawthorn,"Reeves, Ned",13,4,2,9,0,0,22,4
Hawthorn,"Scrimshaw, Jack",24,12,7,12,0,0,0,1
Hawthorn,"Wingard, Chad",21,13,2,8,0,2,0,5
Hawthorn,"Worpel, James",24,13,2,11,0,1,0,4
Hawthorn,"Breust, Luke",9,5,4,4,1,0,0,3
Hawthorn,"Burgoyne, Shaun",16,10,5,6,0,0,0,2
Hawthorn,"Cousins, James",23,16,2,7,0,1,0,1
Hawthorn,"Frost, Sam",14,7,4,7,0,0,0,3
Hawthorn,"Greaves, Damon",9,6,2,3,1,0,0,0
Hawthorn,"Hardwick, Blake",18,17,6,1,0,0,0,1
Hawthorn,"Howe, Daniel",20,13,7,7,0,0,0,4
Hawthorn,"Impey, Jarman",15,8,3,7,0,0,0,1
Hawthorn,"Jiath, Changkuoth",18,8,5,10,0,0,0,2
Hawthorn,"Koschitzke, Jacob",6,2,2,4,0,1,0,2
Hawthorn,"Lewis, Mitch",7,4,4,3,2,1,4,3
Hawthorn,"McEvoy, Ben",14,10,6,4,2,0,18,4
Hawthorn,"Mitchell, Tom",22,12,1,10,0,0,0,5
Hawthorn,"Moore, Dylan",18,14,8,4,2,2,0,3
Hawthorn,"Morris, Josh",3,3,1,0,0,1,0,4
Hawthorn,"Morrison, Harry",0,0,0,0,0,0,0,0
Hawthorn,"OBrien, Tim",11,6,4,5,0,0,0,1
Hawthorn,"Phillips, Tom",19,14,2,5,1,0,0,3
Hawthorn,"Reeves, Ned",7,4,3,3,1,0,35,4
Hawthorn,"Scrimshaw, Jack",21,14,7,7,0,0,0,1
Hawthorn,"Shiels, Liam",27,19,7,8,0,0,0,6
Hawthorn,"Wingard, Chad",24,14,6,10,0,0,0,5
Hawthorn,"Worpel, James",20,9,2,11,1,1,0,7
Hawthorn,"Breust, Luke",11,6,5,5,2,0,0,4
Hawthorn,"Burgoyne, Shaun",12,7,2,5,0,0,0,0
Hawthorn,"Ceglar, Jonathon",20,9,2,11,1,0,35,4
Hawthorn,"Day, Will",12,4,0,8,0,0,0,2
Hawthorn,"Frost, Sam",14,11,5,3,0,0,0,2
Hawthorn,"Hardwick, Blake",18,12,3,6,0,0,0,4
Hawthorn,"Howe, Daniel",23,15,4,8,0,0,0,2
Hawthorn,"Impey, Jarman",12,8,2,4,0,0,0,3
Hawthorn,"Jiath, Changkuoth",28,14,4,14,0,0,0,2
Hawthorn,"Koschitzke, Jacob",5,4,3,1,2,1,0,2
Hawthorn,"McEvoy, Ben",14,8,7,6,1,0,13,5
Hawthorn,"Mitchell, Tom",34,18,2,16,1,0,0,7
Hawthorn,"Moore, Dylan",18,9,4,9,2,0,0,2
Hawthorn,"Morris, Josh",3,1,0,2,0,0,0,1
Hawthorn,"Morrison, Harry",8,4,2,4,1,0,0,0
Hawthorn,"Newcombe, Jai",13,5,1,8,0,1,0,14
Hawthorn,"OBrien, Tim",11,6,4,5,0,1,2,2
Hawthorn,"OMeara, Jaeger",26,12,3,14,0,0,0,4
Hawthorn,"Phillips, Tom",17,8,3,9,2,0,0,4
Hawthorn,"Scrimshaw, Jack",18,11,4,7,0,0,0,1
Hawthorn,"Shiels, Liam",21,14,5,7,1,0,0,7
Hawthorn,"Wingard, Chad",18,9,1,9,1,0,0,3
Hawthorn,"Worpel, James",18,12,4,6,0,0,0,2
Hawthorn,"Bramble, Lachlan",9,6,5,3,0,0,0,1
Hawthorn,"Breust, Luke",14,8,4,6,3,1,0,5
Hawthorn,"Burgoyne, Shaun",7,4,1,3,0,0,0,2
Hawthorn,"Ceglar, Jonathon",11,5,3,6,0,1,11,3
Hawthorn,"Cousins, James",21,11,1,10,0,0,0,4
Hawthorn,"Day, Will",18,11,7,7,0,0,0,2
Hawthorn,"Frost, Sam",11,6,6,5,0,0,0,1
Hawthorn,"Hardwick, Blake",21,17,6,4,0,0,0,2
Hawthorn,"Howe, Daniel",23,16,10,7,0,0,0,3
Hawthorn,"Impey, Jarman",25,18,10,7,0,0,0,3
Hawthorn,"Jiath, Changkuoth",19,6,5,13,0,0,0,0
Hawthorn,"Koschitzke, Jacob",7,7,4,0,3,2,0,3
Hawthorn,"McEvoy, Ben",13,6,3,7,0,1,26,4
Hawthorn,"Mitchell, Tom",36,18,2,18,1,2,0,8
Hawthorn,"Moore, Dylan",9,4,0,5,1,0,0,3
Hawthorn,"Nash, Conor",0,0,0,0,0,0,0,0
Hawthorn,"Newcombe, Jai",6,5,2,1,0,0,0,3
Hawthorn,"OBrien, Tim",11,8,4,3,0,1,1,2
Hawthorn,"OMeara, Jaeger",31,20,6,11,0,0,0,5
Hawthorn,"Phillips, Tom",13,8,2,5,0,0,0,5
Hawthorn,"Scrimshaw, Jack",23,15,10,8,0,1,0,0
Hawthorn,"Shiels, Liam",12,5,2,7,1,0,0,4
Hawthorn,"Wingard, Chad",22,12,3,10,1,2,0,0
Hawthorn,"Bramble, Lachlan",11,7,4,4,0,1,0,1
Hawthorn,"Breust, Luke",10,2,1,8,1,1,0,2
Hawthorn,"Burgoyne, Shaun",9,3,0,6,0,0,0,1
Hawthorn,"Ceglar, Jonathon",15,7,7,8,0,0,29,0
Hawthorn,"Day, Will",29,15,7,14,0,0,0,0
Hawthorn,"Frost, Sam",12,8,2,4,0,0,0,3
Hawthorn,"Grainger-Barras, Denver",7,4,4,3,0,0,0,0
Hawthorn,"Hardwick, Blake",12,8,4,4,0,0,0,1
Hawthorn,"Hartigan, Kyle",13,7,4,6,0,0,0,3
Hawthorn,"Howe, Daniel",31,18,9,13,0,0,0,1
Hawthorn,"Jiath, Changkuoth",22,14,8,8,0,0,0,0
Hawthorn,"Koschitzke, Jacob",6,3,2,3,0,2,0,3
Hawthorn,"McEvoy, Ben",19,9,8,10,1,2,9,3
Hawthorn,"Mitchell, Tom",40,16,11,24,0,0,0,3
Hawthorn,"Moore, Dylan",20,14,4,6,4,1,0,1
Hawthorn,"Newcombe, Jai",12,9,5,3,1,0,0,4
Hawthorn,"OBrien, Tim",13,9,5,4,2,2,0,2
Hawthorn,"OMeara, Jaeger",23,12,6,11,1,1,0,0
Hawthorn,"Phillips, Tom",12,4,4,8,1,0,0,1
Hawthorn,"Scrimshaw, Jack",28,17,6,11,0,0,0,2
Hawthorn,"Shiels, Liam",26,16,4,10,0,0,0,6
Hawthorn,"Wingard, Chad",8,4,3,4,1,0,0,4
Hawthorn,"Worpel, James",21,16,1,5,1,0,0,4
Hawthorn,"Bramble, Lachlan",16,10,7,6,0,0,0,1
Hawthorn,"Breust, Luke",8,4,0,4,2,0,0,1
Hawthorn,"Burgoyne, Shaun",11,6,3,5,0,1,0,0
Hawthorn,"Ceglar, Jonathon",19,6,5,13,0,0,17,4
Hawthorn,"Frost, Sam",16,8,2,8,0,0,0,1
Hawthorn,"Greaves, Damon",18,7,3,11,0,0,0,1
Hawthorn,"Hanrahan, Oliver",0,0,0,0,0,0,0,0
Hawthorn,"Hardwick, Blake",22,18,5,4,0,0,0,3
Hawthorn,"Hartigan, Kyle",11,5,2,6,0,0,0,0
Hawthorn,"Howe, Daniel",16,10,4,6,1,0,0,1
Hawthorn,"Jiath, Changkuoth",15,7,2,8,0,1,0,3
Hawthorn,"Koschitzke, Jacob",7,5,5,2,1,1,0,2
Hawthorn,"McEvoy, Ben",10,7,4,3,0,0,13,8
Hawthorn,"Mitchell, Tom",29,14,4,15,0,0,0,6
Hawthorn,"Moore, Dylan",10,4,1,6,0,0,0,3
Hawthorn,"Nash, Conor",8,4,2,4,0,0,0,1
Hawthorn,"Newcombe, Jai",11,3,1,8,0,0,0,7
Hawthorn,"OBrien, Tim",12,7,5,5,1,0,1,4
Hawthorn,"OMeara, Jaeger",17,12,3,5,1,3,0,4
Hawthorn,"Phillips, Tom",15,8,2,7,0,0,0,3
Hawthorn,"Scrimshaw, Jack",15,9,5,6,0,0,0,1
Hawthorn,"Shiels, Liam",18,11,3,7,0,0,0,5
Hawthorn,"Worpel, James",23,10,1,13,1,1,0,8
Hawthorn,"Bramble, Lachlan",27,18,6,9,0,0,0,2
Hawthorn,"Breust, Luke",11,5,3,6,0,2,0,2
Hawthorn,"Brockman, Tyler",14,5,1,9,0,0,0,1
Hawthorn,"Burgoyne, Shaun",12,9,1,3,0,0,0,1
Hawthorn,"Ceglar, Jonathon",13,6,8,7,0,0,24,1
Hawthorn,"Frost, Sam",11,8,7,3,0,0,0,3
Hawthorn,"Grainger-Barras, Denver",9,6,5,3,0,0,0,1
Hawthorn,"Greaves, Damon",20,13,5,7,0,0,0,3
Hawthorn,"Hanrahan, Oliver",3,0,0,3,0,0,0,0
Hawthorn,"Hartigan, Kyle",11,7,5,4,0,0,0,2
Hawthorn,"Howe, Daniel",10,10,5,0,0,0,0,3
Hawthorn,"Jeka, Emerson",10,6,3,4,2,0,0,0
Hawthorn,"Jiath, Changkuoth",18,12,7,6,0,0,0,4
Hawthorn,"Koschitzke, Jacob",11,6,6,5,2,0,0,0
Hawthorn,"McEvoy, Ben",11,8,4,3,0,1,8,4
Hawthorn,"Mitchell, Tom",39,17,2,22,0,0,0,5
Hawthorn,"Moore, Dylan",19,10,3,9,1,0,0,5
Hawthorn,"Nash, Conor",16,8,4,8,0,1,0,2
Hawthorn,"OMeara, Jaeger",14,5,0,9,0,0,0,7
Hawthorn,"Phillips, Tom",17,15,7,2,0,1,0,0
Hawthorn,"Scrimshaw, Jack",8,6,4,2,0,0,0,1
Hawthorn,"Shiels, Liam",22,9,2,13,0,0,0,5
Hawthorn,"Worpel, James",18,9,1,9,1,2,0,3
Hawthorn,"Bramble, Lachlan",18,10,2,8,0,0,0,5
Hawthorn,"Breust, Luke",14,9,3,5,3,1,0,5
Hawthorn,"Brockman, Tyler",7,5,0,2,0,1,0,4
Hawthorn,"Burgoyne, Shaun",13,10,2,3,0,0,0,9
Hawthorn,"Cousins, James",20,13,1,7,0,0,0,5
Hawthorn,"Frost, Sam",14,12,4,2,0,0,0,5
Hawthorn,"Grainger-Barras, Denver",10,8,6,2,0,0,0,1
Hawthorn,"Greaves, Damon",12,11,3,1,0,0,0,3
Hawthorn,"Hartigan, Kyle",10,7,3,3,0,0,0,3
Hawthorn,"Howe, Daniel",14,9,2,5,1,0,0,3
Hawthorn,"Jeka, Emerson",6,1,0,5,0,0,0,0
Hawthorn,"Koschitzke, Jacob",5,3,2,2,1,2,0,2
Hawthorn,"Lewis, Mitch",12,7,4,5,2,0,1,2
Hawthorn,"McEvoy, Ben",13,7,4,6,1,0,14,3
Hawthorn,"Mitchell, Tom",39,22,6,17,1,1,0,6
Hawthorn,"Moore, Dylan",12,4,1,8,1,0,0,6
Hawthorn,"Newcombe, Jai",0,0,0,0,0,0,0,0
Hawthorn,"OBrien, Tim",11,9,2,2,0,0,0,2
Hawthorn,"OMeara, Jaeger",25,13,1,12,0,1,0,6
Hawthorn,"Phillips, Tom",25,13,5,12,1,0,0,3
Hawthorn,"Reeves, Ned",9,6,0,3,0,0,19,1
Hawthorn,"Shiels, Liam",24,18,3,6,0,0,0,6
Hawthorn,"Worpel, James",29,16,3,13,1,0,0,1
Hawthorn,"Bramble, Lachlan",25,17,4,8,0,0,0,0
Hawthorn,"Breust, Luke",13,4,2,9,1,0,0,2
Hawthorn,"Brockman, Tyler",6,4,1,2,1,0,0,1
Hawthorn,"Burgoyne, Shaun",4,2,0,2,0,0,0,0
Hawthorn,"Cousins, James",18,7,2,11,0,1,0,5
Hawthorn,"Frost, Sam",17,7,4,10,0,0,0,1
Hawthorn,"Grainger-Barras, Denver",7,4,1,3,0,0,0,3
Hawthorn,"Hardwick, Blake",18,12,6,6,0,0,0,2
Hawthorn,"Hartigan, Kyle",14,10,5,4,0,0,0,2
Hawthorn,"Howe, Daniel",20,10,4,10,0,1,0,3
Hawthorn,"Koschitzke, Jacob",5,4,3,1,1,0,0,3
Hawthorn,"Lewis, Mitch",13,9,4,4,3,0,2,2
Hawthorn,"McEvoy, Ben",14,7,6,7,1,0,19,3
Hawthorn,"Mitchell, Tom",28,11,2,17,1,0,0,9
Hawthorn,"Moore, Dylan",25,13,5,12,1,2,0,3
Hawthorn,"OBrien, Tim",13,9,7,4,1,0,0,1
Hawthorn,"OMeara, Jaeger",24,11,3,13,0,0,0,8
Hawthorn,"Phillips, Tom",15,8,4,7,2,0,0,1
Hawthorn,"Reeves, Ned",8,2,3,6,0,0,24,4
Hawthorn,"Scrimshaw, Jack",16,8,5,8,0,0,0,1
Hawthorn,"Shiels, Liam",16,10,2,6,0,0,0,3
Hawthorn,"Wingard, Chad",24,14,3,10,0,0,0,5
Hawthorn,"Worpel, James",28,16,2,12,1,0,0,4
Hawthorn,"Bramble, Lachlan",15,10,3,5,0,2,0,1
Hawthorn,"Breust, Luke",11,8,3,3,3,1,0,1
Hawthorn,"Brockman, Tyler",12,6,3,6,0,0,0,3
Hawthorn,"Burgoyne, Shaun",12,9,4,3,0,0,0,1
Hawthorn,"Frost, Sam",20,12,7,8,0,0,0,2
Hawthorn,"Grainger-Barras, Denver",4,3,1,1,0,0,0,6
Hawthorn,"Greaves, Damon",4,4,1,0,0,0,0,2
Hawthorn,"Hardwick, Blake",11,9,2,2,0,0,0,2
Hawthorn,"Hartigan, Kyle",4,2,2,2,0,0,0,0
Hawthorn,"Howe, Daniel",18,10,3,8,0,0,0,4
Hawthorn,"Lewis, Mitch",12,7,7,5,1,1,1,3
Hawthorn,"McEvoy, Ben",8,3,3,5,0,0,16,2
Hawthorn,"Mitchell, Tom",34,18,6,16,1,0,0,5
Hawthorn,"Moore, Dylan",15,10,4,5,2,0,0,2
Hawthorn,"Nash, Conor",23,9,2,14,0,0,0,9
Hawthorn,"OBrien, Tim",14,8,5,6,1,1,0,2
Hawthorn,"OMeara, Jaeger",35,20,5,15,1,0,0,11
Hawthorn,"Phillips, Tom",15,9,2,6,1,0,0,4
Hawthorn,"Reeves, Ned",11,3,0,8,0,0,31,7
Hawthorn,"Scrimshaw, Jack",25,17,8,8,0,0,0,2
Hawthorn,"Shiels, Liam",18,7,3,11,1,0,0,3
Hawthorn,"Wingard, Chad",32,20,7,12,2,2,0,6
Hawthorn,"Worpel, James",26,12,2,14,1,1,0,7
Hawthorn,"Bramble, Lachlan",25,18,7,7,0,0,0,1
Hawthorn,"Brockman, Tyler",5,3,2,2,0,0,0,0
Hawthorn,"Burgoyne, Shaun",18,11,10,7,1,0,0,1
Hawthorn,"Ceglar, Jonathon",20,6,6,14,0,0,21,1
Hawthorn,"Frost, Sam",14,9,7,5,0,0,0,0
Hawthorn,"Hanrahan, Oliver",9,5,3,4,0,0,0,0
Hawthorn,"Hardwick, Blake",28,20,11,8,0,1,0,1
Hawthorn,"Hartigan, Kyle",8,3,4,5,0,0,0,0
Hawthorn,"Howe, Daniel",18,12,5,6,2,0,0,1
Hawthorn,"Koschitzke, Jacob",9,5,2,4,3,0,0,1
Hawthorn,"Lewis, Mitch",9,7,6,2,1,0,0,1
Hawthorn,"McEvoy, Ben",9,3,3,6,1,0,14,1
Hawthorn,"Mitchell, Tom",44,21,10,23,1,0,0,3
Hawthorn,"Moore, Dylan",20,8,6,12,2,1,0,3
Hawthorn,"Morrison, Harry",15,8,4,7,0,0,0,2
Hawthorn,"Nash, Conor",20,10,5,10,1,0,0,5
Hawthorn,"OBrien, Tim",14,13,10,1,0,0,0,3
Hawthorn,"OMeara, Jaeger",27,9,4,18,1,0,0,3
Hawthorn,"Phillips, Tom",26,21,8,5,0,0,0,1
Hawthorn,"Scrimshaw, Jack",26,16,12,10,1,0,0,2
Hawthorn,"Shiels, Liam",26,6,5,20,0,0,0,3
Hawthorn,"Wingard, Chad",30,17,4,13,0,0,0,4
Hawthorn,"Worpel, James",13,7,3,6,1,0,0,1
Hawthorn,"Bramble, Lachlan",19,13,3,6,1,0,0,4
Hawthorn,"Brockman, Tyler",10,5,1,5,0,1,0,4
Hawthorn,"Burgoyne, Shaun",15,12,5,3,0,0,0,3
Hawthorn,"Ceglar, Jonathon",17,8,4,9,0,1,34,2
Hawthorn,"Downie, Connor",12,6,2,6,0,0,0,0
Hawthorn,"Frost, Sam",17,10,8,7,0,0,0,2
Hawthorn,"Hanrahan, Oliver",17,8,2,9,1,0,0,3
Hawthorn,"Hardwick, Blake",24,20,11,4,0,0,0,2
Hawthorn,"Hartigan, Kyle",12,6,5,6,0,0,0,0
Hawthorn,"Howe, Daniel",34,26,9,8,1,1,0,3
Hawthorn,"Koschitzke, Jacob",10,5,6,5,2,1,0,2
Hawthorn,"Lewis, Mitch",14,11,10,3,1,1,6,5
Hawthorn,"McEvoy, Ben",12,7,5,5,1,1,15,1
Hawthorn,"Mitchell, Tom",27,15,3,12,1,1,0,5
Hawthorn,"Morris, Josh",0,0,0,0,0,0,0,0
Hawthorn,"Morrison, Harry",12,5,5,7,0,0,0,5
Hawthorn,"Nash, Conor",14,5,2,9,0,0,0,3
Hawthorn,"Newcombe, Jai",18,10,8,8,0,0,0,11
Hawthorn,"OBrien, Tim",24,15,10,9,0,0,0,2
Hawthorn,"Phillips, Tom",16,5,2,11,0,1,0,2
Hawthorn,"Scrimshaw, Jack",19,14,8,5,0,0,0,0
Hawthorn,"Shiels, Liam",17,10,4,7,0,0,0,7
Hawthorn,"Wingard, Chad",26,16,3,10,1,0,0,3
Hawthorn,"Bramble, Lachlan",18,10,3,8,0,0,0,4
Hawthorn,"Brockman, Tyler",8,4,4,4,3,0,0,2
Hawthorn,"Burgoyne, Shaun",21,11,3,10,0,0,0,0
Hawthorn,"Ceglar, Jonathon",19,2,2,17,0,0,24,4
Hawthorn,"Frost, Sam",16,14,7,2,0,0,0,2
Hawthorn,"Hanrahan, Oliver",13,7,2,6,1,0,0,0
Hawthorn,"Hardwick, Blake",20,15,6,5,0,0,0,3
Hawthorn,"Hartigan, Kyle",9,4,2,5,0,0,0,0
Hawthorn,"Howe, Daniel",25,15,5,10,0,1,0,2
Hawthorn,"Koschitzke, Jacob",5,4,1,1,0,0,0,3
Hawthorn,"Lewis, Mitch",8,7,5,1,2,1,5,1
Hawthorn,"McEvoy, Ben",13,7,9,6,0,2,13,6
Hawthorn,"Mitchell, Tom",36,14,6,22,0,0,0,5
Hawthorn,"Morrison, Harry",16,5,7,11,0,0,0,3
Hawthorn,"Nash, Conor",24,11,8,13,1,0,0,2
Hawthorn,"Newcombe, Jai",2,0,0,2,0,0,0,0
Hawthorn,"OBrien, Tim",18,11,7,7,0,0,0,1
Hawthorn,"OMeara, Jaeger",36,20,7,16,0,2,0,1
Hawthorn,"Phillips, Tom",16,12,4,4,2,1,0,1
Hawthorn,"Scrimshaw, Jack",25,16,6,9,1,0,0,1
Hawthorn,"Shiels, Liam",20,11,8,9,0,0,0,0
Hawthorn,"Wingard, Chad",30,15,3,15,2,1,0,5
Hawthorn,"Worpel, James",25,14,7,11,0,0,0,1
Melbourne,"Brayshaw, Angus",18,9,4,9,0,1,0,4
Melbourne,"Chandler, Kade",0,0,0,0,0,0,0,0
Melbourne,"Fritsch, Bayley",10,9,6,1,2,1,0,2
Melbourne,"Gawn, Max",12,6,4,6,0,0,30,1
Melbourne,"Harmes, James",20,11,6,9,1,1,0,2
Melbourne,"Hunt, Jayden",10,7,3,3,0,0,0,2
Melbourne,"Jackson, Luke",10,6,4,4,0,1,5,2
Melbourne,"Jetta, Neville",10,5,4,5,0,0,0,1
Melbourne,"Jones, Nathan",18,9,4,9,0,1,0,0
Melbourne,"Jordon, James",15,10,5,5,1,1,0,6
Melbourne,"Langdon, Ed",22,13,5,9,1,1,0,4
Melbourne,"Lever, Jake",18,15,7,3,0,1,0,3
Melbourne,"May, Steven",24,21,8,3,0,0,0,0
Melbourne,"McDonald, Tom",18,12,9,6,2,2,5,5
Melbourne,"Neal-Bullen, Alex",17,11,3,6,0,0,0,0
Melbourne,"Oliver, Clayton",35,10,6,25,0,0,0,3
Melbourne,"Petracca, Christian",24,13,2,11,2,1,0,3
Melbourne,"Pickett, Kysaiah",11,7,3,4,1,0,0,4
Melbourne,"Rivers, Trent",14,7,3,7,0,0,0,0
Melbourne,"Salem, Christian",18,11,6,7,0,0,0,1
Melbourne,"Spargo, Charlie",16,8,2,8,1,0,0,4
Melbourne,"Sparrow, Tom",10,5,3,5,0,1,0,6
Melbourne,"Tomlinson, Adam",15,13,7,2,0,0,0,2
Melbourne,"Baker, Oskar",0,0,0,0,0,0,0,0
Melbourne,"Brayshaw, Angus",13,9,3,4,0,1,0,0
Melbourne,"Fritsch, Bayley",10,6,7,4,1,3,0,1
Melbourne,"Gawn, Max",17,10,5,7,0,0,40,2
Melbourne,"Hunt, Jayden",18,11,4,7,0,0,0,6
Melbourne,"Jackson, Luke",11,3,4,8,0,1,10,1
Melbourne,"Jetta, Neville",9,3,3,6,0,0,0,1
Melbourne,"Jones, Nathan",14,8,3,6,1,0,0,3
Melbourne,"Jordon, James",20,10,6,10,0,1,0,9
Melbourne,"Langdon, Ed",22,11,11,11,1,0,0,1
Melbourne,"Lever, Jake",8,7,3,1,0,0,0,0
Melbourne,"May, Steven",23,20,8,3,0,0,0,1
Melbourne,"McDonald, Tom",19,10,6,9,2,3,2,0
Melbourne,"Neal-Bullen, Alex",22,11,3,11,1,0,0,5
Melbourne,"Oliver, Clayton",37,17,5,20,0,0,0,6
Melbourne,"Petracca, Christian",30,22,9,8,0,3,0,5
Melbourne,"Pickett, Kysaiah",17,8,2,9,2,2,0,2
Melbourne,"Rivers, Trent",20,12,3,8,0,0,0,1
Melbourne,"Salem, Christian",30,22,10,8,0,1,0,3
Melbourne,"Spargo, Charlie",11,7,5,4,1,1,0,4
Melbourne,"Sparrow, Tom",14,10,4,4,1,0,0,1
Melbourne,"Tomlinson, Adam",17,10,11,7,0,0,0,0
Melbourne,"Viney, Jack",13,5,0,8,2,0,0,5
Melbourne,"Brayshaw, Angus",23,17,4,6,1,0,0,4
Melbourne,"Fritsch, Bayley",6,6,4,0,3,1,0,4
Melbourne,"Gawn, Max",24,17,9,7,2,2,28,0
Melbourne,"Hunt, Jayden",25,18,5,7,0,0,0,3
Melbourne,"Jackson, Luke",15,4,3,11,1,0,10,3
Melbourne,"Jetta, Neville",9,4,1,5,0,0,0,0
Melbourne,"Jones, Nathan",15,7,1,8,0,1,0,1
Melbourne,"Jordon, James",16,11,6,5,1,0,0,3
Melbourne,"Langdon, Ed",27,20,9,7,0,0,0,2
Melbourne,"Lever, Jake",22,17,8,5,0,0,0,2
Melbourne,"May, Steven",20,14,4,6,0,0,0,1
Melbourne,"McDonald, Tom",8,7,3,1,0,1,3,5
Melbourne,"Melksham, Jake",0,0,0,0,0,0,0,0
Melbourne,"Neal-Bullen, Alex",11,10,2,1,1,1,0,6
Melbourne,"Oliver, Clayton",23,11,4,12,0,2,0,3
Melbourne,"Petracca, Christian",29,14,8,15,1,0,0,2
Melbourne,"Pickett, Kysaiah",13,10,2,3,4,1,0,2
Melbourne,"Rivers, Trent",16,10,6,6,0,0,0,3
Melbourne,"Salem, Christian",22,12,5,10,0,0,0,1
Melbourne,"Spargo, Charlie",12,7,1,5,1,1,0,3
Melbourne,"Sparrow, Tom",4,1,1,3,0,0,0,4
Melbourne,"Tomlinson, Adam",13,12,8,1,0,0,0,2
Melbourne,"Viney, Jack",24,12,3,12,0,1,0,8
Melbourne,"Brayshaw, Angus",19,11,5,8,0,0,0,2
Melbourne,"Fritsch, Bayley",14,12,8,2,4,1,0,1
Melbourne,"Gawn, Max",23,16,6,7,1,0,41,4
Melbourne,"Hunt, Jayden",14,12,2,2,0,0,0,5
Melbourne,"Jackson, Luke",10,4,2,6,0,0,12,1
Melbourne,"Jetta, Neville",5,3,2,2,0,0,0,2
Melbourne,"Jones, Nathan",10,9,5,1,1,0,0,2
Melbourne,"Jordon, James",4,1,0,3,0,0,0,5
Melbourne,"Langdon, Ed",26,16,3,10,1,0,0,3
Melbourne,"Lever, Jake",15,11,4,4,0,0,0,5
Melbourne,"May, Steven",5,4,1,1,0,0,0,1
Melbourne,"McDonald, Tom",21,11,9,10,0,0,1,3
Melbourne,"Melksham, Jake",11,7,1,4,1,1,0,2
Melbourne,"Neal-Bullen, Alex",13,10,3,3,1,0,0,4
Melbourne,"Oliver, Clayton",34,19,7,15,0,0,0,6
Melbourne,"Petracca, Christian",36,24,7,12,2,1,0,2
Melbourne,"Pickett, Kysaiah",17,9,0,8,1,2,0,7
Melbourne,"Rivers, Trent",11,8,2,3,0,0,0,1
Melbourne,"Salem, Christian",23,19,5,4,0,0,0,3
Melbourne,"Spargo, Charlie",15,10,2,5,0,3,0,6
Melbourne,"Sparrow, Tom",9,4,1,5,0,0,0,5
Melbourne,"Tomlinson, Adam",8,4,0,4,0,0,0,0
Melbourne,"Viney, Jack",24,13,3,11,0,2,0,12
Melbourne,"Brayshaw, Angus",17,13,7,4,0,0,0,1
Melbourne,"Brown, Mitch",10,8,6,2,2,2,0,3
Melbourne,"Gawn, Max",26,20,10,6,1,2,24,0
Melbourne,"Hibberd, Michael",21,8,5,13,0,0,0,2
Melbourne,"Hunt, Jayden",12,7,4,5,0,0,0,4
Melbourne,"Jackson, Luke",17,8,5,9,0,0,22,1
Melbourne,"Jones, Nathan",8,3,1,5,0,1,0,1
Melbourne,"Jordon, James",20,7,1,13,0,0,0,4
Melbourne,"Langdon, Ed",17,10,4,7,3,1,0,1
Melbourne,"Lever, Jake",16,13,8,3,0,0,0,2
Melbourne,"McDonald, Tom",22,18,10,4,2,2,2,1
Melbourne,"Melksham, Jake",11,7,2,4,3,0,0,3
Melbourne,"Neal-Bullen, Alex",14,10,3,4,0,0,0,4
Melbourne,"Oliver, Clayton",30,13,7,17,0,2,0,8
Melbourne,"Petracca, Christian",23,17,5,6,2,0,0,4
Melbourne,"Petty, Harry",8,3,3,5,0,0,0,2
Melbourne,"Pickett, Kysaiah",18,11,6,7,2,3,0,3
Melbourne,"Rivers, Trent",21,13,5,8,0,0,0,1
Melbourne,"Salem, Christian",30,22,7,8,0,0,0,2
Melbourne,"Spargo, Charlie",11,8,6,3,0,1,0,1
Melbourne,"Sparrow, Tom",0,0,0,0,0,0,0,0
Melbourne,"Tomlinson, Adam",16,14,8,2,0,0,0,2
Melbourne,"Viney, Jack",20,11,3,9,0,0,0,3
Melbourne,"Brayshaw, Angus",26,13,3,13,0,0,0,0
Melbourne,"Chandler, Kade",0,0,0,0,0,0,0,0
Melbourne,"Fritsch, Bayley",9,7,4,2,2,1,0,4
Melbourne,"Gawn, Max",22,8,6,14,0,0,30,2
Melbourne,"Hibberd, Michael",11,8,3,3,0,0,0,4
Melbourne,"Hunt, Jayden",18,7,2,11,0,0,0,2
Melbourne,"Jackson, Luke",18,5,5,13,2,0,12,5
Melbourne,"Jones, Nathan",16,7,4,9,0,0,0,3
Melbourne,"Jordon, James",18,5,1,13,0,1,0,5
Melbourne,"Langdon, Ed",32,13,5,19,0,1,0,1
Melbourne,"Lever, Jake",18,11,7,7,0,0,0,2
Melbourne,"May, Steven",24,20,6,4,0,0,0,1
Melbourne,"McDonald, Tom",18,11,5,7,3,0,0,0
Melbourne,"Melksham, Jake",11,5,3,6,0,1,0,2
Melbourne,"Neal-Bullen, Alex",19,13,3,6,2,1,0,4
Melbourne,"Oliver, Clayton",36,15,4,21,0,1,0,6
Melbourne,"Petracca, Christian",38,16,3,22,1,1,0,7
Melbourne,"Pickett, Kysaiah",13,10,1,3,1,2,0,5
Melbourne,"Rivers, Trent",16,9,1,7,0,0,0,2
Melbourne,"Salem, Christian",39,24,7,15,1,0,0,3
Melbourne,"Spargo, Charlie",6,2,0,4,0,0,0,3
Melbourne,"Tomlinson, Adam",15,8,4,7,0,0,0,3
Melbourne,"Viney, Jack",26,6,3,20,0,0,0,7
Melbourne,"Baker, Oskar",15,12,5,3,0,0,0,4
Melbourne,"Brayshaw, Angus",15,7,4,8,0,0,0,4
Melbourne,"Brown, Ben",5,4,1,1,2,1,0,2
Melbourne,"Fritsch, Bayley",14,10,6,4,6,1,0,1
Melbourne,"Gawn, Max",13,5,4,8,0,1,28,2
Melbourne,"Hibberd, Michael",19,13,10,6,0,0,0,0
Melbourne,"Hunt, Jayden",11,6,5,5,0,0,0,2
Melbourne,"Jackson, Luke",22,6,2,16,1,0,7,2
Melbourne,"Jones, Nathan",14,7,5,7,0,0,0,2
Melbourne,"Jordon, James",20,10,3,10,1,0,0,7
Melbourne,"Langdon, Ed",25,17,12,8,1,0,0,2
Melbourne,"Lever, Jake",17,13,7,4,0,0,0,2
Melbourne,"May, Steven",25,21,14,4,0,0,0,1
Melbourne,"McDonald, Tom",15,8,5,7,0,0,1,1
Melbourne,"Melksham, Jake",17,10,6,7,0,0,0,3
Melbourne,"Neal-Bullen, Alex",10,6,2,4,0,0,0,0
Melbourne,"Oliver, Clayton",25,13,2,12,1,0,0,5
Melbourne,"Petracca, Christian",23,16,7,7,0,1,0,4
Melbourne,"Pickett, Kysaiah",17,9,2,8,3,2,0,2
Melbourne,"Rivers, Trent",14,11,6,3,0,0,0,3
Melbourne,"Salem, Christian",29,19,4,10,0,0,0,3
Melbourne,"Spargo, Charlie",10,8,5,2,1,0,0,2
Melbourne,"Tomlinson, Adam",0,0,0,0,0,0,0,0
Melbourne,"Brayshaw, Angus",14,7,3,7,0,0,0,1
Melbourne,"Brown, Ben",9,7,6,2,3,0,1,0
Melbourne,"Chandler, Kade",0,0,0,0,0,0,0,0
Melbourne,"Fritsch, Bayley",9,5,2,4,0,1,0,0
Melbourne,"Gawn, Max",16,8,3,8,0,1,44,3
Melbourne,"Harmes, James",31,7,3,24,0,0,0,7
Melbourne,"Hibberd, Michael",16,7,2,9,0,0,0,2
Melbourne,"Hunt, Jayden",10,5,0,5,0,0,0,3
Melbourne,"Jackson, Luke",11,4,1,7,0,0,7,4
Melbourne,"Jordon, James",23,10,2,13,0,0,0,8
Melbourne,"Langdon, Ed",24,15,5,9,0,0,0,5
Melbourne,"Lever, Jake",9,7,1,2,0,0,0,0
Melbourne,"May, Steven",15,9,3,6,0,0,0,2
Melbourne,"McDonald, Tom",18,13,5,5,4,0,1,1
Melbourne,"Melksham, Jake",12,4,3,8,1,0,0,3
Melbourne,"Neal-Bullen, Alex",16,9,2,7,0,0,0,8
Melbourne,"Oliver, Clayton",35,15,1,20,0,0,0,5
Melbourne,"Petracca, Christian",28,16,0,12,1,1,0,8
Melbourne,"Petty, Harry",10,6,5,4,0,0,0,1
Melbourne,"Pickett, Kysaiah",9,6,2,3,0,1,0,6
Melbourne,"Rivers, Trent",17,8,3,9,0,0,0,3
Melbourne,"Salem, Christian",27,19,4,8,0,0,0,3
Melbourne,"Spargo, Charlie",13,6,0,7,1,0,0,3
Melbourne,"Brayshaw, Angus",26,12,6,14,0,0,0,1
Melbourne,"Brown, Ben",11,7,3,4,0,1,1,0
Melbourne,"Chandler, Kade",4,1,0,3,0,0,0,2
Melbourne,"Fritsch, Bayley",10,6,3,4,3,0,0,2
Melbourne,"Gawn, Max",15,9,3,6,0,0,44,4
Melbourne,"Harmes, James",19,9,3,10,0,0,0,7
Melbourne,"Hibberd, Michael",15,10,2,5,0,0,0,2
Melbourne,"Hunt, Jayden",14,8,1,6,1,0,0,5
Melbourne,"Jordon, James",20,12,2,8,0,1,0,13
Melbourne,"Langdon, Ed",24,13,6,11,1,0,0,2
Melbourne,"Lever, Jake",12,7,5,5,0,0,0,5
Melbourne,"May, Steven",16,13,4,3,0,0,0,2
Melbourne,"McDonald, Tom",18,11,5,7,3,1,1,3
Melbourne,"Melksham, Jake",0,0,0,0,0,0,0,0
Melbourne,"Neal-Bullen, Alex",11,10,7,1,2,1,0,5
Melbourne,"Oliver, Clayton",28,15,1,13,1,2,0,10
Melbourne,"Petracca, Christian",27,18,5,9,0,0,0,0
Melbourne,"Petty, Harry",9,8,5,1,0,0,0,1
Melbourne,"Pickett, Kysaiah",12,10,2,2,1,2,0,3
Melbourne,"Rivers, Trent",14,8,4,6,0,0,0,3
Melbourne,"Salem, Christian",29,15,4,14,0,0,0,3
Melbourne,"Spargo, Charlie",13,10,2,3,1,2,0,1
Melbourne,"Weideman, Sam",13,6,5,7,0,1,1,1
Melbourne,"Brayshaw, Angus",22,13,4,9,0,0,0,3
Melbourne,"Fritsch, Bayley",7,5,2,2,1,1,0,0
Melbourne,"Gawn, Max",20,13,10,7,1,1,32,2
Melbourne,"Harmes, James",18,7,0,11,1,0,0,8
Melbourne,"Hibberd, Michael",12,8,3,4,0,0,0,3
Melbourne,"Hunt, Jayden",7,4,1,3,0,0,0,2
Melbourne,"Jackson, Luke",12,3,4,9,0,0,17,3
Melbourne,"Jetta, Neville",7,5,3,2,0,0,0,3
Melbourne,"Jordon, James",11,8,0,3,0,0,0,9
Melbourne,"Langdon, Ed",27,17,4,10,2,0,0,3
Melbourne,"Lever, Jake",24,14,8,10,0,0,0,1
Melbourne,"May, Steven",14,11,6,3,0,0,0,2
Melbourne,"McDonald, Tom",10,6,3,4,1,1,0,3
Melbourne,"Melksham, Jake",10,9,4,1,0,2,0,0
Melbourne,"Neal-Bullen, Alex",17,13,4,4,0,2,0,7
Melbourne,"Oliver, Clayton",38,20,1,18,3,1,0,9
Melbourne,"Petracca, Christian",32,19,5,13,1,0,0,4
Melbourne,"Petty, Harry",5,4,1,1,0,0,0,2
Melbourne,"Pickett, Kysaiah",11,7,4,4,1,0,0,5
Melbourne,"Rivers, Trent",12,10,3,2,1,0,0,1
Melbourne,"Spargo, Charlie",8,6,1,2,1,0,0,4
Melbourne,"Sparrow, Tom",0,0,0,0,0,0,0,0
Melbourne,"Weideman, Sam",9,5,3,4,1,1,0,4
Melbourne,"Brayshaw, Angus",13,9,6,4,0,0,0,3
Melbourne,"Fritsch, Bayley",12,11,10,1,3,2,0,1
Melbourne,"Gawn, Max",21,13,5,8,1,1,27,4
Melbourne,"Harmes, James",23,11,5,12,1,0,0,7
Melbourne,"Hibberd, Michael",10,7,2,3,0,0,0,0
Melbourne,"Hunt, Jayden",7,6,2,1,0,0,0,2
Melbourne,"Jackson, Luke",8,2,0,6,0,0,11,2
Melbourne,"Jordon, James",14,9,2,5,1,0,0,6
Melbourne,"Langdon, Ed",15,6,3,9,0,0,0,1
Melbourne,"Lever, Jake",16,10,5,6,0,0,0,1
Melbourne,"May, Steven",22,18,5,4,0,0,0,2
Melbourne,"McDonald, Tom",10,9,7,1,3,0,0,2
Melbourne,"Melksham, Jake",15,9,1,6,0,0,0,0
Melbourne,"Neal-Bullen, Alex",15,12,7,3,0,0,0,3
Melbourne,"Oliver, Clayton",33,13,5,20,0,0,0,5
Melbourne,"Petracca, Christian",24,12,2,12,1,0,0,3
Melbourne,"Petty, Harry",11,9,6,2,0,0,0,0
Melbourne,"Pickett, Kysaiah",11,6,4,5,1,1,0,3
Melbourne,"Rivers, Trent",19,13,3,6,0,0,0,0
Melbourne,"Salem, Christian",18,10,6,8,0,0,0,0
Melbourne,"Spargo, Charlie",16,11,5,5,0,2,0,0
Melbourne,"Sparrow, Tom",0,0,0,0,0,0,0,0
Melbourne,"Weideman, Sam",6,5,5,1,2,1,0,1
Melbourne,"Baker, Oskar",0,0,0,0,0,0,0,0
Melbourne,"Brayshaw, Angus",19,13,6,6,0,1,0,1
Melbourne,"Fritsch, Bayley",6,6,5,0,2,0,0,2
Melbourne,"Gawn, Max",17,13,3,4,1,0,31,4
Melbourne,"Harmes, James",23,6,2,17,0,0,0,3
Melbourne,"Hibberd, Michael",10,5,2,5,0,0,0,2
Melbourne,"Hunt, Jayden",10,8,3,2,0,0,0,2
Melbourne,"Jackson, Luke",12,5,2,7,1,1,5,1
Melbourne,"Jordon, James",20,11,3,9,0,0,0,0
Melbourne,"Lever, Jake",9,3,2,6,0,0,0,1
Melbourne,"May, Steven",15,14,7,1,0,0,0,3
Melbourne,"McDonald, Tom",12,10,5,2,3,2,1,3
Melbourne,"Melksham, Jake",5,1,2,4,0,0,0,2
Melbourne,"Neal-Bullen, Alex",15,9,2,6,1,0,0,6
Melbourne,"Oliver, Clayton",25,12,4,13,0,1,0,5
Melbourne,"Petracca, Christian",26,17,4,9,2,1,0,6
Melbourne,"Petty, Harry",11,6,4,5,0,0,0,3
Melbourne,"Pickett, Kysaiah",9,8,3,1,3,3,0,3
Melbourne,"Rivers, Trent",15,10,5,5,0,0,0,0
Melbourne,"Salem, Christian",14,11,4,3,0,1,0,3
Melbourne,"Spargo, Charlie",14,13,4,1,0,1,0,2
Melbourne,"Sparrow, Tom",19,8,4,11,1,0,0,5
Melbourne,"Weideman, Sam",8,3,3,5,0,1,0,2
Melbourne,"Brayshaw, Angus",15,8,4,7,0,0,0,1
Melbourne,"Chandler, Kade",0,0,0,0,0,0,0,0
Melbourne,"Fritsch, Bayley",7,6,1,1,1,0,0,3
Melbourne,"Gawn, Max",19,13,8,6,1,0,20,5
Melbourne,"Harmes, James",23,11,2,12,1,0,0,5
Melbourne,"Hibberd, Michael",16,8,6,8,0,0,0,1
Melbourne,"Hunt, Jayden",17,9,5,8,0,0,0,2
Melbourne,"Jackson, Luke",21,8,7,13,2,0,6,1
Melbourne,"Jordon, James",23,10,5,13,0,0,0,1
Melbourne,"Langdon, Ed",21,14,6,7,1,0,0,2
Melbourne,"Lever, Jake",13,7,4,6,0,0,0,2
Melbourne,"May, Steven",22,16,6,6,0,0,0,1
Melbourne,"McDonald, Tom",8,5,1,3,0,2,0,3
Melbourne,"Neal-Bullen, Alex",15,6,4,9,1,1,0,1
Melbourne,"Oliver, Clayton",23,12,3,11,1,2,0,1
Melbourne,"Petracca, Christian",27,11,8,16,1,0,0,2
Melbourne,"Petty, Harry",9,6,3,3,0,0,0,2
Melbourne,"Pickett, Kysaiah",12,9,3,3,0,1,0,2
Melbourne,"Rivers, Trent",18,14,8,4,0,0,0,1
Melbourne,"Salem, Christian",26,17,7,9,0,0,0,2
Melbourne,"Spargo, Charlie",8,6,5,2,0,1,0,1
Melbourne,"Sparrow, Tom",10,7,1,3,0,0,0,3
Melbourne,"Weideman, Sam",4,0,0,4,0,0,0,1
Melbourne,"Brayshaw, Angus",24,15,8,9,0,1,0,1
Melbourne,"Fritsch, Bayley",10,9,5,1,0,1,0,1
Melbourne,"Gawn, Max",16,11,4,5,0,0,32,3
Melbourne,"Harmes, James",27,10,4,17,1,2,0,0
Melbourne,"Hibberd, Michael",18,12,7,6,0,0,0,3
Melbourne,"Hunt, Jayden",16,10,6,6,0,0,0,4
Melbourne,"Jackson, Luke",11,6,3,5,1,2,7,0
Melbourne,"Jones, Nathan",0,0,0,0,0,0,0,0
Melbourne,"Jordon, James",21,9,5,12,2,1,0,3
Melbourne,"Langdon, Ed",23,19,10,4,0,0,0,0
Melbourne,"Lever, Jake",18,9,8,9,0,0,0,1
Melbourne,"May, Steven",18,16,7,2,0,0,0,3
Melbourne,"McDonald, Tom",13,8,6,5,1,1,1,3
Melbourne,"Neal-Bullen, Alex",13,10,2,3,0,0,0,5
Melbourne,"Oliver, Clayton",34,10,6,24,0,0,0,0
Melbourne,"Petracca, Christian",26,15,6,11,2,0,0,4
Melbourne,"Petty, Harry",5,4,3,1,0,0,0,2
Melbourne,"Pickett, Kysaiah",12,4,1,8,0,0,0,0
Melbourne,"Rivers, Trent",13,9,5,4,0,0,0,2
Melbourne,"Salem, Christian",26,21,10,5,0,0,0,0
Melbourne,"Spargo, Charlie",7,6,2,1,1,0,0,3
Melbourne,"Sparrow, Tom",11,2,2,9,1,0,0,5
Melbourne,"Viney, Jack",17,10,4,7,0,0,0,4
Melbourne,"Brayshaw, Angus",16,10,6,6,0,0,0,2
Melbourne,"Fritsch, Bayley",12,9,8,3,3,1,0,0
Melbourne,"Gawn, Max",18,12,9,6,0,2,17,2
Melbourne,"Harmes, James",18,9,6,9,0,0,0,6
Melbourne,"Hibberd, Michael",3,1,1,2,0,0,0,5
Melbourne,"Hunt, Jayden",17,9,4,8,0,0,0,0
Melbourne,"Jackson, Luke",11,6,4,5,0,0,12,3
Melbourne,"Jordon, James",20,8,2,12,0,0,0,1
Melbourne,"Langdon, Ed",25,13,6,12,0,1,0,0
Melbourne,"Lever, Jake",19,9,7,10,0,0,0,2
Melbourne,"May, Steven",21,19,6,2,0,0,0,1
Melbourne,"McDonald, Tom",22,18,10,4,0,2,0,1
Melbourne,"Neal-Bullen, Alex",16,10,2,6,1,1,0,3
Melbourne,"Oliver, Clayton",28,10,4,18,0,0,0,7
Melbourne,"Petracca, Christian",30,18,10,12,0,2,0,6
Melbourne,"Petty, Harry",9,6,2,3,0,0,0,2
Melbourne,"Pickett, Kysaiah",4,3,1,1,1,0,0,3
Melbourne,"Rivers, Trent",22,15,6,7,0,0,0,4
Melbourne,"Salem, Christian",31,19,9,12,1,0,0,3
Melbourne,"Spargo, Charlie",11,7,6,4,0,0,0,1
Melbourne,"Sparrow, Tom",9,6,3,3,1,0,0,4
Melbourne,"Vandenberg, Aaron",0,0,0,0,0,0,0,0
Melbourne,"Viney, Jack",16,10,3,6,0,1,0,7
Melbourne,"Brayshaw, Angus",16,6,2,10,0,0,0,5
Melbourne,"Brown, Ben",10,10,4,0,0,0,0,3
Melbourne,"Fritsch, Bayley",8,3,3,5,1,1,0,0
Melbourne,"Gawn, Max",18,15,5,3,0,2,31,2
Melbourne,"Harmes, James",15,3,2,12,0,0,0,7
Melbourne,"Hibberd, Michael",14,8,4,6,0,0,0,1
Melbourne,"Hunt, Jayden",9,9,1,0,0,1,0,3
Melbourne,"Jackson, Luke",8,2,1,6,1,0,9,0
Melbourne,"Jordon, James",21,11,2,10,0,0,0,4
Melbourne,"Langdon, Ed",24,16,6,8,0,2,0,1
Melbourne,"Lever, Jake",10,6,6,4,0,0,0,3
Melbourne,"May, Steven",21,19,9,2,0,1,0,0
Melbourne,"McDonald, Tom",19,12,8,7,3,2,2,3
Melbourne,"Neal-Bullen, Alex",11,5,0,6,0,0,0,4
Melbourne,"Oliver, Clayton",31,14,4,17,0,1,0,4
Melbourne,"Petracca, Christian",33,22,8,11,3,1,0,6
Melbourne,"Petty, Harry",12,10,7,2,0,0,0,1
Melbourne,"Pickett, Kysaiah",9,6,3,3,3,0,0,9
Melbourne,"Rivers, Trent",9,5,1,4,0,0,0,0
Melbourne,"Salem, Christian",26,21,8,5,0,0,0,2
Melbourne,"Spargo, Charlie",13,9,4,4,1,0,0,1
Melbourne,"Sparrow, Tom",0,0,0,0,0,0,0,0
Melbourne,"Viney, Jack",18,8,0,10,0,0,0,10
Melbourne,"Brayshaw, Angus",19,7,3,12,1,1,0,4
Melbourne,"Brown, Ben",12,6,6,6,1,2,0,1
Melbourne,"Fritsch, Bayley",13,11,6,2,3,1,0,3
Melbourne,"Gawn, Max",15,14,4,1,0,0,28,4
Melbourne,"Hibberd, Michael",18,10,3,8,0,0,0,3
Melbourne,"Hunt, Jayden",16,12,3,4,1,1,0,1
Melbourne,"Jackson, Luke",7,1,1,6,0,1,9,1
Melbourne,"Jordon, James",20,11,4,9,0,0,0,2
Melbourne,"Langdon, Ed",21,10,4,11,0,1,0,2
Melbourne,"Lever, Jake",17,10,6,7,0,0,0,1
Melbourne,"May, Steven",13,12,3,1,0,0,0,0
Melbourne,"McDonald, Tom",10,9,3,1,1,0,1,1
Melbourne,"Neal-Bullen, Alex",13,10,3,3,1,0,0,4
Melbourne,"Oliver, Clayton",35,19,6,16,0,0,0,6
Melbourne,"Petracca, Christian",33,10,1,23,0,1,0,3
Melbourne,"Petty, Harry",9,8,5,1,0,0,0,1
Melbourne,"Pickett, Kysaiah",14,6,3,8,2,1,0,3
Melbourne,"Rivers, Trent",12,8,4,4,0,0,0,1
Melbourne,"Salem, Christian",25,13,4,12,0,0,0,2
Melbourne,"Spargo, Charlie",11,10,5,1,1,1,0,2
Melbourne,"Sparrow, Tom",0,0,0,0,0,0,0,0
Melbourne,"Vandenberg, Aaron",16,10,2,6,0,0,0,4
Melbourne,"Viney, Jack",32,14,1,18,0,0,0,11
Melbourne,"Brayshaw, Angus",19,12,2,7,0,0,0,5
Melbourne,"Brown, Ben",11,10,6,1,2,2,0,2
Melbourne,"Fritsch, Bayley",12,8,1,4,2,1,0,2
Melbourne,"Gawn, Max",18,16,2,2,0,0,56,2
Melbourne,"Harmes, James",15,6,2,9,0,0,0,8
Melbourne,"Hibberd, Michael",14,6,4,8,0,0,0,0
Melbourne,"Hunt, Jayden",23,16,7,7,0,1,0,1
Melbourne,"Jackson, Luke",9,2,4,7,0,0,9,2
Melbourne,"Jordon, James",14,3,1,11,0,0,0,2
Melbourne,"Langdon, Ed",15,9,1,6,0,0,0,0
Melbourne,"Lever, Jake",20,8,5,12,0,0,0,2
Melbourne,"May, Steven",14,12,1,2,0,0,0,1
Melbourne,"McDonald, Tom",14,9,4,5,1,0,2,2
Melbourne,"Neal-Bullen, Alex",25,16,2,9,0,1,0,7
Melbourne,"Oliver, Clayton",38,19,4,19,0,1,0,5
Melbourne,"Petracca, Christian",31,18,4,13,1,0,0,7
Melbourne,"Petty, Harry",4,1,1,3,0,0,0,1
Melbourne,"Pickett, Kysaiah",13,9,2,4,2,2,0,8
Melbourne,"Rivers, Trent",14,11,1,3,0,0,0,2
Melbourne,"Salem, Christian",20,11,2,9,0,0,0,3
Melbourne,"Spargo, Charlie",8,6,1,2,0,0,0,6
Melbourne,"Sparrow, Tom",0,0,0,0,0,0,0,0
Melbourne,"Viney, Jack",19,13,3,6,1,1,0,9
Melbourne,"Bowey, Jake",13,5,3,8,0,0,0,2
Melbourne,"Brayshaw, Angus",19,15,6,4,0,1,0,1
Melbourne,"Brown, Ben",12,10,6,2,4,1,2,2
Melbourne,"Fritsch, Bayley",11,8,5,3,2,0,0,4
Melbourne,"Gawn, Max",16,14,5,2,2,1,31,1
Melbourne,"Harmes, James",24,10,5,14,0,3,0,8
Melbourne,"Hunt, Jayden",19,14,6,5,0,0,0,0
Melbourne,"Jackson, Luke",17,6,3,11,4,0,13,2
Melbourne,"Jordon, James",2,0,0,2,0,0,0,1
Melbourne,"Langdon, Ed",15,8,4,7,0,0,0,1
Melbourne,"Lever, Jake",14,11,8,3,0,0,0,1
Melbourne,"May, Steven",16,14,5,2,0,1,0,0
Melbourne,"McDonald, Tom",15,9,4,6,1,2,3,5
Melbourne,"Neal-Bullen, Alex",17,9,4,8,0,0,0,9
Melbourne,"Oliver, Clayton",35,13,2,22,1,1,0,5
Melbourne,"Petracca, Christian",32,19,10,13,1,0,0,5
Melbourne,"Petty, Harry",8,6,6,2,0,0,0,2
Melbourne,"Pickett, Kysaiah",15,11,3,4,2,1,0,3
Melbourne,"Rivers, Trent",18,10,4,8,0,0,0,2
Melbourne,"Salem, Christian",17,12,5,5,0,0,0,1
Melbourne,"Spargo, Charlie",13,8,4,5,1,0,0,2
Melbourne,"Sparrow, Tom",16,10,5,6,0,1,0,2
Melbourne,"Viney, Jack",22,9,3,13,0,1,0,4
Melbourne,"Bowey, Jake",21,10,3,11,0,0,0,1
Melbourne,"Brayshaw, Angus",14,10,2,4,0,0,0,1
Melbourne,"Brown, Ben",8,8,7,0,3,0,5,2
Melbourne,"Fritsch, Bayley",8,5,5,3,0,1,0,2
Melbourne,"Gawn, Max",14,10,3,4,0,1,25,3
Melbourne,"Harmes, James",25,16,2,9,1,1,0,4
Melbourne,"Hunt, Jayden",1,1,0,0,0,0,0,0
Melbourne,"Jackson, Luke",21,8,6,13,0,1,6,2
Melbourne,"Jordon, James",17,11,7,6,0,1,0,1
Melbourne,"Langdon, Ed",16,9,2,7,0,0,0,0
Melbourne,"Lever, Jake",11,6,1,5,0,0,0,1
Melbourne,"May, Steven",21,20,4,1,0,0,0,1
Melbourne,"Melksham, Jake",8,3,2,5,2,0,0,1
Melbourne,"Neal-Bullen, Alex",20,16,3,4,2,1,0,8
Melbourne,"Oliver, Clayton",28,11,0,17,0,0,0,3
Melbourne,"Petracca, Christian",28,10,1,18,1,1,0,6
Melbourne,"Petty, Harry",10,6,4,4,0,0,0,1
Melbourne,"Pickett, Kysaiah",9,5,0,4,1,0,0,0
Melbourne,"Rivers, Trent",15,10,5,5,0,1,0,1
Melbourne,"Salem, Christian",23,13,6,10,0,0,0,1
Melbourne,"Spargo, Charlie",9,5,4,4,0,0,0,1
Melbourne,"Sparrow, Tom",12,4,0,8,0,1,0,2
Melbourne,"Vandenberg, Aaron",11,8,1,3,0,0,0,4
Melbourne,"Bowey, Jake",18,9,6,9,0,0,0,0
Melbourne,"Brayshaw, Angus",6,3,0,3,0,0,0,2
Melbourne,"Brown, Ben",6,5,5,1,2,1,2,4
Melbourne,"Fritsch, Bayley",16,12,5,4,7,0,0,3
Melbourne,"Gawn, Max",19,13,1,6,0,0,26,4
Melbourne,"Harmes, James",18,5,1,13,0,2,0,6
Melbourne,"Hibberd, Michael",14,8,1,6,0,0,0,4
Melbourne,"Jackson, Luke",16,5,2,11,2,0,19,3
Melbourne,"Jordon, James",15,4,4,11,0,0,0,5
Melbourne,"Langdon, Ed",27,21,7,6,0,0,0,7
Melbourne,"Lever, Jake",14,10,6,4,0,0,0,3
Melbourne,"Melksham, Jake",7,3,1,4,1,0,0,2
Melbourne,"Neal-Bullen, Alex",16,9,3,7,0,0,0,2
Melbourne,"Oliver, Clayton",28,15,2,13,0,2,0,7
Melbourne,"Petracca, Christian",23,15,8,8,2,0,0,5
Melbourne,"Petty, Harry",11,8,5,3,0,0,0,1
Melbourne,"Pickett, Kysaiah",12,10,4,2,1,2,0,5
Melbourne,"Rivers, Trent",16,15,10,1,0,0,0,2
Melbourne,"Salem, Christian",29,20,8,9,0,0,0,3
Melbourne,"Smith, Joel",9,5,3,4,0,0,0,1
Melbourne,"Spargo, Charlie",18,12,7,6,1,1,0,1
Melbourne,"Sparrow, Tom",14,8,3,6,0,0,0,7
Melbourne,"Vandenberg, Aaron",0,0,0,0,0,0,0,0
Melbourne,"Bowey, Jake",16,7,4,9,0,0,0,0
Melbourne,"Brayshaw, Angus",18,13,5,5,0,0,0,4
Melbourne,"Brown, Ben",9,7,5,2,2,0,0,1
Melbourne,"Fritsch, Bayley",7,6,2,1,1,2,0,4
Melbourne,"Gawn, Max",25,17,6,8,1,0,39,3
Melbourne,"Harmes, James",26,10,2,16,0,0,0,3
Melbourne,"Jackson, Luke",7,1,1,6,0,0,7,2
Melbourne,"Jordon, James",0,0,0,0,0,0,0,0
Melbourne,"Langdon, Ed",19,12,3,7,0,0,0,2
Melbourne,"Lever, Jake",22,11,8,11,0,0,0,1
Melbourne,"May, Steven",19,18,9,1,0,0,0,0
Melbourne,"McDonald, Tom",6,4,2,2,0,0,3,2
Melbourne,"Neal-Bullen, Alex",16,6,3,10,0,0,0,5
Melbourne,"Oliver, Clayton",37,17,2,20,2,1,0,7
Melbourne,"Petracca, Christian",26,13,3,13,0,0,0,3
Melbourne,"Petty, Harry",7,4,1,3,0,0,0,4
Melbourne,"Pickett, Kysaiah",14,12,4,2,3,1,0,3
Melbourne,"Rivers, Trent",12,5,3,7,0,0,0,3
Melbourne,"Salem, Christian",27,16,9,11,0,0,0,4
Melbourne,"Smith, Joel",6,3,4,3,0,0,0,2
Melbourne,"Spargo, Charlie",10,7,3,3,2,0,0,3
Melbourne,"Sparrow, Tom",12,10,6,2,0,0,0,5
Melbourne,"Viney, Jack",17,8,2,9,1,1,0,9
Melbourne,"Bowey, Jake",15,8,0,7,0,0,0,0
Melbourne,"Brayshaw, Angus",26,16,5,10,0,1,0,4
Melbourne,"Brown, Ben",15,12,9,3,1,1,1,1
Melbourne,"Fritsch, Bayley",7,7,5,0,4,1,0,5
Melbourne,"Gawn, Max",19,17,6,2,0,1,37,7
Melbourne,"Harmes, James",20,9,2,11,0,0,0,4
Melbourne,"Jackson, Luke",9,4,3,5,0,2,12,1
Melbourne,"Jordon, James",0,0,0,0,0,0,0,0
Melbourne,"Langdon, Ed",19,14,7,5,1,1,0,2
Melbourne,"Lever, Jake",18,7,5,11,0,0,0,1
Melbourne,"May, Steven",13,11,4,2,0,0,0,0
Melbourne,"McDonald, Tom",4,4,3,0,0,1,0,2
Melbourne,"Neal-Bullen, Alex",27,14,6,13,0,1,0,5
Melbourne,"Oliver, Clayton",33,17,1,16,1,0,0,3
Melbourne,"Petracca, Christian",30,17,3,13,2,2,0,1
Melbourne,"Petty, Harry",8,5,4,3,0,0,0,1
Melbourne,"Pickett, Kysaiah",7,6,1,1,2,1,0,2
Melbourne,"Rivers, Trent",17,10,4,7,0,0,0,0
Melbourne,"Salem, Christian",23,13,2,10,0,0,0,2
Melbourne,"Smith, Joel",5,3,2,2,0,0,0,1
Melbourne,"Spargo, Charlie",9,6,2,3,1,1,0,4
Melbourne,"Sparrow, Tom",21,12,4,9,1,0,0,2
Melbourne,"Viney, Jack",28,17,3,11,0,0,0,6
Melbourne,"Bowey, Jake",19,12,3,7,0,0,0,2
Melbourne,"Brayshaw, Angus",18,11,2,7,0,0,0,5
Melbourne,"Brown, Ben",8,7,7,1,2,2,0,1
Melbourne,"Fritsch, Bayley",13,13,8,0,2,1,0,2
Melbourne,"Gawn, Max",19,13,5,6,5,0,33,6
Melbourne,"Harmes, James",15,7,2,8,1,1,0,6
Melbourne,"Hibberd, Michael",9,5,2,4,0,0,0,3
Melbourne,"Jackson, Luke",12,3,2,9,0,0,12,1
Melbourne,"Jordon, James",9,7,3,2,0,0,0,2
Melbourne,"Langdon, Ed",21,8,5,13,0,0,0,3
Melbourne,"Lever, Jake",12,9,5,3,0,0,0,1
Melbourne,"May, Steven",5,4,0,1,0,0,0,0
Melbourne,"McDonald, Tom",14,9,5,5,1,0,1,2
Melbourne,"Neal-Bullen, Alex",15,9,2,6,1,0,0,4
Melbourne,"Oliver, Clayton",27,14,4,13,0,0,0,7
Melbourne,"Petracca, Christian",32,16,4,16,1,2,0,3
Melbourne,"Petty, Harry",9,4,2,5,0,0,0,2
Melbourne,"Pickett, Kysaiah",13,9,3,4,3,0,0,1
Melbourne,"Rivers, Trent",12,6,4,6,0,0,0,1
Melbourne,"Salem, Christian",29,23,6,6,0,0,0,3
Melbourne,"Spargo, Charlie",18,13,8,5,2,0,0,0
Melbourne,"Sparrow, Tom",11,8,2,3,1,1,0,3
Melbourne,"Viney, Jack",34,17,4,17,0,0,0,5
Melbourne,"Bowey, Jake",17,10,4,7,0,0,0,0
Melbourne,"Brayshaw, Angus",25,15,5,10,1,0,0,2
Melbourne,"Brown, Ben",10,9,4,1,3,2,1,1
Melbourne,"Fritsch, Bayley",13,10,5,3,6,2,0,0
Melbourne,"Gawn, Max",21,13,5,8,0,2,30,1
Melbourne,"Harmes, James",14,5,3,9,0,0,0,3
Melbourne,"Hibberd, Michael",7,3,1,4,0,0,0,0
Melbourne,"Jackson, Luke",13,5,3,8,1,0,16,5
Melbourne,"Jordon, James",0,0,0,0,0,0,0,0
Melbourne,"Langdon, Ed",17,11,2,6,1,1,0,0
Melbourne,"Lever, Jake",17,11,2,6,0,0,0,1
Melbourne,"May, Steven",14,13,5,1,0,0,0,1
Melbourne,"McDonald, Tom",8,4,4,4,2,0,0,0
Melbourne,"Neal-Bullen, Alex",24,11,5,13,1,1,0,2
Melbourne,"Oliver, Clayton",33,14,4,19,1,1,0,10
Melbourne,"Petracca, Christian",39,21,3,18,2,1,0,4
Melbourne,"Petty, Harry",6,3,1,3,0,0,0,2
Melbourne,"Pickett, Kysaiah",4,2,0,2,0,0,0,3
Melbourne,"Rivers, Trent",11,4,2,7,0,0,0,2
Melbourne,"Salem, Christian",27,22,7,5,1,0,0,7
Melbourne,"Spargo, Charlie",7,4,0,3,1,1,0,1
Melbourne,"Sparrow, Tom",14,7,1,7,1,0,0,3
Melbourne,"Viney, Jack",25,9,2,16,0,0,0,6
North Melbourne,"Atley, Shaun",20,12,4,8,0,0,0,3
North Melbourne,"Bonar, Aiden",10,7,4,3,0,0,0,1
North Melbourne,"Corr, Aidan",12,7,5,5,0,0,0,0
North Melbourne,"Davies-Uniacke, Luke",20,11,4,9,1,1,0,5
North Melbourne,"Goldstein, Todd",19,4,1,15,1,0,25,3
North Melbourne,"Larkey, Nick",7,4,1,3,0,0,3,0
North Melbourne,"Lazzaro, Charlie",1,1,1,0,0,0,0,1
North Melbourne,"Mahony, Jack",14,11,3,3,1,1,0,3
North Melbourne,"McKay, Ben",11,5,4,6,0,0,0,3
North Melbourne,"Menadue, Connor",16,8,5,8,0,0,0,1
North Melbourne,"Polec, Jared",22,13,2,9,0,0,0,2
North Melbourne,"Powell, Tom",19,12,3,7,1,1,0,1
North Melbourne,"Scott, Bailey",17,13,6,4,2,2,0,4
North Melbourne,"Simpkin, Jy",23,10,2,13,0,0,0,2
North Melbourne,"Stephenson, Jaidyn",33,17,5,16,0,2,0,7
North Melbourne,"Taylor, Curtis",10,5,2,5,0,0,0,0
North Melbourne,"Thomas, Tarryn",15,8,3,7,2,0,0,3
North Melbourne,"Turner, Kayne",12,2,2,10,0,1,0,4
North Melbourne,"Tyson, Dom",13,5,6,8,0,0,0,3
North Melbourne,"Walker, Josh",7,6,6,1,1,1,0,1
North Melbourne,"Young, Lachie",14,8,3,6,0,0,0,2
North Melbourne,"Ziebell, Jack",25,19,4,6,0,0,0,3
North Melbourne,"Zurhaar, Cameron",10,5,1,5,0,0,0,4
North Melbourne,"Anderson, Jed",27,10,3,17,0,0,0,14
North Melbourne,"Atley, Shaun",27,15,9,12,0,0,0,2
North Melbourne,"Bonar, Aiden",15,12,4,3,0,0,0,3
North Melbourne,"Corr, Aidan",20,12,4,8,0,1,0,5
North Melbourne,"Davies-Uniacke, Luke",21,11,5,10,0,1,0,4
North Melbourne,"Goldstein, Todd",11,4,2,7,1,0,30,2
North Melbourne,"Hall, Aaron",3,1,0,2,0,0,0,1
North Melbourne,"Larkey, Nick",7,3,2,4,1,0,6,2
North Melbourne,"Lazzaro, Charlie",17,10,3,7,0,0,0,4
North Melbourne,"Mahony, Jack",11,5,2,6,0,0,0,2
North Melbourne,"McKay, Ben",6,1,0,5,0,0,0,1
North Melbourne,"Polec, Jared",20,16,7,4,0,1,0,3
North Melbourne,"Powell, Tom",16,6,1,10,1,0,0,2
North Melbourne,"Scott, Bailey",18,11,1,7,1,0,0,3
North Melbourne,"Simpkin, Jy",26,9,4,17,0,0,0,4
North Melbourne,"Stephenson, Jaidyn",14,8,4,6,0,1,0,2
North Melbourne,"Thomas, Tarryn",17,10,2,7,1,3,0,1
North Melbourne,"Turner, Kayne",16,8,4,8,0,0,0,1
North Melbourne,"Tyson, Dom",13,8,5,5,0,0,0,0
North Melbourne,"Walker, Josh",12,5,5,7,0,0,4,1
North Melbourne,"Young, Lachie",15,12,5,3,0,0,0,1
North Melbourne,"Ziebell, Jack",22,18,6,4,0,0,0,1
North Melbourne,"Zurhaar, Cameron",14,8,3,6,0,0,0,3
North Melbourne,"Anderson, Jed",12,7,5,5,0,0,0,4
North Melbourne,"Atley, Shaun",17,12,9,5,0,0,0,2
North Melbourne,"Cunnington, Ben",22,9,3,13,0,1,0,5
North Melbourne,"Davies-Uniacke, Luke",17,11,4,6,0,0,0,5
North Melbourne,"Goldstein, Todd",15,8,5,7,0,0,23,2
North Melbourne,"Hall, Aaron",23,15,9,8,1,0,0,2
North Melbourne,"Hayden, Kyron",5,3,3,2,0,0,0,2
North Melbourne,"Larkey, Nick",8,6,2,2,1,1,11,2
North Melbourne,"Lazzaro, Charlie",7,4,3,3,1,1,0,1
North Melbourne,"Mahony, Jack",11,4,2,7,0,0,0,2
North Melbourne,"McKay, Ben",7,1,2,6,0,0,0,1
North Melbourne,"Phillips, Will",9,4,2,5,0,0,0,3
North Melbourne,"Polec, Jared",7,6,2,1,0,0,0,0
North Melbourne,"Powell, Tom",14,7,7,7,0,0,0,2
North Melbourne,"Scott, Bailey",13,9,6,4,0,0,0,1
North Melbourne,"Simpkin, Jy",22,15,9,7,0,0,0,2
North Melbourne,"Stephenson, Jaidyn",19,15,4,4,2,0,0,1
North Melbourne,"Thomas, Tarryn",12,9,5,3,0,2,0,2
North Melbourne,"Turner, Kayne",13,7,4,6,0,1,0,0
North Melbourne,"Walker, Josh",17,11,10,6,0,0,0,0
North Melbourne,"Young, Lachie",16,9,7,7,0,0,0,5
North Melbourne,"Ziebell, Jack",33,27,11,6,0,0,0,4
North Melbourne,"Zurhaar, Cameron",17,14,9,3,0,1,0,4
North Melbourne,"Atley, Shaun",18,11,5,7,0,0,0,3
North Melbourne,"Bonar, Aiden",8,6,4,2,0,0,0,1
North Melbourne,"Campbell, Tom",8,5,2,3,0,0,14,1
North Melbourne,"Cunnington, Ben",20,8,4,12,0,0,0,6
North Melbourne,"Davies-Uniacke, Luke",19,10,8,9,0,1,0,2
North Melbourne,"Goldstein, Todd",10,9,4,1,2,0,23,3
North Melbourne,"Hall, Aaron",33,25,6,8,0,1,0,3
North Melbourne,"Hayden, Kyron",9,7,2,2,0,0,0,2
North Melbourne,"Larkey, Nick",8,4,1,4,3,0,1,6
North Melbourne,"Lazzaro, Charlie",7,4,2,3,0,0,0,2
North Melbourne,"Mahony, Jack",13,10,3,3,0,1,0,3
North Melbourne,"McDonald, Luke",3,2,0,1,0,0,0,0
North Melbourne,"McKay, Ben",14,3,4,11,0,0,0,2
North Melbourne,"Phillips, Will",13,6,1,7,1,0,0,1
North Melbourne,"Powell, Tom",19,6,5,13,0,0,0,8
North Melbourne,"Scott, Bailey",17,7,1,10,0,0,0,2
North Melbourne,"Simpkin, Jy",29,11,2,18,0,0,0,1
North Melbourne,"Stephenson, Jaidyn",17,12,3,5,2,2,0,4
North Melbourne,"Thomas, Tarryn",12,8,6,4,2,0,0,5
North Melbourne,"Turner, Kayne",13,7,2,6,0,0,0,7
North Melbourne,"Young, Lachie",11,7,3,4,0,1,0,1
North Melbourne,"Ziebell, Jack",25,20,7,5,0,0,0,1
North Melbourne,"Zurhaar, Cameron",2,2,1,0,0,0,0,2
North Melbourne,"Atley, Shaun",24,14,4,10,0,1,0,1
North Melbourne,"Bonar, Aiden",20,8,6,12,0,0,0,1
North Melbourne,"Bosenavulagi, Atu",16,8,3,8,0,0,0,3
North Melbourne,"Campbell, Tom",9,6,3,3,0,0,15,3
North Melbourne,"Cunnington, Ben",29,16,5,13,1,1,0,2
North Melbourne,"Goldstein, Todd",10,8,4,2,0,0,29,3
North Melbourne,"Hall, Aaron",8,7,3,1,1,0,0,0
North Melbourne,"Hayden, Kyron",7,4,3,3,0,0,0,2
North Melbourne,"Larkey, Nick",5,4,4,1,2,0,1,1
North Melbourne,"Lazzaro, Charlie",5,4,0,1,0,0,0,3
North Melbourne,"Mahony, Jack",8,4,4,4,0,0,0,3
North Melbourne,"McKay, Ben",7,4,4,3,0,0,0,0
North Melbourne,"Phillips, Will",7,3,3,4,0,0,0,3
North Melbourne,"Powell, Tom",19,7,6,12,0,0,0,3
North Melbourne,"Scott, Bailey",6,4,2,2,0,0,0,1
North Melbourne,"Simpkin, Jy",24,18,0,6,0,0,0,3
North Melbourne,"Stephenson, Jaidyn",16,14,9,2,2,1,0,2
North Melbourne,"Taylor, Curtis",13,6,3,7,0,0,0,4
North Melbourne,"Thomas, Tarryn",11,4,3,7,1,0,0,3
North Melbourne,"Turner, Kayne",8,0,0,8,0,0,0,7
North Melbourne,"Walker, Josh",11,7,5,4,0,0,0,1
North Melbourne,"Young, Lachie",20,16,6,4,0,0,0,3
North Melbourne,"Ziebell, Jack",38,33,9,5,0,0,0,1
North Melbourne,"Atley, Shaun",22,11,7,11,0,0,0,4
North Melbourne,"Bonar, Aiden",19,17,10,2,0,0,0,2
North Melbourne,"Bosenavulagi, Atu",15,12,9,3,0,0,0,2
North Melbourne,"Campbell, Tom",10,6,5,4,1,0,15,1
North Melbourne,"Cunnington, Ben",25,12,2,13,0,1,0,7
North Melbourne,"Davies-Uniacke, Luke",18,9,3,9,0,2,0,3
North Melbourne,"Goldstein, Todd",18,8,4,10,1,0,18,1
North Melbourne,"Larkey, Nick",12,5,3,7,1,0,0,1
North Melbourne,"Mahony, Jack",21,10,3,11,0,0,0,2
North Melbourne,"McKay, Ben",17,11,8,6,0,0,0,1
North Melbourne,"Menadue, Connor",18,11,7,7,0,0,0,3
North Melbourne,"Phillips, Will",9,5,1,4,1,0,0,1
North Melbourne,"Powell, Tom",25,15,8,10,0,1,0,3
North Melbourne,"Simpkin, Jy",25,13,3,12,0,0,0,6
North Melbourne,"Stephenson, Jaidyn",18,15,5,3,2,0,0,2
North Melbourne,"Taylor, Curtis",18,12,10,6,0,1,0,3
North Melbourne,"Thomas, Tarryn",19,12,4,7,0,2,0,5
North Melbourne,"Turner, Kayne",14,8,5,6,0,1,0,5
North Melbourne,"Tyson, Dom",0,0,0,0,0,0,0,0
North Melbourne,"Walker, Josh",13,6,6,7,0,0,0,1
North Melbourne,"Young, Lachie",15,8,6,7,0,0,0,0
North Melbourne,"Ziebell, Jack",37,32,14,5,0,0,0,5
North Melbourne,"Zurhaar, Cameron",10,7,5,3,0,1,0,4
North Melbourne,"Atley, Shaun",15,9,6,6,1,0,0,3
North Melbourne,"Bonar, Aiden",3,3,3,0,0,0,0,0
North Melbourne,"Bosenavulagi, Atu",15,7,3,8,0,0,0,2
North Melbourne,"Campbell, Tom",11,5,4,6,2,0,8,0
North Melbourne,"Cunnington, Ben",35,19,1,16,2,0,0,6
North Melbourne,"Goldstein, Todd",11,5,2,6,0,0,23,0
North Melbourne,"Hall, Aaron",33,25,12,8,0,0,0,4
North Melbourne,"Larkey, Nick",13,7,5,6,2,1,1,0
North Melbourne,"Lazzaro, Charlie",15,8,3,7,0,0,0,2
North Melbourne,"Mahony, Jack",14,4,4,10,1,0,0,2
North Melbourne,"McKay, Ben",5,4,3,1,0,0,0,0
North Melbourne,"Menadue, Connor",8,6,3,2,0,0,0,1
North Melbourne,"Phillips, Will",16,9,4,7,0,1,0,3
North Melbourne,"Powell, Tom",23,14,4,9,1,0,0,6
North Melbourne,"Simpkin, Jy",30,13,8,17,1,1,0,1
North Melbourne,"Stephenson, Jaidyn",18,13,7,5,0,1,0,2
North Melbourne,"Taylor, Curtis",7,2,0,5,0,0,0,3
North Melbourne,"Thomas, Tarryn",15,9,2,6,0,0,0,3
North Melbourne,"Turner, Kayne",27,14,5,13,0,0,0,6
North Melbourne,"Walker, Josh",11,7,8,4,0,0,0,1
North Melbourne,"Young, Lachie",11,8,3,3,0,0,0,2
North Melbourne,"Ziebell, Jack",23,19,9,4,0,0,0,2
North Melbourne,"Zurhaar, Cameron",8,7,3,1,1,1,0,2
North Melbourne,"Atley, Shaun",22,13,7,9,0,0,0,2
North Melbourne,"Bonar, Aiden",10,8,2,2,0,0,0,2
North Melbourne,"Campbell, Tom",19,8,8,11,1,0,0,3
North Melbourne,"Cunnington, Ben",21,9,6,12,0,1,0,2
North Melbourne,"Davies-Uniacke, Luke",18,11,3,7,0,0,0,3
North Melbourne,"Goldstein, Todd",17,10,5,7,0,1,20,1
North Melbourne,"Hall, Aaron",37,30,8,7,0,1,0,1
North Melbourne,"Larkey, Nick",8,3,3,5,0,0,0,3
North Melbourne,"Lazzaro, Charlie",11,7,3,4,1,0,0,2
North Melbourne,"Mahony, Jack",10,7,4,3,2,0,0,4
North Melbourne,"McKay, Ben",17,8,9,9,0,0,0,4
North Melbourne,"Menadue, Connor",25,12,6,13,0,0,0,3
North Melbourne,"Phillips, Will",1,0,0,1,0,0,0,1
North Melbourne,"Powell, Tom",16,8,3,8,0,0,0,2
North Melbourne,"Simpkin, Jy",16,8,3,8,0,1,0,1
North Melbourne,"Stephenson, Jaidyn",19,11,6,8,2,2,0,1
North Melbourne,"Taylor, Curtis",9,4,1,5,0,0,0,1
North Melbourne,"Thomas, Tarryn",15,11,5,4,2,1,0,2
North Melbourne,"Turner, Kayne",15,9,4,6,1,0,0,3
North Melbourne,"Walker, Josh",12,7,5,5,0,0,0,0
North Melbourne,"Young, Lachie",17,12,7,5,0,1,0,3
North Melbourne,"Ziebell, Jack",30,20,7,10,0,0,0,0
North Melbourne,"Zurhaar, Cameron",13,11,5,2,2,2,0,0
North Melbourne,"Atley, Shaun",19,6,5,13,0,0,0,0
North Melbourne,"Campbell, Tom",10,6,3,4,0,1,12,4
North Melbourne,"Cunnington, Ben",37,12,2,25,0,0,0,3
North Melbourne,"Davies-Uniacke, Luke",24,8,4,16,1,1,0,3
North Melbourne,"Dumont, Trent",14,11,3,3,0,0,0,1
North Melbourne,"Garner, Taylor",13,11,5,2,3,1,0,4
North Melbourne,"Goldstein, Todd",19,9,6,10,1,0,28,1
North Melbourne,"Hall, Aaron",28,17,6,11,0,0,0,3
North Melbourne,"Larkey, Nick",12,8,4,4,1,1,5,1
North Melbourne,"Lazzaro, Charlie",7,6,2,1,0,1,0,4
North Melbourne,"Mahony, Jack",9,5,3,4,1,0,0,3
North Melbourne,"McKay, Ben",10,3,2,7,0,0,0,0
North Melbourne,"Menadue, Connor",8,4,3,4,0,0,0,0
North Melbourne,"Phillips, Will",0,0,0,0,0,0,0,0
North Melbourne,"Powell, Tom",10,6,0,4,0,0,0,4
North Melbourne,"Simpkin, Jy",38,22,2,16,0,0,0,9
North Melbourne,"Taylor, Curtis",15,7,4,8,1,0,0,3
North Melbourne,"Thomas, Tarryn",18,12,2,6,1,2,0,1
North Melbourne,"Turner, Kayne",11,4,1,7,0,0,0,1
North Melbourne,"Walker, Josh",14,10,8,4,0,0,0,2
North Melbourne,"Young, Lachie",5,4,3,1,0,0,0,2
North Melbourne,"Ziebell, Jack",19,17,6,2,0,0,0,3
North Melbourne,"Zurhaar, Cameron",9,6,2,3,4,2,0,2
North Melbourne,"Atley, Shaun",22,12,9,10,0,0,0,1
North Melbourne,"Campbell, Tom",13,5,5,8,2,0,13,1
North Melbourne,"Cunnington, Ben",34,19,4,15,1,0,0,4
North Melbourne,"Davies-Uniacke, Luke",21,9,6,12,0,1,0,2
North Melbourne,"Dumont, Trent",14,9,2,5,0,0,0,3
North Melbourne,"Garner, Taylor",19,11,7,8,3,0,0,1
North Melbourne,"Goldstein, Todd",14,8,3,6,0,0,19,2
North Melbourne,"Hall, Aaron",29,24,7,5,0,1,0,4
North Melbourne,"Larkey, Nick",6,2,2,4,0,0,1,0
North Melbourne,"Lazzaro, Charlie",14,6,4,8,0,1,0,1
North Melbourne,"Mahony, Jack",9,5,2,4,0,1,0,1
North Melbourne,"McKay, Ben",11,6,6,5,0,0,0,2
North Melbourne,"Menadue, Connor",14,7,7,7,0,0,0,1
North Melbourne,"Powell, Tom",14,7,2,7,0,0,0,1
North Melbourne,"Scott, Bailey",0,0,0,0,0,0,0,0
North Melbourne,"Simpkin, Jy",20,7,1,13,0,0,0,4
North Melbourne,"Taylor, Curtis",13,9,6,4,0,0,0,2
North Melbourne,"Thomas, Tarryn",21,13,5,8,2,0,0,3
North Melbourne,"Turner, Kayne",8,4,2,4,0,0,0,1
North Melbourne,"Walker, Josh",15,7,9,8,1,0,0,2
North Melbourne,"Young, Lachie",13,9,5,4,0,0,0,2
North Melbourne,"Ziebell, Jack",24,19,12,5,0,0,0,0
North Melbourne,"Zurhaar, Cameron",13,10,5,3,1,2,0,2
North Melbourne,"Atley, Shaun",15,8,3,7,0,0,0,0
North Melbourne,"Campbell, Tom",12,6,4,6,0,0,13,0
North Melbourne,"Cunnington, Ben",23,9,2,14,0,1,0,6
North Melbourne,"Davies-Uniacke, Luke",23,14,5,9,0,1,0,5
North Melbourne,"Dumont, Trent",18,13,4,5,0,0,0,1
North Melbourne,"Garner, Taylor",15,9,6,6,1,0,0,0
North Melbourne,"Goldstein, Todd",13,5,0,8,0,0,33,2
North Melbourne,"Hall, Aaron",33,25,7,8,0,0,0,4
North Melbourne,"Larkey, Nick",10,6,5,4,2,1,0,2
North Melbourne,"Lazzaro, Charlie",0,0,0,0,0,0,0,0
North Melbourne,"Mahony, Jack",9,4,1,5,0,0,0,6
North Melbourne,"McKay, Ben",9,5,4,4,0,0,0,3
North Melbourne,"Menadue, Connor",14,6,5,8,0,0,0,0
North Melbourne,"Powell, Tom",18,4,2,14,0,0,0,5
North Melbourne,"Scott, Bailey",14,7,4,7,0,1,0,2
North Melbourne,"Simpkin, Jy",26,16,5,10,0,0,0,6
North Melbourne,"Taylor, Curtis",16,13,7,3,1,0,0,0
North Melbourne,"Thomas, Tarryn",17,11,5,6,2,1,0,6
North Melbourne,"Turner, Kayne",7,5,3,2,0,0,0,2
North Melbourne,"Walker, Josh",12,7,7,5,0,0,0,1
North Melbourne,"Young, Lachie",12,6,5,6,0,0,0,1
North Melbourne,"Ziebell, Jack",23,22,7,1,2,0,0,0
North Melbourne,"Zurhaar, Cameron",11,7,3,4,2,0,0,1
North Melbourne,"Atley, Shaun",22,13,9,9,0,0,0,1
North Melbourne,"Cunnington, Ben",25,14,4,11,2,0,0,5
North Melbourne,"Davies-Uniacke, Luke",17,7,4,10,1,0,0,4
North Melbourne,"Dumont, Trent",22,12,7,10,0,0,0,3
North Melbourne,"Garner, Taylor",7,5,3,2,0,0,0,2
North Melbourne,"Goldstein, Todd",14,9,6,5,1,0,29,3
North Melbourne,"Hall, Aaron",35,27,6,8,0,1,0,4
North Melbourne,"Larkey, Nick",9,6,5,3,2,0,0,0
North Melbourne,"Mahony, Jack",15,7,2,8,1,1,0,4
North Melbourne,"McKay, Ben",6,4,3,2,0,0,0,3
North Melbourne,"Powell, Tom",11,9,4,2,1,0,0,4
North Melbourne,"Scott, Bailey",9,6,3,3,1,1,0,3
North Melbourne,"Simpkin, Jy",31,18,6,13,0,0,0,8
North Melbourne,"Stephenson, Jaidyn",18,15,8,3,1,1,0,1
North Melbourne,"Tarrant, Robbie",14,8,4,6,0,0,0,3
North Melbourne,"Taylor, Curtis",0,0,0,0,0,0,0,0
North Melbourne,"Thomas, Tarryn",19,10,4,9,2,0,0,2
North Melbourne,"Turner, Kayne",16,7,5,9,0,0,0,2
North Melbourne,"Walker, Josh",11,6,6,5,0,0,0,0
North Melbourne,"Xerri, Tristan",8,4,2,4,0,0,5,1
North Melbourne,"Young, Lachie",9,5,4,4,0,0,0,1
North Melbourne,"Ziebell, Jack",26,17,6,9,0,0,0,1
North Melbourne,"Zurhaar, Cameron",16,11,4,5,2,2,0,5
North Melbourne,"Atley, Shaun",13,6,1,7,0,0,0,0
North Melbourne,"Cunnington, Ben",25,15,2,10,0,0,0,10
North Melbourne,"Davies-Uniacke, Luke",22,12,8,10,0,1,0,5
North Melbourne,"Dumont, Trent",21,15,4,6,0,0,0,4
North Melbourne,"Goldstein, Todd",8,4,1,4,0,0,53,2
North Melbourne,"Hall, Aaron",27,22,3,5,0,1,0,3
North Melbourne,"Larkey, Nick",12,9,6,3,3,1,0,1
North Melbourne,"Mahony, Jack",9,6,4,3,0,0,0,5
North Melbourne,"McDonald, Luke",17,9,4,8,0,0,0,2
North Melbourne,"McKay, Ben",7,3,2,4,0,0,0,2
North Melbourne,"Powell, Tom",13,6,2,7,0,0,0,7
North Melbourne,"Scott, Bailey",10,4,2,6,0,0,0,6
North Melbourne,"Simpkin, Jy",31,22,3,9,0,1,0,3
North Melbourne,"Stephenson, Jaidyn",10,6,3,4,1,0,0,2
North Melbourne,"Tarrant, Robbie",12,6,2,6,0,0,0,0
North Melbourne,"Taylor, Curtis",14,10,5,4,0,0,0,5
North Melbourne,"Thomas, Tarryn",20,11,5,9,0,2,0,5
North Melbourne,"Turner, Kayne",6,3,0,3,0,0,0,2
North Melbourne,"Walker, Josh",13,8,3,5,0,0,0,1
North Melbourne,"Xerri, Tristan",5,2,1,3,0,0,9,4
North Melbourne,"Young, Lachie",0,0,0,0,0,0,0,0
North Melbourne,"Ziebell, Jack",32,26,5,6,0,0,0,4
North Melbourne,"Zurhaar, Cameron",10,5,1,5,2,2,0,3
North Melbourne,"Atley, Shaun",11,5,0,6,0,0,0,0
North Melbourne,"Bosenavulagi, Atu",0,0,0,0,0,0,0,0
North Melbourne,"Cunnington, Ben",28,17,6,11,0,0,0,5
North Melbourne,"Davies-Uniacke, Luke",26,8,2,18,1,1,0,4
North Melbourne,"Dumont, Trent",21,18,11,3,0,0,0,2
North Melbourne,"Goldstein, Todd",21,10,2,11,0,1,44,3
North Melbourne,"Hall, Aaron",17,14,9,3,0,0,0,3
North Melbourne,"Larkey, Nick",16,9,8,7,3,0,0,3
North Melbourne,"Mahony, Jack",13,6,2,7,1,0,0,2
North Melbourne,"McDonald, Luke",20,11,6,9,0,1,0,4
North Melbourne,"McKay, Ben",8,5,6,3,0,0,0,0
North Melbourne,"Phillips, Will",12,7,4,5,0,2,0,4
North Melbourne,"Simpkin, Jy",30,20,4,10,1,0,0,4
North Melbourne,"Stephenson, Jaidyn",20,16,4,4,0,2,0,7
North Melbourne,"Tarrant, Robbie",10,7,1,3,0,0,0,0
North Melbourne,"Taylor, Curtis",13,8,2,5,0,1,0,2
North Melbourne,"Thomas, Tarryn",16,11,5,5,0,2,0,0
North Melbourne,"Turner, Kayne",10,9,4,1,1,0,0,3
North Melbourne,"Walker, Josh",14,6,2,8,0,0,0,1
North Melbourne,"Xerri, Tristan",11,5,3,6,0,1,7,2
North Melbourne,"Young, Lachie",10,4,1,6,0,0,0,0
North Melbourne,"Ziebell, Jack",19,15,4,4,0,0,0,3
North Melbourne,"Zurhaar, Cameron",24,12,7,12,2,2,0,2
North Melbourne,"Atley, Shaun",15,10,8,5,0,0,0,0
North Melbourne,"Cunnington, Ben",26,17,8,9,2,2,0,7
North Melbourne,"Davies-Uniacke, Luke",18,8,5,10,1,0,0,3
North Melbourne,"Dumont, Trent",17,12,7,5,0,0,0,1
North Melbourne,"Ford, Eddie",0,0,0,0,0,0,0,0
North Melbourne,"Goldstein, Todd",14,11,7,3,2,1,30,0
North Melbourne,"Hall, Aaron",31,23,13,8,0,1,0,3
North Melbourne,"Larkey, Nick",6,3,2,3,0,3,0,1
North Melbourne,"Mahony, Jack",13,6,4,7,0,0,0,2
North Melbourne,"McDonald, Luke",21,12,8,9,0,0,0,0
North Melbourne,"McKay, Ben",11,9,10,2,0,0,0,0
North Melbourne,"Phillips, Will",8,5,3,3,0,1,0,1
North Melbourne,"Scott, Bailey",16,10,7,6,1,0,0,3
North Melbourne,"Simpkin, Jy",24,18,8,6,0,0,0,3
North Melbourne,"Stephenson, Jaidyn",17,12,5,5,0,1,0,2
North Melbourne,"Tarrant, Robbie",24,21,15,3,0,0,0,0
North Melbourne,"Taylor, Curtis",14,9,5,5,0,1,0,1
North Melbourne,"Thomas, Tarryn",24,16,3,8,1,0,0,2
North Melbourne,"Turner, Kayne",7,4,1,3,0,1,0,2
North Melbourne,"Walker, Josh",13,8,6,5,0,0,0,1
North Melbourne,"Xerri, Tristan",6,1,2,5,0,0,13,2
North Melbourne,"Ziebell, Jack",28,21,7,7,0,0,0,2
North Melbourne,"Zurhaar, Cameron",14,9,4,5,4,1,0,1
North Melbourne,"Atley, Shaun",12,6,2,6,0,0,0,0
North Melbourne,"Cunnington, Ben",25,14,8,11,1,1,0,5
North Melbourne,"Davies-Uniacke, Luke",24,10,5,14,0,0,0,3
North Melbourne,"Dumont, Trent",17,11,5,6,0,0,0,2
North Melbourne,"Goldstein, Todd",12,8,6,4,2,0,31,3
North Melbourne,"Hall, Aaron",24,20,8,4,0,0,0,0
North Melbourne,"Larkey, Nick",8,6,5,2,3,0,0,0
North Melbourne,"Lazzaro, Charlie",0,0,0,0,0,0,0,0
North Melbourne,"Mahony, Jack",6,3,0,3,0,0,0,5
North Melbourne,"McDonald, Luke",15,10,4,5,0,0,0,4
North Melbourne,"McKay, Ben",7,3,2,4,0,0,0,3
North Melbourne,"Phillips, Will",10,2,2,8,0,0,0,3
North Melbourne,"Scott, Bailey",16,9,5,7,0,0,0,0
North Melbourne,"Simpkin, Jy",32,23,8,9,0,1,0,2
North Melbourne,"Stephenson, Jaidyn",38,22,10,16,1,0,0,4
North Melbourne,"Tarrant, Robbie",12,8,3,4,0,0,0,0
North Melbourne,"Taylor, Curtis",14,10,4,4,0,1,0,2
North Melbourne,"Thomas, Tarryn",19,12,5,7,1,0,0,4
North Melbourne,"Turner, Kayne",13,7,4,6,0,0,0,2
North Melbourne,"Walker, Josh",11,10,6,1,0,0,0,2
North Melbourne,"Xerri, Tristan",8,7,1,1,0,0,2,4
North Melbourne,"Ziebell, Jack",27,22,6,5,0,0,0,1
North Melbourne,"Zurhaar, Cameron",16,14,6,2,2,6,0,5
North Melbourne,"Atley, Shaun",19,12,10,7,0,0,0,1
North Melbourne,"Bosenavulagi, Atu",1,1,1,0,0,0,0,0
North Melbourne,"Davies-Uniacke, Luke",21,15,4,6,0,0,0,3
North Melbourne,"Dumont, Trent",10,5,4,5,0,0,0,2
North Melbourne,"Goldstein, Todd",15,7,1,8,0,1,37,3
North Melbourne,"Hall, Aaron",31,28,14,3,0,0,0,1
North Melbourne,"Larkey, Nick",11,7,2,4,3,2,0,0
North Melbourne,"Lazzaro, Charlie",12,5,5,7,1,0,0,1
North Melbourne,"Mahony, Jack",9,4,2,5,1,0,0,6
North Melbourne,"McDonald, Luke",26,15,8,11,0,1,0,1
North Melbourne,"McKay, Ben",12,6,7,6,0,0,0,1
North Melbourne,"Phillips, Will",15,5,3,10,0,0,0,2
North Melbourne,"Scott, Bailey",13,7,2,6,1,1,0,1
North Melbourne,"Simpkin, Jy",23,10,3,13,0,0,0,7
North Melbourne,"Stephenson, Jaidyn",18,13,4,5,0,2,0,1
North Melbourne,"Tarrant, Robbie",13,12,7,1,0,0,0,2
North Melbourne,"Taylor, Curtis",15,11,7,4,2,0,0,2
North Melbourne,"Thomas, Tarryn",23,16,9,7,1,0,0,7
North Melbourne,"Turner, Kayne",4,2,2,2,0,0,0,1
North Melbourne,"Walker, Josh",10,3,2,7,0,0,0,2
North Melbourne,"Xerri, Tristan",10,3,2,7,1,1,4,2
North Melbourne,"Ziebell, Jack",19,19,7,0,0,0,0,0
North Melbourne,"Zurhaar, Cameron",13,10,5,3,1,0,0,5
North Melbourne,"Anderson, Jed",16,9,3,7,2,0,0,2
North Melbourne,"Atley, Shaun",14,11,7,3,0,0,0,1
North Melbourne,"Bosenavulagi, Atu",16,8,4,8,0,0,0,3
North Melbourne,"Cunnington, Ben",27,13,5,14,0,0,0,1
North Melbourne,"Davies-Uniacke, Luke",28,14,6,14,0,1,0,1
North Melbourne,"Dumont, Trent",27,16,7,11,0,0,0,2
North Melbourne,"Goldstein, Todd",15,10,4,5,1,0,30,1
North Melbourne,"Hall, Aaron",25,19,9,6,0,0,0,4
North Melbourne,"Larkey, Nick",20,12,8,8,7,1,0,1
North Melbourne,"McDonald, Luke",21,14,7,7,0,0,0,2
North Melbourne,"McKay, Ben",9,4,4,5,0,0,0,1
North Melbourne,"Phillips, Will",13,9,4,4,0,0,0,2
North Melbourne,"Polec, Jared",3,2,0,1,0,1,0,3
North Melbourne,"Scott, Bailey",26,8,4,18,0,0,0,2
North Melbourne,"Simpkin, Jy",31,15,8,16,0,0,0,5
North Melbourne,"Stephenson, Jaidyn",24,16,8,8,3,1,0,2
North Melbourne,"Taylor, Curtis",15,8,4,7,0,0,0,5
North Melbourne,"Thomas, Tarryn",23,13,4,10,4,1,0,5
North Melbourne,"Turner, Kayne",11,8,5,3,0,0,0,1
North Melbourne,"Walker, Josh",8,5,4,3,0,0,0,1
North Melbourne,"Xerri, Tristan",7,2,2,5,0,0,11,1
North Melbourne,"Ziebell, Jack",20,17,5,3,0,0,0,4
North Melbourne,"Zurhaar, Cameron",9,6,1,3,1,0,0,1
North Melbourne,"Anderson, Jed",13,7,2,6,0,1,0,7
North Melbourne,"Atley, Shaun",0,0,0,0,0,0,0,0
North Melbourne,"Bosenavulagi, Atu",11,6,4,5,1,0,0,1
North Melbourne,"Davies-Uniacke, Luke",23,15,6,8,1,0,0,2
North Melbourne,"Dumont, Trent",19,12,7,7,0,0,0,1
North Melbourne,"Ford, Eddie",10,8,7,2,1,1,0,0
North Melbourne,"Goldstein, Todd",12,9,5,3,0,0,21,1
North Melbourne,"Hall, Aaron",36,24,6,12,0,0,0,1
North Melbourne,"Larkey, Nick",5,3,3,2,2,0,0,0
North Melbourne,"Mahony, Jack",8,5,4,3,0,0,0,1
North Melbourne,"McDonald, Luke",17,14,9,3,0,0,0,4
North Melbourne,"McKay, Ben",13,6,6,7,0,0,0,0
North Melbourne,"Phillips, Will",17,8,3,9,0,0,0,2
North Melbourne,"Polec, Jared",11,11,6,0,0,0,0,2
North Melbourne,"Scott, Bailey",20,9,5,11,0,0,0,3
North Melbourne,"Simpkin, Jy",29,16,8,13,0,0,0,2
North Melbourne,"Stephenson, Jaidyn",19,14,8,5,0,0,0,2
North Melbourne,"Tarrant, Robbie",15,9,9,6,0,0,0,1
North Melbourne,"Taylor, Curtis",14,12,10,2,1,0,0,1
North Melbourne,"Turner, Kayne",11,7,5,4,0,0,0,2
North Melbourne,"Walker, Josh",13,7,5,6,0,0,0,1
North Melbourne,"Xerri, Tristan",5,2,1,3,0,0,8,1
North Melbourne,"Ziebell, Jack",20,15,7,5,0,0,0,3
North Melbourne,"Anderson, Jed",25,15,6,10,0,0,0,4
North Melbourne,"Bonar, Aiden",10,2,1,8,0,0,0,1
North Melbourne,"Campbell, Tom",8,2,1,6,0,0,7,1
North Melbourne,"Davies-Uniacke, Luke",38,19,5,19,0,0,0,2
North Melbourne,"Dumont, Trent",20,12,4,8,0,0,0,0
North Melbourne,"Ford, Eddie",8,4,4,4,0,0,0,0
North Melbourne,"Goldstein, Todd",20,5,5,15,0,0,33,0
North Melbourne,"Hall, Aaron",38,23,9,15,0,0,0,0
North Melbourne,"Larkey, Nick",9,7,6,2,1,3,0,0
North Melbourne,"Mahony, Jack",18,10,4,8,1,0,0,5
North Melbourne,"McDonald, Luke",22,8,4,14,0,0,0,0
North Melbourne,"McKay, Ben",9,2,3,7,0,0,0,2
North Melbourne,"Phillips, Will",0,0,0,0,0,0,0,0
North Melbourne,"Scott, Bailey",6,3,2,3,1,0,0,1
North Melbourne,"Simpkin, Jy",34,22,6,12,0,1,0,2
North Melbourne,"Stephenson, Jaidyn",16,10,4,6,0,2,0,2
North Melbourne,"Tarrant, Robbie",17,12,9,5,0,0,0,1
North Melbourne,"Taylor, Curtis",17,6,2,11,1,0,0,0
North Melbourne,"Thomas, Tarryn",22,12,8,10,0,0,0,4
North Melbourne,"Turner, Kayne",15,9,5,6,0,0,0,5
North Melbourne,"Walker, Josh",14,9,6,5,0,0,0,0
North Melbourne,"Ziebell, Jack",23,16,9,7,0,0,0,2
North Melbourne,"Zurhaar, Cameron",10,7,4,3,4,0,0,5
North Melbourne,"Anderson, Jed",19,10,2,9,1,0,0,4
North Melbourne,"Bonar, Aiden",6,4,1,2,0,0,0,2
North Melbourne,"Comben, Charlie",6,3,2,3,1,0,0,1
North Melbourne,"Davies-Uniacke, Luke",24,16,5,8,0,1,0,3
North Melbourne,"Dumont, Trent",16,13,6,3,0,0,0,2
North Melbourne,"Ford, Eddie",11,7,7,4,2,1,0,1
North Melbourne,"Goldstein, Todd",14,5,6,9,0,0,35,2
North Melbourne,"Hall, Aaron",30,26,10,4,0,0,0,1
North Melbourne,"Larkey, Nick",5,3,2,2,2,1,1,2
North Melbourne,"McDonald, Luke",16,11,4,5,0,0,0,4
North Melbourne,"McKay, Ben",8,2,2,6,0,0,0,1
North Melbourne,"Phillips, Will",12,6,0,6,0,0,0,5
North Melbourne,"Scott, Bailey",11,1,2,10,0,0,0,0
North Melbourne,"Simpkin, Jy",22,6,1,16,0,0,0,2
North Melbourne,"Stephenson, Jaidyn",17,13,8,4,1,0,0,0
North Melbourne,"Tarrant, Robbie",12,11,9,1,0,0,0,1
North Melbourne,"Taylor, Curtis",19,11,6,8,1,0,0,1
North Melbourne,"Thomas, Tarryn",18,10,6,8,1,0,0,2
North Melbourne,"Turner, Kayne",13,5,1,8,0,0,0,0
North Melbourne,"Walker, Josh",17,13,4,4,0,0,7,2
North Melbourne,"Young, Lachie",0,0,0,0,0,0,0,0
North Melbourne,"Ziebell, Jack",17,12,7,5,0,0,0,0
North Melbourne,"Zurhaar, Cameron",10,6,3,4,3,1,0,5
North Melbourne,"Anderson, Jed",20,7,1,13,1,0,0,5
North Melbourne,"Atley, Shaun",17,4,2,13,0,0,0,2
North Melbourne,"Bonar, Aiden",6,5,1,1,0,0,0,3
North Melbourne,"Bosenavulagi, Atu",7,4,4,3,0,0,0,2
North Melbourne,"Davies-Uniacke, Luke",18,11,5,7,0,0,0,2
North Melbourne,"Dumont, Trent",14,9,4,5,0,0,0,2
North Melbourne,"Ford, Eddie",9,5,3,4,0,1,0,3
North Melbourne,"Goldstein, Todd",12,4,1,8,0,0,41,4
North Melbourne,"Hall, Aaron",37,28,5,9,0,0,0,3
North Melbourne,"Larkey, Nick",13,6,5,7,3,0,0,1
North Melbourne,"McDonald, Luke",11,8,3,3,0,0,0,7
North Melbourne,"McKay, Ben",6,4,4,2,0,0,0,1
North Melbourne,"Phillips, Will",10,2,1,8,1,0,0,2
North Melbourne,"Scott, Bailey",5,3,0,2,1,0,0,0
North Melbourne,"Simpkin, Jy",26,13,2,13,0,0,0,7
North Melbourne,"Spicer, Phoenix",7,3,1,4,0,1,0,0
North Melbourne,"Stephenson, Jaidyn",17,7,4,10,0,1,0,4
North Melbourne,"Tarrant, Robbie",16,10,8,6,0,0,0,2
North Melbourne,"Taylor, Curtis",14,11,1,3,0,1,0,5
North Melbourne,"Thomas, Tarryn",26,15,5,11,1,1,0,7
North Melbourne,"Turner, Kayne",10,5,5,5,0,0,0,2
North Melbourne,"Walker, Josh",8,5,1,3,1,0,4,1
North Melbourne,"Zurhaar, Cameron",6,6,3,0,0,0,0,2
Port Adelaide,"Aliir, Aliir",14,11,4,3,0,0,0,1
Port Adelaide,"Amon, Karl",16,12,4,4,1,0,0,3
Port Adelaide,"Bergman, Miles",14,7,2,7,0,0,0,3
Port Adelaide,"Boak, Travis",27,17,3,10,2,1,0,4
Port Adelaide,"Bonner, Riley",14,11,2,3,1,0,0,1
Port Adelaide,"Burton, Ryan",19,12,5,7,0,0,0,3
Port Adelaide,"Butters, Zak",16,11,6,5,2,1,0,4
Port Adelaide,"Byrne-Jones, Darcy",19,13,5,6,0,0,0,1
Port Adelaide,"Clurey, Tom",12,9,8,3,0,0,0,2
Port Adelaide,"Dixon, Charlie",11,6,3,5,2,2,1,0
Port Adelaide,"Drew, Willem",17,6,1,11,0,0,0,11
Port Adelaide,"Duursma, Xavier",14,8,5,6,1,0,0,1
Port Adelaide,"Fantasia, Orazio",14,11,3,3,4,4,0,2
Port Adelaide,"Farrell, Kane",11,6,1,5,0,1,0,1
Port Adelaide,"Gray, Robbie",19,11,3,8,0,1,0,1
Port Adelaide,"Houston, Dan",26,18,3,8,0,1,0,1
Port Adelaide,"Jonas, Tom",9,5,2,4,0,0,0,4
Port Adelaide,"Ladhams, Peter",15,7,4,8,0,0,7,2
Port Adelaide,"Lycett, Scott",13,5,2,8,1,0,28,5
Port Adelaide,"Marshall, Todd",10,9,5,1,2,1,0,0
Port Adelaide,"Motlop, Steven",24,16,12,8,1,0,0,2
Port Adelaide,"Rockliff, Tom",11,3,0,8,0,1,0,0
Port Adelaide,"Wines, Ollie",30,15,5,15,0,0,0,2
Port Adelaide,"Aliir, Aliir",14,11,8,3,0,0,0,2
Port Adelaide,"Amon, Karl",20,16,7,4,1,1,0,1
Port Adelaide,"Bergman, Miles",15,12,7,3,0,0,0,1
Port Adelaide,"Boak, Travis",30,14,1,16,0,1,0,4
Port Adelaide,"Burton, Ryan",17,11,6,6,0,0,0,1
Port Adelaide,"Butters, Zak",36,12,3,24,1,0,0,6
Port Adelaide,"Byrne-Jones, Darcy",21,13,2,8,0,0,0,2
Port Adelaide,"Clurey, Tom",10,8,4,2,0,0,0,2
Port Adelaide,"Dixon, Charlie",13,8,5,5,4,2,0,2
Port Adelaide,"Drew, Willem",25,10,1,15,0,1,0,1
Port Adelaide,"Duursma, Xavier",24,12,8,12,0,0,0,4
Port Adelaide,"Fantasia, Orazio",17,14,6,3,2,3,0,2
Port Adelaide,"Farrell, Kane",9,3,3,6,0,0,0,3
Port Adelaide,"Georgiades, Mitch",13,9,8,4,4,0,0,2
Port Adelaide,"Gray, Robbie",16,3,6,13,0,0,0,0
Port Adelaide,"Hartlett, Hamish",22,13,4,9,0,1,0,3
Port Adelaide,"Houston, Dan",25,21,4,4,1,0,0,4
Port Adelaide,"Jonas, Tom",15,7,5,8,0,0,0,1
Port Adelaide,"Ladhams, Peter",11,8,3,3,2,0,10,2
Port Adelaide,"Lycett, Scott",21,9,6,12,1,0,26,0
Port Adelaide,"Motlop, Steven",21,11,6,10,2,0,0,2
Port Adelaide,"Rockliff, Tom",0,0,0,0,0,0,0,0
Port Adelaide,"Wines, Ollie",38,17,0,21,0,0,0,5
Port Adelaide,"Aliir, Aliir",15,9,5,6,0,0,0,1
Port Adelaide,"Amon, Karl",23,15,8,8,0,1,0,5
Port Adelaide,"Bergman, Miles",0,0,0,0,0,0,0,0
Port Adelaide,"Boak, Travis",26,10,2,16,0,0,0,6
Port Adelaide,"Burton, Ryan",21,14,4,7,0,0,0,1
Port Adelaide,"Butters, Zak",16,5,4,11,0,0,0,3
Port Adelaide,"Byrne-Jones, Darcy",19,11,4,8,0,0,0,0
Port Adelaide,"Clurey, Tom",12,11,6,1,0,0,0,0
Port Adelaide,"Dixon, Charlie",10,6,4,4,0,0,0,1
Port Adelaide,"Drew, Willem",15,6,4,9,1,0,0,6
Port Adelaide,"Duursma, Xavier",21,13,6,8,0,0,0,2
Port Adelaide,"Fantasia, Orazio",11,8,3,3,2,0,0,3
Port Adelaide,"Georgiades, Mitch",9,6,2,3,2,1,0,0
Port Adelaide,"Gray, Robbie",18,11,4,7,3,0,0,4
Port Adelaide,"Hartlett, Hamish",19,8,4,11,0,0,0,2
Port Adelaide,"Houston, Dan",28,17,5,11,0,0,0,2
Port Adelaide,"Jonas, Tom",11,6,4,5,0,0,0,0
Port Adelaide,"Ladhams, Peter",5,2,0,3,0,0,6,4
Port Adelaide,"Lycett, Scott",13,10,4,3,0,0,24,1
Port Adelaide,"Marshall, Todd",8,7,5,1,3,1,0,1
Port Adelaide,"Motlop, Steven",10,6,3,4,0,1,0,2
Port Adelaide,"Rozee, Connor",15,7,4,8,0,0,0,2
Port Adelaide,"Wines, Ollie",26,10,2,16,0,0,0,6
Port Adelaide,"Aliir, Aliir",23,14,6,9,0,0,0,2
Port Adelaide,"Amon, Karl",25,16,6,9,0,1,0,2
Port Adelaide,"Boak, Travis",29,17,3,12,0,1,0,2
Port Adelaide,"Burton, Ryan",21,10,3,11,0,0,0,4
Port Adelaide,"Butters, Zak",19,8,3,11,1,0,0,5
Port Adelaide,"Byrne-Jones, Darcy",18,10,3,8,0,0,0,4
Port Adelaide,"Clurey, Tom",16,12,8,4,0,0,0,1
Port Adelaide,"Dixon, Charlie",11,7,4,4,0,1,6,3
Port Adelaide,"Drew, Willem",13,7,1,6,0,0,0,2
Port Adelaide,"Duursma, Xavier",21,16,6,5,1,0,0,2
Port Adelaide,"Fantasia, Orazio",12,7,3,5,1,0,0,2
Port Adelaide,"Georgiades, Mitch",12,8,6,4,1,2,0,0
Port Adelaide,"Gray, Robbie",15,11,6,4,1,2,0,3
Port Adelaide,"Hartlett, Hamish",17,10,6,7,1,0,0,1
Port Adelaide,"Houston, Dan",23,17,5,6,1,1,0,7
Port Adelaide,"Jonas, Tom",13,9,4,4,0,0,0,3
Port Adelaide,"Jones, Lachie",17,14,6,3,0,0,0,0
Port Adelaide,"Ladhams, Peter",7,2,1,5,0,0,5,0
Port Adelaide,"Lycett, Scott",20,11,6,9,0,1,14,4
Port Adelaide,"Mayes, Sam",1,1,0,0,0,0,0,0
Port Adelaide,"Motlop, Steven",15,10,4,5,2,1,0,3
Port Adelaide,"Rozee, Connor",6,4,1,2,2,0,0,0
Port Adelaide,"Wines, Ollie",27,11,4,16,0,0,0,4
Port Adelaide,"Aliir, Aliir",17,11,6,6,0,0,0,1
Port Adelaide,"Amon, Karl",28,23,8,5,1,0,0,1
Port Adelaide,"Bergman, Miles",16,12,7,4,0,0,0,1
Port Adelaide,"Boak, Travis",29,11,1,18,0,1,0,2
Port Adelaide,"Burton, Ryan",19,13,3,6,0,0,0,3
Port Adelaide,"Byrne-Jones, Darcy",24,19,9,5,0,0,0,4
Port Adelaide,"Clurey, Tom",16,12,8,4,0,0,0,1
Port Adelaide,"Dixon, Charlie",13,7,7,6,2,1,1,2
Port Adelaide,"Drew, Willem",14,7,2,7,0,1,0,4
Port Adelaide,"Fantasia, Orazio",15,11,3,4,2,0,0,3
Port Adelaide,"Georgiades, Mitch",15,7,5,8,3,0,0,2
Port Adelaide,"Gray, Robbie",16,8,4,8,3,0,0,0
Port Adelaide,"Hartlett, Hamish",5,3,2,2,0,0,0,2
Port Adelaide,"Houston, Dan",9,6,1,3,0,0,0,1
Port Adelaide,"Jonas, Tom",18,16,6,2,0,0,0,1
Port Adelaide,"Jones, Lachie",17,6,2,11,0,0,0,0
Port Adelaide,"Lycett, Scott",12,6,1,6,1,0,28,4
Port Adelaide,"Marshall, Todd",19,15,9,4,1,0,0,2
Port Adelaide,"Mayes, Sam",20,9,5,11,0,0,0,2
Port Adelaide,"Motlop, Steven",11,8,5,3,0,1,0,3
Port Adelaide,"Rozee, Connor",17,9,4,8,1,1,0,3
Port Adelaide,"Wines, Ollie",32,12,5,20,0,1,0,3
Port Adelaide,"Woodcock, Boyd",18,9,7,9,1,0,0,3
Port Adelaide,"Aliir, Aliir",21,15,12,6,0,0,0,3
Port Adelaide,"Amon, Karl",34,22,15,12,0,1,0,0
Port Adelaide,"Bergman, Miles",16,12,7,4,0,1,0,2
Port Adelaide,"Boak, Travis",27,15,5,12,1,1,0,5
Port Adelaide,"Burton, Ryan",28,19,11,9,0,0,0,2
Port Adelaide,"Byrne-Jones, Darcy",27,18,8,9,0,0,0,5
Port Adelaide,"Clurey, Tom",19,18,8,1,0,0,0,1
Port Adelaide,"Dixon, Charlie",11,8,7,3,2,0,6,2
Port Adelaide,"Drew, Willem",17,5,1,12,0,0,0,8
Port Adelaide,"Fantasia, Orazio",15,12,6,3,3,3,0,1
Port Adelaide,"Frederick, Martin",23,8,6,15,0,0,0,1
Port Adelaide,"Georgiades, Mitch",6,5,6,1,2,1,0,1
Port Adelaide,"Gray, Robbie",15,6,2,9,1,0,0,1
Port Adelaide,"Hartlett, Hamish",26,11,5,15,0,0,0,2
Port Adelaide,"Houston, Dan",32,22,8,10,0,0,0,4
Port Adelaide,"Jonas, Tom",26,22,15,4,0,0,0,2
Port Adelaide,"Lycett, Scott",20,8,4,12,0,0,28,1
Port Adelaide,"Marshall, Todd",10,7,5,3,0,0,1,1
Port Adelaide,"Mayes, Sam",0,0,0,0,0,0,0,0
Port Adelaide,"Motlop, Steven",13,9,7,4,3,0,0,0
Port Adelaide,"Rozee, Connor",18,12,4,6,2,1,0,1
Port Adelaide,"Wines, Ollie",36,16,7,20,0,0,0,5
Port Adelaide,"Woodcock, Boyd",19,8,8,11,0,0,0,0
Port Adelaide,"Aliir, Aliir",18,12,8,6,0,0,0,2
Port Adelaide,"Amon, Karl",20,14,5,6,0,3,0,2
Port Adelaide,"Bergman, Miles",19,15,7,4,1,1,0,0
Port Adelaide,"Burton, Ryan",10,9,1,1,0,0,0,1
Port Adelaide,"Byrne-Jones, Darcy",11,5,2,6,0,0,0,7
Port Adelaide,"Clurey, Tom",13,7,5,6,0,0,0,0
Port Adelaide,"Dixon, Charlie",12,6,1,6,0,2,10,2
Port Adelaide,"Drew, Willem",32,12,6,20,1,1,0,4
Port Adelaide,"Fantasia, Orazio",7,3,1,4,0,1,0,3
Port Adelaide,"Frederick, Martin",16,9,6,7,0,0,0,2
Port Adelaide,"Georgiades, Mitch",8,5,3,3,0,0,0,1
Port Adelaide,"Gray, Robbie",22,10,6,12,1,0,0,0
Port Adelaide,"Hartlett, Hamish",8,6,3,2,0,1,0,1
Port Adelaide,"Houston, Dan",17,10,3,7,0,1,0,3
Port Adelaide,"Jonas, Tom",21,15,2,6,0,0,0,3
Port Adelaide,"Lycett, Scott",9,7,3,2,0,0,23,1
Port Adelaide,"Marshall, Todd",7,5,2,2,0,0,0,2
Port Adelaide,"Mayes, Sam",8,3,1,5,0,0,0,1
Port Adelaide,"Motlop, Steven",19,11,8,8,0,1,0,2
Port Adelaide,"Powell-Pepper, Sam",17,8,1,9,0,0,0,3
Port Adelaide,"Rozee, Connor",23,10,3,13,0,0,0,2
Port Adelaide,"Wines, Ollie",37,15,7,22,1,1,0,3
Port Adelaide,"Woodcock, Boyd",9,8,4,1,1,1,0,5
Port Adelaide,"Aliir, Aliir",12,11,9,1,0,0,0,2
Port Adelaide,"Amon, Karl",27,18,6,9,0,0,0,6
Port Adelaide,"Bergman, Miles",15,8,4,7,0,0,0,3
Port Adelaide,"Boak, Travis",28,11,3,17,0,0,0,3
Port Adelaide,"Burton, Ryan",20,17,6,3,0,0,0,4
Port Adelaide,"Byrne-Jones, Darcy",24,17,5,7,0,0,0,2
Port Adelaide,"Clurey, Tom",17,13,7,4,0,0,0,0
Port Adelaide,"Dixon, Charlie",14,7,4,7,2,1,6,5
Port Adelaide,"Drew, Willem",16,8,1,8,1,0,0,7
Port Adelaide,"Fantasia, Orazio",18,15,6,3,1,5,0,2
Port Adelaide,"Farrell, Kane",19,14,4,5,1,1,0,4
Port Adelaide,"Frederick, Martin",6,2,2,4,0,0,0,2
Port Adelaide,"Georgiades, Mitch",14,11,4,3,2,3,0,3
Port Adelaide,"Gray, Robbie",26,10,0,16,0,0,0,3
Port Adelaide,"Hartlett, Hamish",18,10,1,8,0,0,0,6
Port Adelaide,"Houston, Dan",19,13,3,6,0,0,0,2
Port Adelaide,"Jonas, Tom",16,12,5,4,0,0,0,2
Port Adelaide,"Lycett, Scott",18,10,3,8,0,0,34,6
Port Adelaide,"Marshall, Todd",14,10,3,4,3,0,2,2
Port Adelaide,"Motlop, Steven",13,4,1,9,1,0,0,7
Port Adelaide,"Powell-Pepper, Sam",17,8,1,9,0,0,0,7
Port Adelaide,"Rozee, Connor",23,15,4,8,1,1,0,6
Port Adelaide,"Wines, Ollie",24,13,2,11,0,1,0,1
Port Adelaide,"Aliir, Aliir",14,10,4,4,0,0,0,0
Port Adelaide,"Amon, Karl",21,14,6,7,1,0,0,4
Port Adelaide,"Bergman, Miles",11,6,1,5,0,0,0,4
Port Adelaide,"Boak, Travis",30,15,3,15,0,0,0,7
Port Adelaide,"Bonner, Riley",18,13,3,5,0,0,0,1
Port Adelaide,"Burton, Ryan",10,8,1,2,0,0,0,3
Port Adelaide,"Byrne-Jones, Darcy",24,14,3,10,0,0,0,2
Port Adelaide,"Clurey, Tom",1,0,0,1,0,0,0,0
Port Adelaide,"Dixon, Charlie",12,7,2,5,2,0,14,2
Port Adelaide,"Drew, Willem",14,4,1,10,1,0,0,7
Port Adelaide,"Fantasia, Orazio",6,6,3,0,2,1,0,2
Port Adelaide,"Farrell, Kane",8,4,2,4,0,0,0,3
Port Adelaide,"Frederick, Martin",2,0,0,2,0,0,0,1
Port Adelaide,"Georgiades, Mitch",13,9,8,4,2,1,0,1
Port Adelaide,"Gray, Robbie",13,7,1,6,1,0,0,7
Port Adelaide,"Hartlett, Hamish",15,9,0,6,1,0,0,4
Port Adelaide,"Jonas, Tom",12,8,4,4,0,0,0,1
Port Adelaide,"Ladhams, Peter",18,14,3,4,0,0,37,3
Port Adelaide,"Marshall, Todd",13,10,5,3,0,1,1,0
Port Adelaide,"Motlop, Steven",17,11,1,6,0,1,0,3
Port Adelaide,"Powell-Pepper, Sam",20,12,3,8,1,1,0,2
Port Adelaide,"Rozee, Connor",13,8,5,5,0,0,0,3
Port Adelaide,"Wines, Ollie",32,10,5,22,1,0,0,8
Port Adelaide,"Aliir, Aliir",14,11,7,3,0,0,0,4
Port Adelaide,"Amon, Karl",15,5,2,10,0,0,0,0
Port Adelaide,"Bergman, Miles",0,0,0,0,0,0,0,0
Port Adelaide,"Boak, Travis",27,16,3,11,0,1,0,3
Port Adelaide,"Bonner, Riley",15,11,4,4,0,0,0,0
Port Adelaide,"Burton, Ryan",15,12,4,3,0,0,0,4
Port Adelaide,"Byrne-Jones, Darcy",18,13,5,5,0,0,0,4
Port Adelaide,"Dixon, Charlie",13,7,4,6,1,2,1,1
Port Adelaide,"Drew, Willem",15,9,5,6,0,0,0,6
Port Adelaide,"Farrell, Kane",23,14,6,9,0,1,0,2
Port Adelaide,"Georgiades, Mitch",10,6,5,4,0,1,0,2
Port Adelaide,"Gray, Robbie",18,8,6,10,3,0,0,4
Port Adelaide,"Hartlett, Hamish",9,7,3,2,0,0,0,1
Port Adelaide,"Houston, Dan",12,6,1,6,1,1,0,2
Port Adelaide,"Jonas, Tom",15,13,7,2,0,0,0,1
Port Adelaide,"Jones, Lachie",12,6,3,6,0,0,0,1
Port Adelaide,"Ladhams, Peter",21,12,9,9,0,0,10,1
Port Adelaide,"Marshall, Todd",7,7,4,0,1,0,0,2
Port Adelaide,"McKenzie, Trent",16,14,6,2,0,0,0,1
Port Adelaide,"Motlop, Steven",15,7,2,8,0,0,0,0
Port Adelaide,"Powell-Pepper, Sam",18,11,7,7,1,1,0,8
Port Adelaide,"Rozee, Connor",8,4,1,4,0,0,0,6
Port Adelaide,"Wines, Ollie",27,17,5,10,1,1,0,3
Port Adelaide,"Aliir, Aliir",16,14,6,2,0,0,0,0
Port Adelaide,"Amon, Karl",27,17,5,10,1,0,0,6
Port Adelaide,"Bergman, Miles",2,2,1,0,1,0,0,0
Port Adelaide,"Boak, Travis",31,15,3,16,0,0,0,1
Port Adelaide,"Bonner, Riley",20,14,9,6,0,0,0,2
Port Adelaide,"Burton, Ryan",11,10,4,1,0,0,0,2
Port Adelaide,"Byrne-Jones, Darcy",18,16,10,2,0,0,0,4
Port Adelaide,"Dixon, Charlie",18,10,5,8,3,1,5,4
Port Adelaide,"Drew, Willem",12,3,2,9,0,0,0,6
Port Adelaide,"Fantasia, Orazio",11,6,3,5,2,2,0,1
Port Adelaide,"Farrell, Kane",17,10,2,7,1,0,0,2
Port Adelaide,"Georgiades, Mitch",11,7,4,4,1,1,0,1
Port Adelaide,"Gray, Robbie",23,12,4,11,2,1,0,3
Port Adelaide,"Houston, Dan",29,15,8,14,0,0,0,0
Port Adelaide,"Jonas, Tom",18,14,11,4,0,0,0,1
Port Adelaide,"Jones, Lachie",18,10,6,8,0,0,0,4
Port Adelaide,"Ladhams, Peter",20,11,4,9,2,0,21,3
Port Adelaide,"Marshall, Todd",11,9,7,2,2,1,0,1
Port Adelaide,"McKenzie, Trent",17,17,10,0,0,0,0,2
Port Adelaide,"Motlop, Steven",24,8,4,16,0,0,0,2
Port Adelaide,"Powell-Pepper, Sam",20,10,3,10,3,1,0,5
Port Adelaide,"Rozee, Connor",15,11,6,4,0,0,0,1
Port Adelaide,"Wines, Ollie",35,11,3,24,0,0,0,7
Port Adelaide,"Aliir, Aliir",16,13,6,3,0,0,0,2
Port Adelaide,"Amon, Karl",21,13,5,8,0,2,0,5
Port Adelaide,"Bergman, Miles",16,9,2,7,0,0,0,4
Port Adelaide,"Boak, Travis",27,9,1,18,0,0,0,8
Port Adelaide,"Bonner, Riley",13,9,4,4,0,0,0,0
Port Adelaide,"Burton, Ryan",18,15,8,3,0,0,0,2
Port Adelaide,"Byrne-Jones, Darcy",15,9,2,6,0,0,0,4
Port Adelaide,"Dixon, Charlie",12,7,6,5,4,1,7,1
Port Adelaide,"Drew, Willem",16,8,2,8,0,0,0,10
Port Adelaide,"Farrell, Kane",5,4,2,1,1,0,0,0
Port Adelaide,"Georgiades, Mitch",8,6,6,2,1,1,0,2
Port Adelaide,"Gray, Robbie",20,10,5,10,0,0,0,5
Port Adelaide,"Houston, Dan",20,17,11,3,0,0,0,2
Port Adelaide,"Jonas, Tom",8,4,2,4,0,0,0,1
Port Adelaide,"Jones, Lachie",8,5,3,3,1,0,0,3
Port Adelaide,"Ladhams, Peter",17,5,3,12,0,0,29,1
Port Adelaide,"Marshall, Todd",0,0,0,0,0,0,0,0
Port Adelaide,"McKenzie, Trent",18,15,5,3,0,0,0,2
Port Adelaide,"Motlop, Steven",9,8,2,1,0,0,0,0
Port Adelaide,"Powell-Pepper, Sam",8,4,2,4,1,0,0,2
Port Adelaide,"Rozee, Connor",16,12,3,4,5,1,0,3
Port Adelaide,"Wines, Ollie",29,15,5,14,1,0,0,6
Port Adelaide,"Woodcock, Boyd",6,4,0,2,0,0,0,2
Port Adelaide,"Aliir, Aliir",20,12,6,8,0,0,0,2
Port Adelaide,"Amon, Karl",26,15,7,11,1,1,0,4
Port Adelaide,"Bergman, Miles",23,11,7,12,0,0,0,6
Port Adelaide,"Boak, Travis",25,13,5,12,0,0,0,7
Port Adelaide,"Burton, Ryan",11,9,3,2,0,0,0,2
Port Adelaide,"Byrne-Jones, Darcy",25,17,6,8,0,1,0,3
Port Adelaide,"Dixon, Charlie",16,7,5,9,2,1,3,5
Port Adelaide,"Drew, Willem",27,12,3,15,0,0,0,7
Port Adelaide,"Farrell, Kane",16,5,2,11,0,0,0,5
Port Adelaide,"Georgiades, Mitch",10,7,2,3,2,2,0,1
Port Adelaide,"Gray, Robbie",9,5,3,4,0,0,0,1
Port Adelaide,"Hartlett, Hamish",12,8,5,4,0,0,0,0
Port Adelaide,"Houston, Dan",27,15,5,12,0,0,0,1
Port Adelaide,"Jonas, Tom",18,12,6,6,0,0,0,2
Port Adelaide,"Jones, Lachie",9,3,2,6,0,0,0,1
Port Adelaide,"Ladhams, Peter",15,5,3,10,0,1,14,6
Port Adelaide,"Lienert, Jarrod",20,14,4,6,1,0,0,0
Port Adelaide,"Lycett, Scott",17,7,4,10,1,0,22,1
Port Adelaide,"McKenzie, Trent",16,12,8,4,0,0,0,1
Port Adelaide,"Motlop, Steven",26,16,9,10,2,0,0,2
Port Adelaide,"Powell-Pepper, Sam",15,9,6,6,0,1,0,3
Port Adelaide,"Rozee, Connor",19,9,3,10,3,1,0,4
Port Adelaide,"Wines, Ollie",43,24,8,19,0,0,0,6
Port Adelaide,"Aliir, Aliir",10,6,1,4,0,0,0,0
Port Adelaide,"Amon, Karl",19,15,0,4,0,2,0,5
Port Adelaide,"Bergman, Miles",17,8,7,9,1,1,0,1
Port Adelaide,"Boak, Travis",29,17,3,12,1,0,0,8
Port Adelaide,"Burton, Ryan",14,12,4,2,0,0,0,3
Port Adelaide,"Byrne-Jones, Darcy",20,14,2,6,0,0,0,1
Port Adelaide,"Dixon, Charlie",19,10,3,9,2,0,6,0
Port Adelaide,"Drew, Willem",22,10,0,12,0,0,0,8
Port Adelaide,"Farrell, Kane",13,6,1,7,1,0,0,4
Port Adelaide,"Frederick, Martin",12,8,2,4,0,0,0,2
Port Adelaide,"Georgiades, Mitch",11,5,2,6,0,1,0,1
Port Adelaide,"Houston, Dan",18,12,6,6,1,0,0,7
Port Adelaide,"Jonas, Tom",11,10,4,1,0,0,0,1
Port Adelaide,"Lienert, Jarrod",19,12,3,7,0,0,0,1
Port Adelaide,"Lycett, Scott",14,10,2,4,1,0,38,5
Port Adelaide,"Marshall, Todd",9,4,3,5,2,0,0,3
Port Adelaide,"Mayes, Sam",4,3,1,1,1,1,0,4
Port Adelaide,"McKenzie, Trent",13,11,3,2,0,0,0,2
Port Adelaide,"Motlop, Steven",10,5,2,5,0,1,0,3
Port Adelaide,"Powell-Pepper, Sam",12,7,1,5,1,1,0,5
Port Adelaide,"Rozee, Connor",13,7,0,6,1,0,0,4
Port Adelaide,"Williams, Dylan",7,6,1,1,0,0,0,3
Port Adelaide,"Wines, Ollie",29,16,3,13,0,1,0,3
Port Adelaide,"Aliir, Aliir",18,13,7,5,0,0,0,0
Port Adelaide,"Amon, Karl",26,17,9,9,0,0,0,3
Port Adelaide,"Bergman, Miles",13,8,2,5,2,0,0,1
Port Adelaide,"Boak, Travis",27,15,2,12,0,0,0,7
Port Adelaide,"Bonner, Riley",17,11,2,6,0,1,0,2
Port Adelaide,"Burton, Ryan",19,14,4,5,0,0,0,3
Port Adelaide,"Byrne-Jones, Darcy",29,15,6,14,0,0,0,3
Port Adelaide,"Dixon, Charlie",14,10,2,4,4,2,5,4
Port Adelaide,"Drew, Willem",18,7,2,11,0,0,0,6
Port Adelaide,"Farrell, Kane",1,1,0,0,0,0,0,0
Port Adelaide,"Frederick, Martin",8,4,1,4,1,0,0,0
Port Adelaide,"Georgiades, Mitch",9,3,1,6,1,0,0,1
Port Adelaide,"Houston, Dan",15,11,4,4,0,0,0,5
Port Adelaide,"Jonas, Tom",17,13,11,4,0,0,0,0
Port Adelaide,"Lienert, Jarrod",17,16,7,1,0,0,0,3
Port Adelaide,"Lycett, Scott",8,5,2,3,0,1,39,8
Port Adelaide,"Marshall, Todd",12,7,3,5,2,1,0,1
Port Adelaide,"Mayes, Sam",15,10,2,5,2,1,0,3
Port Adelaide,"McKenzie, Trent",18,14,7,4,0,0,0,2
Port Adelaide,"Motlop, Steven",21,12,5,9,0,0,0,2
Port Adelaide,"Powell-Pepper, Sam",10,5,0,5,0,0,0,5
Port Adelaide,"Rozee, Connor",14,9,0,5,1,2,0,3
Port Adelaide,"Wines, Ollie",43,26,3,17,0,1,0,7
Port Adelaide,"Aliir, Aliir",10,7,5,3,0,0,5,1
Port Adelaide,"Amon, Karl",28,22,8,6,1,0,0,5
Port Adelaide,"Bergman, Miles",15,9,8,6,0,0,0,0
Port Adelaide,"Boak, Travis",25,10,4,15,0,0,0,6
Port Adelaide,"Burton, Ryan",14,11,9,3,0,0,0,1
Port Adelaide,"Butters, Zak",10,6,4,4,0,0,0,3
Port Adelaide,"Byrne-Jones, Darcy",13,5,1,8,0,0,0,2
Port Adelaide,"Clurey, Tom",10,7,3,3,0,0,0,4
Port Adelaide,"Dixon, Charlie",14,9,6,5,2,0,4,1
Port Adelaide,"Drew, Willem",21,11,4,10,0,0,0,6
Port Adelaide,"Frederick, Martin",2,1,0,1,0,0,0,0
Port Adelaide,"Georgiades, Mitch",7,7,5,0,2,1,0,2
Port Adelaide,"Houston, Dan",14,10,5,4,0,0,0,1
Port Adelaide,"Jonas, Tom",12,10,3,2,0,0,0,1
Port Adelaide,"Lienert, Jarrod",15,12,3,3,0,0,0,2
Port Adelaide,"Lycett, Scott",15,5,1,10,0,0,21,7
Port Adelaide,"Marshall, Todd",7,6,2,1,0,0,0,0
Port Adelaide,"Mayes, Sam",9,3,1,6,0,0,0,5
Port Adelaide,"McKenzie, Trent",14,13,6,1,1,0,0,1
Port Adelaide,"Motlop, Steven",15,7,1,8,0,1,0,6
Port Adelaide,"Powell-Pepper, Sam",18,10,3,8,0,1,0,3
Port Adelaide,"Rozee, Connor",6,3,2,3,1,1,0,2
Port Adelaide,"Wines, Ollie",33,14,3,19,1,1,0,2
Port Adelaide,"Aliir, Aliir",17,11,8,6,0,0,0,2
Port Adelaide,"Amon, Karl",26,14,7,12,2,1,0,10
Port Adelaide,"Bergman, Miles",11,5,2,6,0,0,0,3
Port Adelaide,"Boak, Travis",24,7,2,17,0,0,0,3
Port Adelaide,"Bonner, Riley",24,17,6,7,0,0,0,1
Port Adelaide,"Burton, Ryan",25,20,9,5,0,0,0,1
Port Adelaide,"Byrne-Jones, Darcy",18,7,2,11,0,1,0,5
Port Adelaide,"Dixon, Charlie",13,7,2,6,1,1,1,1
Port Adelaide,"Drew, Willem",8,3,1,5,0,0,0,9
Port Adelaide,"Frederick, Martin",6,1,0,5,0,0,0,2
Port Adelaide,"Georgiades, Mitch",10,5,5,5,4,0,0,4
Port Adelaide,"Houston, Dan",18,10,3,8,0,1,0,0
Port Adelaide,"Jonas, Tom",15,12,5,3,0,0,0,1
Port Adelaide,"Ladhams, Peter",12,7,1,5,0,0,10,5
Port Adelaide,"Lienert, Jarrod",13,8,4,5,0,0,0,2
Port Adelaide,"Lycett, Scott",17,6,3,11,0,1,23,9
Port Adelaide,"Marshall, Todd",10,7,3,3,0,1,0,1
Port Adelaide,"Mayes, Sam",6,3,3,3,1,1,0,2
Port Adelaide,"McEntee, Jed",1,0,0,1,0,0,0,0
Port Adelaide,"McKenzie, Trent",22,20,9,2,0,0,0,1
Port Adelaide,"Powell-Pepper, Sam",15,8,1,7,0,1,0,6
Port Adelaide,"Wines, Ollie",36,22,5,14,1,1,0,5
Port Adelaide,"Woodcock, Boyd",12,5,3,7,1,2,0,2
Port Adelaide,"Aliir, Aliir",7,5,5,2,0,0,0,1
Port Adelaide,"Amon, Karl",24,9,3,15,1,1,0,6
Port Adelaide,"Bergman, Miles",8,5,4,3,0,0,0,3
Port Adelaide,"Boak, Travis",30,15,1,15,0,1,0,1
Port Adelaide,"Bonner, Riley",18,12,3,6,0,0,0,3
Port Adelaide,"Burton, Ryan",16,11,5,5,0,0,0,4
Port Adelaide,"Butters, Zak",15,4,3,11,0,1,0,2
Port Adelaide,"Byrne-Jones, Darcy",20,11,1,9,0,0,0,4
Port Adelaide,"Dixon, Charlie",11,7,4,4,4,3,1,2
Port Adelaide,"Drew, Willem",32,9,1,23,0,0,0,5
Port Adelaide,"Duursma, Xavier",18,6,3,12,0,0,0,3
Port Adelaide,"Georgiades, Mitch",7,3,3,4,0,0,0,3
Port Adelaide,"Houston, Dan",21,16,5,5,1,1,0,0
Port Adelaide,"Jonas, Tom",14,7,4,7,0,0,0,1
Port Adelaide,"Ladhams, Peter",17,13,5,4,2,0,6,1
Port Adelaide,"Lycett, Scott",14,7,3,7,0,0,27,4
Port Adelaide,"Marshall, Todd",15,12,4,3,3,0,0,1
Port Adelaide,"Mayes, Sam",0,0,0,0,0,0,0,0
Port Adelaide,"McKenzie, Trent",7,7,1,0,0,0,0,0
Port Adelaide,"Powell-Pepper, Sam",15,7,2,8,0,0,0,5
Port Adelaide,"Rozee, Connor",16,5,7,11,1,1,0,2
Port Adelaide,"Wines, Ollie",30,17,3,13,1,1,0,2
Port Adelaide,"Woodcock, Boyd",9,6,3,3,1,0,0,2
Port Adelaide,"Aliir, Aliir",11,6,2,5,0,1,0,0
Port Adelaide,"Amon, Karl",31,18,6,13,1,0,0,5
Port Adelaide,"Bergman, Miles",21,10,5,11,0,1,0,1
Port Adelaide,"Boak, Travis",24,11,3,13,1,0,0,6
Port Adelaide,"Bonner, Riley",25,18,5,7,0,0,0,0
Port Adelaide,"Burton, Ryan",22,18,9,4,0,1,0,5
Port Adelaide,"Butters, Zak",22,11,6,11,1,0,0,3
Port Adelaide,"Byrne-Jones, Darcy",22,13,4,9,0,0,0,1
Port Adelaide,"Dixon, Charlie",12,10,5,2,4,2,4,2
Port Adelaide,"Drew, Willem",17,8,3,9,0,0,0,10
Port Adelaide,"Duursma, Xavier",16,9,3,7,1,0,0,3
Port Adelaide,"Fantasia, Orazio",11,7,3,4,1,1,0,3
Port Adelaide,"Georgiades, Mitch",7,6,4,1,2,0,0,3
Port Adelaide,"Houston, Dan",18,10,3,8,0,0,0,0
Port Adelaide,"Jonas, Tom",13,10,4,3,0,0,0,3
Port Adelaide,"Ladhams, Peter",13,9,3,4,3,1,12,1
Port Adelaide,"Lycett, Scott",14,9,3,5,0,0,20,4
Port Adelaide,"Marshall, Todd",16,14,9,2,1,1,0,3
Port Adelaide,"McKenzie, Trent",15,13,8,2,0,0,0,1
Port Adelaide,"Powell-Pepper, Sam",8,5,4,3,0,0,0,1
Port Adelaide,"Rozee, Connor",18,7,5,11,0,1,0,4
Port Adelaide,"Wines, Ollie",28,14,6,14,0,0,0,3
Port Adelaide,"Woodcock, Boyd",0,0,0,0,0,0,0,0
Port Adelaide,"Aliir, Aliir",21,17,11,4,0,0,0,1
Port Adelaide,"Amon, Karl",14,11,4,3,0,0,0,7
Port Adelaide,"Bergman, Miles",23,13,2,10,0,0,0,4
Port Adelaide,"Boak, Travis",27,9,2,18,0,0,0,8
Port Adelaide,"Bonner, Riley",21,17,2,4,0,0,0,0
Port Adelaide,"Burton, Ryan",26,18,10,8,0,0,0,3
Port Adelaide,"Butters, Zak",19,16,4,3,2,0,0,4
Port Adelaide,"Byrne-Jones, Darcy",18,9,3,9,0,0,0,1
Port Adelaide,"Dixon, Charlie",7,4,2,3,1,0,5,3
Port Adelaide,"Drew, Willem",23,11,3,12,0,0,0,10
Port Adelaide,"Duursma, Xavier",19,12,5,7,0,1,0,3
Port Adelaide,"Fantasia, Orazio",12,6,3,6,1,1,0,1
Port Adelaide,"Georgiades, Mitch",12,9,7,3,1,1,0,3
Port Adelaide,"Gray, Robbie",13,7,4,6,0,1,0,3
Port Adelaide,"Houston, Dan",24,17,4,7,0,0,0,7
Port Adelaide,"Jonas, Tom",10,7,5,3,0,0,0,1
Port Adelaide,"Ladhams, Peter",12,9,5,3,0,2,4,3
Port Adelaide,"Lycett, Scott",15,7,1,8,0,0,28,4
Port Adelaide,"Marshall, Todd",0,0,0,0,0,0,0,0
Port Adelaide,"McKenzie, Trent",18,13,5,5,0,0,0,3
Port Adelaide,"Powell-Pepper, Sam",14,6,3,8,1,0,0,5
Port Adelaide,"Rozee, Connor",16,7,0,9,0,1,0,2
Port Adelaide,"Wines, Ollie",26,15,5,11,1,3,0,1
Port Adelaide,"Aliir, Aliir",19,14,8,5,0,0,0,4
Port Adelaide,"Amon, Karl",30,21,4,9,0,1,0,3
Port Adelaide,"Bergman, Miles",20,14,7,6,2,1,0,1
Port Adelaide,"Boak, Travis",31,13,3,18,1,3,0,5
Port Adelaide,"Bonner, Riley",18,14,3,4,0,0,0,2
Port Adelaide,"Burton, Ryan",19,14,5,5,0,0,0,1
Port Adelaide,"Butters, Zak",25,11,6,14,0,0,0,3
Port Adelaide,"Byrne-Jones, Darcy",27,16,6,11,0,0,0,2
Port Adelaide,"Clurey, Tom",14,6,4,8,0,0,0,1
Port Adelaide,"Dixon, Charlie",9,8,5,1,4,0,3,1
Port Adelaide,"Drew, Willem",16,4,2,12,0,0,0,6
Port Adelaide,"Duursma, Xavier",16,9,1,7,0,2,0,2
Port Adelaide,"Fantasia, Orazio",14,7,2,7,3,0,0,1
Port Adelaide,"Georgiades, Mitch",11,5,5,6,2,0,0,0
Port Adelaide,"Gray, Robbie",19,9,4,10,2,0,0,3
Port Adelaide,"Houston, Dan",24,17,5,7,1,0,0,1
Port Adelaide,"Jonas, Tom",15,9,2,6,0,0,0,2
Port Adelaide,"Ladhams, Peter",17,9,6,8,1,1,23,4
Port Adelaide,"Lycett, Scott",10,5,3,5,1,2,15,1
Port Adelaide,"Marshall, Todd",12,8,3,4,2,0,1,1
Port Adelaide,"Mayes, Sam",3,2,2,1,1,0,0,1
Port Adelaide,"Rozee, Connor",23,11,4,12,1,1,0,2
Port Adelaide,"Wines, Ollie",31,13,4,18,0,1,0,7
Port Adelaide,"Aliir, Aliir",12,11,8,1,0,0,0,4
Port Adelaide,"Amon, Karl",19,16,6,3,0,2,0,4
Port Adelaide,"Bergman, Miles",14,10,7,4,0,0,0,1
Port Adelaide,"Boak, Travis",31,18,5,13,2,3,0,4
Port Adelaide,"Bonner, Riley",24,17,11,7,0,0,0,2
Port Adelaide,"Burton, Ryan",18,13,7,5,0,0,0,4
Port Adelaide,"Butters, Zak",18,9,4,9,0,0,0,1
Port Adelaide,"Byrne-Jones, Darcy",16,13,4,3,0,0,0,0
Port Adelaide,"Dixon, Charlie",9,5,2,4,0,0,6,0
Port Adelaide,"Drew, Willem",14,5,1,9,0,0,0,6
Port Adelaide,"Duursma, Xavier",18,10,5,8,0,0,0,2
Port Adelaide,"Georgiades, Mitch",7,5,2,2,0,1,0,4
Port Adelaide,"Gray, Robbie",25,13,3,12,2,0,0,3
Port Adelaide,"Houston, Dan",20,10,5,10,0,0,0,2
Port Adelaide,"Jonas, Tom",16,13,9,3,0,0,0,1
Port Adelaide,"Ladhams, Peter",8,4,4,4,2,0,5,1
Port Adelaide,"Lycett, Scott",22,8,2,14,0,1,40,1
Port Adelaide,"Marshall, Todd",12,9,8,3,0,2,0,2
Port Adelaide,"Mayes, Sam",4,1,2,3,0,0,0,2
Port Adelaide,"McKenzie, Trent",19,16,9,3,0,0,0,5
Port Adelaide,"Motlop, Steven",13,7,2,6,0,1,0,4
Port Adelaide,"Rozee, Connor",21,12,6,9,2,1,0,2
Port Adelaide,"Wines, Ollie",34,14,2,20,1,0,0,9
Port Adelaide,"Aliir, Aliir",14,13,7,1,0,0,0,1
Port Adelaide,"Amon, Karl",25,15,5,10,0,0,0,4
Port Adelaide,"Bergman, Miles",18,14,7,4,0,1,0,3
Port Adelaide,"Boak, Travis",32,17,5,15,0,3,0,7
Port Adelaide,"Bonner, Riley",20,17,3,3,0,0,0,1
Port Adelaide,"Burton, Ryan",21,19,6,2,0,0,0,2
Port Adelaide,"Butters, Zak",11,7,4,4,1,0,0,6
Port Adelaide,"Byrne-Jones, Darcy",21,17,8,4,0,0,0,1
Port Adelaide,"Dixon, Charlie",10,6,5,4,0,1,4,2
Port Adelaide,"Drew, Willem",12,7,3,5,0,1,0,11
Port Adelaide,"Duursma, Xavier",24,11,7,13,0,0,0,4
Port Adelaide,"Fantasia, Orazio",9,7,1,2,4,1,0,2
Port Adelaide,"Gray, Robbie",14,7,3,7,1,2,0,1
Port Adelaide,"Houston, Dan",20,9,8,11,0,0,0,2
Port Adelaide,"Jonas, Tom",18,14,9,4,0,0,0,2
Port Adelaide,"Ladhams, Peter",14,7,4,7,1,0,11,2
Port Adelaide,"Lycett, Scott",8,3,1,5,0,0,16,2
Port Adelaide,"Marshall, Todd",9,4,2,5,1,2,0,3
Port Adelaide,"McKenzie, Trent",8,7,2,1,0,0,0,1
Port Adelaide,"Motlop, Steven",15,9,4,6,2,0,0,2
Port Adelaide,"Powell-Pepper, Sam",6,4,2,2,2,1,0,0
Port Adelaide,"Rozee, Connor",17,7,7,10,0,0,0,4
Port Adelaide,"Wines, Ollie",33,10,4,23,0,1,0,2
Port Adelaide,"Aliir, Aliir",15,11,7,4,0,0,0,1
Port Adelaide,"Amon, Karl",21,12,5,9,0,0,0,7
Port Adelaide,"Bergman, Miles",18,9,5,9,0,1,0,0
Port Adelaide,"Boak, Travis",24,10,4,14,0,2,0,3
Port Adelaide,"Bonner, Riley",32,25,10,7,1,0,0,1
Port Adelaide,"Burton, Ryan",19,11,6,8,0,0,0,2
Port Adelaide,"Butters, Zak",18,11,3,7,0,0,0,2
Port Adelaide,"Byrne-Jones, Darcy",13,6,3,7,0,0,0,4
Port Adelaide,"Dixon, Charlie",11,9,4,2,2,1,5,4
Port Adelaide,"Drew, Willem",8,5,2,3,0,0,0,8
Port Adelaide,"Duursma, Xavier",16,5,3,11,0,0,0,3
Port Adelaide,"Fantasia, Orazio",6,6,2,0,0,1,0,2
Port Adelaide,"Gray, Robbie",17,9,3,8,0,1,0,6
Port Adelaide,"Houston, Dan",22,14,5,8,1,0,0,2
Port Adelaide,"Jonas, Tom",13,12,4,1,0,0,0,2
Port Adelaide,"Ladhams, Peter",9,5,0,4,0,0,18,1
Port Adelaide,"Lycett, Scott",14,2,2,12,0,0,26,9
Port Adelaide,"Marshall, Todd",13,9,3,4,1,1,0,1
Port Adelaide,"McKenzie, Trent",12,11,5,1,0,0,0,2
Port Adelaide,"Motlop, Steven",6,4,3,2,0,0,0,2
Port Adelaide,"Powell-Pepper, Sam",6,1,0,5,0,0,0,1
Port Adelaide,"Rozee, Connor",18,7,2,11,0,0,0,4
Port Adelaide,"Wines, Ollie",38,15,4,23,1,1,0,5
Richmond,"Aarts, Jake",12,7,2,5,2,0,0,2
Richmond,"Astbury, David",9,4,4,5,0,0,2,1
Richmond,"Baker, Liam",15,4,0,11,0,0,0,0
Richmond,"Balta, Noah",11,10,4,1,0,1,3,1
Richmond,"Bolton, Shai",25,13,2,12,1,1,0,1
Richmond,"Broad, Nathan",9,4,3,5,0,0,0,0
Richmond,"Caddy, Josh",17,12,4,5,1,1,0,2
Richmond,"Castagna, Jason",13,8,4,5,2,2,0,0
Richmond,"Edwards, Shane",27,11,2,16,0,0,0,3
Richmond,"Graham, Jack",33,22,5,11,0,1,0,3
Richmond,"Grimes, Dylan",10,4,2,6,0,0,0,2
Richmond,"Lambert, Kane",28,13,6,15,0,1,0,1
Richmond,"Lynch, Tom",11,6,4,5,1,1,1,0
Richmond,"Martin, Dustin",31,19,7,12,2,2,0,4
Richmond,"McIntosh, Kamdyn",13,8,3,5,0,0,0,1
Richmond,"Nankervis, Toby",12,4,0,8,0,0,27,1
Richmond,"Pickett, Marlion",13,7,5,6,0,0,0,3
Richmond,"Prestia, Dion",25,12,3,13,0,1,0,4
Richmond,"Riewoldt, Jack",10,9,4,1,4,2,0,5
Richmond,"Rioli, Daniel",10,6,4,4,2,1,0,1
Richmond,"Ross, Jack",8,6,2,2,0,0,0,4
Richmond,"Short, Jayden",23,21,5,2,0,0,0,3
Richmond,"Vlastuin, Nick",11,6,2,5,0,0,0,1
Richmond,"Aarts, Jake",5,3,2,2,1,0,0,0
Richmond,"Astbury, David",17,10,6,7,0,0,1,3
Richmond,"Baker, Liam",16,8,4,8,0,0,0,3
Richmond,"Balta, Noah",13,8,5,5,1,0,3,1
Richmond,"Bolton, Shai",20,9,4,11,0,1,0,1
Richmond,"Broad, Nathan",15,9,6,6,0,0,0,1
Richmond,"Caddy, Josh",19,10,7,9,0,1,0,3
Richmond,"Castagna, Jason",16,11,9,5,2,0,0,0
Richmond,"Cotchin, Trent",27,22,5,5,0,0,0,2
Richmond,"Edwards, Shane",25,16,7,9,0,0,0,2
Richmond,"Graham, Jack",15,7,1,8,0,1,0,4
Richmond,"Grimes, Dylan",10,5,8,5,0,0,0,2
Richmond,"Lambert, Kane",24,18,9,6,0,0,0,3
Richmond,"Lynch, Tom",9,8,7,1,2,1,0,0
Richmond,"Martin, Dustin",28,12,7,16,1,0,0,1
Richmond,"McIntosh, Kamdyn",13,11,5,2,0,1,0,1
Richmond,"Nankervis, Toby",12,8,2,4,0,1,20,0
Richmond,"Pickett, Marlion",14,9,5,5,0,0,0,4
Richmond,"Prestia, Dion",29,13,4,16,0,0,0,4
Richmond,"Riewoldt, Jack",9,7,4,2,4,1,0,1
Richmond,"Rioli, Daniel",7,4,3,3,0,4,0,4
Richmond,"Ross, Jack",0,0,0,0,0,0,0,0
Richmond,"Short, Jayden",22,14,6,8,0,0,0,2
Richmond,"Aarts, Jake",11,4,1,7,1,0,0,2
Richmond,"Astbury, David",15,9,5,6,0,0,3,1
Richmond,"Baker, Liam",23,11,1,12,0,0,0,4
Richmond,"Balta, Noah",14,3,3,11,0,0,1,3
Richmond,"Bolton, Shai",7,4,2,3,0,2,0,3
Richmond,"Broad, Nathan",18,15,6,3,0,0,0,1
Richmond,"Caddy, Josh",22,13,6,9,0,2,0,2
Richmond,"Castagna, Jason",17,10,5,7,2,1,0,1
Richmond,"Cotchin, Trent",17,9,3,8,0,0,0,3
Richmond,"Edwards, Shane",16,9,2,7,1,1,0,3
Richmond,"Eggmolesse-Smith, Derek",9,6,1,3,0,0,0,2
Richmond,"Graham, Jack",16,6,1,10,0,0,0,5
Richmond,"Grimes, Dylan",12,6,5,6,0,0,0,3
Richmond,"Lambert, Kane",22,10,6,12,0,1,0,4
Richmond,"Lynch, Tom",12,8,8,4,3,3,0,3
Richmond,"Martin, Dustin",20,10,1,10,0,0,0,1
Richmond,"McIntosh, Kamdyn",13,9,4,4,0,0,0,0
Richmond,"Nankervis, Toby",15,5,4,10,0,1,16,2
Richmond,"Pickett, Marlion",16,7,3,9,0,0,0,5
Richmond,"Prestia, Dion",3,1,0,2,0,0,0,1
Richmond,"Riewoldt, Jack",10,8,5,2,1,1,0,1
Richmond,"Rioli, Daniel",9,5,2,4,2,0,0,3
Richmond,"Short, Jayden",23,20,5,3,0,0,0,2
Richmond,"Aarts, Jake",7,4,2,3,1,1,0,0
Richmond,"Astbury, David",14,6,4,8,0,0,3,2
Richmond,"Baker, Liam",22,5,3,17,0,0,0,1
Richmond,"Balta, Noah",18,14,2,4,0,0,0,2
Richmond,"Bolton, Shai",22,12,4,10,1,0,0,4
Richmond,"Broad, Nathan",18,13,4,5,0,0,0,2
Richmond,"Caddy, Josh",0,0,0,0,0,0,0,0
Richmond,"Castagna, Jason",8,2,1,6,1,0,0,3
Richmond,"Cotchin, Trent",22,10,3,12,0,0,0,1
Richmond,"Edwards, Shane",15,13,2,2,0,0,0,6
Richmond,"Graham, Jack",15,9,1,6,0,1,0,4
Richmond,"Grimes, Dylan",12,6,3,6,0,0,0,2
Richmond,"Houli, Bachar",26,15,11,11,0,0,0,3
Richmond,"Lambert, Kane",24,11,3,13,2,1,0,4
Richmond,"Lynch, Tom",8,6,2,2,1,3,5,0
Richmond,"Mansell, Rhyan",9,6,3,3,0,0,0,2
Richmond,"Martin, Dustin",23,10,4,13,1,0,0,3
Richmond,"Martyn, Will",12,4,1,8,0,0,0,1
Richmond,"Nankervis, Toby",22,11,6,11,0,0,19,3
Richmond,"Pickett, Marlion",18,8,5,10,0,0,0,3
Richmond,"Riewoldt, Jack",10,8,4,2,3,0,0,0
Richmond,"Ross, Jack",10,3,1,7,0,0,0,4
Richmond,"Short, Jayden",31,25,4,6,1,0,0,2
Richmond,"Aarts, Jake",16,10,1,6,1,2,0,3
Richmond,"Astbury, David",12,5,3,7,0,0,0,0
Richmond,"Baker, Liam",20,10,8,10,0,1,0,2
Richmond,"Balta, Noah",11,6,3,5,0,0,0,2
Richmond,"Bolton, Shai",29,15,5,14,1,0,0,3
Richmond,"Broad, Nathan",12,9,6,3,0,0,0,2
Richmond,"Castagna, Jason",16,8,4,8,2,2,0,2
Richmond,"Cotchin, Trent",21,9,2,12,0,0,0,2
Richmond,"Edwards, Shane",29,14,2,15,1,1,0,3
Richmond,"Graham, Jack",17,8,0,9,3,0,0,12
Richmond,"Grimes, Dylan",9,6,4,3,0,0,0,2
Richmond,"Houli, Bachar",16,7,3,9,0,0,0,4
Richmond,"Lambert, Kane",21,10,6,11,0,0,0,3
Richmond,"Lynch, Tom",9,5,4,4,3,1,3,1
Richmond,"Mansell, Rhyan",13,10,2,3,0,0,0,4
Richmond,"Martin, Dustin",34,15,0,19,1,0,0,2
Richmond,"McIntosh, Kamdyn",19,12,5,7,0,0,0,2
Richmond,"Nankervis, Toby",22,8,3,14,0,0,39,6
Richmond,"Pickett, Marlion",14,4,1,10,1,0,2,3
Richmond,"Riewoldt, Jack",17,12,8,5,5,3,0,2
Richmond,"Rioli, Daniel",12,6,2,6,2,0,0,5
Richmond,"Ross, Jack",0,0,0,0,0,0,0,0
Richmond,"Short, Jayden",20,15,5,5,0,0,0,1
Richmond,"Aarts, Jake",7,5,3,2,1,1,0,4
Richmond,"Astbury, David",12,8,2,4,0,0,0,2
Richmond,"Baker, Liam",27,16,7,11,0,1,0,3
Richmond,"Balta, Noah",6,6,1,0,0,0,2,2
Richmond,"Bolton, Shai",28,18,9,10,1,2,0,4
Richmond,"Broad, Nathan",14,8,2,6,0,0,0,2
Richmond,"Castagna, Jason",9,5,1,4,0,0,0,6
Richmond,"Cotchin, Trent",12,5,0,7,0,0,0,5
Richmond,"Edwards, Shane",24,12,3,12,2,1,0,2
Richmond,"Graham, Jack",17,7,0,10,0,0,0,11
Richmond,"Grimes, Dylan",13,6,5,7,0,0,0,2
Richmond,"Houli, Bachar",24,15,5,9,0,0,0,3
Richmond,"Lambert, Kane",15,7,1,8,0,0,0,1
Richmond,"Lynch, Tom",11,5,2,6,0,0,2,4
Richmond,"Mansell, Rhyan",10,7,1,3,0,0,0,3
Richmond,"Martin, Dustin",8,4,0,4,0,0,0,1
Richmond,"McIntosh, Kamdyn",20,10,1,10,0,0,0,4
Richmond,"Nankervis, Toby",22,12,2,10,0,1,15,4
Richmond,"Pickett, Marlion",21,8,2,13,0,1,1,5
Richmond,"Riewoldt, Jack",10,9,3,1,2,2,0,4
Richmond,"Rioli, Daniel",13,3,1,10,0,0,0,5
Richmond,"Ross, Jack",9,4,1,5,0,0,0,1
Richmond,"Short, Jayden",22,16,3,6,0,0,0,2
Richmond,"Aarts, Jake",15,10,7,5,1,1,0,5
Richmond,"Astbury, David",16,12,12,4,0,0,0,1
Richmond,"Baker, Liam",15,7,0,8,1,0,0,8
Richmond,"Balta, Noah",14,11,9,3,0,0,0,0
Richmond,"Bolton, Shai",22,12,7,10,3,1,0,2
Richmond,"Broad, Nathan",25,20,11,5,0,0,0,2
Richmond,"Castagna, Jason",9,3,2,6,0,0,0,1
Richmond,"Collier-Dawkins, Riley",14,4,3,10,0,0,0,5
Richmond,"Cotchin, Trent",24,13,4,11,0,0,0,2
Richmond,"Edwards, Shane",14,6,4,8,0,0,0,3
Richmond,"Graham, Jack",17,13,4,4,1,0,0,2
Richmond,"Grimes, Dylan",12,8,3,4,0,0,0,2
Richmond,"Houli, Bachar",31,21,10,10,1,0,0,1
Richmond,"Lynch, Tom",14,12,12,2,3,5,0,1
Richmond,"Mansell, Rhyan",9,8,5,1,0,0,0,2
Richmond,"McIntosh, Kamdyn",15,11,5,4,0,0,0,0
Richmond,"Naish, Patrick",1,1,0,0,0,0,0,1
Richmond,"Nankervis, Toby",20,12,3,8,0,0,18,4
Richmond,"Pickett, Marlion",19,9,6,10,0,0,3,4
Richmond,"Riewoldt, Jack",9,8,7,1,1,1,0,0
Richmond,"Rioli, Daniel",11,5,3,6,0,1,0,2
Richmond,"Ross, Jack",10,6,4,4,0,0,0,3
Richmond,"Short, Jayden",26,24,9,2,0,1,0,0
Richmond,"Aarts, Jake",11,8,4,3,3,0,0,2
Richmond,"Astbury, David",13,6,3,7,0,0,0,0
Richmond,"Baker, Liam",20,10,5,10,0,1,0,3
Richmond,"Balta, Noah",12,8,6,4,0,0,0,1
Richmond,"Bolton, Shai",21,11,2,10,3,1,0,2
Richmond,"Broad, Nathan",12,7,5,5,0,0,0,0
Richmond,"Castagna, Jason",7,2,1,5,0,0,0,3
Richmond,"Collier-Dawkins, Riley",14,6,2,8,0,0,0,6
Richmond,"Edwards, Shane",19,10,1,9,0,0,0,5
Richmond,"Graham, Jack",15,6,2,9,0,1,0,7
Richmond,"Houli, Bachar",20,7,4,13,0,0,0,4
Richmond,"Lynch, Tom",7,3,2,4,1,1,0,1
Richmond,"Mansell, Rhyan",10,7,1,3,0,0,0,4
Richmond,"Martin, Dustin",21,10,4,11,0,2,0,0
Richmond,"McIntosh, Kamdyn",14,11,5,3,0,0,0,4
Richmond,"Naish, Patrick",1,1,0,0,0,0,0,0
Richmond,"Nankervis, Toby",10,5,4,5,0,0,36,1
Richmond,"Pickett, Marlion",13,1,1,12,0,0,3,6
Richmond,"Riewoldt, Jack",4,2,1,2,1,0,0,2
Richmond,"Rioli, Daniel",12,6,2,6,1,0,0,3
Richmond,"Ross, Jack",18,7,6,11,0,0,0,1
Richmond,"Short, Jayden",22,17,5,5,0,0,0,3
Richmond,"Vlastuin, Nick",12,9,4,3,0,0,0,2
Richmond,"Aarts, Jake",13,8,0,5,2,0,0,2
Richmond,"Astbury, David",14,9,7,5,0,0,0,0
Richmond,"Baker, Liam",33,19,3,14,0,1,0,6
Richmond,"Balta, Noah",6,3,3,3,0,0,5,1
Richmond,"Broad, Nathan",19,11,6,8,0,0,0,2
Richmond,"Castagna, Jason",16,8,8,8,1,0,0,4
Richmond,"Collier-Dawkins, Riley",18,12,1,6,2,0,0,7
Richmond,"Graham, Jack",23,7,3,16,0,0,0,7
Richmond,"Grimes, Dylan",15,8,5,7,0,0,0,3
Richmond,"Houli, Bachar",21,8,5,13,0,0,0,5
Richmond,"Lynch, Tom",8,8,3,0,1,4,3,2
Richmond,"Mansell, Rhyan",7,3,2,4,0,0,0,1
Richmond,"Martin, Dustin",28,16,1,12,4,2,0,1
Richmond,"McIntosh, Kamdyn",14,9,6,5,0,0,0,2
Richmond,"Naish, Patrick",15,7,5,8,0,0,0,2
Richmond,"Nankervis, Toby",16,10,5,6,1,0,29,5
Richmond,"Pickett, Marlion",10,6,0,4,0,0,0,6
Richmond,"Ralphsmith, Hugo",10,5,0,5,0,1,0,2
Richmond,"Riewoldt, Jack",6,3,2,3,1,0,0,3
Richmond,"Rioli, Daniel",11,4,1,7,1,0,0,3
Richmond,"Ross, Jack",0,0,0,0,0,0,0,0
Richmond,"Short, Jayden",27,19,9,8,0,0,0,1
Richmond,"Vlastuin, Nick",14,10,7,4,0,0,0,4
Richmond,"Aarts, Jake",17,8,8,9,2,1,0,3
Richmond,"Astbury, David",12,6,5,6,0,0,6,1
Richmond,"Baker, Liam",24,11,1,13,0,0,0,6
Richmond,"Balta, Noah",17,13,7,4,0,0,0,1
Richmond,"Broad, Nathan",17,11,8,6,0,0,0,0
Richmond,"Castagna, Jason",11,8,6,3,0,1,0,4
Richmond,"Collier-Dawkins, Riley",18,5,4,13,0,0,0,3
Richmond,"Graham, Jack",12,5,0,7,0,0,0,9
Richmond,"Grimes, Dylan",10,5,2,5,0,0,0,1
Richmond,"Houli, Bachar",27,14,4,13,0,0,0,4
Richmond,"Lynch, Tom",13,9,8,4,3,3,1,1
Richmond,"Martin, Dustin",17,9,4,8,0,0,0,5
Richmond,"Martyn, Will",0,0,0,0,0,0,0,0
Richmond,"McIntosh, Kamdyn",19,15,5,4,0,0,0,5
Richmond,"Naish, Patrick",10,2,1,8,1,0,0,2
Richmond,"Nankervis, Toby",18,5,2,13,0,0,21,4
Richmond,"Pickett, Marlion",20,5,4,15,0,0,0,5
Richmond,"Ralphsmith, Hugo",8,4,0,4,0,0,0,1
Richmond,"Riewoldt, Jack",7,7,5,0,3,1,0,2
Richmond,"Rioli, Daniel",7,5,4,2,0,0,0,3
Richmond,"Ross, Jack",11,5,2,6,2,0,0,2
Richmond,"Short, Jayden",20,14,2,6,0,0,0,0
Richmond,"Vlastuin, Nick",14,10,3,4,0,0,0,1
Richmond,"Aarts, Jake",14,6,3,8,0,1,0,5
Richmond,"Baker, Liam",18,10,9,8,0,0,0,3
Richmond,"Balta, Noah",19,17,9,2,0,0,0,1
Richmond,"Bolton, Shai",23,16,8,7,1,2,0,4
Richmond,"Broad, Nathan",21,18,10,3,0,0,0,1
Richmond,"Caddy, Josh",24,19,12,5,0,0,0,1
Richmond,"Castagna, Jason",13,4,3,9,0,1,0,3
Richmond,"Chol, Mabior",7,6,2,1,2,1,9,3
Richmond,"Coleman-Jones, Callum",10,5,5,5,4,0,2,3
Richmond,"Collier-Dawkins, Riley",18,10,4,8,0,0,0,1
Richmond,"Cotchin, Trent",20,14,4,6,1,0,0,10
Richmond,"Graham, Jack",20,11,5,9,1,0,0,3
Richmond,"Grimes, Dylan",18,8,9,10,0,0,0,3
Richmond,"Houli, Bachar",21,11,10,10,0,0,0,2
Richmond,"Martin, Dustin",22,11,4,11,1,0,0,4
Richmond,"McIntosh, Kamdyn",15,9,6,6,0,0,0,5
Richmond,"Nankervis, Toby",17,5,3,12,0,1,21,5
Richmond,"Prestia, Dion",19,10,2,9,0,0,0,5
Richmond,"Ralphsmith, Hugo",7,5,2,2,2,0,0,0
Richmond,"Riewoldt, Jack",20,17,14,3,5,2,0,2
Richmond,"Rioli, Daniel",0,0,0,0,0,0,0,0
Richmond,"Short, Jayden",23,19,12,4,0,0,0,2
Richmond,"Vlastuin, Nick",19,16,10,3,0,0,0,2
Richmond,"Aarts, Jake",18,10,5,8,0,2,0,5
Richmond,"Baker, Liam",19,13,7,6,0,0,0,0
Richmond,"Balta, Noah",16,13,4,3,1,0,0,2
Richmond,"Bolton, Shai",21,11,5,10,3,0,0,1
Richmond,"Broad, Nathan",9,7,5,2,0,0,0,1
Richmond,"Caddy, Josh",15,8,5,7,1,0,0,1
Richmond,"Castagna, Jason",18,10,12,8,3,0,0,1
Richmond,"Chol, Mabior",19,13,6,6,0,1,19,2
Richmond,"Coleman-Jones, Callum",11,3,2,8,2,1,10,3
Richmond,"Collier-Dawkins, Riley",9,3,1,6,0,0,0,1
Richmond,"Cotchin, Trent",17,12,5,5,0,0,0,3
Richmond,"Edwards, Shane",19,9,5,10,0,0,0,0
Richmond,"Graham, Jack",22,12,5,10,2,0,0,5
Richmond,"Grimes, Dylan",14,10,9,4,0,0,0,0
Richmond,"Houli, Bachar",18,10,4,8,0,0,0,5
Richmond,"Martin, Dustin",27,16,4,11,3,0,0,3
Richmond,"McIntosh, Kamdyn",13,9,2,4,1,0,0,2
Richmond,"Pickett, Marlion",17,4,1,13,0,0,2,4
Richmond,"Prestia, Dion",26,12,6,14,0,1,0,3
Richmond,"Riewoldt, Jack",12,10,5,2,2,3,0,0
Richmond,"Rioli, Daniel",3,3,0,0,1,0,0,0
Richmond,"Short, Jayden",23,20,5,3,0,0,0,1
Richmond,"Vlastuin, Nick",14,12,9,2,0,0,0,3
Richmond,"Aarts, Jake",11,6,5,5,1,1,0,5
Richmond,"Baker, Liam",19,15,6,4,0,0,0,2
Richmond,"Balta, Noah",15,9,4,6,0,0,0,0
Richmond,"Bolton, Shai",23,13,3,10,1,1,0,4
Richmond,"Broad, Nathan",22,15,8,7,0,0,0,2
Richmond,"Caddy, Josh",16,6,2,10,0,1,0,2
Richmond,"Castagna, Jason",10,6,3,4,1,0,0,0
Richmond,"Chol, Mabior",7,4,2,3,0,0,14,7
Richmond,"Coleman-Jones, Callum",13,9,7,4,2,1,2,0
Richmond,"Cotchin, Trent",12,9,3,3,0,0,0,2
Richmond,"Edwards, Shane",19,7,3,12,0,0,0,3
Richmond,"Graham, Jack",17,5,3,12,1,0,0,5
Richmond,"Grimes, Dylan",13,7,6,6,0,0,0,4
Richmond,"Houli, Bachar",26,18,15,8,0,0,0,3
Richmond,"Lambert, Kane",27,13,1,14,2,1,0,3
Richmond,"Martin, Dustin",23,17,2,6,2,0,0,3
Richmond,"McIntosh, Kamdyn",17,13,5,4,0,2,0,3
Richmond,"Pickett, Marlion",17,7,4,10,0,0,2,2
Richmond,"Ralphsmith, Hugo",0,0,0,0,0,0,0,0
Richmond,"Riewoldt, Jack",14,8,4,6,2,2,0,1
Richmond,"Rioli, Daniel",14,4,3,10,0,0,0,1
Richmond,"Short, Jayden",26,24,15,2,0,0,0,0
Richmond,"Vlastuin, Nick",23,18,9,5,0,0,0,1
Richmond,"Aarts, Jake",12,4,0,8,0,1,0,1
Richmond,"Baker, Liam",22,14,4,8,0,0,0,3
Richmond,"Balta, Noah",11,8,5,3,0,0,0,1
Richmond,"Bolton, Shai",11,8,2,3,0,1,0,4
Richmond,"Broad, Nathan",18,12,9,6,0,0,0,1
Richmond,"Castagna, Jason",16,6,4,10,0,0,0,3
Richmond,"Chol, Mabior",11,5,2,6,0,0,12,3
Richmond,"Coleman-Jones, Callum",12,4,5,8,0,1,8,1
Richmond,"Cotchin, Trent",22,15,1,7,0,0,0,4
Richmond,"Edwards, Shane",17,8,4,9,1,0,0,1
Richmond,"Graham, Jack",23,8,2,15,0,1,0,7
Richmond,"Grimes, Dylan",15,11,8,4,0,0,0,3
Richmond,"Houli, Bachar",21,13,3,8,0,0,0,2
Richmond,"Lambert, Kane",21,13,4,8,0,0,0,3
Richmond,"Mansell, Rhyan",2,2,0,0,0,0,0,0
Richmond,"Martin, Dustin",22,15,4,7,1,1,0,3
Richmond,"McIntosh, Kamdyn",16,10,3,6,0,0,0,2
Richmond,"Pickett, Marlion",24,12,5,12,0,1,0,3
Richmond,"Prestia, Dion",16,10,0,6,0,0,0,7
Richmond,"Riewoldt, Jack",13,12,5,1,0,2,0,3
Richmond,"Ryan, Samson",0,0,0,0,0,0,1,0
Richmond,"Short, Jayden",22,16,5,6,0,1,0,6
Richmond,"Vlastuin, Nick",24,14,7,10,0,0,0,2
Richmond,"Aarts, Jake",13,6,2,7,0,0,0,3
Richmond,"Astbury, David",7,4,1,3,0,0,0,1
Richmond,"Baker, Liam",18,7,0,11,0,0,0,3
Richmond,"Bolton, Shai",19,9,2,10,1,0,0,1
Richmond,"Castagna, Jason",13,2,2,11,0,0,0,1
Richmond,"Chol, Mabior",14,7,5,7,0,1,25,2
Richmond,"Coleman-Jones, Callum",1,0,0,1,0,0,7,0
Richmond,"Collier-Dawkins, Riley",8,3,2,5,0,0,0,3
Richmond,"Cotchin, Trent",19,15,2,4,0,0,0,4
Richmond,"Dow, Thomson",5,2,0,3,0,0,0,0
Richmond,"Edwards, Shane",15,5,0,10,0,0,0,1
Richmond,"Graham, Jack",8,6,0,2,1,0,0,4
Richmond,"Grimes, Dylan",15,10,5,5,0,0,0,3
Richmond,"Houli, Bachar",24,20,3,4,0,0,0,4
Richmond,"Lynch, Tom",13,11,6,2,5,2,3,2
Richmond,"Martin, Dustin",23,11,1,12,1,0,0,2
Richmond,"McIntosh, Kamdyn",15,12,4,3,0,0,0,2
Richmond,"Naish, Patrick",12,10,1,2,1,0,0,3
Richmond,"Pickett, Marlion",16,4,3,12,0,0,2,3
Richmond,"Riewoldt, Jack",13,9,5,4,1,3,0,2
Richmond,"Ross, Jack",15,8,6,7,0,0,0,0
Richmond,"Short, Jayden",17,12,3,5,0,0,0,3
Richmond,"Vlastuin, Nick",17,14,4,3,0,0,0,1
Richmond,"Aarts, Jake",13,2,1,11,0,0,0,2
Richmond,"Astbury, David",17,11,4,6,0,0,0,1
Richmond,"Baker, Liam",19,10,3,9,2,0,0,3
Richmond,"Bolton, Shai",26,13,4,13,1,0,0,3
Richmond,"Castagna, Jason",8,5,3,3,1,1,0,2
Richmond,"Chol, Mabior",11,2,1,9,0,0,17,2
Richmond,"Collier-Dawkins, Riley",14,5,1,9,1,0,0,5
Richmond,"Cotchin, Trent",13,8,0,5,0,0,0,4
Richmond,"Dow, Thomson",10,5,4,5,0,0,0,0
Richmond,"Garthwaite, Ryan",9,5,2,4,0,0,0,2
Richmond,"Graham, Jack",23,9,3,14,0,0,0,3
Richmond,"Grimes, Dylan",15,7,7,8,0,0,0,2
Richmond,"Lynch, Tom",15,8,4,7,3,0,0,2
Richmond,"Mansell, Rhyan",15,8,2,7,0,0,0,3
Richmond,"Martin, Dustin",19,14,2,5,1,0,0,2
Richmond,"McIntosh, Kamdyn",23,16,5,7,0,1,0,3
Richmond,"Naish, Patrick",10,6,2,4,0,0,0,2
Richmond,"Pickett, Marlion",16,8,4,8,1,0,1,2
Richmond,"Riewoldt, Jack",8,7,4,1,1,0,0,2
Richmond,"Rioli, Daniel",15,5,3,10,0,0,0,1
Richmond,"Ross, Jack",0,0,0,0,0,0,0,0
Richmond,"Short, Jayden",31,22,2,9,0,0,0,4
Richmond,"Stack, Sydney",13,6,3,7,0,0,0,3
Richmond,"Aarts, Jake",7,7,3,0,0,0,0,2
Richmond,"Astbury, David",15,8,6,7,0,0,0,2
Richmond,"Baker, Liam",18,14,5,4,0,0,0,3
Richmond,"Bolton, Shai",22,9,5,13,1,1,0,4
Richmond,"Castagna, Jason",9,5,1,4,0,2,0,4
Richmond,"Chol, Mabior",10,8,4,2,4,0,12,1
Richmond,"Cotchin, Trent",22,11,4,11,0,0,0,5
Richmond,"Garthwaite, Ryan",7,0,0,7,0,0,0,0
Richmond,"Graham, Jack",19,11,3,8,2,0,0,7
Richmond,"Grimes, Dylan",11,5,3,6,0,0,0,1
Richmond,"Lambert, Kane",23,10,4,13,0,0,0,4
Richmond,"Lynch, Tom",9,4,3,5,2,0,0,1
Richmond,"Mansell, Rhyan",16,9,3,7,0,0,0,2
Richmond,"Martin, Dustin",15,11,1,4,1,0,0,1
Richmond,"McIntosh, Kamdyn",8,7,0,1,0,0,0,0
Richmond,"Nankervis, Toby",22,10,4,12,0,0,25,4
Richmond,"Parker, Matthew",12,10,4,2,0,0,0,7
Richmond,"Pickett, Marlion",8,6,3,2,0,0,0,3
Richmond,"Riewoldt, Jack",14,13,7,1,6,2,0,3
Richmond,"Rioli, Daniel",19,7,4,12,0,0,0,0
Richmond,"Ross, Jack",16,8,3,8,0,0,0,0
Richmond,"Short, Jayden",27,20,7,7,0,0,0,1
Richmond,"Stack, Sydney",11,7,5,4,0,1,0,2
Richmond,"Aarts, Jake",10,7,1,3,2,0,0,4
Richmond,"Astbury, David",10,7,1,3,0,0,0,2
Richmond,"Baker, Liam",15,7,3,8,0,2,0,1
Richmond,"Bolton, Shai",14,4,3,10,0,1,0,2
Richmond,"Caddy, Josh",0,0,0,0,0,0,0,0
Richmond,"Castagna, Jason",11,5,7,6,1,1,0,0
Richmond,"Chol, Mabior",6,3,1,3,0,0,5,1
Richmond,"Cotchin, Trent",19,15,5,4,1,0,0,4
Richmond,"Edwards, Shane",13,10,2,3,0,0,0,1
Richmond,"Garthwaite, Ryan",10,6,3,4,0,0,0,2
Richmond,"Graham, Jack",15,7,3,8,0,0,0,4
Richmond,"Grimes, Dylan",18,11,4,7,0,0,0,1
Richmond,"Lambert, Kane",15,7,3,8,1,0,0,1
Richmond,"Lynch, Tom",12,6,4,6,1,2,1,4
Richmond,"Mansell, Rhyan",17,9,4,8,0,0,0,3
Richmond,"Nankervis, Toby",15,2,1,13,0,0,19,7
Richmond,"Parker, Matthew",19,10,2,9,0,0,0,8
Richmond,"Pickett, Marlion",13,4,3,9,0,1,0,1
Richmond,"Riewoldt, Jack",17,12,5,5,2,1,0,1
Richmond,"Rioli, Daniel",19,10,1,9,0,0,0,7
Richmond,"Ross, Jack",25,13,9,12,0,0,0,2
Richmond,"Short, Jayden",26,16,8,10,0,0,0,2
Richmond,"Stack, Sydney",12,9,5,3,0,0,0,2
Richmond,"Aarts, Jake",6,4,2,2,0,0,0,1
Richmond,"Astbury, David",16,11,8,5,0,0,0,2
Richmond,"Baker, Liam",22,11,0,11,0,1,0,2
Richmond,"Bolton, Shai",12,5,1,7,0,3,0,5
Richmond,"Caddy, Josh",0,0,0,0,0,0,0,0
Richmond,"Castagna, Jason",15,6,4,9,0,1,0,3
Richmond,"Chol, Mabior",8,6,4,2,0,0,6,1
Richmond,"Cotchin, Trent",32,16,3,16,0,0,0,3
Richmond,"Edwards, Shane",16,6,4,10,0,0,0,2
Richmond,"Garthwaite, Ryan",13,11,3,2,0,0,0,1
Richmond,"Graham, Jack",18,10,2,8,0,0,0,3
Richmond,"Grimes, Dylan",11,3,4,8,0,0,0,4
Richmond,"Lambert, Kane",18,10,3,8,1,0,0,4
Richmond,"Lynch, Tom",14,8,5,6,1,2,2,0
Richmond,"Mansell, Rhyan",14,8,3,6,1,0,0,1
Richmond,"Nankervis, Toby",15,5,4,10,0,0,17,4
Richmond,"Parker, Matthew",12,5,2,7,2,2,0,4
Richmond,"Prestia, Dion",31,11,5,20,0,0,0,5
Richmond,"Riewoldt, Jack",9,8,5,1,1,2,0,1
Richmond,"Rioli, Daniel",20,11,3,9,0,0,0,3
Richmond,"Ross, Jack",13,4,4,9,0,0,0,1
Richmond,"Short, Jayden",27,22,5,5,0,0,0,0
Richmond,"Stack, Sydney",25,11,10,14,0,0,0,2
Richmond,"Astbury, David",14,8,9,6,0,0,0,2
Richmond,"Baker, Liam",26,11,7,15,2,0,0,1
Richmond,"Bolton, Shai",17,7,3,10,1,1,0,4
Richmond,"Castagna, Jason",0,0,0,0,0,0,0,0
Richmond,"Coleman-Jones, Callum",14,8,3,6,2,0,4,2
Richmond,"Cotchin, Trent",23,8,4,15,0,0,0,1
Richmond,"Dow, Thomson",22,11,4,11,0,2,0,1
Richmond,"Edwards, Shane",14,7,3,7,2,0,0,1
Richmond,"Graham, Jack",36,23,8,13,0,0,0,8
Richmond,"Grimes, Dylan",15,10,9,5,0,0,0,3
Richmond,"Lambert, Kane",17,10,7,7,0,0,0,3
Richmond,"Lynch, Tom",6,2,1,4,0,0,1,1
Richmond,"Mansell, Rhyan",13,8,3,5,0,0,0,2
Richmond,"Nankervis, Toby",15,10,3,5,0,1,15,5
Richmond,"Parker, Matthew",14,10,3,4,1,1,0,4
Richmond,"Prestia, Dion",29,13,6,16,1,0,0,4
Richmond,"Ralphsmith, Hugo",17,10,4,7,1,1,0,2
Richmond,"Riewoldt, Jack",9,7,4,2,2,1,0,1
Richmond,"Rioli, Daniel",24,14,9,10,0,0,0,2
Richmond,"Rioli, Maurice",6,4,0,2,1,0,0,2
Richmond,"Short, Jayden",26,14,6,12,0,0,0,0
Richmond,"Stack, Sydney",22,12,9,10,0,0,0,2
Richmond,"Vlastuin, Nick",30,20,14,10,0,1,0,2
Richmond,"Aarts, Jake",0,0,0,0,0,0,0,0
Richmond,"Baker, Liam",23,16,7,7,2,0,0,3
Richmond,"Bolton, Shai",17,8,5,9,2,2,0,1
Richmond,"Coleman-Jones, Callum",14,5,5,9,1,1,16,0
Richmond,"Cotchin, Trent",31,15,5,16,0,0,0,2
Richmond,"Dow, Thomson",14,5,5,9,0,0,0,3
Richmond,"Edwards, Shane",12,6,3,6,1,0,0,0
Richmond,"Garthwaite, Ryan",11,3,3,8,0,0,0,4
Richmond,"Graham, Jack",20,14,2,6,0,1,0,4
Richmond,"Grimes, Dylan",17,11,8,6,0,0,0,2
Richmond,"Lambert, Kane",13,5,1,8,0,0,0,6
Richmond,"Lynch, Tom",12,8,5,4,2,2,2,3
Richmond,"Mansell, Rhyan",9,6,6,3,0,0,0,2
Richmond,"Nankervis, Toby",14,2,3,12,0,0,23,2
Richmond,"Parker, Matthew",13,6,4,7,0,0,0,2
Richmond,"Prestia, Dion",22,11,3,11,0,1,0,4
Richmond,"Ralphsmith, Hugo",7,3,1,4,0,0,0,0
Richmond,"Riewoldt, Jack",7,5,2,2,1,0,0,2
Richmond,"Rioli, Daniel",22,14,6,8,0,0,0,0
Richmond,"Rioli, Maurice",3,3,1,0,1,0,0,2
Richmond,"Short, Jayden",32,22,4,10,0,0,0,3
Richmond,"Stack, Sydney",19,6,1,13,0,0,0,3
Richmond,"Vlastuin, Nick",20,16,7,4,0,0,0,4
Richmond,"Aarts, Jake",4,3,1,1,0,1,0,2
Richmond,"Astbury, David",20,12,13,8,0,0,0,2
Richmond,"Baker, Liam",12,9,5,3,0,1,0,1
Richmond,"Bolton, Shai",14,11,6,3,2,0,0,2
Richmond,"Castagna, Jason",11,6,5,5,1,1,0,0
Richmond,"Chol, Mabior",7,5,4,2,1,1,4,3
Richmond,"Coleman-Jones, Callum",9,4,3,5,0,0,12,4
Richmond,"Collier-Dawkins, Riley",19,10,3,9,0,0,0,1
Richmond,"Dow, Thomson",15,6,3,9,0,0,0,1
Richmond,"Graham, Jack",17,14,3,3,0,1,0,5
Richmond,"Grimes, Dylan",21,12,9,9,0,0,0,2
Richmond,"Lynch, Tom",16,13,7,3,3,3,0,2
Richmond,"Martyn, Will",14,10,5,4,0,0,0,2
Richmond,"McIntosh, Kamdyn",16,10,5,6,0,0,0,5
Richmond,"Miller, Ben",6,4,2,2,0,0,0,0
Richmond,"Parker, Matthew",9,6,3,3,0,0,0,4
Richmond,"Pickett, Marlion",13,10,8,3,0,1,0,0
Richmond,"Riewoldt, Jack",12,6,4,6,3,0,0,0
Richmond,"Rioli, Daniel",19,8,3,11,0,0,0,3
Richmond,"Ross, Jack",24,13,5,11,0,0,0,4
Richmond,"Short, Jayden",26,19,9,7,0,0,0,1
Richmond,"Stack, Sydney",15,9,3,6,2,0,0,3
Richmond,"Vlastuin, Nick",20,10,6,10,0,0,0,4
St Kilda,"Battle, Josh",11,8,1,3,1,1,0,3
St Kilda,"Billings, Jack",30,15,5,15,1,0,0,1
St Kilda,"Butler, Dan",10,9,0,1,1,0,0,7
St Kilda,"Bytel, Jack",13,9,1,4,0,0,0,10
St Kilda,"Clark, Hunter",24,17,4,7,0,0,0,5
St Kilda,"Coffield, Nick",17,13,4,4,0,0,0,3
St Kilda,"Gresham, Jade",28,21,5,7,0,0,0,3
St Kilda,"Higgins, Jack",12,8,3,4,2,1,0,4
St Kilda,"Highmore, Tom",19,10,2,9,0,0,0,4
St Kilda,"Hill, Bradley",16,8,3,8,1,1,0,2
St Kilda,"Howard, Dougal",17,15,1,2,0,0,0,1
St Kilda,"Hunter, Paul",9,5,1,4,0,0,19,2
St Kilda,"Long, Ben",17,13,5,4,0,0,0,1
St Kilda,"Lonie, Jack",11,6,2,5,2,0,0,3
St Kilda,"McKenzie, Daniel",9,6,2,3,0,0,0,4
St Kilda,"McKernan, Shaun",6,5,0,1,0,0,17,3
St Kilda,"Membrey, Tim",21,15,7,6,3,0,2,0
St Kilda,"Ross, Sebastian",19,11,4,8,2,0,0,2
St Kilda,"Sinclair, Jack",18,11,2,7,0,1,0,2
St Kilda,"Steele, Jack",20,13,0,7,0,1,0,8
St Kilda,"Webster, Jimmy",13,9,4,4,0,0,0,1
St Kilda,"Wilkie, Callum",12,8,0,4,0,0,0,2
St Kilda,"Wood, Mason",0,0,0,0,0,0,0,0
St Kilda,"Battle, Josh",13,10,6,3,1,1,0,3
St Kilda,"Billings, Jack",23,18,13,5,1,1,0,3
St Kilda,"Butler, Dan",8,6,1,2,0,0,0,0
St Kilda,"Bytel, Jack",6,2,1,4,0,0,0,1
St Kilda,"Clark, Hunter",20,10,5,10,0,0,0,1
St Kilda,"Coffield, Nick",17,10,5,7,0,0,0,0
St Kilda,"Gresham, Jade",29,17,6,12,1,0,0,2
St Kilda,"Higgins, Jack",9,3,1,6,1,0,0,1
St Kilda,"Highmore, Tom",9,5,3,4,0,0,0,5
St Kilda,"Hill, Bradley",21,16,6,5,0,0,0,4
St Kilda,"Howard, Dougal",29,23,8,6,0,0,0,2
St Kilda,"Hunter, Paul",10,4,0,6,0,0,13,5
St Kilda,"Jones, Zak",12,6,3,6,0,1,0,6
St Kilda,"King, Max",10,7,4,3,2,0,0,1
St Kilda,"Long, Ben",14,8,5,6,0,0,0,0
St Kilda,"Lonie, Jack",8,5,2,3,0,0,0,0
St Kilda,"McKernan, Shaun",7,5,2,2,1,0,4,1
St Kilda,"Membrey, Tim",16,10,8,6,1,3,0,1
St Kilda,"Ross, Sebastian",28,13,5,15,0,0,0,4
St Kilda,"Sinclair, Jack",21,9,6,12,0,0,0,2
St Kilda,"Steele, Jack",25,13,4,12,3,1,0,6
St Kilda,"Webster, Jimmy",10,9,4,1,0,0,0,1
St Kilda,"Wilkie, Callum",20,16,6,4,0,0,0,7
St Kilda,"Battle, Josh",10,6,4,4,0,1,0,2
St Kilda,"Billings, Jack",17,14,7,3,2,1,0,0
St Kilda,"Butler, Dan",7,5,1,2,0,0,0,0
St Kilda,"Carlisle, Jake",13,8,6,5,0,2,15,0
St Kilda,"Clark, Hunter",17,7,1,10,0,0,0,3
St Kilda,"Coffield, Nick",15,11,6,4,0,0,0,1
St Kilda,"Crouch, Brad",15,7,3,8,1,2,0,5
St Kilda,"Gresham, Jade",6,4,1,2,0,0,0,1
St Kilda,"Higgins, Jack",17,8,6,9,3,0,0,2
St Kilda,"Hill, Bradley",16,8,5,8,0,0,0,0
St Kilda,"Howard, Dougal",13,9,5,4,0,0,1,1
St Kilda,"Jones, Zak",18,12,4,6,0,0,0,1
St Kilda,"King, Max",8,7,5,1,1,2,1,1
St Kilda,"Long, Ben",6,2,3,4,0,0,0,1
St Kilda,"Lonie, Jack",17,9,5,8,0,1,0,1
St Kilda,"McKenzie, Daniel",8,6,3,2,0,0,0,1
St Kilda,"McKernan, Shaun",12,5,2,7,0,0,14,2
St Kilda,"Membrey, Tim",17,10,9,7,1,2,0,2
St Kilda,"Ross, Sebastian",18,9,2,9,0,1,0,1
St Kilda,"Sinclair, Jack",14,9,3,5,0,0,0,1
St Kilda,"Steele, Jack",35,18,5,17,1,1,0,4
St Kilda,"Wilkie, Callum",13,10,4,3,0,0,0,0
St Kilda,"Wood, Mason",14,8,5,6,0,0,0,2
St Kilda,"Battle, Josh",16,12,11,4,0,0,0,4
St Kilda,"Billings, Jack",27,11,4,16,2,2,0,3
St Kilda,"Butler, Dan",16,14,1,2,3,2,0,3
St Kilda,"Bytel, Jack",19,6,1,13,0,0,0,7
St Kilda,"Carlisle, Jake",11,4,1,7,0,0,16,3
St Kilda,"Clark, Hunter",22,18,8,4,0,0,0,4
St Kilda,"Coffield, Nick",10,6,3,4,0,0,0,1
St Kilda,"Crouch, Brad",26,13,3,13,0,1,0,12
St Kilda,"Higgins, Jack",15,6,3,9,1,0,0,4
St Kilda,"Hill, Bradley",26,19,9,7,0,0,0,3
St Kilda,"Howard, Dougal",11,11,6,0,0,0,0,0
St Kilda,"Jones, Zak",26,15,4,11,0,0,0,2
St Kilda,"King, Max",13,9,4,4,5,2,2,0
St Kilda,"Long, Ben",0,0,0,0,0,0,0,0
St Kilda,"Lonie, Jack",12,7,2,5,0,1,0,4
St Kilda,"Marshall, Rowan",13,10,8,3,0,0,14,0
St Kilda,"McKenzie, Daniel",21,13,7,8,1,0,0,3
St Kilda,"Membrey, Tim",14,11,9,3,2,2,0,4
St Kilda,"Ross, Sebastian",20,14,6,6,0,1,0,2
St Kilda,"Sinclair, Jack",21,13,6,8,0,0,0,2
St Kilda,"Steele, Jack",33,15,5,18,1,0,0,6
St Kilda,"Webster, Jimmy",20,15,8,5,0,0,0,1
St Kilda,"Wilkie, Callum",12,12,6,0,0,0,0,1
St Kilda,"Battle, Josh",19,13,8,6,0,0,0,2
St Kilda,"Billings, Jack",14,6,5,8,0,0,0,2
St Kilda,"Butler, Dan",11,4,2,7,1,0,0,1
St Kilda,"Bytel, Jack",10,4,3,6,0,0,0,4
St Kilda,"Carlisle, Jake",9,4,4,5,0,0,9,5
St Kilda,"Clark, Hunter",33,17,6,16,0,0,0,3
St Kilda,"Coffield, Nick",23,15,12,8,0,0,0,2
St Kilda,"Crouch, Brad",25,11,4,14,0,0,0,4
St Kilda,"Dunstan, Luke",16,9,6,7,0,0,0,4
St Kilda,"Higgins, Jack",12,7,2,5,2,0,0,2
St Kilda,"Hill, Bradley",10,7,3,3,0,0,0,0
St Kilda,"Howard, Dougal",16,16,5,0,0,0,0,1
St Kilda,"Hunter, Paul",6,2,2,4,1,0,19,2
St Kilda,"King, Max",8,5,3,3,1,2,0,0
St Kilda,"Long, Ben",13,10,4,3,0,0,0,2
St Kilda,"Lonie, Jack",13,10,4,3,2,1,0,1
St Kilda,"McKenzie, Daniel",18,9,5,9,0,0,0,2
St Kilda,"Membrey, Tim",11,7,5,4,0,1,0,0
St Kilda,"Ross, Sebastian",15,7,2,8,0,0,0,2
St Kilda,"Sinclair, Jack",19,14,5,5,0,0,0,3
St Kilda,"Steele, Jack",26,9,7,17,0,0,0,9
St Kilda,"Webster, Jimmy",8,5,2,3,0,0,0,0
St Kilda,"Wilkie, Callum",17,12,9,5,0,0,0,1
St Kilda,"Battle, Josh",14,8,3,6,0,1,0,2
St Kilda,"Billings, Jack",14,9,7,5,0,1,0,3
St Kilda,"Butler, Dan",10,8,3,2,0,1,0,4
St Kilda,"Bytel, Jack",6,1,0,5,0,0,0,0
St Kilda,"Carlisle, Jake",5,4,0,1,1,0,7,1
St Kilda,"Clark, Hunter",18,11,3,7,0,0,0,1
St Kilda,"Coffield, Nick",13,10,6,3,0,0,0,1
St Kilda,"Crouch, Brad",18,10,2,8,0,0,0,0
St Kilda,"Higgins, Jack",10,6,1,4,1,2,0,2
St Kilda,"Hill, Bradley",10,7,3,3,1,0,0,1
St Kilda,"Howard, Dougal",17,17,6,0,0,0,0,0
St Kilda,"Jones, Zak",10,4,1,6,0,0,0,1
St Kilda,"Joyce, Darragh",9,8,3,1,0,0,0,0
St Kilda,"King, Max",7,2,1,5,0,1,2,0
St Kilda,"Long, Ben",6,6,4,0,0,0,0,0
St Kilda,"Lonie, Jack",13,8,3,5,0,0,0,4
St Kilda,"Marshall, Rowan",16,13,8,3,1,0,23,7
St Kilda,"McKenzie, Daniel",16,9,6,7,0,0,0,2
St Kilda,"Membrey, Tim",14,12,8,2,1,1,0,0
St Kilda,"Ross, Sebastian",31,19,10,12,0,1,0,8
St Kilda,"Sinclair, Jack",16,14,5,2,0,0,0,5
St Kilda,"Steele, Jack",27,13,3,14,0,0,0,7
St Kilda,"Wilkie, Callum",11,10,5,1,0,0,0,1
St Kilda,"Battle, Josh",8,2,1,6,0,0,0,2
St Kilda,"Billings, Jack",32,13,5,19,0,0,0,1
St Kilda,"Butler, Dan",18,15,9,3,3,2,0,1
St Kilda,"Byrnes, Ryan",18,8,9,10,0,0,0,1
St Kilda,"Bytel, Jack",21,8,2,13,0,0,0,8
St Kilda,"Clark, Hunter",26,16,4,10,2,0,0,6
St Kilda,"Coffield, Nick",17,10,9,7,1,0,0,1
St Kilda,"Crouch, Brad",32,13,4,19,0,0,0,4
St Kilda,"Higgins, Jack",18,10,5,8,4,0,0,0
St Kilda,"Hill, Bradley",27,17,3,10,0,0,0,5
St Kilda,"Howard, Dougal",15,12,6,3,0,0,0,1
St Kilda,"Jones, Zak",37,18,8,19,2,1,0,6
St Kilda,"Joyce, Darragh",12,10,5,2,0,0,0,0
St Kilda,"King, Max",14,10,6,4,2,4,1,1
St Kilda,"Marshall, Rowan",15,11,6,4,2,0,14,0
St Kilda,"Membrey, Tim",17,9,4,8,2,2,0,0
St Kilda,"Ross, Sebastian",29,17,6,12,0,1,0,3
St Kilda,"Ryder, Paddy",7,3,0,4,0,0,36,5
St Kilda,"Sinclair, Jack",26,17,6,9,1,1,0,2
St Kilda,"Steele, Jack",27,10,2,17,0,0,0,5
St Kilda,"Webster, Jimmy",13,8,3,5,0,0,0,0
St Kilda,"Wilkie, Callum",21,13,7,8,0,0,0,2
St Kilda,"Wood, Mason",0,0,0,0,0,0,0,0
St Kilda,"Battle, Josh",19,12,7,7,0,0,0,4
St Kilda,"Billings, Jack",25,20,13,5,2,2,0,3
St Kilda,"Butler, Dan",15,8,3,7,0,3,0,4
St Kilda,"Byrnes, Ryan",16,7,5,9,0,0,0,1
St Kilda,"Bytel, Jack",15,7,3,8,0,1,0,2
St Kilda,"Clark, Hunter",22,15,9,7,0,0,0,2
St Kilda,"Coffield, Nick",11,8,6,3,0,0,0,1
St Kilda,"Crouch, Brad",30,11,4,19,1,0,0,5
St Kilda,"Higgins, Jack",18,13,5,5,1,3,0,3
St Kilda,"Hill, Bradley",21,14,4,7,0,0,0,2
St Kilda,"Howard, Dougal",17,15,7,2,0,0,0,1
St Kilda,"Jones, Zak",31,24,4,7,0,0,0,7
St Kilda,"Joyce, Darragh",9,9,2,0,0,0,0,2
St Kilda,"King, Max",13,7,5,6,1,2,0,1
St Kilda,"Lonie, Jack",0,0,0,0,0,0,0,0
St Kilda,"Marshall, Rowan",14,7,3,7,0,0,22,2
St Kilda,"Membrey, Tim",12,11,8,1,0,1,0,1
St Kilda,"Ryder, Paddy",11,9,4,2,1,0,27,0
St Kilda,"Sinclair, Jack",19,11,4,8,0,0,0,1
St Kilda,"Steele, Jack",28,18,7,10,2,1,0,8
St Kilda,"Webster, Jimmy",21,15,5,6,0,0,0,2
St Kilda,"Wilkie, Callum",25,16,14,9,0,0,0,3
St Kilda,"Wood, Mason",5,3,3,2,0,0,0,1
St Kilda,"Battle, Josh",14,8,0,6,0,0,0,9
St Kilda,"Billings, Jack",20,12,9,8,0,0,0,5
St Kilda,"Butler, Dan",9,7,2,2,1,1,0,7
St Kilda,"Byrnes, Ryan",13,6,4,7,0,0,0,1
St Kilda,"Bytel, Jack",16,8,3,8,0,0,0,7
St Kilda,"Clark, Hunter",16,11,2,5,0,1,0,8
St Kilda,"Crouch, Brad",28,13,2,15,0,1,0,9
St Kilda,"Frawley, James",13,6,5,7,0,0,0,0
St Kilda,"Higgins, Jack",11,7,2,4,0,0,0,1
St Kilda,"Highmore, Tom",13,5,3,8,0,0,0,3
St Kilda,"Hill, Bradley",18,11,3,7,0,0,0,6
St Kilda,"Howard, Dougal",11,8,3,3,0,0,0,3
St Kilda,"King, Max",12,9,10,3,1,5,1,2
St Kilda,"Long, Ben",3,1,1,2,0,0,0,1
St Kilda,"Lonie, Jack",7,5,3,2,0,1,0,3
St Kilda,"Marshall, Rowan",10,8,3,2,0,1,6,1
St Kilda,"Membrey, Tim",13,11,10,2,2,2,0,2
St Kilda,"Ross, Sebastian",26,11,4,15,0,1,0,3
St Kilda,"Ryder, Paddy",8,8,3,0,0,0,35,3
St Kilda,"Sinclair, Jack",17,12,5,5,0,0,0,0
St Kilda,"Steele, Jack",23,14,3,9,1,0,0,11
St Kilda,"Webster, Jimmy",12,6,6,6,0,0,0,1
St Kilda,"Wilkie, Callum",10,8,3,2,0,0,0,1
St Kilda,"Battle, Josh",16,9,4,7,0,0,0,2
St Kilda,"Billings, Jack",17,13,6,4,1,0,0,2
St Kilda,"Butler, Dan",5,5,2,0,1,0,0,3
St Kilda,"Byrnes, Ryan",24,11,12,13,0,0,0,3
St Kilda,"Bytel, Jack",12,5,1,7,0,0,0,3
St Kilda,"Clark, Hunter",21,14,5,7,0,0,0,1
St Kilda,"Crouch, Brad",21,9,2,12,0,0,0,6
St Kilda,"Frawley, James",10,7,5,3,0,0,0,2
St Kilda,"Geary, Jarryn",16,8,5,8,0,1,0,1
St Kilda,"Higgins, Jack",13,5,3,8,0,0,0,4
St Kilda,"Highmore, Tom",0,0,0,0,0,0,0,0
St Kilda,"Hill, Bradley",15,8,3,7,0,0,0,2
St Kilda,"Howard, Dougal",17,14,3,3,0,0,0,1
St Kilda,"King, Max",6,2,1,4,0,1,1,1
St Kilda,"Lonie, Jack",15,9,1,6,0,0,0,2
St Kilda,"McKernan, Shaun",11,9,4,2,1,1,9,1
St Kilda,"Membrey, Tim",14,12,9,2,2,0,2,0
St Kilda,"Ross, Sebastian",23,8,1,15,0,0,0,3
St Kilda,"Ryder, Paddy",12,9,2,3,0,0,41,1
St Kilda,"Sinclair, Jack",28,18,5,10,0,0,0,3
St Kilda,"Steele, Jack",25,7,3,18,0,0,0,5
St Kilda,"Webster, Jimmy",17,7,5,10,0,0,0,2
St Kilda,"Wilkie, Callum",11,10,4,1,0,0,0,0
St Kilda,"Battle, Josh",13,9,5,4,0,3,0,3
St Kilda,"Billings, Jack",19,14,7,5,2,1,0,4
St Kilda,"Butler, Dan",13,12,3,1,0,2,0,2
St Kilda,"Byrnes, Ryan",12,9,4,3,1,0,0,4
St Kilda,"Clavarino, Oscar",7,4,3,3,0,0,0,1
St Kilda,"Coffield, Nick",17,13,6,4,0,1,0,1
St Kilda,"Crouch, Brad",26,14,2,12,1,0,0,10
St Kilda,"Dunstan, Luke",26,22,6,4,0,1,0,13
St Kilda,"Geary, Jarryn",9,6,4,3,1,0,0,4
St Kilda,"Higgins, Jack",13,5,2,8,1,1,0,1
St Kilda,"Highmore, Tom",11,8,6,3,0,0,0,2
St Kilda,"Hill, Bradley",6,3,0,3,0,0,0,3
St Kilda,"Howard, Dougal",14,11,3,3,0,1,0,1
St Kilda,"King, Max",8,4,1,4,0,2,1,1
St Kilda,"Lonie, Jack",0,0,0,0,0,0,0,0
St Kilda,"Membrey, Tim",17,9,5,8,2,2,0,2
St Kilda,"Ross, Sebastian",14,7,1,7,1,0,0,4
St Kilda,"Ryder, Paddy",11,9,4,2,0,0,34,3
St Kilda,"Sinclair, Jack",17,10,6,7,0,0,0,5
St Kilda,"Steele, Jack",24,11,4,13,0,0,0,12
St Kilda,"Webster, Jimmy",14,10,8,4,0,0,0,0
St Kilda,"Wilkie, Callum",15,12,6,3,0,0,0,2
St Kilda,"Wood, Mason",18,9,8,9,3,1,0,4
St Kilda,"Battle, Josh",6,1,1,5,1,0,2,1
St Kilda,"Billings, Jack",13,7,4,6,1,0,0,2
St Kilda,"Butler, Dan",11,6,1,5,1,0,0,6
St Kilda,"Byrnes, Ryan",13,6,4,7,2,0,0,0
St Kilda,"Clark, Hunter",9,5,2,4,0,0,0,2
St Kilda,"Clavarino, Oscar",8,3,1,5,0,0,0,1
St Kilda,"Coffield, Nick",11,5,5,6,0,0,0,2
St Kilda,"Crouch, Brad",38,14,5,24,0,0,0,7
St Kilda,"Dunstan, Luke",25,12,3,13,0,0,0,4
St Kilda,"Geary, Jarryn",15,8,6,7,0,0,0,2
St Kilda,"Higgins, Jack",23,16,12,7,1,6,0,2
St Kilda,"Highmore, Tom",5,4,2,1,0,0,0,1
St Kilda,"Hill, Bradley",25,17,4,8,0,0,0,2
St Kilda,"Howard, Dougal",13,11,2,2,0,0,0,3
St Kilda,"King, Max",4,2,1,2,1,1,0,1
St Kilda,"Membrey, Tim",20,12,8,8,2,2,0,1
St Kilda,"Ross, Sebastian",21,13,2,8,1,2,0,4
St Kilda,"Ryder, Paddy",16,5,4,11,0,0,34,4
St Kilda,"Sinclair, Jack",29,16,4,13,0,0,0,1
St Kilda,"Steele, Jack",31,18,5,13,1,0,0,10
St Kilda,"Webster, Jimmy",18,11,4,7,0,0,0,3
St Kilda,"Wilkie, Callum",21,14,8,7,0,0,0,1
St Kilda,"Wood, Mason",2,1,0,1,1,0,0,0
St Kilda,"Battle, Josh",6,1,2,5,0,0,0,5
St Kilda,"Billings, Jack",22,12,4,10,0,1,0,2
St Kilda,"Butler, Dan",9,5,2,4,1,1,0,10
St Kilda,"Byrnes, Ryan",14,9,2,5,1,0,0,1
St Kilda,"Bytel, Jack",4,3,0,1,0,0,0,2
St Kilda,"Clark, Hunter",8,5,0,3,0,0,0,1
St Kilda,"Coffield, Nick",5,3,0,2,0,0,0,2
St Kilda,"Crouch, Brad",36,16,1,20,1,0,0,6
St Kilda,"Dunstan, Luke",26,15,3,11,0,1,0,10
St Kilda,"Higgins, Jack",24,15,7,9,0,2,0,4
St Kilda,"Highmore, Tom",22,15,13,7,0,0,0,4
St Kilda,"Hill, Bradley",23,15,1,8,0,0,0,3
St Kilda,"Howard, Dougal",24,21,7,3,0,0,0,2
St Kilda,"Hunter, Paul",8,4,1,4,0,0,17,5
St Kilda,"King, Max",13,9,6,4,2,0,0,3
St Kilda,"Long, Ben",15,9,4,6,0,1,0,5
St Kilda,"Lonie, Jack",12,9,1,3,0,2,0,4
St Kilda,"Ryder, Paddy",10,9,2,1,0,1,28,2
St Kilda,"Sinclair, Jack",24,15,1,9,1,0,0,6
St Kilda,"Steele, Jack",34,20,4,14,0,0,0,12
St Kilda,"Webster, Jimmy",17,9,2,8,0,0,0,4
St Kilda,"Wilkie, Callum",12,9,4,3,0,0,0,2
St Kilda,"Wood, Mason",13,8,3,5,2,0,0,7
St Kilda,"Battle, Josh",21,14,8,7,0,0,0,4
St Kilda,"Butler, Dan",14,9,2,5,0,1,0,3
St Kilda,"Byrnes, Ryan",20,9,3,11,0,0,0,2
St Kilda,"Coffield, Nick",9,9,6,0,0,0,0,2
St Kilda,"Connolly, Leo",11,9,7,2,0,0,0,0
St Kilda,"Crouch, Brad",25,17,5,8,0,0,0,7
St Kilda,"Dunstan, Luke",32,20,4,12,1,0,0,1
St Kilda,"Higgins, Jack",13,6,4,7,1,0,0,1
St Kilda,"Highmore, Tom",18,8,5,10,0,0,0,1
St Kilda,"Hill, Bradley",18,11,4,7,0,0,0,1
St Kilda,"Howard, Dougal",21,15,9,6,0,0,0,2
St Kilda,"King, Max",8,5,3,3,2,1,2,2
St Kilda,"Long, Ben",9,6,2,3,1,2,0,4
St Kilda,"Marshall, Rowan",10,7,1,3,0,0,12,1
St Kilda,"McKenzie, Daniel",14,9,2,5,2,0,0,2
St Kilda,"Membrey, Tim",14,13,8,1,0,2,0,0
St Kilda,"Ross, Sebastian",15,11,5,4,1,1,0,5
St Kilda,"Ryder, Paddy",13,10,7,3,0,0,28,1
St Kilda,"Sinclair, Jack",23,15,4,8,0,0,0,0
St Kilda,"Steele, Jack",25,13,4,12,0,0,0,9
St Kilda,"Webster, Jimmy",20,15,7,5,0,0,0,2
St Kilda,"Wilkie, Callum",17,14,9,3,0,0,0,1
St Kilda,"Wood, Mason",18,8,5,10,1,0,0,3
St Kilda,"Battle, Josh",0,0,0,0,0,0,0,0
St Kilda,"Billings, Jack",14,11,5,3,0,1,0,1
St Kilda,"Butler, Dan",8,6,2,2,1,1,0,3
St Kilda,"Byrnes, Ryan",21,8,2,13,0,0,0,1
St Kilda,"Connolly, Leo",12,6,4,6,0,0,0,0
St Kilda,"Crouch, Brad",28,12,1,16,0,0,0,4
St Kilda,"Dunstan, Luke",27,15,5,12,0,0,0,9
St Kilda,"Higgins, Jack",18,7,3,11,1,0,0,4
St Kilda,"Highmore, Tom",10,6,4,4,0,0,0,2
St Kilda,"Hill, Bradley",30,22,4,8,0,0,0,2
St Kilda,"Howard, Dougal",18,16,6,2,0,0,0,2
St Kilda,"King, Max",11,5,4,6,2,1,0,1
St Kilda,"Long, Ben",11,9,5,2,0,3,0,4
St Kilda,"Marshall, Rowan",14,13,7,1,1,0,15,2
St Kilda,"McKenzie, Daniel",21,11,5,10,1,0,0,1
St Kilda,"Membrey, Tim",17,15,7,2,2,1,1,1
St Kilda,"Ross, Sebastian",22,12,5,10,0,0,0,2
St Kilda,"Ryder, Paddy",9,8,3,1,2,0,23,1
St Kilda,"Sinclair, Jack",24,19,8,5,0,0,0,5
St Kilda,"Steele, Jack",36,16,5,20,0,0,0,14
St Kilda,"Webster, Jimmy",21,14,6,7,0,0,0,3
St Kilda,"Wilkie, Callum",16,15,10,1,0,0,0,1
St Kilda,"Wood, Mason",22,14,6,8,0,1,0,7
St Kilda,"Battle, Josh",0,0,0,0,0,0,0,0
St Kilda,"Billings, Jack",24,17,7,7,1,1,0,2
St Kilda,"Butler, Dan",11,7,0,4,0,2,0,4
St Kilda,"Byrnes, Ryan",15,10,4,5,2,0,0,3
St Kilda,"Connolly, Leo",10,6,3,4,1,0,0,0
St Kilda,"Crouch, Brad",23,9,3,14,1,0,0,3
St Kilda,"Dunstan, Luke",29,18,4,11,0,0,0,2
St Kilda,"Highmore, Tom",16,8,7,8,0,0,0,3
St Kilda,"Hill, Bradley",25,15,6,10,0,0,0,1
St Kilda,"Howard, Dougal",15,6,4,9,0,0,0,1
St Kilda,"Jones, Zak",26,13,3,13,0,0,0,2
St Kilda,"Kent, Dean",10,7,6,3,0,1,0,4
St Kilda,"King, Max",13,10,10,3,3,0,0,0
St Kilda,"Long, Ben",17,11,9,6,1,1,0,4
St Kilda,"Marshall, Rowan",15,10,5,5,0,0,10,4
St Kilda,"McKenzie, Daniel",18,9,6,9,1,0,0,2
St Kilda,"Membrey, Tim",17,16,14,1,2,1,1,0
St Kilda,"Ross, Sebastian",24,13,7,11,0,0,0,2
St Kilda,"Ryder, Paddy",8,4,4,4,0,0,21,5
St Kilda,"Sinclair, Jack",21,14,5,7,0,0,0,2
St Kilda,"Steele, Jack",32,13,6,19,2,1,0,7
St Kilda,"Webster, Jimmy",19,11,8,8,0,0,0,2
St Kilda,"Wilkie, Callum",18,15,7,3,0,0,0,2
St Kilda,"Billings, Jack",16,6,2,10,0,0,0,0
St Kilda,"Butler, Dan",10,5,1,5,1,0,0,2
St Kilda,"Byrnes, Ryan",14,7,5,7,0,0,0,1
St Kilda,"Bytel, Jack",5,4,1,1,0,0,0,3
St Kilda,"Connolly, Leo",12,8,2,4,0,0,0,2
St Kilda,"Crouch, Brad",36,21,1,15,0,1,0,9
St Kilda,"Dunstan, Luke",29,15,6,14,0,1,0,3
St Kilda,"Highmore, Tom",12,8,6,4,0,0,0,2
St Kilda,"Hill, Bradley",29,20,6,9,1,0,0,2
St Kilda,"Howard, Dougal",16,11,4,5,0,0,0,1
St Kilda,"Jones, Zak",14,6,2,8,0,0,0,5
St Kilda,"Kent, Dean",18,9,4,9,0,1,0,3
St Kilda,"King, Max",9,5,4,4,1,1,0,0
St Kilda,"Long, Ben",9,6,4,3,0,0,0,1
St Kilda,"Marshall, Rowan",19,14,6,5,2,2,16,5
St Kilda,"McKenzie, Daniel",9,6,2,3,0,0,0,2
St Kilda,"Membrey, Tim",11,9,5,2,0,1,1,2
St Kilda,"Ross, Sebastian",20,13,8,7,0,0,0,2
St Kilda,"Ryder, Paddy",7,4,2,3,1,0,28,3
St Kilda,"Sinclair, Jack",17,7,3,10,0,0,0,1
St Kilda,"Steele, Jack",37,15,8,22,1,0,0,7
St Kilda,"Webster, Jimmy",22,14,4,8,1,0,0,1
St Kilda,"Wilkie, Callum",16,11,5,5,0,1,0,0
St Kilda,"Billings, Jack",15,9,5,6,1,1,0,0
St Kilda,"Butler, Dan",20,11,4,9,2,0,0,4
St Kilda,"Byrnes, Ryan",18,10,4,8,0,1,0,3
St Kilda,"Clavarino, Oscar",14,7,6,7,0,0,0,3
St Kilda,"Coffield, Nick",17,12,3,5,0,0,0,2
St Kilda,"Connolly, Leo",10,7,0,3,0,0,0,1
St Kilda,"Crouch, Brad",17,8,2,9,0,0,0,2
St Kilda,"Dunstan, Luke",18,10,3,8,0,0,0,2
St Kilda,"Hill, Bradley",26,14,6,12,0,0,0,1
St Kilda,"Howard, Dougal",10,6,4,4,0,0,0,0
St Kilda,"Hunter, Paul",7,2,0,5,1,0,8,5
St Kilda,"Jones, Zak",32,19,5,13,0,0,0,1
St Kilda,"Kent, Dean",13,9,7,4,0,2,0,3
St Kilda,"King, Max",13,10,9,3,6,1,0,1
St Kilda,"Long, Ben",9,5,3,4,0,2,0,3
St Kilda,"Membrey, Tim",10,5,3,5,1,0,2,0
St Kilda,"Ross, Sebastian",22,10,7,12,0,0,0,2
St Kilda,"Ryder, Paddy",6,4,2,2,1,0,27,2
St Kilda,"Sharman, Cooper",0,0,0,0,0,0,0,0
St Kilda,"Sinclair, Jack",22,11,4,11,1,0,0,3
St Kilda,"Steele, Jack",18,11,5,7,0,0,0,13
St Kilda,"Webster, Jimmy",17,10,4,7,0,0,0,2
St Kilda,"Wilkie, Callum",15,11,5,4,0,0,0,3
St Kilda,"Billings, Jack",19,11,5,8,0,2,0,1
St Kilda,"Butler, Dan",13,6,1,7,0,1,0,2
St Kilda,"Byrnes, Ryan",17,11,7,6,0,0,0,1
St Kilda,"Clark, Hunter",13,8,4,5,0,0,0,3
St Kilda,"Connolly, Leo",18,13,3,5,0,1,0,0
St Kilda,"Crouch, Brad",27,13,2,14,0,0,0,4
St Kilda,"Dunstan, Luke",29,10,4,19,0,1,0,2
St Kilda,"Higgins, Jack",20,11,7,9,1,0,0,2
St Kilda,"Highmore, Tom",16,7,6,9,0,0,0,2
St Kilda,"Hill, Bradley",18,10,2,8,0,0,0,4
St Kilda,"Howard, Dougal",6,2,2,4,0,0,0,0
St Kilda,"Hunter, Paul",3,0,1,3,0,0,21,3
St Kilda,"Jones, Zak",30,13,5,17,1,0,0,8
St Kilda,"Kent, Dean",13,6,4,7,0,1,0,5
St Kilda,"King, Max",10,6,3,4,4,0,0,0
St Kilda,"Long, Ben",8,3,1,5,0,0,0,3
St Kilda,"Marshall, Rowan",22,14,4,8,1,1,46,5
St Kilda,"Membrey, Tim",15,10,6,5,3,0,2,0
St Kilda,"Ross, Sebastian",24,10,3,14,0,0,0,4
St Kilda,"Sharman, Cooper",8,5,4,3,2,1,1,1
St Kilda,"Steele, Jack",36,20,5,16,0,1,0,14
St Kilda,"Webster, Jimmy",13,7,1,6,0,0,0,0
St Kilda,"Wilkie, Callum",13,9,3,4,0,0,0,0
St Kilda,"Butler, Dan",14,10,1,4,0,0,0,9
St Kilda,"Byrnes, Ryan",15,8,4,7,0,0,0,2
St Kilda,"Bytel, Jack",5,3,0,2,0,0,0,1
St Kilda,"Coffield, Nick",15,11,7,4,0,0,0,2
St Kilda,"Connolly, Leo",10,7,3,3,0,0,0,1
St Kilda,"Crouch, Brad",24,8,3,16,0,0,0,3
St Kilda,"Dunstan, Luke",26,13,4,13,0,0,0,5
St Kilda,"Higgins, Jack",16,10,4,6,4,1,0,1
St Kilda,"Highmore, Tom",21,13,9,8,0,0,0,2
St Kilda,"Hill, Bradley",26,18,4,8,0,0,0,0
St Kilda,"Jones, Zak",22,12,3,10,0,0,0,8
St Kilda,"Joyce, Darragh",8,3,2,5,0,0,3,1
St Kilda,"Kent, Dean",15,12,7,3,3,0,0,4
St Kilda,"King, Max",6,5,4,1,2,2,0,0
St Kilda,"Marshall, Rowan",25,13,6,12,0,0,29,3
St Kilda,"McKenzie, Daniel",20,13,7,7,0,0,0,1
St Kilda,"Membrey, Tim",15,10,6,5,2,0,0,4
St Kilda,"Ross, Sebastian",19,10,6,9,0,0,0,4
St Kilda,"Sharman, Cooper",11,6,5,5,2,1,1,2
St Kilda,"Sinclair, Jack",25,18,6,7,0,0,0,4
St Kilda,"Steele, Jack",34,15,6,19,1,1,0,7
St Kilda,"Webster, Jimmy",14,10,1,4,0,0,0,2
St Kilda,"Wilkie, Callum",16,10,4,6,0,0,0,1
St Kilda,"Butler, Dan",9,5,1,4,0,0,0,2
St Kilda,"Byrnes, Ryan",10,6,3,4,0,0,0,4
St Kilda,"Clavarino, Oscar",0,0,0,0,0,0,1,0
St Kilda,"Coffield, Nick",10,6,4,4,0,0,0,0
St Kilda,"Crouch, Brad",24,15,2,9,2,0,0,5
St Kilda,"Dunstan, Luke",20,10,3,10,0,0,0,4
St Kilda,"Hannebery, Dan",18,9,2,9,0,0,0,2
St Kilda,"Higgins, Jack",9,8,4,1,1,0,0,3
St Kilda,"Hill, Bradley",9,7,3,2,0,0,0,4
St Kilda,"Howard, Dougal",13,9,5,4,0,0,0,1
St Kilda,"Jones, Zak",18,9,4,9,1,0,0,6
St Kilda,"Joyce, Darragh",9,6,1,3,0,0,1,1
St Kilda,"Kent, Dean",10,5,3,5,0,1,0,1
St Kilda,"King, Max",7,7,6,0,2,2,0,0
St Kilda,"Marshall, Rowan",9,5,1,4,0,0,21,2
St Kilda,"McKenzie, Daniel",10,6,6,4,0,0,0,0
St Kilda,"Membrey, Tim",11,7,3,4,3,1,0,1
St Kilda,"Ross, Sebastian",16,11,5,5,0,0,0,1
St Kilda,"Sharman, Cooper",10,5,4,5,2,1,0,3
St Kilda,"Sinclair, Jack",20,17,6,3,0,0,0,0
St Kilda,"Steele, Jack",30,12,5,18,0,0,0,5
St Kilda,"Webster, Jimmy",15,8,2,7,0,0,0,2
St Kilda,"Wilkie, Callum",9,5,2,4,0,0,0,5
St Kilda,"Butler, Dan",7,7,1,0,2,0,0,5
St Kilda,"Byrnes, Ryan",7,6,4,1,0,0,0,1
St Kilda,"Bytel, Jack",17,10,2,7,2,0,0,7
St Kilda,"Clavarino, Oscar",7,6,4,1,0,0,0,3
St Kilda,"Coffield, Nick",21,17,7,4,0,0,0,4
St Kilda,"Crouch, Brad",28,14,5,14,0,0,0,4
St Kilda,"Hannebery, Dan",22,9,2,13,0,0,0,1
St Kilda,"Higgins, Jack",21,10,5,11,2,0,0,1
St Kilda,"Hill, Bradley",19,12,4,7,0,0,0,2
St Kilda,"Howard, Dougal",11,8,6,3,0,0,0,1
St Kilda,"Hunter, Paul",4,1,0,3,0,0,16,6
St Kilda,"Jones, Zak",28,12,3,16,0,0,0,4
St Kilda,"Kent, Dean",17,8,4,9,2,0,0,2
St Kilda,"Long, Ben",6,5,2,1,0,0,0,6
St Kilda,"Marshall, Rowan",21,12,5,9,2,1,13,7
St Kilda,"McKenzie, Daniel",16,8,5,8,0,0,0,0
St Kilda,"Membrey, Tim",16,13,9,3,3,2,1,1
St Kilda,"Ross, Sebastian",14,6,2,8,0,0,0,3
St Kilda,"Sharman, Cooper",15,11,6,4,4,1,2,2
St Kilda,"Sinclair, Jack",22,11,8,11,0,0,0,0
St Kilda,"Steele, Jack",36,17,7,19,0,1,0,6
St Kilda,"Webster, Jimmy",18,12,9,6,0,0,0,0
St Kilda,"Wilkie, Callum",13,8,5,5,0,0,0,3
Sydney,"Blakey, Nick",15,13,5,2,1,0,0,2
Sydney,"Campbell, Braeden",12,6,2,6,0,0,0,2
Sydney,"Cunningham, Harry",9,6,1,3,0,0,0,4
Sydney,"Dawson, Jordan",21,13,1,8,0,0,0,0
Sydney,"Florent, Oliver",16,8,3,8,0,0,0,5
Sydney,"Gulden, Errol",19,17,10,2,3,1,0,1
Sydney,"Hayward, Will",0,0,0,0,0,0,0,0
Sydney,"Heeney, Isaac",13,12,8,1,3,2,0,1
Sydney,"Hewett, George",20,15,6,5,0,0,0,2
Sydney,"Hickey, Tom",23,12,3,11,0,0,24,1
Sydney,"Kennedy, Josh",17,8,2,9,0,2,0,3
Sydney,"Lloyd, Jake",24,13,3,11,0,0,0,3
Sydney,"McCartin, Tom",11,9,4,2,0,0,0,1
Sydney,"McDonald, Logan",11,9,5,2,3,1,0,0
Sydney,"McLean, Hayden",9,5,4,4,0,0,1,0
Sydney,"Mills, Callum",29,14,8,15,2,0,0,2
Sydney,"Papley, Tom",15,12,6,3,1,1,0,0
Sydney,"Parker, Luke",23,11,5,12,2,0,0,3
Sydney,"Rampe, Dane",22,16,5,6,0,0,0,3
Sydney,"Reid, Sam",6,5,5,1,2,1,5,2
Sydney,"Rowbottom, James",22,9,0,13,0,0,0,8
Sydney,"Warner, Chad",19,10,1,9,0,0,0,3
Sydney,"Wicks, Sam",12,6,2,6,2,0,0,5
Sydney,"Blakey, Nick",10,4,3,6,0,0,0,2
Sydney,"Campbell, Braeden",25,21,6,4,0,1,0,2
Sydney,"Cunningham, Harry",15,10,7,5,0,0,0,1
Sydney,"Dawson, Jordan",23,17,5,6,0,1,0,2
Sydney,"Florent, Oliver",23,10,2,13,0,1,0,2
Sydney,"Franklin, Lance",9,7,2,2,3,2,0,0
Sydney,"Gulden, Errol",22,12,7,10,1,1,0,2
Sydney,"Heeney, Isaac",14,10,8,4,3,0,0,1
Sydney,"Hewett, George",18,11,6,7,0,0,0,1
Sydney,"Hickey, Tom",9,6,3,3,2,0,26,0
Sydney,"Kennedy, Josh",27,18,7,9,0,0,0,5
Sydney,"Ling, Matt",0,0,0,0,0,0,0,0
Sydney,"Lloyd, Jake",26,17,4,9,0,0,0,2
Sydney,"McCartin, Tom",18,14,6,4,0,0,0,2
Sydney,"McDonald, Logan",11,9,8,2,2,1,0,0
Sydney,"McInerney, Justin",20,13,5,7,1,0,0,0
Sydney,"Mills, Callum",19,7,5,12,0,0,0,7
Sydney,"Papley, Tom",11,8,3,3,1,2,0,5
Sydney,"Parker, Luke",23,16,4,7,1,1,0,7
Sydney,"Rampe, Dane",13,7,4,6,0,0,0,2
Sydney,"Reid, Sam",7,2,3,5,1,0,8,1
Sydney,"Warner, Chad",20,12,2,8,2,1,0,4
Sydney,"Wicks, Sam",13,8,4,5,1,0,0,7
Sydney,"Bell, James",0,0,0,0,0,0,0,0
Sydney,"Blakey, Nick",13,9,4,4,0,1,0,2
Sydney,"Campbell, Braeden",12,10,5,2,0,0,0,0
Sydney,"Cunningham, Harry",13,9,3,4,0,0,0,1
Sydney,"Dawson, Jordan",27,21,9,6,0,1,0,1
Sydney,"Florent, Oliver",29,19,9,10,0,0,0,2
Sydney,"Gulden, Errol",18,15,9,3,0,1,0,4
Sydney,"Heeney, Isaac",11,9,3,2,2,2,0,3
Sydney,"Hewett, George",10,3,1,7,0,0,0,1
Sydney,"Hickey, Tom",15,9,5,6,2,0,16,1
Sydney,"Kennedy, Josh",27,11,5,16,0,0,0,2
Sydney,"Lloyd, Jake",29,23,11,6,0,0,0,1
Sydney,"McCartin, Tom",12,9,4,3,0,0,0,1
Sydney,"McDonald, Logan",8,7,3,1,2,2,0,1
Sydney,"McInerney, Justin",12,7,6,5,0,0,0,1
Sydney,"McLean, Hayden",8,5,4,3,1,0,2,1
Sydney,"Mills, Callum",31,15,8,16,0,0,0,2
Sydney,"Papley, Tom",17,12,3,5,4,1,0,1
Sydney,"Parker, Luke",29,16,5,13,1,1,0,3
Sydney,"Rampe, Dane",13,8,4,5,0,0,0,1
Sydney,"Reid, Sam",12,8,5,4,0,1,8,2
Sydney,"Warner, Chad",20,12,5,8,2,1,0,5
Sydney,"Wicks, Sam",21,16,13,5,3,2,0,3
Sydney,"Bell, James",4,1,0,3,0,0,0,3
Sydney,"Blakey, Nick",13,11,4,2,0,2,0,1
Sydney,"Campbell, Braeden",19,11,4,8,0,0,0,0
Sydney,"Cunningham, Harry",14,11,4,3,0,0,0,3
Sydney,"Dawson, Jordan",20,15,2,5,0,0,0,1
Sydney,"Florent, Oliver",20,12,1,8,1,0,0,0
Sydney,"Franklin, Lance",9,7,4,2,3,1,0,4
Sydney,"Gulden, Errol",17,12,5,5,0,3,0,2
Sydney,"Heeney, Isaac",9,7,6,2,0,2,0,0
Sydney,"Hewett, George",11,7,2,4,0,0,0,0
Sydney,"Hickey, Tom",14,9,0,5,0,1,27,2
Sydney,"Kennedy, Josh",22,12,4,10,0,0,0,2
Sydney,"Lloyd, Jake",25,20,7,5,0,0,0,3
Sydney,"McCartin, Tom",13,7,5,6,0,0,0,3
Sydney,"McDonald, Logan",7,2,0,5,0,0,0,2
Sydney,"McInerney, Justin",14,6,1,8,2,0,0,3
Sydney,"Mills, Callum",25,12,5,13,1,1,0,2
Sydney,"Papley, Tom",12,10,1,2,1,2,0,1
Sydney,"Parker, Luke",32,21,7,11,1,1,0,3
Sydney,"Rampe, Dane",15,11,10,4,0,0,0,3
Sydney,"Reid, Sam",15,7,7,8,2,1,9,2
Sydney,"Warner, Chad",23,14,3,9,0,1,0,6
Sydney,"Wicks, Sam",13,5,1,8,0,1,0,8
Sydney,"Blakey, Nick",13,5,2,8,0,0,0,2
Sydney,"Campbell, Braeden",14,9,2,5,0,0,0,1
Sydney,"Cunningham, Harry",14,10,3,4,0,0,0,1
Sydney,"Dawson, Jordan",23,18,3,5,0,0,0,4
Sydney,"Florent, Oliver",15,7,4,8,0,1,0,3
Sydney,"Franklin, Lance",14,12,8,2,5,0,0,4
Sydney,"Gulden, Errol",18,9,4,9,0,0,0,2
Sydney,"Hayward, Will",18,11,6,7,3,1,0,3
Sydney,"Hewett, George",13,8,2,5,0,0,0,4
Sydney,"Hickey, Tom",16,7,3,9,0,0,24,3
Sydney,"Kennedy, Josh",19,11,1,8,0,0,0,6
Sydney,"Lloyd, Jake",28,21,7,7,0,1,0,1
Sydney,"McCartin, Tom",11,8,3,3,0,0,0,2
Sydney,"McDonald, Logan",6,2,0,4,0,1,0,1
Sydney,"McInerney, Justin",13,7,2,6,0,0,0,2
Sydney,"Melican, Lewis",15,12,7,3,0,0,0,0
Sydney,"Mills, Callum",20,9,5,11,0,0,0,9
Sydney,"Papley, Tom",10,8,6,2,2,1,0,0
Sydney,"Parker, Luke",21,9,1,12,0,1,0,6
Sydney,"Reid, Sam",16,11,4,5,0,0,15,5
Sydney,"Stephens, Dylan",1,1,0,0,0,0,0,1
Sydney,"Warner, Chad",13,10,2,3,0,2,0,5
Sydney,"Wicks, Sam",6,4,2,2,0,0,0,4
Sydney,"Blakey, Nick",7,3,1,4,0,1,3,4
Sydney,"Brand, Kaiden",14,6,3,8,0,0,0,2
Sydney,"Campbell, Braeden",12,6,3,6,0,0,0,2
Sydney,"Cunningham, Harry",9,7,3,2,0,0,0,5
Sydney,"Dawson, Jordan",24,13,4,11,0,0,0,4
Sydney,"Florent, Oliver",23,17,6,6,1,0,0,1
Sydney,"Gulden, Errol",12,8,3,4,0,0,0,3
Sydney,"Hayward, Will",9,5,5,4,1,0,0,5
Sydney,"Heeney, Isaac",13,8,6,5,1,0,0,1
Sydney,"Hewett, George",3,1,2,2,0,0,0,0
Sydney,"Kennedy, Josh",42,14,6,28,0,1,0,7
Sydney,"Lloyd, Jake",35,16,4,19,0,0,0,4
Sydney,"McInerney, Justin",17,11,5,6,0,0,0,0
Sydney,"McLean, Hayden",8,4,3,4,2,0,1,0
Sydney,"Melican, Lewis",9,6,3,3,0,0,0,1
Sydney,"Mills, Callum",34,18,10,16,0,0,0,7
Sydney,"Papley, Tom",12,6,3,6,1,1,0,0
Sydney,"Parker, Luke",36,15,2,21,0,0,0,5
Sydney,"Reid, Sam",9,4,2,5,0,1,18,4
Sydney,"Rowbottom, James",16,15,4,1,1,0,0,5
Sydney,"Sinclair, Callum",13,7,4,6,0,0,54,3
Sydney,"Warner, Chad",23,17,3,6,1,0,0,4
Sydney,"Wicks, Sam",11,9,5,2,1,0,0,4
Sydney,"Clarke, Ryan",0,0,0,0,0,0,0,0
Sydney,"Cunningham, Harry",17,10,7,7,0,0,0,4
Sydney,"Dawson, Jordan",20,15,1,5,0,1,0,2
Sydney,"Florent, Oliver",26,19,5,7,2,0,0,1
Sydney,"Gulden, Errol",7,6,4,1,1,2,0,5
Sydney,"Hayward, Will",10,4,4,6,0,0,0,4
Sydney,"Heeney, Isaac",7,5,3,2,0,1,0,0
Sydney,"Hickey, Tom",20,9,1,11,1,0,23,2
Sydney,"Kennedy, Josh",22,11,5,11,0,0,0,2
Sydney,"Lloyd, Jake",25,17,3,8,0,0,0,4
Sydney,"McCartin, Tom",9,8,2,1,0,0,0,0
Sydney,"McInerney, Justin",10,7,3,3,1,0,0,1
Sydney,"McLean, Hayden",9,6,4,3,4,0,0,2
Sydney,"Melican, Lewis",11,5,6,6,0,0,0,0
Sydney,"Mills, Callum",19,16,11,3,0,0,0,1
Sydney,"ORiordan, Colin",14,8,3,6,0,0,0,1
Sydney,"Papley, Tom",11,8,1,3,2,0,0,2
Sydney,"Parker, Luke",22,5,3,17,0,0,0,3
Sydney,"Rowbottom, James",20,15,6,5,1,0,0,4
Sydney,"Sinclair, Callum",7,2,1,5,0,0,9,3
Sydney,"Stephens, Dylan",15,11,7,4,1,0,0,1
Sydney,"Warner, Chad",14,9,2,5,1,0,0,6
Sydney,"Wicks, Sam",9,7,1,2,0,0,0,2
Sydney,"Blakey, Nick",0,0,0,0,0,0,0,0
Sydney,"Cunningham, Harry",22,15,7,7,0,0,0,2
Sydney,"Dawson, Jordan",21,19,9,2,0,0,0,3
Sydney,"Florent, Oliver",17,10,3,7,0,0,0,6
Sydney,"Fox, Robbie",19,10,6,9,0,0,0,2
Sydney,"Franklin, Lance",6,5,3,1,0,0,0,5
Sydney,"Gulden, Errol",9,6,0,3,0,0,0,6
Sydney,"Hayward, Will",15,8,4,7,2,1,0,4
Sydney,"Hickey, Tom",16,9,0,7,1,0,16,4
Sydney,"Kennedy, Josh",22,13,4,9,0,0,0,7
Sydney,"Lloyd, Jake",28,20,7,8,1,0,0,3
Sydney,"McCartin, Tom",14,10,3,4,0,0,0,1
Sydney,"McInerney, Justin",15,10,6,5,1,0,0,1
Sydney,"McLean, Hayden",6,5,5,1,0,0,0,2
Sydney,"Mills, Callum",33,14,2,19,1,0,0,10
Sydney,"ORiordan, Colin",9,6,3,3,0,0,0,2
Sydney,"Papley, Tom",17,14,5,3,1,3,0,3
Sydney,"Parker, Luke",32,16,4,16,0,0,0,5
Sydney,"Rampe, Dane",21,12,7,9,0,0,0,1
Sydney,"Rowbottom, James",22,12,4,10,0,0,0,12
Sydney,"Sinclair, Callum",8,4,2,4,1,0,12,3
Sydney,"Warner, Chad",15,9,3,6,0,0,0,4
Sydney,"Wicks, Sam",13,7,0,6,0,1,0,6
Sydney,"Bell, James",0,0,0,0,0,0,0,0
Sydney,"Blakey, Nick",10,6,1,4,1,0,4,5
Sydney,"Cunningham, Harry",20,12,3,8,0,0,0,3
Sydney,"Dawson, Jordan",15,9,3,6,0,0,0,0
Sydney,"Florent, Oliver",15,9,5,6,0,1,0,3
Sydney,"Fox, Robbie",11,8,4,3,0,0,0,2
Sydney,"Franklin, Lance",12,6,2,6,2,2,0,2
Sydney,"Hayward, Will",13,7,7,6,0,0,0,7
Sydney,"Heeney, Isaac",22,12,6,10,3,2,0,3
Sydney,"Hewett, George",20,5,5,15,0,0,0,5
Sydney,"Hickey, Tom",19,11,3,8,0,1,18,3
Sydney,"Kennedy, Josh",23,6,2,17,0,0,0,6
Sydney,"Lloyd, Jake",28,18,3,10,0,0,0,2
Sydney,"McCartin, Tom",13,8,8,5,0,0,0,1
Sydney,"McInerney, Justin",24,17,7,7,0,1,0,4
Sydney,"McLean, Hayden",18,11,9,7,1,2,0,6
Sydney,"Mills, Callum",28,12,6,16,0,0,0,7
Sydney,"Papley, Tom",13,9,2,4,2,1,0,3
Sydney,"Parker, Luke",25,6,2,19,0,0,0,5
Sydney,"Rampe, Dane",20,16,10,4,0,0,0,0
Sydney,"Rowbottom, James",18,10,2,8,0,0,0,7
Sydney,"Warner, Chad",19,10,1,9,1,0,0,1
Sydney,"Wicks, Sam",16,10,4,6,0,2,0,7
Sydney,"Blakey, Nick",8,6,2,2,0,1,5,0
Sydney,"Clarke, Ryan",7,6,3,1,0,0,0,1
Sydney,"Cunningham, Harry",13,11,4,2,0,0,0,3
Sydney,"Dawson, Jordan",31,24,6,7,0,0,0,5
Sydney,"Florent, Oliver",24,19,3,5,1,0,0,2
Sydney,"Fox, Robbie",2,0,0,2,0,0,0,0
Sydney,"Franklin, Lance",18,14,10,4,6,1,0,3
Sydney,"Hayward, Will",5,2,0,3,1,0,0,4
Sydney,"Heeney, Isaac",24,11,6,13,1,0,0,1
Sydney,"Hewett, George",13,8,2,5,0,0,0,4
Sydney,"Hickey, Tom",12,3,2,9,0,0,24,3
Sydney,"Kennedy, Josh",28,15,4,13,0,0,0,6
Sydney,"Lloyd, Jake",26,19,6,7,0,0,0,3
Sydney,"McCartin, Tom",17,10,8,7,0,0,0,1
Sydney,"McLean, Hayden",5,1,2,4,0,0,0,1
Sydney,"Mills, Callum",26,12,6,14,0,0,0,8
Sydney,"Papley, Tom",13,13,4,0,2,0,0,1
Sydney,"Parker, Luke",29,13,1,16,0,0,0,3
Sydney,"Rampe, Dane",19,12,5,7,0,0,0,1
Sydney,"Rowbottom, James",15,10,1,5,1,0,0,8
Sydney,"Stephens, Dylan",10,6,3,4,0,1,0,3
Sydney,"Warner, Chad",12,10,1,2,1,0,0,4
Sydney,"Wicks, Sam",7,3,1,4,0,2,0,4
Sydney,"Brand, Kaiden",13,8,5,5,0,0,0,1
Sydney,"Cunningham, Harry",27,17,10,10,0,0,0,4
Sydney,"Dawson, Jordan",20,16,5,4,0,0,0,7
Sydney,"Florent, Oliver",20,16,5,4,0,0,0,0
Sydney,"Franklin, Lance",13,9,3,4,3,0,0,2
Sydney,"Hayward, Will",11,9,6,2,2,0,0,3
Sydney,"Heeney, Isaac",22,20,14,2,3,1,0,3
Sydney,"Hewett, George",12,8,5,4,0,0,0,3
Sydney,"Kennedy, Josh",19,7,2,12,2,0,0,10
Sydney,"Lloyd, Jake",29,19,3,10,0,0,0,4
Sydney,"McCartin, Tom",12,10,6,2,0,0,0,0
Sydney,"McInerney, Justin",17,10,4,7,0,0,0,1
Sydney,"McLean, Hayden",7,6,4,1,0,1,6,2
Sydney,"Mills, Callum",25,12,3,13,0,0,0,7
Sydney,"Papley, Tom",15,13,6,2,3,0,0,5
Sydney,"Parker, Luke",23,14,3,9,1,0,0,6
Sydney,"Rampe, Dane",14,11,5,3,0,1,0,2
Sydney,"Rowbottom, James",14,6,1,8,0,0,0,11
Sydney,"Sinclair, Callum",12,6,3,6,0,0,24,2
Sydney,"Stephens, Dylan",13,2,4,11,0,0,0,1
Sydney,"Taylor, Lewis",0,0,0,0,0,0,0,0
Sydney,"Warner, Chad",15,9,4,6,0,0,0,4
Sydney,"Wicks, Sam",11,10,6,1,1,2,0,4
Sydney,"Amartey, Joel",14,12,6,2,0,1,9,2
Sydney,"Bell, James",0,0,0,0,0,0,0,0
Sydney,"Cunningham, Harry",25,14,9,11,0,0,0,2
Sydney,"Dawson, Jordan",16,15,5,1,0,1,0,3
Sydney,"Florent, Oliver",15,4,1,11,0,0,0,2
Sydney,"Fox, Robbie",10,6,3,4,0,0,0,1
Sydney,"Franklin, Lance",16,12,4,4,2,1,0,2
Sydney,"Hayward, Will",9,8,4,1,3,2,0,3
Sydney,"Heeney, Isaac",12,8,5,4,2,1,1,2
Sydney,"Hewett, George",23,13,7,10,0,0,0,3
Sydney,"Hickey, Tom",21,11,5,10,0,0,16,1
Sydney,"Kennedy, Josh",14,4,1,10,1,0,0,3
Sydney,"Lloyd, Jake",27,18,6,9,0,0,0,3
Sydney,"McCartin, Tom",18,13,10,5,0,0,0,1
Sydney,"McDonald, Logan",6,4,3,2,2,0,0,0
Sydney,"McInerney, Justin",13,8,5,5,0,0,0,1
Sydney,"Mills, Callum",26,13,3,13,0,0,0,5
Sydney,"Papley, Tom",15,9,5,6,1,2,0,2
Sydney,"Parker, Luke",27,14,4,13,1,1,0,4
Sydney,"Rampe, Dane",16,10,7,6,0,0,0,3
Sydney,"Rowbottom, James",15,7,0,8,1,1,0,6
Sydney,"Warner, Chad",12,9,2,3,0,0,0,1
Sydney,"Wicks, Sam",8,3,2,5,0,0,0,3
Sydney,"Amartey, Joel",12,9,4,3,2,1,8,7
Sydney,"Bell, James",14,8,3,6,0,0,0,5
Sydney,"Cunningham, Harry",5,2,1,3,0,0,0,4
Sydney,"Dawson, Jordan",17,9,2,8,0,0,0,5
Sydney,"Florent, Oliver",16,10,2,6,1,0,0,2
Sydney,"Fox, Robbie",11,4,0,7,0,0,0,2
Sydney,"Franklin, Lance",9,4,3,5,1,0,0,2
Sydney,"Hayward, Will",4,2,2,2,1,0,0,2
Sydney,"Heeney, Isaac",10,3,1,7,1,0,0,2
Sydney,"Hewett, George",11,4,2,7,0,0,0,3
Sydney,"Hickey, Tom",15,8,2,7,0,0,26,2
Sydney,"Kennedy, Josh",28,10,7,18,0,0,0,8
Sydney,"Lloyd, Jake",30,17,4,13,0,0,0,1
Sydney,"McCartin, Tom",13,4,3,9,0,0,0,1
Sydney,"McDonald, Logan",10,5,3,5,0,0,0,2
Sydney,"McInerney, Justin",19,14,4,5,0,0,0,0
Sydney,"Mills, Callum",33,15,1,18,0,0,0,7
Sydney,"Papley, Tom",10,5,6,5,0,0,0,2
Sydney,"Parker, Luke",29,14,4,15,0,1,0,6
Sydney,"Rampe, Dane",29,19,9,10,0,0,0,2
Sydney,"Rowbottom, James",21,11,4,10,0,1,0,11
Sydney,"Taylor, Lewis",6,6,4,0,0,1,0,1
Sydney,"Wicks, Sam",16,8,4,8,1,2,0,4
Sydney,"Amartey, Joel",4,2,0,2,0,0,11,5
Sydney,"Bell, James",8,7,4,1,0,0,0,3
Sydney,"Blakey, Nick",0,0,0,0,0,0,0,0
Sydney,"Brand, Kaiden",11,8,2,3,0,0,0,3
Sydney,"Cunningham, Harry",16,11,2,5,0,0,0,4
Sydney,"Dawson, Jordan",25,12,2,13,0,0,0,4
Sydney,"Florent, Oliver",10,6,3,4,0,0,0,2
Sydney,"Fox, Robbie",13,5,0,8,0,0,0,3
Sydney,"Franklin, Lance",16,12,3,4,4,2,0,2
Sydney,"Gulden, Errol",11,7,1,4,1,0,0,4
Sydney,"Hayward, Will",8,6,1,2,2,0,0,3
Sydney,"Heeney, Isaac",14,10,3,4,0,3,0,3
Sydney,"Hewett, George",21,7,2,14,0,0,0,2
Sydney,"Hickey, Tom",14,9,1,5,0,3,21,2
Sydney,"Kennedy, Josh",19,7,3,12,0,0,0,1
Sydney,"Lloyd, Jake",24,12,1,12,0,0,0,0
Sydney,"McCartin, Tom",13,6,0,7,0,0,0,1
Sydney,"McInerney, Justin",22,10,6,12,0,0,0,1
Sydney,"Mills, Callum",30,18,6,12,0,0,0,4
Sydney,"Papley, Tom",9,7,2,2,2,1,0,1
Sydney,"Parker, Luke",34,11,6,23,1,0,0,3
Sydney,"Rampe, Dane",16,11,0,5,0,0,0,0
Sydney,"Rowbottom, James",15,9,1,6,0,0,0,9
Sydney,"Amartey, Joel",12,7,3,5,2,0,4,4
Sydney,"Bell, James",15,5,6,10,0,1,0,4
Sydney,"Blakey, Nick",19,15,6,4,0,0,0,2
Sydney,"Cunningham, Harry",20,14,7,6,0,0,0,3
Sydney,"Dawson, Jordan",25,12,5,13,2,0,0,2
Sydney,"Florent, Oliver",28,17,5,11,0,1,0,2
Sydney,"Fox, Robbie",16,8,4,8,0,0,0,3
Sydney,"Franklin, Lance",16,12,4,4,3,3,0,4
Sydney,"Gulden, Errol",19,12,5,7,2,1,0,3
Sydney,"Hayward, Will",9,5,3,4,2,0,0,2
Sydney,"Heeney, Isaac",18,12,3,6,3,2,0,2
Sydney,"Hewett, George",26,7,4,19,0,0,0,3
Sydney,"Hickey, Tom",22,8,4,14,0,0,21,2
Sydney,"Kennedy, Josh",22,10,2,12,0,0,0,8
Sydney,"Lloyd, Jake",26,15,7,11,0,0,0,1
Sydney,"McCartin, Tom",12,6,1,6,0,0,0,0
Sydney,"McInerney, Justin",22,11,3,11,0,0,0,2
Sydney,"Mills, Callum",35,22,2,13,0,0,0,4
Sydney,"Papley, Tom",9,5,1,4,2,1,0,1
Sydney,"Parker, Luke",30,10,4,20,0,1,0,5
Sydney,"Rampe, Dane",21,14,7,7,0,0,0,1
Sydney,"Rowbottom, James",0,0,0,0,0,0,0,0
Sydney,"Wicks, Sam",14,9,2,5,2,0,0,4
Sydney,"Amartey, Joel",6,4,2,2,1,1,4,2
Sydney,"Bell, James",9,5,4,4,1,0,0,2
Sydney,"Blakey, Nick",18,14,7,4,0,0,0,2
Sydney,"Cunningham, Harry",16,13,8,3,0,0,0,2
Sydney,"Dawson, Jordan",26,18,6,8,3,0,0,2
Sydney,"Florent, Oliver",17,7,7,10,1,1,0,1
Sydney,"Fox, Robbie",11,5,4,6,0,0,0,3
Sydney,"Franklin, Lance",10,9,7,1,1,3,0,1
Sydney,"Gulden, Errol",15,14,4,1,0,1,0,1
Sydney,"Hayward, Will",11,6,3,5,2,0,0,2
Sydney,"Heeney, Isaac",17,12,4,5,1,0,0,3
Sydney,"Hewett, George",13,3,3,10,0,0,0,4
Sydney,"Hickey, Tom",17,11,4,6,0,0,36,3
Sydney,"Kennedy, Josh",19,4,2,15,0,0,0,4
Sydney,"Lloyd, Jake",33,27,9,6,0,0,0,1
Sydney,"McCartin, Tom",16,11,10,5,0,0,0,2
Sydney,"McInerney, Justin",19,11,11,8,0,1,0,0
Sydney,"Mills, Callum",31,21,9,10,0,0,0,3
Sydney,"ORiordan, Colin",0,0,0,0,0,0,0,0
Sydney,"Papley, Tom",18,13,7,5,0,2,0,1
Sydney,"Parker, Luke",27,13,3,14,1,0,0,4
Sydney,"Rampe, Dane",18,12,7,6,0,0,0,1
Sydney,"Wicks, Sam",8,5,2,3,0,2,0,2
Sydney,"Amartey, Joel",7,4,1,3,0,0,13,3
Sydney,"Bell, James",5,1,1,4,0,0,0,1
Sydney,"Blakey, Nick",18,8,6,10,0,0,0,1
Sydney,"Dawson, Jordan",21,13,4,8,0,0,0,7
Sydney,"Florent, Oliver",17,9,4,8,0,0,0,3
Sydney,"Fox, Robbie",20,10,3,10,0,0,0,0
Sydney,"Franklin, Lance",11,9,6,2,4,2,0,1
Sydney,"Gulden, Errol",19,10,4,9,0,0,0,3
Sydney,"Hayward, Will",13,11,5,2,1,2,0,2
Sydney,"Heeney, Isaac",18,13,4,5,0,0,0,3
Sydney,"Hewett, George",30,10,2,20,0,0,0,6
Sydney,"Hickey, Tom",17,9,1,8,1,0,36,4
Sydney,"Kennedy, Josh",30,12,3,18,0,1,0,4
Sydney,"Lloyd, Jake",25,18,8,7,0,0,0,1
Sydney,"McCartin, Tom",15,12,10,3,0,0,0,0
Sydney,"McInerney, Justin",23,15,7,8,2,0,0,2
Sydney,"Papley, Tom",13,9,3,4,4,0,0,1
Sydney,"Parker, Luke",31,14,4,17,1,0,0,6
Sydney,"Rampe, Dane",17,11,6,6,0,0,0,2
Sydney,"Ronke, Ben",0,0,0,0,0,0,0,0
Sydney,"Rowbottom, James",8,5,0,3,0,0,0,1
Sydney,"Stephens, Dylan",12,4,3,8,0,0,0,1
Sydney,"Wicks, Sam",8,6,3,2,2,1,0,4
Sydney,"Bell, James",10,5,2,5,0,0,0,2
Sydney,"Blakey, Nick",15,11,6,4,0,1,0,2
Sydney,"Dawson, Jordan",23,16,7,7,0,0,0,1
Sydney,"Florent, Oliver",18,10,7,8,0,0,0,7
Sydney,"Fox, Robbie",21,14,4,7,0,0,0,1
Sydney,"Franklin, Lance",9,7,3,2,2,1,0,5
Sydney,"Gulden, Errol",23,15,5,8,1,0,0,5
Sydney,"Hayward, Will",12,6,5,6,1,1,0,5
Sydney,"Heeney, Isaac",22,15,11,7,5,1,0,2
Sydney,"Hewett, George",22,8,3,14,0,0,0,3
Sydney,"Hickey, Tom",18,12,4,6,1,1,21,3
Sydney,"Kennedy, Josh",34,10,6,24,0,1,0,7
Sydney,"Lloyd, Jake",32,19,6,13,0,0,0,1
Sydney,"McCartin, Tom",14,8,4,6,0,0,0,2
Sydney,"McInerney, Justin",14,11,6,3,0,0,0,1
Sydney,"McLean, Hayden",0,0,0,0,0,0,0,0
Sydney,"Papley, Tom",18,13,6,5,1,5,0,0
Sydney,"Parker, Luke",30,15,5,15,2,0,0,3
Sydney,"Rampe, Dane",21,19,8,2,0,0,0,1
Sydney,"Reid, Sam",8,4,4,4,0,0,3,5
Sydney,"Ronke, Ben",5,2,1,3,0,0,0,0
Sydney,"Rowbottom, James",12,8,2,4,1,0,0,5
Sydney,"Wicks, Sam",12,4,2,8,0,1,0,3
Sydney,"Bell, James",4,1,1,3,0,0,0,1
Sydney,"Blakey, Nick",15,9,6,6,1,0,0,0
Sydney,"Cunningham, Harry",14,11,7,3,0,0,0,3
Sydney,"Dawson, Jordan",24,17,11,7,0,1,0,4
Sydney,"Florent, Oliver",13,10,5,3,0,0,0,1
Sydney,"Fox, Robbie",13,9,2,4,0,0,0,4
Sydney,"Franklin, Lance",13,10,7,3,2,2,0,1
Sydney,"Gulden, Errol",14,6,3,8,1,0,0,2
Sydney,"Hayward, Will",11,7,4,4,2,0,0,0
Sydney,"Heeney, Isaac",17,14,9,3,0,0,0,3
Sydney,"Hewett, George",22,10,4,12,0,0,0,1
Sydney,"Hickey, Tom",14,7,4,7,1,0,24,0
Sydney,"Kennedy, Josh",22,11,3,11,1,0,0,3
Sydney,"Lloyd, Jake",27,17,7,10,0,0,0,1
Sydney,"McCartin, Tom",14,9,5,5,0,0,0,1
Sydney,"McInerney, Justin",28,14,8,14,0,0,0,2
Sydney,"Mills, Callum",33,21,12,12,1,0,0,6
Sydney,"Papley, Tom",17,12,3,5,4,1,0,0
Sydney,"Parker, Luke",26,9,5,17,2,0,0,4
Sydney,"Rampe, Dane",20,14,7,6,0,0,0,1
Sydney,"Reid, Sam",14,10,6,4,1,1,1,1
Sydney,"Stephens, Dylan",0,0,0,0,0,0,0,0
Sydney,"Wicks, Sam",10,3,1,7,1,0,0,3
Sydney,"Blakey, Nick",19,13,7,6,0,0,0,3
Sydney,"Clarke, Ryan",0,0,0,0,0,0,0,0
Sydney,"Cunningham, Harry",21,12,5,9,0,0,0,2
Sydney,"Dawson, Jordan",21,12,5,9,2,1,0,1
Sydney,"Florent, Oliver",18,15,4,3,1,0,0,0
Sydney,"Fox, Robbie",17,7,4,10,0,0,0,2
Sydney,"Franklin, Lance",5,4,0,1,1,1,0,3
Sydney,"Gulden, Errol",12,8,2,4,2,1,0,2
Sydney,"Hayward, Will",9,5,0,4,2,1,0,5
Sydney,"Heeney, Isaac",15,11,2,4,0,0,0,1
Sydney,"Hewett, George",18,4,1,14,0,0,0,5
Sydney,"Hickey, Tom",14,9,3,5,0,0,26,1
Sydney,"Kennedy, Josh",24,14,5,10,0,0,0,1
Sydney,"Lloyd, Jake",30,19,6,11,0,0,0,1
Sydney,"McCartin, Tom",16,6,2,10,0,0,0,1
Sydney,"McInerney, Justin",19,10,4,9,0,0,0,1
Sydney,"Papley, Tom",15,12,5,3,2,0,0,1
Sydney,"Parker, Luke",30,13,4,17,0,0,0,4
Sydney,"Rampe, Dane",15,11,7,4,0,0,0,1
Sydney,"Reid, Sam",11,6,5,5,0,0,9,4
Sydney,"Rowbottom, James",14,6,1,8,0,0,0,5
Sydney,"Stephens, Dylan",8,6,3,2,0,0,0,1
Sydney,"Wicks, Sam",6,4,2,2,0,0,0,0
Sydney,"Blakey, Nick",20,11,5,9,0,0,0,0
Sydney,"Campbell, Braeden",10,3,3,7,1,0,0,3
Sydney,"Cunningham, Harry",26,16,10,10,0,0,0,1
Sydney,"Dawson, Jordan",19,14,7,5,1,0,0,1
Sydney,"Florent, Oliver",19,16,2,3,1,0,0,2
Sydney,"Fox, Robbie",9,5,4,4,0,0,0,3
Sydney,"Gulden, Errol",14,9,2,5,1,0,0,1
Sydney,"Hayward, Will",17,14,11,3,3,3,0,3
Sydney,"Heeney, Isaac",14,7,6,7,1,2,0,3
Sydney,"Hewett, George",28,12,5,16,0,0,0,2
Sydney,"Hickey, Tom",18,14,5,4,0,0,23,1
Sydney,"Kennedy, Josh",25,12,2,13,0,1,0,5
Sydney,"McCartin, Tom",16,14,5,2,0,0,0,2
Sydney,"McInerney, Justin",15,9,6,6,0,0,0,0
Sydney,"McLean, Hayden",13,11,10,2,1,1,3,1
Sydney,"Melican, Lewis",14,10,5,4,0,0,0,1
Sydney,"ORiordan, Colin",4,4,2,0,0,0,0,1
Sydney,"Papley, Tom",12,7,0,5,2,2,0,3
Sydney,"Parker, Luke",25,15,3,10,1,0,0,8
Sydney,"Rampe, Dane",13,10,8,3,0,0,0,2
Sydney,"Reid, Sam",11,5,4,6,0,1,2,2
Sydney,"Rowbottom, James",17,11,3,6,0,0,0,3
Sydney,"Wicks, Sam",11,4,1,7,1,1,0,5
Sydney,"Campbell, Braeden",8,5,1,3,0,1,0,1
Sydney,"Cunningham, Harry",14,10,3,4,0,0,0,1
Sydney,"Dawson, Jordan",33,24,16,9,1,1,0,3
Sydney,"Florent, Oliver",21,14,7,7,0,0,0,0
Sydney,"Fox, Robbie",7,4,2,3,0,0,1,0
Sydney,"Franklin, Lance",13,9,7,4,6,2,0,5
Sydney,"Gulden, Errol",19,16,9,3,1,0,0,4
Sydney,"Hayward, Will",12,10,5,2,0,2,0,2
Sydney,"Heeney, Isaac",20,12,6,8,3,1,0,2
Sydney,"Hewett, George",23,10,6,13,0,0,0,6
Sydney,"Hickey, Tom",18,9,2,9,1,0,25,7
Sydney,"Lloyd, Jake",36,22,8,14,0,0,0,0
Sydney,"McCartin, Tom",12,8,5,4,0,0,0,0
Sydney,"McInerney, Justin",29,22,13,7,0,0,0,0
Sydney,"McLean, Hayden",10,8,6,2,2,1,6,4
Sydney,"Melican, Lewis",10,8,1,2,0,0,0,2
Sydney,"Mills, Callum",18,5,5,13,1,0,0,4
Sydney,"ORiordan, Colin",12,8,4,4,0,0,0,1
Sydney,"Papley, Tom",15,13,7,2,3,1,0,0
Sydney,"Parker, Luke",23,11,3,12,0,0,0,5
Sydney,"Rampe, Dane",17,13,4,4,0,0,0,1
Sydney,"Rowbottom, James",18,9,5,9,1,0,0,1
Sydney,"Wicks, Sam",9,5,4,4,2,0,0,2
Sydney,"Bell, James",6,5,3,1,1,1,0,4
Sydney,"Cunningham, Harry",12,8,4,4,0,0,0,2
Sydney,"Dawson, Jordan",18,12,8,6,0,0,0,6
Sydney,"Florent, Oliver",16,9,0,7,0,1,0,3
Sydney,"Fox, Robbie",2,0,0,2,0,0,0,2
Sydney,"Franklin, Lance",14,9,5,5,3,1,0,0
Sydney,"Gulden, Errol",14,13,5,1,0,0,0,2
Sydney,"Hayward, Will",12,8,6,4,0,2,0,1
Sydney,"Heeney, Isaac",21,11,5,10,4,1,0,2
Sydney,"Hewett, George",19,6,4,13,0,0,0,13
Sydney,"Hickey, Tom",15,11,5,4,0,1,33,0
Sydney,"Lloyd, Jake",21,17,4,4,0,0,0,0
Sydney,"McCartin, Tom",8,6,7,2,0,0,0,0
Sydney,"McInerney, Justin",14,6,1,8,0,0,1,0
Sydney,"McLean, Hayden",9,5,2,4,0,1,11,4
Sydney,"Melican, Lewis",17,12,8,5,0,0,0,1
Sydney,"ORiordan, Colin",6,4,1,2,0,0,0,1
Sydney,"Papley, Tom",16,12,4,4,2,0,0,1
Sydney,"Parker, Luke",34,17,5,17,0,1,0,5
Sydney,"Rampe, Dane",21,11,3,10,0,0,0,6
Sydney,"Rowbottom, James",15,9,1,6,0,1,0,9
Sydney,"Warner, Chad",11,4,2,7,0,0,0,1
Sydney,"Wicks, Sam",11,7,3,4,0,1,0,5
West Coast,"Allen, Oscar",13,11,8,2,4,0,0,2
West Coast,"Barrass, Tom",22,15,13,7,0,0,0,2
West Coast,"Cole, Tom",22,14,8,8,0,0,0,1
West Coast,"Cripps, Jamie",20,12,8,8,1,3,0,1
West Coast,"Darling, Jack",14,8,4,6,2,1,0,3
West Coast,"Duggan, Liam",22,15,7,7,0,0,0,0
West Coast,"Gaff, Andrew",16,12,8,4,0,1,0,1
West Coast,"Hurn, Shannon",31,23,12,8,0,0,0,2
West Coast,"Jones, Jamaine",0,0,0,0,0,0,0,0
West Coast,"Kelly, Tim",28,19,7,9,0,1,0,3
West Coast,"Kennedy, Josh",10,8,5,2,2,2,0,1
West Coast,"Langdon, Zac",12,6,6,6,0,1,0,1
West Coast,"McGovern, Jeremy",18,15,7,3,0,0,0,2
West Coast,"Naitanui, Nic",14,4,0,10,0,1,22,1
West Coast,"Nelson, Jackson",19,14,5,5,0,0,0,1
West Coast,"ONeill, Xavier",18,9,2,9,0,0,0,2
West Coast,"Petruccelle, Jack",6,3,1,3,1,0,0,1
West Coast,"Redden, Jack",22,11,7,11,0,0,0,2
West Coast,"Rotham, Josh",16,12,9,4,0,0,0,2
West Coast,"Ryan, Liam",12,10,4,2,1,0,0,2
West Coast,"Sheed, Dom",34,23,12,11,0,1,0,3
West Coast,"Sheppard, Brad",18,13,8,5,0,0,0,1
West Coast,"Vardy, Nathan",3,2,3,1,1,0,1,0
West Coast,"Ah Chee, Brendon",0,0,0,0,0,0,0,0
West Coast,"Allen, Oscar",4,4,4,0,2,1,0,3
West Coast,"Barrass, Tom",17,15,10,2,0,0,0,0
West Coast,"Cole, Tom",10,6,2,4,0,0,0,0
West Coast,"Cripps, Jamie",13,9,4,4,0,1,0,7
West Coast,"Darling, Jack",13,9,9,4,3,0,1,3
West Coast,"Duggan, Liam",25,18,8,7,0,0,0,3
West Coast,"Gaff, Andrew",16,11,3,5,0,0,0,2
West Coast,"Hurn, Shannon",25,23,7,2,0,0,0,0
West Coast,"Jones, Jamaine",8,7,1,1,3,0,0,3
West Coast,"Kelly, Tim",29,17,5,12,0,1,0,4
West Coast,"Kennedy, Josh",11,10,9,1,4,1,0,1
West Coast,"Langdon, Zac",8,3,2,5,0,1,0,3
West Coast,"McGovern, Jeremy",11,10,5,1,0,0,0,0
West Coast,"Naitanui, Nic",13,6,2,7,0,0,40,5
West Coast,"Nelson, Jackson",10,7,4,3,0,0,0,3
West Coast,"ONeill, Xavier",12,8,2,4,0,0,0,1
West Coast,"Redden, Jack",21,11,7,10,0,0,0,1
West Coast,"Rotham, Josh",15,12,9,3,0,0,0,0
West Coast,"Ryan, Liam",9,8,1,1,2,2,0,1
West Coast,"Sheed, Dom",26,16,4,10,0,1,0,3
West Coast,"Sheppard, Brad",12,8,4,4,0,0,0,2
West Coast,"Vardy, Nathan",4,1,0,3,0,0,11,1
West Coast,"Allen, Oscar",12,7,7,5,1,2,6,2
West Coast,"Barrass, Tom",11,9,7,2,0,0,0,1
West Coast,"Brander, Jarrod",21,13,6,8,1,2,0,1
West Coast,"Cole, Tom",17,12,6,5,0,0,0,1
West Coast,"Cripps, Jamie",14,5,1,9,2,1,0,3
West Coast,"Darling, Jack",16,10,7,6,3,0,0,3
West Coast,"Duggan, Liam",19,13,4,6,0,0,0,3
West Coast,"Gaff, Andrew",36,25,13,11,0,0,0,4
West Coast,"Hurn, Shannon",26,21,6,5,0,0,0,2
West Coast,"Jones, Jamaine",4,3,1,1,0,0,0,3
West Coast,"Kelly, Tim",28,17,6,11,1,1,0,1
West Coast,"Kennedy, Josh",9,6,5,3,4,1,0,0
West Coast,"Langdon, Zac",1,0,0,1,0,0,0,0
West Coast,"McGovern, Jeremy",18,13,11,5,0,0,0,1
West Coast,"Naitanui, Nic",11,5,1,6,0,0,26,2
West Coast,"Nelson, Jackson",25,21,10,4,0,0,0,0
West Coast,"Petruccelle, Jack",8,5,4,3,1,0,0,4
West Coast,"Redden, Jack",31,14,6,17,0,0,0,3
West Coast,"Rotham, Josh",19,13,11,6,0,1,0,0
West Coast,"Ryan, Liam",13,11,5,2,2,1,0,1
West Coast,"Sheed, Dom",24,13,5,11,1,1,0,4
West Coast,"Sheppard, Brad",21,14,13,7,0,0,0,1
West Coast,"Shuey, Luke",28,22,7,6,0,1,0,6
West Coast,"Allen, Oscar",14,9,4,5,2,0,6,3
West Coast,"Barrass, Tom",14,11,9,3,0,0,0,2
West Coast,"Brander, Jarrod",16,11,5,5,0,2,0,2
West Coast,"Cole, Tom",17,12,5,5,0,0,0,1
West Coast,"Cripps, Jamie",15,10,3,5,1,0,0,7
West Coast,"Darling, Jack",6,4,2,2,2,0,2,1
West Coast,"Duggan, Liam",19,12,6,7,0,0,0,5
West Coast,"Gaff, Andrew",21,11,8,10,0,0,0,2
West Coast,"Hurn, Shannon",1,1,1,0,0,0,0,0
West Coast,"Jones, Jamaine",5,3,1,2,0,0,0,2
West Coast,"Kelly, Tim",23,11,3,12,0,0,0,6
West Coast,"Kennedy, Josh",11,9,6,2,2,0,1,0
West Coast,"McGovern, Jeremy",22,20,10,2,0,0,0,0
West Coast,"Naitanui, Nic",14,7,2,7,0,0,36,3
West Coast,"Nelson, Jackson",16,14,6,2,0,0,0,1
West Coast,"Petruccelle, Jack",13,10,4,3,4,0,0,3
West Coast,"Redden, Jack",22,5,4,17,0,0,0,5
West Coast,"Rotham, Josh",15,12,8,3,0,0,0,1
West Coast,"Ryan, Liam",9,6,3,3,1,0,0,3
West Coast,"Sheed, Dom",22,11,2,11,0,0,0,1
West Coast,"Sheppard, Brad",17,11,6,6,0,0,0,2
West Coast,"Waterman, Jake",8,6,3,2,0,0,0,2
West Coast,"Winder, Isiah",5,2,1,3,1,0,0,1
West Coast,"Allen, Oscar",13,10,6,3,5,1,0,2
West Coast,"Barrass, Tom",15,12,11,3,0,0,0,0
West Coast,"Brander, Jarrod",18,11,7,7,1,0,0,1
West Coast,"Cole, Tom",12,10,6,2,0,0,0,3
West Coast,"Cripps, Jamie",10,8,2,2,0,1,0,7
West Coast,"Darling, Jack",15,9,4,6,5,1,1,1
West Coast,"Duggan, Liam",36,29,13,7,0,0,0,2
West Coast,"Gaff, Andrew",38,23,10,15,0,0,0,2
West Coast,"Jones, Jamaine",0,0,0,0,0,0,0,0
West Coast,"Kelly, Tim",28,11,1,17,1,1,0,3
West Coast,"Kennedy, Josh",6,6,3,0,1,1,0,0
West Coast,"Langdon, Zac",13,6,2,7,0,0,0,3
West Coast,"McGovern, Jeremy",20,15,9,5,0,0,0,3
West Coast,"Naitanui, Nic",14,1,2,13,0,0,19,5
West Coast,"Nelson, Jackson",11,8,2,3,0,1,0,3
West Coast,"ONeill, Xavier",10,6,2,4,0,0,0,2
West Coast,"Redden, Jack",37,23,10,14,0,0,0,4
West Coast,"Rotham, Josh",23,20,15,3,0,0,0,0
West Coast,"Sheed, Dom",28,15,5,13,3,0,0,1
West Coast,"Sheppard, Brad",21,14,8,7,0,0,0,2
West Coast,"Vardy, Nathan",2,0,1,2,0,0,8,2
West Coast,"Waterman, Jake",14,10,8,4,0,0,0,1
West Coast,"Witherden, Alex",30,21,9,9,0,0,0,4
West Coast,"Ainsworth, Brayden",4,0,1,4,0,0,0,0
West Coast,"Allen, Oscar",8,8,3,0,2,2,0,3
West Coast,"Barrass, Tom",9,5,3,4,0,0,0,0
West Coast,"Brander, Jarrod",12,6,1,6,1,0,0,0
West Coast,"Cole, Tom",9,7,4,2,0,0,0,2
West Coast,"Cripps, Jamie",10,7,1,3,0,2,0,5
West Coast,"Darling, Jack",12,9,8,3,1,2,2,4
West Coast,"Duggan, Liam",10,6,3,4,0,0,0,2
West Coast,"Gaff, Andrew",27,18,7,9,0,0,0,2
West Coast,"Jones, Jamaine",6,4,2,2,0,0,0,5
West Coast,"Kelly, Tim",16,8,1,8,0,0,0,3
West Coast,"Langdon, Zac",9,6,4,3,0,0,0,2
West Coast,"McGovern, Jeremy",7,5,4,2,0,0,0,0
West Coast,"Naitanui, Nic",13,10,0,3,0,0,25,3
West Coast,"Nelson, Jackson",13,9,2,4,0,0,0,0
West Coast,"ONeill, Xavier",14,8,2,6,0,0,0,2
West Coast,"Redden, Jack",20,9,1,11,0,0,0,5
West Coast,"Rotham, Josh",8,6,0,2,0,0,0,0
West Coast,"Sheed, Dom",14,9,3,5,0,1,0,4
West Coast,"Sheppard, Brad",13,8,2,5,0,0,0,2
West Coast,"Vardy, Nathan",4,3,2,1,1,0,18,3
West Coast,"Waterman, Jake",6,4,2,2,0,0,0,4
West Coast,"Witherden, Alex",18,15,8,3,0,0,0,0
West Coast,"Ainsworth, Brayden",0,0,0,0,0,0,0,0
West Coast,"Allen, Oscar",11,7,6,4,0,0,0,0
West Coast,"Brander, Jarrod",16,14,9,2,2,0,0,2
West Coast,"Cole, Tom",17,8,4,9,0,0,0,1
West Coast,"Cripps, Jamie",19,9,5,10,2,2,0,4
West Coast,"Darling, Jack",17,11,9,6,3,2,1,5
West Coast,"Duggan, Liam",19,12,7,7,0,0,0,1
West Coast,"Edwards, Harry",14,11,8,3,0,0,0,1
West Coast,"Gaff, Andrew",35,16,6,19,1,0,0,1
West Coast,"Jones, Jamaine",21,10,3,11,2,0,0,3
West Coast,"Kelly, Tim",42,21,0,21,0,2,0,9
West Coast,"Kennedy, Josh",13,8,5,5,3,0,0,0
West Coast,"Langdon, Zac",16,7,4,9,2,2,0,0
West Coast,"Naitanui, Nic",15,7,2,8,0,0,21,7
West Coast,"Nelson, Jackson",11,10,5,1,0,0,0,0
West Coast,"Petruccelle, Jack",9,6,2,3,1,1,0,0
West Coast,"Redden, Jack",29,16,5,13,0,0,0,3
West Coast,"Rotham, Josh",17,14,12,3,0,0,0,0
West Coast,"Sheed, Dom",30,15,6,15,0,0,0,3
West Coast,"Sheppard, Brad",21,15,8,6,0,0,0,2
West Coast,"Vardy, Nathan",5,4,1,1,1,0,12,0
West Coast,"Waterman, Jake",15,13,8,2,3,0,0,1
West Coast,"Witherden, Alex",17,15,4,2,0,0,0,4
West Coast,"Ah Chee, Brendon",17,12,5,5,4,0,0,4
West Coast,"Allen, Oscar",14,6,4,8,0,0,0,0
West Coast,"Brander, Jarrod",19,15,9,4,0,0,0,0
West Coast,"Cole, Tom",13,6,4,7,0,0,0,3
West Coast,"Cripps, Jamie",11,9,2,2,0,1,0,5
West Coast,"Darling, Jack",17,15,9,2,2,2,5,3
West Coast,"Edwards, Harry",5,2,2,3,0,0,0,3
West Coast,"Foley, Luke",1,1,1,0,0,0,0,0
West Coast,"Gaff, Andrew",38,25,12,13,0,0,0,0
West Coast,"Jones, Jamaine",14,10,3,4,1,0,0,6
West Coast,"Kelly, Tim",25,16,10,9,1,0,0,3
West Coast,"Kennedy, Josh",12,7,7,5,1,2,0,1
West Coast,"Langdon, Zac",11,4,3,7,1,0,0,4
West Coast,"Naitanui, Nic",12,8,0,4,0,0,29,2
West Coast,"Nelson, Jackson",17,13,3,4,0,0,0,1
West Coast,"Petruccelle, Jack",13,6,2,7,2,0,0,4
West Coast,"Redden, Jack",31,11,3,20,0,0,0,1
West Coast,"Rotham, Josh",12,9,8,3,0,0,0,1
West Coast,"Sheed, Dom",35,21,10,14,0,0,0,4
West Coast,"Sheppard, Brad",27,18,12,9,0,0,0,0
West Coast,"Waterman, Jake",7,6,6,1,1,0,0,4
West Coast,"Williams, Bailey",9,7,5,2,1,2,5,0
West Coast,"Witherden, Alex",22,19,6,3,0,0,0,0
West Coast,"Ah Chee, Brendon",12,4,3,8,0,0,0,5
West Coast,"Allen, Oscar",11,7,4,4,3,0,0,1
West Coast,"Barrass, Tom",14,12,7,2,0,0,0,0
West Coast,"Brander, Jarrod",19,14,4,5,0,2,0,0
West Coast,"Cole, Tom",14,11,4,3,0,0,0,3
West Coast,"Cripps, Jamie",25,16,10,9,1,0,0,3
West Coast,"Darling, Jack",15,11,8,4,5,2,1,1
West Coast,"Gaff, Andrew",30,19,7,11,0,0,0,3
West Coast,"Jones, Jamaine",7,3,2,4,1,0,0,7
West Coast,"Kelly, Tim",31,13,3,18,0,0,0,3
West Coast,"Kennedy, Josh",7,6,4,1,3,1,0,1
West Coast,"Langdon, Zac",0,0,0,0,0,0,0,0
West Coast,"McGovern, Jeremy",22,16,10,6,0,0,0,1
West Coast,"Naitanui, Nic",13,7,4,6,0,1,31,3
West Coast,"Nelson, Jackson",13,5,2,8,0,0,0,1
West Coast,"Petruccelle, Jack",14,6,3,8,1,0,0,0
West Coast,"Redden, Jack",26,6,7,20,0,0,0,7
West Coast,"Rotham, Josh",24,18,10,6,0,0,0,1
West Coast,"Sheed, Dom",23,14,6,9,0,1,0,2
West Coast,"Sheppard, Brad",17,9,3,8,0,0,0,5
West Coast,"Waterman, Jake",17,14,12,3,2,1,0,0
West Coast,"Williams, Bailey",5,4,2,1,0,1,9,1
West Coast,"Witherden, Alex",30,26,12,4,0,0,0,2
West Coast,"Ah Chee, Brendon",14,2,0,12,0,1,0,0
West Coast,"Allen, Oscar",15,8,6,7,1,1,0,2
West Coast,"Barrass, Tom",12,10,5,2,0,0,0,2
West Coast,"Brander, Jarrod",10,7,3,3,0,0,0,3
West Coast,"Cole, Tom",9,8,4,1,0,0,0,1
West Coast,"Cripps, Jamie",11,10,1,1,2,1,0,3
West Coast,"Darling, Jack",15,8,6,7,1,2,0,3
West Coast,"Edwards, Harry",7,4,2,3,0,0,0,1
West Coast,"Gaff, Andrew",28,16,5,12,0,0,0,1
West Coast,"Hurn, Shannon",21,13,2,8,0,0,0,4
West Coast,"Jones, Jamaine",0,0,0,0,0,0,0,0
West Coast,"Kelly, Tim",22,10,1,12,1,0,0,3
West Coast,"Kennedy, Josh",10,7,6,3,1,2,0,0
West Coast,"Naitanui, Nic",15,6,1,9,0,1,35,6
West Coast,"Nelson, Jackson",9,7,3,2,0,0,0,1
West Coast,"Petruccelle, Jack",14,11,5,3,2,0,0,1
West Coast,"Redden, Jack",22,6,3,16,1,0,0,4
West Coast,"Rotham, Josh",13,12,3,1,0,0,0,2
West Coast,"Ryan, Liam",8,5,2,3,0,1,0,1
West Coast,"Sheed, Dom",21,12,3,9,0,0,0,2
West Coast,"Sheppard, Brad",13,6,3,7,0,0,0,1
West Coast,"Waterman, Jake",8,4,4,4,1,0,0,3
West Coast,"Williams, Bailey",6,5,4,1,1,0,12,2
West Coast,"Ah Chee, Brendon",12,4,0,8,1,0,0,2
West Coast,"Allen, Oscar",7,6,3,1,0,0,0,0
West Coast,"Barrass, Tom",14,11,7,3,0,0,1,0
West Coast,"Brander, Jarrod",12,7,1,5,0,0,0,0
West Coast,"Cole, Tom",17,10,6,7,0,0,0,4
West Coast,"Cripps, Jamie",12,7,1,5,1,1,0,2
West Coast,"Darling, Jack",7,3,3,4,1,0,0,0
West Coast,"Gaff, Andrew",31,12,1,19,0,0,0,1
West Coast,"Hurn, Shannon",24,19,6,5,0,0,0,2
West Coast,"Jones, Jamaine",6,3,1,3,0,0,0,3
West Coast,"Kelly, Tim",11,5,2,6,0,0,0,0
West Coast,"Kennedy, Josh",8,6,4,2,3,1,0,1
West Coast,"Naitanui, Nic",20,11,1,9,0,0,40,6
West Coast,"Nelson, Jackson",23,15,5,8,0,0,0,0
West Coast,"Petruccelle, Jack",15,5,3,10,1,1,0,2
West Coast,"Redden, Jack",26,11,4,15,0,0,0,5
West Coast,"Rotham, Josh",20,14,11,6,0,0,0,2
West Coast,"Ryan, Liam",8,7,3,1,1,0,0,0
West Coast,"Sheed, Dom",43,28,4,15,1,0,0,1
West Coast,"Sheppard, Brad",18,14,7,4,0,0,0,2
West Coast,"Waterman, Jake",12,8,1,4,2,1,0,5
West Coast,"Williams, Bailey",4,2,1,2,0,0,11,3
West Coast,"Yeo, Elliot",14,10,3,4,0,1,0,4
West Coast,"Barrass, Tom",15,13,8,2,0,0,0,0
West Coast,"Cole, Tom",11,8,5,3,0,0,0,2
West Coast,"Cripps, Jamie",12,10,5,2,1,0,0,1
West Coast,"Darling, Jack",12,9,4,3,1,0,0,3
West Coast,"Edwards, Harry",15,12,9,3,0,0,0,3
West Coast,"Edwards, Luke",15,8,3,7,0,0,0,2
West Coast,"Foley, Luke",16,13,5,3,1,0,0,1
West Coast,"Gaff, Andrew",30,17,5,13,1,0,0,0
West Coast,"Hurn, Shannon",27,21,9,6,0,0,0,1
West Coast,"Jones, Jamaine",8,6,3,2,2,2,0,4
West Coast,"Langdon, Zac",20,10,4,10,1,0,0,2
West Coast,"Naitanui, Nic",15,9,2,6,0,1,33,1
West Coast,"Nelson, Jackson",13,11,5,2,0,0,0,4
West Coast,"ONeill, Xavier",14,8,5,6,1,1,0,3
West Coast,"Petruccelle, Jack",8,4,3,4,0,1,0,0
West Coast,"Redden, Jack",22,11,7,11,1,0,0,10
West Coast,"Rotham, Josh",15,14,9,1,0,0,0,1
West Coast,"Ryan, Liam",17,15,9,2,4,0,0,1
West Coast,"Sheed, Dom",32,20,8,12,1,0,0,2
West Coast,"Sheppard, Brad",3,2,0,1,0,0,0,0
West Coast,"Waterman, Jake",14,11,6,3,0,1,0,1
West Coast,"Williams, Bailey",6,2,1,4,0,0,5,0
West Coast,"Yeo, Elliot",18,13,1,5,0,0,0,7
West Coast,"Allen, Oscar",13,11,4,2,2,2,8,1
West Coast,"Barrass, Tom",11,10,8,1,0,0,0,0
West Coast,"Cole, Tom",13,9,5,4,0,0,0,0
West Coast,"Cripps, Jamie",13,9,4,4,2,0,0,2
West Coast,"Darling, Jack",7,4,3,3,0,0,0,0
West Coast,"Duggan, Liam",9,8,5,1,0,0,0,2
West Coast,"Edwards, Harry",14,7,3,7,0,0,0,4
West Coast,"Edwards, Luke",27,13,5,14,0,0,0,1
West Coast,"Foley, Luke",22,13,7,9,0,0,0,3
West Coast,"Gaff, Andrew",23,11,3,12,0,0,0,2
West Coast,"Hurn, Shannon",25,22,10,3,0,0,0,1
West Coast,"Jones, Jamaine",8,4,2,4,1,0,0,2
West Coast,"Kennedy, Josh",15,12,7,3,4,0,0,3
West Coast,"Langdon, Zac",16,10,9,6,0,1,0,2
West Coast,"Naitanui, Nic",20,9,3,11,1,1,31,3
West Coast,"Nelson, Jackson",11,8,4,3,0,0,0,2
West Coast,"ONeill, Xavier",0,0,0,0,0,0,0,0
West Coast,"Redden, Jack",32,16,12,16,0,0,0,2
West Coast,"Rotham, Josh",15,10,6,5,0,0,0,1
West Coast,"Ryan, Liam",7,7,2,0,1,0,0,2
West Coast,"Sheed, Dom",25,8,4,17,0,0,0,2
West Coast,"Waterman, Jake",7,7,4,0,2,0,0,1
West Coast,"Yeo, Elliot",20,15,2,5,0,0,0,5
West Coast,"Allen, Oscar",7,6,3,1,2,1,6,3
West Coast,"Barrass, Tom",22,13,7,9,0,0,0,2
West Coast,"Cole, Tom",15,11,7,4,0,0,0,3
West Coast,"Cripps, Jamie",9,5,3,4,1,0,0,2
West Coast,"Darling, Jack",11,8,7,3,0,0,0,3
West Coast,"Duggan, Liam",15,12,7,3,0,0,0,0
West Coast,"Edwards, Luke",5,5,3,0,0,0,0,2
West Coast,"Gaff, Andrew",16,11,7,5,1,0,0,1
West Coast,"Hurn, Shannon",26,22,8,4,0,0,0,3
West Coast,"Kelly, Tim",14,8,2,6,0,0,0,0
West Coast,"Kennedy, Josh",9,6,5,3,1,2,0,1
West Coast,"McGovern, Jeremy",17,15,9,2,0,0,0,2
West Coast,"Naitanui, Nic",20,11,1,9,0,1,39,1
West Coast,"Nelson, Jackson",0,0,0,0,0,0,0,0
West Coast,"Petruccelle, Jack",10,7,5,3,1,0,0,4
West Coast,"Redden, Jack",20,14,10,6,0,0,0,6
West Coast,"Rotham, Josh",23,17,12,6,0,0,0,0
West Coast,"Ryan, Liam",8,5,1,3,0,0,0,4
West Coast,"Sheed, Dom",20,13,2,7,0,1,0,3
West Coast,"Sheppard, Brad",24,15,12,9,0,0,0,2
West Coast,"Shuey, Luke",20,13,4,7,0,0,0,2
West Coast,"Waterman, Jake",15,11,10,4,0,1,0,2
West Coast,"Yeo, Elliot",19,10,2,9,0,0,0,3
West Coast,"Allen, Oscar",10,6,5,4,0,1,0,2
West Coast,"Barrass, Tom",15,9,6,6,0,0,0,0
West Coast,"Cole, Tom",16,12,3,4,0,0,0,6
West Coast,"Cripps, Jamie",11,5,3,6,0,1,0,4
West Coast,"Darling, Jack",18,10,7,8,1,2,1,1
West Coast,"Duggan, Liam",22,10,5,12,0,0,0,5
West Coast,"Edwards, Luke",12,6,3,6,0,0,0,0
West Coast,"Foley, Luke",10,6,2,4,0,0,0,1
West Coast,"Hurn, Shannon",24,18,8,6,0,0,0,2
West Coast,"Jones, Jamaine",7,6,1,1,0,1,0,1
West Coast,"Kelly, Tim",27,12,2,15,0,1,0,6
West Coast,"Kennedy, Josh",7,5,2,2,1,0,0,1
West Coast,"Langdon, Zac",13,5,2,8,0,0,0,2
West Coast,"McGovern, Jeremy",18,15,6,3,0,0,0,2
West Coast,"Naitanui, Nic",15,2,1,13,0,0,25,5
West Coast,"Petruccelle, Jack",5,2,1,3,0,0,0,0
West Coast,"Redden, Jack",6,2,0,4,0,0,0,1
West Coast,"Sheed, Dom",37,20,6,17,0,0,0,5
West Coast,"Sheppard, Brad",14,9,7,5,0,0,0,1
West Coast,"Shuey, Luke",19,10,1,9,0,0,0,4
West Coast,"Vardy, Nathan",6,2,1,4,0,0,13,2
West Coast,"Witherden, Alex",14,12,6,2,0,0,0,1
West Coast,"Yeo, Elliot",26,16,5,10,1,1,0,8
West Coast,"Ah Chee, Brendon",13,7,4,6,0,1,0,3
West Coast,"Allen, Oscar",8,6,5,2,2,0,1,2
West Coast,"Barrass, Tom",7,7,4,0,0,0,0,1
West Coast,"Cole, Tom",12,9,3,3,0,0,0,0
West Coast,"Cripps, Jamie",14,9,4,5,0,2,0,4
West Coast,"Darling, Jack",9,5,2,4,0,0,1,2
West Coast,"Duggan, Liam",17,12,6,5,0,0,0,4
West Coast,"Edwards, Luke",0,0,0,0,0,0,0,0
West Coast,"Gaff, Andrew",26,19,4,7,0,0,0,2
West Coast,"Hurn, Shannon",25,20,10,5,0,0,0,1
West Coast,"Kelly, Tim",25,16,4,9,1,0,0,6
West Coast,"Kennedy, Josh",9,5,2,4,2,3,1,3
West Coast,"Langdon, Zac",9,6,5,3,1,0,0,1
West Coast,"McGovern, Jeremy",12,8,5,4,0,0,0,0
West Coast,"Naitanui, Nic",20,11,2,9,0,0,37,1
West Coast,"Nelson, Jackson",8,6,6,2,0,0,0,1
West Coast,"Petruccelle, Jack",12,9,6,3,0,0,0,2
West Coast,"Rotham, Josh",19,15,12,4,0,0,0,0
West Coast,"Ryan, Liam",9,7,4,2,2,0,0,1
West Coast,"Sheed, Dom",27,11,4,16,0,0,0,3
West Coast,"Sheppard, Brad",23,11,6,12,0,0,0,1
West Coast,"Shuey, Luke",18,11,3,7,0,0,0,5
West Coast,"Yeo, Elliot",17,8,2,9,0,1,0,5
West Coast,"Allen, Oscar",6,5,3,1,1,1,0,3
West Coast,"Cole, Tom",13,10,6,3,0,0,0,5
West Coast,"Cripps, Jamie",25,14,4,11,5,2,0,4
West Coast,"Darling, Jack",12,6,4,6,1,0,0,5
West Coast,"Duggan, Liam",19,16,8,3,0,0,0,0
West Coast,"Edwards, Harry",7,5,3,2,0,0,0,1
West Coast,"Edwards, Luke",19,12,6,7,0,0,0,2
West Coast,"Gaff, Andrew",34,21,8,13,0,0,0,0
West Coast,"Hurn, Shannon",24,23,9,1,0,0,0,4
West Coast,"Kelly, Tim",26,15,3,11,0,0,0,5
West Coast,"Langdon, Zac",15,3,6,12,0,1,0,3
West Coast,"McGovern, Jeremy",19,14,10,5,0,0,0,0
West Coast,"Naitanui, Nic",11,4,1,7,0,0,32,2
West Coast,"Nelson, Jackson",1,0,0,1,0,0,0,1
West Coast,"Petruccelle, Jack",20,14,8,6,2,2,0,1
West Coast,"Rotham, Josh",12,7,6,5,0,0,0,2
West Coast,"Ryan, Liam",16,14,10,2,3,4,0,2
West Coast,"Sheed, Dom",17,11,4,6,0,0,0,0
West Coast,"Sheppard, Brad",19,13,9,6,0,0,0,2
West Coast,"Shuey, Luke",16,11,1,5,0,0,0,5
West Coast,"West, Connor",19,13,4,6,0,1,0,4
West Coast,"Williams, Bailey",5,3,2,2,1,0,8,2
West Coast,"Yeo, Elliot",22,11,3,11,1,1,0,4
West Coast,"Allen, Oscar",5,4,1,1,0,1,1,2
West Coast,"Brander, Jarrod",11,2,3,9,0,0,0,0
West Coast,"Cole, Tom",10,8,4,2,0,0,0,2
West Coast,"Cripps, Jamie",17,13,7,4,1,2,0,2
West Coast,"Darling, Jack",6,5,4,1,3,0,0,4
West Coast,"Duggan, Liam",20,18,9,2,0,0,0,2
West Coast,"Edwards, Harry",16,13,12,3,0,0,0,1
West Coast,"Gaff, Andrew",29,19,10,10,0,0,0,1
West Coast,"Hurn, Shannon",21,15,9,6,0,0,0,1
West Coast,"Hutchings, Mark",9,7,3,2,0,0,0,1
West Coast,"Kelly, Tim",26,19,5,7,1,0,0,1
West Coast,"Kennedy, Josh",11,9,8,2,3,0,0,2
West Coast,"Langdon, Zac",14,7,2,7,1,0,0,3
West Coast,"McGovern, Jeremy",10,9,3,1,0,0,9,1
West Coast,"Naitanui, Nic",12,7,3,5,1,1,24,2
West Coast,"ONeill, Xavier",7,3,1,4,0,0,0,4
West Coast,"Rotham, Josh",15,10,9,5,0,0,0,1
West Coast,"Ryan, Liam",2,2,0,0,1,0,0,0
West Coast,"Sheed, Dom",32,15,6,17,2,0,0,0
West Coast,"Sheppard, Brad",17,12,5,5,0,0,0,1
West Coast,"Waterman, Jake",16,12,12,4,1,3,0,1
West Coast,"West, Connor",11,8,3,3,0,1,0,2
West Coast,"Yeo, Elliot",24,11,3,13,0,1,0,5
West Coast,"Allen, Oscar",8,6,5,2,0,0,2,1
West Coast,"Cole, Tom",14,4,3,10,0,0,0,0
West Coast,"Cripps, Jamie",14,9,5,5,2,1,0,5
West Coast,"Darling, Jack",8,6,5,2,1,0,1,1
West Coast,"Duggan, Liam",13,7,6,6,0,0,0,1
West Coast,"Edwards, Harry",10,9,7,1,0,0,0,1
West Coast,"Gaff, Andrew",33,16,7,17,0,0,0,0
West Coast,"Hurn, Shannon",19,13,5,6,0,0,0,1
West Coast,"Hutchings, Mark",0,0,0,0,0,0,0,0
West Coast,"Kelly, Tim",20,11,4,9,0,0,0,1
West Coast,"Kennedy, Josh",14,9,4,5,1,4,0,1
West Coast,"Langdon, Zac",17,4,5,13,0,0,0,2
West Coast,"McGovern, Jeremy",19,15,7,4,0,0,0,2
West Coast,"Naitanui, Nic",17,7,2,10,0,0,24,0
West Coast,"ONeill, Xavier",9,5,2,4,0,0,0,1
West Coast,"Petruccelle, Jack",7,6,4,1,0,2,0,2
West Coast,"Redden, Jack",21,9,6,12,0,0,0,0
West Coast,"Rotham, Josh",11,9,3,2,0,0,0,0
West Coast,"Sheed, Dom",23,13,3,10,1,0,0,2
West Coast,"Sheppard, Brad",22,12,4,10,0,0,0,1
West Coast,"Waterman, Jake",22,14,9,8,0,1,0,2
West Coast,"West, Connor",13,4,4,9,0,1,0,5
West Coast,"Yeo, Elliot",20,9,1,11,1,0,0,3
West Coast,"Allen, Oscar",14,12,6,2,0,2,1,3
West Coast,"Cole, Tom",12,8,5,4,0,0,0,2
West Coast,"Cripps, Jamie",12,7,2,5,2,2,0,2
West Coast,"Darling, Jack",13,10,5,3,2,1,0,2
West Coast,"Edwards, Harry",9,7,5,2,0,0,0,4
West Coast,"Edwards, Luke",9,5,1,4,0,0,0,0
West Coast,"Gaff, Andrew",23,14,4,9,0,0,0,1
West Coast,"Hurn, Shannon",8,6,1,2,0,0,0,0
West Coast,"Hutchings, Mark",16,9,3,7,0,0,0,6
West Coast,"Kelly, Tim",26,11,3,15,0,1,0,4
West Coast,"Kennedy, Josh",10,7,4,3,2,0,0,3
West Coast,"Langdon, Zac",7,3,1,4,0,1,0,2
West Coast,"McGovern, Jeremy",17,13,7,4,0,0,0,0
West Coast,"Naitanui, Nic",12,7,2,5,1,0,29,3
West Coast,"Nelson, Jackson",12,10,6,2,0,0,0,3
West Coast,"Petruccelle, Jack",8,5,3,3,0,1,0,1
West Coast,"Redden, Jack",30,19,8,11,1,0,0,3
West Coast,"Sheed, Dom",27,12,4,15,0,0,0,4
West Coast,"Sheppard, Brad",11,5,4,6,0,0,0,3
West Coast,"Vardy, Nathan",3,3,2,0,0,0,10,1
West Coast,"West, Connor",10,6,3,4,1,0,0,0
West Coast,"Witherden, Alex",20,18,3,2,0,0,0,1
West Coast,"Yeo, Elliot",31,18,1,13,0,0,0,7
West Coast,"Allen, Oscar",12,10,10,2,0,1,0,3
West Coast,"Barrass, Tom",14,9,7,5,0,0,0,0
West Coast,"Cole, Tom",18,14,7,4,0,0,0,2
West Coast,"Cripps, Jamie",14,12,4,2,0,3,0,9
West Coast,"Darling, Jack",13,9,7,4,2,2,0,2
West Coast,"Edwards, Luke",13,8,5,5,0,1,0,3
West Coast,"Foley, Luke",13,10,4,3,0,0,0,0
West Coast,"Gaff, Andrew",32,17,9,15,0,0,0,4
West Coast,"Kelly, Tim",7,5,0,2,0,0,0,3
West Coast,"Kennedy, Josh",6,5,3,1,3,1,0,2
West Coast,"Langdon, Zac",1,1,0,0,0,0,0,5
West Coast,"McGovern, Jeremy",16,13,8,3,0,0,0,1
West Coast,"Naitanui, Nic",15,6,1,9,0,0,36,2
West Coast,"Nelson, Jackson",9,7,6,2,0,0,0,3
West Coast,"Petruccelle, Jack",11,6,3,5,0,0,0,2
West Coast,"Redden, Jack",25,14,4,11,0,1,0,9
West Coast,"Ryan, Liam",13,10,7,3,3,1,0,2
West Coast,"Sheed, Dom",16,8,3,8,0,0,0,2
West Coast,"Sheppard, Brad",16,11,8,5,0,0,0,1
West Coast,"Shuey, Luke",25,15,5,10,0,0,0,7
West Coast,"Vardy, Nathan",5,0,1,5,0,0,12,1
West Coast,"Witherden, Alex",25,20,6,5,1,0,0,2
West Coast,"Yeo, Elliot",23,11,3,12,0,0,0,6
West Coast,"Allen, Oscar",7,5,2,2,1,0,0,1
West Coast,"Barrass, Tom",9,7,5,2,0,0,0,0
West Coast,"Brander, Jarrod",14,8,5,6,0,0,0,2
West Coast,"Cole, Tom",10,6,4,4,0,0,0,2
West Coast,"Cripps, Jamie",13,10,3,3,2,0,0,4
West Coast,"Darling, Jack",11,7,6,4,3,2,0,3
West Coast,"Edwards, Harry",6,5,2,1,0,0,0,1
West Coast,"Foley, Luke",12,10,4,2,0,0,0,2
West Coast,"Gaff, Andrew",15,10,3,5,0,0,0,5
West Coast,"Hutchings, Mark",13,7,3,6,0,0,0,1
West Coast,"Jones, Jamaine",7,5,1,2,1,0,0,8
West Coast,"Naitanui, Nic",24,9,1,15,0,0,53,2
West Coast,"Nelson, Jackson",12,11,2,1,0,0,0,1
West Coast,"Petruccelle, Jack",4,3,2,1,0,0,0,0
West Coast,"Rotham, Josh",13,8,8,5,0,0,0,4
West Coast,"Ryan, Liam",13,9,4,4,3,1,0,1
West Coast,"Sheed, Dom",23,12,4,11,0,0,0,0
West Coast,"Shuey, Luke",34,22,2,12,0,0,0,1
West Coast,"Vardy, Nathan",6,3,2,3,2,0,7,1
West Coast,"Waterman, Jake",12,9,4,3,1,0,0,0
West Coast,"West, Connor",10,4,2,6,0,1,0,2
West Coast,"Witherden, Alex",24,20,5,4,0,0,0,4
West Coast,"Yeo, Elliot",30,18,1,12,0,2,0,6
Western Bulldogs,"Bontempelli, Marcus",28,13,9,15,0,1,0,3
Western Bulldogs,"Bruce, Josh",15,11,11,4,1,0,0,1
Western Bulldogs,"Dale, Bailey",16,12,3,4,0,0,0,1
Western Bulldogs,"Daniel, Caleb",28,18,5,10,0,0,0,5
Western Bulldogs,"Dunkley, Josh",30,13,7,17,0,1,0,3
Western Bulldogs,"Duryea, Taylor",22,15,9,7,0,0,0,1
Western Bulldogs,"English, Tim",14,10,8,4,1,1,4,2
Western Bulldogs,"Gardner, Ryan",11,7,7,4,0,0,0,1
Western Bulldogs,"Hunter, Lachie",31,16,11,15,0,0,0,1
Western Bulldogs,"Keath, Alex",18,15,9,3,0,0,0,4
Western Bulldogs,"Liberatore, Tom",28,14,3,14,0,1,0,7
Western Bulldogs,"Lipinski, Patrick",26,9,4,17,0,0,0,2
Western Bulldogs,"Macrae, Jack",35,17,7,18,0,0,0,7
Western Bulldogs,"Martin, Stefan",15,6,1,9,1,0,15,2
Western Bulldogs,"McNeil, Lachlan",9,5,1,4,1,0,0,0
Western Bulldogs,"Naughton, Aaron",15,10,7,5,2,0,0,1
Western Bulldogs,"Scott, Anthony",16,9,1,7,0,1,0,1
Western Bulldogs,"Smith, Bailey",36,23,8,13,2,0,0,3
Western Bulldogs,"Treloar, Adam",18,7,2,11,0,0,0,3
Western Bulldogs,"Vandermeer, Laitham",14,5,1,9,2,0,0,4
Western Bulldogs,"Wallis, Mitch",13,4,3,9,0,1,0,1
Western Bulldogs,"West, Rhylee",0,0,0,0,0,0,0,0
Western Bulldogs,"Williams, Bailey",28,21,8,7,0,0,0,4
Western Bulldogs,"Bontempelli, Marcus",30,15,6,15,3,1,0,2
Western Bulldogs,"Bruce, Josh",9,8,5,1,3,0,0,1
Western Bulldogs,"Dale, Bailey",17,9,6,8,0,0,0,1
Western Bulldogs,"Daniel, Caleb",26,18,5,8,1,0,0,0
Western Bulldogs,"Dunkley, Josh",25,10,6,15,1,0,0,9
Western Bulldogs,"Duryea, Taylor",22,11,7,11,0,0,0,2
Western Bulldogs,"English, Tim",9,5,4,4,1,0,9,4
Western Bulldogs,"Gardner, Ryan",10,8,4,2,0,0,0,1
Western Bulldogs,"Hunter, Lachie",21,13,5,8,0,0,0,1
Western Bulldogs,"Johannisen, Jason",0,0,0,0,0,0,0,0
Western Bulldogs,"Keath, Alex",14,8,3,6,0,0,0,3
Western Bulldogs,"Liberatore, Tom",26,12,2,14,0,2,0,5
Western Bulldogs,"Lipinski, Patrick",20,10,2,10,0,0,0,1
Western Bulldogs,"Macrae, Jack",41,19,3,22,0,1,0,0
Western Bulldogs,"Martin, Stefan",10,4,1,6,0,0,12,0
Western Bulldogs,"McNeil, Lachlan",9,6,2,3,0,2,0,2
Western Bulldogs,"Naughton, Aaron",13,11,8,2,3,2,0,2
Western Bulldogs,"Scott, Anthony",9,4,2,5,0,0,0,0
Western Bulldogs,"Smith, Bailey",25,7,5,18,1,0,0,3
Western Bulldogs,"Treloar, Adam",25,11,3,14,0,1,0,2
Western Bulldogs,"Vandermeer, Laitham",10,5,3,5,1,2,0,2
Western Bulldogs,"Wallis, Mitch",15,8,7,7,0,1,0,2
Western Bulldogs,"Williams, Bailey",20,12,6,8,0,0,0,0
Western Bulldogs,"Bontempelli, Marcus",18,12,3,6,1,1,0,4
Western Bulldogs,"Bruce, Josh",21,15,10,6,10,2,0,1
Western Bulldogs,"Dale, Bailey",23,11,4,12,2,0,0,1
Western Bulldogs,"Daniel, Caleb",30,14,4,16,0,0,0,2
Western Bulldogs,"Dunkley, Josh",33,12,5,21,1,2,0,3
Western Bulldogs,"Duryea, Taylor",21,13,7,8,0,0,0,3
Western Bulldogs,"English, Tim",16,10,8,6,3,0,8,0
Western Bulldogs,"Gardner, Ryan",0,0,0,0,0,0,0,0
Western Bulldogs,"Hunter, Lachie",18,9,6,9,0,0,0,1
Western Bulldogs,"Johannisen, Jason",15,11,3,4,0,0,0,1
Western Bulldogs,"Keath, Alex",16,7,6,9,0,0,0,3
Western Bulldogs,"Liberatore, Tom",25,13,3,12,0,0,0,4
Western Bulldogs,"Lipinski, Patrick",14,8,5,6,1,0,0,4
Western Bulldogs,"Macrae, Jack",33,17,3,16,0,0,0,2
Western Bulldogs,"Martin, Stefan",10,0,0,10,0,0,9,1
Western Bulldogs,"McNeil, Lachlan",9,5,1,4,1,2,0,2
Western Bulldogs,"Naughton, Aaron",14,12,7,2,2,2,0,3
Western Bulldogs,"Scott, Anthony",15,8,4,7,1,0,0,3
Western Bulldogs,"Smith, Bailey",26,14,5,12,0,2,0,1
Western Bulldogs,"Treloar, Adam",27,16,3,11,3,1,0,2
Western Bulldogs,"Vandermeer, Laitham",9,5,3,4,0,2,0,2
Western Bulldogs,"Williams, Bailey",19,11,4,8,0,0,0,4
Western Bulldogs,"Wood, Easton",22,11,8,11,0,0,0,1
Western Bulldogs,"Bontempelli, Marcus",21,15,1,6,0,0,0,4
Western Bulldogs,"Bruce, Josh",12,5,3,7,1,0,0,3
Western Bulldogs,"Dale, Bailey",21,16,5,5,0,0,0,3
Western Bulldogs,"Daniel, Caleb",8,3,0,5,0,0,0,1
Western Bulldogs,"Dunkley, Josh",27,9,4,18,0,1,0,8
Western Bulldogs,"Duryea, Taylor",15,9,4,6,0,0,0,2
Western Bulldogs,"English, Tim",17,9,9,8,3,3,8,1
Western Bulldogs,"Hunter, Lachie",15,11,2,4,1,0,0,10
Western Bulldogs,"Johannisen, Jason",12,5,0,7,0,1,0,3
Western Bulldogs,"Keath, Alex",12,10,5,2,0,0,2,2
Western Bulldogs,"Liberatore, Tom",17,9,0,8,1,0,0,5
Western Bulldogs,"Lipinski, Patrick",0,0,0,0,0,0,0,0
Western Bulldogs,"Macrae, Jack",32,12,1,20,1,0,0,8
Western Bulldogs,"Martin, Stefan",13,5,2,8,0,0,30,2
Western Bulldogs,"McNeil, Lachlan",10,6,2,4,0,1,0,1
Western Bulldogs,"Naughton, Aaron",18,11,8,7,2,5,0,4
Western Bulldogs,"Scott, Anthony",5,2,0,3,0,0,0,2
Western Bulldogs,"Smith, Bailey",15,8,4,7,1,0,0,3
Western Bulldogs,"Treloar, Adam",29,17,3,12,0,2,0,10
Western Bulldogs,"Vandermeer, Laitham",6,2,0,4,0,0,0,2
Western Bulldogs,"Williams, Bailey",14,10,1,4,0,0,0,2
Western Bulldogs,"Wood, Easton",11,8,4,3,0,0,0,4
Western Bulldogs,"Young, Lewis",17,11,5,6,0,0,0,1
Western Bulldogs,"Bontempelli, Marcus",33,19,1,14,3,1,0,6
Western Bulldogs,"Bruce, Josh",8,5,4,3,2,1,0,1
Western Bulldogs,"Cavarra, Ben",1,1,1,0,0,0,0,1
Western Bulldogs,"Crozier, Hayden",17,15,8,2,0,0,0,2
Western Bulldogs,"Dale, Bailey",27,22,9,5,0,0,0,1
Western Bulldogs,"Dunkley, Josh",38,15,6,23,2,1,0,8
Western Bulldogs,"Duryea, Taylor",16,14,10,2,0,0,0,2
Western Bulldogs,"English, Tim",12,5,4,7,1,2,6,1
Western Bulldogs,"Hunter, Lachie",25,10,6,15,1,0,0,1
Western Bulldogs,"Johannisen, Jason",16,6,1,10,0,0,0,0
Western Bulldogs,"Keath, Alex",20,12,9,8,0,0,0,2
Western Bulldogs,"Liberatore, Tom",24,10,1,14,1,0,0,4
Western Bulldogs,"Lipinski, Patrick",15,12,5,3,0,0,0,2
Western Bulldogs,"Macrae, Jack",35,16,4,19,0,0,0,4
Western Bulldogs,"McNeil, Lachlan",13,5,2,8,1,1,0,3
Western Bulldogs,"Naughton, Aaron",12,10,6,2,2,3,0,0
Western Bulldogs,"Scott, Anthony",13,7,3,6,1,1,0,1
Western Bulldogs,"Smith, Bailey",20,10,5,10,0,2,0,4
Western Bulldogs,"Sweet, Jordon",8,4,2,4,0,0,31,4
Western Bulldogs,"Treloar, Adam",26,14,3,12,2,1,0,4
Western Bulldogs,"Williams, Bailey",14,9,6,5,0,0,0,1
Western Bulldogs,"Wood, Easton",10,8,7,2,1,0,0,1
Western Bulldogs,"Young, Lewis",12,5,2,7,0,0,7,0
Western Bulldogs,"Bontempelli, Marcus",26,13,2,13,1,0,0,6
Western Bulldogs,"Bruce, Josh",11,7,6,4,2,1,0,0
Western Bulldogs,"Cordy, Zaine",11,8,4,3,0,0,0,0
Western Bulldogs,"Crozier, Hayden",14,11,9,3,0,0,0,4
Western Bulldogs,"Dale, Bailey",22,12,3,10,2,0,0,0
Western Bulldogs,"Daniel, Caleb",19,10,1,9,0,0,0,1
Western Bulldogs,"Dunkley, Josh",29,11,5,18,0,2,0,3
Western Bulldogs,"Duryea, Taylor",17,12,4,5,0,0,0,2
Western Bulldogs,"English, Tim",12,5,3,7,0,0,17,1
Western Bulldogs,"Hunter, Lachie",19,13,2,6,1,1,0,2
Western Bulldogs,"Johannisen, Jason",11,6,4,5,1,0,0,2
Western Bulldogs,"Jong, Lin",4,2,2,2,0,1,0,0
Western Bulldogs,"Keath, Alex",13,8,8,5,0,0,0,2
Western Bulldogs,"Liberatore, Tom",27,18,3,9,2,0,0,10
Western Bulldogs,"Macrae, Jack",40,25,8,15,1,1,0,6
Western Bulldogs,"Martin, Stefan",10,3,2,7,0,0,28,2
Western Bulldogs,"McNeil, Lachlan",9,5,3,4,2,0,0,0
Western Bulldogs,"Naughton, Aaron",13,11,9,2,2,3,0,1
Western Bulldogs,"Scott, Anthony",15,5,0,10,0,0,0,3
Western Bulldogs,"Smith, Bailey",20,9,5,11,0,1,0,0
Western Bulldogs,"Treloar, Adam",35,16,3,19,1,0,0,5
Western Bulldogs,"Vandermeer, Laitham",8,4,1,4,0,0,0,2
Western Bulldogs,"Wood, Easton",11,7,2,4,0,0,0,2
Western Bulldogs,"Bontempelli, Marcus",26,16,5,10,0,1,3,4
Western Bulldogs,"Bruce, Josh",11,7,5,4,1,2,1,0
Western Bulldogs,"Cordy, Zaine",9,7,5,2,0,0,1,0
Western Bulldogs,"Crozier, Hayden",13,8,5,5,0,0,0,1
Western Bulldogs,"Dale, Bailey",27,20,3,7,0,0,0,3
Western Bulldogs,"Daniel, Caleb",34,16,5,18,0,0,0,3
Western Bulldogs,"Duryea, Taylor",11,7,3,4,0,0,0,2
Western Bulldogs,"Hannan, Mitch",9,6,4,3,0,1,0,2
Western Bulldogs,"Hunter, Lachie",22,10,8,12,0,0,0,2
Western Bulldogs,"Johannisen, Jason",5,2,0,3,0,0,0,0
Western Bulldogs,"Keath, Alex",18,11,7,7,0,0,5,2
Western Bulldogs,"Liberatore, Tom",23,9,0,14,0,0,0,7
Western Bulldogs,"Lipinski, Patrick",23,10,5,13,0,1,0,1
Western Bulldogs,"Macrae, Jack",30,14,9,16,0,1,0,4
Western Bulldogs,"Martin, Stefan",6,2,1,4,0,0,21,3
Western Bulldogs,"McNeil, Lachlan",0,0,0,0,0,0,0,0
Western Bulldogs,"Naughton, Aaron",11,9,8,2,3,0,0,0
Western Bulldogs,"Schache, Josh",7,5,3,2,1,0,1,2
Western Bulldogs,"Scott, Anthony",7,3,0,4,1,1,0,5
Western Bulldogs,"Smith, Bailey",27,14,4,13,1,0,0,3
Western Bulldogs,"Treloar, Adam",27,15,5,12,0,0,0,5
Western Bulldogs,"West, Rhylee",5,5,2,0,0,2,0,2
Western Bulldogs,"Wood, Easton",15,10,11,5,0,0,0,1
Western Bulldogs,"Bontempelli, Marcus",32,18,6,14,1,0,0,8
Western Bulldogs,"Bruce, Josh",15,12,11,3,5,2,5,3
Western Bulldogs,"Cordy, Zaine",9,6,6,3,0,0,0,2
Western Bulldogs,"Crozier, Hayden",18,12,8,6,0,0,0,0
Western Bulldogs,"Dale, Bailey",27,20,3,7,0,0,0,1
Western Bulldogs,"Daniel, Caleb",22,16,9,6,0,1,0,1
Western Bulldogs,"Duryea, Taylor",23,17,5,6,0,0,0,0
Western Bulldogs,"Hannan, Mitch",7,6,5,1,0,1,0,1
Western Bulldogs,"Hunter, Lachie",14,11,2,3,2,1,0,4
Western Bulldogs,"Johannisen, Jason",6,5,4,1,1,0,0,0
Western Bulldogs,"Keath, Alex",15,11,7,4,0,0,0,3
Western Bulldogs,"Khamis, Buku",11,7,1,4,0,0,0,1
Western Bulldogs,"Liberatore, Tom",27,9,2,18,0,0,0,5
Western Bulldogs,"Lipinski, Patrick",12,4,3,8,1,0,0,5
Western Bulldogs,"Macrae, Jack",32,17,3,15,0,0,0,2
Western Bulldogs,"McNeil, Lachlan",11,4,1,7,0,1,0,5
Western Bulldogs,"Naughton, Aaron",9,6,6,3,2,1,1,1
Western Bulldogs,"Scott, Anthony",12,6,2,6,2,0,0,2
Western Bulldogs,"Smith, Bailey",16,10,6,6,0,1,0,0
Western Bulldogs,"Sweet, Jordon",9,4,1,5,1,0,17,5
Western Bulldogs,"Treloar, Adam",23,12,3,11,1,0,0,9
Western Bulldogs,"West, Rhylee",0,0,0,0,0,0,0,0
Western Bulldogs,"Wood, Easton",9,8,4,1,0,0,0,0
Western Bulldogs,"Bontempelli, Marcus",26,16,4,10,2,0,0,3
Western Bulldogs,"Bruce, Josh",8,6,3,2,2,0,5,3
Western Bulldogs,"Cordy, Zaine",19,13,9,6,0,0,0,2
Western Bulldogs,"Crozier, Hayden",18,12,6,6,0,0,0,1
Western Bulldogs,"Dale, Bailey",23,14,3,9,0,0,0,2
Western Bulldogs,"Daniel, Caleb",26,13,5,13,0,0,0,3
Western Bulldogs,"Duryea, Taylor",20,12,6,8,0,0,0,4
Western Bulldogs,"Hannan, Mitch",6,3,1,3,1,0,0,3
Western Bulldogs,"Johannisen, Jason",12,8,4,4,2,0,0,4
Western Bulldogs,"Keath, Alex",12,6,4,6,0,0,0,0
Western Bulldogs,"Liberatore, Tom",27,8,0,19,0,0,0,2
Western Bulldogs,"Lipinski, Patrick",11,5,4,6,0,0,0,2
Western Bulldogs,"Macrae, Jack",32,18,2,14,0,0,0,6
Western Bulldogs,"McNeil, Lachlan",14,10,2,4,1,0,0,2
Western Bulldogs,"Naughton, Aaron",11,10,5,1,4,0,0,2
Western Bulldogs,"Scott, Anthony",12,4,3,8,0,1,0,1
Western Bulldogs,"Smith, Bailey",25,12,0,13,0,0,0,4
Western Bulldogs,"Smith, Roarke",13,5,2,8,0,0,0,6
Western Bulldogs,"Sweet, Jordon",9,5,2,4,0,0,18,3
Western Bulldogs,"Treloar, Adam",26,13,4,13,0,1,0,3
Western Bulldogs,"Weightman, Cody",12,9,3,3,3,2,0,5
Western Bulldogs,"Williams, Bailey",18,10,6,8,0,0,0,5
Western Bulldogs,"Wood, Easton",1,1,0,0,0,0,0,0
Western Bulldogs,"Bontempelli, Marcus",26,20,5,6,4,3,0,6
Western Bulldogs,"Bruce, Josh",6,4,4,2,3,0,0,0
Western Bulldogs,"Cordy, Zaine",7,6,3,1,0,0,0,4
Western Bulldogs,"Crozier, Hayden",14,10,1,4,0,0,0,1
Western Bulldogs,"Dale, Bailey",34,21,2,13,2,0,0,1
Western Bulldogs,"Daniel, Caleb",25,9,4,16,0,0,0,4
Western Bulldogs,"Duryea, Taylor",17,8,5,9,0,0,0,1
Western Bulldogs,"Hannan, Mitch",15,11,4,4,1,0,0,4
Western Bulldogs,"Hunter, Lachie",24,13,8,11,1,1,0,2
Western Bulldogs,"Johannisen, Jason",19,8,5,11,1,1,0,4
Western Bulldogs,"Keath, Alex",15,8,6,7,0,0,2,1
Western Bulldogs,"Liberatore, Tom",31,13,5,18,1,0,0,4
Western Bulldogs,"Macrae, Jack",41,19,6,22,0,0,0,9
Western Bulldogs,"McNeil, Lachlan",6,2,1,4,0,0,0,7
Western Bulldogs,"Naughton, Aaron",15,11,9,4,5,4,0,2
Western Bulldogs,"Scott, Anthony",5,2,0,3,0,1,0,2
Western Bulldogs,"Smith, Bailey",26,15,4,11,0,1,0,7
Western Bulldogs,"Smith, Roarke",14,6,2,8,1,0,0,3
Western Bulldogs,"Sweet, Jordon",14,7,6,7,0,2,16,6
Western Bulldogs,"Treloar, Adam",14,4,0,10,0,0,0,1
Western Bulldogs,"Weightman, Cody",14,12,6,2,2,2,0,1
Western Bulldogs,"Williams, Bailey",14,10,6,4,0,1,0,4
Western Bulldogs,"Young, Lewis",3,1,2,2,0,0,3,0
Western Bulldogs,"Bontempelli, Marcus",30,16,6,14,0,1,0,8
Western Bulldogs,"Bruce, Josh",4,4,2,0,3,1,0,1
Western Bulldogs,"Butler, Louis",10,6,5,4,0,0,0,2
Western Bulldogs,"Cordy, Zaine",16,15,8,1,0,0,0,0
Western Bulldogs,"Crozier, Hayden",26,18,9,8,0,0,0,3
Western Bulldogs,"Dale, Bailey",30,21,10,9,0,0,0,1
Western Bulldogs,"Daniel, Caleb",26,15,3,11,1,0,0,1
Western Bulldogs,"Duryea, Taylor",15,9,3,6,0,0,0,1
Western Bulldogs,"English, Tim",15,9,9,6,2,0,9,3
Western Bulldogs,"Garcia, Riley",2,1,0,1,0,0,0,0
Western Bulldogs,"Hunter, Lachie",27,16,4,11,0,0,0,2
Western Bulldogs,"Johannisen, Jason",8,4,3,4,0,0,0,4
Western Bulldogs,"Keath, Alex",8,5,3,3,0,0,0,4
Western Bulldogs,"Liberatore, Tom",16,11,4,5,0,0,0,6
Western Bulldogs,"Lipinski, Patrick",23,11,7,12,0,0,0,4
Western Bulldogs,"Macrae, Jack",36,20,7,16,0,0,0,9
Western Bulldogs,"McNeil, Lachlan",9,4,3,5,0,1,0,1
Western Bulldogs,"Naughton, Aaron",14,8,8,6,1,1,0,0
Western Bulldogs,"Smith, Bailey",27,16,2,11,0,0,0,3
Western Bulldogs,"Smith, Roarke",20,9,4,11,0,0,0,1
Western Bulldogs,"Sweet, Jordon",3,1,1,2,0,0,17,1
Western Bulldogs,"Weightman, Cody",10,5,2,5,1,1,0,2
Western Bulldogs,"Williams, Bailey",18,11,2,7,0,0,0,0
Western Bulldogs,"Bontempelli, Marcus",27,18,6,9,2,2,0,5
Western Bulldogs,"Bruce, Josh",11,6,4,5,1,1,1,1
Western Bulldogs,"Cordy, Zaine",7,6,3,1,0,0,0,2
Western Bulldogs,"Crozier, Hayden",19,11,6,8,0,0,0,1
Western Bulldogs,"Dale, Bailey",22,15,3,7,0,0,0,2
Western Bulldogs,"Daniel, Caleb",23,10,1,13,0,0,0,6
Western Bulldogs,"Duryea, Taylor",22,16,7,6,0,0,0,2
Western Bulldogs,"English, Tim",11,8,6,3,1,0,17,5
Western Bulldogs,"Gardner, Ryan",3,2,2,1,0,0,0,0
Western Bulldogs,"Hannan, Mitch",12,8,5,4,2,2,0,5
Western Bulldogs,"Hunter, Lachie",27,18,4,9,1,0,0,2
Western Bulldogs,"Johannisen, Jason",8,3,0,5,0,2,0,5
Western Bulldogs,"Keath, Alex",13,6,3,7,0,0,0,1
Western Bulldogs,"Liberatore, Tom",19,11,2,8,2,1,0,1
Western Bulldogs,"Macrae, Jack",35,16,6,19,0,0,0,2
Western Bulldogs,"Martin, Stefan",6,2,1,4,0,0,8,1
Western Bulldogs,"Naughton, Aaron",19,13,13,6,1,5,0,1
Western Bulldogs,"Scott, Anthony",8,5,3,3,1,0,0,3
Western Bulldogs,"Smith, Bailey",15,9,0,6,0,1,0,1
Western Bulldogs,"Smith, Roarke",6,4,1,2,0,0,0,2
Western Bulldogs,"Weightman, Cody",11,8,2,3,2,0,0,4
Western Bulldogs,"West, Rhylee",4,1,0,3,0,0,0,1
Western Bulldogs,"Williams, Bailey",12,6,4,6,0,0,0,1
Western Bulldogs,"Bontempelli, Marcus",30,18,5,12,1,2,0,7
Western Bulldogs,"Bruce, Josh",8,4,4,4,3,1,1,2
Western Bulldogs,"Cordy, Zaine",12,8,2,4,0,0,0,2
Western Bulldogs,"Crozier, Hayden",10,7,3,3,0,0,0,0
Western Bulldogs,"Dale, Bailey",14,11,2,3,0,0,0,0
Western Bulldogs,"Daniel, Caleb",27,16,3,11,1,0,0,6
Western Bulldogs,"Duryea, Taylor",22,13,4,9,0,0,0,5
Western Bulldogs,"English, Tim",8,5,1,3,0,0,29,4
Western Bulldogs,"Gardner, Ryan",12,8,3,4,0,0,0,2
Western Bulldogs,"Hannan, Mitch",10,6,2,4,0,1,3,2
Western Bulldogs,"Hunter, Lachie",23,14,10,9,0,0,0,3
Western Bulldogs,"Johannisen, Jason",6,4,1,2,1,0,0,2
Western Bulldogs,"Keath, Alex",9,5,3,4,0,0,2,3
Western Bulldogs,"Liberatore, Tom",30,11,1,19,1,0,0,8
Western Bulldogs,"Macrae, Jack",35,15,3,20,0,0,0,3
Western Bulldogs,"McLean, Toby",21,9,5,12,1,0,0,2
Western Bulldogs,"Naughton, Aaron",4,3,1,1,0,1,0,1
Western Bulldogs,"Scott, Anthony",10,8,3,2,2,2,0,2
Western Bulldogs,"Smith, Bailey",14,8,2,6,0,0,0,4
Western Bulldogs,"Smith, Roarke",12,2,0,10,0,1,0,2
Western Bulldogs,"Wallis, Mitch",7,3,1,4,0,0,0,1
Western Bulldogs,"Weightman, Cody",14,10,3,4,1,1,0,1
Western Bulldogs,"Williams, Bailey",24,12,6,12,0,0,0,2
Western Bulldogs,"Bontempelli, Marcus",29,16,4,13,3,1,0,7
Western Bulldogs,"Bruce, Josh",10,6,3,4,0,2,0,0
Western Bulldogs,"Cordy, Zaine",5,5,2,0,0,0,2,2
Western Bulldogs,"Dale, Bailey",23,17,1,6,0,0,0,1
Western Bulldogs,"Daniel, Caleb",24,14,9,10,0,0,0,2
Western Bulldogs,"Duryea, Taylor",21,17,8,4,0,0,0,6
Western Bulldogs,"English, Tim",13,10,7,3,0,2,23,4
Western Bulldogs,"Garcia, Riley",13,9,1,4,1,0,0,0
Western Bulldogs,"Gardner, Ryan",1,0,0,1,0,0,0,0
Western Bulldogs,"Hannan, Mitch",7,3,2,4,0,0,0,2
Western Bulldogs,"Hunter, Lachie",27,15,6,12,0,0,0,1
Western Bulldogs,"Johannisen, Jason",16,11,4,5,0,2,0,2
Western Bulldogs,"Keath, Alex",11,8,3,3,0,0,0,0
Western Bulldogs,"Liberatore, Tom",20,8,2,12,0,2,0,5
Western Bulldogs,"Macrae, Jack",32,19,4,13,1,0,0,3
Western Bulldogs,"McLean, Toby",13,6,2,7,1,0,0,5
Western Bulldogs,"Naughton, Aaron",15,9,9,6,4,2,0,0
Western Bulldogs,"Richards, Ed",16,10,5,6,0,0,0,3
Western Bulldogs,"Scott, Anthony",8,3,0,5,0,0,0,1
Western Bulldogs,"Smith, Bailey",31,17,5,14,2,2,0,5
Western Bulldogs,"Wallis, Mitch",6,3,2,3,0,0,0,1
Western Bulldogs,"Weightman, Cody",10,7,4,3,1,1,0,0
Western Bulldogs,"Williams, Bailey",11,8,3,3,0,1,0,2
Western Bulldogs,"Bontempelli, Marcus",27,16,8,11,0,1,0,4
Western Bulldogs,"Bruce, Josh",11,4,3,7,2,1,1,2
Western Bulldogs,"Cordy, Zaine",10,8,6,2,0,0,0,3
Western Bulldogs,"Dale, Bailey",23,20,3,3,2,0,0,1
Western Bulldogs,"Daniel, Caleb",18,11,7,7,0,0,0,0
Western Bulldogs,"Duryea, Taylor",13,8,4,5,0,0,0,2
Western Bulldogs,"English, Tim",9,5,4,4,0,0,17,1
Western Bulldogs,"Garcia, Riley",13,6,3,7,1,1,0,1
Western Bulldogs,"Hannan, Mitch",11,8,7,3,1,1,0,5
Western Bulldogs,"Hunter, Lachie",19,14,5,5,0,0,0,1
Western Bulldogs,"Johannisen, Jason",14,11,2,3,0,1,0,0
Western Bulldogs,"Keath, Alex",13,8,6,5,0,0,0,5
Western Bulldogs,"Liberatore, Tom",25,14,6,11,2,2,0,5
Western Bulldogs,"Lipinski, Patrick",9,5,4,4,0,0,0,1
Western Bulldogs,"Macrae, Jack",31,10,3,21,0,0,0,3
Western Bulldogs,"McLean, Toby",8,2,2,6,0,2,0,6
Western Bulldogs,"Naughton, Aaron",7,4,3,3,0,2,0,1
Western Bulldogs,"Scott, Anthony",7,2,2,5,0,0,0,1
Western Bulldogs,"Smith, Bailey",16,8,0,8,0,0,0,6
Western Bulldogs,"Wallis, Mitch",12,6,5,6,3,0,0,3
Western Bulldogs,"Weightman, Cody",13,12,7,1,4,1,0,2
Western Bulldogs,"Williams, Bailey",19,17,2,2,1,0,0,1
Western Bulldogs,"Young, Lewis",13,8,6,5,0,0,7,1
Western Bulldogs,"Bontempelli, Marcus",27,12,2,15,0,0,0,5
Western Bulldogs,"Bruce, Josh",8,5,3,3,1,2,0,2
Western Bulldogs,"Cordy, Zaine",8,4,1,4,0,0,0,0
Western Bulldogs,"Dale, Bailey",27,17,3,10,0,0,0,1
Western Bulldogs,"Daniel, Caleb",30,17,3,13,1,0,0,2
Western Bulldogs,"Duryea, Taylor",18,9,8,9,0,0,0,1
Western Bulldogs,"English, Tim",22,10,8,12,1,2,21,6
Western Bulldogs,"Garcia, Riley",15,10,3,5,0,1,0,2
Western Bulldogs,"Hannan, Mitch",8,7,2,1,0,0,0,5
Western Bulldogs,"Hunter, Lachie",17,8,3,9,0,0,0,3
Western Bulldogs,"Johannisen, Jason",10,7,2,3,0,1,0,2
Western Bulldogs,"Keath, Alex",11,6,6,5,0,0,0,0
Western Bulldogs,"Liberatore, Tom",18,10,2,8,0,2,0,5
Western Bulldogs,"Macrae, Jack",25,12,1,13,0,0,1,8
Western Bulldogs,"McNeil, Lachlan",0,0,0,0,0,0,0,0
Western Bulldogs,"Richards, Ed",14,11,5,3,1,0,0,1
Western Bulldogs,"Scott, Anthony",8,3,1,5,1,0,0,3
Western Bulldogs,"Smith, Bailey",27,16,6,11,1,1,0,3
Western Bulldogs,"Ugle-Hagan, Jamarra",7,4,1,3,0,0,0,1
Western Bulldogs,"Wallis, Mitch",8,4,2,4,1,0,0,2
Western Bulldogs,"Weightman, Cody",5,5,2,0,0,1,0,3
Western Bulldogs,"Williams, Bailey",16,8,3,8,0,0,0,3
Western Bulldogs,"Young, Lewis",13,8,0,5,1,0,9,0
Western Bulldogs,"Bontempelli, Marcus",36,17,2,19,0,0,0,5
Western Bulldogs,"Bruce, Josh",14,7,3,7,1,1,7,1
Western Bulldogs,"Cordy, Zaine",4,4,2,0,0,0,1,1
Western Bulldogs,"Crozier, Hayden",10,7,4,3,0,0,0,1
Western Bulldogs,"Dale, Bailey",30,20,5,10,0,0,0,0
Western Bulldogs,"Daniel, Caleb",23,7,1,16,1,0,0,3
Western Bulldogs,"Dunkley, Josh",21,6,2,15,0,0,0,7
Western Bulldogs,"Duryea, Taylor",18,12,3,6,0,0,0,0
Western Bulldogs,"English, Tim",14,8,0,6,1,1,37,2
Western Bulldogs,"Garcia, Riley",16,4,0,12,0,0,0,2
Western Bulldogs,"Hunter, Lachie",27,14,6,13,0,0,0,2
Western Bulldogs,"Johannisen, Jason",14,9,6,5,2,1,0,0
Western Bulldogs,"Keath, Alex",16,7,7,9,0,0,1,2
Western Bulldogs,"Macrae, Jack",31,14,1,17,2,0,0,1
Western Bulldogs,"McNeil, Lachlan",12,8,3,4,1,0,0,1
Western Bulldogs,"Naughton, Aaron",9,2,4,7,1,0,0,1
Western Bulldogs,"Richards, Ed",19,10,2,9,0,0,0,1
Western Bulldogs,"Scott, Anthony",0,0,0,0,0,0,0,0
Western Bulldogs,"Smith, Bailey",33,13,2,20,0,0,0,4
Western Bulldogs,"Smith, Roarke",12,6,2,6,0,0,0,1
Western Bulldogs,"Ugle-Hagan, Jamarra",8,7,5,1,3,0,0,1
Western Bulldogs,"Weightman, Cody",9,8,3,1,2,0,0,3
Western Bulldogs,"Williams, Bailey",16,11,7,5,0,0,0,3
Western Bulldogs,"Bontempelli, Marcus",31,24,3,7,2,0,0,6
Western Bulldogs,"Bruce, Josh",12,6,3,6,2,1,0,0
Western Bulldogs,"Cordy, Zaine",14,7,4,7,0,0,0,6
Western Bulldogs,"Dale, Bailey",24,20,2,4,0,0,0,1
Western Bulldogs,"Daniel, Caleb",34,17,6,17,1,0,0,4
Western Bulldogs,"Duryea, Taylor",17,13,8,4,0,0,0,0
Western Bulldogs,"English, Tim",17,6,2,11,1,0,14,5
Western Bulldogs,"Garcia, Riley",11,5,0,6,0,0,0,5
Western Bulldogs,"Hannan, Mitch",7,6,3,1,2,1,0,2
Western Bulldogs,"Hunter, Lachie",26,14,4,12,0,0,0,5
Western Bulldogs,"Johannisen, Jason",9,5,4,4,0,0,0,1
Western Bulldogs,"Keath, Alex",0,0,0,0,0,0,0,0
Western Bulldogs,"Liberatore, Tom",27,12,2,15,0,1,0,4
Western Bulldogs,"Macrae, Jack",38,19,5,19,0,0,0,7
Western Bulldogs,"Naughton, Aaron",9,5,3,4,2,1,0,1
Western Bulldogs,"Richards, Ed",11,8,1,3,0,0,0,3
Western Bulldogs,"Schache, Josh",17,12,6,5,0,0,4,4
Western Bulldogs,"Scott, Anthony",4,3,0,1,0,0,0,4
Western Bulldogs,"Smith, Bailey",26,18,4,8,1,1,0,9
Western Bulldogs,"Smith, Roarke",5,1,1,4,0,0,0,3
Western Bulldogs,"Ugle-Hagan, Jamarra",5,3,2,2,1,0,0,2
Western Bulldogs,"Weightman, Cody",8,7,4,1,1,0,0,0
Western Bulldogs,"Williams, Bailey",13,10,4,3,0,0,0,4
Western Bulldogs,"Bontempelli, Marcus",15,6,1,9,1,0,0,7
Western Bulldogs,"Bruce, Josh",12,7,6,5,2,1,5,1
Western Bulldogs,"Cordy, Zaine",7,4,1,3,0,0,1,5
Western Bulldogs,"Dale, Bailey",31,25,4,6,1,0,0,0
Western Bulldogs,"Daniel, Caleb",32,16,5,16,1,0,0,2
Western Bulldogs,"Dunkley, Josh",13,4,3,9,0,0,0,4
Western Bulldogs,"English, Tim",14,8,6,6,1,0,27,5
Western Bulldogs,"Garcia, Riley",18,11,4,7,1,1,0,3
Western Bulldogs,"Hannan, Mitch",14,7,6,7,0,1,3,3
Western Bulldogs,"Hunter, Lachie",20,14,3,6,1,0,0,2
Western Bulldogs,"Johannisen, Jason",15,10,4,5,2,0,0,3
Western Bulldogs,"Liberatore, Tom",25,10,2,15,1,0,0,8
Western Bulldogs,"Lipinski, Patrick",0,0,0,0,0,0,0,0
Western Bulldogs,"Macrae, Jack",31,13,1,18,0,1,0,3
Western Bulldogs,"Naughton, Aaron",5,3,3,2,1,2,0,1
Western Bulldogs,"Schache, Josh",12,11,8,1,0,0,0,0
Western Bulldogs,"Scott, Anthony",17,7,5,10,0,0,0,0
Western Bulldogs,"Smith, Bailey",29,19,5,10,0,0,0,7
Western Bulldogs,"Smith, Roarke",15,7,2,8,0,1,0,1
Western Bulldogs,"Ugle-Hagan, Jamarra",9,7,5,2,2,1,0,4
Western Bulldogs,"Weightman, Cody",14,11,4,3,1,1,0,3
Western Bulldogs,"Williams, Bailey",16,8,5,8,0,0,0,5
Western Bulldogs,"Wood, Easton",8,3,2,5,0,0,0,2
Western Bulldogs,"Bontempelli, Marcus",34,17,4,17,1,1,0,0
Western Bulldogs,"Bruce, Josh",15,9,7,6,3,2,2,3
Western Bulldogs,"Cordy, Zaine",10,5,1,5,0,0,0,1
Western Bulldogs,"Dale, Bailey",22,15,2,7,0,0,0,0
Western Bulldogs,"Daniel, Caleb",18,9,4,9,0,0,0,1
Western Bulldogs,"Dunkley, Josh",19,3,4,16,0,0,0,2
Western Bulldogs,"Duryea, Taylor",17,6,5,11,1,0,0,1
Western Bulldogs,"English, Tim",13,5,4,8,1,1,24,2
Western Bulldogs,"Garcia, Riley",7,5,1,2,0,0,0,2
Western Bulldogs,"Hunter, Lachie",22,12,2,10,0,0,0,1
Western Bulldogs,"Johannisen, Jason",5,4,1,1,1,0,0,0
Western Bulldogs,"Liberatore, Tom",22,12,6,10,1,1,0,4
Western Bulldogs,"Macrae, Jack",37,15,2,22,0,0,0,5
Western Bulldogs,"Naughton, Aaron",11,5,5,6,1,3,1,4
Western Bulldogs,"Richards, Ed",8,4,3,4,0,0,0,1
Western Bulldogs,"Schache, Josh",14,10,6,4,0,0,0,0
Western Bulldogs,"Scott, Anthony",8,5,3,3,0,1,0,1
Western Bulldogs,"Smith, Bailey",20,13,5,7,0,0,0,3
Western Bulldogs,"Smith, Roarke",0,0,0,0,0,0,0,0
Western Bulldogs,"Treloar, Adam",22,10,7,12,1,0,0,2
Western Bulldogs,"Ugle-Hagan, Jamarra",6,4,1,2,1,1,0,0
Western Bulldogs,"Williams, Bailey",24,13,4,11,0,0,0,3
Western Bulldogs,"Wood, Easton",16,8,4,8,1,0,0,1
Western Bulldogs,"Bontempelli, Marcus",31,12,2,19,0,0,0,6
Western Bulldogs,"Cordy, Zaine",10,5,4,5,0,0,0,1
Western Bulldogs,"Dale, Bailey",31,22,5,9,0,0,0,1
Western Bulldogs,"Daniel, Caleb",27,16,3,11,0,0,0,4
Western Bulldogs,"Dunkley, Josh",15,4,0,11,0,0,0,4
Western Bulldogs,"Duryea, Taylor",13,9,5,4,0,0,0,2
Western Bulldogs,"English, Tim",10,6,5,4,0,1,10,4
Western Bulldogs,"Garcia, Riley",8,6,2,2,1,0,0,2
Western Bulldogs,"Hannan, Mitch",6,4,4,2,1,0,0,0
Western Bulldogs,"Hunter, Lachie",18,11,2,7,0,0,0,1
Western Bulldogs,"Johannisen, Jason",12,6,7,6,0,1,0,4
Western Bulldogs,"Keath, Alex",6,1,2,5,0,0,1,2
Western Bulldogs,"Liberatore, Tom",26,16,3,10,0,0,0,8
Western Bulldogs,"Macrae, Jack",32,16,5,16,0,0,0,8
Western Bulldogs,"Naughton, Aaron",8,4,5,4,1,1,0,1
Western Bulldogs,"Scott, Anthony",0,0,0,0,0,0,0,0
Western Bulldogs,"Smith, Bailey",18,15,5,3,0,0,0,0
Western Bulldogs,"Treloar, Adam",15,2,0,13,0,0,0,6
Western Bulldogs,"Vandermeer, Laitham",9,4,4,5,0,1,0,3
Western Bulldogs,"Weightman, Cody",7,5,3,2,2,1,0,1
Western Bulldogs,"Williams, Bailey",16,9,4,7,0,0,0,1
Western Bulldogs,"Wood, Easton",13,9,6,4,0,0,0,3
Western Bulldogs,"Young, Lewis",15,6,4,9,0,1,4,2
Western Bulldogs,"Bontempelli, Marcus",15,11,3,4,1,0,4,5
Western Bulldogs,"Cordy, Zaine",6,4,0,2,0,0,0,3
Western Bulldogs,"Dale, Bailey",25,21,3,4,0,0,0,1
Western Bulldogs,"Daniel, Caleb",24,19,3,5,0,0,0,1
Western Bulldogs,"Dunkley, Josh",17,7,3,10,1,0,0,4
Western Bulldogs,"Duryea, Taylor",15,12,3,3,0,0,0,2
Western Bulldogs,"English, Tim",9,7,6,2,2,0,1,0
Western Bulldogs,"Hannan, Mitch",11,6,5,5,0,0,0,5
Western Bulldogs,"Hunter, Lachie",22,17,10,5,1,2,0,3
Western Bulldogs,"Johannisen, Jason",6,5,3,1,1,0,0,1
Western Bulldogs,"Keath, Alex",8,3,3,5,0,0,0,1
Western Bulldogs,"Liberatore, Tom",17,7,1,10,0,0,0,5
Western Bulldogs,"Macrae, Jack",29,16,8,13,0,0,0,6
Western Bulldogs,"Naughton, Aaron",8,5,5,3,1,0,0,1
Western Bulldogs,"Schache, Josh",0,0,0,0,0,0,0,0
Western Bulldogs,"Smith, Bailey",25,14,3,11,0,0,0,4
Western Bulldogs,"Smith, Roarke",13,7,5,6,0,0,0,5
Western Bulldogs,"Treloar, Adam",20,10,5,10,1,0,0,1
Western Bulldogs,"Vandermeer, Laitham",14,8,6,6,1,0,0,2
Western Bulldogs,"Weightman, Cody",10,6,2,4,1,1,0,0
Western Bulldogs,"Williams, Bailey",13,8,5,5,0,0,0,2
Western Bulldogs,"Wood, Easton",13,6,5,7,0,0,0,0
Western Bulldogs,"Young, Lewis",14,4,4,10,0,0,13,2
Western Bulldogs,"Bontempelli, Marcus",23,16,4,7,0,0,1,6
Western Bulldogs,"Dale, Bailey",19,17,4,2,0,0,0,2
Western Bulldogs,"Daniel, Caleb",17,16,2,1,0,0,0,2
Western Bulldogs,"Dunkley, Josh",14,8,1,6,0,0,0,3
Western Bulldogs,"Duryea, Taylor",18,12,3,6,0,0,0,4
Western Bulldogs,"English, Tim",16,9,3,7,0,1,15,2
Western Bulldogs,"Gardner, Ryan",6,4,2,2,0,0,0,0
Western Bulldogs,"Hannan, Mitch",15,10,1,5,2,2,0,4
Western Bulldogs,"Hunter, Lachie",24,12,3,12,0,0,0,5
Western Bulldogs,"Johannisen, Jason",0,0,0,0,0,0,0,0
Western Bulldogs,"Keath, Alex",8,4,2,4,0,0,0,2
Western Bulldogs,"Liberatore, Tom",35,16,5,19,0,0,0,7
Western Bulldogs,"Macrae, Jack",36,15,0,21,0,0,0,3
Western Bulldogs,"Naughton, Aaron",9,5,5,4,3,0,0,4
Western Bulldogs,"Schache, Josh",12,8,5,4,2,0,0,0
Western Bulldogs,"Smith, Bailey",20,16,1,4,1,0,0,2
Western Bulldogs,"Smith, Roarke",14,8,1,6,0,0,0,3
Western Bulldogs,"Treloar, Adam",28,13,3,15,0,1,0,5
Western Bulldogs,"Vandermeer, Laitham",10,6,4,4,1,1,0,3
Western Bulldogs,"Weightman, Cody",12,9,2,3,4,0,0,2
Western Bulldogs,"Williams, Bailey",13,9,4,4,0,0,0,1
Western Bulldogs,"Wood, Easton",10,7,4,3,0,0,0,1
Western Bulldogs,"Young, Lewis",8,2,0,6,0,0,18,3
Western Bulldogs,"Bontempelli, Marcus",29,16,7,13,0,3,0,1
Western Bulldogs,"Dale, Bailey",20,15,4,5,0,0,0,1
Western Bulldogs,"Daniel, Caleb",31,22,2,9,0,0,0,2
Western Bulldogs,"Dunkley, Josh",21,7,5,14,0,1,0,7
Western Bulldogs,"Duryea, Taylor",15,12,2,3,0,0,0,1
Western Bulldogs,"English, Tim",13,9,1,4,0,0,22,7
Western Bulldogs,"Gardner, Ryan",5,2,0,3,0,0,0,0
Western Bulldogs,"Hannan, Mitch",8,6,2,2,1,1,0,2
Western Bulldogs,"Hunter, Lachie",20,14,4,6,0,0,0,2
Western Bulldogs,"Johannisen, Jason",7,7,1,0,1,1,0,2
Western Bulldogs,"Keath, Alex",9,4,3,5,0,1,0,1
Western Bulldogs,"Liberatore, Tom",21,14,4,7,2,0,0,6
Western Bulldogs,"Macrae, Jack",39,27,4,12,1,0,0,5
Western Bulldogs,"Naughton, Aaron",11,5,3,6,1,0,0,6
Western Bulldogs,"Schache, Josh",11,7,4,4,1,0,0,0
Western Bulldogs,"Smith, Bailey",27,19,6,8,3,0,0,4
Western Bulldogs,"Smith, Roarke",12,6,3,6,0,1,0,0
Western Bulldogs,"Treloar, Adam",10,2,1,8,0,0,0,5
Western Bulldogs,"Vandermeer, Laitham",10,5,0,5,0,2,0,4
Western Bulldogs,"Weightman, Cody",4,3,0,1,1,1,0,1
Western Bulldogs,"Williams, Bailey",13,10,3,3,0,0,0,1
Western Bulldogs,"Wood, Easton",12,9,5,3,0,0,0,1
Western Bulldogs,"Young, Lewis",4,2,1,2,0,0,10,5
Western Bulldogs,"Bontempelli, Marcus",20,11,1,9,2,0,0,3
Western Bulldogs,"Cordy, Zaine",6,3,0,3,0,0,0,1
Western Bulldogs,"Dale, Bailey",24,18,3,6,0,0,0,0
Western Bulldogs,"Daniel, Caleb",22,16,4,6,0,0,0,0
Western Bulldogs,"Dunkley, Josh",22,11,4,11,0,0,0,8
Western Bulldogs,"Duryea, Taylor",13,8,5,5,0,0,0,0
Western Bulldogs,"English, Tim",13,6,2,7,0,0,11,2
Western Bulldogs,"Gardner, Ryan",7,6,2,1,0,0,0,1
Western Bulldogs,"Hannan, Mitch",14,13,5,1,3,2,0,3
Western Bulldogs,"Hunter, Lachie",22,16,6,6,0,1,0,2
Western Bulldogs,"Johannisen, Jason",13,8,4,5,1,1,0,0
Western Bulldogs,"Liberatore, Tom",19,8,3,11,0,0,0,2
Western Bulldogs,"Macrae, Jack",36,22,3,14,0,0,0,6
Western Bulldogs,"Martin, Stefan",9,3,1,6,0,0,13,3
Western Bulldogs,"Naughton, Aaron",11,8,9,3,2,2,0,1
Western Bulldogs,"Schache, Josh",10,7,6,3,1,3,0,4
Western Bulldogs,"Scott, Anthony",4,2,1,2,1,0,0,0
Western Bulldogs,"Smith, Bailey",23,16,1,7,4,0,0,3
Western Bulldogs,"Smith, Roarke",15,9,2,6,1,1,0,2
Western Bulldogs,"Treloar, Adam",23,13,2,10,1,2,0,9
Western Bulldogs,"Vandermeer, Laitham",6,2,2,4,1,0,0,2
Western Bulldogs,"Williams, Bailey",19,16,8,3,0,0,0,4
Western Bulldogs,"Wood, Easton",16,12,4,4,0,0,0,2
Western Bulldogs,"Bontempelli, Marcus",25,13,4,12,3,0,0,6
Western Bulldogs,"Cordy, Zaine",13,8,6,5,0,0,0,3
Western Bulldogs,"Dale, Bailey",21,16,5,5,0,0,0,0
Western Bulldogs,"Daniel, Caleb",37,26,6,11,0,0,0,2
Western Bulldogs,"Dunkley, Josh",25,9,1,16,0,0,0,5
Western Bulldogs,"Duryea, Taylor",16,7,4,9,0,0,0,2
Western Bulldogs,"English, Tim",13,9,3,4,0,1,12,2
Western Bulldogs,"Hannan, Mitch",7,4,1,3,0,0,0,3
Western Bulldogs,"Hunter, Lachie",16,11,3,5,1,1,0,1
Western Bulldogs,"Johannisen, Jason",12,7,4,5,1,0,0,1
Western Bulldogs,"Keath, Alex",13,8,5,5,0,0,0,0
Western Bulldogs,"Liberatore, Tom",23,10,3,13,0,0,0,8
Western Bulldogs,"Macrae, Jack",26,12,3,14,0,0,0,8
Western Bulldogs,"Martin, Stefan",14,4,2,10,0,0,18,3
Western Bulldogs,"Naughton, Aaron",9,6,4,3,1,0,0,0
Western Bulldogs,"Schache, Josh",11,7,3,4,0,1,0,1
Western Bulldogs,"Smith, Bailey",26,15,4,11,0,1,0,1
Western Bulldogs,"Smith, Roarke",16,9,4,7,1,0,0,5
Western Bulldogs,"Treloar, Adam",27,11,3,16,3,0,0,1
Western Bulldogs,"Vandermeer, Laitham",0,0,0,0,0,0,0,0
Western Bulldogs,"Weightman, Cody",7,3,1,4,0,0,0,2
Western Bulldogs,"Williams, Bailey",13,8,3,5,0,0,0,0
Western Bulldogs,"Wood, Easton",9,4,4,5,0,0,0,3
Adelaide,"Atkins, Rory",14,6,1,8,1,0,0,5
Adelaide,"Brown, Luke",11,9,2,2,0,0,0,1
Adelaide,"Crouch, Brad",20,10,0,10,0,0,0,4
Adelaide,"Crouch, Matt",18,7,1,11,0,0,0,3
Adelaide,"Davis, Ben",5,4,2,1,1,0,0,2
Adelaide,"Fogarty, Darcy",8,4,4,4,1,0,0,0
Adelaide,"Frampton, Billy",9,6,2,3,0,0,11,2
Adelaide,"Gibbs, Bryce",7,2,1,5,0,0,0,0
Adelaide,"Jones, Chayce",6,6,1,0,1,1,0,3
Adelaide,"Kelly, Jake",8,5,2,3,0,0,0,3
Adelaide,"Laird, Rory",19,11,4,8,0,0,0,2
Adelaide,"Lynch, Tom",14,11,1,3,2,0,0,3
Adelaide,"McAsey, Fischer",5,3,1,2,0,0,0,0
Adelaide,"Milera, Wayne",15,10,5,5,0,0,0,2
Adelaide,"Murphy, Lachlan",10,6,2,4,1,1,0,6
Adelaide,"OBrien, Reilly",11,3,2,8,0,0,22,3
Adelaide,"Seedsman, Paul",14,10,2,4,0,0,0,4
Adelaide,"Sloane, Rory",17,6,1,11,1,1,0,7
Adelaide,"Smith, Brodie",7,6,2,1,0,1,0,2
Adelaide,"Stengle, Tyson",11,3,0,8,1,0,0,2
Adelaide,"Talia, Daniel",13,9,3,4,0,0,0,0
Adelaide,"Walker, Taylor",7,5,2,2,2,1,1,2
Adelaide,"Atkins, Rory",10,7,0,3,0,0,0,2
Adelaide,"Brown, Luke",9,7,2,2,0,0,0,1
Adelaide,"Crocker, Ben",5,4,2,1,1,1,0,2
Adelaide,"Crouch, Brad",25,11,2,14,1,0,0,4
Adelaide,"Crouch, Matt",26,9,2,17,0,0,0,2
Adelaide,"Doedee, Tom",9,2,1,7,0,0,0,1
Adelaide,"Fogarty, Darcy",5,4,2,1,1,0,2,3
Adelaide,"Jones, Chayce",12,9,0,3,0,0,0,2
Adelaide,"Keays, Ben",6,1,1,5,0,0,0,4
Adelaide,"Kelly, Jake",1,0,0,1,0,0,0,1
Adelaide,"Laird, Rory",20,11,0,9,0,0,0,3
Adelaide,"Lynch, Tom",20,14,8,6,0,0,0,1
Adelaide,"McAsey, Fischer",6,4,2,2,0,0,0,4
Adelaide,"McHenry, Ned",12,6,3,6,0,2,0,1
Adelaide,"Milera, Wayne",15,7,2,8,0,0,0,0
Adelaide,"Murphy, Lachlan",9,4,1,5,0,0,0,1
Adelaide,"OBrien, Reilly",16,6,6,10,0,0,27,6
Adelaide,"Seedsman, Paul",11,4,0,7,0,0,0,0
Adelaide,"Sloane, Rory",12,9,0,3,1,0,0,5
Adelaide,"Smith, Brodie",10,8,2,2,1,1,0,1
Adelaide,"Talia, Daniel",10,5,2,5,0,0,0,0
Adelaide,"Walker, Taylor",10,6,1,4,0,0,1,1
Adelaide,"Atkins, Rory",3,2,0,1,0,0,0,1
Adelaide,"Brown, Luke",16,14,4,2,0,0,0,2
Adelaide,"Crocker, Ben",9,7,2,2,1,1,0,3
Adelaide,"Crouch, Brad",22,9,1,13,0,0,0,6
Adelaide,"Crouch, Matt",22,6,1,16,0,0,0,3
Adelaide,"Doedee, Tom",20,13,8,7,0,0,0,2
Adelaide,"Fogarty, Darcy",6,4,3,2,1,0,0,4
Adelaide,"Hamill, Will",9,4,2,5,0,0,0,1
Adelaide,"Jones, Chayce",7,4,1,3,0,0,0,1
Adelaide,"Keays, Ben",12,8,6,4,1,1,0,3
Adelaide,"Kelly, Jake",4,2,2,2,0,0,0,5
Adelaide,"Laird, Rory",25,13,3,12,0,0,0,3
Adelaide,"Lynch, Tom",14,7,2,7,0,1,0,0
Adelaide,"McAsey, Fischer",7,5,3,2,0,0,0,1
Adelaide,"McHenry, Ned",2,0,0,2,0,0,0,4
Adelaide,"Murphy, Lachlan",4,2,1,2,0,0,0,2
Adelaide,"OBrien, Reilly",11,5,3,6,0,0,37,6
Adelaide,"Seedsman, Paul",15,11,4,4,0,0,0,5
Adelaide,"Sloane, Rory",15,7,0,8,0,0,0,1
Adelaide,"Smith, Brodie",17,14,5,3,0,0,0,2
Adelaide,"Talia, Daniel",4,4,3,0,0,0,0,1
Adelaide,"Walker, Taylor",6,4,2,2,1,0,2,1
Adelaide,"Brown, Luke",15,15,6,0,0,0,0,2
Adelaide,"Crocker, Ben",9,7,5,2,1,0,0,0
Adelaide,"Crouch, Brad",24,20,2,4,0,0,0,3
Adelaide,"Doedee, Tom",7,6,3,1,0,0,0,2
Adelaide,"Frampton, Billy",7,5,4,2,2,0,3,0
Adelaide,"Hamill, Will",2,1,1,1,0,0,0,2
Adelaide,"Himmelberg, Elliott",5,3,2,2,0,0,0,1
Adelaide,"Jones, Chayce",11,6,3,5,1,0,0,0
Adelaide,"Keays, Ben",14,10,3,4,0,0,0,7
Adelaide,"Kelly, Jake",10,8,6,2,0,0,0,4
Adelaide,"Laird, Rory",16,12,3,4,0,0,0,2
Adelaide,"Lynch, Tom",15,11,7,4,0,0,0,0
Adelaide,"McAdam, Shane",5,2,2,3,0,0,0,4
Adelaide,"McAsey, Fischer",4,2,0,2,0,0,0,2
Adelaide,"McHenry, Ned",14,4,4,10,0,0,0,1
Adelaide,"Murphy, Lachlan",7,3,1,4,0,0,0,7
Adelaide,"OBrien, Reilly",9,3,2,6,0,0,21,5
Adelaide,"Poholke, Myles",12,9,6,3,1,0,0,3
Adelaide,"Sloane, Rory",13,6,1,7,0,0,0,4
Adelaide,"Smith, Brodie",16,15,3,1,0,0,0,4
Adelaide,"Talia, Daniel",6,5,3,1,0,0,0,2
Adelaide,"Walker, Taylor",11,9,4,2,2,1,0,0
Adelaide,"Brown, Luke",9,7,4,2,0,0,0,1
Adelaide,"Crocker, Ben",14,12,8,2,0,1,0,1
Adelaide,"Crouch, Brad",28,15,3,13,0,0,0,4
Adelaide,"Crouch, Matt",27,10,4,17,0,0,0,5
Adelaide,"Doedee, Tom",18,7,5,11,0,0,0,1
Adelaide,"Frampton, Billy",10,4,4,6,1,1,1,0
Adelaide,"Hamill, Will",13,8,5,5,0,0,0,1
Adelaide,"Hartigan, Kyle",7,4,2,3,0,0,0,1
Adelaide,"Jones, Chayce",12,3,0,9,0,0,0,1
Adelaide,"Keays, Ben",14,11,2,3,0,0,0,4
Adelaide,"Kelly, Jake",9,8,3,1,0,0,0,3
Adelaide,"Laird, Rory",25,14,6,11,0,0,0,1
Adelaide,"Lynch, Tom",17,13,4,4,1,1,0,1
Adelaide,"McAdam, Shane",7,6,3,1,1,1,0,5
Adelaide,"McHenry, Ned",12,4,3,8,0,2,0,0
Adelaide,"Murphy, Lachlan",7,4,2,3,0,1,0,2
Adelaide,"OBrien, Reilly",16,7,4,9,0,0,17,3
Adelaide,"Poholke, Myles",7,3,3,4,1,0,0,1
Adelaide,"Sloane, Rory",16,7,1,9,0,0,0,1
Adelaide,"Smith, Brodie",20,15,7,5,0,0,0,1
Adelaide,"Talia, Daniel",9,6,6,3,0,0,0,1
Adelaide,"Walker, Taylor",6,2,0,4,0,0,0,1
Adelaide,"Brown, Luke",11,7,4,4,0,0,0,3
Adelaide,"Crouch, Brad",23,14,3,9,0,0,0,2
Adelaide,"Crouch, Matt",29,16,4,13,0,0,0,0
Adelaide,"Doedee, Tom",20,15,11,5,0,0,0,0
Adelaide,"Frampton, Billy",8,4,4,4,1,0,5,0
Adelaide,"Hamill, Will",12,7,3,5,0,0,0,3
Adelaide,"Hartigan, Kyle",10,5,6,5,0,0,0,2
Adelaide,"Jones, Chayce",11,6,2,5,1,0,0,2
Adelaide,"Keays, Ben",13,7,3,6,0,0,0,1
Adelaide,"Kelly, Jake",10,10,8,0,0,0,0,2
Adelaide,"Laird, Rory",17,7,5,10,0,0,0,2
Adelaide,"Lynch, Tom",17,10,5,7,1,0,0,1
Adelaide,"Mackay, David",16,5,2,11,0,0,0,2
Adelaide,"McAdam, Shane",7,5,4,2,0,1,0,0
Adelaide,"McAsey, Fischer",14,4,3,10,0,0,0,1
Adelaide,"McHenry, Ned",10,4,3,6,0,0,0,4
Adelaide,"McPherson, Andrew",9,4,5,5,0,0,0,2
Adelaide,"OBrien, Reilly",19,10,9,9,0,0,12,7
Adelaide,"Sloane, Rory",18,9,5,9,1,0,0,2
Adelaide,"Smith, Brodie",31,16,4,15,1,1,0,3
Adelaide,"Stengle, Tyson",5,3,2,2,0,2,0,2
Adelaide,"Talia, Daniel",14,12,7,2,0,0,0,0
Adelaide,"Brown, Luke",11,6,2,5,0,0,0,0
Adelaide,"Crouch, Brad",15,7,1,8,0,0,0,6
Adelaide,"Crouch, Matt",26,8,1,18,0,0,0,3
Adelaide,"Doedee, Tom",18,14,10,4,0,0,0,2
Adelaide,"Hamill, Will",8,2,2,6,0,0,0,0
Adelaide,"Hartigan, Kyle",11,6,4,5,0,0,0,1
Adelaide,"Jones, Chayce",6,3,2,3,0,0,0,3
Adelaide,"Keays, Ben",23,15,2,8,1,0,0,3
Adelaide,"Kelly, Jake",15,11,2,4,0,0,0,0
Adelaide,"Laird, Rory",15,8,3,7,1,0,0,4
Adelaide,"Lynch, Tom",17,11,3,6,1,1,0,0
Adelaide,"Mackay, David",17,9,3,8,0,1,0,2
Adelaide,"McAdam, Shane",7,6,3,1,2,0,0,4
Adelaide,"McAsey, Fischer",5,2,2,3,0,1,0,0
Adelaide,"McHenry, Ned",8,6,2,2,0,0,0,4
Adelaide,"McPherson, Andrew",12,8,3,4,0,0,0,1
Adelaide,"OBrien, Reilly",14,5,4,9,0,0,28,3
Adelaide,"Seedsman, Paul",17,5,1,12,0,0,0,6
Adelaide,"Smith, Brodie",12,8,2,4,0,0,0,3
Adelaide,"Stengle, Tyson",7,7,2,0,0,0,0,1
Adelaide,"Talia, Daniel",14,13,6,1,0,0,0,3
Adelaide,"Walker, Taylor",8,6,2,2,3,2,1,0
Adelaide,"Brown, Luke",14,8,1,6,0,1,0,5
Adelaide,"Crouch, Brad",5,3,0,2,0,0,0,2
Adelaide,"Crouch, Matt",26,12,4,14,0,0,0,2
Adelaide,"Doedee, Tom",7,4,2,3,0,0,0,1
Adelaide,"Hamill, Will",17,9,0,8,0,0,0,6
Adelaide,"Hartigan, Kyle",9,5,0,4,0,0,0,4
Adelaide,"Himmelberg, Elliott",8,4,3,4,0,1,1,0
Adelaide,"Jones, Chayce",6,2,2,4,0,0,0,1
Adelaide,"Keays, Ben",21,8,3,13,0,1,0,4
Adelaide,"Laird, Rory",21,8,3,13,0,0,0,3
Adelaide,"Lynch, Tom",14,11,4,3,0,1,0,0
Adelaide,"Mackay, David",13,4,0,9,0,0,0,2
Adelaide,"McAdam, Shane",9,4,1,5,0,1,0,3
Adelaide,"McAsey, Fischer",7,3,2,4,0,0,0,0
Adelaide,"McPherson, Andrew",19,10,4,9,0,0,0,3
Adelaide,"Murphy, Lachlan",16,10,4,6,3,1,0,1
Adelaide,"OBrien, Reilly",19,8,2,11,0,0,26,1
Adelaide,"Seedsman, Paul",22,11,5,11,1,2,0,7
Adelaide,"Smith, Brodie",24,19,3,5,1,0,0,2
Adelaide,"Stengle, Tyson",18,8,1,10,1,1,0,3
Adelaide,"Talia, Daniel",13,9,6,4,0,0,0,2
Adelaide,"Walker, Taylor",9,7,5,2,2,1,0,2
Adelaide,"Atkins, Rory",10,5,3,5,1,0,0,0
Adelaide,"Brown, Luke",7,2,0,5,0,0,0,1
Adelaide,"Crouch, Matt",22,9,3,13,0,0,0,4
Adelaide,"Gibbs, Bryce",12,7,2,5,0,0,0,2
Adelaide,"Hamill, Will",6,1,2,5,0,0,0,1
Adelaide,"Hartigan, Kyle",12,7,4,5,0,0,0,1
Adelaide,"Himmelberg, Elliott",11,4,3,7,1,0,0,5
Adelaide,"Jones, Chayce",8,6,1,2,0,0,0,4
Adelaide,"Keays, Ben",12,8,2,4,0,0,0,7
Adelaide,"Kelly, Jake",8,6,4,2,0,0,0,4
Adelaide,"Knight, Riley",3,2,1,1,0,0,0,5
Adelaide,"Laird, Rory",22,12,3,10,1,0,0,3
Adelaide,"Lynch, Tom",24,15,3,9,0,0,0,1
Adelaide,"McAdam, Shane",10,8,5,2,2,2,0,3
Adelaide,"McPherson, Andrew",15,4,1,11,0,0,0,2
Adelaide,"Murphy, Lachlan",8,4,3,4,1,0,0,2
Adelaide,"OBrien, Reilly",12,5,2,7,0,0,17,8
Adelaide,"Seedsman, Paul",20,14,4,6,1,1,0,3
Adelaide,"Smith, Brodie",12,9,3,3,0,0,0,8
Adelaide,"Stengle, Tyson",13,5,2,8,0,0,0,4
Adelaide,"Strachan, Kieran",4,1,0,3,0,0,10,4
Adelaide,"Talia, Daniel",7,3,2,4,0,0,0,1
Adelaide,"Brown, Luke",20,15,1,5,0,0,0,1
Adelaide,"Crocker, Ben",4,4,1,0,1,0,0,7
Adelaide,"Crouch, Matt",27,10,0,17,0,1,0,8
Adelaide,"Doedee, Tom",18,5,3,13,0,0,0,1
Adelaide,"Fogarty, Darcy",5,2,1,3,1,1,0,4
Adelaide,"Hamill, Will",1,1,0,0,0,0,0,0
Adelaide,"Himmelberg, Elliott",10,8,3,2,1,1,5,3
Adelaide,"Jones, Chayce",3,2,0,1,0,0,0,4
Adelaide,"Keays, Ben",19,10,4,9,0,0,0,3
Adelaide,"Kelly, Jake",8,7,4,1,0,0,0,5
Adelaide,"Laird, Rory",20,7,0,13,0,0,0,7
Adelaide,"Lynch, Tom",19,8,4,11,0,0,0,1
Adelaide,"Mackay, David",16,7,1,9,0,0,0,1
Adelaide,"McAsey, Fischer",6,5,4,1,0,0,0,0
Adelaide,"McHenry, Ned",8,5,1,3,0,0,0,5
Adelaide,"Murphy, Lachlan",8,1,0,7,0,1,0,8
Adelaide,"OBrien, Reilly",9,6,2,3,0,0,26,2
Adelaide,"Schoenberg, Harry",12,5,2,7,0,0,0,2
Adelaide,"Seedsman, Paul",17,11,1,6,2,0,0,2
Adelaide,"Sholl, Lachlan",10,6,1,4,0,0,0,1
Adelaide,"Talia, Daniel",7,4,3,3,0,0,0,2
Adelaide,"Walker, Taylor",5,4,2,1,0,0,0,0
Adelaide,"Brown, Luke",8,5,3,3,0,0,0,4
Adelaide,"Crocker, Ben",9,7,1,2,0,1,0,3
Adelaide,"Crouch, Matt",29,11,6,18,0,0,0,4
Adelaide,"Doedee, Tom",12,9,4,3,0,0,0,5
Adelaide,"Fogarty, Darcy",9,5,1,4,0,0,0,1
Adelaide,"Hartigan, Kyle",7,4,2,3,0,0,0,0
Adelaide,"Himmelberg, Elliott",10,8,5,2,2,0,5,0
Adelaide,"Keays, Ben",17,7,0,10,0,0,0,2
Adelaide,"Laird, Rory",37,19,5,18,0,0,0,9
Adelaide,"Lynch, Tom",5,5,2,0,0,0,0,1
Adelaide,"Mackay, David",13,7,3,6,0,0,0,1
Adelaide,"McAdam, Shane",8,5,4,3,1,1,0,3
Adelaide,"McAsey, Fischer",7,5,3,2,0,0,0,1
Adelaide,"McHenry, Ned",8,2,1,6,0,0,0,4
Adelaide,"McPherson, Andrew",10,6,5,4,0,0,0,3
Adelaide,"OBrien, Reilly",11,4,3,7,0,0,22,2
Adelaide,"Schoenberg, Harry",7,2,0,5,0,0,0,2
Adelaide,"Seedsman, Paul",16,7,4,9,0,1,0,0
Adelaide,"Sholl, Lachlan",16,11,4,5,0,0,0,1
Adelaide,"Smith, Brodie",21,17,11,4,0,0,0,3
Adelaide,"Stengle, Tyson",8,7,2,1,2,1,0,3
Adelaide,"Walker, Taylor",9,5,3,4,0,1,0,0
Adelaide,"Brown, Luke",14,10,3,4,0,0,0,2
Adelaide,"Crouch, Matt",27,12,3,15,1,0,0,3
Adelaide,"Hartigan, Kyle",8,5,2,3,0,0,0,1
Adelaide,"Himmelberg, Elliott",5,3,2,2,1,1,7,2
Adelaide,"Keays, Ben",23,14,4,9,0,0,0,2
Adelaide,"Kelly, Jake",7,3,2,4,0,0,0,3
Adelaide,"Laird, Rory",16,7,2,9,1,0,0,4
Adelaide,"Mackay, David",11,6,3,5,1,0,0,2
Adelaide,"McAdam, Shane",10,5,2,5,0,1,0,3
Adelaide,"McAsey, Fischer",3,2,1,1,0,1,0,3
Adelaide,"McPherson, Andrew",8,3,1,5,0,0,0,0
Adelaide,"Murphy, Lachlan",8,5,0,3,1,1,0,2
Adelaide,"OBrien, Reilly",17,5,6,12,0,1,38,4
Adelaide,"Poholke, Myles",13,8,4,5,0,0,0,5
Adelaide,"Schoenberg, Harry",15,4,1,11,0,0,0,0
Adelaide,"Seedsman, Paul",12,6,3,6,0,1,0,1
Adelaide,"Sholl, Lachlan",7,4,2,3,0,0,0,0
Adelaide,"Sloane, Rory",15,7,3,8,0,0,0,2
Adelaide,"Smith, Brodie",18,14,4,4,1,0,0,0
Adelaide,"Stengle, Tyson",7,4,0,3,1,0,0,0
Adelaide,"Talia, Daniel",2,1,0,1,0,0,0,0
Adelaide,"Walker, Taylor",6,5,2,1,1,0,0,1
Adelaide,"Brown, Luke",5,3,1,2,0,0,0,2
Adelaide,"Butts, Jordon",8,4,3,4,0,0,0,1
Adelaide,"Crocker, Ben",5,4,3,1,0,1,0,1
Adelaide,"Crouch, Matt",22,12,3,10,0,0,0,14
Adelaide,"Fogarty, Darcy",8,5,1,3,0,0,0,5
Adelaide,"Hartigan, Kyle",9,8,5,1,0,0,0,1
Adelaide,"Himmelberg, Elliott",8,5,1,3,0,1,3,2
Adelaide,"Jones, Chayce",9,3,0,6,0,0,0,5
Adelaide,"Keays, Ben",17,9,4,8,0,1,0,3
Adelaide,"Kelly, Jake",4,3,1,1,0,0,0,1
Adelaide,"Laird, Rory",28,12,2,16,0,1,0,7
Adelaide,"Mackay, David",18,8,4,10,1,0,0,2
Adelaide,"McAdam, Shane",11,8,3,3,1,0,0,1
Adelaide,"Murphy, Lachlan",13,4,1,9,0,0,0,6
Adelaide,"OBrien, Reilly",7,4,1,3,0,2,37,4
Adelaide,"Poholke, Myles",14,6,1,8,0,0,0,3
Adelaide,"Schoenberg, Harry",9,2,0,7,1,0,0,4
Adelaide,"Sholl, Lachlan",8,5,3,3,0,0,0,1
Adelaide,"Sloane, Rory",15,7,0,8,1,0,0,6
Adelaide,"Smith, Brodie",21,16,3,5,0,0,0,1
Adelaide,"Stengle, Tyson",8,5,1,3,1,1,0,0
Adelaide,"Walker, Taylor",3,2,1,1,0,0,0,4
Adelaide,"Brown, Luke",8,6,2,2,0,0,0,3
Adelaide,"Crouch, Brad",27,13,0,14,0,0,0,4
Adelaide,"Crouch, Matt",32,8,3,24,0,1,0,5
Adelaide,"Fogarty, Darcy",9,3,2,6,2,0,0,2
Adelaide,"Hartigan, Kyle",8,5,2,3,0,0,0,2
Adelaide,"Himmelberg, Elliott",16,7,4,9,0,1,4,1
Adelaide,"Jones, Chayce",13,5,2,8,2,0,0,0
Adelaide,"Keays, Ben",22,9,1,13,1,0,0,2
Adelaide,"Kelly, Jake",7,3,1,4,0,0,0,2
Adelaide,"Laird, Rory",25,8,1,17,0,0,0,3
Adelaide,"Mackay, David",15,9,5,6,0,1,0,1
Adelaide,"McAdam, Shane",10,6,6,4,1,1,0,3
Adelaide,"Murphy, Lachlan",13,9,1,4,1,1,0,1
Adelaide,"OBrien, Reilly",19,11,8,8,0,0,26,2
Adelaide,"Poholke, Myles",6,3,1,3,0,1,0,0
Adelaide,"Schoenberg, Harry",11,6,2,5,2,0,0,1
Adelaide,"Sholl, Lachlan",11,9,4,2,0,0,0,1
Adelaide,"Sloane, Rory",18,8,0,10,0,1,0,6
Adelaide,"Smith, Brodie",22,13,2,9,0,0,0,1
Adelaide,"Stengle, Tyson",12,8,4,4,1,2,0,0
Adelaide,"Talia, Daniel",8,4,2,4,0,0,0,1
Adelaide,"Walker, Taylor",8,6,5,2,2,1,0,1
Adelaide,"Brown, Luke",11,5,0,6,0,0,0,4
Adelaide,"Crouch, Brad",31,11,4,20,0,0,0,2
Adelaide,"Crouch, Matt",27,11,2,16,1,0,0,12
Adelaide,"Fogarty, Darcy",7,4,2,3,0,0,0,2
Adelaide,"Hartigan, Kyle",10,6,4,4,0,0,0,4
Adelaide,"Himmelberg, Elliott",14,7,4,7,2,1,5,1
Adelaide,"Jones, Chayce",9,5,3,4,0,0,0,1
Adelaide,"Keays, Ben",18,10,3,8,0,0,0,4
Adelaide,"Kelly, Jake",12,7,2,5,0,0,0,1
Adelaide,"Laird, Rory",28,12,2,16,0,0,0,9
Adelaide,"Mackay, David",19,10,3,9,0,0,0,2
Adelaide,"McAdam, Shane",14,9,7,5,2,1,0,5
Adelaide,"McPherson, Andrew",11,7,2,4,0,0,0,1
Adelaide,"Murphy, Lachlan",8,5,1,3,0,2,0,0
Adelaide,"OBrien, Reilly",13,9,1,4,0,0,43,5
Adelaide,"Schoenberg, Harry",10,6,1,4,0,0,0,1
Adelaide,"Sholl, Lachlan",10,7,1,3,0,0,0,2
Adelaide,"Sloane, Rory",17,8,0,9,1,1,0,7
Adelaide,"Smith, Brodie",16,14,1,2,0,2,0,2
Adelaide,"Stengle, Tyson",14,9,5,5,1,1,0,3
Adelaide,"Talia, Daniel",11,5,4,6,0,0,0,0
Adelaide,"Walker, Taylor",8,5,1,3,1,1,0,1
Adelaide,"Brown, Luke",14,11,5,3,0,0,0,1
Adelaide,"Butts, Jordon",6,4,2,2,0,0,0,1
Adelaide,"Crouch, Brad",18,12,3,6,1,0,0,4
Adelaide,"Crouch, Matt",28,11,2,17,0,1,0,3
Adelaide,"Fogarty, Darcy",7,4,0,3,0,0,0,1
Adelaide,"Frampton, Billy",6,3,3,3,1,0,0,3
Adelaide,"Gibbs, Bryce",27,16,6,11,0,1,0,1
Adelaide,"Hartigan, Kyle",11,6,4,5,0,0,0,1
Adelaide,"Himmelberg, Elliott",10,5,2,5,2,2,3,2
Adelaide,"Jones, Chayce",6,2,2,4,1,0,0,1
Adelaide,"Keays, Ben",18,11,7,7,0,1,0,1
Adelaide,"Kelly, Jake",7,4,2,3,0,0,0,3
Adelaide,"Laird, Rory",27,11,3,16,0,0,0,5
Adelaide,"Lynch, Tom",21,16,5,5,1,0,0,2
Adelaide,"McAdam, Shane",10,10,5,0,1,3,0,4
Adelaide,"McPherson, Andrew",17,6,2,11,0,0,0,1
Adelaide,"OBrien, Reilly",10,8,2,2,0,0,35,3
Adelaide,"Schoenberg, Harry",21,10,4,11,0,0,0,5
Adelaide,"Sholl, Lachlan",24,19,3,5,2,1,0,0
Adelaide,"Sloane, Rory",18,11,3,7,0,0,0,2
Adelaide,"Smith, Brodie",11,8,3,3,1,0,0,1
Adelaide,"Stengle, Tyson",7,3,0,4,0,0,0,7
Adelaide,"Brown, Luke",14,11,6,3,0,0,0,2
Adelaide,"Crouch, Brad",26,11,1,15,0,1,0,4
Adelaide,"Crouch, Matt",30,10,5,20,0,0,0,3
Adelaide,"Fogarty, Darcy",10,6,3,4,2,0,0,0
Adelaide,"Hartigan, Kyle",9,7,2,2,0,0,0,0
Adelaide,"Himmelberg, Elliott",9,4,4,5,0,2,3,3
Adelaide,"Jones, Chayce",3,2,3,1,0,0,0,0
Adelaide,"Keays, Ben",16,9,2,7,0,1,0,3
Adelaide,"Kelly, Jake",15,9,5,6,0,0,0,1
Adelaide,"Laird, Rory",28,14,1,14,0,0,0,2
Adelaide,"Lynch, Tom",25,12,5,13,0,1,0,2
Adelaide,"Mackay, David",17,8,1,9,0,0,0,1
Adelaide,"McAdam, Shane",14,5,2,9,1,0,0,0
Adelaide,"McPherson, Andrew",13,8,2,5,0,0,0,2
Adelaide,"OBrien, Reilly",19,8,7,11,0,0,29,4
Adelaide,"Schoenberg, Harry",9,5,1,4,0,0,0,0
Adelaide,"Sholl, Lachlan",19,11,6,8,0,0,0,1
Adelaide,"Sloane, Rory",15,7,1,8,0,0,0,6
Adelaide,"Smith, Brodie",17,11,3,6,0,1,0,4
Adelaide,"Stengle, Tyson",7,4,1,3,0,1,0,0
Adelaide,"Talia, Daniel",6,3,0,3,0,0,0,2
Adelaide,"Walker, Taylor",9,8,6,1,1,1,0,0
Brisbane Lions,"Adams, Marcus",5,2,1,3,0,0,0,0
Brisbane Lions,"Andrews, Harris",17,9,4,8,0,0,0,2
Brisbane Lions,"Answerth, Noah",15,15,4,0,0,0,0,2
Brisbane Lions,"Bailey, Zac",13,7,3,6,0,0,0,2
Brisbane Lions,"Berry, Jarrod",13,5,2,8,0,1,0,0
Brisbane Lions,"Cameron, Charlie",9,7,3,2,2,0,0,2
Brisbane Lions,"Gardiner, Darcy",7,5,3,2,0,0,0,2
Brisbane Lions,"Hipwood, Eric",16,13,5,3,3,0,0,1
Brisbane Lions,"Lyons, Jarryd",22,15,6,7,0,0,0,5
Brisbane Lions,"Martin, Stefan",10,6,1,4,0,1,12,3
Brisbane Lions,"McCarthy, Lincoln",11,4,3,7,0,1,0,4
Brisbane Lions,"McCluggage, Hugh",19,11,3,8,0,1,0,0
Brisbane Lions,"McInerney, Oscar",4,3,1,1,0,0,10,2
Brisbane Lions,"McStay, Daniel",7,4,3,3,2,0,0,2
Brisbane Lions,"Neale, Lachie",26,14,0,12,1,2,0,10
Brisbane Lions,"Rayner, Cam",9,5,2,4,1,0,0,3
Brisbane Lions,"Rich, Daniel",17,16,4,1,0,0,0,0
Brisbane Lions,"Robertson, Deven",7,3,0,4,0,0,0,3
Brisbane Lions,"Robinson, Mitch",24,14,7,10,0,0,0,2
Brisbane Lions,"Starcevich, Brandon",9,7,4,2,0,0,0,0
Brisbane Lions,"Witherden, Alex",13,10,7,3,0,0,0,0
Brisbane Lions,"Zorko, Dayne",14,9,2,5,0,1,0,5
Brisbane Lions,"Ah Chee, Callum",15,10,5,5,1,0,0,2
Brisbane Lions,"Andrews, Harris",15,8,2,7,0,0,0,0
Brisbane Lions,"Bailey, Zac",12,7,3,5,0,0,0,4
Brisbane Lions,"Berry, Jarrod",14,7,2,7,0,1,0,5
Brisbane Lions,"Berry, Tom",9,5,3,4,0,1,0,1
Brisbane Lions,"Birchall, Grant",14,4,2,10,0,0,0,1
Brisbane Lions,"Cameron, Charlie",14,12,4,2,4,2,0,3
Brisbane Lions,"Gardiner, Darcy",15,12,4,3,0,0,0,1
Brisbane Lions,"Hipwood, Eric",9,4,3,5,1,0,0,1
Brisbane Lions,"Lester, Ryan",10,4,1,6,0,0,0,3
Brisbane Lions,"Lyons, Jarryd",17,11,1,6,0,0,0,8
Brisbane Lions,"Martin, Stefan",6,3,2,3,0,0,18,1
Brisbane Lions,"McCarthy, Lincoln",9,4,3,5,0,0,0,3
Brisbane Lions,"McCluggage, Hugh",15,8,2,7,0,1,0,1
Brisbane Lions,"McInerney, Oscar",13,10,3,3,1,0,19,5
Brisbane Lions,"McStay, Daniel",5,2,2,3,1,0,0,0
Brisbane Lions,"Neale, Lachie",29,11,7,18,2,0,0,2
Brisbane Lions,"Rayner, Cam",10,6,5,4,0,1,0,3
Brisbane Lions,"Rich, Daniel",21,15,4,6,0,0,0,0
Brisbane Lions,"Robinson, Mitch",23,18,5,5,0,0,0,0
Brisbane Lions,"Starcevich, Brandon",17,12,8,5,0,0,0,3
Brisbane Lions,"Zorko, Dayne",17,9,1,8,2,1,0,3
Brisbane Lions,"Ah Chee, Callum",9,5,1,4,0,1,0,4
Brisbane Lions,"Andrews, Harris",8,8,3,0,0,0,0,0
Brisbane Lions,"Bailey, Zac",10,5,2,5,1,1,0,2
Brisbane Lions,"Berry, Jarrod",13,9,3,4,3,2,0,5
Brisbane Lions,"Berry, Tom",4,2,1,2,0,0,0,2
Brisbane Lions,"Birchall, Grant",15,11,8,4,0,0,0,1
Brisbane Lions,"Cameron, Charlie",5,4,2,1,1,0,0,2
Brisbane Lions,"Ellis-Yolmen, Cam",16,10,3,6,0,1,0,1
Brisbane Lions,"Gardiner, Darcy",11,10,4,1,0,0,0,0
Brisbane Lions,"Hipwood, Eric",12,9,4,3,0,2,0,1
Brisbane Lions,"Lester, Ryan",16,8,5,8,0,0,0,4
Brisbane Lions,"Lyons, Jarryd",25,18,2,7,0,0,0,5
Brisbane Lions,"McCarthy, Lincoln",9,3,1,6,0,2,0,3
Brisbane Lions,"McCluggage, Hugh",26,20,4,6,0,2,0,5
Brisbane Lions,"McInerney, Oscar",11,8,1,3,1,0,16,0
Brisbane Lions,"McStay, Daniel",6,3,3,3,1,0,0,0
Brisbane Lions,"Neale, Lachie",32,15,2,17,2,0,0,7
Brisbane Lions,"Rayner, Cam",8,5,1,3,0,1,0,4
Brisbane Lions,"Rich, Daniel",16,15,9,1,0,0,0,2
Brisbane Lions,"Robinson, Mitch",12,10,2,2,0,0,0,5
Brisbane Lions,"Smith, Archie",6,1,0,5,0,0,14,1
Brisbane Lions,"Starcevich, Brandon",12,9,3,3,1,0,0,3
Brisbane Lions,"Ah Chee, Callum",14,9,4,5,0,1,0,2
Brisbane Lions,"Andrews, Harris",10,6,5,4,0,0,0,4
Brisbane Lions,"Bailey, Zac",14,10,4,4,1,1,0,1
Brisbane Lions,"Berry, Jarrod",23,14,7,9,0,0,0,10
Brisbane Lions,"Birchall, Grant",11,8,2,3,0,0,0,2
Brisbane Lions,"Cameron, Charlie",9,9,4,0,2,2,0,1
Brisbane Lions,"Ellis-Yolmen, Cam",12,9,4,3,1,0,0,4
Brisbane Lions,"Gardiner, Darcy",10,7,4,3,0,0,0,5
Brisbane Lions,"Hipwood, Eric",9,9,3,0,1,2,0,0
Brisbane Lions,"Lester, Ryan",11,8,3,3,0,0,0,2
Brisbane Lions,"Lyons, Jarryd",24,18,2,6,0,0,0,4
Brisbane Lions,"McCarthy, Lincoln",11,8,4,3,2,2,0,4
Brisbane Lions,"McCluggage, Hugh",24,18,6,6,1,5,0,2
Brisbane Lions,"McInerney, Oscar",3,1,1,2,0,0,19,5
Brisbane Lions,"McStay, Daniel",12,7,3,5,1,0,0,3
Brisbane Lions,"Neale, Lachie",31,18,8,13,0,6,0,3
Brisbane Lions,"Rayner, Cam",14,4,3,10,0,1,0,3
Brisbane Lions,"Rich, Daniel",12,12,3,0,1,1,0,1
Brisbane Lions,"Robinson, Mitch",17,13,4,4,0,1,0,1
Brisbane Lions,"Smith, Archie",4,2,1,2,0,0,10,3
Brisbane Lions,"Starcevich, Brandon",7,6,3,1,0,0,0,4
Brisbane Lions,"Zorko, Dayne",3,3,2,0,0,0,0,4
Brisbane Lions,"Ah Chee, Callum",4,3,2,1,0,0,0,3
Brisbane Lions,"Andrews, Harris",6,4,3,2,0,0,0,2
Brisbane Lions,"Bailey, Zac",14,6,3,8,1,0,0,2
Brisbane Lions,"Berry, Jarrod",19,10,3,9,0,0,0,5
Brisbane Lions,"Berry, Tom",11,3,2,8,0,1,0,5
Brisbane Lions,"Birchall, Grant",12,7,3,5,0,0,0,2
Brisbane Lions,"Cameron, Charlie",12,11,4,1,1,1,0,1
Brisbane Lions,"Ellis-Yolmen, Cam",3,3,0,0,0,0,0,0
Brisbane Lions,"Gardiner, Darcy",11,9,5,2,0,0,0,2
Brisbane Lions,"Hipwood, Eric",9,8,7,1,1,3,0,1
Brisbane Lions,"Lester, Ryan",9,4,2,5,0,0,0,0
Brisbane Lions,"Lyons, Jarryd",27,17,5,10,0,1,0,5
Brisbane Lions,"Martin, Stefan",6,6,1,0,0,0,22,4
Brisbane Lions,"McCarthy, Lincoln",10,8,2,2,2,1,0,3
Brisbane Lions,"McCluggage, Hugh",19,8,3,11,1,0,0,7
Brisbane Lions,"McInerney, Oscar",9,3,3,6,1,0,21,4
Brisbane Lions,"McStay, Daniel",11,7,8,4,1,1,0,0
Brisbane Lions,"Neale, Lachie",29,16,5,13,1,1,0,2
Brisbane Lions,"Rayner, Cam",15,7,2,8,2,1,0,1
Brisbane Lions,"Rich, Daniel",20,17,1,3,0,0,0,2
Brisbane Lions,"Robinson, Mitch",13,9,4,4,1,0,0,3
Brisbane Lions,"Starcevich, Brandon",5,5,3,0,0,0,0,4
Brisbane Lions,"Ah Chee, Callum",15,10,1,5,0,0,0,4
Brisbane Lions,"Andrews, Harris",7,3,0,4,0,0,0,1
Brisbane Lions,"Bailey, Zac",9,5,2,4,0,0,0,3
Brisbane Lions,"Berry, Jarrod",19,10,2,9,0,2,0,7
Brisbane Lions,"Berry, Tom",7,4,2,3,0,0,0,2
Brisbane Lions,"Birchall, Grant",10,9,3,1,0,0,0,2
Brisbane Lions,"Cameron, Charlie",6,4,2,2,1,2,0,1
Brisbane Lions,"Gardiner, Darcy",6,4,1,2,0,0,0,3
Brisbane Lions,"Hipwood, Eric",8,5,3,3,1,0,0,2
Brisbane Lions,"Lester, Ryan",8,6,2,2,0,0,0,0
Brisbane Lions,"Lyons, Jarryd",20,14,3,6,0,0,0,6
Brisbane Lions,"Martin, Stefan",6,4,2,2,0,0,19,2
Brisbane Lions,"McCarthy, Lincoln",5,4,1,1,0,0,0,5
Brisbane Lions,"McCluggage, Hugh",10,5,4,5,1,0,0,5
Brisbane Lions,"McInerney, Oscar",3,2,0,1,0,1,17,2
Brisbane Lions,"McStay, Daniel",7,4,2,3,0,0,0,0
Brisbane Lions,"Neale, Lachie",26,12,5,14,1,0,0,4
Brisbane Lions,"Rayner, Cam",12,8,6,4,2,0,0,5
Brisbane Lions,"Rich, Daniel",12,12,1,0,0,0,0,1
Brisbane Lions,"Robinson, Mitch",11,5,0,6,0,0,0,0
Brisbane Lions,"Starcevich, Brandon",8,6,3,2,0,0,0,1
Brisbane Lions,"Zorko, Dayne",18,13,0,5,0,1,0,6
Brisbane Lions,"Ah Chee, Callum",11,10,5,1,0,0,0,1
Brisbane Lions,"Andrews, Harris",14,11,7,3,0,0,0,2
Brisbane Lions,"Bailey, Zac",18,11,10,7,2,0,0,3
Brisbane Lions,"Berry, Jarrod",15,10,5,5,0,2,0,3
Brisbane Lions,"Berry, Tom",8,2,2,6,0,0,0,1
Brisbane Lions,"Birchall, Grant",18,16,8,2,0,0,0,0
Brisbane Lions,"Cameron, Charlie",12,8,6,4,2,2,0,2
Brisbane Lions,"Gardiner, Darcy",15,8,5,7,0,0,0,2
Brisbane Lions,"Hipwood, Eric",15,11,4,4,1,2,0,2
Brisbane Lions,"Lester, Ryan",8,5,3,3,0,0,0,0
Brisbane Lions,"Lyons, Jarryd",17,10,5,7,1,0,0,3
Brisbane Lions,"Martin, Stefan",4,2,0,2,1,0,21,0
Brisbane Lions,"McCarthy, Lincoln",9,7,4,2,2,0,0,1
Brisbane Lions,"McCluggage, Hugh",17,13,4,4,0,0,0,1
Brisbane Lions,"McInerney, Oscar",5,2,1,3,0,1,12,0
Brisbane Lions,"McStay, Daniel",11,9,6,2,0,1,0,2
Brisbane Lions,"Neale, Lachie",20,9,4,11,1,0,0,3
Brisbane Lions,"Rayner, Cam",8,5,2,3,2,0,0,1
Brisbane Lions,"Rich, Daniel",16,13,8,3,0,0,0,1
Brisbane Lions,"Robinson, Mitch",11,8,2,3,0,0,0,3
Brisbane Lions,"Starcevich, Brandon",9,7,1,2,0,0,0,1
Brisbane Lions,"Zorko, Dayne",18,17,6,1,1,1,0,2
Brisbane Lions,"Ah Chee, Callum",10,7,4,3,0,0,0,3
Brisbane Lions,"Andrews, Harris",11,8,4,3,0,0,0,1
Brisbane Lions,"Bailey, Zac",21,16,8,5,1,1,0,1
Brisbane Lions,"Berry, Jarrod",20,10,5,10,0,0,0,6
Brisbane Lions,"Berry, Tom",2,0,0,2,0,0,0,1
Brisbane Lions,"Birchall, Grant",15,10,5,5,0,0,0,3
Brisbane Lions,"Cameron, Charlie",9,6,4,3,2,2,0,4
Brisbane Lions,"Gardiner, Darcy",15,12,4,3,0,0,0,1
Brisbane Lions,"Hipwood, Eric",7,7,3,0,1,0,0,0
Brisbane Lions,"Lester, Ryan",9,4,2,5,0,0,0,0
Brisbane Lions,"Lyons, Jarryd",22,15,7,7,0,0,0,9
Brisbane Lions,"McCarthy, Lincoln",9,3,2,6,1,0,0,4
Brisbane Lions,"McCluggage, Hugh",22,13,3,9,0,1,0,2
Brisbane Lions,"McInerney, Oscar",13,8,2,5,0,0,8,1
Brisbane Lions,"McStay, Daniel",9,5,3,4,0,2,0,6
Brisbane Lions,"Neale, Lachie",33,16,6,17,0,0,0,1
Brisbane Lions,"Rayner, Cam",14,6,4,8,1,0,0,4
Brisbane Lions,"Rich, Daniel",5,5,0,0,0,0,0,1
Brisbane Lions,"Robinson, Mitch",15,13,7,2,0,1,0,1
Brisbane Lions,"Smith, Archie",4,2,0,2,0,0,10,1
Brisbane Lions,"Starcevich, Brandon",9,6,4,3,0,1,0,1
Brisbane Lions,"Zorko, Dayne",17,16,2,1,1,1,0,6
Brisbane Lions,"Ah Chee, Callum",11,6,4,5,0,0,0,4
Brisbane Lions,"Andrews, Harris",11,10,7,1,0,0,0,1
Brisbane Lions,"Answerth, Noah",17,12,6,5,0,0,0,0
Brisbane Lions,"Bailey, Zac",16,11,7,5,0,1,0,5
Brisbane Lions,"Ballenden, Connor",6,3,3,3,1,0,2,1
Brisbane Lions,"Berry, Jarrod",19,15,6,4,0,0,0,2
Brisbane Lions,"Birchall, Grant",15,13,6,2,0,0,0,2
Brisbane Lions,"Cameron, Charlie",10,9,4,1,4,1,0,4
Brisbane Lions,"Ellis-Yolmen, Cam",14,8,3,6,1,0,0,3
Brisbane Lions,"Gardiner, Darcy",10,9,6,1,0,0,0,1
Brisbane Lions,"Hipwood, Eric",8,6,2,2,1,1,0,1
Brisbane Lions,"Lyons, Jarryd",22,11,4,11,1,0,0,3
Brisbane Lions,"McCarthy, Lincoln",14,9,5,5,1,0,0,6
Brisbane Lions,"McCluggage, Hugh",13,5,3,8,0,0,0,0
Brisbane Lions,"McInerney, Oscar",9,5,2,4,0,0,23,0
Brisbane Lions,"Neale, Lachie",33,18,5,15,2,0,0,1
Brisbane Lions,"Rayner, Cam",10,6,5,4,1,1,0,4
Brisbane Lions,"Robinson, Mitch",15,6,3,9,0,0,0,2
Brisbane Lions,"Skinner, Sam",10,8,7,2,1,1,0,2
Brisbane Lions,"Starcevich, Brandon",10,6,2,4,0,0,0,1
Brisbane Lions,"Witherden, Alex",25,20,4,5,0,0,0,2
Brisbane Lions,"Zorko, Dayne",19,14,5,5,1,1,0,5
Brisbane Lions,"Ah Chee, Callum",19,14,5,5,0,1,0,1
Brisbane Lions,"Andrews, Harris",15,13,10,2,0,0,0,2
Brisbane Lions,"Answerth, Noah",8,5,4,3,0,0,0,2
Brisbane Lions,"Bailey, Zac",13,12,5,1,0,0,0,2
Brisbane Lions,"Ballenden, Connor",3,2,2,1,0,1,3,0
Brisbane Lions,"Berry, Jarrod",13,10,6,3,0,0,0,5
Brisbane Lions,"Cameron, Charlie",10,9,5,1,1,3,0,1
Brisbane Lions,"Ellis-Yolmen, Cam",10,4,4,6,0,1,0,2
Brisbane Lions,"Gardiner, Darcy",13,10,6,3,0,0,0,2
Brisbane Lions,"Hipwood, Eric",6,4,3,2,1,0,0,0
Brisbane Lions,"Lyons, Jarryd",26,16,7,10,0,3,0,1
Brisbane Lions,"McCarthy, Lincoln",17,8,4,9,1,3,0,0
Brisbane Lions,"McCluggage, Hugh",22,13,6,9,0,0,0,3
Brisbane Lions,"McInerney, Oscar",11,7,4,4,0,0,19,3
Brisbane Lions,"Neale, Lachie",26,16,7,10,0,1,0,1
Brisbane Lions,"Payne, Jack",9,5,5,4,0,0,0,0
Brisbane Lions,"Rayner, Cam",6,5,4,1,0,0,0,1
Brisbane Lions,"Robinson, Mitch",16,11,6,5,0,0,0,2
Brisbane Lions,"Skinner, Sam",7,4,6,3,0,1,1,0
Brisbane Lions,"Starcevich, Brandon",10,7,2,3,0,1,0,2
Brisbane Lions,"Witherden, Alex",19,19,10,0,0,0,0,1
Brisbane Lions,"Zorko, Dayne",19,17,8,2,1,1,0,3
Brisbane Lions,"Ah Chee, Callum",10,8,6,2,2,1,0,3
Brisbane Lions,"Andrews, Harris",4,1,1,3,0,0,0,1
Brisbane Lions,"Answerth, Noah",12,6,4,6,0,0,0,1
Brisbane Lions,"Bailey, Zac",21,14,5,7,2,2,0,3
Brisbane Lions,"Berry, Jarrod",16,9,5,7,0,0,0,3
Brisbane Lions,"Birchall, Grant",13,9,4,4,0,0,0,0
Brisbane Lions,"Cameron, Charlie",8,5,4,3,0,0,0,2
Brisbane Lions,"Eagles, Matt",1,1,0,0,0,0,3,1
Brisbane Lions,"Ellis-Yolmen, Cam",8,4,1,4,0,0,0,2
Brisbane Lions,"Gardiner, Darcy",10,6,2,4,0,0,0,0
Brisbane Lions,"Hipwood, Eric",10,8,3,2,5,1,0,1
Brisbane Lions,"Lyons, Jarryd",25,13,2,12,0,1,0,6
Brisbane Lions,"McCarthy, Lincoln",5,1,1,4,0,0,0,2
Brisbane Lions,"McCluggage, Hugh",21,10,5,11,2,0,0,5
Brisbane Lions,"McInerney, Oscar",9,5,3,4,0,1,39,2
Brisbane Lions,"McStay, Daniel",7,5,2,2,1,0,0,4
Brisbane Lions,"Neale, Lachie",36,19,2,17,1,1,0,4
Brisbane Lions,"Rich, Daniel",14,14,6,0,0,0,0,1
Brisbane Lions,"Robinson, Mitch",8,6,2,2,1,0,0,0
Brisbane Lions,"Starcevich, Brandon",4,3,1,1,0,0,0,0
Brisbane Lions,"Witherden, Alex",24,19,8,5,0,0,0,0
Brisbane Lions,"Zorko, Dayne",24,16,5,8,0,1,0,9
Brisbane Lions,"Ah Chee, Callum",8,6,2,2,0,0,0,3
Brisbane Lions,"Andrews, Harris",10,6,7,4,0,0,0,0
Brisbane Lions,"Answerth, Noah",4,2,0,2,0,0,0,0
Brisbane Lions,"Bailey, Zac",12,8,6,4,1,1,0,1
Brisbane Lions,"Berry, Jarrod",14,4,3,10,0,0,0,4
Brisbane Lions,"Birchall, Grant",17,9,5,8,0,0,0,0
Brisbane Lions,"Cameron, Charlie",5,3,3,2,0,1,0,0
Brisbane Lions,"Eagles, Matt",1,1,0,0,0,0,12,3
Brisbane Lions,"Gardiner, Darcy",10,5,5,5,0,0,0,0
Brisbane Lions,"Hipwood, Eric",7,7,6,0,1,0,0,1
Brisbane Lions,"Lester, Ryan",12,7,6,5,0,0,0,5
Brisbane Lions,"Lyons, Jarryd",23,12,4,11,0,1,0,2
Brisbane Lions,"Mathieson, Rhys",14,8,5,6,0,0,0,2
Brisbane Lions,"McCarthy, Lincoln",9,5,2,4,2,1,0,1
Brisbane Lions,"McCluggage, Hugh",12,8,4,4,0,3,0,1
Brisbane Lions,"McInerney, Oscar",8,3,2,5,2,0,24,5
Brisbane Lions,"McStay, Daniel",7,6,4,1,1,0,0,1
Brisbane Lions,"Neale, Lachie",24,12,5,12,0,0,0,7
Brisbane Lions,"Robinson, Mitch",15,10,0,5,0,0,0,2
Brisbane Lions,"Starcevich, Brandon",11,9,4,2,0,0,0,2
Brisbane Lions,"Witherden, Alex",19,14,4,5,0,0,0,3
Brisbane Lions,"Zorko, Dayne",23,22,5,1,0,2,0,6
Brisbane Lions,"Ah Chee, Callum",12,7,2,5,0,0,0,3
Brisbane Lions,"Andrews, Harris",16,7,5,9,0,0,0,0
Brisbane Lions,"Answerth, Noah",10,9,2,1,0,0,0,0
Brisbane Lions,"Bailey, Zac",17,12,2,5,1,1,0,3
Brisbane Lions,"Berry, Jarrod",20,9,4,11,2,0,0,2
Brisbane Lions,"Birchall, Grant",6,2,0,4,0,0,0,1
Brisbane Lions,"Cameron, Charlie",4,3,2,1,1,0,0,1
Brisbane Lions,"Fullarton, Tom",8,4,1,4,1,2,0,2
Brisbane Lions,"Gardiner, Darcy",14,12,6,2,0,0,0,1
Brisbane Lions,"Hipwood, Eric",14,12,8,2,0,3,0,3
Brisbane Lions,"Lester, Ryan",15,8,8,7,0,0,0,3
Brisbane Lions,"Lyons, Jarryd",11,7,2,4,0,0,0,3
Brisbane Lions,"McCarthy, Lincoln",11,5,2,6,1,1,0,3
Brisbane Lions,"McCluggage, Hugh",19,13,1,6,0,2,0,2
Brisbane Lions,"McInerney, Oscar",8,5,0,3,0,0,20,3
Brisbane Lions,"McStay, Daniel",5,2,3,3,0,1,0,1
Brisbane Lions,"Neale, Lachie",19,8,7,11,0,0,0,1
Brisbane Lions,"Rayner, Cam",10,2,2,8,0,1,0,3
Brisbane Lions,"Robinson, Mitch",6,4,2,2,0,0,0,4
Brisbane Lions,"Starcevich, Brandon",10,9,4,1,0,0,0,0
Brisbane Lions,"Witherden, Alex",15,10,6,5,0,0,0,1
Brisbane Lions,"Zorko, Dayne",21,13,6,8,0,1,0,2
Brisbane Lions,"Ah Chee, Callum",12,5,4,7,0,0,0,1
Brisbane Lions,"Andrews, Harris",5,3,2,2,0,0,0,0
Brisbane Lions,"Answerth, Noah",11,6,3,5,0,0,0,5
Brisbane Lions,"Bailey, Zac",8,3,4,5,0,0,0,4
Brisbane Lions,"Berry, Jarrod",24,16,5,8,1,0,0,3
Brisbane Lions,"Birchall, Grant",13,12,7,1,0,0,0,2
Brisbane Lions,"Cameron, Charlie",10,8,4,2,0,0,0,3
Brisbane Lions,"Coleman, Keidean",12,7,4,5,0,0,0,4
Brisbane Lions,"Fullarton, Tom",1,1,0,0,0,1,0,0
Brisbane Lions,"Gardiner, Darcy",13,10,4,3,0,0,0,0
Brisbane Lions,"Hipwood, Eric",10,8,5,2,2,1,0,1
Brisbane Lions,"Lester, Ryan",12,6,6,6,0,0,0,5
Brisbane Lions,"Lyons, Jarryd",27,16,3,11,1,1,0,2
Brisbane Lions,"McCluggage, Hugh",19,12,1,7,1,1,0,4
Brisbane Lions,"McInerney, Oscar",15,5,0,10,0,0,19,5
Brisbane Lions,"McStay, Daniel",5,4,3,1,0,0,2,0
Brisbane Lions,"Neale, Lachie",27,12,5,15,0,0,0,3
Brisbane Lions,"Rayner, Cam",13,6,5,7,1,0,0,2
Brisbane Lions,"Rich, Daniel",18,14,7,4,0,0,0,2
Brisbane Lions,"Robinson, Mitch",8,7,5,1,0,0,0,4
Brisbane Lions,"Starcevich, Brandon",12,9,4,3,0,0,0,1
Brisbane Lions,"Zorko, Dayne",11,9,1,2,0,1,0,6
Brisbane Lions,"Ah Chee, Callum",17,13,4,4,0,0,0,2
Brisbane Lions,"Answerth, Noah",11,9,2,2,0,0,0,4
Brisbane Lions,"Bailey, Zac",19,13,6,6,0,0,0,3
Brisbane Lions,"Berry, Jarrod",5,3,4,2,1,0,0,0
Brisbane Lions,"Cameron, Charlie",15,11,7,4,2,3,0,5
Brisbane Lions,"Coleman, Keidean",11,7,2,4,0,0,0,4
Brisbane Lions,"Gardiner, Darcy",11,5,0,6,0,0,0,1
Brisbane Lions,"Hipwood, Eric",14,12,10,2,1,1,0,1
Brisbane Lions,"Lester, Ryan",16,10,5,6,0,0,0,3
Brisbane Lions,"Lyons, Jarryd",23,14,2,9,0,1,0,4
Brisbane Lions,"McCarthy, Lincoln",6,3,1,3,1,1,0,1
Brisbane Lions,"McCluggage, Hugh",28,16,4,12,1,0,0,3
Brisbane Lions,"McInerney, Oscar",6,3,1,3,0,0,10,3
Brisbane Lions,"McStay, Daniel",8,6,2,2,1,0,0,2
Brisbane Lions,"Neale, Lachie",33,15,3,18,0,0,0,2
Brisbane Lions,"Payne, Jack",11,8,6,3,0,0,0,1
Brisbane Lions,"Rayner, Cam",12,9,6,3,3,1,0,4
Brisbane Lions,"Rich, Daniel",22,18,6,4,0,0,0,1
Brisbane Lions,"Robinson, Mitch",17,11,8,6,1,0,0,2
Brisbane Lions,"Smith, Archie",8,1,1,7,0,0,8,0
Brisbane Lions,"Starcevich, Brandon",0,0,0,0,0,0,0,0
Brisbane Lions,"Zorko, Dayne",25,20,9,5,2,1,0,4
Brisbane Lions,"Ah Chee, Callum",9,7,2,2,0,0,0,4
Brisbane Lions,"Answerth, Noah",7,7,0,0,0,0,0,3
Brisbane Lions,"Bailey, Zac",8,7,2,1,2,0,0,3
Brisbane Lions,"Birchall, Grant",10,10,4,0,0,0,0,0
Brisbane Lions,"Cameron, Charlie",12,10,2,2,2,1,0,0
Brisbane Lions,"Coleman, Keidean",9,6,2,3,1,1,0,7
Brisbane Lions,"Ellis-Yolmen, Cam",15,7,1,8,1,0,0,3
Brisbane Lions,"Gardiner, Darcy",10,7,7,3,0,0,0,0
Brisbane Lions,"Hinge, Mitch",13,10,2,3,0,0,0,3
Brisbane Lions,"Hipwood, Eric",8,5,0,3,2,0,0,0
Brisbane Lions,"Lester, Ryan",14,12,6,2,0,0,0,4
Brisbane Lions,"Lyons, Jarryd",20,13,1,7,1,1,0,3
Brisbane Lions,"McCluggage, Hugh",15,12,4,3,0,1,0,1
Brisbane Lions,"McInerney, Oscar",14,6,2,8,0,1,20,5
Brisbane Lions,"McStay, Daniel",14,8,5,6,1,0,0,1
Brisbane Lions,"Neale, Lachie",15,5,0,10,0,0,0,1
Brisbane Lions,"Payne, Jack",8,5,3,3,0,0,0,1
Brisbane Lions,"Rayner, Cam",4,2,1,2,0,0,0,5
Brisbane Lions,"Rich, Daniel",23,19,10,4,0,0,0,2
Brisbane Lions,"Robinson, Mitch",13,8,2,5,0,0,0,6
Brisbane Lions,"Smith, Archie",5,3,0,2,0,0,14,0
Brisbane Lions,"Zorko, Dayne",11,8,2,3,1,0,0,3
Brisbane Lions,"Ah Chee, Callum",13,9,10,4,0,0,0,2
Brisbane Lions,"Bailey, Zac",12,6,1,6,0,0,0,1
Brisbane Lions,"Birchall, Grant",13,11,7,2,0,0,0,0
Brisbane Lions,"Cameron, Charlie",11,7,0,4,1,2,0,5
Brisbane Lions,"Coleman, Keidean",6,4,1,2,1,0,0,6
Brisbane Lions,"Ellis-Yolmen, Cam",8,3,0,5,0,0,0,4
Brisbane Lions,"Gardiner, Darcy",9,5,3,4,0,0,0,1
Brisbane Lions,"Hipwood, Eric",9,6,2,3,1,0,0,1
Brisbane Lions,"Lester, Ryan",12,8,1,4,0,0,0,3
Brisbane Lions,"Lyons, Jarryd",20,13,2,7,0,0,0,1
Brisbane Lions,"Martin, Stefan",8,3,1,5,0,0,13,3
Brisbane Lions,"McCarthy, Lincoln",9,6,2,3,2,1,0,2
Brisbane Lions,"McCluggage, Hugh",17,11,5,6,0,3,0,4
Brisbane Lions,"McInerney, Oscar",8,4,1,4,0,0,24,1
Brisbane Lions,"McStay, Daniel",5,3,1,2,0,0,4,3
Brisbane Lions,"Neale, Lachie",29,15,3,14,0,2,0,1
Brisbane Lions,"Payne, Jack",2,2,1,0,0,0,0,0
Brisbane Lions,"Rayner, Cam",11,5,1,6,2,0,0,7
Brisbane Lions,"Rich, Daniel",22,15,2,7,2,0,0,1
Brisbane Lions,"Robinson, Mitch",14,12,1,2,2,1,0,3
Brisbane Lions,"Starcevich, Brandon",16,12,5,4,0,0,0,1
Brisbane Lions,"Zorko, Dayne",14,13,5,1,0,1,0,4
Brisbane Lions,"Ah Chee, Callum",9,5,2,4,0,0,0,6
Brisbane Lions,"Andrews, Harris",12,8,7,4,0,0,0,0
Brisbane Lions,"Bailey, Zac",10,8,1,2,1,0,0,1
Brisbane Lions,"Berry, Jarrod",16,12,6,4,0,2,0,3
Brisbane Lions,"Birchall, Grant",11,10,2,1,0,0,0,0
Brisbane Lions,"Cameron, Charlie",11,10,3,1,3,0,0,4
Brisbane Lions,"Coleman, Keidean",4,1,0,3,0,0,0,2
Brisbane Lions,"Gardiner, Darcy",9,3,2,6,0,0,0,3
Brisbane Lions,"Hipwood, Eric",11,9,5,2,0,2,0,0
Brisbane Lions,"Lester, Ryan",11,9,6,2,0,0,0,2
Brisbane Lions,"Lyons, Jarryd",24,16,6,8,0,1,0,0
Brisbane Lions,"Martin, Stefan",12,8,1,4,0,0,19,3
Brisbane Lions,"McCarthy, Lincoln",7,5,2,2,0,2,0,4
Brisbane Lions,"McCluggage, Hugh",20,10,2,10,1,1,0,5
Brisbane Lions,"McInerney, Oscar",9,6,4,3,1,0,21,7
Brisbane Lions,"McStay, Daniel",3,2,2,1,1,0,0,0
Brisbane Lions,"Neale, Lachie",19,8,1,11,1,0,0,3
Brisbane Lions,"Rayner, Cam",5,1,0,4,1,0,0,2
Brisbane Lions,"Rich, Daniel",20,18,9,2,1,0,0,3
Brisbane Lions,"Robinson, Mitch",11,9,4,2,0,0,0,2
Brisbane Lions,"Starcevich, Brandon",11,7,4,4,0,0,0,2
Brisbane Lions,"Zorko, Dayne",19,13,4,6,0,0,0,5
Brisbane Lions,"Ah Chee, Callum",9,4,0,5,0,0,0,4
Brisbane Lions,"Andrews, Harris",10,8,4,2,0,0,0,1
Brisbane Lions,"Bailey, Zac",8,5,2,3,0,1,0,3
Brisbane Lions,"Berry, Jarrod",8,2,2,6,0,0,0,1
Brisbane Lions,"Birchall, Grant",10,9,3,1,0,0,0,0
Brisbane Lions,"Cameron, Charlie",5,3,1,2,2,0,0,1
Brisbane Lions,"Ellis-Yolmen, Cam",12,2,2,10,0,0,0,2
Brisbane Lions,"Hipwood, Eric",5,4,3,1,1,1,0,0
Brisbane Lions,"Lester, Ryan",14,8,6,6,0,1,0,1
Brisbane Lions,"Lyons, Jarryd",16,6,0,10,0,0,0,7
Brisbane Lions,"Martin, Stefan",6,5,0,1,0,0,13,3
Brisbane Lions,"McCarthy, Lincoln",14,6,1,8,0,0,0,7
Brisbane Lions,"McCluggage, Hugh",17,13,6,4,0,0,0,1
Brisbane Lions,"McInerney, Oscar",8,5,2,3,0,0,22,4
Brisbane Lions,"McStay, Daniel",3,3,2,0,0,1,1,2
Brisbane Lions,"Neale, Lachie",24,10,5,14,2,0,0,3
Brisbane Lions,"Payne, Jack",9,8,5,1,0,0,0,2
Brisbane Lions,"Rayner, Cam",6,3,2,3,1,0,0,2
Brisbane Lions,"Rich, Daniel",18,15,4,3,0,1,0,1
Brisbane Lions,"Robinson, Mitch",12,8,2,4,0,0,0,2
Brisbane Lions,"Starcevich, Brandon",8,5,2,3,0,0,0,3
Brisbane Lions,"Zorko, Dayne",13,10,2,3,0,1,0,2
Carlton,"Casboult, Levi",17,11,4,6,2,0,16,0
Carlton,"Cripps, Patrick",31,15,3,16,0,0,0,2
Carlton,"Cuningham, David",8,7,3,1,2,1,0,1
Carlton,"Curnow, Ed",16,10,2,6,0,0,0,3
Carlton,"Docherty, Sam",26,17,7,9,0,0,0,1
Carlton,"Dow, Paddy",7,4,3,3,0,2,0,2
Carlton,"Fisher, Zac",17,10,3,7,0,0,0,0
Carlton,"Gibbons, Michael",7,3,1,4,0,0,0,0
Carlton,"Jones, Liam",9,5,4,4,0,1,0,0
Carlton,"Kreuzer, Matthew",1,0,1,1,0,0,7,1
Carlton,"Martin, Jack",17,11,6,6,4,1,0,1
Carlton,"McGovern, Mitch",7,4,4,3,1,1,3,2
Carlton,"Murphy, Marc",26,12,8,14,0,0,0,0
Carlton,"Newman, Nic",13,11,2,2,0,0,0,2
Carlton,"Newnes, Jack",12,9,2,3,1,0,0,1
Carlton,"Petrevski-Seton, Sam",19,11,0,8,0,0,0,2
Carlton,"Plowman, Lachie",7,5,1,2,0,1,0,0
Carlton,"Setterfield, Will",6,4,1,2,0,0,0,2
Carlton,"Silvagni, Jack",6,4,1,2,2,1,0,0
Carlton,"Simpson, Kade",20,13,6,7,0,0,0,0
Carlton,"Walsh, Sam",19,12,5,7,0,0,0,0
Carlton,"Weitering, Jacob",12,11,2,1,0,0,0,3
Carlton,"Betts, Eddie",8,5,1,3,1,2,0,3
Carlton,"Casboult, Levi",6,5,5,1,1,0,3,2
Carlton,"Cripps, Patrick",21,11,5,10,1,2,0,2
Carlton,"Cuningham, David",11,4,2,7,1,0,0,2
Carlton,"Curnow, Ed",21,15,7,6,0,0,0,2
Carlton,"Docherty, Sam",24,16,6,8,0,0,0,2
Carlton,"Gibbons, Michael",15,11,2,4,1,0,0,5
Carlton,"Jones, Liam",6,4,2,2,0,0,0,2
Carlton,"Lang, Darcy",4,2,0,2,1,1,0,2
Carlton,"Martin, Jack",11,6,2,5,0,2,0,5
Carlton,"McGovern, Mitch",10,9,7,1,1,0,0,1
Carlton,"McKay, Harry",6,5,5,1,0,1,0,0
Carlton,"Murphy, Marc",24,16,4,8,0,0,0,0
Carlton,"Newman, Nic",2,2,2,0,0,0,0,0
Carlton,"Newnes, Jack",8,3,1,5,0,0,0,1
Carlton,"Petrevski-Seton, Sam",20,13,4,7,0,0,0,2
Carlton,"Pittonet, Marc",14,10,3,4,0,0,23,2
Carlton,"Plowman, Lachie",8,3,2,5,0,0,0,0
Carlton,"Setterfield, Will",14,9,3,5,0,1,0,4
Carlton,"Simpson, Kade",15,13,2,2,0,0,0,1
Carlton,"Walsh, Sam",19,11,3,8,0,1,0,3
Carlton,"Weitering, Jacob",12,10,5,2,0,1,0,0
Carlton,"Betts, Eddie",12,11,3,1,2,0,0,2
Carlton,"Casboult, Levi",11,10,9,1,2,0,8,0
Carlton,"Cripps, Patrick",24,12,3,12,2,0,0,5
Carlton,"Cuningham, David",9,5,3,4,0,0,0,3
Carlton,"Curnow, Ed",14,11,1,3,0,0,0,3
Carlton,"Docherty, Sam",23,19,9,4,0,0,0,1
Carlton,"Gibbons, Michael",18,12,6,6,1,1,0,0
Carlton,"Jones, Liam",5,4,3,1,0,0,0,2
Carlton,"Martin, Jack",18,12,3,6,0,1,0,5
Carlton,"McGovern, Mitch",5,5,2,0,2,0,0,2
Carlton,"McKay, Harry",7,6,3,1,1,2,0,1
Carlton,"Murphy, Marc",11,7,4,4,2,0,0,1
Carlton,"Newnes, Jack",8,7,3,1,0,0,0,1
Carlton,"Petrevski-Seton, Sam",9,5,4,4,0,0,0,1
Carlton,"Pittonet, Marc",9,4,3,5,0,0,36,3
Carlton,"Plowman, Lachie",7,5,4,2,0,0,0,4
Carlton,"Setterfield, Will",8,3,1,5,0,0,0,6
Carlton,"Silvagni, Jack",9,7,3,2,0,1,0,2
Carlton,"Simpson, Kade",10,9,6,1,0,0,0,2
Carlton,"Walsh, Sam",12,6,2,6,0,0,0,3
Carlton,"Weitering, Jacob",12,12,4,0,0,0,0,0
Carlton,"Williamson, Tom",8,4,3,4,0,0,0,2
Carlton,"Betts, Eddie",8,7,2,1,1,2,0,0
Carlton,"Casboult, Levi",14,12,9,2,3,0,5,1
Carlton,"Cripps, Patrick",20,10,2,10,0,1,0,4
Carlton,"Cuningham, David",28,15,8,13,0,2,0,1
Carlton,"Curnow, Ed",20,10,2,10,0,0,0,6
Carlton,"Docherty, Sam",32,22,8,10,0,0,0,0
Carlton,"Gibbons, Michael",25,18,8,7,0,2,0,5
Carlton,"Jones, Liam",3,3,2,0,0,0,0,2
Carlton,"Martin, Jack",11,2,2,9,1,0,0,3
Carlton,"McGovern, Mitch",10,8,1,2,2,0,0,2
Carlton,"Murphy, Marc",21,15,4,6,0,0,0,3
Carlton,"Newnes, Jack",13,8,3,5,0,1,0,3
Carlton,"Petrevski-Seton, Sam",14,9,5,5,0,0,0,3
Carlton,"Philp, Sam",5,2,0,3,0,0,0,2
Carlton,"Pittonet, Marc",11,8,3,3,0,0,20,2
Carlton,"Plowman, Lachie",13,9,2,4,0,0,0,1
Carlton,"Setterfield, Will",18,10,3,8,0,0,0,2
Carlton,"Silvagni, Jack",1,1,1,0,0,0,0,0
Carlton,"Simpson, Kade",15,12,6,3,0,0,0,2
Carlton,"Walsh, Sam",24,12,7,12,0,0,0,2
Carlton,"Weitering, Jacob",11,9,5,2,0,0,0,1
Carlton,"Williamson, Tom",15,9,5,6,0,0,0,2
Carlton,"Betts, Eddie",7,5,0,2,1,0,0,2
Carlton,"Casboult, Levi",6,4,3,2,0,0,4,2
Carlton,"Cripps, Patrick",22,13,4,9,1,1,0,2
Carlton,"Cuningham, David",12,6,4,6,0,0,0,4
Carlton,"Curnow, Ed",16,11,1,5,0,0,0,3
Carlton,"Docherty, Sam",20,13,8,7,0,1,0,0
Carlton,"Gibbons, Michael",11,8,4,3,1,0,0,2
Carlton,"Jones, Liam",13,13,11,0,0,0,0,2
Carlton,"Martin, Jack",19,8,9,11,1,2,0,3
Carlton,"McGovern, Mitch",6,5,2,1,0,0,0,2
Carlton,"McKay, Harry",4,2,1,2,0,0,0,1
Carlton,"Murphy, Marc",14,6,4,8,0,0,0,3
Carlton,"Newnes, Jack",14,9,2,5,1,0,0,0
Carlton,"Petrevski-Seton, Sam",10,7,5,3,0,0,0,1
Carlton,"Philp, Sam",9,6,1,3,1,1,0,1
Carlton,"Pittonet, Marc",5,3,3,2,0,1,22,5
Carlton,"Plowman, Lachie",14,10,4,4,0,0,0,1
Carlton,"Setterfield, Will",13,11,3,2,2,0,0,1
Carlton,"Simpson, Kade",19,11,3,8,0,0,0,0
Carlton,"Walsh, Sam",13,9,3,4,0,0,0,0
Carlton,"Weitering, Jacob",10,8,4,2,0,0,0,0
Carlton,"Williamson, Tom",10,4,5,6,0,0,0,1
Carlton,"Betts, Eddie",14,10,3,4,4,1,0,2
Carlton,"Casboult, Levi",10,7,6,3,1,1,5,2
Carlton,"Cripps, Patrick",13,8,1,5,0,0,0,4
Carlton,"Cuningham, David",8,5,1,3,0,0,0,1
Carlton,"Curnow, Ed",19,15,1,4,1,0,0,5
Carlton,"Docherty, Sam",15,12,7,3,0,0,0,0
Carlton,"Gibbons, Michael",15,11,2,4,2,0,0,3
Carlton,"Jones, Liam",9,8,3,1,0,0,0,1
Carlton,"Kennedy, Matthew",20,9,4,11,0,0,0,1
Carlton,"Martin, Jack",13,6,5,7,2,1,0,5
Carlton,"McGovern, Mitch",12,10,7,2,2,0,0,2
Carlton,"McKay, Harry",9,6,5,3,3,0,0,5
Carlton,"Murphy, Marc",13,9,3,4,0,1,0,2
Carlton,"Newnes, Jack",14,10,5,4,1,0,0,2
Carlton,"Petrevski-Seton, Sam",19,13,4,6,0,0,0,0
Carlton,"Pittonet, Marc",7,1,0,6,0,0,33,1
Carlton,"Plowman, Lachie",10,5,2,5,0,0,0,0
Carlton,"Setterfield, Will",20,15,1,5,0,0,0,4
Carlton,"Simpson, Kade",17,15,3,2,0,0,0,0
Carlton,"Walsh, Sam",22,15,3,7,0,0,0,1
Carlton,"Weitering, Jacob",6,4,1,2,0,0,0,1
Carlton,"Williamson, Tom",10,7,3,3,0,0,0,1
Carlton,"Betts, Eddie",6,4,1,2,1,0,0,2
Carlton,"Casboult, Levi",8,5,5,3,0,2,4,2
Carlton,"Cripps, Patrick",21,7,0,14,0,0,0,6
Carlton,"Cuningham, David",9,4,0,5,0,0,0,3
Carlton,"Curnow, Ed",20,9,3,11,0,1,0,7
Carlton,"Docherty, Sam",18,13,4,5,0,0,0,0
Carlton,"Gibbons, Michael",14,10,4,4,1,0,0,2
Carlton,"Jones, Liam",8,6,4,2,0,0,0,1
Carlton,"Kennedy, Matthew",15,9,1,6,0,0,0,0
Carlton,"Martin, Jack",12,6,2,6,1,1,0,3
Carlton,"McGovern, Mitch",9,9,5,0,0,0,0,2
Carlton,"McKay, Harry",7,4,4,3,3,0,0,0
Carlton,"Murphy, Marc",15,7,2,8,0,1,0,2
Carlton,"Newnes, Jack",13,8,3,5,1,0,0,0
Carlton,"Petrevski-Seton, Sam",10,6,0,4,0,0,0,1
Carlton,"Pittonet, Marc",3,3,1,0,0,0,20,1
Carlton,"Plowman, Lachie",12,10,4,2,0,0,0,0
Carlton,"Setterfield, Will",13,8,2,5,0,0,0,10
Carlton,"Simpson, Kade",17,12,4,5,0,0,0,1
Carlton,"Walsh, Sam",16,11,6,5,2,0,0,3
Carlton,"Weitering, Jacob",14,10,7,4,0,0,0,0
Carlton,"Williamson, Tom",6,5,3,1,0,0,0,1
Carlton,"Betts, Eddie",5,2,2,3,0,0,0,2
Carlton,"Casboult, Levi",5,4,3,1,1,1,0,3
Carlton,"Cripps, Patrick",16,5,2,11,0,0,0,5
Carlton,"Cuningham, David",11,9,1,2,2,2,0,3
Carlton,"Curnow, Ed",19,17,3,2,0,1,0,10
Carlton,"Docherty, Sam",13,9,2,4,0,0,0,5
Carlton,"Gibbons, Michael",9,8,1,1,1,1,0,3
Carlton,"Jones, Liam",6,6,3,0,0,0,0,1
Carlton,"Kennedy, Matthew",20,12,8,8,2,1,0,1
Carlton,"Martin, Jack",18,12,5,6,0,2,0,4
Carlton,"McGovern, Mitch",2,2,1,0,0,1,0,2
Carlton,"Moore, Callum",2,0,0,2,0,0,2,2
Carlton,"Murphy, Marc",22,11,3,11,0,0,0,1
Carlton,"Newnes, Jack",15,9,3,6,2,0,0,5
Carlton,"Petrevski-Seton, Sam",14,12,3,2,0,0,0,6
Carlton,"Pittonet, Marc",11,3,2,8,0,0,27,1
Carlton,"Plowman, Lachie",18,13,7,5,0,0,0,1
Carlton,"Setterfield, Will",20,11,1,9,0,0,0,6
Carlton,"Simpson, Kade",17,10,1,7,0,0,0,0
Carlton,"Walsh, Sam",21,11,4,10,1,0,0,5
Carlton,"Weitering, Jacob",6,6,4,0,0,0,0,0
Carlton,"Williamson, Tom",10,5,1,5,0,0,0,0
Carlton,"Betts, Eddie",8,6,1,2,0,0,0,6
Carlton,"Casboult, Levi",6,5,4,1,3,0,2,2
Carlton,"Cripps, Patrick",27,8,1,19,1,2,0,5
Carlton,"Cuningham, David",4,1,1,3,1,0,0,0
Carlton,"Curnow, Ed",19,12,1,7,0,0,0,6
Carlton,"Docherty, Sam",19,13,3,6,0,0,0,1
Carlton,"Gibbons, Michael",12,10,2,2,0,0,0,2
Carlton,"Jones, Liam",10,8,6,2,0,0,0,0
Carlton,"Kennedy, Matthew",11,7,2,4,0,0,0,5
Carlton,"Martin, Jack",15,5,2,10,2,0,0,4
Carlton,"McKay, Harry",6,5,5,1,0,1,0,1
Carlton,"Moore, Callum",4,2,2,2,0,0,1,2
Carlton,"Murphy, Marc",15,9,3,6,0,0,0,1
Carlton,"Newnes, Jack",6,4,0,2,2,0,0,4
Carlton,"Petrevski-Seton, Sam",8,6,2,2,0,0,0,1
Carlton,"Pittonet, Marc",12,7,1,5,0,0,15,1
Carlton,"Plowman, Lachie",8,7,2,1,0,0,0,2
Carlton,"Setterfield, Will",8,1,0,7,0,0,0,4
Carlton,"Simpson, Kade",11,9,4,2,0,0,0,1
Carlton,"Walsh, Sam",12,6,2,6,0,0,0,3
Carlton,"Weitering, Jacob",14,10,7,4,0,0,0,2
Carlton,"Williamson, Tom",10,6,2,4,0,0,0,3
Carlton,"Betts, Eddie",11,5,0,6,0,1,0,4
Carlton,"Casboult, Levi",7,6,4,1,0,0,5,2
Carlton,"Cottrell, Matthew",9,7,1,2,0,0,0,1
Carlton,"Cripps, Patrick",19,7,2,12,0,1,0,8
Carlton,"Curnow, Ed",14,7,1,7,0,0,0,4
Carlton,"De Koning, Tom",5,1,0,4,0,1,11,3
Carlton,"Docherty, Sam",12,11,4,1,0,0,0,3
Carlton,"Fisher, Zac",12,7,1,5,4,0,0,5
Carlton,"Gibbons, Michael",6,4,1,2,1,0,0,1
Carlton,"Jones, Liam",6,6,6,0,0,0,0,3
Carlton,"Kennedy, Matthew",13,12,6,1,0,0,0,5
Carlton,"Martin, Jack",3,3,2,0,0,0,0,1
Carlton,"Murphy, Marc",23,9,5,14,0,0,0,3
Carlton,"Newnes, Jack",12,9,4,3,0,1,0,5
Carlton,"Petrevski-Seton, Sam",14,9,2,5,0,0,0,4
Carlton,"Pittonet, Marc",9,4,2,5,0,0,17,3
Carlton,"Plowman, Lachie",9,5,3,4,0,0,0,4
Carlton,"Setterfield, Will",15,10,0,5,1,0,0,7
Carlton,"Simpson, Kade",13,8,4,5,0,0,0,0
Carlton,"Walsh, Sam",20,9,5,11,1,0,0,4
Carlton,"Weitering, Jacob",7,5,3,2,0,0,0,1
Carlton,"Williamson, Tom",13,8,5,5,0,1,0,6
Carlton,"Betts, Eddie",7,4,0,3,0,1,0,6
Carlton,"Casboult, Levi",9,8,6,1,1,1,11,1
Carlton,"Cottrell, Matthew",14,14,2,0,1,0,0,0
Carlton,"Cripps, Patrick",24,12,0,12,0,1,0,6
Carlton,"Curnow, Ed",33,21,0,12,0,0,0,4
Carlton,"De Koning, Tom",8,2,0,6,0,0,21,2
Carlton,"Docherty, Sam",19,18,4,1,0,0,0,0
Carlton,"Fisher, Zac",11,8,1,3,0,0,0,5
Carlton,"Gibbons, Michael",13,9,2,4,0,1,0,4
Carlton,"Honey, Josh",4,3,2,1,0,1,0,1
Carlton,"Jones, Liam",7,4,4,3,0,1,0,1
Carlton,"Kennedy, Matthew",11,4,0,7,0,0,0,4
Carlton,"McKay, Harry",9,8,2,1,1,1,0,3
Carlton,"Murphy, Marc",23,9,2,14,0,0,0,3
Carlton,"Newnes, Jack",12,9,0,3,1,1,0,8
Carlton,"Petrevski-Seton, Sam",11,8,1,3,0,0,0,3
Carlton,"Plowman, Lachie",8,5,4,3,0,0,0,3
Carlton,"Setterfield, Will",18,10,0,8,0,0,0,6
Carlton,"Simpson, Kade",8,7,3,1,0,0,0,1
Carlton,"Walsh, Sam",24,16,4,8,1,1,0,3
Carlton,"Weitering, Jacob",9,6,1,3,0,0,0,2
Carlton,"Williamson, Tom",9,5,1,4,0,0,0,2
Carlton,"Betts, Eddie",10,7,2,3,1,1,0,1
Carlton,"Casboult, Levi",8,5,5,3,0,1,1,0
Carlton,"Cottrell, Matthew",12,10,2,2,0,0,0,0
Carlton,"Cripps, Patrick",23,13,4,10,0,1,0,6
Carlton,"Curnow, Ed",19,15,5,4,1,0,0,6
Carlton,"De Koning, Tom",10,6,4,4,0,1,8,3
Carlton,"Docherty, Sam",16,12,8,4,0,0,0,1
Carlton,"Fisher, Zac",21,8,4,13,0,0,0,5
Carlton,"Gibbons, Michael",19,12,5,7,2,0,0,5
Carlton,"Jones, Liam",8,7,5,1,0,0,0,1
Carlton,"Martin, Jack",21,11,6,10,0,1,0,4
Carlton,"McKay, Harry",13,11,8,2,2,4,0,1
Carlton,"Murphy, Marc",28,18,4,10,0,2,0,2
Carlton,"Newnes, Jack",23,9,4,14,1,0,0,0
Carlton,"Petrevski-Seton, Sam",10,8,3,2,0,0,0,3
Carlton,"Pittonet, Marc",3,2,1,1,0,0,14,1
Carlton,"Plowman, Lachie",9,7,3,2,0,0,0,0
Carlton,"Setterfield, Will",23,15,3,8,0,0,0,5
Carlton,"Simpson, Kade",15,13,6,2,0,0,0,1
Carlton,"Walsh, Sam",24,12,3,12,0,1,0,0
Carlton,"Weitering, Jacob",13,7,6,6,0,0,0,1
Carlton,"Williamson, Tom",7,6,2,1,0,0,0,4
Carlton,"Betts, Eddie",13,11,6,2,2,2,0,3
Carlton,"Casboult, Levi",8,4,4,4,0,0,0,2
Carlton,"Cripps, Patrick",16,4,5,12,0,1,0,7
Carlton,"Curnow, Ed",22,19,4,3,1,1,0,9
Carlton,"De Koning, Tom",6,3,2,3,0,0,7,0
Carlton,"Docherty, Sam",19,13,4,6,0,0,0,4
Carlton,"Dow, Paddy",12,4,3,8,0,0,0,1
Carlton,"Fisher, Zac",16,9,2,7,1,0,0,3
Carlton,"Gibbons, Michael",14,9,3,5,0,1,0,6
Carlton,"Jones, Liam",11,5,4,6,0,0,0,4
Carlton,"Martin, Jack",10,7,3,3,0,0,0,2
Carlton,"McKay, Harry",6,3,2,3,1,0,0,1
Carlton,"Murphy, Marc",18,9,3,9,0,0,0,2
Carlton,"Newnes, Jack",16,10,7,6,1,0,0,3
Carlton,"Pittonet, Marc",5,2,0,3,0,1,16,4
Carlton,"Plowman, Lachie",9,6,6,3,0,0,0,1
Carlton,"Polson, Cameron",8,5,2,3,0,0,0,0
Carlton,"Setterfield, Will",21,12,3,9,0,0,0,6
Carlton,"Simpson, Kade",18,13,4,5,0,0,0,3
Carlton,"Walsh, Sam",22,9,4,13,1,0,0,4
Carlton,"Weitering, Jacob",12,6,3,6,0,0,0,0
Carlton,"Williamson, Tom",11,9,3,2,0,0,0,0
Carlton,"Betts, Eddie",8,4,0,4,0,1,0,2
Carlton,"Casboult, Levi",7,4,2,3,0,0,6,1
Carlton,"Cottrell, Matthew",9,6,1,3,0,0,0,3
Carlton,"Cripps, Patrick",13,8,2,5,0,0,0,5
Carlton,"Curnow, Ed",17,9,4,8,0,0,0,4
Carlton,"Docherty, Sam",21,15,7,6,0,0,0,0
Carlton,"Dow, Paddy",8,4,0,4,1,0,0,0
Carlton,"Fisher, Zac",6,3,0,3,0,0,0,1
Carlton,"Jones, Liam",6,6,2,0,0,0,0,0
Carlton,"Martin, Jack",14,11,8,3,1,0,0,2
Carlton,"McGovern, Mitch",8,6,4,2,0,0,0,3
Carlton,"McKay, Harry",9,8,7,1,1,3,0,1
Carlton,"Murphy, Marc",18,12,1,6,1,1,0,4
Carlton,"Newnes, Jack",12,9,3,3,0,0,0,1
Carlton,"Petrevski-Seton, Sam",5,3,1,2,0,0,0,1
Carlton,"Pittonet, Marc",9,5,2,4,0,1,20,0
Carlton,"Polson, Cameron",10,7,0,3,0,1,0,1
Carlton,"Setterfield, Will",14,7,2,7,0,0,0,3
Carlton,"Simpson, Kade",13,10,2,3,0,0,0,2
Carlton,"Walsh, Sam",23,10,6,13,1,0,0,4
Carlton,"Weitering, Jacob",14,11,5,3,0,0,0,0
Carlton,"Williamson, Tom",15,12,4,3,0,0,0,1
Carlton,"Casboult, Levi",14,12,6,2,1,1,8,3
Carlton,"Cottrell, Matthew",9,7,2,2,1,0,0,0
Carlton,"Cripps, Patrick",17,10,4,7,1,0,0,7
Carlton,"Cuningham, David",10,4,1,6,0,0,0,3
Carlton,"Curnow, Ed",16,8,3,8,0,0,0,5
Carlton,"De Koning, Tom",12,5,2,7,0,0,19,3
Carlton,"Docherty, Sam",18,11,1,7,0,0,0,1
Carlton,"Fisher, Zac",16,7,2,9,1,1,0,1
Carlton,"Jones, Liam",7,6,2,1,0,0,0,2
Carlton,"Martin, Jack",10,9,8,1,0,0,0,0
Carlton,"McGovern, Mitch",5,1,0,4,0,0,0,2
Carlton,"McKay, Harry",7,6,4,1,2,2,0,2
Carlton,"Murphy, Marc",16,11,2,5,0,2,0,2
Carlton,"Newnes, Jack",17,7,2,10,1,1,0,2
Carlton,"Owies, Matthew",5,3,1,2,0,0,0,1
Carlton,"Petrevski-Seton, Sam",22,18,6,4,0,0,0,3
Carlton,"Plowman, Lachie",10,10,4,0,0,0,0,5
Carlton,"Setterfield, Will",16,10,4,6,0,0,0,8
Carlton,"Simpson, Kade",18,14,4,4,0,0,0,2
Carlton,"Walsh, Sam",25,20,9,5,1,1,0,3
Carlton,"Weitering, Jacob",16,15,12,1,0,0,0,1
Carlton,"Williamson, Tom",13,8,5,5,0,0,0,0
Carlton,"Betts, Eddie",9,4,1,5,0,2,0,4
Carlton,"Casboult, Levi",14,9,5,5,0,1,3,5
Carlton,"Cripps, Patrick",16,6,2,10,1,1,0,5
Carlton,"Cuningham, David",14,5,4,9,0,1,0,3
Carlton,"Curnow, Ed",16,9,1,7,0,0,0,7
Carlton,"De Koning, Tom",10,7,2,3,0,0,19,1
Carlton,"Docherty, Sam",3,2,1,1,0,0,0,0
Carlton,"Fisher, Zac",8,5,0,3,0,1,0,0
Carlton,"Gibbons, Michael",17,10,5,7,0,0,0,3
Carlton,"Jones, Liam",12,11,5,1,0,0,0,1
Carlton,"McGovern, Mitch",8,6,3,2,1,0,0,1
Carlton,"McKay, Harry",8,6,6,2,4,1,0,2
Carlton,"Murphy, Marc",15,11,8,4,0,0,0,2
Carlton,"Newnes, Jack",14,8,7,6,0,0,0,4
Carlton,"OBrien, Lochie",7,5,2,2,1,0,0,2
Carlton,"Petrevski-Seton, Sam",15,12,4,3,0,0,0,2
Carlton,"Plowman, Lachie",12,8,4,4,0,1,0,4
Carlton,"Setterfield, Will",16,10,2,6,1,0,0,9
Carlton,"Simpson, Kade",19,16,6,3,0,0,0,0
Carlton,"Walsh, Sam",22,12,6,10,0,0,0,6
Carlton,"Weitering, Jacob",11,9,4,2,0,0,0,4
Carlton,"Williamson, Tom",7,5,4,2,0,0,0,0
Carlton,"Betts, Eddie",7,4,2,3,0,0,0,2
Carlton,"Casboult, Levi",2,1,0,1,1,0,5,3
Carlton,"Cripps, Patrick",11,3,0,8,0,0,0,2
Carlton,"Cuningham, David",14,7,4,7,0,0,0,9
Carlton,"Curnow, Ed",19,14,3,5,1,0,0,4
Carlton,"De Koning, Tom",3,2,0,1,0,0,2,4
Carlton,"Gibbons, Michael",12,9,5,3,1,0,0,1
Carlton,"Jones, Liam",9,9,6,0,0,0,0,1
Carlton,"Kennedy, Matthew",23,10,5,13,0,0,0,4
Carlton,"Martin, Jack",11,6,1,5,0,0,0,6
Carlton,"McGovern, Mitch",6,5,3,1,0,0,0,1
Carlton,"McKay, Harry",6,6,5,0,3,0,0,2
Carlton,"Murphy, Marc",11,7,3,4,1,0,0,6
Carlton,"Newnes, Jack",13,11,4,2,1,0,0,4
Carlton,"Petrevski-Seton, Sam",17,15,5,2,0,0,0,3
Carlton,"Pittonet, Marc",11,7,2,4,0,0,29,1
Carlton,"Plowman, Lachie",9,8,2,1,0,0,0,4
Carlton,"Polson, Cameron",6,4,1,2,0,0,0,2
Carlton,"Simpson, Kade",19,16,2,3,1,0,0,3
Carlton,"Walsh, Sam",31,12,1,19,0,0,0,3
Carlton,"Weitering, Jacob",9,7,1,2,0,0,0,1
Carlton,"Williamson, Tom",14,10,2,4,1,0,0,5
Collingwood,"Adams, Taylor",26,16,3,10,1,0,0,5
Collingwood,"Brown, Callum",14,6,1,8,1,0,0,3
Collingwood,"Brown, Tyler",15,4,0,11,0,0,0,3
Collingwood,"Cox, Mason",9,5,4,4,2,0,8,0
Collingwood,"Crisp, Jack",15,12,7,3,0,1,0,0
Collingwood,"Daicos, Josh",14,7,3,7,2,0,0,5
Collingwood,"Elliott, Jamie",13,9,3,4,1,1,0,1
Collingwood,"Grundy, Brodie",19,8,3,11,1,3,35,3
Collingwood,"Hoskin-Elliott, Will",15,9,6,6,1,0,0,2
Collingwood,"Howe, Jeremy",25,16,9,9,0,0,0,4
Collingwood,"Madgen, Jack",5,4,3,1,0,0,0,0
Collingwood,"Maynard, Brayden",19,15,6,4,0,0,0,2
Collingwood,"Mayne, Chris",29,13,7,16,0,0,0,0
Collingwood,"Mihocek, Brody",11,9,8,2,3,0,0,3
Collingwood,"Moore, Darcy",11,7,6,4,0,0,0,0
Collingwood,"Noble, John",19,8,4,11,0,0,0,3
Collingwood,"Pendlebury, Scott",25,13,4,12,0,0,0,4
Collingwood,"Phillips, Tom",12,5,0,7,0,0,0,3
Collingwood,"Roughead, Jordan",5,3,2,2,0,0,0,1
Collingwood,"Sidebottom, Steele",26,11,9,15,0,1,0,4
Collingwood,"Thomas, Josh",11,2,2,9,0,0,0,2
Collingwood,"de Goey, Jordan",14,9,4,5,1,2,0,1
Collingwood,"Adams, Taylor",21,14,6,7,1,0,0,5
Collingwood,"Brown, Callum",13,3,1,10,1,0,0,0
Collingwood,"Brown, Tyler",8,2,0,6,0,0,0,1
Collingwood,"Cameron, Darcy",13,7,8,6,0,0,4,0
Collingwood,"Crisp, Jack",20,12,10,8,0,0,0,0
Collingwood,"Daicos, Josh",24,14,5,10,0,0,0,1
Collingwood,"Elliott, Jamie",5,3,2,2,0,0,0,2
Collingwood,"Grundy, Brodie",15,7,4,8,0,0,33,1
Collingwood,"Hoskin-Elliott, Will",6,4,3,2,0,0,0,0
Collingwood,"Howe, Jeremy",20,16,7,4,0,0,0,2
Collingwood,"Madgen, Jack",10,7,4,3,0,0,0,2
Collingwood,"Maynard, Brayden",23,16,4,7,0,0,0,1
Collingwood,"Mayne, Chris",16,7,3,9,0,0,0,2
Collingwood,"Mihocek, Brody",9,6,4,3,0,1,0,0
Collingwood,"Moore, Darcy",10,4,1,6,0,0,0,1
Collingwood,"Noble, John",15,8,3,7,0,0,0,0
Collingwood,"Pendlebury, Scott",31,15,5,16,0,0,0,2
Collingwood,"Phillips, Tom",20,13,7,7,2,1,0,3
Collingwood,"Roughead, Jordan",5,2,2,3,0,0,0,1
Collingwood,"Sidebottom, Steele",27,13,2,14,1,0,0,1
Collingwood,"Thomas, Josh",5,3,0,2,0,0,0,2
Collingwood,"de Goey, Jordan",17,10,0,7,0,2,0,2
Collingwood,"Adams, Taylor",19,12,1,7,2,0,0,4
Collingwood,"Brown, Callum",14,7,3,7,1,2,0,0
Collingwood,"Brown, Tyler",15,6,2,9,1,0,0,3
Collingwood,"Cameron, Darcy",2,2,2,0,0,0,3,5
Collingwood,"Crisp, Jack",24,12,6,12,0,0,0,0
Collingwood,"Daicos, Josh",17,7,5,10,0,2,0,3
Collingwood,"Elliott, Jamie",13,9,4,4,2,3,0,3
Collingwood,"Grundy, Brodie",20,5,5,15,0,0,31,4
Collingwood,"Hoskin-Elliott, Will",15,12,8,3,0,0,0,2
Collingwood,"Howe, Jeremy",18,16,4,2,0,0,0,0
Collingwood,"Maynard, Brayden",21,15,5,6,0,0,0,6
Collingwood,"Mayne, Chris",15,7,6,8,0,0,0,1
Collingwood,"Mihocek, Brody",9,7,6,2,2,0,0,2
Collingwood,"Moore, Darcy",15,5,6,10,0,0,0,0
Collingwood,"Noble, John",14,9,5,5,0,0,0,0
Collingwood,"Pendlebury, Scott",26,12,7,14,0,0,0,3
Collingwood,"Phillips, Tom",11,6,5,5,0,1,0,3
Collingwood,"Roughead, Jordan",10,9,7,1,0,0,0,2
Collingwood,"Sidebottom, Steele",31,17,5,14,1,0,0,6
Collingwood,"Stephenson, Jaidyn",6,5,3,1,2,0,0,0
Collingwood,"Wills, Rupert",16,5,2,11,0,0,0,4
Collingwood,"de Goey, Jordan",16,9,4,7,1,1,0,4
Collingwood,"Adams, Taylor",17,13,4,4,0,0,0,10
Collingwood,"Brown, Callum",13,5,3,8,0,0,0,2
Collingwood,"Brown, Tyler",8,5,3,3,0,0,0,0
Collingwood,"Cox, Mason",8,5,4,3,1,0,8,0
Collingwood,"Crisp, Jack",17,13,3,4,1,0,0,3
Collingwood,"Daicos, Josh",7,4,2,3,1,0,0,7
Collingwood,"Elliott, Jamie",11,5,1,6,0,0,0,4
Collingwood,"Grundy, Brodie",19,8,5,11,0,0,47,2
Collingwood,"Hoskin-Elliott, Will",8,7,3,1,0,2,0,0
Collingwood,"Howe, Jeremy",23,18,6,5,0,0,0,2
Collingwood,"Maynard, Brayden",23,17,5,6,0,0,0,1
Collingwood,"Mayne, Chris",8,3,2,5,0,1,0,2
Collingwood,"Mihocek, Brody",5,4,2,1,2,1,0,3
Collingwood,"Moore, Darcy",16,10,9,6,0,0,0,0
Collingwood,"Noble, John",11,6,2,5,0,0,0,5
Collingwood,"Pendlebury, Scott",26,14,1,12,0,1,0,2
Collingwood,"Phillips, Tom",9,6,1,3,2,0,0,3
Collingwood,"Roughead, Jordan",12,8,6,4,0,0,0,3
Collingwood,"Sidebottom, Steele",12,7,2,5,0,0,0,6
Collingwood,"Stephenson, Jaidyn",10,7,4,3,2,2,0,3
Collingwood,"Wills, Rupert",16,7,2,9,0,0,0,8
Collingwood,"de Goey, Jordan",10,5,2,5,0,1,0,0
Collingwood,"Adams, Taylor",17,10,4,7,0,0,0,6
Collingwood,"Brown, Callum",13,6,3,7,1,0,0,0
Collingwood,"Brown, Tyler",9,3,0,6,0,0,0,0
Collingwood,"Cox, Mason",2,0,1,2,0,0,4,1
Collingwood,"Crisp, Jack",13,7,1,6,0,0,0,4
Collingwood,"Daicos, Josh",21,14,4,7,1,0,0,3
Collingwood,"Elliott, Jamie",9,5,3,4,0,0,0,1
Collingwood,"Grundy, Brodie",20,7,2,13,0,0,37,6
Collingwood,"Hoskin-Elliott, Will",13,6,3,7,0,0,0,2
Collingwood,"Maynard, Brayden",24,9,2,15,0,0,0,3
Collingwood,"Mayne, Chris",14,10,3,4,0,0,0,1
Collingwood,"Mihocek, Brody",9,6,1,3,1,1,0,2
Collingwood,"Moore, Darcy",11,7,4,4,0,0,0,2
Collingwood,"Pendlebury, Scott",22,8,5,14,0,0,0,3
Collingwood,"Phillips, Tom",17,6,2,11,0,1,0,1
Collingwood,"Roughead, Jordan",8,3,6,5,0,0,0,0
Collingwood,"Scharenberg, Matt",12,8,4,4,0,0,0,2
Collingwood,"Stephenson, Jaidyn",12,8,6,4,3,0,0,3
Collingwood,"Treloar, Adam",30,19,2,11,0,2,0,5
Collingwood,"Varcoe, Travis",7,4,1,3,1,0,0,1
Collingwood,"Wills, Rupert",14,3,0,11,0,0,0,2
Collingwood,"de Goey, Jordan",21,14,2,7,0,2,0,2
Collingwood,"Adams, Taylor",22,11,6,11,0,0,0,5
Collingwood,"Bosenavulagi, Atu",16,6,4,10,0,0,0,1
Collingwood,"Brown, Callum",13,5,2,8,0,0,0,2
Collingwood,"Cox, Mason",5,2,0,3,1,0,3,0
Collingwood,"Crisp, Jack",15,7,4,8,0,0,0,2
Collingwood,"Elliott, Jamie",15,5,2,10,0,1,0,1
Collingwood,"Grundy, Brodie",11,3,1,8,0,0,22,2
Collingwood,"Hoskin-Elliott, Will",10,9,4,1,2,1,0,1
Collingwood,"Kelly, Will",5,4,2,1,1,1,0,0
Collingwood,"Maynard, Brayden",20,15,1,5,0,0,0,4
Collingwood,"Mayne, Chris",18,7,3,11,0,0,0,3
Collingwood,"Mihocek, Brody",9,9,5,0,4,1,0,2
Collingwood,"Moore, Darcy",21,13,6,8,0,0,0,1
Collingwood,"Pendlebury, Scott",21,8,1,13,0,0,0,2
Collingwood,"Phillips, Tom",15,11,2,4,0,0,0,1
Collingwood,"Quaynor, Isaac",15,8,3,7,0,0,0,1
Collingwood,"Roughead, Jordan",3,0,1,3,0,0,0,0
Collingwood,"Scharenberg, Matt",16,9,5,7,0,0,0,2
Collingwood,"Stephenson, Jaidyn",15,9,2,6,0,0,0,4
Collingwood,"Treloar, Adam",35,16,1,19,0,0,0,1
Collingwood,"Varcoe, Travis",15,6,3,9,0,0,0,4
Collingwood,"Wills, Rupert",19,7,1,12,0,0,0,5
Collingwood,"Adams, Taylor",21,11,4,10,1,0,0,6
Collingwood,"Bosenavulagi, Atu",3,2,1,1,0,0,0,3
Collingwood,"Brown, Callum",12,3,2,9,0,0,0,4
Collingwood,"Crisp, Jack",20,12,5,8,0,0,0,2
Collingwood,"Daicos, Josh",14,9,1,5,1,0,0,2
Collingwood,"Elliott, Jamie",12,10,3,2,0,1,0,4
Collingwood,"Grundy, Brodie",17,10,5,7,0,0,46,3
Collingwood,"Hoskin-Elliott, Will",11,6,4,5,1,2,0,0
Collingwood,"Maynard, Brayden",13,9,2,4,0,0,0,4
Collingwood,"Mayne, Chris",16,8,3,8,0,1,0,9
Collingwood,"Mihocek, Brody",7,3,4,4,0,0,0,1
Collingwood,"Moore, Darcy",13,5,2,8,0,0,0,1
Collingwood,"Noble, John",15,8,3,7,0,0,0,2
Collingwood,"Pendlebury, Scott",25,16,1,9,0,0,0,0
Collingwood,"Phillips, Tom",21,14,1,7,0,0,0,4
Collingwood,"Quaynor, Isaac",11,6,3,5,0,0,0,5
Collingwood,"Roughead, Jordan",8,5,2,3,0,0,0,2
Collingwood,"Stephenson, Jaidyn",10,5,3,5,0,0,0,3
Collingwood,"Treloar, Adam",34,18,2,16,0,1,0,6
Collingwood,"Varcoe, Travis",11,5,0,6,0,0,0,1
Collingwood,"Wills, Rupert",13,6,2,7,0,0,0,4
Collingwood,"de Goey, Jordan",17,11,5,6,5,1,0,1
Collingwood,"Adams, Taylor",21,11,2,10,0,0,0,2
Collingwood,"Bosenavulagi, Atu",2,1,1,1,0,0,0,1
Collingwood,"Brown, Callum",12,4,0,8,0,0,0,1
Collingwood,"Cameron, Darcy",8,5,3,3,2,0,3,1
Collingwood,"Crisp, Jack",18,14,5,4,0,1,0,2
Collingwood,"Daicos, Josh",7,4,2,3,1,0,0,4
Collingwood,"Elliott, Jamie",10,7,3,3,1,1,0,1
Collingwood,"Grundy, Brodie",10,6,2,4,0,0,24,2
Collingwood,"Hoskin-Elliott, Will",12,11,5,1,2,0,0,0
Collingwood,"Maynard, Brayden",13,10,2,3,0,0,0,2
Collingwood,"Mayne, Chris",14,4,3,10,0,0,0,2
Collingwood,"Mihocek, Brody",9,5,2,4,0,2,0,1
Collingwood,"Moore, Darcy",12,11,8,1,0,0,0,0
Collingwood,"Noble, John",11,7,2,4,0,0,0,1
Collingwood,"Phillips, Tom",16,7,2,9,0,1,0,1
Collingwood,"Quaynor, Isaac",18,6,3,12,0,0,0,2
Collingwood,"Roughead, Jordan",10,6,2,4,0,0,0,0
Collingwood,"Scharenberg, Matt",12,8,3,4,0,0,0,4
Collingwood,"Stephenson, Jaidyn",13,6,3,7,0,0,0,3
Collingwood,"Thomas, Josh",11,4,2,7,0,0,0,1
Collingwood,"Treloar, Adam",22,12,3,10,0,0,0,1
Collingwood,"Wills, Rupert",11,5,2,6,0,0,0,5
Collingwood,"Adams, Taylor",18,9,3,9,0,0,0,6
Collingwood,"Cameron, Darcy",11,6,4,5,0,1,8,1
Collingwood,"Crisp, Jack",20,11,3,9,0,0,0,4
Collingwood,"Daicos, Josh",12,5,3,7,0,0,0,2
Collingwood,"Elliott, Jamie",15,8,0,7,0,0,0,6
Collingwood,"Grundy, Brodie",11,7,5,4,1,0,43,2
Collingwood,"Hoskin-Elliott, Will",7,3,2,4,1,0,0,2
Collingwood,"Keane, Mark",7,5,1,2,0,0,0,2
Collingwood,"Madgen, Jack",10,3,1,7,0,0,0,3
Collingwood,"Maynard, Brayden",24,19,8,5,0,0,0,0
Collingwood,"Mayne, Chris",5,2,0,3,0,0,0,2
Collingwood,"Mihocek, Brody",11,7,2,4,1,0,0,1
Collingwood,"Moore, Darcy",19,9,7,10,0,0,0,0
Collingwood,"Noble, John",25,13,7,12,0,0,0,3
Collingwood,"Phillips, Tom",14,10,4,4,0,0,0,1
Collingwood,"Quaynor, Isaac",10,7,1,3,0,0,0,1
Collingwood,"Sidebottom, Steele",25,12,4,13,2,1,0,3
Collingwood,"Sier, Brayden",13,3,2,10,1,0,0,2
Collingwood,"Stephenson, Jaidyn",12,6,3,6,1,1,0,1
Collingwood,"Thomas, Josh",9,5,1,4,0,0,0,2
Collingwood,"Treloar, Adam",30,13,3,17,0,0,0,2
Collingwood,"Varcoe, Travis",10,6,1,4,0,0,0,1
Collingwood,"Adams, Taylor",29,17,4,12,1,1,0,4
Collingwood,"Brown, Callum",14,3,3,11,0,0,0,4
Collingwood,"Crisp, Jack",15,9,2,6,0,0,0,5
Collingwood,"Daicos, Josh",25,19,5,6,1,0,0,2
Collingwood,"Elliott, Jamie",10,7,3,3,1,0,0,6
Collingwood,"Grundy, Brodie",16,4,0,12,0,0,32,7
Collingwood,"Hoskin-Elliott, Will",0,0,0,0,0,0,0,0
Collingwood,"Madgen, Jack",16,9,3,7,0,0,0,4
Collingwood,"Maynard, Brayden",19,14,4,5,0,1,0,4
Collingwood,"Mihocek, Brody",15,10,9,5,0,1,0,2
Collingwood,"Moore, Darcy",9,6,4,3,0,0,0,3
Collingwood,"Noble, John",14,7,4,7,1,0,0,2
Collingwood,"Phillips, Tom",20,14,6,6,0,0,0,0
Collingwood,"Quaynor, Isaac",7,2,1,5,0,0,0,0
Collingwood,"Reid, Ben",9,5,2,4,1,0,1,0
Collingwood,"Roughead, Jordan",18,9,6,9,0,0,0,1
Collingwood,"Ruscoe, Trey",7,6,1,1,1,3,0,0
Collingwood,"Sidebottom, Steele",18,9,3,9,0,0,0,8
Collingwood,"Sier, Brayden",23,8,1,15,0,1,0,3
Collingwood,"Stephenson, Jaidyn",10,8,5,2,0,2,0,2
Collingwood,"Thomas, Josh",13,5,1,8,0,0,0,4
Collingwood,"Treloar, Adam",25,11,3,14,0,0,0,2
Collingwood,"Adams, Taylor",27,16,2,11,0,0,0,6
Collingwood,"Broomhead, Tim",7,2,0,5,0,0,0,2
Collingwood,"Brown, Callum",17,10,2,7,0,0,0,2
Collingwood,"Cameron, Darcy",15,12,9,3,2,0,4,1
Collingwood,"Crisp, Jack",22,17,4,5,0,0,0,3
Collingwood,"Daicos, Josh",15,5,5,10,1,0,0,0
Collingwood,"Dunn, Lynden",10,7,4,3,1,0,0,2
Collingwood,"Grundy, Brodie",10,2,1,8,0,0,24,6
Collingwood,"Madgen, Jack",13,8,6,5,0,0,0,2
Collingwood,"Maynard, Brayden",21,17,7,4,0,0,0,4
Collingwood,"Mayne, Chris",10,6,5,4,0,0,0,5
Collingwood,"Mihocek, Brody",13,7,5,6,1,1,0,4
Collingwood,"Noble, John",20,11,3,9,0,0,0,1
Collingwood,"Phillips, Tom",22,15,6,7,0,0,0,1
Collingwood,"Roughead, Jordan",11,6,2,5,0,0,0,1
Collingwood,"Ruscoe, Trey",6,6,3,0,2,1,0,2
Collingwood,"Sidebottom, Steele",22,13,1,9,0,0,0,1
Collingwood,"Sier, Brayden",16,3,1,13,0,0,0,5
Collingwood,"Stephenson, Jaidyn",4,3,1,1,2,0,0,1
Collingwood,"Thomas, Josh",14,9,6,5,1,0,0,1
Collingwood,"Varcoe, Travis",9,5,4,4,0,0,0,4
Collingwood,"Wills, Rupert",20,5,0,15,0,0,0,6
Collingwood,"Adams, Taylor",30,14,9,16,1,0,0,0
Collingwood,"Brown, Callum",8,4,2,4,1,0,0,0
Collingwood,"Cameron, Darcy",5,2,1,3,0,1,1,1
Collingwood,"Crisp, Jack",14,7,3,7,0,0,0,2
Collingwood,"Daicos, Josh",21,10,6,11,0,1,0,1
Collingwood,"Dunn, Lynden",8,5,1,3,0,0,0,1
Collingwood,"Elliott, Jamie",15,12,3,3,1,0,0,5
Collingwood,"Grundy, Brodie",15,7,3,8,0,0,35,6
Collingwood,"Hoskin-Elliott, Will",11,7,2,4,1,2,0,1
Collingwood,"Madgen, Jack",13,5,2,8,0,0,0,1
Collingwood,"Maynard, Brayden",14,7,0,7,0,0,0,2
Collingwood,"Mihocek, Brody",1,1,1,0,0,0,0,0
Collingwood,"Moore, Darcy",10,4,1,6,0,0,0,1
Collingwood,"Noble, John",19,9,3,10,0,0,0,2
Collingwood,"Pendlebury, Scott",28,13,1,15,0,0,1,1
Collingwood,"Phillips, Tom",22,14,3,8,0,0,0,2
Collingwood,"Reid, Ben",2,2,1,0,2,0,0,1
Collingwood,"Ruscoe, Trey",4,1,0,3,0,0,0,1
Collingwood,"Sidebottom, Steele",29,16,6,13,0,0,0,4
Collingwood,"Thomas, Josh",12,5,1,7,0,0,0,4
Collingwood,"Varcoe, Travis",17,11,5,6,0,1,0,0
Collingwood,"Wills, Rupert",16,5,1,11,0,0,0,4
Collingwood,"Adams, Taylor",31,17,6,14,1,0,0,3
Collingwood,"Appleby, Flynn",9,4,1,5,1,2,0,2
Collingwood,"Cameron, Darcy",9,4,4,5,0,0,4,0
Collingwood,"Cox, Mason",5,2,1,3,1,0,0,1
Collingwood,"Crisp, Jack",18,10,3,8,0,0,0,1
Collingwood,"Daicos, Josh",22,11,3,11,1,0,0,1
Collingwood,"Elliott, Jamie",15,8,4,7,0,0,0,0
Collingwood,"Greenwood, Levi",15,8,4,7,0,0,0,1
Collingwood,"Grundy, Brodie",15,4,5,11,0,0,20,2
Collingwood,"Hoskin-Elliott, Will",19,12,10,7,1,0,0,0
Collingwood,"Madgen, Jack",18,11,6,7,0,0,0,2
Collingwood,"Maynard, Brayden",26,22,6,4,0,0,0,6
Collingwood,"Mayne, Chris",24,10,5,14,0,0,0,1
Collingwood,"Moore, Darcy",16,9,6,7,0,0,0,0
Collingwood,"Noble, John",17,8,4,9,0,0,0,2
Collingwood,"Pendlebury, Scott",28,11,4,17,1,0,0,3
Collingwood,"Phillips, Tom",9,6,2,3,0,1,0,4
Collingwood,"Roughead, Jordan",9,5,5,4,0,0,0,2
Collingwood,"Ruscoe, Trey",6,4,1,2,2,0,0,0
Collingwood,"Sidebottom, Steele",23,14,1,9,1,1,0,5
Collingwood,"Thomas, Josh",12,6,2,6,1,0,0,1
Collingwood,"Varcoe, Travis",13,8,2,5,0,0,0,3
Collingwood,"Adams, Taylor",23,12,0,11,0,0,0,5
Collingwood,"Brown, Callum",11,2,0,9,0,0,0,2
Collingwood,"Brown, Tyler",14,6,0,8,0,0,0,2
Collingwood,"Cameron, Darcy",1,0,0,1,0,0,5,2
Collingwood,"Cox, Mason",8,3,3,5,2,1,0,0
Collingwood,"Crisp, Jack",25,16,12,9,0,0,0,4
Collingwood,"Daicos, Josh",21,12,5,9,1,0,0,0
Collingwood,"Elliott, Jamie",19,16,5,3,0,1,0,8
Collingwood,"Grundy, Brodie",12,7,4,5,0,0,34,3
Collingwood,"Hoskin-Elliott, Will",11,8,6,3,0,0,0,2
Collingwood,"Madgen, Jack",9,5,2,4,0,0,0,1
Collingwood,"Maynard, Brayden",18,11,4,7,0,0,0,2
Collingwood,"Mayne, Chris",12,3,3,9,0,0,0,4
Collingwood,"Mihocek, Brody",9,6,2,3,2,0,0,2
Collingwood,"Moore, Darcy",18,15,7,3,0,0,0,0
Collingwood,"Noble, John",20,11,4,9,0,0,0,3
Collingwood,"Pendlebury, Scott",19,13,3,6,0,0,0,5
Collingwood,"Phillips, Tom",19,9,4,10,1,1,0,3
Collingwood,"Quaynor, Isaac",20,11,5,9,0,0,0,5
Collingwood,"Roughead, Jordan",9,7,5,2,0,0,0,3
Collingwood,"Stephenson, Jaidyn",11,10,5,1,2,4,0,2
Collingwood,"Thomas, Josh",12,7,4,5,2,3,0,2
Collingwood,"Adams, Taylor",23,10,3,13,0,0,0,7
Collingwood,"Brown, Callum",14,7,2,7,1,0,0,6
Collingwood,"Brown, Tyler",10,5,2,5,0,0,0,2
Collingwood,"Cox, Mason",7,4,3,3,2,0,0,2
Collingwood,"Crisp, Jack",30,16,8,14,0,0,0,6
Collingwood,"Daicos, Josh",25,14,5,11,0,0,0,1
Collingwood,"Elliott, Jamie",15,8,4,7,1,0,0,1
Collingwood,"Greenwood, Levi",13,8,1,5,0,0,0,1
Collingwood,"Grundy, Brodie",11,3,3,8,0,0,29,3
Collingwood,"Hoskin-Elliott, Will",16,5,6,11,0,0,0,2
Collingwood,"Lynch, Max",2,1,0,1,0,0,2,5
Collingwood,"Madgen, Jack",19,9,6,10,0,0,0,2
Collingwood,"Maynard, Brayden",14,12,5,2,0,0,0,0
Collingwood,"Mihocek, Brody",7,6,4,1,1,0,0,1
Collingwood,"Moore, Darcy",9,7,3,2,0,0,0,1
Collingwood,"Noble, John",23,14,2,9,0,0,0,1
Collingwood,"Pendlebury, Scott",29,17,3,12,0,1,0,6
Collingwood,"Phillips, Tom",18,5,1,13,0,1,0,5
Collingwood,"Quaynor, Isaac",14,6,3,8,0,0,0,1
Collingwood,"Roughead, Jordan",13,6,7,7,0,0,0,1
Collingwood,"Stephenson, Jaidyn",8,2,1,6,0,0,0,1
Collingwood,"Thomas, Josh",9,4,3,5,0,0,0,2
Collingwood,"Adams, Taylor",18,11,1,7,0,1,0,5
Collingwood,"Brown, Callum",10,4,0,6,0,0,0,3
Collingwood,"Brown, Tyler",15,9,5,6,1,0,0,0
Collingwood,"Cox, Mason",8,5,7,3,2,0,4,0
Collingwood,"Crisp, Jack",23,13,3,10,1,0,0,3
Collingwood,"Daicos, Josh",21,10,5,11,0,0,0,0
Collingwood,"Elliott, Jamie",16,9,2,7,0,0,0,6
Collingwood,"Greenwood, Levi",14,8,2,6,0,0,0,4
Collingwood,"Grundy, Brodie",12,3,2,9,0,0,27,8
Collingwood,"Hoskin-Elliott, Will",16,9,9,7,1,0,0,1
Collingwood,"Madgen, Jack",10,6,3,4,0,0,0,2
Collingwood,"Maynard, Brayden",16,15,6,1,0,0,0,3
Collingwood,"Mihocek, Brody",9,7,4,2,1,1,0,2
Collingwood,"Moore, Darcy",14,10,4,4,0,0,0,2
Collingwood,"Noble, John",21,13,5,8,0,0,0,1
Collingwood,"Pendlebury, Scott",19,7,2,12,0,0,0,4
Collingwood,"Quaynor, Isaac",17,12,7,5,0,0,0,2
Collingwood,"Roughead, Jordan",14,10,6,4,0,0,0,0
Collingwood,"Thomas, Josh",8,5,2,3,0,1,0,2
Collingwood,"Treloar, Adam",26,10,1,16,0,0,0,5
Collingwood,"Varcoe, Travis",8,5,4,3,0,1,0,1
Collingwood,"de Goey, Jordan",10,8,2,2,4,2,0,1
Collingwood,"Adams, Taylor",26,16,4,10,0,0,0,11
Collingwood,"Brown, Tyler",12,5,2,7,0,0,0,2
Collingwood,"Cox, Mason",7,6,5,1,0,1,6,1
Collingwood,"Crisp, Jack",25,11,3,14,0,0,0,4
Collingwood,"Daicos, Josh",19,10,4,9,0,0,0,4
Collingwood,"Elliott, Jamie",15,5,3,10,1,0,0,2
Collingwood,"Greenwood, Levi",11,4,0,7,1,0,0,2
Collingwood,"Grundy, Brodie",18,5,3,13,0,0,36,3
Collingwood,"Hoskin-Elliott, Will",10,6,4,4,0,0,0,0
Collingwood,"Madgen, Jack",12,5,3,7,0,0,0,0
Collingwood,"Maynard, Brayden",18,16,5,2,0,0,0,1
Collingwood,"Mihocek, Brody",9,4,3,5,2,0,0,4
Collingwood,"Moore, Darcy",11,8,5,3,0,0,0,1
Collingwood,"Noble, John",15,13,2,2,0,0,0,0
Collingwood,"Pendlebury, Scott",23,11,1,12,0,0,0,6
Collingwood,"Quaynor, Isaac",16,7,4,9,0,0,0,2
Collingwood,"Roughead, Jordan",10,5,2,5,0,0,0,0
Collingwood,"Stephenson, Jaidyn",8,6,3,2,1,0,0,1
Collingwood,"Thomas, Josh",9,4,2,5,0,0,0,3
Collingwood,"Treloar, Adam",24,5,1,19,1,0,0,3
Collingwood,"Varcoe, Travis",6,4,1,2,0,0,0,0
Collingwood,"de Goey, Jordan",7,5,2,2,1,0,0,0
Collingwood,"Adams, Taylor",25,13,1,12,1,0,0,8
Collingwood,"Cameron, Darcy",7,5,4,2,0,0,9,1
Collingwood,"Cox, Mason",6,4,5,2,3,0,0,1
Collingwood,"Crisp, Jack",16,10,3,6,0,0,0,8
Collingwood,"Daicos, Josh",17,7,3,10,0,0,0,2
Collingwood,"Elliott, Jamie",9,6,2,3,1,1,0,3
Collingwood,"Greenwood, Levi",13,8,0,5,0,0,0,8
Collingwood,"Grundy, Brodie",12,6,3,6,0,0,18,3
Collingwood,"Hoskin-Elliott, Will",12,6,7,6,1,1,0,2
Collingwood,"Madgen, Jack",12,7,3,5,0,0,0,2
Collingwood,"Maynard, Brayden",14,9,4,5,0,0,0,0
Collingwood,"Mayne, Chris",18,7,6,11,0,0,0,2
Collingwood,"Mihocek, Brody",10,8,4,2,3,0,0,1
Collingwood,"Moore, Darcy",13,11,4,2,0,0,0,0
Collingwood,"Noble, John",12,10,3,2,1,0,0,2
Collingwood,"Pendlebury, Scott",18,9,0,9,0,0,0,2
Collingwood,"Quaynor, Isaac",11,5,1,6,0,0,0,1
Collingwood,"Roughead, Jordan",5,2,1,3,0,0,0,0
Collingwood,"Stephenson, Jaidyn",10,8,6,2,0,1,0,0
Collingwood,"Thomas, Josh",9,5,0,4,0,0,0,0
Collingwood,"Treloar, Adam",25,10,0,15,0,1,0,1
Collingwood,"de Goey, Jordan",9,8,1,1,2,0,0,1
Collingwood,"Adams, Taylor",17,12,0,5,0,0,0,5
Collingwood,"Cameron, Darcy",5,3,1,2,0,0,16,2
Collingwood,"Cox, Mason",4,2,2,2,0,0,1,0
Collingwood,"Crisp, Jack",13,11,6,2,0,0,0,5
Collingwood,"Daicos, Josh",10,7,2,3,0,0,0,4
Collingwood,"Elliott, Jamie",10,9,4,1,1,1,0,3
Collingwood,"Greenwood, Levi",4,1,1,3,0,0,0,3
Collingwood,"Grundy, Brodie",10,3,1,7,1,0,20,2
Collingwood,"Hoskin-Elliott, Will",3,3,3,0,0,0,0,0
Collingwood,"Madgen, Jack",8,6,4,2,0,0,0,1
Collingwood,"Maynard, Brayden",9,6,2,3,0,0,0,2
Collingwood,"Mayne, Chris",6,2,1,4,0,0,0,4
Collingwood,"Mihocek, Brody",6,5,2,1,2,0,0,2
Collingwood,"Moore, Darcy",10,5,4,5,0,0,0,1
Collingwood,"Noble, John",6,6,0,0,0,0,0,1
Collingwood,"Pendlebury, Scott",14,8,0,6,0,0,0,2
Collingwood,"Quaynor, Isaac",9,4,2,5,0,0,0,5
Collingwood,"Roughead, Jordan",7,4,2,3,0,0,0,1
Collingwood,"Stephenson, Jaidyn",3,2,2,1,1,0,0,1
Collingwood,"Thomas, Josh",14,6,0,8,0,0,0,2
Collingwood,"Treloar, Adam",18,8,3,10,0,0,0,4
Collingwood,"de Goey, Jordan",14,7,4,7,0,1,0,0
Essendon,"Bellchambers, Tom",7,5,1,2,0,0,29,3
Essendon,"Cutler, Tom",17,11,3,6,0,0,0,1
Essendon,"Fantasia, Orazio",6,4,5,2,1,0,0,1
Essendon,"Francis, Aaron",10,5,4,5,0,0,0,2
Essendon,"Guelfi, Matt",16,9,4,7,0,0,0,2
Essendon,"Hurley, Michael",17,12,11,5,0,0,0,0
Essendon,"Langford, Kyle",18,9,8,9,0,1,0,3
Essendon,"Laverde, Jayden",5,4,4,1,1,0,0,1
Essendon,"McDonald-Tipungwuti, Anthony",11,4,1,7,0,0,0,5
Essendon,"McGrath, Andrew",23,12,1,11,0,0,0,8
Essendon,"Merrett, Zach",22,9,4,13,0,0,0,3
Essendon,"Parish, Darcy",12,6,1,6,0,0,0,1
Essendon,"Redman, Mason",17,12,9,5,0,0,0,3
Essendon,"Ridley, Jordan",16,12,9,4,0,0,0,2
Essendon,"Saad, Adam",28,15,6,13,0,1,0,3
Essendon,"Shiel, Dylan",35,21,5,14,0,1,0,3
Essendon,"Smith, Devon",15,9,2,6,1,1,0,5
Essendon,"Snelling, Will",17,4,4,13,1,0,0,4
Essendon,"Stringer, Jake",9,9,5,0,2,3,0,4
Essendon,"Townsend, Jacob",9,4,3,5,3,0,0,3
Essendon,"Zaharakis, David",17,9,5,8,0,0,0,1
Essendon,"Zerk-Thatcher, Brandon",12,7,3,5,0,0,0,0
Essendon,"Bellchambers, Tom",5,4,1,1,0,0,27,2
Essendon,"Cutler, Tom",14,8,6,6,0,0,0,2
Essendon,"Francis, Aaron",11,5,3,6,0,0,0,1
Essendon,"Guelfi, Matt",5,1,1,4,0,0,0,1
Essendon,"Heppell, Dyson",17,9,0,8,0,0,0,2
Essendon,"Hooker, Cale",13,6,7,7,0,0,0,2
Essendon,"Hurley, Michael",15,10,4,5,0,0,0,1
Essendon,"Langford, Kyle",22,14,6,8,1,1,0,1
Essendon,"McDonald-Tipungwuti, Anthony",7,5,1,2,2,0,0,2
Essendon,"McGrath, Andrew",23,8,2,15,0,0,0,7
Essendon,"McKernan, Shaun",7,4,2,3,3,0,3,3
Essendon,"Merrett, Zach",29,14,4,15,1,1,0,4
Essendon,"Parish, Darcy",17,8,3,9,1,1,0,1
Essendon,"Redman, Mason",12,7,1,5,0,0,0,2
Essendon,"Ridley, Jordan",17,10,4,7,0,0,0,1
Essendon,"Saad, Adam",20,11,1,9,0,0,0,1
Essendon,"Shiel, Dylan",22,12,0,10,0,1,0,2
Essendon,"Smith, Devon",17,9,1,8,1,2,0,3
Essendon,"Snelling, Will",6,4,0,2,0,0,0,4
Essendon,"Stringer, Jake",7,6,2,1,3,0,0,2
Essendon,"Townsend, Jacob",5,4,0,1,0,0,0,4
Essendon,"Zaharakis, David",6,4,1,2,0,0,0,1
Essendon,"Bellchambers, Tom",6,5,0,1,0,0,24,0
Essendon,"Fantasia, Orazio",6,4,1,2,0,0,0,3
Essendon,"Francis, Aaron",14,9,7,5,0,0,0,4
Essendon,"Gleeson, Martin",14,10,3,4,0,0,0,1
Essendon,"Ham, Brayden",6,4,2,2,0,0,0,0
Essendon,"Hooker, Cale",13,5,5,8,0,0,0,0
Essendon,"Hurley, Michael",16,14,4,2,0,0,0,0
Essendon,"Langford, Kyle",14,6,3,8,0,0,0,4
Essendon,"McDonald-Tipungwuti, Anthony",4,3,1,1,1,0,0,3
Essendon,"McGrath, Andrew",20,11,0,9,0,0,0,5
Essendon,"McKernan, Shaun",13,10,7,3,1,0,8,2
Essendon,"Merrett, Zach",17,9,1,8,0,0,0,3
Essendon,"Parish, Darcy",10,6,0,4,2,0,0,2
Essendon,"Redman, Mason",10,7,2,3,0,0,0,3
Essendon,"Ridley, Jordan",18,13,6,5,0,0,0,2
Essendon,"Saad, Adam",16,12,3,4,0,0,0,5
Essendon,"Shiel, Dylan",19,11,1,8,0,0,0,2
Essendon,"Smith, Devon",18,11,5,7,1,0,0,6
Essendon,"Snelling, Will",7,1,0,6,0,0,0,3
Essendon,"Stringer, Jake",8,5,1,3,2,0,0,2
Essendon,"Townsend, Jacob",5,4,3,1,1,0,0,1
Essendon,"Zaharakis, David",13,4,2,9,0,0,0,6
Essendon,"Fantasia, Orazio",9,7,4,2,0,0,0,1
Essendon,"Gleeson, Martin",11,8,4,3,0,0,0,2
Essendon,"Ham, Brayden",15,10,2,5,0,0,0,2
Essendon,"Hibberd, Mitchell",10,5,2,5,0,0,0,0
Essendon,"Hooker, Cale",11,6,6,5,0,0,0,1
Essendon,"Hurley, Michael",17,11,7,6,0,0,0,1
Essendon,"Langford, Kyle",16,10,6,6,0,0,0,1
Essendon,"Laverde, Jayden",6,4,2,2,0,0,0,3
Essendon,"McDonald-Tipungwuti, Anthony",10,7,3,3,2,1,0,7
Essendon,"McGrath, Andrew",19,11,1,8,0,0,0,4
Essendon,"McKernan, Shaun",5,4,2,1,1,0,0,0
Essendon,"Parish, Darcy",12,5,3,7,1,0,0,0
Essendon,"Phillips, Andrew",11,6,2,5,0,0,13,5
Essendon,"Redman, Mason",8,6,1,2,0,0,0,1
Essendon,"Ridley, Jordan",18,12,7,6,0,0,0,3
Essendon,"Saad, Adam",18,11,4,7,0,0,0,2
Essendon,"Shiel, Dylan",29,19,4,10,1,0,0,5
Essendon,"Smith, Devon",13,10,1,3,0,0,0,6
Essendon,"Snelling, Will",16,7,0,9,0,0,0,6
Essendon,"Stringer, Jake",10,8,3,2,3,0,0,7
Essendon,"Townsend, Jacob",6,5,2,1,1,1,0,7
Essendon,"Zaharakis, David",2,1,1,1,1,0,0,1
Essendon,"Fantasia, Orazio",19,9,4,10,0,0,0,1
Essendon,"Gleeson, Martin",12,8,3,4,0,0,0,1
Essendon,"Ham, Brayden",13,10,4,3,0,1,0,3
Essendon,"Hibberd, Mitchell",19,9,1,10,0,1,0,5
Essendon,"Hooker, Cale",10,5,1,5,0,0,0,1
Essendon,"Hurley, Michael",16,10,4,6,0,0,0,0
Essendon,"Langford, Kyle",14,8,1,6,2,1,0,1
Essendon,"Laverde, Jayden",12,5,3,7,1,2,0,3
Essendon,"McDonald-Tipungwuti, Anthony",14,4,2,10,1,1,0,3
Essendon,"McGrath, Andrew",25,13,2,12,0,0,0,8
Essendon,"McKenna, Conor",18,10,2,8,0,0,0,4
Essendon,"McKernan, Shaun",9,5,3,4,0,1,4,2
Essendon,"Merrett, Zach",18,8,3,10,0,0,0,2
Essendon,"Parish, Darcy",21,8,0,13,0,0,0,6
Essendon,"Phillips, Andrew",4,4,1,0,0,0,28,4
Essendon,"Ridley, Jordan",18,14,7,4,0,0,0,1
Essendon,"Saad, Adam",21,11,2,10,0,0,0,2
Essendon,"Shiel, Dylan",12,5,1,7,0,0,0,5
Essendon,"Smith, Devon",23,10,2,13,0,1,0,6
Essendon,"Snelling, Will",15,8,1,7,1,0,0,8
Essendon,"Townsend, Jacob",9,7,3,2,1,2,0,0
Essendon,"Zaharakis, David",20,11,3,9,3,2,0,0
Essendon,"Cahill, Ned",7,2,3,5,0,0,0,2
Essendon,"Fantasia, Orazio",9,3,1,6,0,0,0,0
Essendon,"Ham, Brayden",12,9,3,3,0,0,0,1
Essendon,"Hibberd, Mitchell",8,4,1,4,0,1,0,3
Essendon,"Hooker, Cale",12,7,6,5,1,0,0,0
Essendon,"Hurley, Michael",18,14,8,4,0,0,0,0
Essendon,"Langford, Kyle",19,6,3,13,0,1,0,0
Essendon,"Laverde, Jayden",12,7,4,5,2,1,0,3
Essendon,"McDonald-Tipungwuti, Anthony",6,4,2,2,1,1,0,3
Essendon,"McGrath, Andrew",24,10,2,14,0,0,0,3
Essendon,"McKenna, Conor",19,12,5,7,0,0,0,1
Essendon,"McKernan, Shaun",8,5,4,3,0,3,8,1
Essendon,"Merrett, Zach",20,8,4,12,0,0,0,4
Essendon,"Parish, Darcy",22,11,2,11,0,0,0,1
Essendon,"Phillips, Andrew",10,6,5,4,0,1,28,1
Essendon,"Redman, Mason",12,6,4,6,0,0,0,0
Essendon,"Ridley, Jordan",14,10,8,4,0,0,0,0
Essendon,"Saad, Adam",23,12,2,11,0,0,0,0
Essendon,"Smith, Devon",15,10,3,5,1,0,0,6
Essendon,"Snelling, Will",9,2,1,7,1,0,0,3
Essendon,"Townsend, Jacob",4,3,2,1,0,0,0,2
Essendon,"Zaharakis, David",20,10,3,10,1,0,0,4
Essendon,"Bellchambers, Tom",10,8,2,2,0,0,19,3
Essendon,"Cahill, Ned",7,3,1,4,2,1,0,0
Essendon,"Francis, Aaron",9,5,3,4,0,0,0,1
Essendon,"Gleeson, Martin",7,4,1,3,0,0,0,1
Essendon,"Ham, Brayden",8,6,2,2,0,0,0,3
Essendon,"Hibberd, Mitchell",15,8,2,7,0,0,0,9
Essendon,"Hurley, Michael",15,8,7,7,0,0,0,0
Essendon,"Langford, Kyle",19,10,4,9,2,0,0,1
Essendon,"Laverde, Jayden",5,4,3,1,1,0,0,1
Essendon,"McDonald-Tipungwuti, Anthony",13,8,1,5,2,0,0,3
Essendon,"McGrath, Andrew",25,16,3,9,0,1,0,10
Essendon,"McKenna, Conor",14,10,3,4,0,0,0,2
Essendon,"McKernan, Shaun",9,6,3,3,0,0,6,3
Essendon,"Merrett, Zach",33,20,9,13,0,0,0,6
Essendon,"Parish, Darcy",22,8,1,14,1,0,0,3
Essendon,"Redman, Mason",13,9,2,4,0,0,0,2
Essendon,"Ridley, Jordan",18,12,6,6,0,0,0,3
Essendon,"Saad, Adam",19,12,5,7,0,0,0,4
Essendon,"Smith, Devon",13,5,2,8,0,1,0,3
Essendon,"Snelling, Will",18,4,3,14,0,0,0,11
Essendon,"Townsend, Jacob",10,5,2,5,1,1,0,4
Essendon,"Zaharakis, David",20,5,1,15,0,2,0,3
Essendon,"Bellchambers, Tom",3,3,2,0,0,0,13,0
Essendon,"Cahill, Ned",3,3,0,0,0,1,0,1
Essendon,"Cutler, Tom",11,9,3,2,0,2,0,0
Essendon,"Draper, Sam",9,6,2,3,0,1,21,2
Essendon,"Francis, Aaron",10,3,2,7,0,0,0,2
Essendon,"Gleeson, Martin",8,3,2,5,0,0,0,1
Essendon,"Ham, Brayden",7,6,2,1,0,0,0,0
Essendon,"Hurley, Michael",14,9,5,5,0,0,0,2
Essendon,"McDonald-Tipungwuti, Anthony",7,4,0,3,0,0,0,5
Essendon,"McGrath, Andrew",25,11,3,14,0,0,0,1
Essendon,"Merrett, Zach",18,11,1,7,0,0,0,2
Essendon,"Parish, Darcy",15,10,1,5,1,0,0,4
Essendon,"Redman, Mason",12,8,1,4,0,1,0,0
Essendon,"Ridley, Jordan",20,10,4,10,0,0,0,1
Essendon,"Saad, Adam",11,7,1,4,0,0,0,1
Essendon,"Shiel, Dylan",17,9,1,8,0,1,0,4
Essendon,"Smith, Devon",14,8,3,6,2,1,0,2
Essendon,"Snelling, Will",14,3,0,11,0,0,0,6
Essendon,"Stewart, James",4,3,2,1,0,1,0,3
Essendon,"Townsend, Jacob",6,5,3,1,0,1,0,0
Essendon,"Zaharakis, David",13,4,1,9,0,0,0,2
Essendon,"Zerk-Thatcher, Brandon",7,5,2,2,0,0,0,0
Essendon,"Cutler, Tom",13,5,1,8,0,0,0,2
Essendon,"Draper, Sam",13,9,1,4,1,1,16,0
Essendon,"Francis, Aaron",10,6,3,4,0,0,0,3
Essendon,"Guelfi, Matt",12,7,3,5,0,0,0,2
Essendon,"Hurley, Michael",23,14,8,9,0,0,0,0
Essendon,"Langford, Kyle",11,6,2,5,2,1,0,0
Essendon,"McDonald-Tipungwuti, Anthony",9,9,3,0,1,1,0,4
Essendon,"McGrath, Andrew",18,10,1,8,0,0,0,8
Essendon,"McKenna, Conor",4,4,0,0,1,0,0,1
Essendon,"McKernan, Shaun",9,7,4,2,0,1,6,0
Essendon,"Merrett, Zach",33,19,5,14,0,0,0,1
Essendon,"Parish, Darcy",13,6,2,7,0,1,0,5
Essendon,"Redman, Mason",17,10,6,7,0,0,0,1
Essendon,"Ridley, Jordan",17,13,8,4,0,0,0,2
Essendon,"Saad, Adam",20,15,2,5,1,0,0,1
Essendon,"Shiel, Dylan",15,8,1,7,1,0,0,2
Essendon,"Smith, Devon",18,10,3,8,0,0,0,4
Essendon,"Snelling, Will",13,4,3,9,0,0,0,3
Essendon,"Stewart, James",4,2,1,2,0,0,0,0
Essendon,"Townsend, Jacob",1,1,0,0,0,0,0,2
Essendon,"Zaharakis, David",18,9,4,9,1,0,0,1
Essendon,"Zerk-Thatcher, Brandon",16,9,8,7,0,0,0,2
Essendon,"Bellchambers, Tom",7,5,3,2,1,0,18,2
Essendon,"Clarke, Dylan",10,5,2,5,0,0,0,4
Essendon,"Cutler, Tom",10,6,2,4,1,1,0,1
Essendon,"Francis, Aaron",13,9,4,4,0,0,0,0
Essendon,"Gleeson, Martin",13,7,6,6,0,0,0,1
Essendon,"Guelfi, Matt",14,8,4,6,0,0,0,1
Essendon,"Langford, Kyle",11,4,4,7,2,0,0,2
Essendon,"McDonald-Tipungwuti, Anthony",10,3,1,7,0,0,0,3
Essendon,"McGrath, Andrew",26,12,1,14,0,0,0,2
Essendon,"McKenna, Conor",8,6,2,2,0,0,0,0
Essendon,"McKernan, Shaun",8,5,5,3,0,1,6,0
Essendon,"Merrett, Zach",30,17,5,13,0,0,0,0
Essendon,"Parish, Darcy",20,13,2,7,0,1,0,8
Essendon,"Redman, Mason",15,6,3,9,0,0,0,1
Essendon,"Ridley, Jordan",23,20,10,3,0,0,0,0
Essendon,"Saad, Adam",16,8,2,8,0,0,0,2
Essendon,"Shiel, Dylan",26,16,4,10,0,1,0,4
Essendon,"Smith, Devon",13,4,2,9,0,0,0,4
Essendon,"Snelling, Will",18,8,3,10,1,0,0,7
Essendon,"Stewart, James",10,8,5,2,3,1,0,0
Essendon,"Zaharakis, David",13,6,3,7,3,0,0,1
Essendon,"Zerk-Thatcher, Brandon",3,1,1,2,0,0,0,1
Essendon,"Begley, Josh",5,3,2,2,1,0,0,4
Essendon,"Clarke, Dylan",6,4,3,2,0,0,0,1
Essendon,"Cutler, Tom",14,8,6,6,0,1,0,1
Essendon,"Draper, Sam",6,6,1,0,0,0,22,1
Essendon,"Gleeson, Martin",15,7,6,8,0,0,0,0
Essendon,"Guelfi, Matt",11,5,2,6,0,0,0,3
Essendon,"Hurley, Michael",19,15,8,4,0,0,0,0
Essendon,"Langford, Kyle",18,10,4,8,1,0,0,3
Essendon,"McDonald-Tipungwuti, Anthony",9,6,3,3,1,0,0,5
Essendon,"McGrath, Andrew",23,7,3,16,0,0,0,3
Essendon,"McKenna, Conor",17,13,6,4,0,0,0,2
Essendon,"McKernan, Shaun",4,2,1,2,0,0,0,0
Essendon,"Merrett, Zach",24,17,5,7,0,0,0,1
Essendon,"Mutch, Kobe",11,5,4,6,0,0,0,0
Essendon,"Parish, Darcy",29,11,2,18,0,0,0,3
Essendon,"Ridley, Jordan",18,13,7,5,0,1,0,0
Essendon,"Saad, Adam",18,12,3,6,1,0,0,1
Essendon,"Shiel, Dylan",29,14,4,15,0,0,0,5
Essendon,"Snelling, Will",11,1,1,10,0,0,0,3
Essendon,"Stewart, James",5,3,2,2,0,1,0,0
Essendon,"Townsend, Jacob",6,5,3,1,1,0,0,1
Essendon,"Zerk-Thatcher, Brandon",9,5,4,4,0,0,0,0
Essendon,"Bellchambers, Tom",3,0,1,3,0,0,9,0
Essendon,"Clarke, Dylan",13,3,3,10,1,0,0,1
Essendon,"Draper, Sam",13,9,6,4,0,0,14,4
Essendon,"Francis, Aaron",2,2,1,0,0,0,0,1
Essendon,"Gleeson, Martin",13,7,3,6,0,0,0,2
Essendon,"Guelfi, Matt",19,9,9,10,0,0,0,1
Essendon,"Ham, Brayden",11,5,4,6,0,0,0,2
Essendon,"Hurley, Michael",14,12,4,2,0,0,0,0
Essendon,"Langford, Kyle",13,4,4,9,0,0,0,0
Essendon,"McDonald-Tipungwuti, Anthony",7,5,3,2,2,0,0,2
Essendon,"McGrath, Andrew",17,9,1,8,0,0,0,4
Essendon,"Merrett, Zach",34,19,8,15,1,0,0,3
Essendon,"Mosquito, Irving",8,5,2,3,2,1,0,2
Essendon,"Parish, Darcy",23,6,1,17,0,0,0,1
Essendon,"Redman, Mason",12,8,5,4,0,0,0,6
Essendon,"Ridley, Jordan",16,10,8,6,0,0,0,1
Essendon,"Saad, Adam",21,14,2,7,0,0,0,1
Essendon,"Shiel, Dylan",17,11,4,6,0,0,0,1
Essendon,"Smith, Devon",27,15,2,12,0,0,0,2
Essendon,"Snelling, Will",17,7,4,10,1,0,0,2
Essendon,"Stewart, James",9,5,4,4,2,0,0,0
Essendon,"Stringer, Jake",3,3,0,0,1,0,0,0
Essendon,"Clarke, Dylan",5,2,1,3,2,0,0,2
Essendon,"Daniher, Joe",14,13,10,1,3,3,0,0
Essendon,"Gleeson, Martin",13,5,3,8,0,0,0,2
Essendon,"Guelfi, Matt",7,4,2,3,0,0,0,0
Essendon,"Ham, Brayden",5,1,1,4,0,0,0,1
Essendon,"Hooker, Cale",17,5,3,12,2,0,0,2
Essendon,"Langford, Kyle",27,11,2,16,1,1,0,2
Essendon,"McDonald-Tipungwuti, Anthony",5,3,2,2,2,0,0,3
Essendon,"McGrath, Andrew",32,15,2,17,0,0,0,3
Essendon,"Merrett, Zach",36,15,3,21,0,1,0,6
Essendon,"Mosquito, Irving",8,4,3,4,0,1,0,1
Essendon,"Parish, Darcy",24,11,1,13,0,1,0,5
Essendon,"Phillips, Andrew",7,1,0,6,0,0,21,2
Essendon,"Redman, Mason",8,2,0,6,0,0,0,1
Essendon,"Ridley, Jordan",16,9,3,7,0,0,0,0
Essendon,"Saad, Adam",19,11,3,8,0,0,0,3
Essendon,"Shiel, Dylan",25,12,2,13,0,0,0,7
Essendon,"Smith, Devon",23,11,4,12,0,0,0,1
Essendon,"Snelling, Will",12,0,1,12,0,0,0,7
Essendon,"Stewart, James",8,6,4,2,1,0,1,1
Essendon,"Stringer, Jake",7,5,1,2,2,0,0,1
Essendon,"Zerk-Thatcher, Brandon",7,5,3,2,0,0,0,0
Essendon,"Clarke, Dylan",12,7,3,5,0,0,0,0
Essendon,"Daniher, Joe",7,6,6,1,0,3,0,1
Essendon,"Draper, Sam",5,4,0,1,0,0,17,4
Essendon,"Gleeson, Martin",10,3,1,7,0,0,0,1
Essendon,"Guelfi, Matt",12,6,5,6,0,0,0,0
Essendon,"Heppell, Dyson",15,3,2,12,1,0,0,0
Essendon,"Hooker, Cale",4,2,2,2,0,2,0,0
Essendon,"Hurley, Michael",16,10,7,6,0,0,0,0
Essendon,"Langford, Kyle",29,14,8,15,0,1,0,4
Essendon,"McDonald-Tipungwuti, Anthony",10,7,5,3,4,0,0,0
Essendon,"McGrath, Andrew",10,4,0,6,0,0,0,1
Essendon,"Merrett, Zach",33,19,5,14,0,0,0,3
Essendon,"Mosquito, Irving",10,3,3,7,0,1,0,4
Essendon,"Parish, Darcy",23,11,4,12,0,0,0,6
Essendon,"Ridley, Jordan",25,18,13,7,0,0,0,0
Essendon,"Saad, Adam",21,14,3,7,0,0,0,1
Essendon,"Shiel, Dylan",32,15,4,17,0,0,0,4
Essendon,"Smith, Devon",20,12,3,8,0,0,0,2
Essendon,"Snelling, Will",14,7,3,7,0,2,0,5
Essendon,"Stewart, James",6,5,2,1,1,0,3,1
Essendon,"Stringer, Jake",4,0,0,4,0,0,0,0
Essendon,"Zerk-Thatcher, Brandon",7,3,1,4,0,0,0,1
Essendon,"Clarke, Dylan",12,2,0,10,0,0,0,5
Essendon,"Draper, Sam",9,8,3,1,0,1,26,2
Essendon,"Gleeson, Martin",6,4,1,2,0,0,0,1
Essendon,"Guelfi, Matt",13,6,2,7,0,0,0,3
Essendon,"Heppell, Dyson",8,3,2,5,0,1,0,1
Essendon,"Hooker, Cale",9,7,7,2,0,1,0,0
Essendon,"Hurley, Michael",7,5,2,2,0,0,0,1
Essendon,"Langford, Kyle",16,13,5,3,0,2,0,4
Essendon,"McDonald-Tipungwuti, Anthony",10,4,3,6,0,2,0,2
Essendon,"Merrett, Zach",24,7,1,17,0,0,0,3
Essendon,"Mosquito, Irving",6,3,1,3,0,1,0,0
Essendon,"Parish, Darcy",16,6,1,10,0,0,0,4
Essendon,"Redman, Mason",11,8,6,3,1,0,0,1
Essendon,"Ridley, Jordan",14,9,2,5,0,0,0,3
Essendon,"Saad, Adam",11,8,2,3,0,0,0,5
Essendon,"Shiel, Dylan",20,13,2,7,1,1,0,0
Essendon,"Smith, Devon",20,13,4,7,0,0,0,1
Essendon,"Snelling, Will",12,4,2,8,0,0,0,2
Essendon,"Stewart, James",11,5,3,6,1,0,3,2
Essendon,"Stringer, Jake",8,6,2,2,1,1,0,2
Essendon,"Townsend, Jacob",7,5,0,2,1,0,0,5
Essendon,"Zerk-Thatcher, Brandon",3,2,3,1,0,1,0,2
Essendon,"Clarke, Dylan",10,5,2,5,1,0,0,4
Essendon,"Cutler, Tom",8,5,1,3,1,0,0,2
Essendon,"Daniher, Joe",8,5,3,3,0,0,0,0
Essendon,"Draper, Sam",7,3,2,4,0,0,19,1
Essendon,"Gleeson, Martin",8,3,3,5,0,0,0,2
Essendon,"Guelfi, Matt",16,12,2,4,0,0,0,3
Essendon,"Ham, Brayden",9,6,2,3,1,0,0,1
Essendon,"Hibberd, Mitchell",17,5,1,12,0,0,0,6
Essendon,"Langford, Kyle",18,11,1,7,0,0,0,1
Essendon,"McDonald-Tipungwuti, Anthony",5,5,2,0,0,1,0,4
Essendon,"Merrett, Zach",24,16,4,8,0,0,0,5
Essendon,"Parish, Darcy",22,13,0,9,1,0,0,1
Essendon,"Phillips, Andrew",3,0,0,3,0,0,17,1
Essendon,"Ridley, Jordan",23,16,4,7,0,0,0,0
Essendon,"Saad, Adam",20,13,3,7,0,0,0,1
Essendon,"Shiel, Dylan",24,15,4,9,0,1,0,5
Essendon,"Smith, Devon",26,13,2,13,0,0,0,7
Essendon,"Snelling, Will",8,4,1,4,0,0,0,2
Essendon,"Stewart, James",11,7,5,4,0,0,0,2
Essendon,"Stringer, Jake",5,5,1,0,0,2,0,0
Essendon,"Townsend, Jacob",7,5,1,2,0,0,0,3
Essendon,"Zerk-Thatcher, Brandon",4,0,0,4,0,0,0,1
Essendon,"Clarke, Dylan",13,3,3,10,0,0,0,2
Essendon,"Cutler, Tom",23,14,3,9,0,1,0,1
Essendon,"Daniher, Joe",9,7,6,2,0,0,2,0
Essendon,"Draper, Sam",4,1,0,3,0,0,13,1
Essendon,"Gleeson, Martin",10,6,4,4,0,0,0,2
Essendon,"Guelfi, Matt",14,5,3,9,0,0,0,2
Essendon,"Ham, Brayden",13,10,6,3,0,0,0,0
Essendon,"Hurley, Michael",13,10,7,3,0,0,0,0
Essendon,"Langford, Kyle",23,10,4,13,0,0,0,3
Essendon,"Laverde, Jayden",6,6,4,0,1,0,0,4
Essendon,"McDonald-Tipungwuti, Anthony",10,5,2,5,0,0,0,3
Essendon,"Merrett, Zach",25,13,7,12,0,0,0,9
Essendon,"Parish, Darcy",25,7,3,18,0,0,0,1
Essendon,"Redman, Mason",12,5,1,7,0,0,0,1
Essendon,"Ridley, Jordan",13,10,4,3,0,1,0,1
Essendon,"Saad, Adam",19,16,5,3,0,0,0,1
Essendon,"Shiel, Dylan",25,7,1,18,1,0,0,3
Essendon,"Smith, Devon",16,8,1,8,1,1,0,3
Essendon,"Snelling, Will",15,3,2,12,0,0,0,3
Essendon,"Stewart, James",7,6,5,1,3,1,3,1
Essendon,"Stringer, Jake",12,10,3,2,1,1,0,1
Essendon,"Zerk-Thatcher, Brandon",14,9,5,5,0,1,0,1
Fremantle,"Aish, James",12,8,2,4,0,0,0,1
Fremantle,"Banfield, Bailey",12,5,3,7,0,0,0,2
Fremantle,"Bewley, Brett",20,16,8,4,0,0,0,2
Fremantle,"Brayshaw, Andrew",14,7,1,7,0,2,0,1
Fremantle,"Cerra, Adam",15,4,4,11,0,1,0,1
Fremantle,"Colyer, Travis",13,10,4,3,1,2,0,1
Fremantle,"Conca, Reece",15,10,4,5,0,0,0,4
Fremantle,"Cox, Brennan",10,6,3,4,0,0,0,1
Fremantle,"Crowden, Mitch",10,7,2,3,0,0,0,2
Fremantle,"Darcy, Sean",6,1,2,5,0,0,21,0
Fremantle,"Duman, Taylin",10,7,5,3,0,0,0,3
Fremantle,"Fyfe, Nat",26,10,4,16,0,0,0,4
Fremantle,"Hughes, Ethan",7,5,3,2,0,0,0,0
Fremantle,"Lobb, Rory",15,13,7,2,2,0,9,2
Fremantle,"Logue, Griffin",6,2,1,4,0,0,0,0
Fremantle,"McCarthy, Cam",11,8,3,3,0,1,0,1
Fremantle,"Ryan, Luke",11,9,1,2,0,0,0,0
Fremantle,"Schultz, Lachie",9,6,4,3,0,0,0,2
Fremantle,"Sturt, Sam",10,5,3,5,3,0,0,2
Fremantle,"Taberner, Matthew",10,6,5,4,1,2,0,0
Fremantle,"Tucker, Darcy",23,10,6,13,0,0,0,2
Fremantle,"Walters, Michael",21,11,4,10,1,0,0,2
Fremantle,"Aish, James",26,15,7,11,0,1,0,1
Fremantle,"Banfield, Bailey",9,5,0,4,1,0,0,3
Fremantle,"Bewley, Brett",16,8,4,8,0,0,0,0
Fremantle,"Brayshaw, Andrew",19,8,4,11,0,0,0,3
Fremantle,"Cerra, Adam",13,8,3,5,0,0,0,2
Fremantle,"Colyer, Travis",11,6,0,5,0,0,0,3
Fremantle,"Conca, Reece",17,13,2,4,0,0,0,2
Fremantle,"Cox, Brennan",8,6,5,2,0,0,0,0
Fremantle,"Darcy, Sean",4,1,0,3,0,0,14,2
Fremantle,"Duman, Taylin",9,5,2,4,0,0,0,3
Fremantle,"Fyfe, Nat",24,12,4,12,3,1,0,3
Fremantle,"Hughes, Ethan",7,5,1,2,0,0,0,0
Fremantle,"Lobb, Rory",11,9,2,2,0,0,7,1
Fremantle,"Logue, Griffin",9,1,3,8,0,0,0,0
Fremantle,"Matera, Brandon",6,4,3,2,1,0,0,1
Fremantle,"Mundy, David",13,6,2,7,0,0,0,3
Fremantle,"Ryan, Luke",21,19,8,2,0,0,0,1
Fremantle,"Schultz, Lachie",7,4,0,3,1,1,0,2
Fremantle,"Taberner, Matthew",9,7,7,2,2,3,0,0
Fremantle,"Tucker, Darcy",17,13,1,4,0,0,0,3
Fremantle,"Walters, Michael",28,10,1,18,2,0,0,5
Fremantle,"Young, Hayden",11,5,1,6,0,0,0,3
Fremantle,"Aish, James",15,13,3,2,0,0,0,1
Fremantle,"Bewley, Brett",17,9,2,8,0,0,0,2
Fremantle,"Brayshaw, Andrew",13,3,3,10,0,0,0,4
Fremantle,"Cerra, Adam",15,8,3,7,0,0,0,8
Fremantle,"Colyer, Travis",8,6,0,2,1,0,0,2
Fremantle,"Conca, Reece",11,11,5,0,0,0,0,2
Fremantle,"Cox, Brennan",15,9,5,6,0,0,0,0
Fremantle,"Fyfe, Nat",23,9,3,14,1,1,0,4
Fremantle,"Hogan, Jesse",9,2,1,7,0,0,0,0
Fremantle,"Hughes, Ethan",9,5,4,4,0,0,0,4
Fremantle,"Lobb, Rory",7,5,2,2,0,0,17,3
Fremantle,"Logue, Griffin",9,5,0,4,0,0,0,0
Fremantle,"Matera, Brandon",7,6,4,1,1,1,0,3
Fremantle,"Mundy, David",13,7,3,6,0,0,0,3
Fremantle,"Ryan, Luke",12,10,4,2,0,0,0,3
Fremantle,"Schultz, Lachie",10,8,3,2,0,1,0,1
Fremantle,"Sturt, Sam",2,2,1,0,0,0,0,1
Fremantle,"Taberner, Matthew",8,7,3,1,2,0,3,0
Fremantle,"Tucker, Darcy",14,8,3,6,0,0,0,6
Fremantle,"Walters, Michael",23,12,1,11,1,1,0,1
Fremantle,"Wilson, Nathan",12,12,3,0,0,0,0,1
Fremantle,"Young, Hayden",8,6,3,2,0,0,0,0
Fremantle,"Aish, James",13,10,4,3,0,1,0,1
Fremantle,"Bewley, Brett",11,9,4,2,2,0,0,1
Fremantle,"Brayshaw, Andrew",13,5,1,8,0,0,0,5
Fremantle,"Cerra, Adam",11,5,3,6,0,0,0,1
Fremantle,"Colyer, Travis",9,6,2,3,0,0,0,1
Fremantle,"Conca, Reece",13,12,3,1,0,0,0,1
Fremantle,"Fyfe, Nat",11,4,1,7,0,0,0,3
Fremantle,"Hill, Stephen",12,7,3,5,0,0,0,2
Fremantle,"Hogan, Jesse",13,8,9,5,0,1,0,0
Fremantle,"Hughes, Ethan",17,12,6,5,0,0,0,0
Fremantle,"Lobb, Rory",13,6,4,7,0,0,14,1
Fremantle,"Logue, Griffin",11,6,4,5,0,0,0,4
Fremantle,"Matera, Brandon",4,3,1,1,1,1,0,3
Fremantle,"Mundy, David",16,4,2,12,0,0,0,4
Fremantle,"Ryan, Luke",10,6,2,4,0,0,0,1
Fremantle,"Schultz, Lachie",7,5,3,2,1,0,0,3
Fremantle,"Serong, Caleb",12,6,3,6,0,0,0,5
Fremantle,"Taberner, Matthew",15,11,11,4,1,0,4,1
Fremantle,"Tucker, Darcy",20,12,4,8,1,0,0,5
Fremantle,"Walters, Michael",15,10,4,5,2,0,0,4
Fremantle,"Wilson, Nathan",5,4,1,1,0,0,0,1
Fremantle,"Young, Hayden",15,12,6,3,0,0,0,4
Fremantle,"Aish, James",19,14,10,5,0,0,0,0
Fremantle,"Bewley, Brett",10,6,4,4,0,0,0,5
Fremantle,"Brayshaw, Andrew",23,13,8,10,0,0,0,5
Fremantle,"Cerra, Adam",17,13,6,4,0,0,0,5
Fremantle,"Conca, Reece",10,8,5,2,0,0,0,1
Fremantle,"Darcy, Sean",7,2,4,5,0,0,24,1
Fremantle,"Duman, Taylin",8,6,4,2,0,0,0,2
Fremantle,"Hill, Stephen",12,9,4,3,0,0,0,1
Fremantle,"Hogan, Jesse",9,8,6,1,0,0,0,0
Fremantle,"Hughes, Ethan",13,9,8,4,0,0,0,1
Fremantle,"Lobb, Rory",9,7,4,2,2,0,7,2
Fremantle,"Logue, Griffin",14,8,4,6,0,0,0,1
Fremantle,"Mundy, David",25,14,4,11,0,1,0,1
Fremantle,"Ryan, Luke",18,18,7,0,0,0,0,1
Fremantle,"Schultz, Lachie",8,5,1,3,0,1,0,6
Fremantle,"Serong, Caleb",10,6,2,4,0,0,0,3
Fremantle,"Sturt, Sam",11,5,3,6,1,0,0,0
Fremantle,"Taberner, Matthew",6,6,5,0,1,2,0,0
Fremantle,"Tucker, Darcy",16,13,6,3,2,1,0,3
Fremantle,"Walters, Michael",14,7,5,7,2,0,0,3
Fremantle,"Wilson, Nathan",11,10,3,1,0,0,0,0
Fremantle,"Young, Hayden",15,10,6,5,0,0,0,0
Fremantle,"Acres, Blake",11,7,7,4,0,0,0,1
Fremantle,"Aish, James",18,11,7,7,0,0,0,1
Fremantle,"Banfield, Bailey",11,8,3,3,1,0,0,2
Fremantle,"Bewley, Brett",16,9,5,7,1,0,0,0
Fremantle,"Brayshaw, Andrew",20,11,6,9,0,0,0,5
Fremantle,"Cerra, Adam",16,9,4,7,0,0,0,2
Fremantle,"Colyer, Travis",9,6,3,3,0,0,0,1
Fremantle,"Darcy, Sean",7,6,2,1,1,2,11,1
Fremantle,"Duman, Taylin",12,7,5,5,0,0,0,1
Fremantle,"Fyfe, Nat",18,8,1,10,2,0,0,1
Fremantle,"Hill, Stephen",16,9,6,7,0,0,0,0
Fremantle,"Hughes, Ethan",10,7,4,3,0,0,0,1
Fremantle,"Lobb, Rory",14,7,6,7,1,0,16,0
Fremantle,"Mundy, David",12,6,2,6,0,0,0,4
Fremantle,"Ryan, Luke",14,11,5,3,0,0,0,3
Fremantle,"Schultz, Lachie",9,8,4,1,2,2,0,2
Fremantle,"Serong, Caleb",11,8,2,3,1,0,0,2
Fremantle,"Taberner, Matthew",13,9,7,4,2,0,0,1
Fremantle,"Tucker, Darcy",15,8,1,7,1,1,0,2
Fremantle,"Walters, Michael",26,16,3,10,0,0,0,3
Fremantle,"Wilson, Nathan",13,10,6,3,0,0,0,0
Fremantle,"Young, Hayden",1,0,0,1,0,0,0,0
Fremantle,"Acres, Blake",17,4,4,13,0,0,0,4
Fremantle,"Aish, James",18,9,3,9,0,0,0,2
Fremantle,"Banfield, Bailey",6,3,2,3,0,0,0,4
Fremantle,"Bewley, Brett",16,8,3,8,0,0,0,2
Fremantle,"Brayshaw, Andrew",17,7,1,10,0,0,0,7
Fremantle,"Cerra, Adam",16,6,0,10,0,0,0,6
Fremantle,"Colyer, Travis",7,6,2,1,0,0,0,0
Fremantle,"Cox, Brennan",16,9,3,7,0,0,0,3
Fremantle,"Darcy, Sean",6,1,1,5,0,0,16,0
Fremantle,"Duman, Taylin",11,8,3,3,0,0,0,2
Fremantle,"Frederick, Michael",10,5,3,5,1,0,0,0
Fremantle,"Hill, Stephen",14,10,6,4,0,0,0,0
Fremantle,"Hughes, Ethan",11,6,6,5,0,0,0,0
Fremantle,"Lobb, Rory",10,9,7,1,2,1,6,1
Fremantle,"Mundy, David",14,3,1,11,0,0,0,1
Fremantle,"Ryan, Luke",19,15,5,4,0,0,0,1
Fremantle,"Schultz, Lachie",7,4,2,3,0,0,0,1
Fremantle,"Serong, Caleb",10,4,0,6,0,0,0,1
Fremantle,"Taberner, Matthew",14,11,7,3,2,0,0,1
Fremantle,"Tucker, Darcy",7,4,0,3,0,0,0,5
Fremantle,"Walters, Michael",18,11,4,7,0,0,0,4
Fremantle,"Wilson, Nathan",14,11,5,3,0,0,0,1
Fremantle,"Acres, Blake",10,4,1,6,0,0,0,3
Fremantle,"Aish, James",12,7,2,5,0,0,0,0
Fremantle,"Banfield, Bailey",9,5,0,4,0,0,0,7
Fremantle,"Bewley, Brett",16,8,4,8,0,0,0,1
Fremantle,"Brayshaw, Andrew",28,7,2,21,0,0,0,8
Fremantle,"Cerra, Adam",17,7,2,10,0,0,0,9
Fremantle,"Conca, Reece",17,13,3,4,0,0,0,5
Fremantle,"Darcy, Sean",11,1,0,10,0,0,36,5
Fremantle,"Duman, Taylin",11,7,2,4,0,0,0,1
Fremantle,"Frederick, Michael",5,3,0,2,0,1,0,2
Fremantle,"Hughes, Ethan",9,7,1,2,0,0,0,4
Fremantle,"Lobb, Rory",8,4,2,4,0,1,7,3
Fremantle,"Matera, Brandon",8,7,0,1,0,1,0,3
Fremantle,"Mundy, David",24,10,1,14,0,0,0,3
Fremantle,"Ryan, Luke",23,21,4,2,0,0,0,2
Fremantle,"Schultz, Lachie",9,4,2,5,0,0,0,3
Fremantle,"Serong, Caleb",22,11,2,11,1,0,0,7
Fremantle,"Taberner, Matthew",4,4,4,0,1,0,0,0
Fremantle,"Tucker, Darcy",0,0,0,0,0,0,0,0
Fremantle,"Walters, Michael",22,17,7,5,0,0,0,4
Fremantle,"Watson, Tobe",8,3,1,5,0,0,0,1
Fremantle,"Wilson, Nathan",9,7,1,2,0,0,0,2
Fremantle,"Bewley, Brett",17,6,2,11,0,0,0,1
Fremantle,"Blakely, Connor",23,9,4,14,0,0,0,2
Fremantle,"Brayshaw, Andrew",17,9,3,8,0,0,0,7
Fremantle,"Cerra, Adam",14,6,2,8,0,0,0,2
Fremantle,"Colyer, Travis",11,7,1,4,0,0,0,0
Fremantle,"Conca, Reece",17,10,2,7,0,0,0,5
Fremantle,"Cox, Brennan",9,5,3,4,0,0,0,2
Fremantle,"Crowden, Mitch",12,8,1,4,2,0,0,2
Fremantle,"Darcy, Sean",10,5,2,5,0,0,19,2
Fremantle,"Duman, Taylin",9,5,0,4,0,0,0,1
Fremantle,"Frederick, Michael",7,5,1,2,0,1,0,1
Fremantle,"Fyfe, Nat",24,11,2,13,1,0,0,2
Fremantle,"Hughes, Ethan",17,13,8,4,0,0,0,0
Fremantle,"Lobb, Rory",12,8,1,4,0,0,9,1
Fremantle,"Matera, Brandon",6,5,0,1,0,0,0,2
Fremantle,"Mundy, David",23,11,4,12,1,0,0,5
Fremantle,"Ryan, Luke",25,18,7,7,0,0,0,3
Fremantle,"Schultz, Lachie",11,8,5,3,2,0,0,1
Fremantle,"Serong, Caleb",24,13,2,11,0,0,0,6
Fremantle,"Taberner, Matthew",13,11,6,2,4,0,0,1
Fremantle,"Watson, Tobe",12,9,4,3,0,0,0,5
Fremantle,"Wilson, Nathan",18,10,5,8,0,0,0,1
Fremantle,"Aish, James",21,12,2,9,0,0,0,2
Fremantle,"Bewley, Brett",12,8,2,4,1,0,0,3
Fremantle,"Blakely, Connor",14,3,3,11,0,0,0,2
Fremantle,"Brayshaw, Andrew",33,16,4,17,0,0,0,1
Fremantle,"Cerra, Adam",26,14,8,12,0,0,0,4
Fremantle,"Colyer, Travis",5,3,2,2,1,0,0,0
Fremantle,"Conca, Reece",23,9,4,14,0,0,0,3
Fremantle,"Cox, Brennan",16,9,7,7,0,0,0,2
Fremantle,"Crowden, Mitch",12,6,4,6,0,0,0,11
Fremantle,"Darcy, Sean",12,3,3,9,1,1,25,3
Fremantle,"Duman, Taylin",12,7,2,5,0,0,0,3
Fremantle,"Frederick, Michael",15,8,2,7,0,1,0,0
Fremantle,"Fyfe, Nat",28,7,3,21,1,1,0,4
Fremantle,"Hill, Stephen",13,8,3,5,0,0,0,2
Fremantle,"Hughes, Ethan",16,13,7,3,0,0,0,1
Fremantle,"Lobb, Rory",13,8,3,5,0,1,6,0
Fremantle,"Mundy, David",24,11,3,13,0,0,0,4
Fremantle,"Ryan, Luke",21,20,7,1,0,0,0,2
Fremantle,"Schultz, Lachie",10,4,4,6,1,0,0,3
Fremantle,"Serong, Caleb",20,8,1,12,0,0,0,4
Fremantle,"Taberner, Matthew",13,10,5,3,2,1,0,0
Fremantle,"Wilson, Nathan",21,17,5,4,0,0,0,2
Fremantle,"Aish, James",16,11,4,5,0,0,0,6
Fremantle,"Bewley, Brett",9,5,0,4,0,0,0,4
Fremantle,"Blakely, Connor",18,10,2,8,0,0,0,4
Fremantle,"Brayshaw, Andrew",16,4,2,12,0,0,0,7
Fremantle,"Cerra, Adam",18,8,2,10,0,0,0,5
Fremantle,"Conca, Reece",16,12,2,4,0,0,0,3
Fremantle,"Cox, Brennan",8,5,3,3,0,0,0,0
Fremantle,"Crowden, Mitch",6,5,0,1,0,0,0,5
Fremantle,"Darcy, Sean",6,2,2,4,0,0,32,4
Fremantle,"Duman, Taylin",10,7,1,3,0,0,0,3
Fremantle,"Frederick, Michael",4,3,3,1,1,1,0,0
Fremantle,"Fyfe, Nat",21,12,3,9,0,0,0,4
Fremantle,"Hill, Stephen",16,9,1,7,0,0,0,3
Fremantle,"Hughes, Ethan",11,8,3,3,0,0,0,3
Fremantle,"Lobb, Rory",8,5,2,3,1,0,11,0
Fremantle,"Mundy, David",15,6,0,9,0,0,0,5
Fremantle,"Ryan, Luke",24,18,5,6,0,0,0,1
Fremantle,"Schultz, Lachie",9,5,3,4,0,0,0,2
Fremantle,"Serong, Caleb",13,7,2,6,0,0,0,2
Fremantle,"Taberner, Matthew",12,10,5,2,3,0,0,0
Fremantle,"Walters, Michael",10,4,0,6,0,1,0,3
Fremantle,"Wilson, Nathan",13,12,4,1,0,0,0,2
Fremantle,"Aish, James",18,8,3,10,0,0,0,2
Fremantle,"Blakely, Connor",14,1,1,13,0,0,0,2
Fremantle,"Brayshaw, Andrew",26,13,1,13,0,0,0,7
Fremantle,"Cerra, Adam",13,6,1,7,1,0,0,4
Fremantle,"Conca, Reece",13,7,3,6,0,0,0,4
Fremantle,"Cox, Brennan",12,5,6,7,0,0,0,0
Fremantle,"Crowden, Mitch",8,3,2,5,0,0,0,5
Fremantle,"Darcy, Sean",9,1,0,8,0,0,21,0
Fremantle,"Duman, Taylin",15,11,2,4,0,0,0,2
Fremantle,"Frederick, Michael",9,6,3,3,1,0,0,1
Fremantle,"Fyfe, Nat",22,9,0,13,0,0,0,1
Fremantle,"Henry, Liam",9,8,6,1,0,0,0,0
Fremantle,"Hill, Stephen",6,2,1,4,0,0,0,0
Fremantle,"Hughes, Ethan",10,7,3,3,0,0,0,1
Fremantle,"Lobb, Rory",7,5,5,2,1,1,6,0
Fremantle,"Mundy, David",22,13,3,9,1,0,0,3
Fremantle,"Ryan, Luke",26,18,5,8,0,0,0,0
Fremantle,"Schultz, Lachie",19,13,9,6,1,0,0,2
Fremantle,"Serong, Caleb",20,10,1,10,0,1,0,5
Fremantle,"Taberner, Matthew",12,10,9,2,2,0,1,2
Fremantle,"Walters, Michael",18,13,4,5,0,1,0,0
Fremantle,"Wilson, Nathan",17,10,3,7,0,0,0,2
Fremantle,"Aish, James",8,4,0,4,0,0,0,3
Fremantle,"Bewley, Brett",14,8,2,6,1,0,0,0
Fremantle,"Blakely, Connor",6,3,2,3,0,0,0,2
Fremantle,"Brayshaw, Andrew",24,12,5,12,0,0,0,8
Fremantle,"Cerra, Adam",24,14,5,10,0,0,0,5
Fremantle,"Conca, Reece",11,8,7,3,0,0,0,2
Fremantle,"Cox, Brennan",8,4,2,4,0,0,0,0
Fremantle,"Crowden, Mitch",5,3,0,2,1,0,0,6
Fremantle,"Darcy, Sean",11,2,1,9,0,1,24,0
Fremantle,"Duman, Taylin",16,10,3,6,0,0,0,2
Fremantle,"Fyfe, Nat",11,6,2,5,0,0,0,4
Fremantle,"Henry, Liam",8,4,1,4,1,1,0,1
Fremantle,"Hill, Stephen",8,4,1,4,0,0,0,0
Fremantle,"Hughes, Ethan",13,7,3,6,0,0,0,3
Fremantle,"Lobb, Rory",7,4,2,3,0,0,10,2
Fremantle,"Mundy, David",20,8,2,12,2,0,0,8
Fremantle,"Ryan, Luke",12,10,2,2,0,0,0,0
Fremantle,"Schultz, Lachie",10,6,3,4,0,1,0,4
Fremantle,"Serong, Caleb",15,6,2,9,0,0,0,2
Fremantle,"Taberner, Matthew",7,4,3,3,2,0,0,0
Fremantle,"Walters, Michael",18,7,2,11,0,1,0,3
Fremantle,"Wilson, Nathan",18,10,3,8,1,0,0,0
Fremantle,"Acres, Blake",27,15,6,12,0,0,0,5
Fremantle,"Aish, James",10,7,2,3,0,0,0,1
Fremantle,"Brayshaw, Andrew",18,11,3,7,0,1,0,3
Fremantle,"Cerra, Adam",17,7,0,10,0,0,0,4
Fremantle,"Conca, Reece",10,6,1,4,0,0,0,3
Fremantle,"Cox, Brennan",8,4,3,4,0,0,0,1
Fremantle,"Crowden, Mitch",7,6,1,1,2,0,0,3
Fremantle,"Darcy, Sean",6,3,1,3,0,0,21,0
Fremantle,"Duman, Taylin",9,7,4,2,0,0,0,2
Fremantle,"Frederick, Michael",11,5,4,6,0,0,0,1
Fremantle,"Fyfe, Nat",23,14,5,9,0,1,0,2
Fremantle,"Hill, Stephen",12,8,3,4,0,0,0,2
Fremantle,"Hogan, Jesse",13,9,8,4,0,2,0,0
Fremantle,"Hughes, Ethan",15,8,5,7,0,0,0,1
Fremantle,"Lobb, Rory",12,5,3,7,0,0,5,4
Fremantle,"Mundy, David",17,6,2,11,0,0,0,2
Fremantle,"Ryan, Luke",16,13,6,3,0,0,0,0
Fremantle,"Schultz, Lachie",8,5,4,3,0,0,0,2
Fremantle,"Serong, Caleb",22,17,6,5,0,0,0,5
Fremantle,"Taberner, Matthew",8,7,5,1,1,1,0,0
Fremantle,"Walters, Michael",10,8,2,2,1,0,0,3
Fremantle,"Wilson, Nathan",10,6,2,4,0,0,0,0
Fremantle,"Acres, Blake",23,12,4,11,0,0,0,3
Fremantle,"Aish, James",22,10,5,12,0,0,0,0
Fremantle,"Brayshaw, Andrew",21,8,1,13,0,0,0,7
Fremantle,"Cerra, Adam",30,13,3,17,1,1,0,2
Fremantle,"Conca, Reece",15,13,2,2,0,0,0,1
Fremantle,"Cox, Brennan",16,10,2,6,0,0,0,0
Fremantle,"Crowden, Mitch",6,3,0,3,0,0,0,7
Fremantle,"Darcy, Sean",11,5,3,6,1,1,16,4
Fremantle,"Duman, Taylin",15,10,6,5,0,0,0,2
Fremantle,"Frederick, Michael",6,2,0,4,1,1,0,3
Fremantle,"Fyfe, Nat",21,8,4,13,0,1,0,4
Fremantle,"Hill, Stephen",9,5,3,4,0,0,0,5
Fremantle,"Hogan, Jesse",8,2,3,6,0,0,0,0
Fremantle,"Hughes, Ethan",20,10,6,10,0,0,0,0
Fremantle,"Lobb, Rory",8,5,2,3,0,1,7,3
Fremantle,"Mundy, David",20,10,2,10,0,0,0,7
Fremantle,"Ryan, Luke",21,15,6,6,0,0,0,1
Fremantle,"Schultz, Lachie",12,9,6,3,0,0,0,4
Fremantle,"Serong, Caleb",18,11,5,7,0,0,0,5
Fremantle,"Taberner, Matthew",12,9,6,3,0,3,0,2
Fremantle,"Walters, Michael",11,7,0,4,3,1,0,4
Fremantle,"Wilson, Nathan",16,13,5,3,0,1,0,1
Fremantle,"Acres, Blake",24,18,9,6,0,0,0,3
Fremantle,"Aish, James",23,13,3,10,0,0,0,4
Fremantle,"Brayshaw, Andrew",20,9,4,11,0,0,0,1
Fremantle,"Cerra, Adam",15,6,2,9,0,1,0,4
Fremantle,"Cox, Brennan",12,7,6,5,0,0,0,1
Fremantle,"Crowden, Mitch",12,5,3,7,0,0,0,3
Fremantle,"Darcy, Sean",13,5,2,8,1,0,22,3
Fremantle,"Duman, Taylin",15,8,2,7,0,0,0,0
Fremantle,"Frederick, Michael",8,3,1,5,0,1,0,0
Fremantle,"Fyfe, Nat",25,10,7,15,0,1,0,2
Fremantle,"Hill, Stephen",20,12,6,8,0,0,0,5
Fremantle,"Hogan, Jesse",6,5,4,1,4,0,0,1
Fremantle,"Hughes, Ethan",15,10,8,5,0,0,0,0
Fremantle,"Lobb, Rory",12,11,7,1,1,0,4,0
Fremantle,"Mundy, David",24,12,2,12,0,0,0,3
Fremantle,"Ryan, Luke",18,13,5,5,0,0,0,1
Fremantle,"Schultz, Lachie",14,7,4,7,3,1,0,3
Fremantle,"Serong, Caleb",14,7,0,7,0,0,0,5
Fremantle,"Taberner, Matthew",10,7,4,3,3,1,0,0
Fremantle,"Walters, Michael",13,12,7,1,3,2,0,1
Fremantle,"Watson, Tobe",10,9,7,1,0,0,0,1
Fremantle,"Wilson, Nathan",12,9,1,3,0,0,0,1
Fremantle,"Acres, Blake",22,15,9,7,0,0,0,0
Fremantle,"Aish, James",14,10,6,4,0,0,0,0
Fremantle,"Brayshaw, Andrew",16,4,0,12,0,0,0,4
Fremantle,"Cerra, Adam",18,9,3,9,0,0,0,0
Fremantle,"Colyer, Travis",7,4,2,3,0,0,0,1
Fremantle,"Conca, Reece",11,8,5,3,0,0,0,2
Fremantle,"Cox, Brennan",10,4,3,6,0,0,0,1
Fremantle,"Crowden, Mitch",6,4,2,2,1,1,0,3
Fremantle,"Darcy, Sean",15,4,2,11,1,1,28,1
Fremantle,"Duman, Taylin",9,8,5,1,0,0,0,2
Fremantle,"Frederick, Michael",5,1,1,4,0,0,0,0
Fremantle,"Fyfe, Nat",23,10,4,13,2,0,0,4
Fremantle,"Henry, Liam",5,4,1,1,0,2,0,3
Fremantle,"Hill, Stephen",19,13,3,6,0,0,0,1
Fremantle,"Hogan, Jesse",13,7,6,6,1,1,0,3
Fremantle,"Hughes, Ethan",17,8,3,9,0,0,0,1
Fremantle,"Lobb, Rory",7,5,4,2,0,1,15,1
Fremantle,"Mundy, David",8,4,0,4,0,0,0,3
Fremantle,"Ryan, Luke",25,17,9,8,0,0,0,0
Fremantle,"Schultz, Lachie",10,8,4,2,1,0,0,2
Fremantle,"Serong, Caleb",25,13,4,12,0,0,0,6
Fremantle,"Wilson, Nathan",16,12,3,4,0,0,0,0
Gold Coast,"Ainsworth, Ben",15,12,6,3,1,1,0,2
Gold Coast,"Anderson, Noah",12,6,2,6,0,0,0,0
Gold Coast,"Bowes, Jack",18,9,3,9,0,0,0,2
Gold Coast,"Brodie, Will",14,4,3,10,0,0,0,1
Gold Coast,"Budarick, Connor",8,3,0,5,0,0,0,3
Gold Coast,"Collins, Sam",15,11,6,4,0,0,0,0
Gold Coast,"Day, Sam",7,1,0,6,0,1,10,1
Gold Coast,"Ellis, Brandon",21,15,3,6,0,0,0,2
Gold Coast,"Fiorini, Brayden",19,14,4,5,0,0,0,4
Gold Coast,"Graham, Caleb",5,4,3,1,0,0,0,0
Gold Coast,"Greenwood, Hugh",18,9,1,9,0,0,0,3
Gold Coast,"Holman, Nick",8,3,0,5,0,0,0,1
Gold Coast,"Joyce, Jesse",14,9,3,5,0,0,0,1
Gold Coast,"King, Ben",7,5,2,2,1,0,0,1
Gold Coast,"Lemmens, Sean",9,6,1,3,1,0,0,3
Gold Coast,"Lukosius, Jack",14,12,3,2,0,0,0,2
Gold Coast,"Macpherson, Darcy",12,7,2,5,0,0,0,2
Gold Coast,"Miller, Touk",22,11,5,11,0,0,0,4
Gold Coast,"Rowell, Matt",19,6,1,13,0,0,0,4
Gold Coast,"Swallow, David",17,13,5,4,1,0,0,2
Gold Coast,"Weller, Lachie",17,11,6,6,0,0,0,2
Gold Coast,"Witts, Jarrod",5,2,0,3,0,0,24,1
Gold Coast,"Ainsworth, Ben",16,7,3,9,2,1,0,0
Gold Coast,"Anderson, Noah",19,12,5,7,1,0,0,2
Gold Coast,"Ballard, Charlie",6,4,2,2,0,0,0,2
Gold Coast,"Bowes, Jack",17,14,9,3,0,0,0,0
Gold Coast,"Budarick, Connor",16,10,5,6,0,0,0,3
Gold Coast,"Collins, Sam",7,5,3,2,0,0,0,0
Gold Coast,"Day, Sam",18,8,5,10,2,0,5,2
Gold Coast,"Fiorini, Brayden",21,14,5,7,0,0,0,1
Gold Coast,"Greenwood, Hugh",20,15,0,5,1,0,0,3
Gold Coast,"Hanley, Pearce",12,11,4,1,0,0,0,0
Gold Coast,"Harbrow, Jarrod",10,6,2,4,0,0,0,4
Gold Coast,"Holman, Nick",6,4,1,2,1,0,0,3
Gold Coast,"King, Ben",11,10,7,1,1,2,0,0
Gold Coast,"Lemmens, Sean",12,6,1,6,1,0,0,0
Gold Coast,"Lukosius, Jack",13,11,6,2,1,0,0,2
Gold Coast,"Macpherson, Darcy",12,4,2,8,1,0,0,2
Gold Coast,"Miller, Touk",22,12,0,10,0,0,0,4
Gold Coast,"Powell, Wil",21,9,0,12,0,0,0,0
Gold Coast,"Rowell, Matt",26,11,1,15,2,0,0,7
Gold Coast,"Sexton, Alex",14,12,3,2,0,3,0,0
Gold Coast,"Weller, Lachie",24,13,2,11,1,0,0,3
Gold Coast,"Witts, Jarrod",14,9,2,5,0,0,23,0
Gold Coast,"Ainsworth, Ben",17,10,5,7,1,2,0,5
Gold Coast,"Anderson, Noah",9,4,3,5,0,0,0,2
Gold Coast,"Ballard, Charlie",13,9,7,4,0,0,0,0
Gold Coast,"Bowes, Jack",20,14,7,6,0,0,0,3
Gold Coast,"Budarick, Connor",16,11,6,5,1,0,0,2
Gold Coast,"Collins, Sam",10,5,6,5,0,0,0,2
Gold Coast,"Day, Sam",4,3,0,1,0,0,5,2
Gold Coast,"Ellis, Brandon",20,16,3,4,0,1,0,5
Gold Coast,"Greenwood, Hugh",11,7,1,4,0,1,0,13
Gold Coast,"Hanley, Pearce",17,12,5,5,0,0,0,2
Gold Coast,"Harbrow, Jarrod",10,8,1,2,0,0,0,0
Gold Coast,"Holman, Nick",9,3,4,6,0,0,0,4
Gold Coast,"King, Ben",13,7,6,6,3,2,0,0
Gold Coast,"Lukosius, Jack",15,11,6,4,0,0,0,3
Gold Coast,"Macpherson, Darcy",18,7,3,11,2,0,0,2
Gold Coast,"Miller, Touk",26,16,6,10,1,0,0,3
Gold Coast,"Powell, Wil",12,3,2,9,0,0,0,3
Gold Coast,"Rowell, Matt",20,10,1,10,2,0,0,10
Gold Coast,"Sexton, Alex",6,5,1,1,1,1,0,5
Gold Coast,"Swallow, David",16,11,3,5,0,1,0,3
Gold Coast,"Weller, Lachie",21,12,5,9,1,0,0,5
Gold Coast,"Witts, Jarrod",17,12,6,5,0,1,22,1
Gold Coast,"Ainsworth, Ben",12,7,6,5,2,0,0,1
Gold Coast,"Anderson, Noah",14,12,5,2,0,0,0,1
Gold Coast,"Ballard, Charlie",11,8,6,3,0,0,0,2
Gold Coast,"Bowes, Jack",18,12,5,6,0,0,0,1
Gold Coast,"Budarick, Connor",8,7,2,1,0,0,0,0
Gold Coast,"Collins, Sam",7,6,6,1,0,0,0,1
Gold Coast,"Day, Sam",7,2,2,5,1,1,4,1
Gold Coast,"Ellis, Brandon",20,13,7,7,0,0,0,2
Gold Coast,"Greenwood, Hugh",7,3,0,4,0,0,0,8
Gold Coast,"Hanley, Pearce",10,7,2,3,0,0,0,1
Gold Coast,"Harbrow, Jarrod",14,12,8,2,0,0,0,1
Gold Coast,"Holman, Nick",12,4,4,8,0,0,0,3
Gold Coast,"King, Ben",10,5,3,5,2,1,0,0
Gold Coast,"Lukosius, Jack",16,14,5,2,1,0,0,0
Gold Coast,"Macpherson, Darcy",13,10,4,3,0,0,0,3
Gold Coast,"Miller, Touk",20,12,2,8,0,0,0,6
Gold Coast,"Powell, Wil",17,7,3,10,0,0,0,0
Gold Coast,"Rowell, Matt",20,10,1,10,2,0,0,5
Gold Coast,"Sexton, Alex",9,6,1,3,2,0,0,1
Gold Coast,"Swallow, David",14,7,3,7,0,1,0,4
Gold Coast,"Weller, Lachie",15,8,2,7,0,0,0,4
Gold Coast,"Witts, Jarrod",12,8,5,4,0,0,38,2
Gold Coast,"Ainsworth, Ben",9,7,2,2,0,0,0,5
Gold Coast,"Anderson, Noah",18,10,4,8,0,0,0,2
Gold Coast,"Ballard, Charlie",9,5,5,4,0,0,0,1
Gold Coast,"Bowes, Jack",17,10,2,7,0,0,0,2
Gold Coast,"Budarick, Connor",5,3,0,2,0,0,0,2
Gold Coast,"Collins, Sam",8,7,5,1,0,0,0,2
Gold Coast,"Day, Sam",10,4,3,6,2,0,4,1
Gold Coast,"Ellis, Brandon",16,9,6,7,0,0,0,3
Gold Coast,"Greenwood, Hugh",21,14,2,7,0,0,0,11
Gold Coast,"Hanley, Pearce",10,7,2,3,0,0,0,1
Gold Coast,"Harbrow, Jarrod",13,12,5,1,0,0,0,1
Gold Coast,"Holman, Nick",13,7,3,6,0,0,0,8
Gold Coast,"King, Ben",5,5,3,0,3,1,0,1
Gold Coast,"Lukosius, Jack",10,8,1,2,0,0,0,4
Gold Coast,"Macpherson, Darcy",11,8,3,3,0,0,0,1
Gold Coast,"Miller, Touk",17,9,2,8,0,0,0,6
Gold Coast,"Powell, Wil",7,4,3,3,0,0,0,2
Gold Coast,"Rowell, Matt",2,1,0,1,0,0,0,0
Gold Coast,"Sexton, Alex",7,6,3,1,1,1,0,4
Gold Coast,"Swallow, David",22,12,7,10,0,0,0,5
Gold Coast,"Weller, Lachie",11,8,2,3,2,1,0,5
Gold Coast,"Witts, Jarrod",9,5,2,4,0,0,29,1
Gold Coast,"Ainsworth, Ben",9,8,5,1,1,1,0,2
Gold Coast,"Anderson, Noah",17,7,2,10,0,0,0,3
Gold Coast,"Ballard, Charlie",15,13,7,2,0,0,0,0
Gold Coast,"Bowes, Jack",19,10,6,9,0,0,0,1
Gold Coast,"Budarick, Connor",13,8,5,5,0,0,0,0
Gold Coast,"Collins, Sam",15,8,7,7,0,0,0,1
Gold Coast,"Day, Sam",7,4,2,3,0,0,2,1
Gold Coast,"Ellis, Brandon",16,13,3,3,2,0,0,2
Gold Coast,"Fiorini, Brayden",9,5,3,4,1,0,0,0
Gold Coast,"Greenwood, Hugh",18,9,4,9,0,1,0,12
Gold Coast,"Hanley, Pearce",11,6,5,5,0,0,0,2
Gold Coast,"Harbrow, Jarrod",10,5,3,5,0,0,0,3
Gold Coast,"Holman, Nick",9,3,3,6,0,0,0,4
Gold Coast,"King, Ben",7,7,6,0,1,2,0,0
Gold Coast,"Lukosius, Jack",18,14,1,4,0,0,0,1
Gold Coast,"Macpherson, Darcy",4,2,0,2,0,0,0,4
Gold Coast,"Miller, Touk",23,10,4,13,0,1,0,5
Gold Coast,"Rankine, Izak",12,8,1,4,3,3,0,3
Gold Coast,"Sexton, Alex",9,7,2,2,0,0,0,1
Gold Coast,"Swallow, David",17,10,3,7,0,0,0,5
Gold Coast,"Weller, Lachie",15,8,2,7,1,0,0,1
Gold Coast,"Witts, Jarrod",8,3,1,5,0,1,18,5
Gold Coast,"Ainsworth, Ben",15,8,3,7,0,2,0,3
Gold Coast,"Anderson, Noah",15,12,5,3,1,1,0,3
Gold Coast,"Ballard, Charlie",12,9,4,3,0,0,0,1
Gold Coast,"Bowes, Jack",17,11,6,6,0,0,0,0
Gold Coast,"Budarick, Connor",8,6,3,2,0,0,0,1
Gold Coast,"Collins, Sam",8,6,3,2,0,0,0,5
Gold Coast,"Day, Sam",7,5,2,2,2,1,4,2
Gold Coast,"Ellis, Brandon",21,17,6,4,0,0,0,1
Gold Coast,"Greenwood, Hugh",23,14,0,9,0,0,0,12
Gold Coast,"Hanley, Pearce",13,11,5,2,0,1,0,0
Gold Coast,"Harbrow, Jarrod",18,15,4,3,0,0,0,1
Gold Coast,"Holman, Nick",7,4,1,3,1,0,0,2
Gold Coast,"King, Ben",3,3,0,0,1,1,0,0
Gold Coast,"Lukosius, Jack",17,10,2,7,1,0,0,0
Gold Coast,"Macpherson, Darcy",10,5,1,5,1,0,0,3
Gold Coast,"Miller, Touk",20,9,2,11,0,0,0,3
Gold Coast,"Powell, Wil",4,1,0,3,0,0,0,0
Gold Coast,"Rankine, Izak",16,12,3,4,2,2,0,4
Gold Coast,"Sexton, Alex",11,6,3,5,1,1,0,0
Gold Coast,"Swallow, David",22,9,5,13,1,2,0,6
Gold Coast,"Weller, Lachie",15,7,0,8,2,0,0,7
Gold Coast,"Witts, Jarrod",14,6,5,8,0,0,36,2
Gold Coast,"Ainsworth, Ben",9,7,2,2,1,1,0,0
Gold Coast,"Anderson, Noah",11,9,2,2,0,1,0,4
Gold Coast,"Ballard, Charlie",13,6,3,7,0,0,0,3
Gold Coast,"Bowes, Jack",18,14,5,4,0,0,0,0
Gold Coast,"Budarick, Connor",11,6,2,5,0,0,0,1
Gold Coast,"Collins, Sam",17,11,4,6,0,0,0,1
Gold Coast,"Day, Sam",4,2,1,2,0,0,0,2
Gold Coast,"Ellis, Brandon",15,7,5,8,1,0,0,1
Gold Coast,"Greenwood, Hugh",22,13,4,9,0,0,2,9
Gold Coast,"Hanley, Pearce",9,6,2,3,0,0,0,4
Gold Coast,"Harbrow, Jarrod",16,13,3,3,0,0,0,2
Gold Coast,"Holman, Nick",14,7,1,7,0,0,0,5
Gold Coast,"King, Ben",4,3,2,1,0,0,0,0
Gold Coast,"Lukosius, Jack",15,12,3,3,0,0,0,2
Gold Coast,"Macpherson, Darcy",9,7,2,2,0,0,0,3
Gold Coast,"Miller, Touk",26,12,2,14,0,0,0,7
Gold Coast,"Powell, Wil",10,7,2,3,0,0,0,2
Gold Coast,"Rankine, Izak",11,7,4,4,1,4,0,1
Gold Coast,"Sexton, Alex",11,9,5,2,3,0,0,2
Gold Coast,"Swallow, David",21,16,4,5,0,1,0,7
Gold Coast,"Weller, Lachie",18,14,2,4,0,0,0,2
Gold Coast,"Witts, Jarrod",7,2,2,5,0,0,46,3
Gold Coast,"Ainsworth, Ben",14,12,9,2,1,1,0,1
Gold Coast,"Anderson, Noah",15,5,2,10,0,0,0,2
Gold Coast,"Ballard, Charlie",11,7,4,4,0,0,0,0
Gold Coast,"Bowes, Jack",14,11,3,3,0,0,0,3
Gold Coast,"Budarick, Connor",13,10,2,3,0,0,0,0
Gold Coast,"Collins, Sam",11,6,5,5,0,0,0,7
Gold Coast,"Day, Sam",9,6,3,3,0,1,4,0
Gold Coast,"Ellis, Brandon",16,9,5,7,0,0,0,3
Gold Coast,"Greenwood, Hugh",14,9,2,5,0,0,0,0
Gold Coast,"Hanley, Pearce",11,7,5,4,0,0,0,2
Gold Coast,"Harbrow, Jarrod",9,4,0,5,0,0,0,1
Gold Coast,"Holman, Nick",12,4,3,8,0,0,0,2
Gold Coast,"King, Ben",6,4,1,2,1,1,0,2
Gold Coast,"Lukosius, Jack",19,15,4,4,0,1,0,2
Gold Coast,"Macpherson, Darcy",14,10,4,4,0,0,0,1
Gold Coast,"Miller, Touk",15,11,2,4,0,0,0,6
Gold Coast,"Powell, Wil",17,10,5,7,0,0,0,1
Gold Coast,"Rankine, Izak",9,5,1,4,0,1,0,1
Gold Coast,"Sexton, Alex",6,5,4,1,0,2,0,1
Gold Coast,"Swallow, David",14,9,4,5,1,1,0,2
Gold Coast,"Weller, Lachie",13,7,0,6,1,0,0,1
Gold Coast,"Witts, Jarrod",7,3,3,4,0,0,23,0
Gold Coast,"Ainsworth, Ben",18,10,6,8,0,0,0,1
Gold Coast,"Anderson, Noah",16,9,1,7,1,1,0,1
Gold Coast,"Ballard, Charlie",7,6,3,1,0,0,0,1
Gold Coast,"Bowes, Jack",11,6,1,5,0,0,0,2
Gold Coast,"Budarick, Connor",8,5,2,3,0,0,0,3
Gold Coast,"Collins, Sam",14,7,3,7,0,0,0,3
Gold Coast,"Day, Sam",12,4,4,8,0,1,2,2
Gold Coast,"Ellis, Brandon",23,12,3,11,0,0,0,7
Gold Coast,"Greenwood, Hugh",22,11,0,11,0,1,0,5
Gold Coast,"Harbrow, Jarrod",17,11,4,6,0,0,0,0
Gold Coast,"Holman, Nick",13,3,2,10,0,0,0,2
Gold Coast,"King, Ben",5,4,2,1,3,1,0,0
Gold Coast,"Lemmens, Sean",12,8,0,4,1,0,0,1
Gold Coast,"Lukosius, Jack",21,13,4,8,0,0,0,2
Gold Coast,"Miller, Touk",18,12,5,6,2,1,0,7
Gold Coast,"Powell, Wil",14,9,4,5,2,0,0,3
Gold Coast,"Rankine, Izak",13,9,2,4,2,0,0,3
Gold Coast,"Sexton, Alex",11,11,2,0,0,1,0,3
Gold Coast,"Sharp, Jeremy",9,5,1,4,0,0,0,0
Gold Coast,"Swallow, David",22,8,2,14,0,0,0,3
Gold Coast,"Weller, Lachie",18,10,1,8,0,0,0,1
Gold Coast,"Witts, Jarrod",10,6,0,4,0,1,25,1
Gold Coast,"Ainsworth, Ben",9,5,2,4,1,0,0,0
Gold Coast,"Anderson, Noah",15,9,3,6,0,0,0,2
Gold Coast,"Ballard, Charlie",10,10,7,0,0,0,0,0
Gold Coast,"Bowes, Jack",16,13,4,3,1,0,0,1
Gold Coast,"Budarick, Connor",6,5,2,1,0,0,0,2
Gold Coast,"Collins, Sam",5,3,2,2,0,0,0,1
Gold Coast,"Corbett, Josh",11,7,5,4,0,1,0,1
Gold Coast,"Day, Sam",10,7,6,3,2,0,1,1
Gold Coast,"Ellis, Brandon",18,12,5,6,0,1,0,1
Gold Coast,"Fiorini, Brayden",13,10,5,3,1,0,0,1
Gold Coast,"Flanders, Sam",8,3,0,5,0,0,0,5
Gold Coast,"Greenwood, Hugh",18,11,1,7,1,0,0,3
Gold Coast,"Harbrow, Jarrod",7,6,3,1,0,0,0,0
Gold Coast,"King, Ben",8,7,3,1,2,1,0,0
Gold Coast,"Lemmens, Sean",8,5,2,3,0,0,0,4
Gold Coast,"Lukosius, Jack",11,8,2,3,0,0,0,3
Gold Coast,"Miller, Touk",11,7,2,4,0,0,0,4
Gold Coast,"Powell, Wil",7,5,4,2,0,0,0,4
Gold Coast,"Rankine, Izak",14,10,3,4,1,2,0,0
Gold Coast,"Swallow, David",13,6,2,7,0,0,0,4
Gold Coast,"Weller, Lachie",18,10,1,8,2,1,0,3
Gold Coast,"Witts, Jarrod",11,6,0,5,0,0,31,2
Gold Coast,"Ainsworth, Ben",12,3,1,9,0,0,0,0
Gold Coast,"Anderson, Noah",26,11,4,15,0,1,0,1
Gold Coast,"Ballard, Charlie",6,3,3,3,0,0,0,0
Gold Coast,"Bowes, Jack",21,16,6,5,0,0,0,5
Gold Coast,"Budarick, Connor",2,2,0,0,0,0,0,5
Gold Coast,"Collins, Sam",7,5,3,2,0,0,0,0
Gold Coast,"Corbett, Josh",7,5,5,2,0,0,0,0
Gold Coast,"Day, Sam",5,4,3,1,0,0,0,1
Gold Coast,"Ellis, Brandon",17,14,7,3,1,1,0,2
Gold Coast,"Fiorini, Brayden",3,2,1,1,0,0,0,3
Gold Coast,"Flanders, Sam",6,2,1,4,1,0,0,3
Gold Coast,"Graham, Caleb",8,6,6,2,0,0,0,0
Gold Coast,"Greenwood, Hugh",15,10,3,5,0,1,0,7
Gold Coast,"Holman, Nick",9,3,1,6,0,0,0,2
Gold Coast,"King, Ben",6,3,1,3,1,1,0,0
Gold Coast,"Lukosius, Jack",27,21,7,6,0,1,0,3
Gold Coast,"Miller, Touk",21,8,5,13,0,0,0,7
Gold Coast,"Powell, Wil",13,10,9,3,0,0,0,1
Gold Coast,"Rankine, Izak",11,6,3,5,0,0,0,1
Gold Coast,"Sexton, Alex",8,6,3,2,1,0,0,2
Gold Coast,"Weller, Lachie",17,8,1,9,0,0,0,1
Gold Coast,"Witts, Jarrod",11,8,4,3,0,0,25,2
Gold Coast,"Ainsworth, Ben",14,12,3,2,0,0,0,3
Gold Coast,"Anderson, Noah",5,4,1,1,0,0,0,2
Gold Coast,"Ballard, Charlie",13,10,3,3,0,0,0,0
Gold Coast,"Bowes, Jack",20,14,5,6,0,0,0,3
Gold Coast,"Budarick, Connor",9,8,3,1,0,0,0,1
Gold Coast,"Collins, Sam",11,8,4,3,0,0,0,2
Gold Coast,"Corbett, Josh",8,6,4,2,0,0,0,0
Gold Coast,"Day, Sam",6,1,1,5,0,0,5,0
Gold Coast,"Ellis, Brandon",13,9,4,4,0,0,0,7
Gold Coast,"Flanders, Sam",6,5,2,1,1,0,0,3
Gold Coast,"Graham, Caleb",6,5,3,1,0,0,0,2
Gold Coast,"Greenwood, Hugh",11,7,0,4,0,0,0,11
Gold Coast,"Harbrow, Jarrod",14,10,1,4,0,0,0,0
Gold Coast,"King, Ben",5,2,0,3,0,1,0,0
Gold Coast,"Lemmens, Sean",7,4,3,3,1,0,0,1
Gold Coast,"Lukosius, Jack",23,19,6,4,0,0,0,1
Gold Coast,"Miller, Touk",17,10,2,7,0,0,0,7
Gold Coast,"Powell, Wil",11,7,3,4,0,0,0,1
Gold Coast,"Rankine, Izak",8,6,5,2,1,1,0,0
Gold Coast,"Swallow, David",15,11,4,4,0,1,0,7
Gold Coast,"Weller, Lachie",10,6,3,4,1,0,0,1
Gold Coast,"Witts, Jarrod",9,5,0,4,0,0,21,2
Gold Coast,"Ainsworth, Ben",23,19,11,4,1,2,0,0
Gold Coast,"Anderson, Noah",23,13,3,10,1,0,0,1
Gold Coast,"Ballard, Charlie",12,11,5,1,0,0,0,0
Gold Coast,"Bowes, Jack",15,7,3,8,0,0,0,2
Gold Coast,"Budarick, Connor",9,6,3,3,0,0,0,2
Gold Coast,"Collins, Sam",10,4,5,6,0,0,0,0
Gold Coast,"Corbett, Josh",12,10,8,2,0,3,0,4
Gold Coast,"Day, Sam",13,6,5,7,2,2,0,0
Gold Coast,"Ellis, Brandon",16,10,1,6,1,0,0,1
Gold Coast,"Flanders, Sam",4,3,0,1,0,1,0,1
Gold Coast,"Graham, Caleb",4,1,1,3,0,0,0,0
Gold Coast,"Greenwood, Hugh",23,13,1,10,0,0,0,6
Gold Coast,"King, Ben",11,9,6,2,2,4,0,1
Gold Coast,"Lukosius, Jack",13,10,4,3,0,0,0,1
Gold Coast,"Macpherson, Darcy",7,5,1,2,0,0,0,3
Gold Coast,"Miller, Touk",23,11,5,12,0,0,0,2
Gold Coast,"Powell, Wil",11,6,3,5,0,0,0,4
Gold Coast,"Rankine, Izak",13,9,3,4,1,1,0,1
Gold Coast,"Sexton, Alex",7,6,3,1,4,0,0,0
Gold Coast,"Swallow, David",20,10,5,10,0,1,0,2
Gold Coast,"Weller, Lachie",20,11,2,9,0,1,0,1
Gold Coast,"Witts, Jarrod",16,9,2,7,0,0,25,1
Gold Coast,"Ainsworth, Ben",18,10,3,8,1,0,0,2
Gold Coast,"Anderson, Noah",21,8,3,13,0,0,0,2
Gold Coast,"Ballard, Charlie",9,4,1,5,0,0,0,0
Gold Coast,"Bowes, Jack",14,8,1,6,0,0,0,0
Gold Coast,"Budarick, Connor",6,2,0,4,0,0,0,0
Gold Coast,"Collins, Sam",11,5,4,6,0,0,0,0
Gold Coast,"Corbett, Josh",11,7,4,4,2,1,0,0
Gold Coast,"Day, Sam",10,4,4,6,0,0,1,1
Gold Coast,"Ellis, Brandon",25,18,6,7,0,0,0,1
Gold Coast,"Flanders, Sam",7,4,1,3,0,0,0,2
Gold Coast,"Graham, Caleb",9,5,4,4,0,0,0,0
Gold Coast,"Greenwood, Hugh",25,11,2,14,0,0,0,4
Gold Coast,"King, Ben",6,6,3,0,2,0,0,1
Gold Coast,"Lukosius, Jack",19,16,2,3,0,0,0,0
Gold Coast,"Macpherson, Darcy",16,7,1,9,0,0,0,8
Gold Coast,"Miller, Touk",14,7,1,7,0,0,0,4
Gold Coast,"Powell, Wil",14,7,4,7,0,0,0,1
Gold Coast,"Rankine, Izak",14,8,0,6,0,1,0,2
Gold Coast,"Sexton, Alex",5,3,2,2,0,0,0,2
Gold Coast,"Swallow, David",15,9,2,6,0,1,0,3
Gold Coast,"Weller, Lachie",16,8,4,8,1,0,0,3
Gold Coast,"Witts, Jarrod",6,4,1,2,0,0,32,0
Gold Coast,"Anderson, Noah",20,12,2,8,0,0,0,4
Gold Coast,"Ballard, Charlie",7,6,5,1,0,0,0,0
Gold Coast,"Bowes, Jack",21,17,2,4,0,0,0,2
Gold Coast,"Collins, Sam",10,5,4,5,0,0,0,1
Gold Coast,"Corbett, Josh",7,4,2,3,1,0,0,1
Gold Coast,"Day, Sam",9,5,4,4,0,0,4,2
Gold Coast,"Ellis, Brandon",24,14,3,10,0,0,0,2
Gold Coast,"Graham, Caleb",9,8,4,1,0,0,0,0
Gold Coast,"Greenwood, Hugh",20,11,6,9,0,0,0,3
Gold Coast,"Harbrow, Jarrod",13,9,3,4,0,0,0,0
Gold Coast,"Holman, Nick",9,3,4,6,0,0,0,5
Gold Coast,"King, Ben",5,3,2,2,1,2,0,0
Gold Coast,"Lemmens, Sean",0,0,0,0,0,0,0,0
Gold Coast,"Lukosius, Jack",16,15,2,1,0,0,0,1
Gold Coast,"Macpherson, Darcy",12,8,3,4,0,0,0,1
Gold Coast,"Miller, Touk",22,10,4,12,0,1,0,9
Gold Coast,"Powell, Wil",22,14,6,8,0,0,0,2
Gold Coast,"Rankine, Izak",9,6,0,3,0,1,0,2
Gold Coast,"Sexton, Alex",15,11,5,4,3,3,0,1
Gold Coast,"Swallow, David",15,8,1,7,1,0,0,6
Gold Coast,"Weller, Lachie",23,12,3,11,0,0,0,4
Gold Coast,"Witts, Jarrod",13,8,3,5,0,0,31,1
Gold Coast,"Ainsworth, Ben",17,10,3,7,0,2,0,2
Gold Coast,"Anderson, Noah",25,16,1,9,0,0,0,0
Gold Coast,"Ballard, Charlie",4,3,3,1,0,0,0,3
Gold Coast,"Bowes, Jack",14,9,1,5,0,0,0,3
Gold Coast,"Collins, Sam",9,5,4,4,0,0,0,1
Gold Coast,"Corbett, Josh",6,6,3,0,0,1,0,1
Gold Coast,"Day, Sam",9,2,2,7,1,0,3,2
Gold Coast,"Ellis, Brandon",12,6,1,6,0,0,0,2
Gold Coast,"Farrar, Jy",6,3,2,3,1,0,0,1
Gold Coast,"Graham, Caleb",9,7,4,2,0,0,0,0
Gold Coast,"Greenwood, Hugh",15,6,0,9,1,0,1,7
Gold Coast,"Harbrow, Jarrod",10,7,3,3,0,0,0,0
Gold Coast,"King, Ben",9,5,1,4,1,0,0,1
Gold Coast,"Lukosius, Jack",11,10,4,1,0,1,0,0
Gold Coast,"Miller, Touk",23,10,1,13,0,1,0,4
Gold Coast,"Powell, Wil",17,3,2,14,0,0,0,1
Gold Coast,"Rankine, Izak",8,4,1,4,1,1,0,3
Gold Coast,"Sexton, Alex",12,10,7,2,3,0,0,0
Gold Coast,"Sharp, Jeremy",10,5,3,5,0,0,0,0
Gold Coast,"Swallow, David",27,15,4,12,0,1,0,0
Gold Coast,"Weller, Lachie",16,8,3,8,0,0,0,4
Gold Coast,"Witts, Jarrod",2,2,1,0,0,0,28,4
Geelong,"Ablett, Gary",24,16,4,8,1,2,0,1
Geelong,"Atkins, Tom",7,4,2,3,0,0,0,0
Geelong,"Blicavs, Mark",9,5,2,4,0,0,0,2
Geelong,"Clark, Jordan",13,10,4,3,0,1,0,1
Geelong,"Dahlhaus, Luke",16,6,6,10,1,0,0,1
Geelong,"Dangerfield, Patrick",16,8,1,8,1,0,0,1
Geelong,"Duncan, Mitch",21,16,6,5,3,0,0,0
Geelong,"Fort, Darcy",8,8,2,0,0,0,24,0
Geelong,"Guthrie, Cameron",11,6,5,5,0,0,0,3
Geelong,"Guthrie, Zach",7,4,0,3,0,0,0,1
Geelong,"Hawkins, Tom",11,8,6,3,2,2,1,3
Geelong,"Henry, Jack",11,8,6,3,0,0,0,1
Geelong,"Menegola, Sam",12,4,5,8,0,0,0,2
Geelong,"Miers, Gryan",8,5,3,3,1,0,0,2
Geelong,"Narkle, Quinton",12,3,1,9,0,0,0,5
Geelong,"OConnor, Mark",12,11,4,1,1,0,0,1
Geelong,"Ratugolea, Esava",6,2,1,4,0,1,3,1
Geelong,"Rohan, Gary",8,8,5,0,1,1,0,0
Geelong,"Selwood, Joel",16,10,5,6,0,0,0,2
Geelong,"Stewart, Tom",18,12,6,6,0,0,0,0
Geelong,"Taylor, Harry",12,8,5,4,0,0,0,1
Geelong,"Tuohy, Zach",16,14,4,2,0,0,0,1
Geelong,"Ablett, Gary",21,9,2,12,2,1,0,3
Geelong,"Atkins, Tom",13,5,1,8,2,0,0,0
Geelong,"Bews, Jed",6,6,4,0,0,0,0,1
Geelong,"Blicavs, Mark",12,7,5,5,0,0,0,1
Geelong,"Dahlhaus, Luke",15,5,0,10,2,0,0,3
Geelong,"Dangerfield, Patrick",24,14,3,10,1,2,0,3
Geelong,"Duncan, Mitch",20,11,5,9,1,0,0,1
Geelong,"Guthrie, Cameron",15,7,2,8,0,0,0,4
Geelong,"Hawkins, Tom",11,6,2,5,0,0,0,2
Geelong,"Henry, Jack",7,5,3,2,0,0,0,1
Geelong,"Menegola, Sam",23,11,5,12,2,0,0,0
Geelong,"Miers, Gryan",20,15,9,5,3,0,0,1
Geelong,"Narkle, Quinton",15,11,4,4,0,0,0,6
Geelong,"OConnor, Mark",12,7,3,5,0,0,0,2
Geelong,"Parfitt, Brandan",19,12,1,7,0,0,0,10
Geelong,"Ratugolea, Esava",8,3,0,5,0,1,8,2
Geelong,"Rohan, Gary",5,2,3,3,1,0,0,1
Geelong,"Selwood, Joel",28,12,4,16,1,0,0,3
Geelong,"Stanley, Rhys",14,10,3,4,2,0,26,0
Geelong,"Stewart, Tom",20,16,9,4,0,0,0,0
Geelong,"Taylor, Harry",15,12,7,3,0,0,0,1
Geelong,"Tuohy, Zach",17,15,3,2,0,0,0,1
Geelong,"Ablett, Gary",14,8,2,6,0,1,0,4
Geelong,"Atkins, Tom",5,2,0,3,1,0,0,5
Geelong,"Bews, Jed",11,8,0,3,1,0,0,1
Geelong,"Blicavs, Mark",9,5,3,4,0,0,0,1
Geelong,"Dahlhaus, Luke",2,0,1,2,0,0,0,0
Geelong,"Dangerfield, Patrick",21,12,2,9,0,1,0,4
Geelong,"Duncan, Mitch",24,13,5,11,0,2,0,3
Geelong,"Guthrie, Cameron",19,5,1,14,1,0,0,3
Geelong,"Hawkins, Tom",11,6,4,5,2,1,0,2
Geelong,"Henry, Jack",7,7,6,0,0,0,0,2
Geelong,"Menegola, Sam",9,4,2,5,0,0,0,1
Geelong,"Miers, Gryan",16,12,2,4,1,0,0,3
Geelong,"Narkle, Quinton",18,7,2,11,0,0,0,4
Geelong,"OConnor, Mark",8,4,3,4,0,0,0,0
Geelong,"Ratugolea, Esava",12,5,0,7,0,0,5,6
Geelong,"Rohan, Gary",10,8,4,2,2,1,0,5
Geelong,"Selwood, Joel",18,11,0,7,1,2,0,4
Geelong,"Stanley, Rhys",10,5,1,5,1,0,17,0
Geelong,"Steven, Jack",6,4,1,2,0,0,0,1
Geelong,"Stewart, Tom",16,14,7,2,0,0,0,5
Geelong,"Taylor, Harry",11,7,3,4,1,0,0,0
Geelong,"Tuohy, Zach",19,15,3,4,0,0,0,1
Geelong,"Ablett, Gary",11,3,1,8,0,0,0,4
Geelong,"Atkins, Tom",1,1,0,0,0,0,0,1
Geelong,"Bews, Jed",15,14,6,1,0,0,0,1
Geelong,"Blicavs, Mark",15,10,5,5,0,0,0,2
Geelong,"Dahlhaus, Luke",14,7,3,7,0,0,0,5
Geelong,"Dangerfield, Patrick",22,14,6,8,1,0,0,3
Geelong,"Duncan, Mitch",19,14,9,5,1,0,0,4
Geelong,"Fort, Darcy",7,3,2,4,1,0,19,1
Geelong,"Guthrie, Cameron",24,19,10,5,1,0,0,2
Geelong,"Hawkins, Tom",13,10,7,3,1,3,2,0
Geelong,"Henry, Jack",8,8,3,0,0,0,0,5
Geelong,"Kolodjashnij, Jake",14,10,6,4,0,0,0,2
Geelong,"Menegola, Sam",25,13,10,12,0,0,0,4
Geelong,"Miers, Gryan",21,11,9,10,0,0,0,0
Geelong,"OConnor, Mark",20,17,14,3,0,0,0,2
Geelong,"Parfitt, Brandan",14,10,3,4,1,0,0,9
Geelong,"Ratugolea, Esava",5,4,4,1,1,1,7,2
Geelong,"Rohan, Gary",6,3,0,3,0,0,0,2
Geelong,"Selwood, Joel",23,13,4,10,0,0,0,2
Geelong,"Steven, Jack",17,8,5,9,0,0,0,1
Geelong,"Stewart, Tom",4,3,2,1,0,0,0,0
Geelong,"Tuohy, Zach",17,14,3,3,0,0,0,0
Geelong,"Ablett, Gary",14,6,2,8,1,0,0,2
Geelong,"Bews, Jed",6,5,1,1,0,0,0,1
Geelong,"Blicavs, Mark",13,6,5,7,0,0,0,3
Geelong,"Dahlhaus, Luke",18,6,5,12,1,0,0,3
Geelong,"Dangerfield, Patrick",20,12,1,8,1,0,0,2
Geelong,"Duncan, Mitch",25,15,5,10,0,1,0,4
Geelong,"Fort, Darcy",12,7,2,5,0,0,25,3
Geelong,"Guthrie, Cameron",12,5,2,7,0,0,0,6
Geelong,"Hawkins, Tom",17,12,8,5,3,2,3,1
Geelong,"Henry, Jack",8,6,3,2,0,0,0,0
Geelong,"Kolodjashnij, Jake",12,7,5,5,0,0,0,0
Geelong,"Menegola, Sam",23,13,6,10,1,1,0,2
Geelong,"Miers, Gryan",12,5,3,7,1,0,0,3
Geelong,"Narkle, Quinton",11,6,2,5,0,1,0,2
Geelong,"OConnor, Mark",12,8,3,4,0,0,0,1
Geelong,"Parfitt, Brandan",11,6,2,5,2,0,0,11
Geelong,"Ratugolea, Esava",11,7,5,4,1,0,4,1
Geelong,"Rohan, Gary",13,10,7,3,1,3,0,5
Geelong,"Selwood, Joel",22,9,2,13,0,0,0,8
Geelong,"Steven, Jack",17,9,3,8,1,0,0,3
Geelong,"Taylor, Harry",12,7,4,5,0,0,0,1
Geelong,"Tuohy, Zach",20,17,5,3,0,2,0,0
Geelong,"Ablett, Gary",14,11,3,3,2,0,0,3
Geelong,"Bews, Jed",11,8,3,3,0,0,0,4
Geelong,"Blicavs, Mark",11,8,4,3,0,0,0,3
Geelong,"Dahlhaus, Luke",12,7,3,5,0,0,0,6
Geelong,"Dangerfield, Patrick",26,18,7,8,0,2,0,3
Geelong,"Duncan, Mitch",3,2,1,1,0,0,0,0
Geelong,"Fort, Darcy",12,8,0,4,0,0,16,2
Geelong,"Guthrie, Cameron",22,10,5,12,0,0,0,5
Geelong,"Hawkins, Tom",15,10,6,5,3,1,3,5
Geelong,"Henry, Jack",10,6,3,4,0,0,0,3
Geelong,"Kolodjashnij, Jake",11,7,3,4,0,0,0,2
Geelong,"Menegola, Sam",26,16,5,10,2,0,0,0
Geelong,"Miers, Gryan",16,7,3,9,0,0,0,0
Geelong,"Narkle, Quinton",1,0,0,1,0,0,0,1
Geelong,"OConnor, Mark",12,9,4,3,0,0,0,2
Geelong,"Parfitt, Brandan",19,8,2,11,1,0,0,3
Geelong,"Ratugolea, Esava",8,6,4,2,1,0,3,4
Geelong,"Rohan, Gary",11,6,4,5,2,1,0,0
Geelong,"Selwood, Joel",20,13,2,7,0,0,0,8
Geelong,"Simpson, Sam",27,12,6,15,0,0,0,5
Geelong,"Taylor, Harry",10,6,2,4,0,0,0,3
Geelong,"Tuohy, Zach",19,15,5,4,0,1,0,3
Geelong,"Ablett, Gary",19,10,1,9,0,0,0,0
Geelong,"Bews, Jed",8,4,0,4,0,0,0,2
Geelong,"Blicavs, Mark",9,9,3,0,0,0,0,1
Geelong,"Clark, Jordan",12,7,4,5,1,0,0,2
Geelong,"Dahlhaus, Luke",14,5,2,9,0,0,0,1
Geelong,"Dangerfield, Patrick",32,23,3,9,0,1,0,4
Geelong,"Fort, Darcy",8,5,3,3,0,0,23,3
Geelong,"Guthrie, Cameron",28,16,7,12,1,0,0,2
Geelong,"Hawkins, Tom",11,8,3,3,0,1,2,2
Geelong,"Henry, Jack",9,7,3,2,0,0,0,2
Geelong,"Kolodjashnij, Jake",10,6,5,4,0,0,0,0
Geelong,"Menegola, Sam",19,9,3,10,0,0,0,1
Geelong,"Miers, Gryan",14,8,3,6,0,0,0,2
Geelong,"OConnor, Mark",11,7,5,4,0,0,0,4
Geelong,"Parfitt, Brandan",12,7,1,5,0,1,0,7
Geelong,"Ratugolea, Esava",7,3,2,4,0,0,7,1
Geelong,"Rohan, Gary",7,5,2,2,1,0,0,1
Geelong,"Selwood, Joel",1,0,0,1,0,0,0,1
Geelong,"Simpson, Sam",12,9,3,3,1,0,0,3
Geelong,"Steven, Jack",16,11,3,5,0,0,0,6
Geelong,"Taylor, Harry",7,5,3,2,0,0,0,4
Geelong,"Tuohy, Zach",17,15,1,2,1,0,0,0
Geelong,"Bews, Jed",11,5,1,6,0,0,0,2
Geelong,"Blicavs, Mark",19,6,2,13,0,0,24,2
Geelong,"Close, Brad",14,7,3,7,1,1,0,4
Geelong,"Constable, Charlie",19,8,0,11,0,1,0,5
Geelong,"Dangerfield, Patrick",18,9,2,9,0,1,0,3
Geelong,"Duncan, Mitch",26,13,3,13,1,0,0,7
Geelong,"Fogarty, Lachie",13,9,1,4,0,0,0,6
Geelong,"Guthrie, Cameron",30,15,3,15,0,1,0,6
Geelong,"Hawkins, Tom",12,8,5,4,3,1,3,1
Geelong,"Henderson, Lachie",12,7,4,5,0,0,0,0
Geelong,"Henry, Jack",8,5,1,3,0,0,0,0
Geelong,"Kolodjashnij, Jake",6,5,4,1,0,1,0,2
Geelong,"Menegola, Sam",26,17,3,9,1,1,0,3
Geelong,"Miers, Gryan",12,6,2,6,0,0,0,3
Geelong,"OConnor, Mark",12,8,0,4,0,0,0,1
Geelong,"Parfitt, Brandan",17,8,0,9,0,0,0,7
Geelong,"Ratugolea, Esava",8,4,1,4,0,0,8,3
Geelong,"Rohan, Gary",10,6,2,4,0,0,0,4
Geelong,"Simpson, Sam",12,6,1,6,0,0,0,5
Geelong,"Stewart, Tom",13,11,3,2,0,0,0,2
Geelong,"Taylor, Harry",18,10,4,8,0,0,0,4
Geelong,"Tuohy, Zach",26,18,5,8,0,1,0,3
Geelong,"Bews, Jed",8,5,0,3,0,0,0,1
Geelong,"Blicavs, Mark",10,6,3,4,0,0,17,5
Geelong,"Close, Brad",11,3,2,8,0,0,0,2
Geelong,"Constable, Charlie",16,5,4,11,0,0,0,3
Geelong,"Dangerfield, Patrick",18,14,3,4,1,1,0,4
Geelong,"Duncan, Mitch",21,14,11,7,1,0,0,3
Geelong,"Fogarty, Lachie",5,3,3,2,0,0,0,2
Geelong,"Guthrie, Cameron",23,14,6,9,0,0,0,3
Geelong,"Hawkins, Tom",8,4,2,4,2,0,0,1
Geelong,"Henderson, Lachie",13,10,4,3,0,0,0,2
Geelong,"Henry, Jack",7,6,5,1,0,0,0,3
Geelong,"Kolodjashnij, Jake",7,5,5,2,0,0,0,3
Geelong,"Menegola, Sam",19,11,6,8,1,0,0,2
Geelong,"Miers, Gryan",12,10,6,2,1,0,0,0
Geelong,"OConnor, Mark",10,8,5,2,0,0,0,0
Geelong,"Parfitt, Brandan",15,8,0,7,1,0,0,1
Geelong,"Ratugolea, Esava",11,8,4,3,0,1,9,4
Geelong,"Rohan, Gary",3,3,2,0,0,1,0,1
Geelong,"Simpson, Sam",11,6,2,5,1,1,0,2
Geelong,"Stewart, Tom",22,17,10,5,0,0,0,2
Geelong,"Taylor, Harry",12,8,7,4,0,0,0,1
Geelong,"Tuohy, Zach",18,14,5,4,2,0,0,1
Geelong,"Atkins, Tom",7,4,2,3,0,1,0,3
Geelong,"Bews, Jed",9,6,2,3,0,0,0,0
Geelong,"Blicavs, Mark",19,6,1,13,0,0,7,3
Geelong,"Close, Brad",6,3,1,3,0,0,0,2
Geelong,"Dangerfield, Patrick",17,9,5,8,0,2,0,0
Geelong,"Duncan, Mitch",20,14,6,6,1,1,0,4
Geelong,"Fogarty, Lachie",23,14,3,9,0,1,0,4
Geelong,"Guthrie, Cameron",29,17,3,12,0,0,0,3
Geelong,"Guthrie, Zach",11,8,3,3,2,0,0,1
Geelong,"Hawkins, Tom",14,9,7,5,3,2,1,0
Geelong,"Henderson, Lachie",8,6,4,2,0,0,0,3
Geelong,"Henry, Jack",10,6,1,4,0,0,0,1
Geelong,"Menegola, Sam",28,16,4,12,1,0,0,1
Geelong,"Miers, Gryan",11,8,3,3,4,0,0,2
Geelong,"OConnor, Mark",10,5,2,5,0,0,0,0
Geelong,"Selwood, Joel",14,6,0,8,0,1,0,4
Geelong,"Simpson, Sam",12,6,2,6,1,0,0,3
Geelong,"Stanley, Rhys",13,4,2,9,1,0,20,0
Geelong,"Steven, Jack",21,15,6,6,0,0,0,4
Geelong,"Stewart, Tom",17,11,5,6,0,0,0,1
Geelong,"Taylor, Harry",8,3,1,5,0,0,0,0
Geelong,"Tuohy, Zach",16,11,6,5,0,2,0,0
Geelong,"Atkins, Tom",9,2,0,7,0,0,0,2
Geelong,"Bews, Jed",14,8,8,6,0,0,0,3
Geelong,"Blicavs, Mark",12,4,3,8,0,0,12,3
Geelong,"Close, Brad",10,4,1,6,0,0,0,6
Geelong,"Dangerfield, Patrick",19,15,6,4,1,2,0,2
Geelong,"Duncan, Mitch",22,13,4,9,1,0,0,4
Geelong,"Guthrie, Cameron",14,4,2,10,0,0,0,2
Geelong,"Hawkins, Tom",11,9,5,2,5,0,1,2
Geelong,"Henderson, Lachie",13,12,10,1,0,0,0,3
Geelong,"Henry, Jack",9,4,1,5,0,0,0,2
Geelong,"Kolodjashnij, Jake",12,10,5,2,0,0,0,3
Geelong,"Menegola, Sam",26,15,11,11,2,0,0,2
Geelong,"Miers, Gryan",12,8,7,4,0,0,0,0
Geelong,"OConnor, Mark",16,12,9,4,0,0,0,3
Geelong,"Parfitt, Brandan",13,7,2,6,0,0,0,9
Geelong,"Rohan, Gary",16,14,5,2,4,3,0,0
Geelong,"Selwood, Joel",15,7,1,8,0,0,0,3
Geelong,"Stanley, Rhys",15,4,3,11,0,2,17,3
Geelong,"Steven, Jack",19,10,5,9,0,1,0,4
Geelong,"Stewart, Tom",22,19,4,3,0,0,0,1
Geelong,"Taylor, Harry",6,6,3,0,0,0,0,2
Geelong,"Tuohy, Zach",18,10,5,8,1,0,0,1
Geelong,"Atkins, Tom",10,7,2,3,1,0,0,1
Geelong,"Bews, Jed",14,9,4,5,0,0,0,2
Geelong,"Blicavs, Mark",21,11,7,10,0,0,6,3
Geelong,"Dangerfield, Patrick",24,14,5,10,0,0,0,4
Geelong,"Duncan, Mitch",20,13,5,7,0,1,0,6
Geelong,"Fogarty, Lachie",12,9,3,3,1,0,0,4
Geelong,"Guthrie, Cameron",27,9,4,18,1,0,0,5
Geelong,"Hawkins, Tom",17,12,10,5,6,2,0,3
Geelong,"Henderson, Lachie",13,10,8,3,1,0,0,0
Geelong,"Henry, Jack",11,11,7,0,0,0,0,4
Geelong,"Kolodjashnij, Jake",7,6,3,1,0,0,0,1
Geelong,"Menegola, Sam",21,13,6,8,1,0,0,0
Geelong,"Miers, Gryan",19,13,6,6,0,1,0,0
Geelong,"OConnor, Mark",11,7,3,4,0,0,0,2
Geelong,"Parfitt, Brandan",16,5,0,11,0,1,0,5
Geelong,"Rohan, Gary",12,11,7,1,3,0,0,3
Geelong,"Selwood, Joel",14,8,3,6,0,0,0,2
Geelong,"Simpson, Sam",9,5,3,4,0,1,0,1
Geelong,"Stanley, Rhys",12,7,3,5,0,0,13,1
Geelong,"Stewart, Tom",20,16,9,4,0,0,0,1
Geelong,"Taylor, Harry",8,3,4,5,0,0,1,1
Geelong,"Tuohy, Zach",13,11,6,2,0,0,0,0
Geelong,"Atkins, Tom",10,2,0,8,0,0,0,8
Geelong,"Bews, Jed",14,9,2,5,0,0,0,2
Geelong,"Blicavs, Mark",14,7,4,7,1,0,7,2
Geelong,"Clark, Jordan",13,7,4,6,0,0,0,6
Geelong,"Close, Brad",8,4,2,4,0,0,0,3
Geelong,"Dahlhaus, Luke",14,8,2,6,0,0,0,3
Geelong,"Dangerfield, Patrick",27,16,3,11,0,0,0,4
Geelong,"Duncan, Mitch",22,15,6,7,2,1,0,6
Geelong,"Guthrie, Cameron",33,13,8,20,0,0,0,5
Geelong,"Hawkins, Tom",13,7,4,6,3,3,0,3
Geelong,"Henderson, Lachie",15,10,5,5,0,0,0,1
Geelong,"Henry, Jack",8,8,5,0,0,0,0,1
Geelong,"Kolodjashnij, Jake",13,7,4,6,0,0,0,2
Geelong,"Menegola, Sam",24,11,6,13,0,1,0,3
Geelong,"Miers, Gryan",15,9,3,6,0,0,0,1
Geelong,"OConnor, Mark",10,9,6,1,0,0,0,2
Geelong,"Parfitt, Brandan",23,10,4,13,0,1,0,4
Geelong,"Ratugolea, Esava",9,3,2,6,0,1,4,3
Geelong,"Rohan, Gary",5,2,0,3,1,1,0,0
Geelong,"Stanley, Rhys",7,3,2,4,2,0,25,5
Geelong,"Steven, Jack",24,10,2,14,0,1,0,11
Geelong,"Stewart, Tom",20,15,7,5,0,0,0,2
Geelong,"Atkins, Tom",13,7,0,6,0,0,0,5
Geelong,"Bews, Jed",13,6,4,7,0,0,0,2
Geelong,"Blicavs, Mark",11,3,3,8,0,0,26,2
Geelong,"Close, Brad",8,4,1,4,0,1,0,2
Geelong,"Dahlhaus, Luke",14,3,2,11,1,0,0,2
Geelong,"Dangerfield, Patrick",32,18,5,14,0,0,0,2
Geelong,"Duncan, Mitch",18,10,6,8,1,1,0,3
Geelong,"Guthrie, Cameron",21,12,3,9,0,0,0,5
Geelong,"Hawkins, Tom",14,10,6,4,2,2,4,0
Geelong,"Henderson, Lachie",13,10,8,3,0,0,0,2
Geelong,"Henry, Jack",15,10,6,5,0,0,0,2
Geelong,"Kolodjashnij, Jake",10,8,3,2,0,0,0,1
Geelong,"Menegola, Sam",18,9,4,9,0,0,0,2
Geelong,"Miers, Gryan",11,9,2,2,2,1,0,3
Geelong,"OConnor, Mark",10,7,2,3,1,0,0,1
Geelong,"Parfitt, Brandan",19,8,2,11,0,0,0,4
Geelong,"Rohan, Gary",10,7,1,3,2,1,0,4
Geelong,"Stanley, Rhys",16,7,4,9,1,0,19,0
Geelong,"Steven, Jack",15,8,3,7,0,0,0,2
Geelong,"Stewart, Tom",22,16,9,6,0,0,0,3
Geelong,"Taylor, Harry",10,4,1,6,0,0,0,0
Geelong,"Tuohy, Zach",10,7,2,3,0,0,0,2
Geelong,"Atkins, Tom",14,2,1,12,0,0,0,3
Geelong,"Bews, Jed",12,10,8,2,2,1,0,1
Geelong,"Blicavs, Mark",7,4,1,3,2,0,15,5
Geelong,"Close, Brad",10,2,2,8,0,0,0,3
Geelong,"Dahlhaus, Luke",16,5,3,11,1,0,0,3
Geelong,"Dangerfield, Patrick",17,11,6,6,2,1,0,2
Geelong,"Duncan, Mitch",19,13,7,6,0,0,0,4
Geelong,"Fogarty, Lachie",14,8,2,6,0,0,0,2
Geelong,"Guthrie, Cameron",24,9,4,15,0,0,0,3
Geelong,"Guthrie, Zach",14,10,4,4,0,0,0,0
Geelong,"Hawkins, Tom",17,12,8,5,4,1,1,1
Geelong,"Henderson, Lachie",15,13,10,2,0,0,0,1
Geelong,"Henry, Jack",12,10,6,2,0,0,0,0
Geelong,"Jenkins, Josh",14,8,3,6,0,0,7,4
Geelong,"Kolodjashnij, Jake",8,7,5,1,0,0,0,1
Geelong,"Menegola, Sam",30,17,6,13,2,0,0,2
Geelong,"Miers, Gryan",15,12,6,3,3,0,0,2
Geelong,"OConnor, Mark",7,4,2,3,0,0,0,1
Geelong,"Parfitt, Brandan",17,6,3,11,0,0,0,7
Geelong,"Rohan, Gary",6,5,2,1,1,1,0,0
Geelong,"Stewart, Tom",24,18,10,6,0,1,0,2
Geelong,"Taylor, Harry",11,8,3,3,0,0,0,4
Geelong,"Atkins, Tom",16,5,3,11,0,0,0,8
Geelong,"Bews, Jed",8,5,5,3,0,1,0,1
Geelong,"Blicavs, Mark",18,9,7,9,0,0,12,5
Geelong,"Close, Brad",3,2,1,1,1,0,0,2
Geelong,"Dahlhaus, Luke",14,8,5,6,0,0,0,1
Geelong,"Dangerfield, Patrick",19,14,3,5,0,1,0,2
Geelong,"Duncan, Mitch",15,13,6,2,0,0,0,2
Geelong,"Fogarty, Lachie",14,9,5,5,0,0,0,1
Geelong,"Guthrie, Cameron",23,16,9,7,0,0,0,6
Geelong,"Hawkins, Tom",6,5,4,1,1,2,3,1
Geelong,"Henderson, Lachie",12,8,4,4,0,0,0,0
Geelong,"Henry, Jack",11,8,3,3,0,0,0,1
Geelong,"Jarvis, Ben",5,3,3,2,0,1,0,1
Geelong,"Kolodjashnij, Jake",11,10,7,1,0,0,0,1
Geelong,"Menegola, Sam",18,12,5,6,0,0,0,1
Geelong,"Miers, Gryan",11,8,7,3,0,0,0,3
Geelong,"OConnor, Mark",18,10,9,8,0,0,0,2
Geelong,"Parfitt, Brandan",16,10,1,6,0,0,0,1
Geelong,"Ratugolea, Esava",15,11,7,4,2,0,5,2
Geelong,"Stewart, Tom",25,20,8,5,0,0,0,0
Geelong,"Taylor, Harry",12,9,5,3,0,0,0,0
Geelong,"Tuohy, Zach",15,12,4,3,0,0,0,2
Geelong,"Ablett, Gary",16,11,2,5,1,1,0,1
Geelong,"Bews, Jed",16,9,5,7,0,0,0,2
Geelong,"Blicavs, Mark",8,4,1,4,0,0,12,1
Geelong,"Dahlhaus, Luke",11,3,2,8,0,0,0,3
Geelong,"Dangerfield, Patrick",14,11,5,3,3,2,0,4
Geelong,"Duncan, Mitch",16,8,7,8,0,0,0,2
Geelong,"Guthrie, Cameron",19,11,5,8,1,0,0,5
Geelong,"Hawkins, Tom",6,6,3,0,2,2,3,0
Geelong,"Henderson, Lachie",10,7,4,3,0,0,0,0
Geelong,"Henry, Jack",8,7,1,1,0,0,0,1
Geelong,"Kolodjashnij, Jake",14,12,9,2,0,1,0,4
Geelong,"Menegola, Sam",25,20,10,5,0,0,0,1
Geelong,"Miers, Gryan",14,8,6,6,0,1,0,2
Geelong,"OConnor, Mark",7,5,3,2,0,0,0,1
Geelong,"Parfitt, Brandan",14,10,1,4,2,0,0,3
Geelong,"Ratugolea, Esava",4,4,2,0,0,0,10,1
Geelong,"Rohan, Gary",8,6,1,2,0,2,0,2
Geelong,"Selwood, Joel",16,8,3,8,0,0,0,5
Geelong,"Steven, Jack",13,9,5,4,0,0,0,3
Geelong,"Stewart, Tom",22,17,7,5,0,0,0,0
Geelong,"Taylor, Harry",6,2,1,4,0,0,0,1
Geelong,"Tuohy, Zach",17,11,5,6,1,0,0,0
Geelong,"Ablett, Gary",10,7,0,3,0,0,0,3
Geelong,"Atkins, Tom",12,2,0,10,0,0,0,2
Geelong,"Bews, Jed",13,8,4,5,0,0,0,0
Geelong,"Blicavs, Mark",9,3,2,6,0,0,16,5
Geelong,"Dahlhaus, Luke",16,9,4,7,0,0,0,0
Geelong,"Dangerfield, Patrick",22,14,2,8,1,0,0,2
Geelong,"Duncan, Mitch",19,15,7,4,0,0,0,6
Geelong,"Guthrie, Cameron",16,5,3,11,0,0,0,9
Geelong,"Hawkins, Tom",13,8,7,5,0,5,3,4
Geelong,"Henderson, Lachie",18,13,8,5,0,0,0,1
Geelong,"Henry, Jack",10,9,4,1,0,0,0,3
Geelong,"Kolodjashnij, Jake",12,6,4,6,0,1,0,0
Geelong,"Menegola, Sam",18,9,2,9,0,0,0,3
Geelong,"Miers, Gryan",7,5,2,2,0,0,0,0
Geelong,"OConnor, Mark",9,4,2,5,0,0,0,1
Geelong,"Parfitt, Brandan",16,9,3,7,0,1,0,3
Geelong,"Rohan, Gary",5,4,3,1,0,0,0,3
Geelong,"Selwood, Joel",16,8,2,8,1,1,0,3
Geelong,"Stanley, Rhys",10,8,3,2,2,1,17,1
Geelong,"Stewart, Tom",14,13,6,1,0,0,0,0
Geelong,"Taylor, Harry",7,3,1,4,0,0,0,1
Geelong,"Tuohy, Zach",16,11,4,5,1,1,0,1
Geelong,"Ablett, Gary",10,4,2,6,0,1,0,1
Geelong,"Bews, Jed",12,10,4,2,0,0,0,3
Geelong,"Blicavs, Mark",14,9,7,5,0,0,6,1
Geelong,"Dahlhaus, Luke",17,9,3,8,1,0,0,3
Geelong,"Dangerfield, Patrick",19,13,6,6,4,0,0,1
Geelong,"Duncan, Mitch",30,18,12,12,0,1,0,2
Geelong,"Guthrie, Cameron",26,12,7,14,1,0,0,3
Geelong,"Hawkins, Tom",17,12,9,5,4,1,0,2
Geelong,"Henderson, Lachie",19,15,14,4,0,0,0,0
Geelong,"Henry, Jack",12,9,7,3,0,0,0,2
Geelong,"Kolodjashnij, Jake",13,8,4,5,0,0,0,0
Geelong,"Menegola, Sam",23,15,7,8,1,0,0,2
Geelong,"Miers, Gryan",11,10,3,1,1,1,0,1
Geelong,"OConnor, Mark",9,6,3,3,0,0,0,4
Geelong,"Parfitt, Brandan",17,8,2,9,0,2,0,9
Geelong,"Rohan, Gary",13,11,8,2,0,1,0,2
Geelong,"Selwood, Joel",18,9,5,9,1,0,0,4
Geelong,"Simpson, Sam",16,7,4,9,0,0,0,4
Geelong,"Stanley, Rhys",14,8,5,6,1,0,13,2
Geelong,"Stewart, Tom",26,18,14,8,0,0,0,1
Geelong,"Taylor, Harry",8,6,4,2,0,0,0,1
Geelong,"Tuohy, Zach",12,10,4,2,1,0,0,0
Geelong,"Ablett, Gary",14,8,4,6,2,2,0,4
Geelong,"Bews, Jed",8,6,4,2,0,0,0,4
Geelong,"Blicavs, Mark",10,6,2,4,0,1,11,5
Geelong,"Dahlhaus, Luke",9,1,2,8,0,0,0,0
Geelong,"Dangerfield, Patrick",17,14,3,3,0,0,0,2
Geelong,"Duncan, Mitch",22,13,5,9,0,0,0,3
Geelong,"Guthrie, Cameron",17,8,2,9,0,0,0,3
Geelong,"Hawkins, Tom",12,7,5,5,2,3,11,4
Geelong,"Henderson, Lachie",15,11,6,4,0,0,0,3
Geelong,"Henry, Jack",10,9,5,1,1,0,0,0
Geelong,"Kolodjashnij, Jake",9,5,1,4,0,0,0,1
Geelong,"Menegola, Sam",19,16,7,3,0,2,0,0
Geelong,"Miers, Gryan",14,9,3,5,1,1,0,3
Geelong,"OConnor, Mark",13,7,5,6,0,0,0,0
Geelong,"Parfitt, Brandan",14,11,3,3,1,0,0,7
Geelong,"Rohan, Gary",11,9,4,2,3,1,0,1
Geelong,"Selwood, Joel",16,10,3,6,0,0,0,9
Geelong,"Simpson, Sam",14,6,2,8,0,0,0,4
Geelong,"Stanley, Rhys",15,6,3,9,0,1,16,1
Geelong,"Stewart, Tom",19,11,3,8,0,0,0,0
Geelong,"Taylor, Harry",6,5,3,1,0,0,0,1
Geelong,"Tuohy, Zach",16,8,2,8,1,0,0,0
Geelong,"Ablett, Gary",12,4,1,8,0,0,0,1
Geelong,"Bews, Jed",9,5,0,4,0,0,0,2
Geelong,"Blicavs, Mark",13,4,0,9,0,0,10,4
Geelong,"Dahlhaus, Luke",14,7,1,7,0,0,0,3
Geelong,"Dangerfield, Patrick",12,7,1,5,1,1,0,3
Geelong,"Duncan, Mitch",25,19,7,6,1,0,0,4
Geelong,"Guthrie, Cameron",14,12,4,2,1,1,0,3
Geelong,"Hawkins, Tom",10,3,3,7,1,2,4,3
Geelong,"Henderson, Lachie",7,5,1,2,0,0,0,1
Geelong,"Henry, Jack",14,8,3,6,0,0,0,1
Geelong,"Kolodjashnij, Jake",8,6,4,2,0,0,0,2
Geelong,"Menegola, Sam",13,10,5,3,2,0,0,0
Geelong,"Miers, Gryan",14,10,5,4,1,1,0,2
Geelong,"OConnor, Mark",9,3,0,6,0,0,0,1
Geelong,"Parfitt, Brandan",7,5,1,2,0,0,0,7
Geelong,"Rohan, Gary",5,3,1,2,0,0,0,2
Geelong,"Selwood, Joel",21,14,3,7,0,0,0,5
Geelong,"Simpson, Sam",12,3,0,9,0,0,0,1
Geelong,"Stanley, Rhys",14,10,3,4,0,1,29,1
Geelong,"Stewart, Tom",20,16,6,4,0,0,0,3
Geelong,"Taylor, Harry",7,1,0,6,0,0,0,1
Geelong,"Tuohy, Zach",14,6,2,8,0,1,0,1
Greater Western Sydney,"Cameron, Jeremy",7,5,5,2,3,0,0,1
Greater Western Sydney,"Coniglio, Stephen",19,12,2,7,2,0,0,1
Greater Western Sydney,"Corr, Aidan",9,6,3,3,0,0,0,1
Greater Western Sydney,"Cumming, Isaac",8,5,1,3,0,0,0,3
Greater Western Sydney,"Daniels, Brent",9,5,1,4,0,0,0,2
Greater Western Sydney,"Davis, Phil",6,5,3,1,0,0,0,0
Greater Western Sydney,"Finlayson, Jeremy",7,7,1,0,1,0,4,2
Greater Western Sydney,"Green, Tom",6,3,1,3,0,0,0,2
Greater Western Sydney,"Greene, Toby",16,12,6,4,4,1,0,0
Greater Western Sydney,"Haynes, Nick",20,17,9,3,0,0,0,0
Greater Western Sydney,"Himmelberg, Harry",7,4,2,3,0,0,0,0
Greater Western Sydney,"Hopper, Jacob",22,10,7,12,0,0,0,3
Greater Western Sydney,"Jacobs, Sam",10,7,1,3,0,0,28,5
Greater Western Sydney,"Kelly, Josh",18,10,2,8,0,1,0,6
Greater Western Sydney,"Kennedy, Adam",1,1,0,0,0,0,0,0
Greater Western Sydney,"Langdon, Zac",10,6,2,4,1,0,0,2
Greater Western Sydney,"Lloyd, Daniel",13,12,5,1,2,0,0,2
Greater Western Sydney,"Perryman, Harry",20,10,2,10,4,0,0,2
Greater Western Sydney,"Shaw, Heath",11,10,7,1,0,0,0,3
Greater Western Sydney,"Taylor, Sam",4,0,1,4,0,0,0,1
Greater Western Sydney,"Whitfield, Lachie",21,12,2,9,0,0,0,2
Greater Western Sydney,"de Boer, Matt",14,8,1,6,0,0,0,5
Greater Western Sydney,"Caldwell, Jye",15,9,3,6,0,1,0,2
Greater Western Sydney,"Cameron, Jeremy",7,4,3,3,1,1,0,3
Greater Western Sydney,"Coniglio, Stephen",19,10,1,9,0,1,0,10
Greater Western Sydney,"Corr, Aidan",10,7,3,3,0,0,0,0
Greater Western Sydney,"Cumming, Isaac",11,5,2,6,0,0,0,2
Greater Western Sydney,"Daniels, Brent",11,2,0,9,0,0,0,2
Greater Western Sydney,"Davis, Phil",3,2,3,1,0,0,0,3
Greater Western Sydney,"Finlayson, Jeremy",7,6,2,1,2,1,3,4
Greater Western Sydney,"Greene, Toby",13,4,2,9,0,2,0,1
Greater Western Sydney,"Haynes, Nick",15,13,5,2,0,0,0,2
Greater Western Sydney,"Himmelberg, Harry",12,8,3,4,2,0,1,1
Greater Western Sydney,"Hopper, Jacob",13,9,0,4,0,2,0,6
Greater Western Sydney,"Jacobs, Sam",5,3,2,2,0,0,31,2
Greater Western Sydney,"Kelly, Josh",17,9,0,8,0,1,0,5
Greater Western Sydney,"Lloyd, Daniel",5,3,1,2,0,0,0,2
Greater Western Sydney,"Perryman, Harry",11,4,1,7,2,0,0,1
Greater Western Sydney,"Shaw, Heath",6,2,1,4,0,0,0,1
Greater Western Sydney,"Taylor, Sam",7,3,2,4,0,0,0,4
Greater Western Sydney,"Ward, Callan",21,9,1,12,1,1,0,0
Greater Western Sydney,"Whitfield, Lachie",19,11,2,8,0,0,0,4
Greater Western Sydney,"Williams, Zac",15,11,3,4,0,0,0,3
Greater Western Sydney,"de Boer, Matt",17,8,3,9,0,0,0,6
Greater Western Sydney,"Ash, Lachie",7,5,3,2,0,0,0,0
Greater Western Sydney,"Caldwell, Jye",14,7,8,7,0,0,0,4
Greater Western Sydney,"Cameron, Jeremy",8,6,4,2,1,0,0,1
Greater Western Sydney,"Coniglio, Stephen",24,15,2,9,0,1,0,1
Greater Western Sydney,"Corr, Aidan",16,13,11,3,0,0,0,1
Greater Western Sydney,"Daniels, Brent",9,7,2,2,0,0,0,2
Greater Western Sydney,"Davis, Phil",12,8,6,4,0,0,0,1
Greater Western Sydney,"Finlayson, Jeremy",6,5,2,1,1,1,2,1
Greater Western Sydney,"Hately, Jackson",21,12,7,9,0,0,0,2
Greater Western Sydney,"Haynes, Nick",17,14,11,3,0,0,0,0
Greater Western Sydney,"Himmelberg, Harry",7,3,2,4,0,1,0,0
Greater Western Sydney,"Hopper, Jacob",18,14,3,4,0,0,0,5
Greater Western Sydney,"Jacobs, Sam",6,4,1,2,0,0,24,0
Greater Western Sydney,"Langdon, Zac",4,2,1,2,0,1,0,4
Greater Western Sydney,"Lloyd, Daniel",7,4,2,3,0,0,0,5
Greater Western Sydney,"Perryman, Harry",23,17,8,6,2,0,0,2
Greater Western Sydney,"Shaw, Heath",17,12,9,5,0,0,0,0
Greater Western Sydney,"Taylor, Sam",13,5,5,8,0,1,0,4
Greater Western Sydney,"Ward, Callan",19,13,8,6,0,0,1,1
Greater Western Sydney,"Whitfield, Lachie",4,2,1,2,0,0,0,0
Greater Western Sydney,"Williams, Zac",9,9,6,0,0,0,0,2
Greater Western Sydney,"de Boer, Matt",9,3,1,6,0,0,0,3
Greater Western Sydney,"Ash, Lachie",4,2,1,2,0,0,0,2
Greater Western Sydney,"Cameron, Jeremy",11,9,3,2,2,1,0,3
Greater Western Sydney,"Coniglio, Stephen",11,8,2,3,0,1,0,1
Greater Western Sydney,"Corr, Aidan",17,12,6,5,0,0,0,3
Greater Western Sydney,"Daniels, Brent",13,5,4,8,0,0,0,3
Greater Western Sydney,"Davis, Phil",7,3,2,4,0,0,0,2
Greater Western Sydney,"Finlayson, Jeremy",10,8,2,2,1,1,3,3
Greater Western Sydney,"Green, Tom",18,5,2,13,1,0,0,0
Greater Western Sydney,"Greene, Toby",19,11,5,8,3,0,0,0
Greater Western Sydney,"Hately, Jackson",8,3,1,5,0,0,0,0
Greater Western Sydney,"Haynes, Nick",16,12,8,4,0,0,0,1
Greater Western Sydney,"Himmelberg, Harry",5,4,2,1,0,0,0,4
Greater Western Sydney,"Hopper, Jacob",14,5,1,9,0,0,0,6
Greater Western Sydney,"Kelly, Josh",21,11,3,10,1,0,0,6
Greater Western Sydney,"Mumford, Shane",9,2,3,7,0,0,17,4
Greater Western Sydney,"Perryman, Harry",14,7,2,7,1,0,0,0
Greater Western Sydney,"Shaw, Heath",16,13,5,3,0,0,1,1
Greater Western Sydney,"Taylor, Sam",8,2,3,6,0,0,0,1
Greater Western Sydney,"Ward, Callan",14,6,0,8,1,0,0,5
Greater Western Sydney,"Whitfield, Lachie",24,15,6,9,0,1,0,2
Greater Western Sydney,"Williams, Zac",21,14,0,7,0,0,0,2
Greater Western Sydney,"de Boer, Matt",11,6,3,5,0,0,0,2
Greater Western Sydney,"Ash, Lachie",15,8,4,7,0,0,0,2
Greater Western Sydney,"Cameron, Jeremy",10,7,7,3,2,1,0,2
Greater Western Sydney,"Coniglio, Stephen",24,16,4,8,0,1,0,3
Greater Western Sydney,"Corr, Aidan",10,10,6,0,0,0,0,1
Greater Western Sydney,"Daniels, Brent",6,3,2,3,0,0,0,1
Greater Western Sydney,"Davis, Phil",16,7,5,9,0,0,0,1
Greater Western Sydney,"Finlayson, Jeremy",11,10,5,1,4,0,2,1
Greater Western Sydney,"Green, Tom",14,5,2,9,0,0,0,5
Greater Western Sydney,"Greene, Toby",18,8,3,10,1,0,0,4
Greater Western Sydney,"Hately, Jackson",14,9,6,5,0,0,0,2
Greater Western Sydney,"Haynes, Nick",21,17,11,4,0,0,0,5
Greater Western Sydney,"Himmelberg, Harry",9,9,3,0,4,0,0,6
Greater Western Sydney,"Hopper, Jacob",15,6,2,9,0,0,0,3
Greater Western Sydney,"Keeffe, Lachlan",13,8,7,5,0,0,0,1
Greater Western Sydney,"Kelly, Josh",30,15,12,15,0,1,0,1
Greater Western Sydney,"Lloyd, Daniel",10,9,8,1,1,0,0,4
Greater Western Sydney,"Mumford, Shane",8,2,1,6,1,0,20,2
Greater Western Sydney,"Perryman, Harry",28,18,11,10,0,0,0,1
Greater Western Sydney,"Shaw, Heath",24,19,6,5,0,0,0,1
Greater Western Sydney,"Sheridan, Tom",6,4,3,2,0,0,0,1
Greater Western Sydney,"Whitfield, Lachie",28,15,10,13,0,0,0,0
Greater Western Sydney,"de Boer, Matt",13,2,2,11,0,0,0,4
Greater Western Sydney,"Ash, Lachie",13,6,0,7,1,0,0,2
Greater Western Sydney,"Cameron, Jeremy",15,9,7,6,2,1,0,1
Greater Western Sydney,"Coniglio, Stephen",22,11,3,11,0,1,0,4
Greater Western Sydney,"Corr, Aidan",14,11,4,3,0,0,0,1
Greater Western Sydney,"Daniels, Brent",12,5,2,7,0,0,0,1
Greater Western Sydney,"Davis, Phil",10,4,2,6,0,0,0,1
Greater Western Sydney,"Finlayson, Jeremy",9,7,5,2,1,1,4,2
Greater Western Sydney,"Green, Tom",8,4,2,4,0,1,0,2
Greater Western Sydney,"Greene, Toby",21,11,5,10,1,0,0,1
Greater Western Sydney,"Hately, Jackson",15,9,6,6,0,0,0,1
Greater Western Sydney,"Haynes, Nick",23,17,8,6,0,0,0,0
Greater Western Sydney,"Himmelberg, Harry",7,4,2,3,0,1,0,2
Greater Western Sydney,"Hopper, Jacob",22,5,1,17,0,0,0,6
Greater Western Sydney,"Keeffe, Lachlan",13,7,5,6,0,0,0,1
Greater Western Sydney,"Kelly, Josh",16,9,0,7,0,2,0,4
Greater Western Sydney,"Lloyd, Daniel",1,0,0,1,0,0,0,1
Greater Western Sydney,"Mumford, Shane",5,1,1,4,0,0,16,5
Greater Western Sydney,"Perryman, Harry",24,11,1,13,0,0,0,1
Greater Western Sydney,"Shaw, Heath",20,15,6,5,0,0,0,0
Greater Western Sydney,"Ward, Callan",17,8,0,9,0,0,0,3
Greater Western Sydney,"Whitfield, Lachie",25,13,8,12,1,0,0,4
Greater Western Sydney,"de Boer, Matt",15,5,5,10,0,0,0,2
Greater Western Sydney,"Ash, Lachie",14,9,3,5,0,0,0,1
Greater Western Sydney,"Caldwell, Jye",16,6,1,10,0,0,0,4
Greater Western Sydney,"Cameron, Jeremy",12,10,3,2,2,3,0,3
Greater Western Sydney,"Coniglio, Stephen",27,12,2,15,0,1,0,3
Greater Western Sydney,"Corr, Aidan",21,19,4,2,0,1,0,1
Greater Western Sydney,"Daniels, Brent",12,3,2,9,0,1,0,2
Greater Western Sydney,"Davis, Phil",7,3,3,4,0,0,0,0
Greater Western Sydney,"Finlayson, Jeremy",7,7,1,0,1,1,10,2
Greater Western Sydney,"Hately, Jackson",13,9,4,4,0,0,0,2
Greater Western Sydney,"Haynes, Nick",12,8,2,4,0,0,0,2
Greater Western Sydney,"Hill, Bobby",5,2,1,3,0,0,0,0
Greater Western Sydney,"Himmelberg, Harry",8,5,1,3,3,0,0,1
Greater Western Sydney,"Hopper, Jacob",19,9,3,10,0,0,0,4
Greater Western Sydney,"Keeffe, Lachlan",6,5,4,1,0,0,0,2
Greater Western Sydney,"Kelly, Josh",21,11,3,10,1,0,0,2
Greater Western Sydney,"Langdon, Zac",5,2,0,3,0,0,0,3
Greater Western Sydney,"Mumford, Shane",7,0,1,7,0,0,21,0
Greater Western Sydney,"Perryman, Harry",16,8,5,8,0,0,0,2
Greater Western Sydney,"Shaw, Heath",9,7,3,2,0,0,0,1
Greater Western Sydney,"Taranto, Tim",16,12,2,4,2,0,0,3
Greater Western Sydney,"Whitfield, Lachie",24,15,7,9,0,0,0,0
Greater Western Sydney,"de Boer, Matt",10,2,0,8,1,0,0,1
Greater Western Sydney,"Ash, Lachie",8,6,2,2,0,0,0,3
Greater Western Sydney,"Caldwell, Jye",12,6,1,6,0,0,0,3
Greater Western Sydney,"Cameron, Jeremy",12,6,2,6,0,0,0,0
Greater Western Sydney,"Coniglio, Stephen",24,16,3,8,0,0,0,7
Greater Western Sydney,"Corr, Aidan",11,10,3,1,0,0,0,1
Greater Western Sydney,"Daniels, Brent",13,8,2,5,0,4,0,7
Greater Western Sydney,"Davis, Phil",7,3,3,4,0,0,0,2
Greater Western Sydney,"Finlayson, Jeremy",5,4,2,1,1,0,3,2
Greater Western Sydney,"Greene, Toby",18,11,8,7,5,0,0,0
Greater Western Sydney,"Haynes, Nick",15,13,10,2,0,0,0,2
Greater Western Sydney,"Himmelberg, Harry",9,2,2,7,1,0,0,2
Greater Western Sydney,"Hopper, Jacob",18,12,2,6,0,0,0,4
Greater Western Sydney,"Jacobs, Sam",5,3,2,2,1,0,26,2
Greater Western Sydney,"Keeffe, Lachlan",8,4,2,4,0,0,0,0
Greater Western Sydney,"Kelly, Josh",26,16,4,10,1,0,0,8
Greater Western Sydney,"Langdon, Zac",6,3,2,3,0,2,0,4
Greater Western Sydney,"Lloyd, Daniel",9,5,2,4,0,0,0,5
Greater Western Sydney,"Perryman, Harry",12,10,6,2,0,0,0,1
Greater Western Sydney,"Shaw, Heath",13,10,3,3,0,0,0,6
Greater Western Sydney,"Taranto, Tim",18,12,1,6,0,1,0,3
Greater Western Sydney,"Whitfield, Lachie",26,17,9,9,0,0,0,2
Greater Western Sydney,"de Boer, Matt",7,1,0,6,0,0,0,4
Greater Western Sydney,"Ash, Lachie",13,11,6,2,0,0,0,1
Greater Western Sydney,"Caldwell, Jye",15,4,2,11,0,0,0,3
Greater Western Sydney,"Cameron, Jeremy",10,6,0,4,2,0,1,3
Greater Western Sydney,"Coniglio, Stephen",20,14,3,6,1,0,0,5
Greater Western Sydney,"Corr, Aidan",16,12,4,4,0,0,0,2
Greater Western Sydney,"Daniels, Brent",14,7,2,7,0,0,0,2
Greater Western Sydney,"Davis, Phil",12,6,6,6,0,0,0,1
Greater Western Sydney,"Finlayson, Jeremy",11,10,5,1,1,1,1,1
Greater Western Sydney,"Greene, Toby",6,5,1,1,0,2,0,0
Greater Western Sydney,"Haynes, Nick",18,15,8,3,0,0,0,0
Greater Western Sydney,"Himmelberg, Harry",16,8,7,8,2,0,0,1
Greater Western Sydney,"Hopper, Jacob",27,14,4,13,1,2,0,4
Greater Western Sydney,"Jacobs, Sam",7,5,3,2,0,0,18,2
Greater Western Sydney,"Keeffe, Lachlan",5,0,0,5,0,0,0,0
Greater Western Sydney,"Kelly, Josh",28,15,4,13,1,0,0,3
Greater Western Sydney,"Langdon, Zac",9,2,0,7,0,1,0,2
Greater Western Sydney,"Perryman, Harry",20,10,7,10,0,0,0,1
Greater Western Sydney,"Shaw, Heath",10,8,4,2,0,0,0,2
Greater Western Sydney,"Taranto, Tim",21,12,5,9,1,0,0,6
Greater Western Sydney,"Whitfield, Lachie",29,18,13,11,0,0,0,1
Greater Western Sydney,"Williams, Zac",26,20,6,6,0,0,0,0
Greater Western Sydney,"de Boer, Matt",15,7,3,8,0,0,0,6
Greater Western Sydney,"Ash, Lachie",9,4,2,5,0,0,0,1
Greater Western Sydney,"Caldwell, Jye",8,4,0,4,0,0,0,5
Greater Western Sydney,"Cameron, Jeremy",13,10,5,3,2,2,0,0
Greater Western Sydney,"Coniglio, Stephen",26,15,3,11,1,0,0,5
Greater Western Sydney,"Corr, Aidan",10,7,0,3,0,0,0,2
Greater Western Sydney,"Daniels, Brent",12,4,0,8,0,1,0,4
Greater Western Sydney,"Davis, Phil",4,1,4,3,0,0,0,1
Greater Western Sydney,"Finlayson, Jeremy",5,5,1,0,1,0,4,4
Greater Western Sydney,"Haynes, Nick",18,14,9,4,0,0,0,2
Greater Western Sydney,"Himmelberg, Harry",11,8,3,3,1,0,5,1
Greater Western Sydney,"Hopper, Jacob",23,15,4,8,0,1,0,1
Greater Western Sydney,"Keeffe, Lachlan",7,3,1,4,0,0,0,0
Greater Western Sydney,"Kelly, Josh",22,12,1,10,0,1,0,4
Greater Western Sydney,"Langdon, Zac",9,6,1,3,0,0,0,4
Greater Western Sydney,"Mumford, Shane",11,2,0,9,0,0,30,3
Greater Western Sydney,"OHalloran, Xavier",9,5,0,4,0,0,0,3
Greater Western Sydney,"Perryman, Harry",15,10,2,5,0,2,0,1
Greater Western Sydney,"Shaw, Heath",9,8,6,1,2,0,0,4
Greater Western Sydney,"Taranto, Tim",32,16,4,16,0,0,0,4
Greater Western Sydney,"Ward, Callan",14,7,2,7,1,0,0,1
Greater Western Sydney,"Whitfield, Lachie",26,11,6,15,0,0,0,2
Greater Western Sydney,"Williams, Zac",13,8,1,5,0,0,0,3
Greater Western Sydney,"Ash, Lachie",6,4,0,2,0,0,0,3
Greater Western Sydney,"Caldwell, Jye",13,8,4,5,0,1,0,2
Greater Western Sydney,"Cameron, Jeremy",5,3,0,2,1,0,1,3
Greater Western Sydney,"Coniglio, Stephen",20,12,2,8,0,0,0,5
Greater Western Sydney,"Corr, Aidan",9,7,2,2,0,0,0,2
Greater Western Sydney,"Daniels, Brent",13,9,4,4,0,0,0,4
Greater Western Sydney,"Finlayson, Jeremy",8,5,2,3,1,1,2,2
Greater Western Sydney,"Haynes, Nick",7,5,2,2,0,0,0,0
Greater Western Sydney,"Himmelberg, Harry",6,4,1,2,0,0,2,1
Greater Western Sydney,"Hopper, Jacob",14,6,0,8,0,0,0,3
Greater Western Sydney,"Hutchesson, Tom",7,4,2,3,0,1,0,1
Greater Western Sydney,"Jacobs, Sam",10,4,2,6,0,0,25,1
Greater Western Sydney,"Keeffe, Lachlan",5,3,3,2,0,0,0,0
Greater Western Sydney,"Kelly, Josh",31,19,1,12,0,1,0,5
Greater Western Sydney,"Langdon, Zac",8,3,2,5,1,2,0,4
Greater Western Sydney,"OHalloran, Xavier",10,4,2,6,0,0,0,3
Greater Western Sydney,"Perryman, Harry",20,12,3,8,0,0,0,3
Greater Western Sydney,"Shaw, Heath",6,5,2,1,0,0,0,2
Greater Western Sydney,"Taranto, Tim",13,10,1,3,0,0,0,7
Greater Western Sydney,"Ward, Callan",12,8,1,4,0,0,0,1
Greater Western Sydney,"Whitfield, Lachie",14,10,5,4,0,0,0,4
Greater Western Sydney,"Williams, Zac",21,15,2,6,0,0,0,1
Greater Western Sydney,"Caldwell, Jye",10,5,5,5,0,0,0,3
Greater Western Sydney,"Cameron, Jeremy",8,7,5,1,0,0,0,1
Greater Western Sydney,"Coniglio, Stephen",19,10,2,9,1,0,0,1
Greater Western Sydney,"Corr, Aidan",8,6,5,2,0,0,0,0
Greater Western Sydney,"Daniels, Brent",13,6,1,7,1,0,0,2
Greater Western Sydney,"Greene, Toby",20,12,2,8,0,0,0,3
Greater Western Sydney,"Haynes, Nick",17,12,7,5,0,0,0,3
Greater Western Sydney,"Hill, Bobby",6,5,2,1,0,1,0,3
Greater Western Sydney,"Himmelberg, Harry",13,6,3,7,1,1,3,1
Greater Western Sydney,"Hopper, Jacob",21,6,1,15,0,1,0,4
Greater Western Sydney,"Keeffe, Lachlan",11,7,6,4,0,0,0,0
Greater Western Sydney,"Kelly, Josh",26,12,6,14,1,0,0,2
Greater Western Sydney,"Kennedy, Adam",19,8,4,11,0,0,0,4
Greater Western Sydney,"Lloyd, Daniel",17,8,6,9,1,0,0,1
Greater Western Sydney,"Mumford, Shane",9,1,0,8,0,0,24,3
Greater Western Sydney,"Perryman, Harry",24,13,4,11,0,0,0,2
Greater Western Sydney,"Riccardi, Jake",16,12,10,4,2,1,0,0
Greater Western Sydney,"Shaw, Heath",14,9,4,5,0,0,0,2
Greater Western Sydney,"Taranto, Tim",13,8,2,5,0,0,0,5
Greater Western Sydney,"Ward, Callan",7,5,4,2,0,0,0,0
Greater Western Sydney,"Whitfield, Lachie",25,12,8,13,0,0,0,2
Greater Western Sydney,"Williams, Zac",16,12,6,4,0,1,0,5
Greater Western Sydney,"Ash, Lachie",14,8,4,6,0,0,0,3
Greater Western Sydney,"Cameron, Jeremy",18,14,8,4,4,2,0,0
Greater Western Sydney,"Coniglio, Stephen",24,13,3,11,0,0,0,4
Greater Western Sydney,"Corr, Aidan",6,4,1,2,0,0,0,2
Greater Western Sydney,"Daniels, Brent",13,7,2,6,1,1,0,3
Greater Western Sydney,"Greene, Toby",14,7,2,7,1,0,0,3
Greater Western Sydney,"Haynes, Nick",17,9,7,8,0,0,0,2
Greater Western Sydney,"Hill, Bobby",13,7,1,6,2,2,0,1
Greater Western Sydney,"Himmelberg, Harry",10,7,4,3,1,0,1,1
Greater Western Sydney,"Hopper, Jacob",23,11,3,12,0,0,0,6
Greater Western Sydney,"Keeffe, Lachlan",16,8,5,8,0,0,0,0
Greater Western Sydney,"Kelly, Josh",11,7,2,4,0,0,0,5
Greater Western Sydney,"Kennedy, Adam",16,10,2,6,0,0,0,1
Greater Western Sydney,"Lloyd, Daniel",14,8,3,6,0,0,0,0
Greater Western Sydney,"Mumford, Shane",12,2,0,10,0,0,25,3
Greater Western Sydney,"Perryman, Harry",17,10,0,7,0,0,0,5
Greater Western Sydney,"Riccardi, Jake",12,10,9,2,4,1,0,0
Greater Western Sydney,"Shaw, Heath",9,7,5,2,0,0,0,4
Greater Western Sydney,"Taranto, Tim",25,13,6,12,1,0,0,3
Greater Western Sydney,"Whitfield, Lachie",31,18,9,13,0,0,0,1
Greater Western Sydney,"Williams, Zac",21,14,5,7,0,0,0,1
Greater Western Sydney,"de Boer, Matt",14,5,0,9,0,0,0,5
Greater Western Sydney,"Ash, Lachie",15,6,2,9,0,0,0,3
Greater Western Sydney,"Cameron, Jeremy",7,4,0,3,0,0,0,1
Greater Western Sydney,"Coniglio, Stephen",15,8,2,7,0,1,0,6
Greater Western Sydney,"Corr, Aidan",13,9,3,4,0,0,0,4
Greater Western Sydney,"Daniels, Brent",14,9,1,5,0,1,0,3
Greater Western Sydney,"Finlayson, Jeremy",11,10,3,1,1,1,1,2
Greater Western Sydney,"Greene, Toby",19,17,7,2,1,2,0,1
Greater Western Sydney,"Haynes, Nick",21,17,8,4,0,0,0,1
Greater Western Sydney,"Hill, Bobby",13,10,5,3,1,2,0,2
Greater Western Sydney,"Himmelberg, Harry",13,10,4,3,0,1,0,2
Greater Western Sydney,"Hopper, Jacob",21,8,1,13,0,0,0,2
Greater Western Sydney,"Keeffe, Lachlan",4,2,1,2,0,0,0,0
Greater Western Sydney,"Kennedy, Adam",13,7,1,6,0,0,0,2
Greater Western Sydney,"Lloyd, Daniel",11,5,1,6,0,0,0,1
Greater Western Sydney,"Mumford, Shane",7,0,1,7,0,0,23,6
Greater Western Sydney,"Perryman, Harry",14,8,2,6,1,0,0,1
Greater Western Sydney,"Riccardi, Jake",9,7,5,2,2,2,0,0
Greater Western Sydney,"Shaw, Heath",9,6,4,3,0,0,0,2
Greater Western Sydney,"Taranto, Tim",17,14,3,3,0,0,0,3
Greater Western Sydney,"Whitfield, Lachie",15,8,4,7,0,0,0,2
Greater Western Sydney,"Williams, Zac",13,11,3,2,0,0,0,1
Greater Western Sydney,"de Boer, Matt",8,2,1,6,0,0,0,3
Greater Western Sydney,"Ash, Lachie",18,10,4,8,0,0,0,1
Greater Western Sydney,"Caldwell, Jye",11,7,3,4,1,0,0,7
Greater Western Sydney,"Cameron, Jeremy",11,8,7,3,1,1,0,0
Greater Western Sydney,"Coniglio, Stephen",20,9,4,11,0,1,0,4
Greater Western Sydney,"Corr, Aidan",10,10,4,0,0,0,0,1
Greater Western Sydney,"Finlayson, Jeremy",8,5,3,3,2,0,3,4
Greater Western Sydney,"Greene, Toby",15,6,5,9,0,0,0,1
Greater Western Sydney,"Hately, Jackson",11,5,4,6,0,0,0,7
Greater Western Sydney,"Haynes, Nick",17,12,6,5,0,0,0,2
Greater Western Sydney,"Hill, Bobby",6,4,1,2,1,0,0,5
Greater Western Sydney,"Himmelberg, Harry",15,12,2,3,0,0,0,3
Greater Western Sydney,"Hopper, Jacob",18,7,1,11,0,0,0,5
Greater Western Sydney,"Jacobs, Sam",14,8,4,6,1,0,20,7
Greater Western Sydney,"Keeffe, Lachlan",7,4,4,3,0,0,0,2
Greater Western Sydney,"Kennedy, Adam",8,3,1,5,0,0,0,3
Greater Western Sydney,"Lloyd, Daniel",11,5,2,6,0,0,0,1
Greater Western Sydney,"Reid, Sam",9,3,2,6,0,0,0,2
Greater Western Sydney,"Riccardi, Jake",4,2,1,2,0,0,0,1
Greater Western Sydney,"Shaw, Heath",15,13,6,2,1,0,0,5
Greater Western Sydney,"Taranto, Tim",23,16,3,7,0,1,0,6
Greater Western Sydney,"Whitfield, Lachie",29,21,5,8,0,0,0,7
Greater Western Sydney,"de Boer, Matt",11,3,1,8,0,0,0,2
Greater Western Sydney,"Buckley, Jack",12,5,3,7,0,0,0,3
Greater Western Sydney,"Cameron, Jeremy",12,5,2,7,1,0,0,2
Greater Western Sydney,"Daniels, Brent",16,12,3,4,3,0,0,3
Greater Western Sydney,"Finlayson, Jeremy",13,9,2,4,1,2,0,3
Greater Western Sydney,"Green, Tom",30,8,2,22,0,0,0,3
Greater Western Sydney,"Greene, Toby",15,11,3,4,0,3,0,5
Greater Western Sydney,"Haynes, Nick",10,7,5,3,0,0,0,1
Greater Western Sydney,"Himmelberg, Harry",5,2,2,3,0,0,2,1
Greater Western Sydney,"Hopper, Jacob",21,13,4,8,0,1,0,5
Greater Western Sydney,"Idun, Connor",4,2,2,2,0,0,0,0
Greater Western Sydney,"Keeffe, Lachlan",7,7,3,0,0,0,0,5
Greater Western Sydney,"Kelly, Josh",24,20,2,4,0,1,0,5
Greater Western Sydney,"Kennedy, Adam",11,7,3,4,0,0,0,2
Greater Western Sydney,"Lloyd, Daniel",8,5,2,3,2,0,0,3
Greater Western Sydney,"Mumford, Shane",7,4,3,3,0,0,18,7
Greater Western Sydney,"Perryman, Harry",18,10,1,8,1,0,0,3
Greater Western Sydney,"Reid, Sam",6,3,0,3,0,0,0,2
Greater Western Sydney,"Shaw, Heath",5,3,0,2,0,0,0,3
Greater Western Sydney,"Taranto, Tim",15,7,0,8,0,0,0,3
Greater Western Sydney,"Whitfield, Lachie",22,10,3,12,0,0,0,1
Greater Western Sydney,"Williams, Zac",18,13,4,5,2,0,0,4
Greater Western Sydney,"de Boer, Matt",9,6,0,3,1,0,0,3
Greater Western Sydney,"Buckley, Jack",7,6,4,1,0,0,0,2
Greater Western Sydney,"Cameron, Jeremy",10,8,6,2,0,1,0,0
Greater Western Sydney,"Coniglio, Stephen",23,15,6,8,0,0,0,2
Greater Western Sydney,"Cumming, Isaac",16,11,8,5,0,0,0,0
Greater Western Sydney,"Daniels, Brent",14,8,3,6,0,0,0,1
Greater Western Sydney,"Finlayson, Jeremy",5,4,2,1,0,0,2,2
Greater Western Sydney,"Green, Tom",15,6,6,9,0,2,0,2
Greater Western Sydney,"Greene, Toby",12,7,3,5,1,1,0,0
Greater Western Sydney,"Haynes, Nick",8,6,5,2,0,0,0,0
Greater Western Sydney,"Hopper, Jacob",18,9,3,9,0,0,0,4
Greater Western Sydney,"Idun, Connor",13,7,3,6,0,0,0,1
Greater Western Sydney,"Keeffe, Lachlan",14,8,6,6,0,0,0,0
Greater Western Sydney,"Kelly, Josh",18,11,2,7,0,0,0,2
Greater Western Sydney,"Lloyd, Daniel",17,10,6,7,1,0,0,3
Greater Western Sydney,"Mumford, Shane",5,0,1,5,0,0,12,2
Greater Western Sydney,"Perryman, Harry",18,12,6,6,0,0,0,6
Greater Western Sydney,"Reid, Sam",2,1,2,1,0,0,0,2
Greater Western Sydney,"Riccardi, Jake",11,6,5,5,1,2,1,1
Greater Western Sydney,"Shaw, Heath",16,15,7,1,0,1,0,1
Greater Western Sydney,"Taranto, Tim",19,12,3,7,0,1,0,2
Greater Western Sydney,"Whitfield, Lachie",28,16,13,12,0,1,0,0
Greater Western Sydney,"Williams, Zac",13,9,2,4,0,1,0,3
Hawthorn,"Breust, Luke",12,7,2,5,3,0,0,5
Hawthorn,"Burgoyne, Shaun",10,7,3,3,3,0,0,4
Hawthorn,"Ceglar, Jonathon",8,3,2,5,0,0,28,1
Hawthorn,"Frawley, James",6,4,2,2,0,0,0,3
Hawthorn,"Frost, Sam",11,4,1,7,0,0,0,1
Hawthorn,"Gunston, Jack",16,13,4,3,0,1,0,1
Hawthorn,"Hanrahan, Oliver",15,9,3,6,1,1,0,2
Hawthorn,"Henderson, Ricky",11,8,8,3,0,0,0,1
Hawthorn,"McEvoy, Ben",9,5,3,4,0,1,3,2
Hawthorn,"Mitchell, Tom",25,11,2,14,0,0,0,3
Hawthorn,"Morrison, Harry",10,10,2,0,0,0,0,2
Hawthorn,"OBrien, Tim",8,4,1,4,1,0,1,0
Hawthorn,"OMeara, Jaeger",23,11,4,12,0,0,0,5
Hawthorn,"Patton, Jonathon",7,5,4,2,1,1,1,0
Hawthorn,"Puopolo, Paul",8,5,2,3,0,0,0,2
Hawthorn,"Scully, Tom",15,9,4,6,1,0,0,1
Hawthorn,"Shiels, Liam",24,15,4,9,0,0,0,6
Hawthorn,"Sicily, James",17,15,5,2,0,0,0,0
Hawthorn,"Smith, Isaac",19,12,4,7,1,0,0,4
Hawthorn,"Stratton, Ben",5,3,3,2,0,0,0,1
Hawthorn,"Wingard, Chad",20,14,5,6,3,0,0,3
Hawthorn,"Worpel, James",19,13,5,6,0,1,0,4
Hawthorn,"Breust, Luke",8,6,0,2,1,1,0,6
Hawthorn,"Burgoyne, Shaun",9,7,0,2,1,0,0,5
Hawthorn,"Ceglar, Jonathon",13,4,2,9,0,0,30,4
Hawthorn,"Frawley, James",11,9,4,2,0,0,0,1
Hawthorn,"Frost, Sam",14,11,9,3,0,0,0,2
Hawthorn,"Gunston, Jack",8,6,4,2,2,0,0,2
Hawthorn,"Hanrahan, Oliver",14,6,1,8,1,0,0,0
Hawthorn,"Hardwick, Blake",9,4,0,5,0,0,0,2
Hawthorn,"Henderson, Ricky",8,4,1,4,0,0,0,1
Hawthorn,"McEvoy, Ben",7,3,3,4,0,0,1,3
Hawthorn,"Mitchell, Tom",22,9,1,13,0,0,0,3
Hawthorn,"Morrison, Harry",14,11,3,3,0,0,0,1
Hawthorn,"OBrien, Tim",5,4,2,1,1,0,2,2
Hawthorn,"Patton, Jonathon",6,4,2,2,1,1,0,0
Hawthorn,"Puopolo, Paul",9,2,0,7,0,0,0,3
Hawthorn,"Scully, Tom",16,10,3,6,0,0,0,1
Hawthorn,"Shiels, Liam",9,5,1,4,0,0,0,5
Hawthorn,"Sicily, James",12,8,2,4,0,0,0,4
Hawthorn,"Smith, Isaac",16,8,4,8,0,0,0,1
Hawthorn,"Stratton, Ben",8,3,1,5,0,0,0,1
Hawthorn,"Wingard, Chad",17,13,5,4,0,1,0,2
Hawthorn,"Worpel, James",15,9,1,6,0,0,0,7
Hawthorn,"Breust, Luke",9,5,1,4,1,0,0,1
Hawthorn,"Burgoyne, Shaun",11,5,2,6,0,0,0,0
Hawthorn,"Ceglar, Jonathon",15,8,1,7,1,0,20,3
Hawthorn,"Frawley, James",7,5,3,2,0,0,0,0
Hawthorn,"Frost, Sam",15,9,5,6,0,0,0,3
Hawthorn,"Gunston, Jack",9,8,6,1,2,2,0,0
Hawthorn,"Hanrahan, Oliver",11,6,3,5,0,0,0,0
Hawthorn,"Hardwick, Blake",17,12,4,5,0,0,0,4
Hawthorn,"Henderson, Ricky",15,6,5,9,0,0,0,2
Hawthorn,"McEvoy, Ben",12,6,4,6,0,0,0,0
Hawthorn,"Mitchell, Tom",23,6,6,17,0,0,0,1
Hawthorn,"OBrien, Tim",5,3,0,2,1,0,5,2
Hawthorn,"OMeara, Jaeger",23,14,5,9,1,0,0,3
Hawthorn,"Patton, Jonathon",7,5,3,2,1,0,0,2
Hawthorn,"Scrimshaw, Jack",18,11,3,7,0,0,0,1
Hawthorn,"Scully, Tom",12,6,2,6,0,0,0,0
Hawthorn,"Shiels, Liam",13,8,3,5,0,0,0,1
Hawthorn,"Sicily, James",23,19,4,4,0,0,0,0
Hawthorn,"Smith, Isaac",29,19,4,10,1,0,0,1
Hawthorn,"Stratton, Ben",12,8,3,4,0,0,0,0
Hawthorn,"Wingard, Chad",15,12,5,3,3,0,0,3
Hawthorn,"Worpel, James",17,8,4,9,0,1,0,7
Hawthorn,"Breust, Luke",11,6,2,5,1,0,0,7
Hawthorn,"Burgoyne, Shaun",10,6,1,4,1,1,0,1
Hawthorn,"Ceglar, Jonathon",12,8,1,4,0,0,28,6
Hawthorn,"Frawley, James",8,6,3,2,0,0,0,0
Hawthorn,"Frost, Sam",7,5,0,2,0,0,0,3
Hawthorn,"Gunston, Jack",12,6,3,6,0,2,0,1
Hawthorn,"Hanrahan, Oliver",7,5,0,2,0,0,0,0
Hawthorn,"Hardwick, Blake",8,5,2,3,0,0,0,2
Hawthorn,"Henderson, Ricky",17,7,5,10,0,0,0,3
Hawthorn,"Lewis, Mitch",4,2,0,2,1,1,0,1
Hawthorn,"McEvoy, Ben",2,1,0,1,0,0,0,1
Hawthorn,"Mitchell, Tom",22,5,1,17,0,0,0,8
Hawthorn,"OBrien, Tim",8,7,4,1,1,0,1,8
Hawthorn,"OMeara, Jaeger",11,8,2,3,0,2,0,4
Hawthorn,"Scrimshaw, Jack",10,4,2,6,0,0,0,0
Hawthorn,"Scully, Tom",10,6,2,4,0,0,0,1
Hawthorn,"Shiels, Liam",22,11,1,11,1,0,0,3
Hawthorn,"Sicily, James",18,14,3,4,0,0,0,3
Hawthorn,"Smith, Isaac",16,11,3,5,0,1,0,3
Hawthorn,"Stratton, Ben",7,5,3,2,0,0,0,3
Hawthorn,"Wingard, Chad",18,11,4,7,3,1,0,2
Hawthorn,"Worpel, James",24,13,1,11,0,1,0,9
Hawthorn,"Burgoyne, Shaun",6,3,3,3,1,0,0,1
Hawthorn,"Ceglar, Jonathon",7,3,1,4,0,0,20,3
Hawthorn,"Frawley, James",8,6,4,2,0,0,0,2
Hawthorn,"Frost, Sam",9,4,4,5,0,0,0,2
Hawthorn,"Gunston, Jack",12,6,3,6,3,1,0,6
Hawthorn,"Hardwick, Blake",13,10,1,3,0,0,0,1
Hawthorn,"Henderson, Ricky",15,3,1,12,0,0,0,1
Hawthorn,"Jones, Harry",11,3,1,8,0,0,0,4
Hawthorn,"Lewis, Mitch",4,2,1,2,0,0,1,0
Hawthorn,"McEvoy, Ben",13,5,4,8,2,0,17,2
Hawthorn,"Mitchell, Tom",24,11,4,13,0,0,0,2
Hawthorn,"OBrien, Tim",4,3,3,1,0,0,0,1
Hawthorn,"OMeara, Jaeger",25,13,2,12,0,0,0,2
Hawthorn,"Puopolo, Paul",10,8,2,2,1,1,0,1
Hawthorn,"Scrimshaw, Jack",11,7,4,4,0,0,0,1
Hawthorn,"Scully, Tom",11,7,3,4,0,0,0,4
Hawthorn,"Shiels, Liam",11,8,1,3,0,0,0,1
Hawthorn,"Sicily, James",10,7,4,3,0,0,0,0
Hawthorn,"Smith, Isaac",19,12,3,7,0,0,0,3
Hawthorn,"Stratton, Ben",10,6,3,4,0,0,0,1
Hawthorn,"Wingard, Chad",12,6,3,6,0,2,0,5
Hawthorn,"Worpel, James",16,12,3,4,0,0,0,6
Hawthorn,"Ceglar, Jonathon",9,4,0,5,0,0,9,2
Hawthorn,"Day, Will",16,10,2,6,0,0,0,2
Hawthorn,"Frawley, James",12,9,4,3,0,0,0,0
Hawthorn,"Frost, Sam",9,5,4,4,0,0,0,0
Hawthorn,"Gunston, Jack",10,10,5,0,1,3,0,2
Hawthorn,"Hardwick, Blake",20,17,6,3,0,0,0,1
Hawthorn,"Henderson, Ricky",16,13,8,3,0,0,0,1
Hawthorn,"McEvoy, Ben",10,6,6,4,1,0,8,1
Hawthorn,"Mitchell, Tom",33,14,7,19,0,0,0,1
Hawthorn,"Morris, Josh",4,2,1,2,0,0,0,2
Hawthorn,"Morrison, Harry",17,12,9,5,0,0,0,2
Hawthorn,"OBrien, Tim",10,9,7,1,0,1,1,1
Hawthorn,"OMeara, Jaeger",20,11,2,9,0,1,0,5
Hawthorn,"Patton, Jonathon",1,1,0,0,0,0,0,0
Hawthorn,"Puopolo, Paul",7,2,0,5,0,0,0,4
Hawthorn,"Scully, Tom",10,4,0,6,0,0,0,1
Hawthorn,"Shiels, Liam",20,11,6,9,0,0,0,6
Hawthorn,"Sicily, James",28,17,14,11,0,0,0,0
Hawthorn,"Smith, Isaac",26,12,9,14,1,1,0,1
Hawthorn,"Stratton, Ben",12,6,4,6,0,0,0,1
Hawthorn,"Wingard, Chad",10,8,3,2,0,1,0,1
Hawthorn,"Worpel, James",18,12,3,6,0,0,0,4
Hawthorn,"Burgoyne, Shaun",10,6,3,4,0,1,0,3
Hawthorn,"Day, Will",19,10,8,9,0,0,0,0
Hawthorn,"Frawley, James",9,3,1,6,0,0,0,0
Hawthorn,"Frost, Sam",12,8,8,4,0,0,0,1
Hawthorn,"Gunston, Jack",7,7,5,0,3,0,0,0
Hawthorn,"Hardwick, Blake",16,11,6,5,0,0,0,0
Hawthorn,"Henderson, Ricky",23,14,9,9,0,0,0,2
Hawthorn,"Lewis, Mitch",8,6,2,2,0,1,0,0
Hawthorn,"McEvoy, Ben",6,2,2,4,0,0,16,0
Hawthorn,"Minchington, Darren",13,7,3,6,0,1,0,2
Hawthorn,"Mitchell, Tom",20,8,1,12,0,0,0,4
Hawthorn,"Morris, Josh",9,5,3,4,1,1,0,2
Hawthorn,"Morrison, Harry",13,7,5,6,0,0,0,1
Hawthorn,"OBrien, Tim",1,1,1,0,0,0,2,1
Hawthorn,"OMeara, Jaeger",19,13,5,6,1,0,0,4
Hawthorn,"Scully, Tom",13,7,3,6,0,0,0,1
Hawthorn,"Shiels, Liam",16,6,2,10,0,0,0,2
Hawthorn,"Sicily, James",24,16,8,8,0,0,0,0
Hawthorn,"Smith, Isaac",14,6,1,8,0,0,0,3
Hawthorn,"Stratton, Ben",6,4,3,2,0,0,0,1
Hawthorn,"Wingard, Chad",10,3,2,7,2,0,0,4
Hawthorn,"Worpel, James",14,9,2,5,0,0,0,4
Hawthorn,"Brooksby, Keegan",5,4,0,1,0,0,10,2
Hawthorn,"Burgoyne, Shaun",14,5,0,9,1,0,0,4
Hawthorn,"Day, Will",10,7,4,3,0,0,0,1
Hawthorn,"Frawley, James",11,5,4,6,0,0,0,1
Hawthorn,"Frost, Sam",7,4,1,3,0,0,0,0
Hawthorn,"Gunston, Jack",11,8,4,3,1,1,0,1
Hawthorn,"Hardwick, Blake",12,7,1,5,0,0,0,0
Hawthorn,"Lewis, Mitch",1,1,0,0,0,0,1,0
Hawthorn,"McEvoy, Ben",9,3,0,6,0,0,18,5
Hawthorn,"Minchington, Darren",11,5,1,6,0,1,0,0
Hawthorn,"Mitchell, Tom",18,9,0,9,1,0,0,6
Hawthorn,"Morris, Josh",6,4,0,2,0,0,0,2
Hawthorn,"Morrison, Harry",13,9,2,4,0,0,0,2
Hawthorn,"OMeara, Jaeger",25,21,5,4,1,0,0,5
Hawthorn,"Scrimshaw, Jack",10,6,1,4,0,0,0,3
Hawthorn,"Scully, Tom",14,11,2,3,0,0,0,0
Hawthorn,"Shiels, Liam",24,19,1,5,1,0,0,9
Hawthorn,"Sicily, James",23,18,7,5,1,0,0,1
Hawthorn,"Smith, Isaac",16,9,2,7,0,0,0,4
Hawthorn,"Stratton, Ben",6,2,2,4,0,0,0,2
Hawthorn,"Wingard, Chad",17,11,2,6,1,3,0,3
Hawthorn,"Worpel, James",17,10,1,7,0,0,0,5
Hawthorn,"Breust, Luke",12,7,2,5,2,1,0,0
Hawthorn,"Burgoyne, Shaun",14,8,2,6,0,0,0,1
Hawthorn,"Ceglar, Jonathon",8,4,4,4,0,0,22,4
Hawthorn,"Day, Will",10,7,5,3,1,0,0,0
Hawthorn,"Frawley, James",7,6,1,1,0,0,0,1
Hawthorn,"Frost, Sam",15,10,3,5,0,0,0,0
Hawthorn,"Gunston, Jack",16,11,7,5,3,1,0,0
Hawthorn,"Hardwick, Blake",14,6,3,8,0,0,0,2
Hawthorn,"Impey, Jarman",11,7,4,4,1,1,0,2
Hawthorn,"McEvoy, Ben",6,4,3,2,0,0,19,1
Hawthorn,"Mitchell, Tom",28,16,4,12,0,0,0,8
Hawthorn,"Morrison, Harry",13,6,2,7,0,0,0,1
Hawthorn,"OBrien, Tim",7,4,2,3,1,1,1,2
Hawthorn,"OMeara, Jaeger",18,9,1,9,1,0,0,4
Hawthorn,"Scrimshaw, Jack",11,9,1,2,0,0,0,2
Hawthorn,"Scully, Tom",11,6,2,5,0,1,0,1
Hawthorn,"Shiels, Liam",15,9,4,6,2,0,0,3
Hawthorn,"Sicily, James",15,11,5,4,0,0,0,0
Hawthorn,"Smith, Isaac",15,9,5,6,2,0,0,1
Hawthorn,"Stratton, Ben",8,3,2,5,0,0,0,0
Hawthorn,"Wingard, Chad",13,7,2,6,1,0,0,4
Hawthorn,"Worpel, James",20,8,4,12,0,0,0,5
Hawthorn,"Breust, Luke",12,4,3,8,2,0,0,5
Hawthorn,"Ceglar, Jonathon",7,2,2,5,0,0,11,0
Hawthorn,"Day, Will",18,9,4,9,0,0,0,0
Hawthorn,"Frawley, James",4,2,2,2,0,0,0,0
Hawthorn,"Frost, Sam",10,6,5,4,0,0,0,2
Hawthorn,"Gunston, Jack",13,9,2,4,1,2,0,1
Hawthorn,"Hardwick, Blake",14,13,1,1,0,0,0,0
Hawthorn,"Impey, Jarman",7,4,2,3,0,0,0,2
Hawthorn,"McEvoy, Ben",12,7,2,5,0,0,14,2
Hawthorn,"Mitchell, Tom",32,14,4,18,0,0,0,0
Hawthorn,"Morrison, Harry",16,6,7,10,0,0,0,2
Hawthorn,"Nash, Conor",11,8,4,3,0,1,0,0
Hawthorn,"OBrien, Tim",8,4,2,4,0,0,0,1
Hawthorn,"OMeara, Jaeger",17,10,3,7,0,0,0,4
Hawthorn,"Scrimshaw, Jack",19,12,4,7,0,0,0,1
Hawthorn,"Scully, Tom",10,6,5,4,0,0,0,0
Hawthorn,"Shiels, Liam",17,9,1,8,0,0,0,3
Hawthorn,"Sicily, James",14,9,5,5,1,1,0,1
Hawthorn,"Smith, Isaac",3,2,0,1,0,0,0,0
Hawthorn,"Stratton, Ben",6,2,3,4,0,0,0,1
Hawthorn,"Wingard, Chad",15,9,2,6,0,1,0,6
Hawthorn,"Worpel, James",19,14,1,5,0,0,0,10
Hawthorn,"Breust, Luke",6,2,0,4,0,0,0,2
Hawthorn,"Burgoyne, Shaun",13,7,3,6,1,0,0,4
Hawthorn,"Day, Will",16,11,8,5,0,0,0,2
Hawthorn,"Frawley, James",11,6,1,5,0,0,0,0
Hawthorn,"Frost, Sam",9,4,3,5,0,0,0,0
Hawthorn,"Glass, Conor",12,8,7,4,1,0,0,4
Hawthorn,"Gunston, Jack",9,6,1,3,2,1,0,0
Hawthorn,"Hardwick, Blake",14,6,3,8,0,0,0,2
Hawthorn,"Impey, Jarman",10,4,1,6,0,1,0,3
Hawthorn,"Jiath, Changkuoth",12,5,1,7,0,0,0,0
Hawthorn,"McEvoy, Ben",8,2,1,6,0,0,16,4
Hawthorn,"Mitchell, Tom",34,11,2,23,0,1,0,5
Hawthorn,"Morrison, Harry",13,6,1,7,0,1,0,3
Hawthorn,"Nash, Conor",5,3,1,2,0,0,0,0
Hawthorn,"OBrien, Tim",10,7,5,3,1,0,1,4
Hawthorn,"OMeara, Jaeger",27,13,1,14,0,1,0,7
Hawthorn,"Scrimshaw, Jack",18,12,6,6,0,0,0,1
Hawthorn,"Shiels, Liam",25,16,6,9,1,0,0,2
Hawthorn,"Sicily, James",12,12,5,0,0,0,0,0
Hawthorn,"Stratton, Ben",7,4,1,3,0,0,0,3
Hawthorn,"Wingard, Chad",13,5,3,8,0,0,0,6
Hawthorn,"Worpel, James",27,11,5,16,1,0,0,2
Hawthorn,"Breust, Luke",10,5,2,5,1,0,0,6
Hawthorn,"Burgoyne, Shaun",10,8,1,2,2,0,0,4
Hawthorn,"Cousins, James",17,11,3,6,0,0,0,2
Hawthorn,"Day, Will",12,7,4,5,0,1,0,4
Hawthorn,"Frost, Sam",8,5,1,3,0,0,0,1
Hawthorn,"Glass, Conor",11,6,1,5,0,0,0,0
Hawthorn,"Hanrahan, Oliver",10,7,1,3,1,0,0,1
Hawthorn,"Hardwick, Blake",9,6,2,3,0,0,0,2
Hawthorn,"Hartley, Michael",14,10,1,4,0,0,0,2
Hawthorn,"Howe, Daniel",8,5,5,3,0,0,0,1
Hawthorn,"Impey, Jarman",10,4,2,6,1,1,0,2
Hawthorn,"Jiath, Changkuoth",9,6,4,3,0,0,0,4
Hawthorn,"McEvoy, Ben",11,6,5,5,1,0,33,2
Hawthorn,"Mitchell, Tom",25,10,1,15,0,0,0,11
Hawthorn,"OBrien, Tim",6,4,1,2,1,0,3,1
Hawthorn,"Patton, Jonathon",7,3,2,4,0,0,3,2
Hawthorn,"Scrimshaw, Jack",18,8,4,10,0,0,0,1
Hawthorn,"Scully, Tom",16,7,2,9,0,0,0,1
Hawthorn,"Shiels, Liam",16,8,4,8,0,0,0,2
Hawthorn,"Stratton, Ben",11,8,4,3,0,0,0,0
Hawthorn,"Wingard, Chad",10,6,1,4,2,0,0,3
Hawthorn,"Worpel, James",26,17,3,9,0,1,0,5
Hawthorn,"Breust, Luke",13,6,1,7,0,2,0,3
Hawthorn,"Ceglar, Jonathon",13,4,2,9,0,0,30,0
Hawthorn,"Cousins, James",19,10,3,9,1,1,0,2
Hawthorn,"Day, Will",16,7,2,9,0,0,0,3
Hawthorn,"Frost, Sam",12,5,2,7,0,0,0,2
Hawthorn,"Glass, Conor",13,9,3,4,0,0,0,3
Hawthorn,"Gunston, Jack",11,7,3,4,2,1,0,1
Hawthorn,"Hanrahan, Oliver",11,6,1,5,0,2,0,1
Hawthorn,"Hardwick, Blake",14,9,5,5,0,0,0,1
Hawthorn,"Hartley, Michael",14,10,2,4,0,0,0,3
Hawthorn,"Howe, Daniel",11,8,4,3,2,0,0,2
Hawthorn,"Jiath, Changkuoth",11,6,2,5,0,0,0,1
Hawthorn,"McEvoy, Ben",16,6,7,10,0,0,5,2
Hawthorn,"Minchington, Darren",6,5,1,1,1,0,0,1
Hawthorn,"Mitchell, Tom",27,7,3,20,0,0,0,7
Hawthorn,"OBrien, Tim",7,5,3,2,1,1,1,0
Hawthorn,"Patton, Jonathon",1,0,0,1,0,0,1,0
Hawthorn,"Scrimshaw, Jack",22,12,9,10,0,0,0,1
Hawthorn,"Scully, Tom",15,6,1,9,2,0,0,1
Hawthorn,"Shiels, Liam",9,4,3,5,0,0,0,0
Hawthorn,"Wingard, Chad",8,5,3,3,0,0,0,2
Hawthorn,"Worpel, James",23,15,6,8,1,3,0,6
Hawthorn,"Breust, Luke",6,4,1,2,0,0,0,8
Hawthorn,"Burgoyne, Shaun",10,6,1,4,0,0,0,0
Hawthorn,"Ceglar, Jonathon",15,5,5,10,0,0,14,3
Hawthorn,"Cousins, James",16,8,2,8,0,0,0,5
Hawthorn,"Frawley, James",9,5,4,4,0,0,0,0
Hawthorn,"Glass, Conor",6,3,2,3,0,0,0,3
Hawthorn,"Gunston, Jack",10,9,3,1,3,1,0,4
Hawthorn,"Hanrahan, Oliver",7,5,1,2,0,1,0,3
Hawthorn,"Hardwick, Blake",13,10,6,3,0,0,0,0
Hawthorn,"Howe, Daniel",12,9,2,3,0,0,0,1
Hawthorn,"Impey, Jarman",8,3,4,5,0,0,0,0
Hawthorn,"Jiath, Changkuoth",9,6,4,3,0,0,0,0
Hawthorn,"Lewis, Mitch",4,3,1,1,1,1,1,1
Hawthorn,"McEvoy, Ben",5,5,3,0,0,0,3,2
Hawthorn,"Minchington, Darren",9,7,1,2,1,0,0,2
Hawthorn,"Mitchell, Tom",23,8,3,15,0,0,0,5
Hawthorn,"OBrien, Tim",12,7,2,5,0,0,4,0
Hawthorn,"Scrimshaw, Jack",22,15,6,7,0,0,0,2
Hawthorn,"Scully, Tom",18,9,1,9,0,0,0,3
Hawthorn,"Stratton, Ben",10,7,4,3,0,0,0,1
Hawthorn,"Wingard, Chad",16,7,2,9,2,0,0,3
Hawthorn,"Worpel, James",15,11,0,4,0,0,0,6
Hawthorn,"Breust, Luke",9,7,2,2,2,2,0,4
Hawthorn,"Ceglar, Jonathon",13,5,4,8,0,0,15,1
Hawthorn,"Cousins, James",22,10,3,12,0,1,0,0
Hawthorn,"Day, Will",21,15,4,6,0,0,0,2
Hawthorn,"Frawley, James",10,7,3,3,0,0,0,0
Hawthorn,"Frost, Sam",8,6,4,2,0,1,0,0
Hawthorn,"Greaves, Damon",17,12,7,5,0,0,0,0
Hawthorn,"Gunston, Jack",10,6,4,4,1,2,0,0
Hawthorn,"Hardwick, Blake",6,5,1,1,1,0,0,2
Hawthorn,"Howe, Daniel",9,3,3,6,0,0,0,0
Hawthorn,"Jiath, Changkuoth",7,4,2,3,0,0,0,3
Hawthorn,"Lewis, Mitch",6,4,3,2,1,1,1,0
Hawthorn,"Mitchell, Tom",27,14,5,13,1,0,0,2
Hawthorn,"Moore, Dylan",6,2,2,4,1,1,0,1
Hawthorn,"Morris, Josh",4,3,1,1,0,1,0,0
Hawthorn,"Morrison, Harry",14,9,2,5,0,0,0,1
Hawthorn,"OBrien, Tim",7,6,5,1,1,0,2,1
Hawthorn,"Scrimshaw, Jack",16,9,3,7,0,0,0,2
Hawthorn,"Scully, Tom",19,10,4,9,1,1,0,1
Hawthorn,"Shiels, Liam",18,8,6,10,0,0,0,3
Hawthorn,"Wingard, Chad",20,9,3,11,0,1,0,8
Hawthorn,"Worpel, James",17,5,0,12,0,0,0,1
Hawthorn,"Breust, Luke",16,9,5,7,1,0,0,3
Hawthorn,"Burgoyne, Shaun",11,6,4,5,0,0,0,5
Hawthorn,"Ceglar, Jonathon",9,1,1,8,0,0,30,1
Hawthorn,"Cousins, James",19,9,2,10,0,0,0,4
Hawthorn,"Day, Will",16,6,2,10,0,0,0,1
Hawthorn,"Frost, Sam",6,2,2,4,0,0,0,2
Hawthorn,"Greaves, Damon",14,10,6,4,0,0,0,3
Hawthorn,"Gunston, Jack",9,6,3,3,3,1,0,3
Hawthorn,"Hardwick, Blake",14,9,1,5,0,0,0,2
Hawthorn,"Howe, Daniel",13,11,2,2,0,0,0,1
Hawthorn,"Lewis, Mitch",7,3,3,4,0,1,9,2
Hawthorn,"Maginness, Finn",10,2,0,8,0,0,0,5
Hawthorn,"McEvoy, Ben",6,3,3,3,0,0,0,4
Hawthorn,"Mitchell, Tom",12,3,1,9,0,0,0,7
Hawthorn,"Moore, Dylan",9,6,4,3,0,0,0,3
Hawthorn,"Morrison, Harry",16,7,4,9,0,0,0,3
Hawthorn,"OBrien, Tim",10,8,5,2,1,0,7,2
Hawthorn,"OMeara, Jaeger",17,7,1,10,0,0,0,4
Hawthorn,"Puopolo, Paul",9,4,1,5,0,0,0,2
Hawthorn,"Scrimshaw, Jack",12,8,4,4,0,0,0,5
Hawthorn,"Shiels, Liam",21,12,2,9,0,0,0,4
Hawthorn,"Wingard, Chad",14,8,2,6,1,0,0,5
Hawthorn,"Breust, Luke",17,9,3,8,2,0,0,1
Hawthorn,"Burgoyne, Shaun",11,3,3,8,1,0,0,0
Hawthorn,"Ceglar, Jonathon",8,4,4,4,0,0,17,4
Hawthorn,"Cousins, James",24,12,7,12,0,1,0,3
Hawthorn,"Day, Will",18,11,5,7,0,0,0,0
Hawthorn,"Frawley, James",9,4,5,5,0,0,0,2
Hawthorn,"Frost, Sam",12,8,3,4,0,1,0,1
Hawthorn,"Greaves, Damon",21,13,4,8,0,0,0,2
Hawthorn,"Gunston, Jack",18,15,11,3,4,2,0,0
Hawthorn,"Hardwick, Blake",13,9,3,4,0,0,0,0
Hawthorn,"Lewis, Mitch",12,7,5,5,2,0,2,1
Hawthorn,"McEvoy, Ben",9,5,5,4,0,0,8,0
Hawthorn,"Mitchell, Tom",34,16,7,18,0,0,0,2
Hawthorn,"Moore, Dylan",25,10,8,15,1,0,0,1
Hawthorn,"Morrison, Harry",17,9,1,8,0,0,0,1
Hawthorn,"OBrien, Tim",8,6,4,2,2,0,3,2
Hawthorn,"OMeara, Jaeger",25,10,4,15,0,0,0,3
Hawthorn,"Puopolo, Paul",11,6,2,5,3,0,0,3
Hawthorn,"Scrimshaw, Jack",16,8,4,8,0,0,0,3
Hawthorn,"Shiels, Liam",26,13,1,13,1,0,0,5
Hawthorn,"Stratton, Ben",13,5,5,8,1,0,0,2
Hawthorn,"Wingard, Chad",23,11,2,12,0,1,0,1
Melbourne,"Bedford, Toby",8,2,1,6,0,0,0,2
Melbourne,"Brayshaw, Angus",18,8,3,10,0,2,0,2
Melbourne,"Brown, Mitch",8,4,3,4,0,0,0,1
Melbourne,"Fritsch, Bayley",9,7,5,2,0,2,0,0
Melbourne,"Gawn, Max",14,8,6,6,0,0,18,0
Melbourne,"Harmes, James",18,5,2,13,0,0,0,3
Melbourne,"Hibberd, Michael",21,16,9,5,0,0,0,0
Melbourne,"Jetta, Neville",7,3,3,4,0,0,0,1
Melbourne,"Langdon, Ed",31,23,4,8,0,1,0,1
Melbourne,"Lever, Jake",9,6,3,3,0,0,0,1
Melbourne,"Lockhart, Jay",13,6,2,7,0,0,0,1
Melbourne,"May, Steven",10,9,4,1,0,0,0,0
Melbourne,"McDonald, Oscar",14,9,3,5,0,0,0,0
Melbourne,"McDonald, Tom",7,5,4,2,2,0,1,0
Melbourne,"Melksham, Jake",8,4,3,4,1,0,0,0
Melbourne,"Neal-Bullen, Alex",12,7,3,5,1,0,0,2
Melbourne,"Oliver, Clayton",20,8,3,12,0,0,0,4
Melbourne,"Petracca, Christian",24,11,6,13,0,0,0,3
Melbourne,"Pickett, Kysaiah",11,7,1,4,2,2,0,1
Melbourne,"Spargo, Charlie",8,6,1,2,0,0,0,0
Melbourne,"Tomlinson, Adam",14,9,6,5,0,0,0,1
Melbourne,"Viney, Jack",34,14,5,20,1,1,0,6
Melbourne,"Bennell, Harley",14,6,3,8,0,0,0,1
Melbourne,"Brayshaw, Angus",15,8,4,7,0,1,0,5
Melbourne,"Fritsch, Bayley",9,8,4,1,1,4,0,4
Melbourne,"Gawn, Max",21,13,4,8,0,0,34,5
Melbourne,"Harmes, James",18,8,4,10,0,0,0,2
Melbourne,"Hunt, Jayden",7,4,3,3,3,0,0,2
Melbourne,"Jackson, Luke",7,4,1,3,0,1,0,1
Melbourne,"Jetta, Neville",9,3,0,6,0,0,0,1
Melbourne,"Jones, Nathan",11,3,3,8,0,0,0,1
Melbourne,"Langdon, Ed",23,16,5,7,0,0,0,1
Melbourne,"Lever, Jake",6,4,3,2,0,0,0,1
Melbourne,"May, Steven",13,9,0,4,0,0,0,1
Melbourne,"McDonald, Tom",9,7,4,2,0,0,0,2
Melbourne,"Melksham, Jake",10,6,2,4,0,0,0,2
Melbourne,"Neal-Bullen, Alex",9,5,1,4,2,0,0,1
Melbourne,"Oliver, Clayton",28,12,5,16,0,0,0,5
Melbourne,"Petracca, Christian",24,12,5,12,2,0,0,6
Melbourne,"Rivers, Trent",12,7,3,5,0,0,0,2
Melbourne,"Salem, Christian",21,19,4,2,0,0,0,1
Melbourne,"Smith, Joel",7,4,2,3,0,0,0,1
Melbourne,"Tomlinson, Adam",16,7,6,9,0,0,0,2
Melbourne,"Viney, Jack",18,8,3,10,0,0,0,3
Melbourne,"Brayshaw, Angus",15,7,0,8,2,0,0,5
Melbourne,"Fritsch, Bayley",5,5,4,0,1,1,0,0
Melbourne,"Gawn, Max",17,11,3,6,0,0,33,2
Melbourne,"Hannan, Mitch",7,4,4,3,0,1,0,2
Melbourne,"Harmes, James",18,2,3,16,0,0,0,0
Melbourne,"Hibberd, Michael",11,7,3,4,0,0,0,1
Melbourne,"Hunt, Jayden",5,3,0,2,1,0,0,4
Melbourne,"Langdon, Ed",16,9,6,7,0,0,0,0
Melbourne,"Lever, Jake",10,6,2,4,0,0,0,0
Melbourne,"Lockhart, Jay",8,6,2,2,0,0,0,3
Melbourne,"May, Steven",10,9,3,1,0,0,0,0
Melbourne,"McDonald, Tom",8,4,2,4,1,0,0,1
Melbourne,"Melksham, Jake",11,10,2,1,0,2,0,1
Melbourne,"Oliver, Clayton",23,10,2,13,0,0,0,6
Melbourne,"Petracca, Christian",18,9,2,9,1,1,0,4
Melbourne,"Pickett, Kysaiah",10,4,0,6,0,1,0,3
Melbourne,"Rivers, Trent",12,7,1,5,0,0,0,3
Melbourne,"Salem, Christian",11,9,4,2,0,0,0,2
Melbourne,"Smith, Joel",6,4,2,2,0,0,0,1
Melbourne,"Tomlinson, Adam",19,15,5,4,0,1,0,3
Melbourne,"Vandenberg, Aaron",7,1,0,6,0,0,0,3
Melbourne,"Viney, Jack",21,10,2,11,0,0,0,3
Melbourne,"Brayshaw, Angus",17,6,2,11,0,0,0,5
Melbourne,"Fritsch, Bayley",16,11,9,5,2,0,0,1
Melbourne,"Gawn, Max",22,12,5,10,0,0,33,6
Melbourne,"Hannan, Mitch",10,6,2,4,3,1,0,3
Melbourne,"Harmes, James",19,10,1,9,0,0,0,1
Melbourne,"Hibberd, Michael",25,11,5,14,0,0,0,3
Melbourne,"Hunt, Jayden",4,3,2,1,0,0,0,1
Melbourne,"Langdon, Ed",16,8,4,8,0,0,0,2
Melbourne,"Lever, Jake",7,5,3,2,0,0,0,1
Melbourne,"Lockhart, Jay",11,4,4,7,0,0,0,1
Melbourne,"May, Steven",20,16,8,4,0,0,0,1
Melbourne,"McDonald, Tom",13,7,5,6,1,0,0,0
Melbourne,"Melksham, Jake",3,3,3,0,2,1,0,0
Melbourne,"Oliver, Clayton",26,8,3,18,0,0,0,1
Melbourne,"Petracca, Christian",27,7,3,20,0,0,0,1
Melbourne,"Pickett, Kysaiah",5,4,1,1,0,1,0,6
Melbourne,"Rivers, Trent",8,4,2,4,0,0,0,1
Melbourne,"Salem, Christian",21,16,3,5,0,0,0,0
Melbourne,"Smith, Joel",7,5,2,2,0,0,0,2
Melbourne,"Tomlinson, Adam",13,8,2,5,0,0,1,3
Melbourne,"Vandenberg, Aaron",14,6,4,8,0,0,0,3
Melbourne,"Viney, Jack",18,7,3,11,0,0,0,3
Melbourne,"Bennell, Harley",13,7,2,6,1,1,0,0
Melbourne,"Brayshaw, Angus",12,9,1,3,0,1,0,0
Melbourne,"Fritsch, Bayley",9,7,2,2,2,1,0,0
Melbourne,"Gawn, Max",15,10,8,5,0,0,30,3
Melbourne,"Hannan, Mitch",8,8,1,0,1,0,0,2
Melbourne,"Harmes, James",14,9,2,5,1,0,0,1
Melbourne,"Hibberd, Michael",11,8,4,3,1,0,0,1
Melbourne,"Jetta, Neville",5,1,1,4,0,0,0,0
Melbourne,"Langdon, Ed",19,13,4,6,0,1,0,0
Melbourne,"Lever, Jake",11,8,6,3,0,0,0,2
Melbourne,"Lockhart, Jay",4,3,2,1,0,0,0,2
Melbourne,"May, Steven",18,14,5,4,0,0,0,1
Melbourne,"McDonald, Oscar",9,6,3,3,0,0,0,4
Melbourne,"McDonald, Tom",3,2,2,1,0,0,0,0
Melbourne,"Melksham, Jake",14,5,3,9,1,0,0,3
Melbourne,"Oliver, Clayton",24,14,3,10,0,0,0,5
Melbourne,"Petracca, Christian",25,11,6,14,2,0,0,1
Melbourne,"Pickett, Kysaiah",8,5,1,3,0,0,0,1
Melbourne,"Salem, Christian",18,12,2,6,1,0,0,2
Melbourne,"Vandenberg, Aaron",11,6,3,5,0,1,0,3
Melbourne,"Viney, Jack",21,10,3,11,0,0,0,8
Melbourne,"Weideman, Sam",7,4,3,3,2,0,0,0
Melbourne,"Bennell, Harley",11,5,1,6,1,0,0,0
Melbourne,"Brayshaw, Angus",16,8,2,8,0,0,0,2
Melbourne,"Fritsch, Bayley",9,8,6,1,2,2,0,1
Melbourne,"Gawn, Max",22,15,8,7,0,0,27,1
Melbourne,"Hannan, Mitch",11,3,1,8,2,0,0,3
Melbourne,"Harmes, James",15,9,6,6,0,1,0,3
Melbourne,"Hibberd, Michael",16,8,3,8,0,0,0,2
Melbourne,"Jackson, Luke",14,5,3,9,1,0,3,3
Melbourne,"Jetta, Neville",7,4,1,3,0,0,0,4
Melbourne,"Langdon, Ed",17,8,4,9,0,0,0,1
Melbourne,"Lever, Jake",10,7,5,3,0,0,0,2
Melbourne,"Lockhart, Jay",6,2,1,4,0,0,0,2
Melbourne,"May, Steven",19,14,5,5,0,0,0,0
Melbourne,"McDonald, Oscar",11,8,5,3,0,0,0,1
Melbourne,"Melksham, Jake",9,7,5,2,1,0,0,1
Melbourne,"Oliver, Clayton",29,16,6,13,0,0,0,6
Melbourne,"Petracca, Christian",29,12,3,17,1,1,0,2
Melbourne,"Pickett, Kysaiah",6,4,1,2,2,0,0,1
Melbourne,"Salem, Christian",17,6,5,11,0,0,0,2
Melbourne,"Vandenberg, Aaron",13,8,1,5,0,0,0,4
Melbourne,"Viney, Jack",19,10,1,9,1,1,0,6
Melbourne,"Weideman, Sam",10,8,6,2,3,2,0,0
Melbourne,"Bennell, Harley",11,6,1,5,0,1,0,2
Melbourne,"Brayshaw, Angus",9,4,1,5,0,0,0,2
Melbourne,"Fritsch, Bayley",6,3,2,3,2,0,0,1
Melbourne,"Gawn, Max",13,8,3,5,0,0,41,5
Melbourne,"Hannan, Mitch",4,2,2,2,0,0,0,2
Melbourne,"Harmes, James",12,8,2,4,0,1,0,2
Melbourne,"Hibberd, Michael",10,7,2,3,0,0,0,1
Melbourne,"Jackson, Luke",8,2,2,6,0,0,3,0
Melbourne,"Jetta, Neville",2,1,0,1,0,0,0,0
Melbourne,"Jones, Nathan",13,9,4,4,1,0,0,1
Melbourne,"Langdon, Ed",17,11,4,6,0,1,0,1
Melbourne,"Lever, Jake",12,8,3,4,0,0,0,1
Melbourne,"Lockhart, Jay",10,6,3,4,0,0,0,1
Melbourne,"May, Steven",17,11,2,6,0,0,0,1
Melbourne,"McDonald, Oscar",6,4,2,2,0,0,0,1
Melbourne,"Melksham, Jake",10,9,2,1,3,0,0,1
Melbourne,"Oliver, Clayton",28,12,5,16,0,0,0,10
Melbourne,"Petracca, Christian",24,11,1,13,0,0,0,8
Melbourne,"Pickett, Kysaiah",5,3,0,2,0,1,0,4
Melbourne,"Salem, Christian",17,14,5,3,0,0,0,4
Melbourne,"Viney, Jack",24,13,1,11,1,0,0,3
Melbourne,"Weideman, Sam",6,3,4,3,0,2,0,1
Melbourne,"Brayshaw, Angus",11,2,1,9,0,0,0,5
Melbourne,"Fritsch, Bayley",13,4,4,9,0,0,0,0
Melbourne,"Gawn, Max",11,9,5,2,0,0,40,3
Melbourne,"Hannan, Mitch",6,3,3,3,0,0,0,0
Melbourne,"Harmes, James",16,8,3,8,0,0,0,1
Melbourne,"Hibberd, Michael",18,9,3,9,0,0,0,0
Melbourne,"Jackson, Luke",4,2,0,2,0,1,4,0
Melbourne,"Jones, Nathan",14,5,4,9,0,0,0,3
Melbourne,"Langdon, Ed",14,9,4,5,0,0,0,1
Melbourne,"Lever, Jake",12,8,6,4,0,0,0,2
Melbourne,"Lockhart, Jay",12,9,4,3,0,2,0,1
Melbourne,"May, Steven",17,15,0,2,0,0,0,0
Melbourne,"McDonald, Oscar",11,4,1,7,0,0,0,0
Melbourne,"McDonald, Tom",7,5,4,2,0,1,0,1
Melbourne,"Melksham, Jake",10,7,3,3,1,1,0,0
Melbourne,"Oliver, Clayton",23,9,2,14,0,1,0,8
Melbourne,"Petracca, Christian",24,10,2,14,1,1,0,4
Melbourne,"Pickett, Kysaiah",11,6,1,5,0,0,0,2
Melbourne,"Salem, Christian",22,8,4,14,0,0,0,4
Melbourne,"Sparrow, Tom",15,6,1,9,0,0,0,2
Melbourne,"Viney, Jack",19,10,2,9,0,0,0,4
Melbourne,"Weideman, Sam",5,2,2,3,2,0,0,1
Melbourne,"Bennell, Harley",5,2,0,3,1,0,0,2
Melbourne,"Brayshaw, Angus",17,10,4,7,0,0,0,2
Melbourne,"Fritsch, Bayley",8,7,5,1,2,0,0,4
Melbourne,"Gawn, Max",11,3,3,8,0,0,29,2
Melbourne,"Harmes, James",15,7,1,8,0,0,0,2
Melbourne,"Hibberd, Michael",11,9,1,2,0,0,0,0
Melbourne,"Jackson, Luke",8,4,2,4,2,0,14,1
Melbourne,"Jones, Nathan",13,8,5,5,0,1,0,5
Melbourne,"Langdon, Ed",17,9,2,8,0,2,0,2
Melbourne,"Lever, Jake",10,7,3,3,0,0,0,1
Melbourne,"Lockhart, Jay",7,5,2,2,0,0,0,2
Melbourne,"May, Steven",16,12,5,4,0,0,0,2
Melbourne,"Melksham, Jake",11,8,4,3,2,1,0,3
Melbourne,"Neal-Bullen, Alex",7,3,1,4,0,0,0,4
Melbourne,"Oliver, Clayton",34,17,5,17,1,0,0,6
Melbourne,"Petracca, Christian",20,12,4,8,0,3,0,8
Melbourne,"Salem, Christian",26,20,4,6,0,0,0,1
Melbourne,"Sparrow, Tom",11,4,3,7,0,0,0,2
Melbourne,"Tomlinson, Adam",8,6,3,2,0,0,0,1
Melbourne,"Vandenberg, Aaron",6,5,2,1,0,0,0,2
Melbourne,"Viney, Jack",22,12,3,10,2,1,0,2
Melbourne,"Weideman, Sam",7,6,4,1,3,0,0,2
Melbourne,"Brayshaw, Angus",29,17,4,12,1,1,0,3
Melbourne,"Fritsch, Bayley",14,11,4,3,2,4,0,1
Melbourne,"Hannan, Mitch",13,8,4,5,1,1,0,0
Melbourne,"Harmes, James",8,3,1,5,0,0,0,1
Melbourne,"Hibberd, Michael",19,12,5,7,0,0,0,2
Melbourne,"Jackson, Luke",11,2,1,9,0,0,5,3
Melbourne,"Jones, Nathan",13,8,1,5,0,1,0,0
Melbourne,"Langdon, Ed",23,12,4,11,0,0,0,2
Melbourne,"Lever, Jake",12,10,7,2,0,0,0,2
Melbourne,"May, Steven",10,10,4,0,0,0,0,0
Melbourne,"McDonald, Tom",13,9,3,4,1,0,2,7
Melbourne,"Melksham, Jake",7,5,4,2,1,0,0,2
Melbourne,"Oliver, Clayton",31,17,3,14,1,0,0,5
Melbourne,"Petracca, Christian",29,13,5,16,1,2,0,3
Melbourne,"Pickett, Kysaiah",12,7,3,5,1,2,0,3
Melbourne,"Rivers, Trent",14,6,6,8,0,0,0,0
Melbourne,"Salem, Christian",18,10,2,8,0,0,0,2
Melbourne,"Spargo, Charlie",12,8,5,4,1,0,0,1
Melbourne,"Sparrow, Tom",17,9,3,8,1,0,0,4
Melbourne,"Tomlinson, Adam",13,6,2,7,0,0,0,0
Melbourne,"Vandenberg, Aaron",11,6,6,5,0,0,0,3
Melbourne,"Weideman, Sam",13,5,5,8,2,3,0,0
Melbourne,"Brayshaw, Angus",23,11,7,12,1,0,0,4
Melbourne,"Fritsch, Bayley",14,11,7,3,2,1,0,1
Melbourne,"Harmes, James",15,6,2,9,0,0,0,3
Melbourne,"Hibberd, Michael",17,12,6,5,0,0,0,1
Melbourne,"Jones, Nathan",16,5,2,11,0,0,0,2
Melbourne,"Langdon, Ed",22,13,3,9,2,0,0,2
Melbourne,"Lever, Jake",10,4,2,6,0,0,0,2
Melbourne,"Lockhart, Jay",10,8,5,2,0,0,0,3
Melbourne,"May, Steven",17,14,5,3,0,0,0,2
Melbourne,"McDonald, Tom",8,3,2,5,1,0,2,2
Melbourne,"Melksham, Jake",13,9,3,4,2,0,0,0
Melbourne,"Oliver, Clayton",24,10,3,14,0,0,0,4
Melbourne,"Petracca, Christian",24,14,5,10,1,1,0,1
Melbourne,"Pickett, Kysaiah",5,4,1,1,1,0,0,1
Melbourne,"Preuss, Braydon",12,8,3,4,0,0,24,0
Melbourne,"Salem, Christian",22,16,10,6,0,0,0,2
Melbourne,"Spargo, Charlie",7,6,2,1,3,0,0,2
Melbourne,"Sparrow, Tom",8,5,1,3,1,0,0,3
Melbourne,"Tomlinson, Adam",10,8,5,2,0,0,0,0
Melbourne,"Vandenberg, Aaron",18,11,2,7,0,0,0,0
Melbourne,"Viney, Jack",19,14,3,5,0,0,0,2
Melbourne,"Weideman, Sam",8,6,5,2,2,0,0,1
Melbourne,"Brayshaw, Angus",21,11,6,10,0,0,0,3
Melbourne,"Fritsch, Bayley",12,12,10,0,1,2,0,0
Melbourne,"Hannan, Mitch",6,3,1,3,0,0,0,3
Melbourne,"Harmes, James",12,3,0,9,0,0,0,1
Melbourne,"Hibberd, Michael",16,11,5,5,0,0,0,3
Melbourne,"Langdon, Ed",18,7,4,11,0,0,0,1
Melbourne,"Lever, Jake",14,10,9,4,0,0,0,1
Melbourne,"Lockhart, Jay",7,6,3,1,0,0,0,3
Melbourne,"May, Steven",15,13,6,2,0,0,0,1
Melbourne,"McDonald, Tom",9,8,3,1,1,0,11,2
Melbourne,"Melksham, Jake",9,6,4,3,1,3,0,1
Melbourne,"Oliver, Clayton",15,9,4,6,1,0,0,7
Melbourne,"Petracca, Christian",26,14,2,12,0,0,0,1
Melbourne,"Pickett, Kysaiah",6,3,1,3,0,2,0,5
Melbourne,"Preuss, Braydon",8,6,2,2,0,0,31,0
Melbourne,"Salem, Christian",19,12,4,7,0,0,0,3
Melbourne,"Spargo, Charlie",4,2,1,2,1,0,0,1
Melbourne,"Sparrow, Tom",5,2,1,3,0,1,0,2
Melbourne,"Tomlinson, Adam",14,6,3,8,0,0,0,2
Melbourne,"Vandenberg, Aaron",11,6,3,5,0,0,0,1
Melbourne,"Viney, Jack",24,14,2,10,0,0,0,4
Melbourne,"Weideman, Sam",13,7,3,6,2,0,0,1
Melbourne,"Brayshaw, Angus",13,7,4,6,0,0,0,2
Melbourne,"Brown, Mitch",8,6,4,2,1,0,0,3
Melbourne,"Gawn, Max",15,8,2,7,1,0,30,2
Melbourne,"Hannan, Mitch",7,4,3,3,0,0,0,0
Melbourne,"Hibberd, Michael",16,9,6,7,0,0,0,0
Melbourne,"Jones, Nathan",14,6,1,8,0,0,0,1
Melbourne,"Langdon, Ed",22,16,8,6,0,0,0,3
Melbourne,"Lever, Jake",9,7,5,2,0,0,0,0
Melbourne,"May, Steven",22,14,9,8,0,0,0,1
Melbourne,"McDonald, Oscar",11,8,3,3,0,0,0,0
Melbourne,"Melksham, Jake",8,7,5,1,0,0,0,2
Melbourne,"Oliver, Clayton",26,8,3,18,0,0,0,4
Melbourne,"Petracca, Christian",15,11,3,4,4,1,0,2
Melbourne,"Pickett, Kysaiah",4,2,2,2,0,0,0,2
Melbourne,"Rivers, Trent",16,11,6,5,0,0,0,1
Melbourne,"Salem, Christian",21,11,4,10,0,0,0,2
Melbourne,"Spargo, Charlie",8,3,1,5,0,0,0,3
Melbourne,"Tomlinson, Adam",11,8,3,3,0,0,0,2
Melbourne,"Vandenberg, Aaron",9,5,2,4,0,0,0,0
Melbourne,"Viney, Jack",9,5,0,4,0,0,0,6
Melbourne,"Wagner, Josh",15,10,5,5,0,0,0,0
Melbourne,"Weideman, Sam",8,5,2,3,2,1,0,0
Melbourne,"Brayshaw, Angus",17,8,1,9,1,1,0,1
Melbourne,"Brown, Mitch",8,4,3,4,1,1,0,2
Melbourne,"Fritsch, Bayley",13,7,4,6,0,1,0,2
Melbourne,"Gawn, Max",15,13,6,2,0,1,37,1
Melbourne,"Harmes, James",12,9,3,3,1,0,0,7
Melbourne,"Jones, Nathan",10,6,3,4,0,1,0,0
Melbourne,"Langdon, Ed",26,16,9,10,0,2,0,2
Melbourne,"Lever, Jake",14,9,2,5,0,0,0,2
Melbourne,"May, Steven",17,10,4,7,1,0,0,0
Melbourne,"McDonald, Oscar",7,3,0,4,0,0,1,2
Melbourne,"Melksham, Jake",8,6,2,2,0,0,0,0
Melbourne,"Neal-Bullen, Alex",13,6,3,7,1,0,0,4
Melbourne,"Oliver, Clayton",26,11,2,15,0,0,0,8
Melbourne,"Petracca, Christian",21,12,2,9,0,1,0,2
Melbourne,"Rivers, Trent",16,8,3,8,0,0,0,1
Melbourne,"Salem, Christian",14,9,2,5,0,0,0,3
Melbourne,"Smith, Joel",4,1,0,3,0,0,0,2
Melbourne,"Spargo, Charlie",9,5,3,4,1,0,0,2
Melbourne,"Tomlinson, Adam",18,14,8,4,0,0,0,2
Melbourne,"Viney, Jack",12,7,2,5,0,1,0,6
Melbourne,"Wagner, Josh",10,4,0,6,0,0,0,3
Melbourne,"Weideman, Sam",2,2,0,0,0,0,0,0
Melbourne,"Baker, Oskar",12,7,1,5,0,0,0,0
Melbourne,"Bedford, Toby",8,4,2,4,0,1,0,2
Melbourne,"Fritsch, Bayley",17,10,4,7,1,1,0,1
Melbourne,"Gawn, Max",14,11,5,3,0,0,36,1
Melbourne,"Hibberd, Michael",7,5,0,2,0,0,0,0
Melbourne,"Hunt, Jayden",7,6,0,1,1,1,0,0
Melbourne,"Langdon, Ed",14,10,1,4,0,0,0,2
Melbourne,"Lever, Jake",4,1,0,3,0,0,0,1
Melbourne,"May, Steven",11,7,1,4,0,0,0,2
Melbourne,"Melksham, Jake",9,7,2,2,0,0,0,2
Melbourne,"Neal-Bullen, Alex",6,6,2,0,0,0,0,3
Melbourne,"Oliver, Clayton",25,16,0,9,0,0,0,4
Melbourne,"Petracca, Christian",25,16,1,9,0,2,0,4
Melbourne,"Pickett, Kysaiah",6,2,0,4,0,1,0,3
Melbourne,"Preuss, Braydon",3,2,1,1,0,0,9,1
Melbourne,"Rivers, Trent",15,13,2,2,0,2,0,1
Melbourne,"Salem, Christian",13,11,1,2,0,0,0,4
Melbourne,"Smith, Joel",5,2,0,3,0,0,0,2
Melbourne,"Tomlinson, Adam",6,4,3,2,0,0,0,2
Melbourne,"Vandenberg, Aaron",14,5,2,9,1,0,0,5
Melbourne,"Viney, Jack",27,14,1,13,0,0,0,5
Melbourne,"Weideman, Sam",7,3,3,4,1,0,0,0
Melbourne,"Baker, Oskar",14,10,3,4,2,0,0,2
Melbourne,"Brown, Mitch",13,11,7,2,0,0,1,0
Melbourne,"Fritsch, Bayley",8,7,4,1,1,1,0,1
Melbourne,"Gawn, Max",15,11,1,4,0,0,44,4
Melbourne,"Hunt, Jayden",5,4,2,1,1,1,0,0
Melbourne,"Jetta, Neville",7,2,1,5,0,0,0,2
Melbourne,"Langdon, Ed",23,19,9,4,0,1,0,0
Melbourne,"Lever, Jake",11,8,6,3,0,0,0,4
Melbourne,"May, Steven",19,18,8,1,0,0,0,1
Melbourne,"Melksham, Jake",12,6,2,6,0,0,0,5
Melbourne,"Neal-Bullen, Alex",9,6,2,3,1,0,0,1
Melbourne,"Oliver, Clayton",23,11,2,12,0,0,0,7
Melbourne,"Petracca, Christian",22,12,1,10,1,1,0,4
Melbourne,"Pickett, Kysaiah",15,8,4,7,1,3,0,1
Melbourne,"Rivers, Trent",16,10,2,6,2,0,0,3
Melbourne,"Salem, Christian",19,13,4,6,1,0,0,5
Melbourne,"Smith, Joel",4,3,2,1,0,0,0,2
Melbourne,"Spargo, Charlie",13,7,5,6,2,0,0,2
Melbourne,"Tomlinson, Adam",7,5,3,2,0,0,0,3
Melbourne,"Vandenberg, Aaron",13,8,5,5,0,0,0,4
Melbourne,"Viney, Jack",14,8,4,6,0,0,0,3
Melbourne,"Weideman, Sam",7,4,1,3,0,0,0,0
Melbourne,"Baker, Oskar",15,13,4,2,0,0,0,3
Melbourne,"Brown, Mitch",20,14,13,6,0,2,2,0
Melbourne,"Fritsch, Bayley",14,10,7,4,3,4,0,0
Melbourne,"Gawn, Max",17,10,4,7,0,0,26,0
Melbourne,"Hibberd, Michael",16,11,10,5,0,0,0,0
Melbourne,"Hunt, Jayden",7,7,3,0,4,0,0,0
Melbourne,"Langdon, Ed",23,17,13,6,0,0,0,1
Melbourne,"Lever, Jake",17,13,10,4,0,0,0,2
Melbourne,"May, Steven",21,15,7,6,0,0,0,1
Melbourne,"Melksham, Jake",8,5,0,3,0,0,0,0
Melbourne,"Neal-Bullen, Alex",7,3,2,4,2,0,0,1
Melbourne,"Oliver, Clayton",20,7,6,13,0,0,0,2
Melbourne,"Petracca, Christian",23,14,7,9,1,0,0,1
Melbourne,"Pickett, Kysaiah",5,3,1,2,0,0,0,2
Melbourne,"Rivers, Trent",14,9,3,5,0,0,0,1
Melbourne,"Salem, Christian",22,14,6,8,0,0,0,4
Melbourne,"Smith, Joel",5,4,1,1,0,0,0,0
Melbourne,"Spargo, Charlie",4,1,1,3,0,1,0,1
Melbourne,"Tomlinson, Adam",13,10,7,3,0,0,0,1
Melbourne,"Vandenberg, Aaron",15,6,4,9,0,0,0,3
Melbourne,"Viney, Jack",17,10,5,7,0,0,0,3
Melbourne,"Weideman, Sam",7,4,3,3,0,0,0,0
North Melbourne,"Ahern, Paul",4,3,1,1,0,0,0,0
North Melbourne,"Anderson, Jed",16,8,2,8,0,1,0,2
North Melbourne,"Atley, Shaun",15,7,2,8,0,0,0,2
North Melbourne,"Brown, Ben",9,5,3,4,1,1,0,3
North Melbourne,"Cunnington, Ben",25,12,4,13,2,0,1,7
North Melbourne,"Dumont, Trent",19,11,6,8,0,1,0,0
North Melbourne,"Goldstein, Todd",14,7,2,7,1,0,27,0
North Melbourne,"Hall, Aaron",9,5,1,4,1,0,0,3
North Melbourne,"Higgins, Shaun",21,11,2,10,0,0,0,5
North Melbourne,"Larkey, Nick",7,4,2,3,1,1,0,1
North Melbourne,"Macmillan, Jamie",15,10,1,5,0,0,0,1
North Melbourne,"McDonald, Luke",10,4,2,6,0,0,0,3
North Melbourne,"Murphy, Tom",7,3,0,4,0,0,0,2
North Melbourne,"Pittard, Jasper",9,8,3,1,0,0,0,2
North Melbourne,"Polec, Jared",25,18,4,7,0,1,0,1
North Melbourne,"Simpkin, Jy",23,15,3,8,1,0,0,3
North Melbourne,"Tarrant, Robbie",12,6,5,6,0,0,0,1
North Melbourne,"Taylor, Curtis",10,8,3,2,1,0,0,2
North Melbourne,"Thomas, Tarryn",9,3,2,6,0,0,0,7
North Melbourne,"Walker, Josh",1,0,0,1,0,0,0,0
North Melbourne,"Ziebell, Jack",6,4,2,2,0,1,0,1
North Melbourne,"Zurhaar, Cameron",8,3,1,5,0,1,0,5
North Melbourne,"Anderson, Jed",16,5,1,11,0,0,0,7
North Melbourne,"Atley, Shaun",22,11,4,11,0,0,0,1
North Melbourne,"Brown, Ben",10,9,6,1,1,2,0,1
North Melbourne,"Cunnington, Ben",21,5,1,16,0,0,0,3
North Melbourne,"Dumont, Trent",22,12,3,10,0,0,0,6
North Melbourne,"Goldstein, Todd",19,9,2,10,1,0,51,3
North Melbourne,"Hall, Aaron",10,7,3,3,0,2,0,6
North Melbourne,"Hayden, Kyron",8,4,1,4,0,0,0,1
North Melbourne,"Higgins, Shaun",28,11,2,17,0,0,0,4
North Melbourne,"Macmillan, Jamie",12,7,2,5,0,0,0,3
North Melbourne,"McDonald, Luke",12,7,3,5,0,0,0,2
North Melbourne,"Pittard, Jasper",12,6,1,6,1,0,0,1
North Melbourne,"Polec, Jared",23,13,4,10,1,0,0,3
North Melbourne,"Scott, Bailey",6,4,3,2,1,0,0,1
North Melbourne,"Simpkin, Jy",25,14,2,11,0,0,0,1
North Melbourne,"Tarrant, Robbie",18,15,5,3,0,0,0,1
North Melbourne,"Taylor, Curtis",14,7,5,7,1,0,0,3
North Melbourne,"Thomas, Tarryn",6,4,1,2,2,0,0,3
North Melbourne,"Walker, Josh",6,2,1,4,0,0,0,4
North Melbourne,"Wood, Mason",7,2,1,5,0,0,0,0
North Melbourne,"Ziebell, Jack",13,11,7,2,1,1,0,1
North Melbourne,"Zurhaar, Cameron",11,9,2,2,3,1,0,2
North Melbourne,"Ahern, Paul",10,5,1,5,1,0,0,0
North Melbourne,"Anderson, Jed",14,10,3,4,0,0,0,5
North Melbourne,"Atley, Shaun",12,6,2,6,0,0,0,3
North Melbourne,"Bonar, Aiden",8,3,0,5,0,0,0,4
North Melbourne,"Brown, Ben",6,6,3,0,3,2,0,0
North Melbourne,"Dumont, Trent",17,9,3,8,1,1,0,3
North Melbourne,"Goldstein, Todd",18,7,2,11,0,1,35,2
North Melbourne,"Hall, Aaron",21,15,4,6,1,3,0,2
North Melbourne,"Hayden, Kyron",6,2,1,4,0,0,0,4
North Melbourne,"Higgins, Shaun",11,4,2,7,0,0,0,2
North Melbourne,"Macmillan, Jamie",9,4,2,5,0,0,0,3
North Melbourne,"McDonald, Luke",12,5,0,7,0,0,0,2
North Melbourne,"Pittard, Jasper",19,13,3,6,0,0,0,3
North Melbourne,"Polec, Jared",12,5,0,7,0,0,0,3
North Melbourne,"Simpkin, Jy",26,13,2,13,1,1,0,4
North Melbourne,"Tarrant, Robbie",14,10,2,4,0,0,0,2
North Melbourne,"Taylor, Curtis",10,5,2,5,0,0,0,0
North Melbourne,"Thomas, Tarryn",7,2,0,5,0,0,0,2
North Melbourne,"Walker, Josh",10,5,2,5,0,0,0,1
North Melbourne,"Wood, Mason",9,2,1,7,0,0,0,2
North Melbourne,"Ziebell, Jack",14,7,7,7,0,2,0,3
North Melbourne,"Zurhaar, Cameron",7,5,3,2,1,1,0,2
North Melbourne,"Ahern, Paul",12,6,4,6,0,1,0,0
North Melbourne,"Anderson, Jed",20,13,4,7,1,2,0,4
North Melbourne,"Atley, Shaun",14,8,5,6,0,0,0,3
North Melbourne,"Brown, Ben",3,2,0,1,1,0,0,0
North Melbourne,"Dumont, Trent",22,7,3,15,0,0,0,3
North Melbourne,"Goldstein, Todd",18,15,1,3,0,0,30,2
North Melbourne,"Hall, Aaron",14,6,0,8,1,0,0,3
North Melbourne,"Hayden, Kyron",15,6,3,9,0,0,0,0
North Melbourne,"Higgins, Shaun",30,12,2,18,0,0,0,3
North Melbourne,"Mahony, Jack",8,1,0,7,0,0,0,1
North Melbourne,"McDonald, Luke",21,9,5,12,0,0,0,1
North Melbourne,"Pittard, Jasper",24,18,7,6,0,0,0,1
North Melbourne,"Polec, Jared",23,17,4,6,0,0,0,3
North Melbourne,"Simpkin, Jy",23,8,2,15,1,1,0,6
North Melbourne,"Tarrant, Robbie",16,14,4,2,0,0,0,1
North Melbourne,"Taylor, Curtis",11,8,7,3,1,1,0,0
North Melbourne,"Thomas, Tarryn",9,6,4,3,1,0,0,5
North Melbourne,"Walker, Josh",17,7,5,10,0,0,0,0
North Melbourne,"Williams, Marley",13,9,2,4,0,0,0,4
North Melbourne,"Xerri, Tristan",5,2,0,3,1,0,3,3
North Melbourne,"Ziebell, Jack",7,3,0,4,0,0,0,3
North Melbourne,"Zurhaar, Cameron",4,4,3,0,1,0,0,1
North Melbourne,"Anderson, Jed",17,13,1,4,0,0,0,4
North Melbourne,"Atley, Shaun",12,5,2,7,0,0,0,3
North Melbourne,"Brown, Ben",11,9,6,2,0,0,0,0
North Melbourne,"Cunnington, Ben",7,1,1,6,0,0,0,2
North Melbourne,"Dumont, Trent",18,13,2,5,0,0,0,3
North Melbourne,"Goldstein, Todd",15,6,3,9,2,0,31,3
North Melbourne,"Hall, Aaron",5,3,2,2,0,2,0,1
North Melbourne,"Hayden, Kyron",11,6,1,5,0,0,0,2
North Melbourne,"Higgins, Shaun",14,6,2,8,0,1,0,1
North Melbourne,"Macmillan, Jamie",10,7,5,3,0,0,0,3
North Melbourne,"Mahony, Jack",9,4,2,5,0,0,0,1
North Melbourne,"McDonald, Luke",15,7,2,8,0,0,0,6
North Melbourne,"Pittard, Jasper",10,5,1,5,0,0,0,1
North Melbourne,"Polec, Jared",15,11,3,4,0,1,0,3
North Melbourne,"Simpkin, Jy",20,6,0,14,0,0,0,3
North Melbourne,"Tarrant, Robbie",17,15,10,2,0,0,0,1
North Melbourne,"Taylor, Curtis",13,7,5,6,2,0,0,3
North Melbourne,"Thomas, Tarryn",3,2,0,1,0,0,0,1
North Melbourne,"Walker, Josh",17,7,6,10,0,0,0,3
North Melbourne,"Williams, Marley",12,10,3,2,0,1,0,2
North Melbourne,"Xerri, Tristan",6,4,2,2,0,0,2,2
North Melbourne,"Zurhaar, Cameron",11,8,5,3,1,0,0,3
North Melbourne,"Ahern, Paul",13,8,2,5,0,0,0,5
North Melbourne,"Atley, Shaun",15,13,5,2,1,0,0,1
North Melbourne,"Brown, Ben",8,8,4,0,1,0,0,1
North Melbourne,"Campbell, Tom",5,3,1,2,0,0,2,0
North Melbourne,"Dumont, Trent",18,10,3,8,0,0,0,7
North Melbourne,"Goldstein, Todd",19,13,5,6,1,0,30,2
North Melbourne,"Hall, Aaron",23,14,4,9,0,2,0,2
North Melbourne,"Hayden, Kyron",6,5,4,1,0,0,0,2
North Melbourne,"Higgins, Shaun",15,11,3,4,1,0,0,2
North Melbourne,"Macmillan, Jamie",10,6,2,4,0,0,0,4
North Melbourne,"Mahony, Jack",10,3,1,7,0,1,0,3
North Melbourne,"McDonald, Luke",12,5,1,7,0,0,0,5
North Melbourne,"Pittard, Jasper",18,16,5,2,0,0,0,3
North Melbourne,"Polec, Jared",18,13,5,5,0,1,0,4
North Melbourne,"Scott, Bailey",7,6,2,1,1,0,0,1
North Melbourne,"Simpkin, Jy",23,16,3,7,0,1,0,6
North Melbourne,"Tarrant, Robbie",10,10,0,0,0,0,0,1
North Melbourne,"Taylor, Curtis",4,1,0,3,0,1,0,0
North Melbourne,"Thomas, Tarryn",13,7,1,6,0,2,0,1
North Melbourne,"Walker, Josh",8,7,3,1,0,0,0,0
North Melbourne,"Williams, Marley",5,1,0,4,0,0,0,0
North Melbourne,"Zurhaar, Cameron",19,8,2,11,2,1,0,3
North Melbourne,"Atley, Shaun",15,5,2,10,0,0,0,1
North Melbourne,"Bonar, Aiden",11,5,4,6,0,0,0,3
North Melbourne,"Brown, Ben",8,5,4,3,0,3,1,1
North Melbourne,"Dumont, Trent",25,11,4,14,1,0,0,6
North Melbourne,"Goldstein, Todd",14,8,2,6,0,0,26,1
North Melbourne,"Hall, Aaron",22,12,2,10,0,0,0,1
North Melbourne,"Hayden, Kyron",4,3,2,1,0,0,0,0
North Melbourne,"Higgins, Shaun",36,14,5,22,0,0,0,5
North Melbourne,"Macmillan, Jamie",14,9,2,5,0,0,0,1
North Melbourne,"Mahony, Jack",8,3,2,5,0,1,0,2
North Melbourne,"McDonald, Luke",13,6,2,7,0,0,0,3
North Melbourne,"McKay, Ben",5,4,1,1,0,0,0,3
North Melbourne,"Pittard, Jasper",9,4,0,5,0,0,0,2
North Melbourne,"Polec, Jared",23,15,3,8,0,0,0,2
North Melbourne,"Scott, Bailey",8,4,3,4,0,0,0,1
North Melbourne,"Simpkin, Jy",14,8,1,6,0,1,0,1
North Melbourne,"Tarrant, Robbie",18,11,4,7,0,0,0,2
North Melbourne,"Taylor, Curtis",18,10,6,8,0,0,0,2
North Melbourne,"Walker, Josh",14,8,8,6,1,2,1,0
North Melbourne,"Williams, Marley",20,14,2,6,0,0,0,3
North Melbourne,"Wood, Mason",9,4,3,5,0,0,0,2
North Melbourne,"Ziebell, Jack",0,0,0,0,0,0,0,0
North Melbourne,"Anderson, Jed",19,14,5,5,0,0,0,7
North Melbourne,"Atley, Shaun",18,12,5,6,0,0,0,1
North Melbourne,"Brown, Ben",7,5,5,2,1,0,3,0
North Melbourne,"Davies-Uniacke, Luke",7,3,2,4,0,0,0,1
North Melbourne,"Dumont, Trent",22,17,4,5,0,0,0,4
North Melbourne,"Goldstein, Todd",8,2,3,6,0,1,41,2
North Melbourne,"Hall, Aaron",13,6,2,7,1,0,0,5
North Melbourne,"Hayden, Kyron",12,5,3,7,0,0,0,3
North Melbourne,"Higgins, Shaun",19,13,0,6,0,0,0,7
North Melbourne,"Larkey, Nick",5,3,0,2,2,1,0,0
North Melbourne,"Macmillan, Jamie",13,8,5,5,0,0,0,1
North Melbourne,"Mahony, Jack",7,2,0,5,0,0,0,4
North Melbourne,"McDonald, Luke",18,15,4,3,0,0,0,4
North Melbourne,"McKay, Ben",10,5,4,5,0,0,0,0
North Melbourne,"Pittard, Jasper",11,9,4,2,1,0,0,1
North Melbourne,"Polec, Jared",25,13,4,12,1,0,0,6
North Melbourne,"Scott, Bailey",11,6,2,5,3,0,0,4
North Melbourne,"Simpkin, Jy",11,8,3,3,0,0,0,4
North Melbourne,"Tarrant, Robbie",16,14,3,2,0,0,0,3
North Melbourne,"Taylor, Curtis",6,3,2,3,0,0,0,2
North Melbourne,"Walker, Josh",13,8,4,5,0,0,0,2
North Melbourne,"Zurhaar, Cameron",8,4,1,4,0,1,0,2
North Melbourne,"Anderson, Jed",28,17,4,11,1,0,0,8
North Melbourne,"Atley, Shaun",20,7,8,13,0,0,0,0
North Melbourne,"Bonar, Aiden",12,4,2,8,0,0,0,2
North Melbourne,"Davies-Uniacke, Luke",17,11,5,6,2,0,0,3
North Melbourne,"Daw, Majak",8,6,4,2,1,0,8,4
North Melbourne,"Dumont, Trent",24,11,4,13,0,0,0,6
North Melbourne,"Goldstein, Todd",19,5,0,14,0,2,19,4
North Melbourne,"Hall, Aaron",20,15,9,5,2,0,0,4
North Melbourne,"Hayden, Kyron",17,7,7,10,0,0,0,0
North Melbourne,"Higgins, Shaun",18,11,5,7,2,0,0,4
North Melbourne,"Larkey, Nick",6,5,4,1,2,0,0,1
North Melbourne,"Macmillan, Jamie",17,6,3,11,1,0,0,2
North Melbourne,"Mahony, Jack",10,7,3,3,2,0,0,7
North Melbourne,"McDonald, Luke",35,25,8,10,0,0,0,2
North Melbourne,"McKay, Ben",15,9,8,6,0,0,2,7
North Melbourne,"Pittard, Jasper",15,11,4,4,2,0,0,3
North Melbourne,"Scott, Bailey",14,6,3,8,0,0,0,3
North Melbourne,"Simpkin, Jy",17,10,2,7,1,0,0,1
North Melbourne,"Tarrant, Robbie",13,6,2,7,0,0,0,1
North Melbourne,"Taylor, Curtis",6,2,2,4,0,0,0,2
North Melbourne,"Walker, Josh",17,12,8,5,0,0,0,0
North Melbourne,"Zurhaar, Cameron",10,8,5,2,3,1,0,2
North Melbourne,"Anderson, Jed",22,11,1,11,0,1,0,5
North Melbourne,"Atley, Shaun",13,8,2,5,0,0,0,1
North Melbourne,"Bonar, Aiden",5,3,1,2,0,0,0,1
North Melbourne,"Brown, Ben",0,0,0,0,0,0,0,0
North Melbourne,"Daw, Majak",10,6,4,4,1,1,7,0
North Melbourne,"Dumont, Trent",16,8,0,8,0,0,0,8
North Melbourne,"Goldstein, Todd",15,8,3,7,0,0,17,2
North Melbourne,"Hall, Aaron",12,8,0,4,1,0,0,3
North Melbourne,"Higgins, Shaun",20,12,3,8,0,0,0,2
North Melbourne,"Hosie, Lachlan",9,4,1,5,2,0,0,2
North Melbourne,"Macmillan, Jamie",11,3,3,8,0,0,0,3
North Melbourne,"Mahony, Jack",8,2,0,6,1,0,0,3
North Melbourne,"McDonald, Luke",18,13,3,5,0,0,0,2
North Melbourne,"McKay, Ben",12,2,4,10,0,0,0,0
North Melbourne,"Pittard, Jasper",12,7,2,5,0,0,0,0
North Melbourne,"Polec, Jared",15,8,4,7,1,0,0,4
North Melbourne,"Scott, Bailey",13,9,6,4,1,0,0,2
North Melbourne,"Simpkin, Jy",25,15,2,10,1,0,0,3
North Melbourne,"Tarrant, Robbie",15,10,1,5,0,0,0,1
North Melbourne,"Walker, Josh",10,8,3,2,1,0,0,3
North Melbourne,"Walker, Will",11,6,1,5,0,0,0,4
North Melbourne,"Zurhaar, Cameron",9,4,2,5,0,0,0,2
North Melbourne,"Anderson, Jed",10,2,2,8,0,0,0,8
North Melbourne,"Atley, Shaun",17,8,2,9,0,0,0,2
North Melbourne,"Bonar, Aiden",11,5,0,6,0,0,0,1
North Melbourne,"Davies-Uniacke, Luke",24,9,3,15,0,0,0,2
North Melbourne,"Daw, Majak",8,3,0,5,1,0,6,2
North Melbourne,"Dumont, Trent",27,13,6,14,0,0,0,6
North Melbourne,"Durdin, Sam",6,4,4,2,0,0,0,0
North Melbourne,"Goldstein, Todd",17,3,0,14,0,0,23,2
North Melbourne,"Hall, Aaron",17,11,6,6,0,2,0,1
North Melbourne,"Higgins, Shaun",27,10,3,17,0,0,0,1
North Melbourne,"Larkey, Nick",7,6,3,1,4,0,0,2
North Melbourne,"Macmillan, Jamie",14,7,2,7,0,0,0,2
North Melbourne,"Mahony, Jack",6,0,1,6,0,0,0,4
North Melbourne,"McDonald, Luke",33,22,9,11,0,0,0,2
North Melbourne,"McKay, Ben",13,5,4,8,0,0,0,1
North Melbourne,"Pittard, Jasper",16,8,3,8,0,0,0,0
North Melbourne,"Polec, Jared",18,12,4,6,0,0,0,1
North Melbourne,"Scott, Bailey",9,7,4,2,0,0,0,3
North Melbourne,"Simpkin, Jy",20,12,4,8,0,0,0,4
North Melbourne,"Tarrant, Robbie",23,16,5,7,0,0,0,3
North Melbourne,"Walker, Josh",9,3,1,6,0,0,0,2
North Melbourne,"Zurhaar, Cameron",12,11,3,1,0,1,0,3
North Melbourne,"Anderson, Jed",29,18,5,11,0,0,0,6
North Melbourne,"Atley, Shaun",22,12,5,10,0,0,0,3
North Melbourne,"Davies-Uniacke, Luke",15,8,2,7,0,0,0,4
North Melbourne,"Dumont, Trent",22,7,0,15,0,0,0,6
North Melbourne,"Durdin, Sam",8,5,4,3,0,0,0,1
North Melbourne,"Goldstein, Todd",18,7,4,11,0,0,23,2
North Melbourne,"Higgins, Shaun",24,13,8,11,0,0,0,1
North Melbourne,"Hosie, Lachlan",8,5,3,3,0,0,0,0
North Melbourne,"Larkey, Nick",7,6,4,1,2,2,0,1
North Melbourne,"Mahony, Jack",11,4,1,7,0,0,0,0
North Melbourne,"McDonald, Luke",24,18,5,6,0,0,0,2
North Melbourne,"McKay, Ben",8,2,3,6,0,0,0,2
North Melbourne,"Murphy, Tom",9,5,3,4,1,0,0,2
North Melbourne,"Scott, Bailey",11,5,3,6,1,1,0,1
North Melbourne,"Simpkin, Jy",26,11,4,15,0,0,0,8
North Melbourne,"Vickers-Willis, Ed",8,5,2,3,0,0,0,2
North Melbourne,"Walker, Josh",12,8,6,4,0,0,0,0
North Melbourne,"Walker, Will",15,6,3,9,0,0,0,3
North Melbourne,"Williams, Marley",10,8,3,2,0,0,0,1
North Melbourne,"Wood, Mason",6,6,5,0,0,0,0,1
North Melbourne,"Xerri, Tristan",4,3,1,1,2,0,2,2
North Melbourne,"Zurhaar, Cameron",11,9,3,2,2,1,0,2
North Melbourne,"Ahern, Paul",11,5,1,6,0,0,0,1
North Melbourne,"Anderson, Jed",30,18,4,12,0,0,0,5
North Melbourne,"Atley, Shaun",18,9,3,9,0,0,0,2
North Melbourne,"Davies-Uniacke, Luke",22,13,2,9,0,0,0,3
North Melbourne,"Dumont, Trent",20,10,4,10,1,1,0,3
North Melbourne,"Goldstein, Todd",10,2,0,8,0,1,26,2
North Melbourne,"Higgins, Shaun",26,17,6,9,0,0,0,3
North Melbourne,"Hosie, Lachlan",12,8,4,4,1,1,0,1
North Melbourne,"Larkey, Nick",10,6,3,4,0,0,0,0
North Melbourne,"Mahony, Jack",7,2,2,5,0,0,0,1
North Melbourne,"McDonald, Luke",30,21,9,9,0,0,0,4
North Melbourne,"McKay, Ben",10,4,4,6,0,0,0,3
North Melbourne,"Murphy, Tom",11,8,4,3,0,0,0,2
North Melbourne,"Scott, Bailey",15,11,7,4,1,0,0,2
North Melbourne,"Simpkin, Jy",19,5,2,14,1,0,0,5
North Melbourne,"Tarrant, Robbie",16,11,11,5,0,0,0,1
North Melbourne,"Vickers-Willis, Ed",12,7,5,5,0,0,0,3
North Melbourne,"Walker, Josh",14,11,6,3,0,0,0,0
North Melbourne,"Williams, Marley",16,11,5,5,0,0,0,2
North Melbourne,"Wood, Mason",9,4,1,5,0,0,0,0
North Melbourne,"Xerri, Tristan",4,4,2,0,1,0,2,1
North Melbourne,"Zurhaar, Cameron",10,5,3,5,0,1,0,2
North Melbourne,"Ahern, Paul",13,8,4,5,0,0,0,1
North Melbourne,"Anderson, Jed",20,11,4,9,0,0,0,2
North Melbourne,"Atley, Shaun",17,9,5,8,0,0,0,1
North Melbourne,"Davies-Uniacke, Luke",13,8,2,5,0,0,0,3
North Melbourne,"Daw, Majak",9,2,1,7,0,0,2,2
North Melbourne,"Dumont, Trent",16,11,5,5,0,0,0,2
North Melbourne,"Goldstein, Todd",14,4,1,10,0,0,21,2
North Melbourne,"Hall, Aaron",10,7,2,3,1,1,0,1
North Melbourne,"Higgins, Shaun",13,7,4,6,0,0,0,2
North Melbourne,"Hosie, Lachlan",7,4,3,3,0,0,0,0
North Melbourne,"Larkey, Nick",2,1,1,1,0,0,0,0
North Melbourne,"McDonald, Luke",27,18,4,9,0,0,0,2
North Melbourne,"McKay, Ben",6,1,1,5,0,0,0,0
North Melbourne,"Murphy, Tom",10,9,7,1,0,0,0,1
North Melbourne,"Scott, Bailey",10,8,2,2,0,0,0,1
North Melbourne,"Simpkin, Jy",16,9,2,7,0,0,0,4
North Melbourne,"Tarrant, Robbie",17,11,4,6,0,0,0,1
North Melbourne,"Vickers-Willis, Ed",12,9,3,3,0,0,0,2
North Melbourne,"Walker, Josh",7,4,3,3,0,0,0,0
North Melbourne,"Williams, Marley",13,11,6,2,0,0,0,0
North Melbourne,"Wood, Mason",11,8,4,3,2,1,0,3
North Melbourne,"Zurhaar, Cameron",10,7,3,3,1,1,0,0
North Melbourne,"Anderson, Jed",24,9,2,15,0,0,0,6
North Melbourne,"Atley, Shaun",11,4,3,7,0,0,0,1
North Melbourne,"Davies-Uniacke, Luke",23,9,3,14,0,0,0,2
North Melbourne,"Dumont, Trent",16,10,2,6,0,1,0,5
North Melbourne,"Goldstein, Todd",9,2,1,7,1,0,23,3
North Melbourne,"Hall, Aaron",15,11,6,4,1,0,0,1
North Melbourne,"Higgins, Shaun",19,11,4,8,0,0,0,4
North Melbourne,"Hosie, Lachlan",3,3,1,0,0,0,0,1
North Melbourne,"Larkey, Nick",4,3,1,1,1,0,0,1
North Melbourne,"McDonald, Luke",17,11,3,6,0,0,0,1
North Melbourne,"McKay, Ben",10,5,4,5,0,0,0,0
North Melbourne,"Perez, Flynn",9,5,4,4,0,0,0,3
North Melbourne,"Polec, Jared",15,9,2,6,0,0,0,1
North Melbourne,"Scott, Bailey",13,6,2,7,0,0,0,4
North Melbourne,"Simpkin, Jy",9,6,2,3,0,0,0,1
North Melbourne,"Tarrant, Robbie",20,13,5,7,0,0,0,1
North Melbourne,"Vickers-Willis, Ed",14,7,3,7,0,0,0,3
North Melbourne,"Walker, Josh",9,7,6,2,1,0,1,3
North Melbourne,"Williams, Marley",9,5,1,4,0,0,0,1
North Melbourne,"Wood, Mason",8,5,4,3,1,1,0,1
North Melbourne,"Ziebell, Jack",9,6,5,3,0,1,0,1
North Melbourne,"Zurhaar, Cameron",8,5,1,3,1,1,0,5
North Melbourne,"Anderson, Jed",20,12,2,8,0,0,0,3
North Melbourne,"Atley, Shaun",8,3,0,5,0,0,0,0
North Melbourne,"Bonar, Aiden",6,4,3,2,0,0,0,0
North Melbourne,"Davies-Uniacke, Luke",11,5,0,6,0,0,0,2
North Melbourne,"Dumont, Trent",16,6,1,10,0,0,0,4
North Melbourne,"Garner, Taylor",9,3,3,6,1,0,0,1
North Melbourne,"Goldstein, Todd",9,2,0,7,0,0,28,1
North Melbourne,"Hall, Aaron",14,8,4,6,1,1,0,2
North Melbourne,"Higgins, Shaun",19,14,6,5,0,0,0,2
North Melbourne,"Larkey, Nick",7,3,2,4,1,0,0,2
North Melbourne,"McDonald, Luke",19,10,6,9,0,0,0,1
North Melbourne,"McKay, Ben",5,3,0,2,0,0,0,1
North Melbourne,"Perez, Flynn",4,2,2,2,0,0,0,2
North Melbourne,"Polec, Jared",13,8,1,5,0,0,0,1
North Melbourne,"Scott, Bailey",8,4,1,4,0,0,0,3
North Melbourne,"Simpkin, Jy",15,3,0,12,0,0,0,4
North Melbourne,"Tarrant, Robbie",13,9,4,4,0,0,0,0
North Melbourne,"Vickers-Willis, Ed",8,2,2,6,0,0,0,1
North Melbourne,"Walker, Josh",11,6,2,5,0,1,0,0
North Melbourne,"Wood, Mason",11,7,3,4,0,0,0,1
North Melbourne,"Ziebell, Jack",6,2,0,4,0,0,0,3
North Melbourne,"Zurhaar, Cameron",9,7,6,2,2,0,0,2
North Melbourne,"Anderson, Jed",30,16,1,14,1,0,0,3
North Melbourne,"Atley, Shaun",19,5,2,14,0,0,0,0
North Melbourne,"Davies-Uniacke, Luke",24,7,0,17,0,0,0,1
North Melbourne,"Dumont, Trent",22,10,2,12,0,0,0,4
North Melbourne,"Durdin, Sam",6,2,0,4,0,1,0,1
North Melbourne,"Garner, Taylor",12,5,2,7,0,0,0,4
North Melbourne,"Goldstein, Todd",18,5,4,13,0,1,21,2
North Melbourne,"Hall, Aaron",14,6,2,8,0,1,0,2
North Melbourne,"Higgins, Shaun",23,9,6,14,1,0,0,2
North Melbourne,"Larkey, Nick",7,4,3,3,1,0,0,2
North Melbourne,"McDonald, Luke",28,13,2,15,0,0,0,2
North Melbourne,"McKay, Ben",8,3,3,5,0,0,0,1
North Melbourne,"Murphy, Tom",10,3,2,7,0,2,0,1
North Melbourne,"Perez, Flynn",15,8,1,7,0,0,0,3
North Melbourne,"Polec, Jared",25,20,4,5,0,0,0,2
North Melbourne,"Scott, Bailey",13,5,1,8,0,0,0,3
North Melbourne,"Simpkin, Jy",32,12,3,20,0,1,0,5
North Melbourne,"Tarrant, Robbie",12,7,3,5,0,0,0,1
North Melbourne,"Vickers-Willis, Ed",18,10,3,8,0,0,0,1
North Melbourne,"Walker, Josh",7,4,1,3,0,0,0,1
North Melbourne,"Ziebell, Jack",8,5,4,3,0,2,0,4
North Melbourne,"Zurhaar, Cameron",9,5,3,4,1,0,1,2
Port Adelaide,"Amon, Karl",21,15,6,6,0,2,0,2
Port Adelaide,"Boak, Travis",25,12,2,13,0,0,0,4
Port Adelaide,"Burton, Ryan",18,13,6,5,0,0,0,3
Port Adelaide,"Butters, Zak",12,8,2,4,1,0,0,0
Port Adelaide,"Byrne-Jones, Darcy",25,16,5,9,0,1,0,1
Port Adelaide,"Clurey, Tom",12,7,6,5,0,0,0,1
Port Adelaide,"Duursma, Xavier",18,12,4,6,0,1,0,0
Port Adelaide,"Ebert, Brad",20,11,8,9,1,3,0,6
Port Adelaide,"Georgiades, Mitch",11,8,3,3,2,0,0,2
Port Adelaide,"Gray, Robbie",18,11,6,7,0,1,0,3
Port Adelaide,"Hartlett, Hamish",10,6,3,4,1,0,0,2
Port Adelaide,"Houston, Dan",19,8,4,11,0,0,0,6
Port Adelaide,"Jonas, Tom",8,4,3,4,0,0,0,6
Port Adelaide,"Lienert, Jarrod",11,7,2,4,0,0,0,2
Port Adelaide,"Lycett, Scott",10,4,2,6,0,0,22,0
Port Adelaide,"Marshall, Todd",10,6,4,4,2,2,2,2
Port Adelaide,"McKenzie, Trent",15,12,7,3,0,0,0,1
Port Adelaide,"Motlop, Steven",15,10,2,5,2,0,0,3
Port Adelaide,"Powell-Pepper, Sam",20,11,2,9,0,2,0,4
Port Adelaide,"Rockliff, Tom",26,16,3,10,0,0,0,4
Port Adelaide,"Rozee, Connor",21,13,6,8,1,0,0,3
Port Adelaide,"Westhoff, Justin",12,9,4,3,0,1,7,5
Port Adelaide,"Amon, Karl",14,12,5,2,0,0,0,4
Port Adelaide,"Boak, Travis",24,12,5,12,1,1,0,3
Port Adelaide,"Bonner, Riley",14,13,7,1,0,0,0,1
Port Adelaide,"Burton, Ryan",12,8,3,4,0,0,0,0
Port Adelaide,"Butters, Zak",21,11,7,10,1,1,0,8
Port Adelaide,"Byrne-Jones, Darcy",25,13,7,12,0,0,0,0
Port Adelaide,"Clurey, Tom",17,17,8,0,0,0,0,5
Port Adelaide,"Dixon, Charlie",8,4,1,4,3,0,4,0
Port Adelaide,"Duursma, Xavier",17,11,5,6,3,1,0,3
Port Adelaide,"Ebert, Brad",16,11,8,5,1,0,0,4
Port Adelaide,"Gray, Robbie",19,10,4,9,0,1,0,0
Port Adelaide,"Hartlett, Hamish",21,13,6,8,0,0,0,1
Port Adelaide,"Houston, Dan",14,11,3,3,0,0,0,4
Port Adelaide,"Jonas, Tom",9,3,0,6,0,0,0,0
Port Adelaide,"Lycett, Scott",15,5,2,10,0,0,32,5
Port Adelaide,"Marshall, Todd",11,8,6,3,2,0,0,1
Port Adelaide,"McKenzie, Trent",15,12,11,3,0,0,0,0
Port Adelaide,"Motlop, Steven",24,13,5,11,2,0,0,2
Port Adelaide,"Powell-Pepper, Sam",11,7,2,4,0,0,0,5
Port Adelaide,"Rockliff, Tom",24,14,3,10,0,0,0,8
Port Adelaide,"Rozee, Connor",17,8,2,9,1,0,0,6
Port Adelaide,"Westhoff, Justin",15,10,5,5,3,0,4,1
Port Adelaide,"Amon, Karl",14,9,3,5,0,0,0,2
Port Adelaide,"Boak, Travis",26,16,2,10,1,0,0,7
Port Adelaide,"Bonner, Riley",10,8,3,2,0,0,0,1
Port Adelaide,"Butters, Zak",9,6,2,3,0,0,0,2
Port Adelaide,"Byrne-Jones, Darcy",15,14,4,1,0,0,0,2
Port Adelaide,"Clurey, Tom",6,4,3,2,0,0,0,0
Port Adelaide,"Dixon, Charlie",9,7,6,2,2,2,6,2
Port Adelaide,"Duursma, Xavier",8,6,2,2,0,0,0,2
Port Adelaide,"Ebert, Brad",16,13,5,3,1,1,0,3
Port Adelaide,"Gray, Robbie",10,3,1,7,1,0,0,2
Port Adelaide,"Hartlett, Hamish",14,9,3,5,0,0,0,4
Port Adelaide,"Houston, Dan",12,10,4,2,0,0,0,2
Port Adelaide,"Jonas, Tom",5,2,0,3,0,0,0,1
Port Adelaide,"Lycett, Scott",12,5,2,7,0,0,37,4
Port Adelaide,"Marshall, Todd",10,8,3,2,1,2,0,3
Port Adelaide,"McKenzie, Trent",16,16,5,0,0,0,0,2
Port Adelaide,"Motlop, Steven",5,3,1,2,0,0,0,3
Port Adelaide,"Powell-Pepper, Sam",10,4,0,6,1,1,0,1
Port Adelaide,"Rockliff, Tom",19,8,1,11,0,0,0,3
Port Adelaide,"Rozee, Connor",8,4,2,4,0,0,0,0
Port Adelaide,"Westhoff, Justin",15,11,5,4,2,1,1,1
Port Adelaide,"Wines, Ollie",25,13,2,12,1,0,0,3
Port Adelaide,"Amon, Karl",17,13,4,4,1,1,0,2
Port Adelaide,"Boak, Travis",19,10,2,9,0,1,0,3
Port Adelaide,"Bonner, Riley",11,10,4,1,0,0,0,0
Port Adelaide,"Butters, Zak",14,9,3,5,0,2,0,1
Port Adelaide,"Byrne-Jones, Darcy",16,14,4,2,0,0,0,0
Port Adelaide,"Clurey, Tom",12,10,9,2,0,0,0,2
Port Adelaide,"Dixon, Charlie",15,9,7,6,6,2,1,1
Port Adelaide,"Ebert, Brad",16,13,4,3,2,0,0,5
Port Adelaide,"Farrell, Kane",10,8,3,2,0,0,0,2
Port Adelaide,"Gray, Robbie",11,6,0,5,0,0,0,4
Port Adelaide,"Hartlett, Hamish",22,16,6,6,1,1,0,0
Port Adelaide,"Houston, Dan",18,11,5,7,0,0,0,5
Port Adelaide,"Jonas, Tom",15,11,6,4,0,0,0,2
Port Adelaide,"Lycett, Scott",10,6,1,4,0,0,15,6
Port Adelaide,"Marshall, Todd",8,7,5,1,1,1,0,5
Port Adelaide,"McKenzie, Trent",7,6,2,1,0,0,0,1
Port Adelaide,"Motlop, Steven",13,3,3,10,0,0,0,1
Port Adelaide,"Powell-Pepper, Sam",11,2,2,9,0,0,0,3
Port Adelaide,"Rockliff, Tom",19,9,4,10,0,0,0,3
Port Adelaide,"Rozee, Connor",15,10,5,5,0,1,0,0
Port Adelaide,"Westhoff, Justin",13,9,8,4,2,0,1,3
Port Adelaide,"Wines, Ollie",14,7,3,7,0,1,0,1
Port Adelaide,"Amon, Karl",11,6,1,5,0,0,0,2
Port Adelaide,"Boak, Travis",26,8,0,18,0,1,0,5
Port Adelaide,"Bonner, Riley",14,10,0,4,0,0,0,3
Port Adelaide,"Butters, Zak",18,10,5,8,2,0,0,3
Port Adelaide,"Byrne-Jones, Darcy",12,5,1,7,0,0,0,1
Port Adelaide,"Clurey, Tom",6,5,2,1,0,0,0,1
Port Adelaide,"Dixon, Charlie",6,5,4,1,0,2,5,6
Port Adelaide,"Ebert, Brad",15,10,5,5,0,1,0,4
Port Adelaide,"Farrell, Kane",10,4,2,6,0,1,0,2
Port Adelaide,"Gray, Robbie",11,5,1,6,1,1,0,5
Port Adelaide,"Hartlett, Hamish",11,3,2,8,0,0,0,2
Port Adelaide,"Houston, Dan",21,16,3,5,0,0,0,3
Port Adelaide,"Jonas, Tom",9,8,4,1,0,0,0,0
Port Adelaide,"Lycett, Scott",10,7,0,3,0,1,20,4
Port Adelaide,"Marshall, Todd",4,3,2,1,1,0,1,4
Port Adelaide,"McKenzie, Trent",7,6,1,1,0,0,0,1
Port Adelaide,"Motlop, Steven",13,11,6,2,0,1,0,0
Port Adelaide,"Powell-Pepper, Sam",13,8,3,5,0,1,0,4
Port Adelaide,"Rockliff, Tom",14,7,1,7,1,0,0,4
Port Adelaide,"Rozee, Connor",13,6,2,7,1,0,0,4
Port Adelaide,"Westhoff, Justin",5,3,1,2,0,0,3,1
Port Adelaide,"Wines, Ollie",14,4,3,10,0,0,0,3
Port Adelaide,"Amon, Karl",15,13,4,2,1,0,0,3
Port Adelaide,"Boak, Travis",16,10,4,6,1,0,0,3
Port Adelaide,"Burton, Ryan",17,13,2,4,0,0,0,0
Port Adelaide,"Butters, Zak",14,6,3,8,1,0,0,2
Port Adelaide,"Byrne-Jones, Darcy",18,9,7,9,0,0,0,0
Port Adelaide,"Clurey, Tom",10,10,4,0,0,0,0,0
Port Adelaide,"Dixon, Charlie",10,6,5,4,1,1,6,0
Port Adelaide,"Ebert, Brad",11,6,1,5,0,1,0,4
Port Adelaide,"Farrell, Kane",19,11,3,8,1,2,0,6
Port Adelaide,"Gray, Robbie",13,3,0,10,1,0,0,3
Port Adelaide,"Hartlett, Hamish",14,13,3,1,0,0,0,6
Port Adelaide,"Houston, Dan",22,12,1,10,0,0,0,2
Port Adelaide,"Jonas, Tom",16,12,8,4,0,1,0,2
Port Adelaide,"Lycett, Scott",11,7,1,4,0,0,21,1
Port Adelaide,"Marshall, Todd",7,7,3,0,1,1,0,1
Port Adelaide,"McKenzie, Trent",12,11,2,1,0,0,0,2
Port Adelaide,"Motlop, Steven",9,2,2,7,1,0,0,3
Port Adelaide,"Powell-Pepper, Sam",22,11,3,11,1,0,0,0
Port Adelaide,"Rozee, Connor",12,9,3,3,0,1,0,3
Port Adelaide,"Sutcliffe, Cam",6,4,1,2,0,0,0,0
Port Adelaide,"Westhoff, Justin",11,7,4,4,0,0,6,0
Port Adelaide,"Wines, Ollie",20,7,1,13,0,2,0,4
Port Adelaide,"Amon, Karl",10,7,0,3,0,0,0,1
Port Adelaide,"Boak, Travis",18,9,2,9,1,1,0,6
Port Adelaide,"Burton, Ryan",20,15,9,5,0,0,0,1
Port Adelaide,"Butters, Zak",15,12,5,3,1,0,0,4
Port Adelaide,"Byrne-Jones, Darcy",16,8,5,8,0,0,0,2
Port Adelaide,"Clurey, Tom",12,9,4,3,0,0,0,0
Port Adelaide,"Dixon, Charlie",15,11,7,4,3,4,0,0
Port Adelaide,"Duursma, Xavier",9,6,4,3,0,0,0,4
Port Adelaide,"Farrell, Kane",11,8,5,3,2,0,0,0
Port Adelaide,"Gray, Robbie",16,7,4,9,1,1,0,1
Port Adelaide,"Hartlett, Hamish",14,9,3,5,0,0,0,3
Port Adelaide,"Houston, Dan",15,10,3,5,0,1,0,8
Port Adelaide,"Jonas, Tom",20,11,9,9,0,0,0,2
Port Adelaide,"Ladhams, Peter",21,9,3,12,0,0,16,2
Port Adelaide,"Marshall, Todd",15,12,5,3,0,1,0,3
Port Adelaide,"Mayes, Sam",17,8,4,9,0,0,0,4
Port Adelaide,"McKenzie, Trent",13,11,5,2,0,0,0,1
Port Adelaide,"Motlop, Steven",6,4,1,2,1,0,0,0
Port Adelaide,"Powell-Pepper, Sam",12,4,4,8,0,1,0,1
Port Adelaide,"Rozee, Connor",8,5,1,3,0,1,0,3
Port Adelaide,"Westhoff, Justin",3,2,2,1,0,0,1,1
Port Adelaide,"Wines, Ollie",20,9,4,11,0,0,0,1
Port Adelaide,"Amon, Karl",15,5,2,10,0,0,0,3
Port Adelaide,"Boak, Travis",15,8,2,7,0,0,0,2
Port Adelaide,"Bonner, Riley",14,8,3,6,0,0,0,0
Port Adelaide,"Butters, Zak",7,3,2,4,0,0,0,1
Port Adelaide,"Byrne-Jones, Darcy",21,13,2,8,0,0,0,1
Port Adelaide,"Clurey, Tom",11,9,4,2,0,0,0,1
Port Adelaide,"Dixon, Charlie",8,5,4,3,1,0,1,2
Port Adelaide,"Duursma, Xavier",12,9,5,3,1,0,0,2
Port Adelaide,"Ebert, Brad",13,11,3,2,0,2,0,3
Port Adelaide,"Farrell, Kane",8,4,1,4,0,1,0,3
Port Adelaide,"Georgiades, Mitch",7,4,3,3,1,0,0,0
Port Adelaide,"Gray, Robbie",7,4,2,3,1,0,0,2
Port Adelaide,"Hartlett, Hamish",8,7,4,1,0,0,0,3
Port Adelaide,"Houston, Dan",18,11,3,7,0,1,0,1
Port Adelaide,"Jonas, Tom",14,8,3,6,0,0,0,2
Port Adelaide,"Ladhams, Peter",20,6,3,14,0,0,14,0
Port Adelaide,"Marshall, Todd",6,6,2,0,1,0,0,5
Port Adelaide,"Mayes, Sam",12,9,2,3,0,0,0,1
Port Adelaide,"Powell-Pepper, Sam",12,5,2,7,1,2,0,5
Port Adelaide,"Rozee, Connor",12,6,3,6,0,0,0,0
Port Adelaide,"Westhoff, Justin",10,6,3,4,0,0,1,2
Port Adelaide,"Wines, Ollie",17,11,0,6,0,1,0,5
Port Adelaide,"Amon, Karl",25,12,5,13,0,0,0,1
Port Adelaide,"Boak, Travis",25,14,4,11,1,1,0,2
Port Adelaide,"Butters, Zak",15,7,6,8,0,0,0,2
Port Adelaide,"Byrne-Jones, Darcy",17,12,0,5,0,0,0,3
Port Adelaide,"Clurey, Tom",10,5,3,5,0,0,0,0
Port Adelaide,"Dixon, Charlie",5,4,2,1,1,0,0,1
Port Adelaide,"Duursma, Xavier",15,8,4,7,0,0,0,2
Port Adelaide,"Ebert, Brad",10,3,1,7,0,0,0,3
Port Adelaide,"Farrell, Kane",11,6,2,5,1,2,0,2
Port Adelaide,"Georgiades, Mitch",11,8,5,3,3,2,0,2
Port Adelaide,"Gray, Robbie",15,5,4,10,0,0,0,3
Port Adelaide,"Hartlett, Hamish",14,9,4,5,0,0,0,4
Port Adelaide,"Houston, Dan",19,15,4,4,0,0,0,0
Port Adelaide,"Jonas, Tom",6,5,4,1,0,0,0,3
Port Adelaide,"Ladhams, Peter",13,4,1,9,0,1,10,1
Port Adelaide,"Lienert, Jarrod",15,9,2,6,0,0,0,1
Port Adelaide,"Mayes, Sam",19,12,6,7,1,1,0,4
Port Adelaide,"Powell-Pepper, Sam",14,9,2,5,0,0,0,7
Port Adelaide,"Rockliff, Tom",21,10,3,11,0,0,0,10
Port Adelaide,"Rozee, Connor",9,6,2,3,2,1,0,3
Port Adelaide,"Westhoff, Justin",10,6,5,4,2,0,3,3
Port Adelaide,"Wines, Ollie",25,7,0,18,1,0,0,3
Port Adelaide,"Amon, Karl",16,10,3,6,0,0,0,2
Port Adelaide,"Boak, Travis",10,4,2,6,0,0,0,4
Port Adelaide,"Butters, Zak",24,12,6,12,0,0,0,4
Port Adelaide,"Byrne-Jones, Darcy",15,11,5,4,0,0,0,3
Port Adelaide,"Clurey, Tom",10,8,5,2,0,0,0,0
Port Adelaide,"Dixon, Charlie",10,7,5,3,2,1,4,0
Port Adelaide,"Duursma, Xavier",10,7,2,3,0,0,0,3
Port Adelaide,"Farrell, Kane",6,3,0,3,1,0,0,4
Port Adelaide,"Georgiades, Mitch",10,8,5,2,0,1,0,3
Port Adelaide,"Gray, Robbie",15,6,1,9,2,1,0,5
Port Adelaide,"Hartlett, Hamish",18,10,6,8,0,0,0,2
Port Adelaide,"Houston, Dan",12,7,3,5,0,0,0,0
Port Adelaide,"Jonas, Tom",13,10,5,3,0,0,0,0
Port Adelaide,"Ladhams, Peter",18,7,3,11,1,0,32,3
Port Adelaide,"Mayes, Sam",11,7,3,4,0,0,0,7
Port Adelaide,"McKenzie, Trent",13,13,5,0,0,0,0,0
Port Adelaide,"Powell-Pepper, Sam",12,4,1,8,1,0,0,10
Port Adelaide,"Rockliff, Tom",23,12,2,11,0,1,0,15
Port Adelaide,"Rozee, Connor",15,7,0,8,0,0,0,6
Port Adelaide,"Westhoff, Justin",9,5,3,4,0,2,8,2
Port Adelaide,"Wines, Ollie",18,8,1,10,1,0,0,1
Port Adelaide,"Woodcock, Boyd",11,6,1,5,0,1,0,2
Port Adelaide,"Amon, Karl",19,14,5,5,1,1,0,3
Port Adelaide,"Boak, Travis",31,16,3,15,0,1,0,3
Port Adelaide,"Butters, Zak",20,5,2,15,1,0,0,2
Port Adelaide,"Byrne-Jones, Darcy",14,7,1,7,0,0,0,5
Port Adelaide,"Clurey, Tom",7,3,3,4,0,0,0,1
Port Adelaide,"Dixon, Charlie",14,10,5,4,2,4,4,1
Port Adelaide,"Duursma, Xavier",12,5,1,7,0,1,0,3
Port Adelaide,"Farrell, Kane",10,3,1,7,0,1,0,4
Port Adelaide,"Georgiades, Mitch",7,3,1,4,0,0,0,4
Port Adelaide,"Gray, Robbie",22,9,2,13,3,0,0,2
Port Adelaide,"Hartlett, Hamish",16,8,0,8,0,0,0,6
Port Adelaide,"Houston, Dan",17,13,3,4,1,0,0,2
Port Adelaide,"Jonas, Tom",8,8,5,0,0,0,0,0
Port Adelaide,"Ladhams, Peter",12,6,5,6,2,0,11,6
Port Adelaide,"Lienert, Jarrod",11,11,2,0,0,0,0,2
Port Adelaide,"Lycett, Scott",9,3,2,6,0,0,16,2
Port Adelaide,"McKenzie, Trent",3,3,2,0,0,1,0,0
Port Adelaide,"Powell-Pepper, Sam",18,9,1,9,0,0,0,5
Port Adelaide,"Rockliff, Tom",20,12,1,8,1,1,0,5
Port Adelaide,"Sutcliffe, Cam",11,4,2,7,0,1,0,2
Port Adelaide,"Wines, Ollie",28,11,1,17,1,0,0,11
Port Adelaide,"Woodcock, Boyd",12,7,2,5,1,1,0,0
Port Adelaide,"Amon, Karl",16,13,4,3,0,2,0,1
Port Adelaide,"Boak, Travis",24,13,4,11,0,0,0,4
Port Adelaide,"Butters, Zak",12,7,2,5,0,0,0,3
Port Adelaide,"Byrne-Jones, Darcy",10,4,1,6,0,0,0,2
Port Adelaide,"Clurey, Tom",12,10,5,2,0,0,0,0
Port Adelaide,"Dixon, Charlie",3,2,2,1,0,0,3,2
Port Adelaide,"Duursma, Xavier",8,3,2,5,0,0,0,2
Port Adelaide,"Farrell, Kane",6,4,1,2,1,1,0,2
Port Adelaide,"Georgiades, Mitch",3,1,1,2,1,0,0,2
Port Adelaide,"Gray, Robbie",15,4,2,11,0,0,0,3
Port Adelaide,"Hartlett, Hamish",8,5,3,3,0,0,0,3
Port Adelaide,"Houston, Dan",15,13,6,2,0,0,0,4
Port Adelaide,"Jonas, Tom",11,10,2,1,0,0,0,2
Port Adelaide,"Ladhams, Peter",12,8,3,4,0,0,9,2
Port Adelaide,"Lycett, Scott",9,5,1,4,1,0,20,2
Port Adelaide,"Mayes, Sam",10,7,1,3,0,0,0,0
Port Adelaide,"McKenzie, Trent",12,12,4,0,0,0,0,3
Port Adelaide,"Motlop, Steven",5,3,1,2,0,0,0,1
Port Adelaide,"Powell-Pepper, Sam",16,11,2,5,0,2,0,0
Port Adelaide,"Rockliff, Tom",14,6,1,8,0,0,0,6
Port Adelaide,"Wines, Ollie",19,9,2,10,0,0,0,4
Port Adelaide,"Woodcock, Boyd",12,7,3,5,1,0,0,2
Port Adelaide,"Amon, Karl",15,11,3,4,1,0,0,8
Port Adelaide,"Boak, Travis",34,11,6,23,0,1,0,6
Port Adelaide,"Bonner, Riley",15,13,3,2,0,0,0,0
Port Adelaide,"Butters, Zak",14,8,2,6,2,1,0,1
Port Adelaide,"Byrne-Jones, Darcy",15,9,2,6,0,0,0,2
Port Adelaide,"Clurey, Tom",14,11,9,3,0,0,0,2
Port Adelaide,"Dixon, Charlie",7,4,2,3,2,0,0,1
Port Adelaide,"Ebert, Brad",14,9,3,5,1,2,0,5
Port Adelaide,"Georgiades, Mitch",9,7,2,2,1,3,0,1
Port Adelaide,"Gray, Robbie",20,8,2,12,1,0,0,2
Port Adelaide,"Hartlett, Hamish",14,9,2,5,0,0,0,1
Port Adelaide,"Jonas, Tom",12,5,6,7,0,0,0,1
Port Adelaide,"Lienert, Jarrod",14,10,1,4,0,0,0,1
Port Adelaide,"Lycett, Scott",17,5,3,12,0,1,22,2
Port Adelaide,"Mayes, Sam",13,7,4,6,0,1,0,1
Port Adelaide,"McKenzie, Trent",15,12,5,3,0,0,0,1
Port Adelaide,"Motlop, Steven",8,4,1,4,0,0,0,1
Port Adelaide,"Powell-Pepper, Sam",21,7,3,14,0,1,0,7
Port Adelaide,"Rockliff, Tom",28,11,3,17,0,0,0,6
Port Adelaide,"Westhoff, Justin",9,5,4,4,0,1,4,2
Port Adelaide,"Wines, Ollie",20,9,0,11,0,0,0,7
Port Adelaide,"Woodcock, Boyd",9,5,3,4,1,1,0,3
Port Adelaide,"Amon, Karl",18,10,0,8,0,0,0,1
Port Adelaide,"Boak, Travis",20,12,3,8,1,0,0,4
Port Adelaide,"Bonner, Riley",9,6,2,3,0,0,0,0
Port Adelaide,"Burton, Ryan",15,10,3,5,0,0,0,1
Port Adelaide,"Butters, Zak",13,8,2,5,1,1,0,2
Port Adelaide,"Byrne-Jones, Darcy",17,6,1,11,0,0,0,1
Port Adelaide,"Clurey, Tom",9,8,5,1,0,0,0,1
Port Adelaide,"Dixon, Charlie",13,6,5,7,4,1,6,2
Port Adelaide,"Duursma, Xavier",20,8,3,12,0,0,0,4
Port Adelaide,"Ebert, Brad",7,5,0,2,0,0,0,3
Port Adelaide,"Gray, Robbie",27,7,1,20,2,0,0,6
Port Adelaide,"Hartlett, Hamish",20,12,6,8,0,0,0,1
Port Adelaide,"Jonas, Tom",5,1,1,4,0,0,0,1
Port Adelaide,"Lycett, Scott",10,5,0,5,0,0,26,2
Port Adelaide,"Marshall, Todd",7,3,1,4,0,0,0,2
Port Adelaide,"McKenzie, Trent",14,11,5,3,0,0,0,0
Port Adelaide,"Powell-Pepper, Sam",20,8,1,12,0,0,0,4
Port Adelaide,"Rockliff, Tom",24,10,2,14,0,0,0,4
Port Adelaide,"Rozee, Connor",11,4,2,7,0,0,0,1
Port Adelaide,"Sutcliffe, Cam",10,7,0,3,1,1,0,1
Port Adelaide,"Westhoff, Justin",10,4,1,6,1,2,3,5
Port Adelaide,"Wines, Ollie",22,12,2,10,1,0,0,7
Port Adelaide,"Amon, Karl",18,13,6,5,1,1,0,5
Port Adelaide,"Boak, Travis",34,18,4,16,1,0,0,0
Port Adelaide,"Burton, Ryan",2,1,0,1,0,1,0,0
Port Adelaide,"Butters, Zak",17,6,3,11,1,0,0,4
Port Adelaide,"Byrne-Jones, Darcy",20,13,4,7,0,1,0,0
Port Adelaide,"Clurey, Tom",4,4,3,0,0,0,0,0
Port Adelaide,"Dixon, Charlie",11,6,2,5,2,1,4,3
Port Adelaide,"Duursma, Xavier",14,6,3,8,0,0,0,4
Port Adelaide,"Farrell, Kane",7,4,1,3,0,1,0,3
Port Adelaide,"Gray, Robbie",20,5,2,15,1,1,0,6
Port Adelaide,"Hartlett, Hamish",22,13,4,9,0,0,0,3
Port Adelaide,"Houston, Dan",15,12,5,3,0,1,0,6
Port Adelaide,"Jonas, Tom",8,5,2,3,0,0,0,1
Port Adelaide,"Lycett, Scott",12,7,1,5,0,0,27,1
Port Adelaide,"Marshall, Todd",8,5,1,3,0,0,0,1
Port Adelaide,"McKenzie, Trent",13,10,5,3,0,0,0,1
Port Adelaide,"Motlop, Steven",11,7,5,4,1,1,0,2
Port Adelaide,"Powell-Pepper, Sam",18,8,3,10,1,2,0,4
Port Adelaide,"Rockliff, Tom",30,20,2,10,0,0,0,9
Port Adelaide,"Rozee, Connor",14,3,2,11,1,1,0,7
Port Adelaide,"Sutcliffe, Cam",5,3,0,2,0,0,0,3
Port Adelaide,"Wines, Ollie",30,16,5,14,2,0,0,0
Port Adelaide,"Amon, Karl",21,9,1,12,0,1,0,5
Port Adelaide,"Boak, Travis",26,9,0,17,1,0,0,4
Port Adelaide,"Bonner, Riley",19,16,6,3,0,0,0,2
Port Adelaide,"Byrne-Jones, Darcy",19,15,3,4,0,0,0,5
Port Adelaide,"Clurey, Tom",7,4,1,3,0,0,0,1
Port Adelaide,"Dixon, Charlie",10,10,6,0,2,3,0,2
Port Adelaide,"Duursma, Xavier",11,7,3,4,1,0,0,2
Port Adelaide,"Ebert, Brad",19,8,4,11,1,0,0,3
Port Adelaide,"Farrell, Kane",4,1,2,3,0,0,0,2
Port Adelaide,"Gray, Robbie",15,8,1,7,1,0,0,2
Port Adelaide,"Hartlett, Hamish",17,10,3,7,0,0,0,2
Port Adelaide,"Houston, Dan",17,15,8,2,0,0,0,3
Port Adelaide,"Jonas, Tom",9,8,6,1,0,0,0,2
Port Adelaide,"Ladhams, Peter",8,3,0,5,1,0,10,2
Port Adelaide,"Lycett, Scott",12,5,1,7,0,1,22,3
Port Adelaide,"Marshall, Todd",10,9,3,1,0,1,0,4
Port Adelaide,"McKenzie, Trent",14,13,6,1,0,1,0,2
Port Adelaide,"Motlop, Steven",13,4,2,9,1,0,0,0
Port Adelaide,"Powell-Pepper, Sam",12,3,2,9,1,0,0,4
Port Adelaide,"Rockliff, Tom",31,20,4,11,1,1,0,6
Port Adelaide,"Rozee, Connor",18,6,3,12,0,2,0,6
Port Adelaide,"Wines, Ollie",28,13,1,15,1,0,0,2
Port Adelaide,"Amon, Karl",13,9,5,4,0,0,0,1
Port Adelaide,"Boak, Travis",21,11,2,10,0,0,0,3
Port Adelaide,"Bonner, Riley",16,13,5,3,0,0,0,0
Port Adelaide,"Byrne-Jones, Darcy",20,14,8,6,0,0,0,3
Port Adelaide,"Dixon, Charlie",11,4,2,7,1,0,1,1
Port Adelaide,"Duursma, Xavier",16,8,6,8,1,0,0,2
Port Adelaide,"Ebert, Brad",16,8,3,8,2,2,0,2
Port Adelaide,"Gray, Robbie",25,11,4,14,0,0,0,2
Port Adelaide,"Hartlett, Hamish",11,7,4,4,0,0,0,1
Port Adelaide,"Houston, Dan",23,17,12,6,0,0,0,2
Port Adelaide,"Jonas, Tom",11,7,5,4,0,0,0,0
Port Adelaide,"Ladhams, Peter",8,6,2,2,0,0,4,1
Port Adelaide,"Lienert, Jarrod",12,9,3,3,0,0,0,0
Port Adelaide,"Lycett, Scott",10,3,1,7,0,0,22,3
Port Adelaide,"Marshall, Todd",6,5,4,1,1,0,0,2
Port Adelaide,"McKenzie, Trent",11,7,2,4,0,0,0,1
Port Adelaide,"Motlop, Steven",6,5,2,1,2,0,0,1
Port Adelaide,"Powell-Pepper, Sam",9,3,2,6,1,0,0,5
Port Adelaide,"Rockliff, Tom",30,15,5,15,1,0,0,3
Port Adelaide,"Rozee, Connor",11,6,2,5,0,2,0,1
Port Adelaide,"Wines, Ollie",23,13,1,10,0,1,0,4
Port Adelaide,"Woodcock, Boyd",8,3,3,5,0,0,0,1
Port Adelaide,"Amon, Karl",12,8,1,4,0,0,0,4
Port Adelaide,"Boak, Travis",22,10,1,12,0,1,0,5
Port Adelaide,"Burton, Ryan",12,9,7,3,0,0,0,3
Port Adelaide,"Butters, Zak",14,8,2,6,0,0,0,4
Port Adelaide,"Byrne-Jones, Darcy",14,12,2,2,0,0,0,1
Port Adelaide,"Clurey, Tom",5,3,1,2,0,0,0,0
Port Adelaide,"Dixon, Charlie",6,4,0,2,1,0,0,3
Port Adelaide,"Duursma, Xavier",8,5,3,3,0,0,0,1
Port Adelaide,"Ebert, Brad",16,11,3,5,2,2,0,3
Port Adelaide,"Gray, Robbie",17,6,2,11,0,0,0,3
Port Adelaide,"Hartlett, Hamish",15,10,7,5,0,0,0,7
Port Adelaide,"Houston, Dan",13,11,2,2,0,0,0,1
Port Adelaide,"Jonas, Tom",13,12,5,1,0,0,0,2
Port Adelaide,"Ladhams, Peter",14,7,1,7,1,1,4,1
Port Adelaide,"Lycett, Scott",9,3,0,6,0,0,20,2
Port Adelaide,"Marshall, Todd",3,2,1,1,1,0,0,2
Port Adelaide,"McKenzie, Trent",8,7,5,1,0,0,0,0
Port Adelaide,"Motlop, Steven",11,8,1,3,3,0,0,3
Port Adelaide,"Powell-Pepper, Sam",14,4,1,10,0,0,0,6
Port Adelaide,"Rockliff, Tom",22,9,0,13,0,0,0,9
Port Adelaide,"Rozee, Connor",8,4,1,4,1,0,0,4
Port Adelaide,"Wines, Ollie",24,12,1,12,0,0,0,5
Port Adelaide,"Amon, Karl",16,10,0,6,0,0,0,5
Port Adelaide,"Boak, Travis",20,14,3,6,0,0,0,4
Port Adelaide,"Burton, Ryan",5,5,0,0,0,0,0,0
Port Adelaide,"Butters, Zak",9,3,1,6,0,1,0,4
Port Adelaide,"Byrne-Jones, Darcy",12,9,2,3,0,0,0,2
Port Adelaide,"Clurey, Tom",11,8,3,3,0,0,0,3
Port Adelaide,"Dixon, Charlie",9,6,4,3,1,0,1,3
Port Adelaide,"Duursma, Xavier",19,13,5,6,1,0,0,2
Port Adelaide,"Ebert, Brad",18,12,4,6,0,0,0,7
Port Adelaide,"Gray, Robbie",19,9,1,10,0,1,0,3
Port Adelaide,"Hartlett, Hamish",12,5,0,7,0,0,0,2
Port Adelaide,"Houston, Dan",23,19,2,4,0,0,0,0
Port Adelaide,"Jonas, Tom",14,8,2,6,0,0,0,3
Port Adelaide,"Ladhams, Peter",6,4,0,2,1,0,14,1
Port Adelaide,"Lycett, Scott",9,6,2,3,1,0,30,2
Port Adelaide,"Marshall, Todd",6,3,1,3,0,1,0,0
Port Adelaide,"McKenzie, Trent",9,7,3,2,0,0,0,2
Port Adelaide,"Motlop, Steven",10,7,1,3,0,0,0,4
Port Adelaide,"Powell-Pepper, Sam",15,5,0,10,0,0,0,2
Port Adelaide,"Rockliff, Tom",20,12,1,8,0,0,0,5
Port Adelaide,"Rozee, Connor",14,9,4,5,2,0,0,5
Port Adelaide,"Wines, Ollie",24,16,3,8,0,0,0,3
Richmond,"Astbury, David",14,9,3,5,0,0,0,2
Richmond,"Baker, Liam",16,6,2,10,0,0,0,1
Richmond,"Bolton, Shai",13,11,6,2,3,1,0,2
Richmond,"Broad, Nathan",9,8,4,1,0,0,0,1
Richmond,"Caddy, Josh",15,10,5,5,0,0,0,3
Richmond,"Castagna, Jason",8,5,1,3,3,0,0,3
Richmond,"Cotchin, Trent",19,11,3,8,0,2,0,2
Richmond,"Edwards, Shane",15,7,1,8,1,0,0,2
Richmond,"Graham, Jack",8,2,0,6,0,0,0,1
Richmond,"Grimes, Dylan",7,5,5,2,0,0,0,2
Richmond,"Lambert, Kane",14,6,3,8,1,1,0,2
Richmond,"Lynch, Tom",9,4,0,5,0,1,0,1
Richmond,"Martin, Dustin",24,12,3,12,1,1,0,4
Richmond,"Nankervis, Toby",7,1,1,6,0,0,16,1
Richmond,"Pickett, Marlion",14,8,1,6,0,0,0,5
Richmond,"Prestia, Dion",25,11,2,14,1,0,0,5
Richmond,"Riewoldt, Jack",6,5,5,1,3,1,0,2
Richmond,"Rioli, Daniel",12,8,3,4,3,0,0,3
Richmond,"Short, Jayden",15,13,5,2,0,0,0,2
Richmond,"Soldo, Ivan",10,4,2,6,0,1,25,3
Richmond,"Stack, Sydney",10,3,0,7,0,0,0,2
Richmond,"Vlastuin, Nick",7,6,2,1,0,0,0,3
Richmond,"Astbury, David",14,13,6,1,0,0,0,3
Richmond,"Baker, Liam",12,9,4,3,0,0,0,1
Richmond,"Bolton, Shai",11,9,3,2,1,0,0,6
Richmond,"Broad, Nathan",10,6,3,4,0,0,0,1
Richmond,"Castagna, Jason",11,6,4,5,0,0,0,1
Richmond,"Cotchin, Trent",23,14,3,9,0,0,0,5
Richmond,"Edwards, Shane",13,5,1,8,0,0,0,5
Richmond,"Graham, Jack",14,3,4,11,0,0,0,2
Richmond,"Grimes, Dylan",10,6,3,4,0,0,0,2
Richmond,"Higgins, Jack",12,11,8,1,1,1,0,3
Richmond,"Houli, Bachar",26,12,8,14,0,0,0,3
Richmond,"Lambert, Kane",17,9,2,8,0,0,0,4
Richmond,"Lynch, Tom",12,10,3,2,3,1,0,2
Richmond,"Martin, Dustin",20,13,2,7,0,0,0,4
Richmond,"Pickett, Marlion",7,4,2,3,0,0,0,4
Richmond,"Prestia, Dion",20,12,2,8,0,0,0,5
Richmond,"Riewoldt, Jack",6,4,2,2,0,0,1,0
Richmond,"Rioli, Daniel",6,4,1,2,0,0,0,2
Richmond,"Short, Jayden",14,11,6,3,0,0,0,2
Richmond,"Soldo, Ivan",6,4,2,2,0,0,23,9
Richmond,"Stack, Sydney",4,2,0,2,0,0,0,3
Richmond,"Vlastuin, Nick",13,10,5,3,0,0,0,3
Richmond,"Astbury, David",17,9,6,8,0,0,0,0
Richmond,"Bolton, Shai",9,6,3,3,1,1,0,1
Richmond,"Broad, Nathan",13,7,3,6,0,0,1,1
Richmond,"Caddy, Josh",13,6,5,7,0,1,0,1
Richmond,"Castagna, Jason",5,4,3,1,2,1,0,2
Richmond,"Cotchin, Trent",18,9,2,9,0,0,0,3
Richmond,"Edwards, Shane",12,4,0,8,1,0,0,0
Richmond,"Graham, Jack",12,8,5,4,0,0,0,0
Richmond,"Grimes, Dylan",18,12,7,6,0,0,0,0
Richmond,"Higgins, Jack",15,14,2,1,0,1,0,2
Richmond,"Houli, Bachar",25,10,6,15,0,0,0,2
Richmond,"Lambert, Kane",14,8,2,6,0,0,0,1
Richmond,"Lynch, Tom",6,5,5,1,1,1,1,0
Richmond,"Pickett, Marlion",10,7,2,3,0,0,0,2
Richmond,"Prestia, Dion",17,10,2,7,0,0,0,0
Richmond,"Riewoldt, Jack",11,10,4,1,0,2,0,1
Richmond,"Rioli, Daniel",6,2,0,4,0,0,0,3
Richmond,"Ross, Jack",11,5,0,6,0,0,0,3
Richmond,"Short, Jayden",18,11,7,7,0,0,0,0
Richmond,"Soldo, Ivan",7,3,0,4,0,0,9,3
Richmond,"Stack, Sydney",18,7,4,11,0,0,0,2
Richmond,"Vlastuin, Nick",22,14,6,8,0,0,0,0
Richmond,"Astbury, David",14,8,5,6,0,0,0,1
Richmond,"Baker, Liam",14,2,3,12,0,0,0,4
Richmond,"Bolton, Shai",10,8,3,2,2,0,0,4
Richmond,"Broad, Nathan",10,2,3,8,0,0,0,0
Richmond,"Caddy, Josh",12,6,4,6,0,0,0,1
Richmond,"Castagna, Jason",9,2,1,7,1,1,0,2
Richmond,"Cotchin, Trent",23,10,4,13,0,0,0,6
Richmond,"Edwards, Shane",24,10,0,14,1,0,0,6
Richmond,"Grimes, Dylan",5,2,0,3,0,0,0,0
Richmond,"Higgins, Jack",17,8,4,9,1,1,0,2
Richmond,"Houli, Bachar",21,13,8,8,0,0,0,2
Richmond,"Lambert, Kane",11,2,0,9,0,0,0,4
Richmond,"Lynch, Tom",14,8,4,6,2,2,0,1
Richmond,"Martin, Dustin",18,7,2,11,0,0,0,1
Richmond,"McIntosh, Kamdyn",9,5,3,4,0,0,0,2
Richmond,"Nankervis, Toby",17,9,4,8,1,0,26,7
Richmond,"Prestia, Dion",25,13,1,12,0,0,0,6
Richmond,"Riewoldt, Jack",7,5,3,2,1,3,0,1
Richmond,"Ross, Jack",13,6,1,7,0,0,0,1
Richmond,"Short, Jayden",20,13,5,7,0,0,0,0
Richmond,"Stack, Sydney",9,3,1,6,1,0,0,0
Richmond,"Vlastuin, Nick",11,7,3,4,0,0,0,0
Richmond,"Aarts, Jake",15,6,3,9,0,1,0,2
Richmond,"Baker, Liam",17,10,1,7,0,0,0,1
Richmond,"Balta, Noah",20,13,8,7,0,0,0,0
Richmond,"Broad, Nathan",13,8,4,5,0,0,0,0
Richmond,"Caddy, Josh",19,12,8,7,0,0,0,4
Richmond,"Castagna, Jason",15,5,2,10,1,1,0,2
Richmond,"Chol, Mabior",8,5,1,3,0,0,3,3
Richmond,"Cotchin, Trent",14,6,2,8,0,0,0,4
Richmond,"Edwards, Shane",18,7,1,11,0,0,0,2
Richmond,"Grimes, Dylan",8,5,1,3,0,0,0,1
Richmond,"Higgins, Jack",19,9,5,10,1,1,0,1
Richmond,"Houli, Bachar",19,7,4,12,0,0,0,2
Richmond,"Lambert, Kane",27,11,6,16,3,0,0,1
Richmond,"Lynch, Tom",12,10,6,2,3,2,0,0
Richmond,"Martin, Dustin",20,13,4,7,1,0,0,1
Richmond,"McIntosh, Kamdyn",14,9,2,5,0,0,0,1
Richmond,"Nankervis, Toby",12,7,1,5,1,0,9,1
Richmond,"Prestia, Dion",19,6,5,13,0,0,0,5
Richmond,"Riewoldt, Jack",9,7,5,2,1,0,1,2
Richmond,"Rioli, Daniel",8,6,4,2,1,0,0,1
Richmond,"Short, Jayden",18,12,3,6,0,0,0,2
Richmond,"Vlastuin, Nick",11,6,6,5,0,0,0,1
Richmond,"Aarts, Jake",6,4,3,2,0,0,0,2
Richmond,"Baker, Liam",17,10,8,7,0,0,0,3
Richmond,"Balta, Noah",6,3,3,3,0,0,0,1
Richmond,"Bolton, Shai",14,11,2,3,1,1,0,2
Richmond,"Broad, Nathan",16,14,6,2,0,0,0,3
Richmond,"Caddy, Josh",17,8,5,9,0,1,0,0
Richmond,"Castagna, Jason",14,12,3,2,0,1,0,3
Richmond,"Chol, Mabior",7,6,2,1,0,1,11,1
Richmond,"Eggmolesse-Smith, Derek",10,5,1,5,0,0,0,3
Richmond,"Graham, Jack",16,12,4,4,0,0,0,6
Richmond,"Grimes, Dylan",14,8,6,6,0,0,0,2
Richmond,"Higgins, Jack",19,8,1,11,0,0,0,3
Richmond,"Lambert, Kane",22,13,7,9,0,0,0,6
Richmond,"Lynch, Tom",5,5,2,0,1,1,0,0
Richmond,"Martin, Dustin",15,5,1,10,1,0,0,0
Richmond,"McIntosh, Kamdyn",24,14,5,10,0,0,0,2
Richmond,"Pickett, Marlion",11,4,2,7,0,0,0,4
Richmond,"Riewoldt, Jack",9,7,4,2,1,2,0,2
Richmond,"Rioli, Daniel",6,4,3,2,0,0,0,0
Richmond,"Short, Jayden",26,20,9,6,0,0,0,0
Richmond,"Soldo, Ivan",8,2,1,6,0,1,21,2
Richmond,"Vlastuin, Nick",16,10,5,6,0,0,0,1
Richmond,"Aarts, Jake",8,6,4,2,2,3,0,0
Richmond,"Baker, Liam",15,5,3,10,0,0,0,1
Richmond,"Balta, Noah",10,4,1,6,0,0,0,0
Richmond,"Bolton, Shai",19,10,1,9,0,1,0,1
Richmond,"Broad, Nathan",15,13,6,2,0,0,0,1
Richmond,"Caddy, Josh",5,3,2,2,0,0,0,0
Richmond,"Castagna, Jason",18,13,6,5,1,1,0,1
Richmond,"Chol, Mabior",9,7,4,2,2,0,1,3
Richmond,"Eggmolesse-Smith, Derek",23,17,6,6,0,0,0,3
Richmond,"Graham, Jack",14,5,3,9,0,0,0,9
Richmond,"Grimes, Dylan",19,12,9,7,0,0,0,2
Richmond,"Higgins, Jack",19,10,5,9,0,0,0,0
Richmond,"Lambert, Kane",19,7,5,12,0,0,0,2
Richmond,"Lynch, Tom",4,3,2,1,1,1,0,1
Richmond,"Martin, Dustin",16,11,3,5,2,0,0,3
Richmond,"McIntosh, Kamdyn",7,3,2,4,0,0,0,5
Richmond,"Pickett, Marlion",16,8,5,8,1,0,0,7
Richmond,"Riewoldt, Jack",8,6,4,2,1,1,0,2
Richmond,"Rioli, Daniel",11,5,1,6,1,0,0,3
Richmond,"Short, Jayden",21,18,8,3,0,2,0,0
Richmond,"Soldo, Ivan",8,4,2,4,0,0,23,3
Richmond,"Vlastuin, Nick",16,12,7,4,0,0,0,2
Richmond,"Aarts, Jake",5,3,0,2,1,1,0,3
Richmond,"Baker, Liam",11,7,3,4,0,0,0,2
Richmond,"Balta, Noah",9,5,2,4,0,0,0,1
Richmond,"Bolton, Shai",19,11,2,8,1,2,0,1
Richmond,"Broad, Nathan",12,10,6,2,0,0,0,2
Richmond,"Castagna, Jason",12,7,2,5,1,0,0,4
Richmond,"Chol, Mabior",4,0,0,4,0,0,7,2
Richmond,"Eggmolesse-Smith, Derek",10,7,2,3,0,0,0,1
Richmond,"Graham, Jack",6,2,1,4,0,0,0,7
Richmond,"Grimes, Dylan",11,6,5,5,0,0,0,2
Richmond,"Higgins, Jack",12,9,2,3,0,1,0,1
Richmond,"Lambert, Kane",14,5,2,9,0,0,0,5
Richmond,"Lynch, Tom",6,4,2,2,0,2,0,1
Richmond,"Martin, Dustin",23,15,5,8,2,1,0,2
Richmond,"McIntosh, Kamdyn",15,11,2,4,0,1,0,1
Richmond,"Naish, Patrick",9,3,0,6,0,0,0,3
Richmond,"Pickett, Marlion",10,6,1,4,0,2,0,1
Richmond,"Riewoldt, Jack",8,7,4,1,1,0,0,0
Richmond,"Rioli, Daniel",8,5,2,3,0,1,0,6
Richmond,"Short, Jayden",18,13,7,5,0,0,0,1
Richmond,"Soldo, Ivan",3,3,1,0,0,0,37,4
Richmond,"Vlastuin, Nick",10,7,5,3,0,0,0,4
Richmond,"Aarts, Jake",7,5,0,2,3,0,0,4
Richmond,"Baker, Liam",15,5,6,10,0,0,0,1
Richmond,"Balta, Noah",15,9,4,6,0,0,0,3
Richmond,"Bolton, Shai",19,8,4,11,0,0,0,3
Richmond,"Broad, Nathan",17,13,6,4,0,0,0,1
Richmond,"Castagna, Jason",14,10,7,4,2,2,0,1
Richmond,"Chol, Mabior",7,5,1,2,1,1,7,0
Richmond,"Cotchin, Trent",17,7,2,10,0,0,0,6
Richmond,"Eggmolesse-Smith, Derek",15,12,4,3,0,0,0,1
Richmond,"Grimes, Dylan",18,11,6,7,0,0,0,2
Richmond,"Higgins, Jack",14,9,4,5,0,1,0,2
Richmond,"Lambert, Kane",17,8,4,9,0,1,0,2
Richmond,"Lynch, Tom",12,7,4,5,2,1,0,0
Richmond,"Markov, Oleg",11,9,2,2,0,0,0,2
Richmond,"Martin, Dustin",26,16,2,10,3,1,0,3
Richmond,"McIntosh, Kamdyn",9,7,3,2,0,1,0,1
Richmond,"Pickett, Marlion",14,10,4,4,1,0,0,2
Richmond,"Riewoldt, Jack",7,4,2,3,1,0,0,1
Richmond,"Ross, Jack",17,9,4,8,0,0,0,1
Richmond,"Short, Jayden",21,16,7,5,0,0,0,0
Richmond,"Soldo, Ivan",9,2,2,7,0,0,23,4
Richmond,"Stack, Sydney",8,2,2,6,0,0,0,7
Richmond,"Aarts, Jake",14,7,4,7,2,0,0,2
Richmond,"Baker, Liam",26,18,6,8,0,0,0,1
Richmond,"Balta, Noah",10,8,6,2,0,0,0,3
Richmond,"Bolton, Shai",24,13,3,11,1,0,0,3
Richmond,"Broad, Nathan",7,5,3,2,0,0,0,0
Richmond,"Castagna, Jason",12,11,6,1,0,1,0,2
Richmond,"Chol, Mabior",5,3,1,2,0,1,9,3
Richmond,"Cotchin, Trent",15,6,2,9,0,0,0,5
Richmond,"Eggmolesse-Smith, Derek",8,6,1,2,0,0,0,1
Richmond,"Grimes, Dylan",5,3,4,2,0,0,0,2
Richmond,"Higgins, Jack",6,4,1,2,1,0,0,1
Richmond,"Lambert, Kane",15,8,3,7,0,0,0,1
Richmond,"Lynch, Tom",11,7,3,4,3,2,0,2
Richmond,"Martin, Dustin",24,16,4,8,0,1,0,1
Richmond,"McIntosh, Kamdyn",15,8,6,7,0,0,0,1
Richmond,"Pickett, Marlion",14,5,3,9,1,0,0,5
Richmond,"Riewoldt, Jack",10,9,4,1,4,1,0,0
Richmond,"Ross, Jack",12,7,4,5,0,0,0,1
Richmond,"Short, Jayden",23,16,4,7,0,0,0,0
Richmond,"Soldo, Ivan",6,5,1,1,0,0,14,2
Richmond,"Stack, Sydney",16,6,3,10,0,1,0,2
Richmond,"Vlastuin, Nick",17,12,8,5,0,0,0,1
Richmond,"Aarts, Jake",10,6,1,4,2,0,0,0
Richmond,"Baker, Liam",9,6,5,3,0,0,0,4
Richmond,"Balta, Noah",7,4,2,3,0,0,0,3
Richmond,"Bolton, Shai",16,8,2,8,0,0,0,5
Richmond,"Broad, Nathan",7,5,1,2,0,0,0,5
Richmond,"Caddy, Josh",11,6,0,5,0,0,0,5
Richmond,"Castagna, Jason",5,2,1,3,0,0,0,2
Richmond,"Chol, Mabior",8,5,2,3,2,0,7,0
Richmond,"Eggmolesse-Smith, Derek",11,6,1,5,0,0,0,4
Richmond,"Grimes, Dylan",11,8,6,3,0,0,0,3
Richmond,"Lambert, Kane",5,2,0,3,1,0,0,5
Richmond,"Lynch, Tom",8,6,3,2,1,0,0,0
Richmond,"Martin, Dustin",17,9,2,8,1,2,0,5
Richmond,"McIntosh, Kamdyn",18,12,5,6,0,0,0,2
Richmond,"Pickett, Marlion",8,2,1,6,0,0,0,4
Richmond,"Riewoldt, Jack",7,7,1,0,3,0,0,1
Richmond,"Rioli, Daniel",17,9,4,8,0,0,0,5
Richmond,"Ross, Jack",15,6,0,9,0,0,0,7
Richmond,"Short, Jayden",18,15,3,3,0,0,0,1
Richmond,"Soldo, Ivan",7,4,2,3,0,1,29,1
Richmond,"Stack, Sydney",8,1,1,7,1,0,0,3
Richmond,"Vlastuin, Nick",18,11,4,7,0,0,0,3
Richmond,"Aarts, Jake",4,3,2,1,0,0,0,4
Richmond,"Baker, Liam",17,11,5,6,0,0,0,2
Richmond,"Balta, Noah",9,8,4,1,0,0,0,0
Richmond,"Bolton, Shai",13,8,2,5,0,0,0,3
Richmond,"Broad, Nathan",9,8,5,1,0,0,0,4
Richmond,"Castagna, Jason",13,4,2,9,0,0,0,0
Richmond,"Chol, Mabior",3,2,1,1,1,0,2,2
Richmond,"Cotchin, Trent",26,13,2,13,0,0,0,6
Richmond,"Graham, Jack",16,6,2,10,0,0,0,8
Richmond,"Grimes, Dylan",11,9,4,2,0,0,0,1
Richmond,"Lambert, Kane",22,8,5,14,0,0,0,4
Richmond,"Lynch, Tom",10,7,6,3,2,1,0,0
Richmond,"Markov, Oleg",14,11,5,3,0,0,0,0
Richmond,"Martin, Dustin",20,11,2,9,0,0,0,3
Richmond,"McIntosh, Kamdyn",15,12,9,3,1,0,0,2
Richmond,"Pickett, Marlion",13,8,4,5,1,1,0,5
Richmond,"Riewoldt, Jack",10,10,8,0,2,2,0,0
Richmond,"Rioli, Daniel",11,5,4,6,0,0,0,3
Richmond,"Short, Jayden",18,14,4,4,0,0,0,3
Richmond,"Soldo, Ivan",9,4,2,5,1,0,24,2
Richmond,"Stack, Sydney",9,3,1,6,0,0,0,6
Richmond,"Vlastuin, Nick",15,10,7,5,0,0,0,1
Richmond,"Aarts, Jake",10,3,1,7,0,0,0,2
Richmond,"Baker, Liam",16,7,3,9,0,0,0,1
Richmond,"Balta, Noah",9,7,3,2,0,0,0,0
Richmond,"Bolton, Shai",29,16,5,13,1,0,0,0
Richmond,"Castagna, Jason",12,5,3,7,0,0,0,0
Richmond,"Chol, Mabior",5,2,1,3,1,0,8,1
Richmond,"Cotchin, Trent",14,9,3,5,0,0,0,1
Richmond,"Graham, Jack",23,9,2,14,0,1,0,2
Richmond,"Grimes, Dylan",10,7,3,3,0,1,0,3
Richmond,"Houli, Bachar",11,6,2,5,0,0,0,2
Richmond,"Lambert, Kane",18,8,5,10,1,0,0,4
Richmond,"Lynch, Tom",9,5,4,4,2,2,0,2
Richmond,"Markov, Oleg",9,7,2,2,0,1,0,1
Richmond,"Martin, Dustin",30,20,3,10,1,2,0,2
Richmond,"McIntosh, Kamdyn",18,13,5,5,0,1,0,1
Richmond,"Pickett, Marlion",18,11,6,7,0,0,0,2
Richmond,"Riewoldt, Jack",8,6,4,2,2,1,0,1
Richmond,"Rioli, Daniel",16,7,3,9,1,0,0,5
Richmond,"Short, Jayden",14,9,5,5,0,0,0,1
Richmond,"Soldo, Ivan",17,8,4,9,0,0,19,2
Richmond,"Stack, Sydney",10,3,3,7,0,1,0,1
Richmond,"Vlastuin, Nick",13,9,5,4,1,0,0,2
Richmond,"Aarts, Jake",16,5,1,11,1,0,0,3
Richmond,"Baker, Liam",15,11,4,4,0,0,0,3
Richmond,"Balta, Noah",16,14,9,2,1,0,0,0
Richmond,"Bolton, Shai",16,8,3,8,1,0,0,4
Richmond,"Castagna, Jason",16,10,6,6,1,0,0,3
Richmond,"Cotchin, Trent",26,18,2,8,0,0,0,1
Richmond,"Dow, Thomson",12,2,2,10,0,0,0,2
Richmond,"Graham, Jack",16,6,1,10,1,0,0,3
Richmond,"Grimes, Dylan",1,1,0,0,0,0,0,2
Richmond,"Houli, Bachar",23,17,7,6,0,0,0,3
Richmond,"Lambert, Kane",9,1,0,8,0,0,0,5
Richmond,"Lynch, Tom",4,3,2,1,3,0,0,1
Richmond,"Markov, Oleg",12,7,2,5,0,0,0,1
Richmond,"Martin, Dustin",17,10,2,7,2,0,0,6
Richmond,"McIntosh, Kamdyn",6,5,2,1,0,0,0,1
Richmond,"Nankervis, Toby",14,5,1,9,1,0,9,6
Richmond,"Pickett, Marlion",12,6,2,6,0,0,0,1
Richmond,"Riewoldt, Jack",9,4,1,5,1,1,0,1
Richmond,"Rioli, Daniel",10,6,2,4,1,0,0,5
Richmond,"Short, Jayden",19,17,8,2,0,0,0,1
Richmond,"Soldo, Ivan",9,5,3,4,1,0,22,1
Richmond,"Vlastuin, Nick",15,11,9,4,0,0,0,1
Richmond,"Aarts, Jake",13,7,2,6,1,0,0,4
Richmond,"Baker, Liam",15,11,2,4,0,0,0,2
Richmond,"Balta, Noah",14,8,6,6,0,0,0,1
Richmond,"Bolton, Shai",12,8,4,4,0,0,0,3
Richmond,"Broad, Nathan",9,8,5,1,0,0,0,1
Richmond,"Castagna, Jason",15,9,5,6,0,0,0,2
Richmond,"Cotchin, Trent",16,10,4,6,0,0,0,1
Richmond,"Dow, Thomson",4,0,0,4,0,0,0,2
Richmond,"Graham, Jack",18,12,2,6,1,0,0,2
Richmond,"Higgins, Jack",12,7,4,5,1,1,0,2
Richmond,"Houli, Bachar",18,11,2,7,0,0,0,1
Richmond,"Lynch, Tom",7,6,5,1,3,1,0,2
Richmond,"Markov, Oleg",11,10,3,1,0,0,0,1
Richmond,"Martin, Dustin",11,5,1,6,0,0,0,1
Richmond,"McIntosh, Kamdyn",16,13,7,3,1,0,0,1
Richmond,"Nankervis, Toby",1,1,0,0,0,1,16,3
Richmond,"Pickett, Marlion",19,10,3,9,0,0,0,3
Richmond,"Riewoldt, Jack",10,9,5,1,1,1,0,1
Richmond,"Rioli, Daniel",13,1,4,12,0,0,0,0
Richmond,"Short, Jayden",23,13,8,10,0,0,0,1
Richmond,"Soldo, Ivan",7,2,0,5,0,0,16,0
Richmond,"Vlastuin, Nick",17,11,8,6,0,0,0,3
Richmond,"Aarts, Jake",7,4,3,3,0,0,0,3
Richmond,"Baker, Liam",17,7,3,10,0,0,0,1
Richmond,"Balta, Noah",8,6,2,2,0,0,0,0
Richmond,"Bolton, Shai",18,10,5,8,0,1,0,6
Richmond,"Castagna, Jason",11,6,4,5,1,2,0,3
Richmond,"Cotchin, Trent",15,10,2,5,0,1,0,3
Richmond,"Graham, Jack",15,8,2,7,0,0,0,3
Richmond,"Grimes, Dylan",16,8,6,8,0,0,0,0
Richmond,"Houli, Bachar",10,6,1,4,0,1,0,2
Richmond,"Lambert, Kane",12,6,1,6,0,0,0,2
Richmond,"Lynch, Tom",9,6,3,3,1,2,0,3
Richmond,"Markov, Oleg",11,3,2,8,0,0,0,1
Richmond,"Martin, Dustin",19,13,4,6,0,3,0,3
Richmond,"McIntosh, Kamdyn",13,11,3,2,0,0,0,1
Richmond,"Nankervis, Toby",12,10,6,2,0,0,16,4
Richmond,"Pickett, Marlion",10,5,1,5,0,1,0,3
Richmond,"Riewoldt, Jack",10,7,6,3,4,0,0,0
Richmond,"Rioli, Daniel",14,11,5,3,1,1,0,2
Richmond,"Ross, Jack",13,7,3,6,0,0,0,4
Richmond,"Short, Jayden",16,10,3,6,0,1,0,1
Richmond,"Soldo, Ivan",2,2,1,0,0,0,7,2
Richmond,"Vlastuin, Nick",15,10,7,5,0,0,0,2
Richmond,"Aarts, Jake",12,7,3,5,2,0,0,1
Richmond,"Astbury, David",14,10,6,4,0,0,0,2
Richmond,"Baker, Liam",12,7,4,5,0,0,0,4
Richmond,"Balta, Noah",10,8,5,2,0,0,0,0
Richmond,"Caddy, Josh",8,5,3,3,2,0,1,0
Richmond,"Castagna, Jason",9,5,4,4,1,1,0,5
Richmond,"Chol, Mabior",3,3,1,0,1,0,2,2
Richmond,"Cotchin, Trent",12,8,0,4,0,0,0,3
Richmond,"Edwards, Shane",18,11,4,7,0,0,0,3
Richmond,"Graham, Jack",21,10,0,11,0,1,0,8
Richmond,"Grimes, Dylan",10,8,5,2,0,0,0,1
Richmond,"Houli, Bachar",14,9,2,5,0,0,0,3
Richmond,"Lambert, Kane",18,10,6,8,1,0,0,5
Richmond,"Martin, Dustin",28,16,6,12,1,0,1,0
Richmond,"McIntosh, Kamdyn",13,7,2,6,1,0,0,1
Richmond,"Nankervis, Toby",12,1,2,11,0,0,24,3
Richmond,"Pickett, Marlion",8,4,3,4,0,0,0,7
Richmond,"Riewoldt, Jack",13,8,6,5,2,0,0,1
Richmond,"Rioli, Daniel",14,8,2,6,1,1,0,3
Richmond,"Ross, Jack",12,8,2,4,0,0,0,3
Richmond,"Short, Jayden",20,17,7,3,0,0,0,1
Richmond,"Vlastuin, Nick",15,7,4,8,0,0,0,5
Richmond,"Aarts, Jake",8,5,4,3,0,0,0,3
Richmond,"Astbury, David",12,8,7,4,0,0,0,4
Richmond,"Baker, Liam",8,4,2,4,1,0,0,2
Richmond,"Balta, Noah",12,11,3,1,0,0,0,0
Richmond,"Bolton, Shai",17,9,1,8,0,1,0,1
Richmond,"Castagna, Jason",12,7,5,5,1,0,0,2
Richmond,"Chol, Mabior",7,1,1,6,0,0,9,0
Richmond,"Cotchin, Trent",18,10,2,8,1,0,0,1
Richmond,"Edwards, Shane",13,4,1,9,0,0,0,1
Richmond,"Graham, Jack",16,8,2,8,0,0,0,9
Richmond,"Grimes, Dylan",5,2,1,3,0,0,0,3
Richmond,"Houli, Bachar",17,10,2,7,0,0,0,3
Richmond,"Lambert, Kane",19,5,3,14,0,0,0,1
Richmond,"Martin, Dustin",18,15,1,3,0,0,0,2
Richmond,"McIntosh, Kamdyn",7,6,2,1,1,1,0,3
Richmond,"Nankervis, Toby",16,9,4,7,0,0,11,0
Richmond,"Pickett, Marlion",12,6,1,6,0,0,0,4
Richmond,"Prestia, Dion",20,7,0,13,0,0,0,4
Richmond,"Riewoldt, Jack",6,5,2,1,2,2,0,3
Richmond,"Rioli, Daniel",10,6,4,4,2,0,0,3
Richmond,"Short, Jayden",22,15,4,7,0,0,0,3
Richmond,"Vlastuin, Nick",14,8,1,6,0,0,0,1
Richmond,"Astbury, David",12,6,5,6,0,0,0,1
Richmond,"Baker, Liam",19,11,6,8,0,1,0,0
Richmond,"Balta, Noah",6,5,2,1,0,0,1,1
Richmond,"Bolton, Shai",11,8,2,3,3,0,0,1
Richmond,"Broad, Nathan",11,6,5,5,0,0,0,2
Richmond,"Castagna, Jason",9,7,4,2,1,0,0,2
Richmond,"Cotchin, Trent",19,9,3,10,0,0,0,0
Richmond,"Edwards, Shane",21,9,2,12,2,0,0,3
Richmond,"Graham, Jack",14,4,3,10,0,0,0,3
Richmond,"Grimes, Dylan",9,6,5,3,0,0,0,4
Richmond,"Houli, Bachar",32,16,5,16,0,0,0,2
Richmond,"Lambert, Kane",13,6,3,7,0,0,0,4
Richmond,"Lynch, Tom",17,13,6,4,2,5,0,3
Richmond,"Martin, Dustin",25,16,1,9,1,0,0,1
Richmond,"McIntosh, Kamdyn",19,12,5,7,1,0,0,1
Richmond,"Nankervis, Toby",14,4,3,10,0,0,15,4
Richmond,"Pickett, Marlion",9,3,0,6,0,0,0,2
Richmond,"Prestia, Dion",17,8,0,9,1,0,0,2
Richmond,"Riewoldt, Jack",4,2,2,2,0,0,0,3
Richmond,"Rioli, Daniel",15,9,2,6,1,0,0,3
Richmond,"Short, Jayden",17,14,7,3,0,0,0,1
Richmond,"Vlastuin, Nick",16,10,1,6,0,0,0,6
Richmond,"Astbury, David",7,5,0,2,0,0,3,3
Richmond,"Baker, Liam",12,9,0,3,0,0,0,3
Richmond,"Balta, Noah",11,10,3,1,0,1,0,1
Richmond,"Bolton, Shai",15,8,4,7,0,2,0,1
Richmond,"Broad, Nathan",9,8,3,1,0,0,0,4
Richmond,"Castagna, Jason",7,4,0,3,0,0,0,2
Richmond,"Cotchin, Trent",17,13,1,4,0,0,0,4
Richmond,"Edwards, Shane",11,6,0,5,0,0,0,3
Richmond,"Graham, Jack",14,8,0,6,0,0,0,4
Richmond,"Grimes, Dylan",5,4,1,1,0,0,0,3
Richmond,"Houli, Bachar",15,10,0,5,0,0,0,2
Richmond,"Lambert, Kane",13,8,0,5,2,1,0,6
Richmond,"Lynch, Tom",9,5,4,4,1,1,1,1
Richmond,"Martin, Dustin",21,12,3,9,2,0,0,1
Richmond,"McIntosh, Kamdyn",13,9,2,4,0,0,0,2
Richmond,"Nankervis, Toby",13,10,4,3,0,0,19,10
Richmond,"Pickett, Marlion",13,6,2,7,0,0,0,3
Richmond,"Prestia, Dion",19,11,0,8,0,0,0,3
Richmond,"Riewoldt, Jack",6,6,0,0,1,1,0,2
Richmond,"Rioli, Daniel",13,5,2,8,0,0,0,6
Richmond,"Short, Jayden",14,12,1,2,0,1,0,1
Richmond,"Vlastuin, Nick",11,8,2,3,0,0,0,1
Richmond,"Astbury, David",7,5,1,2,0,0,0,1
Richmond,"Baker, Liam",14,10,3,4,0,0,0,2
Richmond,"Balta, Noah",12,9,2,3,0,0,2,2
Richmond,"Bolton, Shai",16,11,3,5,0,1,0,7
Richmond,"Broad, Nathan",8,7,2,1,0,0,0,2
Richmond,"Castagna, Jason",11,8,2,3,1,1,0,4
Richmond,"Cotchin, Trent",19,13,2,6,0,0,0,4
Richmond,"Edwards, Shane",27,15,0,12,0,1,0,2
Richmond,"Graham, Jack",17,7,0,10,0,0,0,5
Richmond,"Grimes, Dylan",4,3,2,1,0,0,0,0
Richmond,"Houli, Bachar",11,4,1,7,0,0,0,1
Richmond,"Lambert, Kane",13,6,4,7,1,0,0,4
Richmond,"Lynch, Tom",8,7,3,1,1,1,0,3
Richmond,"Martin, Dustin",21,16,1,5,4,0,0,3
Richmond,"McIntosh, Kamdyn",13,8,3,5,1,0,0,2
Richmond,"Nankervis, Toby",8,5,0,3,0,0,25,6
Richmond,"Pickett, Marlion",14,6,0,8,0,0,0,5
Richmond,"Prestia, Dion",14,7,0,7,2,0,0,5
Richmond,"Riewoldt, Jack",9,8,3,1,2,2,0,3
Richmond,"Rioli, Daniel",6,1,1,5,0,0,0,4
Richmond,"Short, Jayden",25,18,3,7,0,0,0,6
Richmond,"Vlastuin, Nick",1,0,0,1,0,0,0,2
St Kilda,"Billings, Jack",18,9,2,9,2,0,0,6
St Kilda,"Butler, Dan",9,5,2,4,0,1,0,8
St Kilda,"Clark, Hunter",18,10,0,8,0,0,0,3
St Kilda,"Dunstan, Luke",21,13,3,8,0,0,0,9
St Kilda,"Geary, Jarryn",15,4,1,11,0,0,0,3
St Kilda,"Gresham, Jade",12,7,2,5,0,1,0,0
St Kilda,"Hannebery, Dan",22,11,3,11,0,1,0,4
St Kilda,"Hill, Bradley",12,9,1,3,0,0,0,1
St Kilda,"Howard, Dougal",5,4,2,1,0,0,0,3
St Kilda,"Jones, Zak",22,12,6,10,0,3,0,5
St Kilda,"Kent, Dean",14,8,5,6,0,2,0,5
St Kilda,"King, Max",6,5,1,1,2,1,0,0
St Kilda,"Long, Ben",14,7,3,7,0,0,0,2
St Kilda,"Lonie, Jack",6,4,1,2,0,1,0,3
St Kilda,"Marshall, Rowan",12,9,6,3,0,1,13,2
St Kilda,"Membrey, Tim",6,6,5,0,1,0,0,0
St Kilda,"Paton, Ben",14,7,2,7,0,0,0,5
St Kilda,"Roberton, Dylan",8,7,1,1,0,0,0,0
St Kilda,"Ross, Sebastian",22,10,0,12,0,0,0,2
St Kilda,"Ryder, Paddy",12,7,3,5,1,0,13,3
St Kilda,"Steele, Jack",22,8,2,14,1,0,0,4
St Kilda,"Wilkie, Callum",10,5,0,5,0,0,0,4
St Kilda,"Billings, Jack",24,17,4,7,3,0,0,5
St Kilda,"Butler, Dan",14,9,3,5,2,1,0,6
St Kilda,"Carlisle, Jake",7,6,3,1,0,0,0,1
St Kilda,"Clark, Hunter",19,16,7,3,0,0,0,4
St Kilda,"Coffield, Nick",12,6,3,6,0,0,0,1
St Kilda,"Geary, Jarryn",3,1,0,2,0,0,0,1
St Kilda,"Gresham, Jade",25,13,2,12,0,1,0,5
St Kilda,"Hannebery, Dan",20,13,2,7,1,0,0,4
St Kilda,"Hill, Bradley",19,10,3,9,0,0,0,1
St Kilda,"Hind, Nick",15,5,1,10,1,0,0,2
St Kilda,"Howard, Dougal",6,6,4,0,0,0,0,1
St Kilda,"Jones, Zak",29,14,6,15,1,0,0,3
St Kilda,"King, Max",10,6,4,4,2,0,0,0
St Kilda,"Long, Ben",9,5,4,4,0,0,0,2
St Kilda,"Lonie, Jack",15,12,8,3,1,1,0,3
St Kilda,"Marshall, Rowan",11,8,6,3,1,0,21,1
St Kilda,"Membrey, Tim",13,10,7,3,1,0,0,1
St Kilda,"Paton, Ben",16,6,4,10,0,0,0,2
St Kilda,"Ross, Sebastian",24,14,7,10,0,0,0,6
St Kilda,"Ryder, Paddy",5,4,1,1,0,0,28,2
St Kilda,"Steele, Jack",22,11,8,11,1,0,0,4
St Kilda,"Wilkie, Callum",18,12,5,6,0,0,0,2
St Kilda,"Billings, Jack",16,9,7,7,0,0,0,1
St Kilda,"Butler, Dan",16,12,2,4,2,1,0,4
St Kilda,"Carlisle, Jake",20,16,9,4,0,0,0,1
St Kilda,"Clark, Hunter",16,7,3,9,0,0,0,3
St Kilda,"Coffield, Nick",15,10,8,5,0,0,0,2
St Kilda,"Gresham, Jade",22,13,5,9,0,1,0,1
St Kilda,"Hannebery, Dan",16,4,5,12,0,0,0,1
St Kilda,"Hill, Bradley",25,18,7,7,0,0,0,2
St Kilda,"Hind, Nick",4,3,3,1,0,0,0,2
St Kilda,"Howard, Dougal",16,13,7,3,0,0,0,0
St Kilda,"Jones, Zak",16,7,2,9,0,0,0,5
St Kilda,"King, Max",8,5,4,3,1,1,1,2
St Kilda,"Long, Ben",11,6,3,5,0,0,0,1
St Kilda,"Lonie, Jack",9,5,4,4,0,1,0,2
St Kilda,"Marsh, Jonathon",9,4,3,5,1,0,0,1
St Kilda,"Marshall, Rowan",14,9,2,5,1,0,11,3
St Kilda,"Membrey, Tim",6,6,3,0,0,1,0,2
St Kilda,"Paton, Ben",18,10,7,8,0,0,0,1
St Kilda,"Ross, Sebastian",17,7,4,10,0,0,0,0
St Kilda,"Ryder, Paddy",8,6,2,2,0,0,17,3
St Kilda,"Steele, Jack",13,8,4,5,0,1,0,6
St Kilda,"Wilkie, Callum",10,7,1,3,0,0,0,0
St Kilda,"Battle, Josh",16,9,6,7,1,0,2,0
St Kilda,"Billings, Jack",25,13,5,12,0,0,0,2
St Kilda,"Butler, Dan",14,10,3,4,3,2,0,3
St Kilda,"Carlisle, Jake",9,8,9,1,0,0,3,1
St Kilda,"Clark, Hunter",15,8,2,7,0,0,0,5
St Kilda,"Coffield, Nick",16,10,5,6,0,0,0,1
St Kilda,"Gresham, Jade",10,4,2,6,0,0,0,2
St Kilda,"Hannebery, Dan",18,5,1,13,0,0,0,1
St Kilda,"Hill, Bradley",19,14,6,5,1,0,0,2
St Kilda,"Howard, Dougal",8,8,5,0,0,0,1,1
St Kilda,"Jones, Zak",12,6,2,6,0,0,0,0
St Kilda,"Kent, Dean",10,8,2,2,2,0,0,0
St Kilda,"King, Max",10,5,3,5,0,0,0,1
St Kilda,"Long, Ben",17,9,2,8,0,0,0,7
St Kilda,"Lonie, Jack",16,12,3,4,2,0,0,1
St Kilda,"Marsh, Jonathon",11,7,4,4,1,0,0,5
St Kilda,"Marshall, Rowan",15,8,4,7,2,0,25,2
St Kilda,"Membrey, Tim",13,7,7,6,3,1,0,3
St Kilda,"Paton, Ben",14,5,5,9,0,0,0,0
St Kilda,"Ross, Sebastian",16,9,2,7,0,0,0,3
St Kilda,"Steele, Jack",21,10,3,11,0,0,0,10
St Kilda,"Wilkie, Callum",10,8,1,2,0,0,0,2
St Kilda,"Battle, Josh",12,10,4,2,1,2,1,1
St Kilda,"Billings, Jack",23,12,6,11,1,0,0,1
St Kilda,"Butler, Dan",13,8,3,5,2,1,0,2
St Kilda,"Carlisle, Jake",9,5,4,4,0,0,0,1
St Kilda,"Clark, Hunter",10,6,4,4,0,0,0,3
St Kilda,"Coffield, Nick",20,13,9,7,0,0,0,1
St Kilda,"Geary, Jarryn",6,4,3,2,2,0,0,2
St Kilda,"Gresham, Jade",13,7,3,6,1,0,0,3
St Kilda,"Hannebery, Dan",13,7,2,6,0,0,0,1
St Kilda,"Hill, Bradley",8,6,3,2,0,0,0,0
St Kilda,"Howard, Dougal",7,5,1,2,0,0,0,0
St Kilda,"Kent, Dean",11,10,8,1,1,1,0,2
St Kilda,"King, Max",6,5,2,1,2,0,0,0
St Kilda,"Long, Ben",12,7,3,5,0,0,0,0
St Kilda,"Lonie, Jack",12,10,5,2,0,0,0,1
St Kilda,"Marsh, Jonathon",10,5,2,5,0,1,0,2
St Kilda,"Marshall, Rowan",19,14,3,5,0,0,22,3
St Kilda,"Membrey, Tim",10,7,4,3,1,1,0,1
St Kilda,"Paton, Ben",12,9,7,3,0,0,0,1
St Kilda,"Ross, Sebastian",21,12,3,9,0,0,0,3
St Kilda,"Steele, Jack",23,11,6,12,0,0,0,9
St Kilda,"Wilkie, Callum",18,12,5,6,0,0,0,0
St Kilda,"Battle, Josh",14,8,4,6,0,0,2,4
St Kilda,"Billings, Jack",18,12,6,6,1,1,0,0
St Kilda,"Butler, Dan",6,5,1,1,1,0,0,1
St Kilda,"Carlisle, Jake",12,9,7,3,0,0,4,0
St Kilda,"Clark, Hunter",18,10,1,8,0,0,0,0
St Kilda,"Coffield, Nick",12,5,6,7,0,0,0,1
St Kilda,"Geary, Jarryn",11,4,0,7,0,0,0,1
St Kilda,"Gresham, Jade",17,13,2,4,1,1,0,0
St Kilda,"Hill, Bradley",11,8,0,3,0,0,0,0
St Kilda,"Howard, Dougal",11,9,7,2,0,0,0,0
St Kilda,"Jones, Zak",15,9,2,6,2,0,0,4
St Kilda,"Kent, Dean",7,4,1,3,1,0,0,3
St Kilda,"King, Max",7,5,3,2,1,3,0,1
St Kilda,"Long, Ben",14,6,5,8,0,0,0,2
St Kilda,"Lonie, Jack",9,6,2,3,1,1,0,4
St Kilda,"Marsh, Jonathon",3,2,0,1,0,0,0,4
St Kilda,"Marshall, Rowan",9,7,2,2,0,0,29,1
St Kilda,"Membrey, Tim",11,8,6,3,3,1,0,2
St Kilda,"Paton, Ben",13,6,3,7,0,0,0,0
St Kilda,"Ross, Sebastian",12,5,2,7,0,0,0,1
St Kilda,"Steele, Jack",22,10,3,12,0,0,0,3
St Kilda,"Wilkie, Callum",18,14,3,4,0,0,0,1
St Kilda,"Battle, Josh",2,2,2,0,0,0,0,2
St Kilda,"Billings, Jack",14,10,3,4,0,0,0,5
St Kilda,"Butler, Dan",12,11,0,1,3,0,0,4
St Kilda,"Byrnes, Ryan",5,2,0,3,0,0,0,2
St Kilda,"Carlisle, Jake",12,7,5,5,0,0,0,4
St Kilda,"Clark, Hunter",16,10,5,6,0,0,0,2
St Kilda,"Coffield, Nick",17,13,7,4,0,0,0,0
St Kilda,"Geary, Jarryn",9,5,2,4,0,0,0,2
St Kilda,"Gresham, Jade",18,16,0,2,1,2,0,5
St Kilda,"Hill, Bradley",12,7,1,5,0,0,0,1
St Kilda,"Howard, Dougal",16,14,7,2,1,0,0,0
St Kilda,"Jones, Zak",20,14,4,6,0,1,0,3
St Kilda,"Kent, Dean",10,9,2,1,2,0,0,5
St Kilda,"King, Max",4,2,2,2,2,0,2,1
St Kilda,"Lonie, Jack",8,6,3,2,1,0,0,4
St Kilda,"Marshall, Rowan",8,5,3,3,0,0,10,4
St Kilda,"Membrey, Tim",7,2,1,5,1,0,0,0
St Kilda,"Paton, Ben",16,11,5,5,0,0,0,2
St Kilda,"Ross, Sebastian",10,4,1,6,0,0,0,3
St Kilda,"Ryder, Paddy",7,6,2,1,0,0,22,4
St Kilda,"Steele, Jack",26,13,3,13,1,0,0,6
St Kilda,"Wilkie, Callum",8,6,4,2,0,0,0,1
St Kilda,"Billings, Jack",22,12,3,10,0,0,0,2
St Kilda,"Butler, Dan",9,9,4,0,2,1,0,6
St Kilda,"Carlisle, Jake",13,8,4,5,0,0,0,0
St Kilda,"Clark, Hunter",24,17,3,7,0,0,0,1
St Kilda,"Coffield, Nick",7,6,4,1,0,0,0,2
St Kilda,"Geary, Jarryn",7,4,3,3,0,0,0,0
St Kilda,"Gresham, Jade",23,13,1,10,1,0,0,0
St Kilda,"Hill, Bradley",16,11,4,5,0,0,0,1
St Kilda,"Hind, Nick",12,5,1,7,1,0,0,4
St Kilda,"Howard, Dougal",8,7,5,1,0,0,0,3
St Kilda,"Jones, Zak",20,12,2,8,0,0,0,2
St Kilda,"Kent, Dean",6,4,2,2,1,0,0,0
St Kilda,"King, Max",8,4,2,4,1,0,0,2
St Kilda,"Marshall, Rowan",15,14,3,1,2,0,11,5
St Kilda,"Membrey, Tim",9,6,3,3,2,0,0,1
St Kilda,"Parker, Matthew",6,3,0,3,0,0,0,1
St Kilda,"Paton, Ben",16,10,7,6,0,0,0,2
St Kilda,"Ross, Sebastian",18,10,1,8,0,0,0,3
St Kilda,"Ryder, Paddy",10,4,2,6,2,0,29,0
St Kilda,"Sinclair, Jack",15,10,4,5,0,0,0,2
St Kilda,"Steele, Jack",21,9,3,12,0,0,0,6
St Kilda,"Wilkie, Callum",9,8,2,1,0,0,0,1
St Kilda,"Battle, Josh",11,7,3,4,2,1,0,2
St Kilda,"Billings, Jack",19,9,4,10,0,1,0,5
St Kilda,"Butler, Dan",13,11,1,2,2,0,0,8
St Kilda,"Carlisle, Jake",7,4,3,3,0,0,0,3
St Kilda,"Clark, Hunter",20,13,6,7,1,1,0,3
St Kilda,"Coffield, Nick",17,8,8,9,0,0,0,0
St Kilda,"Geary, Jarryn",6,1,0,5,1,0,0,4
St Kilda,"Gresham, Jade",23,13,3,10,2,0,0,1
St Kilda,"Hill, Bradley",15,10,2,5,0,0,0,2
St Kilda,"Hind, Nick",16,12,2,4,3,1,0,5
St Kilda,"Howard, Dougal",9,8,6,1,0,0,0,2
St Kilda,"Jones, Zak",21,8,3,13,1,0,0,5
St Kilda,"King, Max",9,3,2,6,3,0,2,3
St Kilda,"Marshall, Rowan",17,9,3,8,0,2,14,4
St Kilda,"Membrey, Tim",12,8,5,4,0,0,0,1
St Kilda,"Parker, Matthew",7,5,1,2,0,2,0,4
St Kilda,"Paton, Ben",14,11,7,3,0,0,0,0
St Kilda,"Ryder, Paddy",7,4,1,3,0,0,19,2
St Kilda,"Savage, Shane",14,13,4,1,0,2,0,3
St Kilda,"Sinclair, Jack",15,6,2,9,0,0,0,7
St Kilda,"Steele, Jack",23,14,2,9,0,0,0,6
St Kilda,"Wilkie, Callum",16,15,2,1,0,0,0,3
St Kilda,"Battle, Josh",13,11,4,2,2,0,1,0
St Kilda,"Billings, Jack",26,13,5,13,0,1,0,1
St Kilda,"Butler, Dan",13,12,1,1,4,1,0,4
St Kilda,"Carlisle, Jake",17,11,9,6,0,0,0,3
St Kilda,"Clark, Hunter",19,11,1,8,0,0,0,1
St Kilda,"Coffield, Nick",14,12,5,2,0,0,0,2
St Kilda,"Gresham, Jade",16,7,4,9,1,0,0,2
St Kilda,"Hill, Bradley",17,9,4,8,0,0,0,2
St Kilda,"Hind, Nick",17,11,3,6,0,1,0,2
St Kilda,"Howard, Dougal",10,4,1,6,0,0,0,1
St Kilda,"Jones, Zak",13,8,1,5,0,0,0,5
St Kilda,"Kent, Dean",11,8,3,3,1,0,0,1
St Kilda,"King, Max",6,5,3,1,1,0,1,4
St Kilda,"Long, Ben",5,2,3,3,0,0,0,0
St Kilda,"Marshall, Rowan",17,11,5,6,1,0,11,1
St Kilda,"Membrey, Tim",11,6,2,5,0,1,0,0
St Kilda,"Paton, Ben",11,7,2,4,0,0,0,1
St Kilda,"Phillips, Ed",13,6,7,7,0,0,0,2
St Kilda,"Ryder, Paddy",7,3,0,4,0,0,15,2
St Kilda,"Sinclair, Jack",18,10,3,8,0,0,0,3
St Kilda,"Steele, Jack",21,13,8,8,2,0,0,5
St Kilda,"Wilkie, Callum",18,14,6,4,0,0,0,0
St Kilda,"Battle, Josh",8,6,4,2,1,0,0,1
St Kilda,"Billings, Jack",17,9,3,8,1,0,0,4
St Kilda,"Butler, Dan",4,4,0,0,0,0,0,3
St Kilda,"Bytel, Jack",18,7,2,11,0,0,0,2
St Kilda,"Carlisle, Jake",10,8,5,2,0,0,2,0
St Kilda,"Clark, Hunter",16,10,4,6,0,0,0,1
St Kilda,"Coffield, Nick",14,9,4,5,0,0,0,1
St Kilda,"Geary, Jarryn",4,0,0,4,0,0,0,1
St Kilda,"Gresham, Jade",15,5,1,10,0,0,0,2
St Kilda,"Hill, Bradley",7,5,0,2,0,0,0,2
St Kilda,"Hind, Nick",8,5,0,3,0,1,0,1
St Kilda,"Howard, Dougal",6,5,1,1,0,1,0,2
St Kilda,"Kent, Dean",13,7,5,6,0,1,0,1
St Kilda,"King, Max",5,2,3,3,0,2,1,1
St Kilda,"Long, Ben",14,5,2,9,0,1,0,3
St Kilda,"Marshall, Rowan",16,14,1,2,0,0,24,1
St Kilda,"Membrey, Tim",12,7,3,5,0,0,1,0
St Kilda,"Paton, Ben",10,6,4,4,0,0,0,2
St Kilda,"Phillips, Ed",16,8,2,8,2,0,0,1
St Kilda,"Sinclair, Jack",19,7,1,12,0,0,0,2
St Kilda,"Steele, Jack",25,13,4,12,0,1,0,4
St Kilda,"Wilkie, Callum",10,9,2,1,0,0,0,2
St Kilda,"Battle, Josh",18,14,9,4,1,0,0,2
St Kilda,"Billings, Jack",23,13,6,10,0,0,0,1
St Kilda,"Butler, Dan",9,6,3,3,1,0,0,4
St Kilda,"Bytel, Jack",13,0,0,13,0,0,0,1
St Kilda,"Clark, Hunter",20,12,4,8,0,0,0,4
St Kilda,"Coffield, Nick",19,13,10,6,0,0,0,1
St Kilda,"Geary, Jarryn",13,9,7,4,0,0,0,1
St Kilda,"Hill, Bradley",17,14,6,3,0,1,0,2
St Kilda,"Hind, Nick",7,7,4,0,1,1,0,2
St Kilda,"Howard, Dougal",8,4,3,4,0,0,0,2
St Kilda,"Jones, Zak",26,15,4,11,0,0,0,5
St Kilda,"King, Max",7,5,6,2,3,1,0,1
St Kilda,"Long, Ben",12,7,4,5,0,0,0,0
St Kilda,"Lonie, Jack",10,8,4,2,1,1,0,0
St Kilda,"Marshall, Rowan",16,11,8,5,0,1,15,1
St Kilda,"Membrey, Tim",10,8,5,2,2,0,1,2
St Kilda,"Paton, Ben",1,0,0,1,0,0,0,0
St Kilda,"Ross, Sebastian",16,10,3,6,0,0,0,1
St Kilda,"Ryder, Paddy",10,9,4,1,1,1,18,3
St Kilda,"Sinclair, Jack",9,9,4,0,0,0,0,3
St Kilda,"Steele, Jack",21,9,1,12,0,0,0,1
St Kilda,"Wilkie, Callum",13,8,3,5,0,0,0,1
St Kilda,"Battle, Josh",13,9,2,4,0,2,0,4
St Kilda,"Billings, Jack",15,9,3,6,1,0,0,1
St Kilda,"Butler, Dan",8,7,2,1,2,0,0,5
St Kilda,"Bytel, Jack",8,2,1,6,0,0,0,5
St Kilda,"Carlisle, Jake",14,13,8,1,0,0,0,2
St Kilda,"Coffield, Nick",14,10,3,4,0,0,0,1
St Kilda,"Geary, Jarryn",16,9,7,7,0,0,0,0
St Kilda,"Hill, Bradley",15,12,4,3,0,0,0,0
St Kilda,"Hind, Nick",7,3,1,4,0,0,0,4
St Kilda,"Howard, Dougal",6,6,2,0,0,0,0,2
St Kilda,"Jones, Zak",23,12,1,11,0,1,0,3
St Kilda,"Kent, Dean",6,5,2,1,1,0,0,2
St Kilda,"King, Max",11,5,4,6,0,2,2,2
St Kilda,"Long, Ben",11,2,3,9,0,0,0,4
St Kilda,"Marshall, Rowan",14,11,4,3,1,1,10,2
St Kilda,"Membrey, Tim",9,7,5,2,1,0,0,8
St Kilda,"Paton, Ben",14,10,4,4,0,0,0,1
St Kilda,"Ross, Sebastian",15,7,0,8,0,0,0,3
St Kilda,"Ryder, Paddy",4,0,0,4,0,0,18,5
St Kilda,"Sinclair, Jack",11,7,2,4,0,0,0,3
St Kilda,"Steele, Jack",25,10,3,15,1,0,0,10
St Kilda,"Wilkie, Callum",12,10,2,2,0,0,0,1
St Kilda,"Battle, Josh",6,6,2,0,1,0,0,4
St Kilda,"Billings, Jack",14,11,5,3,0,1,0,2
St Kilda,"Butler, Dan",11,7,3,4,0,0,0,1
St Kilda,"Clark, Hunter",8,4,1,4,0,0,0,4
St Kilda,"Coffield, Nick",15,10,7,5,0,0,0,1
St Kilda,"Geary, Jarryn",14,10,5,4,0,0,0,4
St Kilda,"Hill, Bradley",27,15,5,12,0,0,0,1
St Kilda,"Hind, Nick",5,1,2,4,0,0,0,2
St Kilda,"Howard, Dougal",11,8,4,3,0,0,0,4
St Kilda,"Jones, Zak",20,10,3,10,0,0,0,8
St Kilda,"Kent, Dean",9,5,3,4,0,0,0,1
St Kilda,"King, Max",3,2,1,1,1,0,3,1
St Kilda,"Long, Ben",15,8,3,7,0,0,0,2
St Kilda,"Marshall, Rowan",13,10,6,3,1,2,11,4
St Kilda,"Membrey, Tim",7,5,3,2,1,2,0,1
St Kilda,"Paton, Ben",16,6,3,10,0,0,0,0
St Kilda,"Phillips, Ed",12,8,4,4,1,0,0,1
St Kilda,"Ross, Sebastian",15,9,0,6,0,0,0,4
St Kilda,"Ryder, Paddy",6,6,3,0,1,0,17,1
St Kilda,"Sinclair, Jack",14,9,1,5,0,0,0,0
St Kilda,"Steele, Jack",26,13,5,13,1,0,0,1
St Kilda,"Wilkie, Callum",15,7,4,8,0,0,0,0
St Kilda,"Abbott, Ryan",3,2,2,1,1,0,2,0
St Kilda,"Battle, Josh",9,8,3,1,1,3,0,2
St Kilda,"Billings, Jack",19,10,4,9,1,0,0,1
St Kilda,"Butler, Dan",14,10,4,4,1,1,0,2
St Kilda,"Clark, Hunter",15,9,7,6,0,0,0,1
St Kilda,"Coffield, Nick",21,14,11,7,0,0,0,2
St Kilda,"Geary, Jarryn",14,10,6,4,0,0,0,1
St Kilda,"Hill, Bradley",22,15,5,7,0,1,0,1
St Kilda,"Howard, Dougal",15,14,6,1,0,0,0,0
St Kilda,"Jones, Zak",22,11,6,11,1,0,0,2
St Kilda,"Kent, Dean",15,8,5,7,0,1,0,4
St Kilda,"Long, Ben",18,10,6,8,0,0,0,2
St Kilda,"Lonie, Jack",9,7,4,2,2,1,0,2
St Kilda,"Marsh, Jonathon",7,2,1,5,0,2,0,1
St Kilda,"Marshall, Rowan",14,11,8,3,2,2,2,1
St Kilda,"Paton, Ben",11,11,10,0,0,0,0,0
St Kilda,"Phillips, Ed",9,6,3,3,0,0,0,0
St Kilda,"Ross, Sebastian",23,15,2,8,0,0,0,2
St Kilda,"Ryder, Paddy",9,7,2,2,1,0,26,1
St Kilda,"Sinclair, Jack",13,6,6,7,0,0,0,3
St Kilda,"Steele, Jack",21,11,5,10,1,0,0,6
St Kilda,"Wilkie, Callum",11,8,6,3,0,0,0,0
St Kilda,"Battle, Josh",6,5,3,1,0,0,0,3
St Kilda,"Billings, Jack",18,11,2,7,0,0,0,2
St Kilda,"Butler, Dan",9,8,0,1,1,1,0,3
St Kilda,"Clark, Hunter",24,10,4,14,0,0,0,3
St Kilda,"Coffield, Nick",15,9,3,6,0,0,0,0
St Kilda,"Geary, Jarryn",13,10,3,3,0,0,0,2
St Kilda,"Hill, Bradley",14,11,5,3,0,1,0,2
St Kilda,"Hind, Nick",7,4,0,3,0,1,0,4
St Kilda,"Howard, Dougal",14,10,4,4,0,0,0,1
St Kilda,"Jones, Zak",15,7,1,8,0,3,0,2
St Kilda,"Kent, Dean",2,0,0,2,0,0,0,2
St Kilda,"King, Max",9,6,2,3,0,4,2,0
St Kilda,"Long, Ben",9,1,0,8,0,0,0,2
St Kilda,"Lonie, Jack",11,4,0,7,1,0,0,5
St Kilda,"Marshall, Rowan",11,7,1,4,1,0,11,2
St Kilda,"Membrey, Tim",11,8,4,3,1,0,1,3
St Kilda,"Paton, Ben",12,12,4,0,0,0,0,1
St Kilda,"Ross, Sebastian",18,6,0,12,1,0,0,6
St Kilda,"Ryder, Paddy",13,10,4,3,1,1,22,4
St Kilda,"Sinclair, Jack",19,12,1,7,0,0,0,3
St Kilda,"Steele, Jack",26,16,3,10,0,0,0,6
St Kilda,"Wilkie, Callum",9,7,3,2,0,0,0,2
St Kilda,"Battle, Josh",5,5,1,0,1,0,0,0
St Kilda,"Billings, Jack",12,8,2,4,1,0,0,2
St Kilda,"Butler, Dan",11,9,2,2,1,1,0,2
St Kilda,"Carlisle, Jake",5,5,1,0,0,0,0,1
St Kilda,"Clark, Hunter",16,11,3,5,0,0,0,5
St Kilda,"Coffield, Nick",15,11,7,4,0,0,0,0
St Kilda,"Geary, Jarryn",9,2,1,7,0,0,0,2
St Kilda,"Hannebery, Dan",13,9,2,4,0,1,0,1
St Kilda,"Hill, Bradley",14,12,4,2,1,0,0,3
St Kilda,"Howard, Dougal",9,8,3,1,0,0,0,0
St Kilda,"Kent, Dean",12,9,6,3,0,0,0,1
St Kilda,"King, Max",9,6,5,3,1,2,0,1
St Kilda,"Long, Ben",12,9,5,3,0,0,0,0
St Kilda,"Lonie, Jack",9,8,2,1,2,0,0,3
St Kilda,"Marshall, Rowan",18,14,7,4,1,1,7,1
St Kilda,"Membrey, Tim",9,8,3,1,1,1,0,1
St Kilda,"Paton, Ben",13,9,4,4,0,0,0,1
St Kilda,"Ross, Sebastian",19,13,1,6,0,1,0,1
St Kilda,"Ryder, Paddy",6,5,1,1,1,0,29,3
St Kilda,"Sinclair, Jack",13,7,2,6,0,0,0,3
St Kilda,"Steele, Jack",18,7,1,11,2,0,0,7
St Kilda,"Wilkie, Callum",11,9,4,2,0,0,0,1
St Kilda,"Billings, Jack",13,7,3,6,0,1,0,3
St Kilda,"Butler, Dan",9,5,1,4,1,1,0,2
St Kilda,"Carlisle, Jake",11,7,6,4,0,0,0,0
St Kilda,"Clark, Hunter",19,13,6,6,0,0,0,1
St Kilda,"Coffield, Nick",14,11,8,3,0,0,0,1
St Kilda,"Geary, Jarryn",12,7,7,5,2,1,0,0
St Kilda,"Hannebery, Dan",19,9,3,10,0,0,0,0
St Kilda,"Hill, Bradley",12,8,3,4,0,0,0,1
St Kilda,"Howard, Dougal",20,18,6,2,0,0,0,0
St Kilda,"Jones, Zak",16,7,2,9,0,0,0,2
St Kilda,"Kent, Dean",5,4,0,1,0,0,0,0
St Kilda,"King, Max",7,6,5,1,2,1,1,1
St Kilda,"Long, Ben",11,6,3,5,0,0,0,3
St Kilda,"Lonie, Jack",11,8,4,3,1,1,0,0
St Kilda,"Marshall, Rowan",11,10,6,1,0,0,10,1
St Kilda,"Membrey, Tim",16,13,9,3,2,1,0,1
St Kilda,"Paton, Ben",9,4,3,5,0,0,0,0
St Kilda,"Ross, Sebastian",16,5,0,11,0,1,0,6
St Kilda,"Ryder, Paddy",9,8,4,1,2,0,20,2
St Kilda,"Sinclair, Jack",14,8,2,6,0,0,0,1
St Kilda,"Steele, Jack",16,8,3,8,0,0,0,6
St Kilda,"Wilkie, Callum",14,12,4,2,0,0,0,1
St Kilda,"Battle, Josh",9,8,5,1,1,1,0,1
St Kilda,"Billings, Jack",16,11,5,5,0,1,0,3
St Kilda,"Butler, Dan",13,8,2,5,1,0,0,6
St Kilda,"Clark, Hunter",17,11,3,6,0,0,0,2
St Kilda,"Coffield, Nick",17,11,9,6,0,0,0,1
St Kilda,"Geary, Jarryn",14,3,3,11,0,0,0,4
St Kilda,"Hannebery, Dan",20,9,1,11,0,0,0,1
St Kilda,"Hill, Bradley",11,7,0,4,0,0,0,3
St Kilda,"Howard, Dougal",12,8,2,4,0,0,2,1
St Kilda,"Jones, Zak",14,5,2,9,0,0,0,3
St Kilda,"Kent, Dean",11,7,4,4,1,0,0,2
St Kilda,"King, Max",12,7,5,5,0,3,2,1
St Kilda,"Lonie, Jack",6,5,4,1,0,0,0,0
St Kilda,"Marsh, Jonathon",13,8,0,5,0,2,2,1
St Kilda,"Marshall, Rowan",16,10,5,6,0,1,20,2
St Kilda,"Membrey, Tim",12,7,8,5,0,0,0,0
St Kilda,"Paton, Ben",7,5,1,2,0,0,0,1
St Kilda,"Ross, Sebastian",25,10,3,15,1,0,0,1
St Kilda,"Savage, Shane",17,13,4,4,1,0,0,1
St Kilda,"Sinclair, Jack",11,7,2,4,0,1,0,0
St Kilda,"Steele, Jack",25,10,5,15,1,0,0,4
St Kilda,"Wilkie, Callum",10,7,4,3,0,0,0,0
Sydney,"Aliir, Aliir",11,6,3,5,0,0,4,2
Sydney,"Blakey, Nick",8,5,2,3,1,1,0,1
Sydney,"Brand, Kaiden",11,8,5,3,0,0,0,1
Sydney,"Cunningham, Harry",12,10,3,2,0,0,0,2
Sydney,"Dawson, Jordan",18,12,4,6,0,0,0,2
Sydney,"Florent, Oliver",21,15,2,6,0,1,0,2
Sydney,"Gray, Sam",16,9,3,7,1,0,0,3
Sydney,"Hayward, Will",4,2,1,2,2,0,0,1
Sydney,"Heeney, Isaac",16,12,5,4,4,1,0,4
Sydney,"Kennedy, Josh",25,13,2,12,1,0,0,7
Sydney,"Lloyd, Jake",17,10,4,7,0,0,0,1
Sydney,"McCartin, Tom",11,7,3,4,1,1,2,1
Sydney,"McInerney, Justin",15,7,1,8,0,0,0,2
Sydney,"Mills, Callum",18,11,4,7,0,0,0,3
Sydney,"Naismith, Sam",11,9,1,2,0,0,28,4
Sydney,"ORiordan, Colin",15,7,3,8,0,0,0,2
Sydney,"Papley, Tom",15,11,6,4,1,2,0,3
Sydney,"Parker, Luke",30,16,5,14,0,0,0,6
Sydney,"Rampe, Dane",10,8,4,2,0,0,0,3
Sydney,"Ronke, Ben",9,6,1,3,0,0,0,6
Sydney,"Rowbottom, James",11,9,1,2,0,1,0,3
Sydney,"Taylor, Lewis",9,7,5,2,0,1,0,4
Sydney,"Aliir, Aliir",15,7,2,8,0,0,7,3
Sydney,"Blakey, Nick",11,10,3,1,1,0,0,2
Sydney,"Brand, Kaiden",7,2,2,5,0,0,0,2
Sydney,"Cunningham, Harry",15,11,3,4,0,0,0,5
Sydney,"Dawson, Jordan",16,10,6,6,0,0,0,0
Sydney,"Florent, Oliver",27,22,4,5,0,0,0,2
Sydney,"Gray, Sam",7,4,2,3,0,1,0,2
Sydney,"Hayward, Will",9,5,1,4,0,1,0,2
Sydney,"Heeney, Isaac",10,4,0,6,1,1,0,4
Sydney,"Hewett, George",13,6,4,7,0,0,0,3
Sydney,"Kennedy, Josh",19,10,3,9,0,0,0,4
Sydney,"Lloyd, Jake",29,15,4,14,1,0,0,5
Sydney,"McCartin, Tom",6,4,3,2,1,0,0,0
Sydney,"McInerney, Justin",10,6,3,4,0,0,0,1
Sydney,"Mills, Callum",17,9,8,8,0,0,0,2
Sydney,"ORiordan, Colin",9,5,3,4,0,0,0,2
Sydney,"Papley, Tom",11,6,4,5,3,1,0,1
Sydney,"Parker, Luke",25,13,5,12,0,0,0,4
Sydney,"Rampe, Dane",20,16,8,4,0,0,0,1
Sydney,"Rowbottom, James",10,6,1,4,0,1,0,3
Sydney,"Sinclair, Callum",13,7,3,6,1,0,27,4
Sydney,"Taylor, Lewis",12,10,4,2,3,1,0,0
Sydney,"Aliir, Aliir",11,5,4,6,0,0,0,1
Sydney,"Blakey, Nick",6,5,2,1,1,2,0,3
Sydney,"Cunningham, Harry",11,4,1,7,0,0,0,4
Sydney,"Dawson, Jordan",16,14,2,2,1,0,0,3
Sydney,"Florent, Oliver",22,13,3,9,0,1,0,2
Sydney,"Fox, Robbie",13,12,5,1,0,0,0,1
Sydney,"Gray, Sam",13,4,1,9,0,0,0,3
Sydney,"Hayward, Will",6,2,0,4,1,0,0,2
Sydney,"Heeney, Isaac",18,12,8,6,1,2,0,2
Sydney,"Hewett, George",11,3,1,8,0,0,0,3
Sydney,"Kennedy, Josh",22,11,1,11,0,1,0,6
Sydney,"Lloyd, Jake",22,15,6,7,0,0,0,1
Sydney,"McCartin, Tom",2,1,2,1,0,1,1,1
Sydney,"McLean, Hayden",7,4,3,3,1,0,3,3
Sydney,"Mills, Callum",9,7,4,2,0,0,0,1
Sydney,"ORiordan, Colin",4,1,1,3,0,0,0,2
Sydney,"Papley, Tom",13,10,2,3,2,1,0,4
Sydney,"Parker, Luke",19,11,6,8,1,0,0,3
Sydney,"Rampe, Dane",8,5,1,3,0,0,0,1
Sydney,"Rowbottom, James",18,9,1,9,1,0,0,3
Sydney,"Sinclair, Callum",8,3,1,5,0,0,19,1
Sydney,"Taylor, Lewis",5,4,2,1,1,0,0,3
Sydney,"Aliir, Aliir",11,6,3,5,0,0,0,1
Sydney,"Blakey, Nick",6,5,1,1,0,1,0,2
Sydney,"Cunningham, Harry",13,8,5,5,0,0,0,2
Sydney,"Dawson, Jordan",16,10,2,6,0,0,0,1
Sydney,"Florent, Oliver",12,7,3,5,0,0,0,1
Sydney,"Fox, Robbie",9,5,2,4,0,0,0,0
Sydney,"Hayward, Will",11,5,6,6,0,0,0,4
Sydney,"Heeney, Isaac",11,9,6,2,0,2,0,3
Sydney,"Hewett, George",14,5,1,9,0,0,0,2
Sydney,"Kennedy, Josh",19,13,3,6,1,0,0,8
Sydney,"Lloyd, Jake",22,11,2,11,0,0,0,1
Sydney,"McInerney, Justin",12,4,2,8,0,0,0,4
Sydney,"McLean, Hayden",4,2,2,2,0,1,1,4
Sydney,"Mills, Callum",18,13,6,5,0,0,0,4
Sydney,"Naismith, Sam",8,6,4,2,0,0,25,5
Sydney,"Papley, Tom",13,10,8,3,4,2,0,0
Sydney,"Parker, Luke",25,13,3,12,0,0,0,3
Sydney,"Rampe, Dane",12,8,2,4,0,0,0,1
Sydney,"Ronke, Ben",10,7,3,3,0,0,0,4
Sydney,"Rowbottom, James",14,9,2,5,0,0,0,7
Sydney,"Sinclair, Callum",8,5,4,3,0,1,19,1
Sydney,"Taylor, Lewis",8,6,3,2,0,1,0,3
Sydney,"Aliir, Aliir",7,3,3,4,0,0,5,0
Sydney,"Blakey, Nick",13,10,5,3,0,1,0,3
Sydney,"Clarke, Ryan",14,3,1,11,0,0,0,4
Sydney,"Cunningham, Harry",9,6,1,3,0,0,0,1
Sydney,"Dawson, Jordan",15,10,3,5,0,1,0,1
Sydney,"Florent, Oliver",19,12,5,7,1,0,0,1
Sydney,"Gray, Sam",11,4,1,7,0,0,0,1
Sydney,"Hayward, Will",8,2,4,6,0,0,0,5
Sydney,"Heeney, Isaac",15,8,5,7,1,1,0,1
Sydney,"Hewett, George",12,6,2,6,1,0,0,2
Sydney,"Kennedy, Josh",25,10,6,15,0,1,0,6
Sydney,"Lloyd, Jake",26,16,5,10,0,0,0,3
Sydney,"McInerney, Justin",13,4,3,9,0,0,0,1
Sydney,"McLean, Hayden",8,5,1,3,2,0,5,2
Sydney,"Melican, Lewis",5,3,1,2,0,0,0,1
Sydney,"Mills, Callum",18,8,4,10,0,0,0,3
Sydney,"ORiordan, Colin",7,3,1,4,0,0,0,0
Sydney,"Papley, Tom",15,8,8,7,1,1,0,0
Sydney,"Parker, Luke",19,10,3,9,0,1,0,6
Sydney,"Rampe, Dane",7,4,1,3,0,0,0,1
Sydney,"Ronke, Ben",10,6,2,4,0,0,0,1
Sydney,"Rowbottom, James",16,8,2,8,0,1,0,4
Sydney,"Blakey, Nick",9,6,1,3,0,3,0,4
Sydney,"Clarke, Ryan",23,7,2,16,0,0,0,1
Sydney,"Cunningham, Harry",18,13,3,5,0,0,0,1
Sydney,"Dawson, Jordan",13,9,0,4,0,2,0,4
Sydney,"Florent, Oliver",17,7,3,10,0,0,0,3
Sydney,"Fox, Robbie",13,5,2,8,0,0,0,4
Sydney,"Gray, Sam",7,4,4,3,0,0,0,3
Sydney,"Hayward, Will",13,8,4,5,0,0,0,0
Sydney,"Heeney, Isaac",16,8,5,8,0,0,0,1
Sydney,"Hewett, George",15,6,2,9,0,0,0,5
Sydney,"Kennedy, Josh",2,2,1,0,0,0,0,1
Sydney,"Lloyd, Jake",24,19,6,5,0,0,0,1
Sydney,"McLean, Hayden",11,7,3,4,0,0,5,4
Sydney,"Mills, Callum",29,23,9,6,0,1,0,4
Sydney,"ORiordan, Colin",12,7,3,5,0,0,0,3
Sydney,"Papley, Tom",10,7,3,3,2,1,0,1
Sydney,"Parker, Luke",10,4,2,6,0,0,0,5
Sydney,"Rampe, Dane",16,10,3,6,0,0,0,1
Sydney,"Rowbottom, James",15,9,3,6,1,0,0,2
Sydney,"Stephens, Dylan",11,10,5,1,0,1,0,4
Sydney,"Stoddart, Ryley",10,4,2,6,0,0,0,2
Sydney,"Warner, Chad",8,4,2,4,0,0,0,2
Sydney,"Aliir, Aliir",7,5,5,2,2,0,4,0
Sydney,"Blakey, Nick",4,3,1,1,0,0,0,3
Sydney,"Clarke, Ryan",17,11,3,6,1,0,0,0
Sydney,"Cunningham, Harry",21,13,1,8,0,0,0,2
Sydney,"Dawson, Jordan",16,11,3,5,0,1,0,3
Sydney,"Florent, Oliver",9,6,1,3,0,1,0,4
Sydney,"Fox, Robbie",8,4,1,4,0,0,0,6
Sydney,"Hayward, Will",12,6,3,6,2,0,0,5
Sydney,"Hewett, George",18,3,1,15,0,0,0,4
Sydney,"Lloyd, Jake",24,15,3,9,0,0,0,1
Sydney,"McCartin, Tom",9,5,4,4,2,0,0,2
Sydney,"Mills, Callum",21,11,3,10,0,0,0,2
Sydney,"ORiordan, Colin",4,1,0,3,0,0,0,0
Sydney,"Papley, Tom",10,9,3,1,2,0,0,2
Sydney,"Parker, Luke",27,16,4,11,0,0,0,8
Sydney,"Rampe, Dane",15,9,3,6,0,0,0,4
Sydney,"Rowbottom, James",15,9,1,6,0,1,0,2
Sydney,"Sinclair, Callum",8,4,2,4,0,0,16,7
Sydney,"Stephens, Dylan",11,8,3,3,0,1,0,1
Sydney,"Stoddart, Ryley",16,12,2,4,0,0,0,1
Sydney,"Taylor, Elijah",9,6,1,3,0,0,0,0
Sydney,"Warner, Chad",6,5,1,1,0,0,0,1
Sydney,"Aliir, Aliir",11,8,5,3,0,0,3,1
Sydney,"Bell, James",7,4,3,3,0,0,0,3
Sydney,"Blakey, Nick",11,7,4,4,1,0,0,2
Sydney,"Clarke, Ryan",20,14,1,6,0,1,0,5
Sydney,"Cunningham, Harry",19,9,4,10,0,0,0,6
Sydney,"Dawson, Jordan",14,11,2,3,0,0,0,1
Sydney,"Florent, Oliver",20,12,1,8,0,0,0,3
Sydney,"Fox, Robbie",10,5,1,5,0,0,0,1
Sydney,"Gray, Sam",11,8,3,3,0,0,0,1
Sydney,"Ling, Matt",10,7,2,3,0,0,0,1
Sydney,"Lloyd, Jake",34,18,7,16,0,0,0,2
Sydney,"McCartin, Tom",8,5,4,3,1,0,0,0
Sydney,"Mills, Callum",17,10,5,7,0,0,0,8
Sydney,"Papley, Tom",11,10,2,1,4,2,0,1
Sydney,"Parker, Luke",22,15,3,7,1,1,0,5
Sydney,"Rampe, Dane",25,12,5,13,0,0,0,0
Sydney,"Reid, Sam",12,6,4,6,1,0,0,0
Sydney,"Rowbottom, James",18,13,1,5,0,0,0,3
Sydney,"Sinclair, Callum",5,4,2,1,0,1,24,3
Sydney,"Stephens, Dylan",9,3,1,6,0,0,0,0
Sydney,"Taylor, Elijah",8,5,0,3,1,1,0,1
Sydney,"Taylor, Lewis",14,7,4,7,0,0,0,1
Sydney,"Aliir, Aliir",12,7,3,5,0,1,10,1
Sydney,"Bell, James",15,8,3,7,0,0,0,4
Sydney,"Blakey, Nick",5,3,1,2,0,1,0,1
Sydney,"Clarke, Ryan",10,8,0,2,0,0,0,0
Sydney,"Cunningham, Harry",18,10,4,8,0,0,0,2
Sydney,"Dawson, Jordan",13,9,4,4,0,0,0,3
Sydney,"Florent, Oliver",20,14,0,6,1,1,0,4
Sydney,"Fox, Robbie",16,5,2,11,0,0,0,2
Sydney,"Gray, Sam",10,5,1,5,0,1,0,2
Sydney,"Hayward, Will",15,10,6,5,0,1,0,4
Sydney,"Ling, Matt",10,8,1,2,0,0,0,1
Sydney,"Lloyd, Jake",25,14,2,11,0,0,0,2
Sydney,"McCartin, Tom",9,6,5,3,3,0,0,1
Sydney,"Mills, Callum",20,7,2,13,0,0,0,1
Sydney,"Papley, Tom",9,6,1,3,1,2,0,2
Sydney,"Parker, Luke",27,14,4,13,0,1,0,4
Sydney,"Rampe, Dane",14,10,3,4,0,0,0,1
Sydney,"Reid, Sam",10,3,4,7,0,1,0,1
Sydney,"Rowbottom, James",16,7,3,9,0,0,0,6
Sydney,"Sinclair, Callum",5,4,1,1,1,0,27,3
Sydney,"Taylor, Elijah",8,4,1,4,0,0,0,1
Sydney,"Taylor, Lewis",10,5,1,5,0,1,0,5
Sydney,"Aliir, Aliir",3,1,1,2,0,0,2,0
Sydney,"Bell, James",6,5,1,1,1,0,0,5
Sydney,"Cunningham, Harry",13,9,2,4,0,0,0,1
Sydney,"Dawson, Jordan",17,10,8,7,0,0,0,4
Sydney,"Florent, Oliver",12,7,1,5,0,0,0,6
Sydney,"Fox, Robbie",8,4,3,4,0,0,0,3
Sydney,"Hayward, Will",13,7,5,6,0,0,0,4
Sydney,"Ling, Matt",6,5,2,1,0,0,0,0
Sydney,"Lloyd, Jake",25,19,7,6,0,0,0,3
Sydney,"McCartin, Tom",9,5,3,4,0,0,0,2
Sydney,"Melican, Lewis",7,4,1,3,0,0,0,1
Sydney,"Mills, Callum",12,10,4,2,0,0,0,5
Sydney,"Papley, Tom",7,6,1,1,1,2,0,5
Sydney,"Parker, Luke",12,6,2,6,0,0,0,12
Sydney,"Rampe, Dane",12,8,5,4,0,0,0,1
Sydney,"Reid, Sam",8,6,5,2,0,1,0,3
Sydney,"Rowbottom, James",17,8,0,9,0,0,0,2
Sydney,"Sinclair, Callum",12,7,3,5,0,0,22,4
Sydney,"Stephens, Dylan",12,9,2,3,1,1,0,5
Sydney,"Taylor, Elijah",6,2,2,4,0,0,0,0
Sydney,"Thurlow, Jackson",15,10,5,5,2,1,0,3
Sydney,"Wicks, Sam",9,6,1,3,1,0,0,6
Sydney,"Bell, James",13,6,3,7,1,0,0,5
Sydney,"Blakey, Nick",18,14,6,4,2,1,0,3
Sydney,"Cunningham, Harry",10,7,4,3,0,0,0,0
Sydney,"Dawson, Jordan",18,13,5,5,2,0,0,2
Sydney,"Florent, Oliver",12,9,0,3,0,0,0,4
Sydney,"Foot, Zac",10,6,5,4,1,0,0,1
Sydney,"Fox, Robbie",4,4,2,0,0,0,0,3
Sydney,"Hayward, Will",6,3,2,3,1,0,0,1
Sydney,"Lloyd, Jake",27,20,6,7,0,0,0,4
Sydney,"McCartin, Tom",5,4,3,1,0,0,0,2
Sydney,"Melican, Lewis",15,10,3,5,0,0,0,2
Sydney,"Mills, Callum",19,14,10,5,0,0,0,2
Sydney,"ORiordan, Colin",15,8,3,7,0,0,0,2
Sydney,"Papley, Tom",10,8,1,2,0,3,0,3
Sydney,"Parker, Luke",29,15,3,14,0,1,0,6
Sydney,"Rampe, Dane",22,15,7,7,0,0,0,1
Sydney,"Reid, Sam",6,3,3,3,0,0,10,1
Sydney,"Rowbottom, James",20,17,2,3,1,0,0,2
Sydney,"Sinclair, Callum",12,6,4,6,0,0,28,2
Sydney,"Stephens, Dylan",11,8,4,3,1,0,0,6
Sydney,"Thurlow, Jackson",15,11,7,4,1,0,0,3
Sydney,"Wicks, Sam",6,2,1,4,0,0,0,2
Sydney,"Bell, James",7,4,2,3,0,0,0,4
Sydney,"Blakey, Nick",15,12,3,3,0,0,0,2
Sydney,"Cunningham, Harry",21,11,6,10,0,0,0,2
Sydney,"Dawson, Jordan",19,17,6,2,0,0,0,1
Sydney,"Florent, Oliver",20,8,2,12,0,0,0,2
Sydney,"Foot, Zac",4,1,1,3,0,0,0,3
Sydney,"Fox, Robbie",15,12,3,3,0,0,0,2
Sydney,"Hayward, Will",9,3,2,6,0,0,0,1
Sydney,"Kennedy, Josh",17,8,2,9,0,0,0,4
Sydney,"Lloyd, Jake",28,21,7,7,0,0,0,1
Sydney,"McCartin, Tom",8,6,4,2,1,0,0,0
Sydney,"Melican, Lewis",13,10,4,3,0,0,0,2
Sydney,"Mills, Callum",16,6,5,10,0,0,0,2
Sydney,"ORiordan, Colin",10,7,6,3,0,0,0,2
Sydney,"Papley, Tom",12,11,3,1,0,0,0,2
Sydney,"Parker, Luke",17,9,3,8,0,0,0,4
Sydney,"Reid, Sam",10,8,7,2,0,3,6,0
Sydney,"Rowbottom, James",19,11,2,8,0,0,0,6
Sydney,"Sinclair, Callum",9,5,5,4,0,0,26,1
Sydney,"Stephens, Dylan",11,5,2,6,0,0,0,5
Sydney,"Thurlow, Jackson",16,7,2,9,0,1,0,2
Sydney,"Wicks, Sam",7,3,2,4,1,0,0,2
Sydney,"Aliir, Aliir",13,8,7,5,0,0,10,1
Sydney,"Bell, James",6,4,1,2,1,1,0,4
Sydney,"Blakey, Nick",8,7,1,1,1,1,0,1
Sydney,"Clarke, Ryan",20,9,5,11,0,0,0,3
Sydney,"Cunningham, Harry",15,7,5,8,0,1,0,3
Sydney,"Dawson, Jordan",16,11,4,5,1,1,0,6
Sydney,"Florent, Oliver",15,14,3,1,0,0,0,2
Sydney,"Fox, Robbie",14,10,5,4,0,0,0,1
Sydney,"Hayward, Will",12,7,3,5,0,0,0,1
Sydney,"Kennedy, Josh",28,9,5,19,0,0,0,4
Sydney,"Lloyd, Jake",31,24,7,7,0,0,0,3
Sydney,"McCartin, Tom",16,8,6,8,0,0,0,1
Sydney,"McInerney, Justin",15,8,1,7,0,0,0,1
Sydney,"Melican, Lewis",10,5,3,5,0,0,0,4
Sydney,"Mills, Callum",20,12,5,8,0,0,0,4
Sydney,"Papley, Tom",11,7,2,4,1,0,0,1
Sydney,"Parker, Luke",18,4,0,14,0,0,0,6
Sydney,"Reid, Sam",7,3,4,4,2,0,2,1
Sydney,"Rowbottom, James",12,3,0,9,0,0,0,5
Sydney,"Sinclair, Callum",7,6,2,1,1,0,27,6
Sydney,"Thurlow, Jackson",14,7,2,7,0,0,0,1
Sydney,"Wicks, Sam",6,4,0,2,0,1,0,9
Sydney,"Aliir, Aliir",8,6,3,2,0,0,0,1
Sydney,"Blakey, Nick",16,14,1,2,0,0,0,1
Sydney,"Clarke, Ryan",22,13,5,9,1,0,0,5
Sydney,"Cunningham, Harry",12,6,2,6,0,0,0,2
Sydney,"Dawson, Jordan",16,14,4,2,0,2,0,1
Sydney,"Florent, Oliver",8,5,0,3,0,0,0,2
Sydney,"Fox, Robbie",3,2,0,1,0,0,0,8
Sydney,"Hayward, Will",9,6,5,3,1,1,0,1
Sydney,"Kennedy, Josh",24,14,0,10,0,1,0,5
Sydney,"Lloyd, Jake",28,17,2,11,0,0,0,2
Sydney,"McCartin, Tom",10,4,1,6,0,0,0,0
Sydney,"McInerney, Justin",14,7,5,7,2,0,0,1
Sydney,"McLean, Hayden",6,4,2,2,1,0,0,2
Sydney,"Melican, Lewis",6,2,1,4,0,0,0,1
Sydney,"Papley, Tom",14,9,2,5,0,2,0,3
Sydney,"Parker, Luke",24,12,3,12,2,1,0,5
Sydney,"Reid, Sam",9,3,4,6,0,0,4,3
Sydney,"Rowbottom, James",13,5,1,8,1,0,0,3
Sydney,"Sinclair, Callum",11,0,1,11,0,0,15,1
Sydney,"Taylor, Lewis",11,8,2,3,1,0,0,3
Sydney,"Thurlow, Jackson",14,9,5,5,0,0,0,3
Sydney,"Wicks, Sam",11,5,4,6,1,0,0,5
Sydney,"Aliir, Aliir",4,2,0,2,0,0,7,7
Sydney,"Blakey, Nick",10,8,2,2,0,0,0,6
Sydney,"Clarke, Ryan",10,4,2,6,0,0,0,3
Sydney,"Cunningham, Harry",12,11,5,1,0,0,0,2
Sydney,"Dawson, Jordan",15,10,4,5,1,0,0,3
Sydney,"Florent, Oliver",15,12,4,3,2,0,0,4
Sydney,"Fox, Robbie",11,7,2,4,0,0,0,1
Sydney,"Hayward, Will",11,9,4,2,1,0,0,3
Sydney,"Kennedy, Josh",16,13,2,3,0,0,0,4
Sydney,"Lloyd, Jake",24,14,3,10,0,0,0,3
Sydney,"McCartin, Tom",11,6,7,5,0,0,0,1
Sydney,"McInerney, Justin",13,7,1,6,1,0,0,2
Sydney,"McLean, Hayden",2,2,2,0,1,0,0,0
Sydney,"Melican, Lewis",13,8,4,5,0,0,0,1
Sydney,"Papley, Tom",10,7,3,3,0,1,0,1
Sydney,"Parker, Luke",17,7,0,10,0,0,0,3
Sydney,"Reid, Sam",7,4,3,3,1,1,3,3
Sydney,"Rowbottom, James",9,3,1,6,0,0,0,5
Sydney,"Sinclair, Callum",8,6,1,2,0,1,21,0
Sydney,"Taylor, Lewis",9,4,1,5,1,1,0,1
Sydney,"Thurlow, Jackson",11,7,1,4,0,0,0,1
Sydney,"Wicks, Sam",7,3,2,4,0,0,0,3
Sydney,"Aliir, Aliir",9,7,3,2,0,0,11,4
Sydney,"Amartey, Joel",3,3,0,0,0,0,8,2
Sydney,"Bell, James",14,5,0,9,0,1,0,3
Sydney,"Blakey, Nick",14,11,0,3,0,0,0,1
Sydney,"Clarke, Ryan",13,7,2,6,0,0,0,2
Sydney,"Cunningham, Harry",14,11,8,3,0,0,0,1
Sydney,"Florent, Oliver",14,9,0,5,0,0,0,1
Sydney,"Fox, Robbie",10,5,1,5,0,0,0,2
Sydney,"Hayward, Will",11,7,5,4,2,0,0,2
Sydney,"Kennedy, Josh",26,13,5,13,0,0,0,10
Sydney,"Lloyd, Jake",26,20,4,6,0,0,0,2
Sydney,"McCartin, Tom",4,3,1,1,0,0,0,1
Sydney,"McInerney, Justin",17,6,3,11,0,0,0,1
Sydney,"Melican, Lewis",9,6,1,3,0,0,0,1
Sydney,"Mills, Callum",17,11,4,6,0,0,0,3
Sydney,"Papley, Tom",12,10,3,2,2,2,0,0
Sydney,"Parker, Luke",33,13,3,20,2,0,0,2
Sydney,"Reid, Sam",5,3,1,2,0,0,1,2
Sydney,"Stephens, Dylan",16,13,5,3,0,0,0,2
Sydney,"Taylor, Lewis",0,0,0,0,0,0,0,0
Sydney,"Thurlow, Jackson",11,7,2,4,0,0,0,3
Sydney,"Wicks, Sam",12,8,5,4,0,0,0,5
Sydney,"Aliir, Aliir",13,7,3,6,1,0,3,0
Sydney,"Bell, James",1,1,0,0,0,0,0,0
Sydney,"Blakey, Nick",8,6,3,2,1,2,0,1
Sydney,"Clarke, Ryan",16,10,4,6,0,0,0,2
Sydney,"Cunningham, Harry",20,11,2,9,0,0,0,2
Sydney,"Dawson, Jordan",22,12,3,10,1,0,0,3
Sydney,"Florent, Oliver",15,8,8,7,0,0,0,0
Sydney,"Fox, Robbie",10,6,1,4,0,0,0,3
Sydney,"Hayward, Will",12,5,3,7,0,0,0,1
Sydney,"Kennedy, Josh",25,13,4,12,1,0,0,3
Sydney,"Lloyd, Jake",27,16,6,11,0,0,0,2
Sydney,"McCartin, Tom",11,6,5,5,0,0,0,0
Sydney,"McInerney, Justin",16,11,7,5,2,0,0,0
Sydney,"Melican, Lewis",11,4,3,7,0,0,0,1
Sydney,"Mills, Callum",20,12,4,8,0,0,0,5
Sydney,"Papley, Tom",17,13,5,4,2,5,0,0
Sydney,"Parker, Luke",23,12,5,11,0,0,0,2
Sydney,"Reid, Sam",10,4,3,6,1,0,0,1
Sydney,"Rowbottom, James",14,6,1,8,0,0,0,2
Sydney,"Sinclair, Callum",13,7,3,6,0,0,22,0
Sydney,"Stephens, Dylan",19,12,5,7,0,0,0,3
Sydney,"Thurlow, Jackson",11,7,3,4,0,0,0,1
West Coast,"Ah Chee, Brendon",12,7,3,5,2,1,0,2
West Coast,"Barrass, Tom",16,14,9,2,0,0,0,0
West Coast,"Brander, Jarrod",13,9,7,4,0,1,0,1
West Coast,"Cripps, Jamie",12,9,7,3,0,0,0,1
West Coast,"Darling, Jack",8,4,2,4,1,0,0,3
West Coast,"Duggan, Liam",21,12,8,9,0,0,0,1
West Coast,"Gaff, Andrew",30,16,8,14,1,0,0,0
West Coast,"Hickey, Tom",4,1,0,3,0,0,8,0
West Coast,"Hurn, Shannon",23,17,9,6,0,0,0,1
West Coast,"Jetta, Lewis",18,14,8,4,1,0,0,3
West Coast,"Kelly, Tim",19,14,5,5,1,0,0,2
West Coast,"Kennedy, Josh",4,2,3,2,0,0,0,0
West Coast,"McGovern, Jeremy",12,7,3,5,0,0,0,3
West Coast,"Naitanui, Nic",13,4,1,9,0,0,23,0
West Coast,"Nelson, Jackson",12,8,6,4,0,0,0,2
West Coast,"Petruccelle, Jack",5,4,4,1,1,0,0,1
West Coast,"Redden, Jack",9,5,4,4,0,0,0,1
West Coast,"Ryan, Liam",14,14,4,0,3,3,0,3
West Coast,"Sheed, Dom",22,15,6,7,2,0,0,1
West Coast,"Sheppard, Brad",16,12,8,4,0,0,0,0
West Coast,"Shuey, Luke",27,18,8,9,0,0,0,5
West Coast,"Yeo, Elliot",12,8,6,4,0,0,0,5
West Coast,"Ah Chee, Brendon",3,1,0,2,0,0,0,0
West Coast,"Allen, Oscar",8,7,4,1,2,0,7,3
West Coast,"Barrass, Tom",8,5,3,3,0,0,0,0
West Coast,"Brander, Jarrod",12,8,3,4,0,0,0,2
West Coast,"Cripps, Jamie",7,3,1,4,0,0,0,2
West Coast,"Darling, Jack",9,5,3,4,1,1,0,2
West Coast,"Duggan, Liam",13,10,4,3,0,0,0,2
West Coast,"Gaff, Andrew",29,20,2,9,0,0,0,3
West Coast,"Hurn, Shannon",16,11,4,5,0,0,0,1
West Coast,"Jetta, Lewis",16,11,4,5,0,0,0,3
West Coast,"Kelly, Tim",24,13,1,11,0,0,0,8
West Coast,"Kennedy, Josh",5,4,3,1,1,1,0,1
West Coast,"McGovern, Jeremy",9,7,5,2,0,0,0,2
West Coast,"Naitanui, Nic",9,7,0,2,0,0,36,1
West Coast,"Nelson, Jackson",5,2,0,3,0,0,0,3
West Coast,"Petruccelle, Jack",8,5,0,3,1,2,0,0
West Coast,"Redden, Jack",18,9,4,9,0,0,0,3
West Coast,"Ryan, Liam",11,8,1,3,0,4,0,1
West Coast,"Sheed, Dom",19,10,5,9,0,1,0,1
West Coast,"Sheppard, Brad",12,7,5,5,0,0,0,2
West Coast,"Shuey, Luke",25,18,3,7,1,0,0,2
West Coast,"Yeo, Elliot",21,12,1,9,0,0,0,13
West Coast,"Ah Chee, Brendon",13,9,2,4,0,1,0,1
West Coast,"Allen, Oscar",8,3,1,5,0,1,7,2
West Coast,"Barrass, Tom",2,2,1,0,0,0,0,1
West Coast,"Brander, Jarrod",14,12,8,2,0,0,0,1
West Coast,"Cripps, Jamie",11,7,1,4,0,0,0,5
West Coast,"Darling, Jack",7,3,3,4,1,0,0,3
West Coast,"Duggan, Liam",10,9,2,1,0,0,0,2
West Coast,"Gaff, Andrew",30,23,7,7,0,2,0,1
West Coast,"Hurn, Shannon",14,12,5,2,0,0,0,1
West Coast,"Jetta, Lewis",10,10,2,0,0,0,0,2
West Coast,"Kelly, Tim",17,11,1,6,0,0,0,4
West Coast,"Kennedy, Josh",5,3,2,2,1,0,0,3
West Coast,"Naitanui, Nic",12,9,1,3,1,0,34,5
West Coast,"Petruccelle, Jack",7,3,1,4,0,0,0,3
West Coast,"Redden, Jack",12,4,1,8,0,0,0,2
West Coast,"Rotham, Josh",5,5,0,0,0,0,0,2
West Coast,"Ryan, Liam",6,4,2,2,3,0,0,1
West Coast,"Schofield, Will",7,4,1,3,0,0,0,2
West Coast,"Sheed, Dom",12,2,0,10,0,0,0,2
West Coast,"Sheppard, Brad",15,11,5,4,0,0,0,2
West Coast,"Shuey, Luke",13,4,0,9,0,0,0,1
West Coast,"Yeo, Elliot",16,9,1,7,0,0,0,6
West Coast,"Ah Chee, Brendon",9,3,2,6,0,0,0,1
West Coast,"Barrass, Tom",5,5,4,0,0,0,0,0
West Coast,"Brander, Jarrod",10,7,5,3,0,0,0,1
West Coast,"Cole, Tom",10,5,2,5,0,0,0,5
West Coast,"Cripps, Jamie",12,6,4,6,0,1,0,1
West Coast,"Darling, Jack",4,2,1,2,0,1,0,1
West Coast,"Duggan, Liam",15,10,3,5,0,0,0,0
West Coast,"Gaff, Andrew",27,17,6,10,0,0,0,1
West Coast,"Hickey, Tom",4,2,2,2,0,0,6,1
West Coast,"Hurn, Shannon",17,15,5,2,0,0,0,0
West Coast,"Jetta, Lewis",15,10,3,5,0,0,0,2
West Coast,"Jones, Jamaine",11,6,3,5,0,0,0,3
West Coast,"Kelly, Tim",18,15,2,3,1,0,0,6
West Coast,"Kennedy, Josh",11,7,7,4,4,1,0,1
West Coast,"Naitanui, Nic",9,6,0,3,0,0,30,0
West Coast,"Redden, Jack",12,7,5,5,0,0,0,2
West Coast,"Ryan, Liam",11,10,5,1,1,0,0,2
West Coast,"Schofield, Will",3,1,0,2,0,0,0,1
West Coast,"Sheed, Dom",20,9,4,11,0,0,0,1
West Coast,"Sheppard, Brad",15,9,6,6,0,0,0,2
West Coast,"Shuey, Luke",22,13,1,9,0,0,0,2
West Coast,"Yeo, Elliot",18,10,1,8,0,0,0,3
West Coast,"Ah Chee, Brendon",16,10,3,6,0,0,0,3
West Coast,"Allen, Oscar",11,6,6,5,3,1,7,3
West Coast,"Barrass, Tom",13,10,6,3,0,0,0,1
West Coast,"Cole, Tom",9,6,3,3,0,0,0,1
West Coast,"Cripps, Jamie",11,6,2,5,2,2,0,2
West Coast,"Darling, Jack",10,5,4,5,2,0,0,4
West Coast,"Duggan, Liam",17,14,8,3,0,0,0,0
West Coast,"Gaff, Andrew",18,8,3,10,0,0,0,3
West Coast,"Hurn, Shannon",16,8,2,8,0,0,0,2
West Coast,"Jones, Jamaine",10,7,2,3,0,1,0,5
West Coast,"Kelly, Tim",19,10,5,9,0,1,0,3
West Coast,"Kennedy, Josh",7,6,3,1,0,3,0,0
West Coast,"McGovern, Jeremy",10,6,5,4,0,0,0,3
West Coast,"Naitanui, Nic",11,8,1,3,0,1,39,4
West Coast,"Nelson, Jackson",14,11,5,3,0,0,0,2
West Coast,"Redden, Jack",15,10,2,5,0,1,0,2
West Coast,"Ryan, Liam",8,5,2,3,1,1,0,3
West Coast,"Sheed, Dom",24,17,10,7,1,0,0,2
West Coast,"Sheppard, Brad",21,15,13,6,0,0,0,0
West Coast,"Shuey, Luke",6,3,0,3,0,0,0,1
West Coast,"Waterman, Jake",11,9,5,2,2,0,0,1
West Coast,"Yeo, Elliot",21,14,2,7,0,0,0,5
West Coast,"Ah Chee, Brendon",6,4,2,2,1,0,0,2
West Coast,"Ainsworth, Brayden",12,4,4,8,1,0,0,3
West Coast,"Allen, Oscar",15,11,5,4,1,3,4,4
West Coast,"Barrass, Tom",14,9,6,5,0,0,0,0
West Coast,"Cameron, Jarrod",5,2,0,3,0,0,0,2
West Coast,"Cole, Tom",10,6,3,4,0,0,0,1
West Coast,"Cripps, Jamie",10,7,0,3,1,0,0,2
West Coast,"Darling, Jack",10,5,3,5,2,1,0,0
West Coast,"Duggan, Liam",17,13,7,4,0,0,0,3
West Coast,"Gaff, Andrew",12,8,2,4,0,0,0,3
West Coast,"Hurn, Shannon",10,8,2,2,0,0,0,0
West Coast,"Kelly, Tim",24,14,5,10,0,0,0,4
West Coast,"Kennedy, Josh",5,5,4,0,1,3,0,1
West Coast,"McGovern, Jeremy",17,13,12,4,0,0,0,0
West Coast,"Naitanui, Nic",7,4,0,3,1,0,24,3
West Coast,"Nelson, Jackson",16,10,4,6,0,0,0,3
West Coast,"Redden, Jack",18,10,6,8,1,0,0,3
West Coast,"Ryan, Liam",5,2,2,3,1,0,0,1
West Coast,"Sheed, Dom",24,13,7,11,0,0,0,4
West Coast,"Sheppard, Brad",19,13,9,6,0,0,0,0
West Coast,"Waterman, Jake",7,4,5,3,0,0,0,0
West Coast,"Yeo, Elliot",21,15,2,6,0,0,0,5
West Coast,"Ah Chee, Brendon",13,3,1,10,0,0,0,0
West Coast,"Ainsworth, Brayden",12,7,7,5,0,0,0,0
West Coast,"Allen, Oscar",11,8,5,3,0,0,2,2
West Coast,"Barrass, Tom",13,11,10,2,0,0,0,0
West Coast,"Cameron, Jarrod",5,5,1,0,1,0,0,3
West Coast,"Cole, Tom",13,8,4,5,0,0,0,3
West Coast,"Cripps, Jamie",9,6,2,3,0,1,0,4
West Coast,"Darling, Jack",8,6,3,2,2,0,1,4
West Coast,"Duggan, Liam",19,16,8,3,0,0,0,0
West Coast,"Gaff, Andrew",24,15,4,9,0,1,0,1
West Coast,"Hurn, Shannon",17,14,10,3,0,0,0,2
West Coast,"Kelly, Tim",18,9,3,9,0,0,0,6
West Coast,"Kennedy, Josh",11,9,6,2,4,4,0,0
West Coast,"McGovern, Jeremy",14,10,7,4,0,0,0,2
West Coast,"Naitanui, Nic",9,4,0,5,0,0,22,3
West Coast,"Nelson, Jackson",23,15,8,8,0,0,0,2
West Coast,"Redden, Jack",21,9,5,12,0,0,0,3
West Coast,"Ryan, Liam",9,8,2,1,0,0,0,1
West Coast,"Sheed, Dom",18,7,3,11,0,0,0,3
West Coast,"Sheppard, Brad",23,18,10,5,0,0,0,0
West Coast,"Waterman, Jake",15,13,10,2,2,0,0,0
West Coast,"Yeo, Elliot",20,9,2,11,0,0,0,6
West Coast,"Ainsworth, Brayden",5,2,2,3,0,0,0,0
West Coast,"Allen, Oscar",14,10,4,4,3,0,4,4
West Coast,"Barrass, Tom",9,7,6,2,0,0,0,0
West Coast,"Cameron, Jarrod",7,5,1,2,0,1,0,2
West Coast,"Cole, Tom",9,5,2,4,0,0,0,1
West Coast,"Cripps, Jamie",11,3,5,8,1,0,0,3
West Coast,"Darling, Jack",7,5,3,2,1,0,0,2
West Coast,"Duggan, Liam",13,11,7,2,0,0,0,3
West Coast,"Gaff, Andrew",26,18,11,8,1,0,0,4
West Coast,"Hurn, Shannon",15,10,5,5,0,0,0,3
West Coast,"Kelly, Tim",29,16,4,13,1,0,0,3
West Coast,"Kennedy, Josh",13,10,5,3,7,0,0,1
West Coast,"Naitanui, Nic",8,3,0,5,1,1,24,1
West Coast,"Nelson, Jackson",19,14,3,5,0,0,0,2
West Coast,"Redden, Jack",15,4,2,11,0,0,0,2
West Coast,"Rotham, Josh",10,8,4,2,0,0,0,3
West Coast,"Ryan, Liam",15,13,8,2,1,1,0,1
West Coast,"Sheed, Dom",14,10,0,4,0,0,0,2
West Coast,"Sheppard, Brad",13,9,4,4,0,0,0,3
West Coast,"Shuey, Luke",19,9,5,10,0,0,0,5
West Coast,"Waterman, Jake",6,5,3,1,2,0,0,0
West Coast,"Yeo, Elliot",22,10,2,12,0,0,0,3
West Coast,"Ah Chee, Brendon",6,1,1,5,1,0,0,2
West Coast,"Ainsworth, Brayden",6,5,4,1,0,0,0,0
West Coast,"Allen, Oscar",9,4,1,5,0,1,3,5
West Coast,"Barrass, Tom",7,6,3,1,0,0,0,1
West Coast,"Cameron, Jarrod",4,3,2,1,0,0,0,1
West Coast,"Cole, Tom",9,5,4,4,0,0,0,1
West Coast,"Cripps, Jamie",13,8,5,5,1,0,0,4
West Coast,"Darling, Jack",11,8,3,3,2,1,2,2
West Coast,"Duggan, Liam",17,14,5,3,0,0,0,3
West Coast,"Edwards, Harry",3,2,0,1,0,0,0,0
West Coast,"Gaff, Andrew",14,8,2,6,0,0,0,3
West Coast,"Hurn, Shannon",12,8,6,4,0,0,0,1
West Coast,"Kelly, Tim",23,16,2,7,0,0,0,3
West Coast,"Kennedy, Josh",7,6,4,1,4,0,0,0
West Coast,"Naitanui, Nic",10,6,0,4,0,0,34,3
West Coast,"Nelson, Jackson",8,2,0,6,0,0,0,1
West Coast,"Ryan, Liam",11,9,2,2,1,3,0,3
West Coast,"Sheed, Dom",24,11,2,13,2,1,0,2
West Coast,"Sheppard, Brad",10,9,4,1,0,0,0,3
West Coast,"Shuey, Luke",23,16,2,7,0,0,0,1
West Coast,"Waterman, Jake",11,7,2,4,0,0,0,2
West Coast,"Yeo, Elliot",20,12,3,8,0,0,0,5
West Coast,"Ah Chee, Brendon",7,3,3,4,0,0,0,1
West Coast,"Allen, Oscar",7,5,2,2,0,1,7,3
West Coast,"Barrass, Tom",10,9,6,1,0,0,0,0
West Coast,"Cameron, Jarrod",3,1,1,2,1,0,0,3
West Coast,"Cole, Tom",13,10,5,3,0,0,0,3
West Coast,"Cripps, Jamie",13,5,2,8,1,0,0,3
West Coast,"Darling, Jack",12,7,2,5,2,1,1,2
West Coast,"Duggan, Liam",16,15,11,1,0,0,0,1
West Coast,"Gaff, Andrew",20,13,4,7,1,0,0,2
West Coast,"Hurn, Shannon",14,11,5,3,0,0,0,2
West Coast,"Kelly, Tim",22,13,1,9,0,0,0,3
West Coast,"Kennedy, Josh",8,5,5,3,2,1,0,2
West Coast,"Naitanui, Nic",8,3,0,5,0,0,41,4
West Coast,"Nelson, Jackson",17,16,6,1,0,0,0,1
West Coast,"Redden, Jack",17,6,0,11,0,0,0,2
West Coast,"Rotham, Josh",12,11,8,1,0,0,0,1
West Coast,"Ryan, Liam",3,2,0,1,0,0,0,3
West Coast,"Sheed, Dom",26,15,2,11,2,0,0,5
West Coast,"Sheppard, Brad",13,9,5,4,1,0,0,1
West Coast,"Shuey, Luke",16,8,3,8,0,0,0,7
West Coast,"Waterman, Jake",9,7,4,2,1,2,0,2
West Coast,"Yeo, Elliot",21,8,2,13,0,1,0,5
West Coast,"Ah Chee, Brendon",8,7,5,1,0,0,0,3
West Coast,"Ainsworth, Brayden",11,7,1,4,0,0,0,4
West Coast,"Allen, Oscar",6,6,3,0,1,0,10,2
West Coast,"Barrass, Tom",19,14,9,5,0,0,0,0
West Coast,"Brander, Jarrod",10,6,3,4,0,0,0,5
West Coast,"Cole, Tom",14,6,4,8,0,0,0,2
West Coast,"Cripps, Jamie",15,9,2,6,1,1,0,4
West Coast,"Darling, Jack",13,8,7,5,2,1,1,5
West Coast,"Gaff, Andrew",33,15,4,18,0,0,0,0
West Coast,"Hurn, Shannon",17,12,3,5,0,0,0,3
West Coast,"Kelly, Tim",15,8,0,7,0,1,0,4
West Coast,"Kennedy, Josh",8,7,5,1,3,1,0,3
West Coast,"McGovern, Jeremy",16,12,8,4,0,0,0,1
West Coast,"Naitanui, Nic",14,8,1,6,0,0,35,1
West Coast,"Nelson, Jackson",15,12,3,3,0,0,0,3
West Coast,"Redden, Jack",8,2,2,6,0,0,0,3
West Coast,"Reid, Nic",9,4,0,5,1,1,0,2
West Coast,"Rotham, Josh",14,11,6,3,0,0,0,2
West Coast,"Ryan, Liam",12,10,5,2,3,0,0,1
West Coast,"Sheed, Dom",17,8,2,9,0,1,0,3
West Coast,"Sheppard, Brad",22,12,8,10,1,0,0,3
West Coast,"Shuey, Luke",24,14,3,10,0,0,0,2
West Coast,"Ah Chee, Brendon",9,8,5,1,2,1,0,1
West Coast,"Allen, Oscar",6,3,2,3,0,1,6,2
West Coast,"Barrass, Tom",6,5,4,1,0,0,0,1
West Coast,"Brander, Jarrod",16,14,6,2,0,0,0,1
West Coast,"Cole, Tom",8,5,2,3,0,0,0,3
West Coast,"Cripps, Jamie",12,6,1,6,0,0,0,3
West Coast,"Darling, Jack",7,6,5,1,3,0,1,0
West Coast,"Duggan, Liam",10,8,6,2,0,0,0,0
West Coast,"Gaff, Andrew",21,13,6,8,1,0,0,2
West Coast,"Hurn, Shannon",12,10,4,2,0,0,0,2
West Coast,"Kelly, Tim",16,10,1,6,0,0,0,4
West Coast,"Kennedy, Josh",5,4,4,1,1,1,0,0
West Coast,"McGovern, Jeremy",18,16,10,2,0,0,0,0
West Coast,"Naitanui, Nic",14,9,2,5,1,1,28,2
West Coast,"Nelson, Jackson",10,8,6,2,0,0,0,3
West Coast,"ONeill, Xavier",10,4,1,6,1,0,0,4
West Coast,"Reid, Nic",7,3,1,4,0,0,0,3
West Coast,"Rotham, Josh",16,13,11,3,0,0,0,1
West Coast,"Ryan, Liam",5,3,2,2,0,0,0,0
West Coast,"Sheed, Dom",20,10,4,10,0,0,0,1
West Coast,"Sheppard, Brad",17,7,7,10,0,0,0,5
West Coast,"Shuey, Luke",15,8,1,7,0,1,0,3
West Coast,"Ah Chee, Brendon",10,3,0,7,0,1,0,2
West Coast,"Barrass, Tom",9,8,3,1,0,0,0,0
West Coast,"Brander, Jarrod",6,5,2,1,0,0,0,1
West Coast,"Cole, Tom",21,8,3,13,0,0,0,1
West Coast,"Cripps, Jamie",14,7,2,7,1,0,0,6
West Coast,"Darling, Jack",7,6,1,1,3,0,0,2
West Coast,"Duggan, Liam",23,16,5,7,0,1,0,4
West Coast,"Gaff, Andrew",32,12,2,20,0,0,0,6
West Coast,"Hurn, Shannon",11,7,2,4,0,0,0,1
West Coast,"Hutchings, Mark",12,8,0,4,0,0,0,1
West Coast,"Kelly, Tim",26,12,4,14,1,0,0,4
West Coast,"Kennedy, Josh",1,1,0,0,0,0,0,1
West Coast,"McGovern, Jeremy",9,5,2,4,0,0,0,1
West Coast,"Naitanui, Nic",11,6,0,5,1,0,22,2
West Coast,"ONeill, Xavier",16,11,4,5,0,1,0,2
West Coast,"Reid, Nic",5,1,0,4,0,0,0,3
West Coast,"Rotham, Josh",10,8,3,2,0,0,0,1
West Coast,"Ryan, Liam",12,7,4,5,3,1,0,3
West Coast,"Sheed, Dom",26,10,2,16,0,0,0,3
West Coast,"Sheppard, Brad",16,9,3,7,0,0,0,4
West Coast,"Shuey, Luke",27,14,2,13,0,0,0,6
West Coast,"Williams, Bailey",8,4,2,4,0,1,8,2
West Coast,"Ah Chee, Brendon",9,3,3,6,0,0,0,1
West Coast,"Allen, Oscar",4,3,2,1,1,0,0,1
West Coast,"Barrass, Tom",11,11,6,0,0,0,0,0
West Coast,"Cole, Tom",9,5,4,4,1,0,0,3
West Coast,"Darling, Jack",10,7,6,3,2,1,0,0
West Coast,"Duggan, Liam",17,12,8,5,0,0,0,1
West Coast,"Gaff, Andrew",23,14,8,9,0,0,0,2
West Coast,"Hurn, Shannon",20,17,12,3,0,0,0,1
West Coast,"Hutchings, Mark",8,5,4,3,0,0,0,1
West Coast,"Jetta, Lewis",12,7,1,5,0,2,0,2
West Coast,"Kelly, Tim",13,8,1,5,0,0,0,1
West Coast,"McGovern, Jeremy",16,14,7,2,0,0,0,0
West Coast,"Naitanui, Nic",9,6,1,3,0,0,22,0
West Coast,"Nelson, Jackson",10,7,6,3,0,0,0,0
West Coast,"ONeill, Xavier",10,3,2,7,0,0,0,3
West Coast,"Redden, Jack",21,10,5,11,0,0,0,3
West Coast,"Rotham, Josh",15,14,9,1,0,0,0,0
West Coast,"Ryan, Liam",14,12,8,2,4,1,0,1
West Coast,"Sheed, Dom",11,7,2,4,0,0,0,2
West Coast,"Sheppard, Brad",20,13,9,7,0,0,0,0
West Coast,"Shuey, Luke",15,9,1,6,0,0,0,3
West Coast,"Williams, Bailey",6,4,2,2,1,0,11,1
West Coast,"Ah Chee, Brendon",11,5,3,6,0,0,0,1
West Coast,"Ainsworth, Brayden",8,5,4,3,0,0,0,1
West Coast,"Allen, Oscar",4,3,2,1,0,0,4,4
West Coast,"Barrass, Tom",13,11,7,2,0,0,0,0
West Coast,"Cole, Tom",10,9,7,1,1,0,0,1
West Coast,"Darling, Jack",11,10,3,1,0,2,2,0
West Coast,"Duggan, Liam",18,12,6,6,0,0,0,2
West Coast,"Gaff, Andrew",15,9,1,6,0,0,0,2
West Coast,"Hickey, Tom",8,3,3,5,0,0,28,2
West Coast,"Hutchings, Mark",4,2,1,2,0,0,0,2
West Coast,"Jetta, Lewis",15,10,4,5,0,0,0,4
West Coast,"Kelly, Tim",17,6,1,11,0,0,0,3
West Coast,"Kennedy, Josh",8,8,7,0,2,2,0,0
West Coast,"McGovern, Jeremy",13,7,2,6,0,0,0,0
West Coast,"Nelson, Jackson",10,9,2,1,0,0,0,2
West Coast,"ONeill, Xavier",7,4,1,3,0,0,0,0
West Coast,"Redden, Jack",20,13,3,7,0,0,0,3
West Coast,"Rotham, Josh",9,9,6,0,0,0,0,1
West Coast,"Ryan, Liam",11,8,5,3,1,0,0,1
West Coast,"Sheed, Dom",19,8,2,11,1,0,0,3
West Coast,"Sheppard, Brad",16,14,6,2,0,0,0,1
West Coast,"Waterman, Jake",14,10,4,4,2,0,0,1
West Coast,"Ainsworth, Brayden",6,3,1,3,0,0,0,3
West Coast,"Allen, Oscar",5,4,2,1,2,0,3,4
West Coast,"Barrass, Tom",15,9,7,6,0,0,0,0
West Coast,"Brander, Jarrod",8,6,2,2,0,0,0,0
West Coast,"Brayshaw, Hamish",5,3,1,2,0,1,0,1
West Coast,"Cole, Tom",8,6,2,2,1,0,0,4
West Coast,"Darling, Jack",10,7,6,3,2,1,0,2
West Coast,"Duggan, Liam",15,11,2,4,0,1,0,6
West Coast,"Gaff, Andrew",33,15,3,18,1,1,0,4
West Coast,"Hurn, Shannon",17,17,3,0,0,0,0,1
West Coast,"Kelly, Tim",30,20,6,10,1,2,0,4
West Coast,"Kennedy, Josh",9,8,4,1,1,1,0,0
West Coast,"McGovern, Jeremy",8,7,5,1,0,0,0,1
West Coast,"Naitanui, Nic",18,12,2,6,0,0,33,3
West Coast,"Nelson, Jackson",15,11,4,4,0,0,0,1
West Coast,"ONeill, Xavier",6,3,1,3,0,0,0,0
West Coast,"Petruccelle, Jack",11,7,2,4,0,1,0,2
West Coast,"Rotham, Josh",9,5,2,4,0,0,0,1
West Coast,"Ryan, Liam",16,10,4,6,1,1,0,4
West Coast,"Schofield, Will",4,2,1,2,0,0,0,2
West Coast,"Sheppard, Brad",11,7,2,4,0,0,0,1
West Coast,"Waterman, Jake",11,7,7,4,0,0,0,1
West Coast,"Ah Chee, Brendon",15,6,2,9,0,1,0,2
West Coast,"Ainsworth, Brayden",11,7,2,4,1,1,0,1
West Coast,"Allen, Oscar",10,5,2,5,3,0,0,1
West Coast,"Barrass, Tom",4,3,1,1,0,0,0,0
West Coast,"Cole, Tom",7,4,1,3,0,0,0,1
West Coast,"Darling, Jack",12,7,3,5,1,0,0,1
West Coast,"Duggan, Liam",20,15,3,5,0,0,0,3
West Coast,"Foley, Luke",3,3,2,0,0,0,0,1
West Coast,"Gaff, Andrew",26,16,2,10,0,0,0,3
West Coast,"Hurn, Shannon",23,17,4,6,0,0,0,4
West Coast,"Kelly, Tim",18,8,2,10,0,0,0,5
West Coast,"Kennedy, Josh",2,2,1,0,0,0,0,1
West Coast,"Naitanui, Nic",13,3,2,10,0,0,24,5
West Coast,"Nelson, Jackson",22,19,5,3,0,0,0,4
West Coast,"Petruccelle, Jack",8,3,2,5,0,2,0,1
West Coast,"Rotham, Josh",7,6,3,1,0,0,0,1
West Coast,"Ryan, Liam",15,8,4,7,2,1,0,2
West Coast,"Schofield, Will",8,5,1,3,0,0,0,3
West Coast,"Sheed, Dom",23,12,1,11,0,0,0,4
West Coast,"Sheppard, Brad",16,11,3,5,0,0,0,7
West Coast,"Waterman, Jake",8,5,1,3,0,0,0,1
West Coast,"Williams, Bailey",7,2,1,5,0,0,5,2
West Coast,"Ah Chee, Brendon",8,4,1,4,0,0,0,4
West Coast,"Ainsworth, Brayden",6,4,1,2,1,0,0,0
West Coast,"Allen, Oscar",14,8,3,6,2,0,2,1
West Coast,"Barrass, Tom",7,5,3,2,0,0,0,0
West Coast,"Cole, Tom",7,7,2,0,0,0,0,0
West Coast,"Cripps, Jamie",17,12,2,5,1,2,0,5
West Coast,"Darling, Jack",13,11,6,2,3,2,0,2
West Coast,"Duggan, Liam",20,13,5,7,0,0,0,0
West Coast,"Gaff, Andrew",24,11,6,13,0,0,0,2
West Coast,"Hurn, Shannon",17,11,6,6,0,0,0,1
West Coast,"Kelly, Tim",13,5,2,8,0,0,0,8
West Coast,"Kennedy, Josh",10,9,6,1,3,4,0,2
West Coast,"McGovern, Jeremy",15,10,6,5,0,0,0,1
West Coast,"Naitanui, Nic",17,11,2,6,0,1,25,3
West Coast,"Nelson, Jackson",8,6,3,2,0,0,0,2
West Coast,"Petruccelle, Jack",3,0,0,3,0,0,0,0
West Coast,"Redden, Jack",18,9,5,9,0,0,0,2
West Coast,"Ryan, Liam",16,7,6,9,1,0,0,1
West Coast,"Sheed, Dom",17,8,3,9,0,0,0,1
West Coast,"Sheppard, Brad",11,9,5,2,0,0,0,0
West Coast,"Shuey, Luke",14,10,4,4,0,0,0,7
West Coast,"Waterman, Jake",11,11,10,0,0,0,0,0
Western Bulldogs,"Bontempelli, Marcus",15,5,0,10,0,0,0,6
Western Bulldogs,"Bruce, Josh",6,2,1,4,1,0,2,2
Western Bulldogs,"Cavarra, Ben",3,2,1,1,1,1,0,1
Western Bulldogs,"Cordy, Zaine",9,9,2,0,0,0,0,0
Western Bulldogs,"Crozier, Hayden",17,12,4,5,0,0,0,7
Western Bulldogs,"Dale, Bailey",6,1,1,5,0,0,0,0
Western Bulldogs,"Daniel, Caleb",20,10,3,10,0,0,0,1
Western Bulldogs,"Dunkley, Josh",19,9,2,10,0,0,0,2
Western Bulldogs,"English, Tim",10,9,4,1,0,1,12,0
Western Bulldogs,"Gardner, Ryan",11,8,5,3,0,0,0,1
Western Bulldogs,"Hunter, Lachie",22,13,5,9,0,0,0,1
Western Bulldogs,"Johannisen, Jason",16,11,4,5,0,0,0,0
Western Bulldogs,"Keath, Alex",15,13,9,2,0,0,0,1
Western Bulldogs,"Lloyd, Sam",8,6,4,2,0,1,0,5
Western Bulldogs,"Macrae, Jack",22,11,5,11,0,0,0,5
Western Bulldogs,"Naughton, Aaron",2,1,0,1,0,0,0,1
Western Bulldogs,"Smith, Bailey",23,9,5,14,0,0,0,7
Western Bulldogs,"Suckling, Matt",11,8,6,3,1,0,0,1
Western Bulldogs,"Wallis, Mitch",12,5,2,7,1,0,0,1
Western Bulldogs,"Williams, Bailey",17,9,6,8,1,0,0,0
Western Bulldogs,"Wood, Easton",14,7,5,7,0,0,0,0
Western Bulldogs,"Young, Lewis",4,3,3,1,0,1,1,0
Western Bulldogs,"Bontempelli, Marcus",24,11,2,13,0,0,0,1
Western Bulldogs,"Bruce, Josh",11,3,1,8,0,1,1,3
Western Bulldogs,"Crozier, Hayden",17,13,4,4,0,0,0,0
Western Bulldogs,"Dale, Bailey",9,4,2,5,0,2,0,1
Western Bulldogs,"Daniel, Caleb",15,4,4,11,0,0,0,4
Western Bulldogs,"Dunkley, Josh",28,8,3,20,1,0,0,8
Western Bulldogs,"English, Tim",12,7,4,5,0,0,10,2
Western Bulldogs,"Gardner, Ryan",6,4,1,2,0,0,0,1
Western Bulldogs,"Gowers, Billy",6,3,1,3,0,0,0,1
Western Bulldogs,"Johannisen, Jason",14,7,1,7,0,0,0,3
Western Bulldogs,"Jong, Lin",17,7,3,10,0,0,1,4
Western Bulldogs,"Keath, Alex",9,4,2,5,0,0,0,0
Western Bulldogs,"Lipinski, Patrick",22,7,4,15,0,0,0,1
Western Bulldogs,"Lloyd, Sam",7,5,2,2,0,1,0,3
Western Bulldogs,"Macrae, Jack",18,8,1,10,1,0,0,3
Western Bulldogs,"Naughton, Aaron",10,7,3,3,1,1,0,1
Western Bulldogs,"Richards, Ed",14,6,2,8,1,0,0,4
Western Bulldogs,"Smith, Bailey",29,9,2,20,0,0,0,5
Western Bulldogs,"Suckling, Matt",15,9,4,6,0,0,0,0
Western Bulldogs,"Vandermeer, Laitham",10,6,3,4,1,1,0,2
Western Bulldogs,"Wallis, Mitch",12,4,2,8,1,0,0,1
Western Bulldogs,"Williams, Bailey",14,6,4,8,1,0,0,1
Western Bulldogs,"Bontempelli, Marcus",16,9,3,7,1,0,1,5
Western Bulldogs,"Bruce, Josh",6,3,2,3,0,0,0,1
Western Bulldogs,"Cordy, Zaine",9,7,6,2,0,0,3,3
Western Bulldogs,"Crozier, Hayden",16,12,2,4,0,0,0,5
Western Bulldogs,"Dale, Bailey",10,7,4,3,1,0,0,0
Western Bulldogs,"Daniel, Caleb",23,17,6,6,0,0,0,1
Western Bulldogs,"Dunkley, Josh",16,4,2,12,1,0,2,6
Western Bulldogs,"English, Tim",15,10,7,5,0,2,11,1
Western Bulldogs,"Johannisen, Jason",20,14,4,6,0,1,0,3
Western Bulldogs,"Jong, Lin",11,2,3,9,0,1,0,4
Western Bulldogs,"Keath, Alex",14,9,5,5,1,0,0,1
Western Bulldogs,"Liberatore, Tom",18,9,3,9,1,0,0,1
Western Bulldogs,"Lloyd, Sam",7,2,3,5,0,0,0,1
Western Bulldogs,"Macrae, Jack",25,10,5,15,0,0,0,7
Western Bulldogs,"McLean, Toby",17,8,3,9,0,0,0,3
Western Bulldogs,"Naughton, Aaron",9,5,5,4,0,1,0,0
Western Bulldogs,"Richards, Ed",9,8,0,1,1,0,0,3
Western Bulldogs,"Smith, Bailey",17,11,0,6,1,1,0,3
Western Bulldogs,"Suckling, Matt",12,9,3,3,0,0,0,1
Western Bulldogs,"Vandermeer, Laitham",10,5,2,5,0,0,0,3
Western Bulldogs,"Wallis, Mitch",8,4,3,4,1,1,0,3
Western Bulldogs,"Williams, Bailey",15,12,6,3,0,0,0,0
Western Bulldogs,"Bontempelli, Marcus",19,10,3,9,2,1,0,8
Western Bulldogs,"Bruce, Josh",8,3,2,5,1,1,0,1
Western Bulldogs,"Butler, Louis",14,11,2,3,0,0,0,1
Western Bulldogs,"Cordy, Zaine",9,7,3,2,0,0,1,3
Western Bulldogs,"Crozier, Hayden",16,13,0,3,0,0,0,2
Western Bulldogs,"Dale, Bailey",15,11,4,4,1,0,0,3
Western Bulldogs,"Daniel, Caleb",17,9,2,8,0,0,0,4
Western Bulldogs,"English, Tim",22,12,6,10,1,0,17,1
Western Bulldogs,"Johannisen, Jason",13,9,4,4,0,0,0,1
Western Bulldogs,"Keath, Alex",6,4,2,2,0,0,0,0
Western Bulldogs,"Liberatore, Tom",16,10,2,6,0,0,0,4
Western Bulldogs,"Lipinski, Patrick",20,7,3,13,0,1,0,2
Western Bulldogs,"Lloyd, Sam",5,3,1,2,1,1,0,2
Western Bulldogs,"Macrae, Jack",22,10,2,12,1,0,0,2
Western Bulldogs,"McLean, Toby",10,2,0,8,0,0,0,4
Western Bulldogs,"Naughton, Aaron",4,3,2,1,1,0,0,1
Western Bulldogs,"Richards, Ed",12,6,3,6,0,1,0,2
Western Bulldogs,"Smith, Bailey",20,7,2,13,0,0,0,2
Western Bulldogs,"Vandermeer, Laitham",7,6,5,1,1,1,0,0
Western Bulldogs,"Wallis, Mitch",14,6,3,8,0,0,0,1
Western Bulldogs,"West, Rhylee",12,7,4,5,1,0,0,1
Western Bulldogs,"Williams, Bailey",14,9,5,5,0,0,0,2
Western Bulldogs,"Bontempelli, Marcus",11,4,1,7,0,1,0,4
Western Bulldogs,"Bruce, Josh",10,7,6,3,6,0,0,0
Western Bulldogs,"Cordy, Zaine",11,7,2,4,0,0,0,2
Western Bulldogs,"Crozier, Hayden",15,11,2,4,0,0,0,3
Western Bulldogs,"Dale, Bailey",12,7,3,5,1,1,0,5
Western Bulldogs,"Daniel, Caleb",22,12,1,10,0,0,0,2
Western Bulldogs,"English, Tim",22,9,8,13,0,1,15,2
Western Bulldogs,"Johannisen, Jason",22,15,5,7,0,1,0,2
Western Bulldogs,"Jong, Lin",13,3,4,10,0,0,0,1
Western Bulldogs,"Keath, Alex",12,7,3,5,0,0,0,1
Western Bulldogs,"Liberatore, Tom",23,9,2,14,0,0,0,1
Western Bulldogs,"Lipinski, Patrick",20,7,3,13,0,0,0,4
Western Bulldogs,"Macrae, Jack",24,10,5,14,0,1,0,2
Western Bulldogs,"McLean, Toby",22,10,1,12,0,0,0,3
Western Bulldogs,"Richards, Ed",12,5,0,7,1,0,0,0
Western Bulldogs,"Schache, Josh",11,7,3,4,2,0,0,0
Western Bulldogs,"Smith, Bailey",2,0,0,2,0,0,0,0
Western Bulldogs,"Vandermeer, Laitham",13,9,3,4,1,0,0,6
Western Bulldogs,"Wallis, Mitch",10,6,6,4,2,1,0,2
Western Bulldogs,"West, Rhylee",15,5,0,10,0,0,0,3
Western Bulldogs,"Williams, Bailey",15,8,3,7,0,0,0,0
Western Bulldogs,"Wood, Easton",14,8,9,6,0,0,0,2
Western Bulldogs,"Bontempelli, Marcus",22,13,1,9,1,0,0,6
Western Bulldogs,"Bruce, Josh",6,2,2,4,0,0,1,2
Western Bulldogs,"Butler, Louis",16,13,4,3,0,1,0,0
Western Bulldogs,"Cordy, Zaine",7,4,4,3,0,0,0,1
Western Bulldogs,"Dale, Bailey",6,3,1,3,1,0,0,3
Western Bulldogs,"Daniel, Caleb",14,9,3,5,0,0,0,2
Western Bulldogs,"English, Tim",17,8,3,9,0,0,27,1
Western Bulldogs,"Hunter, Lachie",27,17,4,10,0,0,0,5
Western Bulldogs,"Johannisen, Jason",13,7,4,6,0,0,0,1
Western Bulldogs,"Keath, Alex",11,9,2,2,0,0,0,0
Western Bulldogs,"Liberatore, Tom",22,10,2,12,0,0,0,3
Western Bulldogs,"Lipinski, Patrick",14,5,0,9,1,0,0,3
Western Bulldogs,"Macrae, Jack",26,11,4,15,0,0,0,4
Western Bulldogs,"McLean, Toby",13,6,1,7,0,2,0,4
Western Bulldogs,"Richards, Ed",14,8,1,6,0,1,0,3
Western Bulldogs,"Schache, Josh",2,1,0,1,0,0,0,0
Western Bulldogs,"Smith, Bailey",26,11,1,15,1,1,0,6
Western Bulldogs,"Vandermeer, Laitham",14,9,4,5,2,2,0,2
Western Bulldogs,"Wallis, Mitch",7,1,1,6,1,0,0,4
Western Bulldogs,"West, Rhylee",9,6,4,3,0,0,0,2
Western Bulldogs,"Williams, Bailey",12,10,3,2,0,0,0,0
Western Bulldogs,"Wood, Easton",8,5,3,3,0,0,0,2
Western Bulldogs,"Bontempelli, Marcus",23,11,4,12,0,0,0,3
Western Bulldogs,"Bruce, Josh",16,8,6,8,1,1,0,0
Western Bulldogs,"Cordy, Zaine",5,5,2,0,0,0,0,0
Western Bulldogs,"Crozier, Hayden",12,8,3,4,0,0,0,4
Western Bulldogs,"Dale, Bailey",5,3,1,2,1,0,0,0
Western Bulldogs,"Daniel, Caleb",20,14,6,6,0,0,0,2
Western Bulldogs,"English, Tim",22,10,7,12,1,1,16,4
Western Bulldogs,"Hunter, Lachie",26,12,4,14,0,0,0,5
Western Bulldogs,"Johannisen, Jason",14,7,5,7,1,0,0,3
Western Bulldogs,"Keath, Alex",8,5,4,3,0,0,0,0
Western Bulldogs,"Liberatore, Tom",22,9,3,13,0,1,0,6
Western Bulldogs,"Lipinski, Patrick",14,6,2,8,1,0,0,3
Western Bulldogs,"Macrae, Jack",29,14,2,15,0,0,0,2
Western Bulldogs,"Richards, Ed",11,6,2,5,1,1,0,1
Western Bulldogs,"Smith, Bailey",20,15,2,5,0,1,0,2
Western Bulldogs,"Suckling, Matt",13,11,8,2,2,0,0,0
Western Bulldogs,"Vandermeer, Laitham",7,5,1,2,1,0,0,3
Western Bulldogs,"Wallis, Mitch",10,7,1,3,3,0,0,1
Western Bulldogs,"Weightman, Cody",9,5,3,4,2,1,0,0
Western Bulldogs,"Williams, Bailey",17,11,3,6,0,0,0,1
Western Bulldogs,"Wood, Easton",5,5,3,0,0,0,0,2
Western Bulldogs,"Young, Lachie",7,3,1,4,0,0,0,2
Western Bulldogs,"Bontempelli, Marcus",20,16,5,4,0,1,0,4
Western Bulldogs,"Bruce, Josh",8,0,0,8,0,0,1,1
Western Bulldogs,"Cordy, Zaine",7,6,1,1,0,0,1,4
Western Bulldogs,"Crozier, Hayden",19,11,7,8,0,0,0,1
Western Bulldogs,"Daniel, Caleb",25,14,4,11,0,0,0,0
Western Bulldogs,"English, Tim",9,6,2,3,0,0,14,0
Western Bulldogs,"Gowers, Billy",8,5,2,3,0,1,0,2
Western Bulldogs,"Johannisen, Jason",18,10,7,8,1,0,0,2
Western Bulldogs,"Keath, Alex",13,7,2,6,0,0,0,2
Western Bulldogs,"Liberatore, Tom",19,10,1,9,1,0,0,4
Western Bulldogs,"Lipinski, Patrick",20,10,3,10,1,0,0,3
Western Bulldogs,"Macrae, Jack",29,13,2,16,0,0,2,6
Western Bulldogs,"Porter, Callum",9,4,0,5,0,0,0,4
Western Bulldogs,"Richards, Ed",8,6,1,2,1,0,0,6
Western Bulldogs,"Smith, Bailey",22,14,2,8,1,2,0,3
Western Bulldogs,"Suckling, Matt",8,4,1,4,0,0,0,0
Western Bulldogs,"Vandermeer, Laitham",12,7,3,5,0,1,0,2
Western Bulldogs,"Wallis, Mitch",8,3,0,5,1,0,0,3
Western Bulldogs,"Weightman, Cody",4,3,1,1,0,0,0,2
Western Bulldogs,"Williams, Bailey",22,14,4,8,0,0,0,0
Western Bulldogs,"Wood, Easton",15,9,4,6,0,0,0,1
Western Bulldogs,"Young, Lachie",11,8,1,3,1,0,0,2
Western Bulldogs,"Bontempelli, Marcus",15,8,4,7,0,1,0,1
Western Bulldogs,"Bruce, Josh",8,4,3,4,2,0,1,3
Western Bulldogs,"Cordy, Zaine",11,6,2,5,0,0,0,0
Western Bulldogs,"Crozier, Hayden",11,10,4,1,0,0,0,1
Western Bulldogs,"Daniel, Caleb",22,10,1,12,0,0,0,1
Western Bulldogs,"English, Tim",13,6,3,7,0,1,13,1
Western Bulldogs,"Gowers, Billy",7,4,0,3,0,1,0,0
Western Bulldogs,"Johannisen, Jason",10,5,2,5,0,0,0,3
Western Bulldogs,"Keath, Alex",6,4,2,2,0,0,0,1
Western Bulldogs,"Liberatore, Tom",20,8,2,12,0,1,0,1
Western Bulldogs,"Lipinski, Patrick",9,5,1,4,0,0,0,2
Western Bulldogs,"Lloyd, Sam",6,4,1,2,0,0,0,1
Western Bulldogs,"Macrae, Jack",37,15,2,22,0,0,0,4
Western Bulldogs,"McLean, Toby",15,5,2,10,0,0,0,4
Western Bulldogs,"Richards, Ed",10,3,3,7,0,0,0,1
Western Bulldogs,"Smith, Bailey",19,10,2,9,0,0,0,1
Western Bulldogs,"Suckling, Matt",2,1,1,1,0,0,0,0
Western Bulldogs,"Trengove, Jackson",8,2,1,6,0,0,3,4
Western Bulldogs,"Vandermeer, Laitham",8,5,1,3,2,0,0,4
Western Bulldogs,"Wallis, Mitch",7,4,5,3,3,1,0,2
Western Bulldogs,"Williams, Bailey",23,14,5,9,0,1,0,1
Western Bulldogs,"Wood, Easton",11,8,2,3,0,0,0,0
Western Bulldogs,"Bontempelli, Marcus",22,10,1,12,0,0,0,5
Western Bulldogs,"Bruce, Josh",2,1,1,1,0,0,0,0
Western Bulldogs,"Cordy, Zaine",8,7,4,1,0,0,0,2
Western Bulldogs,"Crozier, Hayden",10,7,3,3,0,0,0,0
Western Bulldogs,"Daniel, Caleb",16,7,2,9,0,0,0,3
Western Bulldogs,"Dunkley, Josh",19,11,1,8,0,0,1,7
Western Bulldogs,"English, Tim",11,7,4,4,0,0,26,1
Western Bulldogs,"Johannisen, Jason",14,7,2,7,0,0,0,4
Western Bulldogs,"Keath, Alex",9,4,1,5,0,0,0,1
Western Bulldogs,"Liberatore, Tom",24,7,0,17,0,0,0,3
Western Bulldogs,"Lipinski, Patrick",14,8,2,6,0,0,0,3
Western Bulldogs,"Lloyd, Sam",15,9,6,6,2,1,0,2
Western Bulldogs,"Macrae, Jack",27,13,3,14,0,0,3,7
Western Bulldogs,"McLean, Toby",13,6,1,7,2,1,0,5
Western Bulldogs,"Richards, Ed",13,7,2,6,0,1,0,2
Western Bulldogs,"Smith, Bailey",20,9,1,11,0,1,0,4
Western Bulldogs,"Smith, Roarke",8,3,1,5,0,0,0,2
Western Bulldogs,"Vandermeer, Laitham",9,6,2,3,0,4,0,1
Western Bulldogs,"Wallis, Mitch",9,2,0,7,0,0,0,5
Western Bulldogs,"Weightman, Cody",5,3,0,2,1,0,0,2
Western Bulldogs,"Williams, Bailey",17,16,4,1,0,0,0,4
Western Bulldogs,"Wood, Easton",7,6,3,1,0,0,0,1
Western Bulldogs,"Bontempelli, Marcus",30,12,4,18,1,0,0,2
Western Bulldogs,"Bruce, Josh",9,4,4,5,1,1,2,1
Western Bulldogs,"Cordy, Zaine",10,6,4,4,0,0,0,2
Western Bulldogs,"Dale, Bailey",8,5,4,3,1,0,0,0
Western Bulldogs,"Daniel, Caleb",16,15,3,1,0,0,0,2
Western Bulldogs,"Dunkley, Josh",18,7,2,11,0,0,1,4
Western Bulldogs,"English, Tim",16,4,3,12,0,0,20,6
Western Bulldogs,"Gardner, Ryan",5,2,1,3,0,0,0,1
Western Bulldogs,"Johannisen, Jason",17,11,5,6,0,0,0,2
Western Bulldogs,"Keath, Alex",6,4,3,2,0,0,0,0
Western Bulldogs,"Liberatore, Tom",18,9,2,9,0,0,0,4
Western Bulldogs,"Lipinski, Patrick",17,8,5,9,1,0,0,2
Western Bulldogs,"Lloyd, Sam",7,7,4,0,2,0,0,2
Western Bulldogs,"Macrae, Jack",40,15,4,25,1,0,0,4
Western Bulldogs,"McLean, Toby",13,2,1,11,0,0,0,1
Western Bulldogs,"Naughton, Aaron",6,2,2,4,1,0,0,1
Western Bulldogs,"Richards, Ed",15,4,0,11,0,0,0,1
Western Bulldogs,"Smith, Bailey",13,11,0,2,0,1,0,2
Western Bulldogs,"Vandermeer, Laitham",13,7,4,6,0,0,0,3
Western Bulldogs,"Wallis, Mitch",7,7,3,0,3,2,0,1
Western Bulldogs,"Williams, Bailey",17,12,4,5,0,0,0,5
Western Bulldogs,"Wood, Easton",8,5,2,3,0,0,0,1
Western Bulldogs,"Bontempelli, Marcus",33,18,6,15,2,0,0,9
Western Bulldogs,"Cavarra, Ben",15,8,3,7,2,2,0,2
Western Bulldogs,"Dale, Bailey",12,7,0,5,1,0,0,1
Western Bulldogs,"Daniel, Caleb",25,17,2,8,0,0,0,1
Western Bulldogs,"Dunkley, Josh",17,4,1,13,1,0,3,5
Western Bulldogs,"English, Tim",12,7,5,5,1,4,16,5
Western Bulldogs,"Gardner, Ryan",6,3,2,3,0,0,0,0
Western Bulldogs,"Hunter, Lachie",29,11,6,18,1,1,0,1
Western Bulldogs,"Keath, Alex",11,8,5,3,0,0,0,1
Western Bulldogs,"Liberatore, Tom",25,12,2,13,0,1,0,4
Western Bulldogs,"Lipinski, Patrick",16,6,4,10,0,0,0,1
Western Bulldogs,"Lloyd, Sam",10,4,3,6,1,0,0,2
Western Bulldogs,"Macrae, Jack",27,14,1,13,0,1,1,0
Western Bulldogs,"McLean, Toby",13,4,4,9,1,0,0,5
Western Bulldogs,"Naughton, Aaron",8,7,6,1,6,1,0,2
Western Bulldogs,"Richards, Ed",10,6,0,4,0,0,0,2
Western Bulldogs,"Smith, Bailey",37,26,4,11,0,0,0,3
Western Bulldogs,"Smith, Roarke",12,3,1,9,0,0,0,0
Western Bulldogs,"Wallis, Mitch",10,5,3,5,0,3,0,3
Western Bulldogs,"West, Rhylee",12,5,4,7,0,0,0,1
Western Bulldogs,"Williams, Bailey",20,17,9,3,0,1,0,2
Western Bulldogs,"Wood, Easton",13,9,7,4,0,0,0,4
Western Bulldogs,"Bontempelli, Marcus",22,18,4,4,1,1,0,5
Western Bulldogs,"Bruce, Josh",5,1,2,4,0,0,5,4
Western Bulldogs,"Cavarra, Ben",7,5,1,2,1,0,0,5
Western Bulldogs,"Crozier, Hayden",14,10,8,4,0,0,0,2
Western Bulldogs,"Daniel, Caleb",15,10,2,5,0,1,0,2
Western Bulldogs,"Dunkley, Josh",19,4,3,15,0,0,1,7
Western Bulldogs,"English, Tim",6,3,2,3,1,0,6,0
Western Bulldogs,"Gardner, Ryan",7,3,3,4,0,0,0,2
Western Bulldogs,"Hunter, Lachie",24,15,8,9,0,1,0,2
Western Bulldogs,"Johannisen, Jason",21,15,3,6,0,0,0,1
Western Bulldogs,"Keath, Alex",13,8,6,5,0,0,0,0
Western Bulldogs,"Liberatore, Tom",20,10,1,10,1,0,0,2
Western Bulldogs,"Lipinski, Patrick",18,9,1,9,0,3,0,2
Western Bulldogs,"Macrae, Jack",26,9,3,17,0,0,1,8
Western Bulldogs,"McLean, Toby",13,4,2,9,1,0,0,2
Western Bulldogs,"Naughton, Aaron",10,3,4,7,0,0,0,0
Western Bulldogs,"Richards, Ed",7,5,2,2,0,0,0,0
Western Bulldogs,"Smith, Bailey",26,12,2,14,1,0,0,0
Western Bulldogs,"Vandermeer, Laitham",13,7,3,6,1,0,0,0
Western Bulldogs,"Wallis, Mitch",11,7,5,4,4,0,0,1
Western Bulldogs,"Williams, Bailey",19,14,5,5,1,0,0,3
Western Bulldogs,"Wood, Easton",11,5,4,6,0,0,0,1
Western Bulldogs,"Bontempelli, Marcus",14,8,2,6,1,0,0,10
Western Bulldogs,"Bruce, Josh",6,3,4,3,0,2,0,0
Western Bulldogs,"Crozier, Hayden",14,10,4,4,1,0,0,3
Western Bulldogs,"Daniel, Caleb",20,13,3,7,0,1,0,2
Western Bulldogs,"Dickson, Tory",4,0,0,4,0,0,0,1
Western Bulldogs,"Dunkley, Josh",13,5,1,8,1,1,3,6
Western Bulldogs,"English, Tim",11,7,5,4,0,0,10,0
Western Bulldogs,"Gardner, Ryan",8,3,1,5,0,0,0,3
Western Bulldogs,"Hayes, Will",11,4,1,7,0,0,0,5
Western Bulldogs,"Hunter, Lachie",27,16,8,11,1,0,0,1
Western Bulldogs,"Johannisen, Jason",21,12,6,9,0,1,0,1
Western Bulldogs,"Keath, Alex",10,7,5,3,0,0,0,2
Western Bulldogs,"Liberatore, Tom",15,6,3,9,1,0,0,2
Western Bulldogs,"Macrae, Jack",26,8,2,18,0,0,0,5
Western Bulldogs,"McLean, Toby",15,4,1,11,1,0,0,5
Western Bulldogs,"Naughton, Aaron",9,6,6,3,2,1,0,0
Western Bulldogs,"Richards, Ed",11,6,2,5,1,0,0,2
Western Bulldogs,"Smith, Bailey",21,12,1,9,0,0,0,0
Western Bulldogs,"Vandermeer, Laitham",1,0,0,1,0,0,0,0
Western Bulldogs,"Wallis, Mitch",6,3,1,3,0,0,0,2
Western Bulldogs,"Williams, Bailey",16,11,3,5,0,0,0,2
Western Bulldogs,"Wood, Easton",3,2,2,1,0,0,0,1
Western Bulldogs,"Bontempelli, Marcus",21,12,5,9,1,1,0,2
Western Bulldogs,"Bruce, Josh",11,5,3,6,0,0,1,2
Western Bulldogs,"Cordy, Zaine",10,6,3,4,0,0,0,1
Western Bulldogs,"Crozier, Hayden",9,4,5,5,0,0,0,1
Western Bulldogs,"Daniel, Caleb",25,19,3,6,0,0,0,2
Western Bulldogs,"Dunkley, Josh",22,7,3,15,1,2,1,9
Western Bulldogs,"English, Tim",10,5,3,5,0,0,23,4
Western Bulldogs,"Gardner, Ryan",7,3,3,4,0,0,0,1
Western Bulldogs,"Hayes, Will",9,3,1,6,0,0,0,1
Western Bulldogs,"Hunter, Lachie",24,16,2,8,0,0,0,4
Western Bulldogs,"Johannisen, Jason",14,8,6,6,0,1,0,1
Western Bulldogs,"Keath, Alex",8,2,3,6,0,0,0,0
Western Bulldogs,"Liberatore, Tom",21,11,0,10,0,0,0,3
Western Bulldogs,"Lloyd, Sam",12,7,2,5,1,1,0,2
Western Bulldogs,"Macrae, Jack",29,10,2,19,0,0,0,3
Western Bulldogs,"McLean, Toby",20,5,0,15,0,1,0,9
Western Bulldogs,"Naughton, Aaron",4,3,3,1,0,2,0,0
Western Bulldogs,"Richards, Ed",5,3,0,2,0,0,0,1
Western Bulldogs,"Smith, Bailey",24,9,1,15,0,0,0,3
Western Bulldogs,"Smith, Roarke",9,5,4,4,1,0,0,0
Western Bulldogs,"Wallis, Mitch",10,4,2,6,2,2,0,0
Western Bulldogs,"Williams, Bailey",15,10,5,5,0,0,0,0
Western Bulldogs,"Bontempelli, Marcus",28,18,8,10,0,0,0,6
Western Bulldogs,"Bruce, Josh",11,3,4,8,0,1,2,2
Western Bulldogs,"Cordy, Zaine",10,7,3,3,0,0,0,0
Western Bulldogs,"Crozier, Hayden",14,13,5,1,0,1,0,0
Western Bulldogs,"Daniel, Caleb",28,21,11,7,1,0,0,3
Western Bulldogs,"Dunkley, Josh",20,8,4,12,0,1,0,10
Western Bulldogs,"Duryea, Taylor",14,10,3,4,0,0,0,6
Western Bulldogs,"English, Tim",8,5,4,3,2,0,23,5
Western Bulldogs,"Gardner, Ryan",9,5,5,4,0,0,0,2
Western Bulldogs,"Hunter, Lachie",19,9,5,10,0,2,0,5
Western Bulldogs,"Johannisen, Jason",18,12,2,6,2,0,0,0
Western Bulldogs,"Keath, Alex",12,6,6,6,0,0,0,2
Western Bulldogs,"Liberatore, Tom",28,12,4,16,0,0,0,9
Western Bulldogs,"Macrae, Jack",29,15,1,14,0,1,0,3
Western Bulldogs,"McLean, Toby",1,1,0,0,1,0,0,0
Western Bulldogs,"Naughton, Aaron",13,6,6,7,2,0,0,3
Western Bulldogs,"Richards, Ed",16,6,3,10,0,2,0,1
Western Bulldogs,"Smith, Bailey",25,11,2,14,1,0,0,4
Western Bulldogs,"Smith, Roarke",15,6,3,9,1,1,0,1
Western Bulldogs,"Suckling, Matt",8,5,3,3,0,0,0,0
Western Bulldogs,"Wallis, Mitch",11,5,2,6,1,0,0,2
Western Bulldogs,"Williams, Bailey",13,8,1,5,0,0,0,1
Western Bulldogs,"Bontempelli, Marcus",20,14,3,6,1,0,0,5
Western Bulldogs,"Bruce, Josh",7,4,5,3,1,1,3,2
Western Bulldogs,"Cordy, Zaine",9,7,1,2,0,0,0,1
Western Bulldogs,"Crozier, Hayden",11,9,4,2,0,0,0,6
Western Bulldogs,"Daniel, Caleb",14,10,1,4,1,0,0,7
Western Bulldogs,"Dunkley, Josh",15,6,3,9,0,0,0,3
Western Bulldogs,"Duryea, Taylor",17,13,5,4,0,0,0,3
Western Bulldogs,"English, Tim",14,7,2,7,2,0,20,3
Western Bulldogs,"Gardner, Ryan",3,1,0,2,0,0,0,2
Western Bulldogs,"Hunter, Lachie",35,17,7,18,1,3,0,0
Western Bulldogs,"Johannisen, Jason",9,7,1,2,1,1,0,1
Western Bulldogs,"Keath, Alex",7,6,5,1,0,1,0,3
Western Bulldogs,"Liberatore, Tom",25,12,2,13,0,0,0,8
Western Bulldogs,"Lipinski, Patrick",17,7,2,10,1,0,0,3
Western Bulldogs,"Macrae, Jack",19,7,1,12,0,0,0,3
Western Bulldogs,"Naughton, Aaron",4,1,1,3,1,0,0,0
Western Bulldogs,"Richards, Ed",9,3,1,6,0,0,0,2
Western Bulldogs,"Smith, Bailey",14,5,2,9,1,0,0,0
Western Bulldogs,"Smith, Roarke",11,5,1,6,0,0,0,2
Western Bulldogs,"Wallis, Mitch",8,6,2,2,1,2,0,0
Western Bulldogs,"Williams, Bailey",13,10,6,3,0,0,0,2
Western Bulldogs,"Wood, Easton",6,5,3,1,0,0,0,2
Western Bulldogs,"Bontempelli, Marcus",20,14,3,6,0,1,0,6
Western Bulldogs,"Bruce, Josh",6,2,1,4,1,0,0,4
Western Bulldogs,"Cordy, Zaine",3,2,3,1,0,0,0,1
Western Bulldogs,"Crozier, Hayden",14,11,4,3,1,1,0,5
Western Bulldogs,"Daniel, Caleb",26,14,2,12,1,0,0,3
Western Bulldogs,"Dunkley, Josh",13,12,3,1,1,1,0,4
Western Bulldogs,"Duryea, Taylor",16,12,5,4,0,0,0,0
Western Bulldogs,"English, Tim",12,7,5,5,0,1,8,3
Western Bulldogs,"Gardner, Ryan",14,9,6,5,0,0,0,0
Western Bulldogs,"Hunter, Lachie",20,11,5,9,1,1,0,0
Western Bulldogs,"Johannisen, Jason",13,8,5,5,1,0,0,1
Western Bulldogs,"Keath, Alex",9,6,5,3,0,0,0,0
Western Bulldogs,"Liberatore, Tom",16,6,2,10,1,0,0,2
Western Bulldogs,"Lipinski, Patrick",10,5,2,5,0,0,0,1
Western Bulldogs,"Macrae, Jack",20,13,5,7,0,0,0,3
Western Bulldogs,"Naughton, Aaron",5,2,4,3,1,0,0,0
Western Bulldogs,"Richards, Ed",7,5,2,2,0,1,0,3
Western Bulldogs,"Smith, Bailey",24,9,1,15,0,2,0,0
Western Bulldogs,"Smith, Roarke",15,7,2,8,0,0,0,3
Western Bulldogs,"Wallis, Mitch",6,4,1,2,1,2,0,0
Western Bulldogs,"Williams, Bailey",19,11,6,8,0,0,0,0
Western Bulldogs,"Wood, Easton",9,5,3,4,0,0,0,2
Adelaide,"Atkins, Rory",31,22,7,9,0,1,0,0
Adelaide,"Betts, Eddie",10,6,3,4,2,0,0,3
Adelaide,"Crouch, Brad",28,13,6,15,2,0,0,2
Adelaide,"Crouch, Matt",40,16,5,24,1,0,0,4
Adelaide,"Doedee, Tom",8,5,3,3,0,0,0,1
Adelaide,"Douglas, Richard",15,13,4,2,0,2,0,1
Adelaide,"Gibbs, Bryce",16,10,3,6,0,0,0,7
Adelaide,"Jacobs, Sam",12,6,2,6,0,1,31,2
Adelaide,"Jenkins, Josh",12,7,5,5,0,0,4,4
Adelaide,"Jones, Chayce",9,3,3,6,1,1,0,4
Adelaide,"Keath, Alex",20,13,6,7,0,0,0,2
Adelaide,"Kelly, Jake",25,11,4,14,0,0,0,1
Adelaide,"Knight, Riley",20,8,3,12,0,1,0,3
Adelaide,"Laird, Rory",29,18,5,11,0,0,0,3
Adelaide,"Lynch, Tom",20,8,5,12,0,0,0,1
Adelaide,"Mackay, David",19,13,2,6,0,0,0,2
Adelaide,"Milera, Wayne",26,13,4,13,0,1,0,4
Adelaide,"Murphy, Lachlan",11,5,2,6,0,0,0,1
Adelaide,"Sloane, Rory",36,15,4,21,1,0,0,9
Adelaide,"Smith, Brodie",21,9,5,12,0,1,0,2
Adelaide,"Talia, Daniel",18,7,4,11,0,0,0,1
Adelaide,"Walker, Taylor",13,8,6,5,0,1,0,1
Adelaide,"Atkins, Rory",21,14,3,7,1,1,0,1
Adelaide,"Betts, Eddie",9,7,1,2,1,1,0,3
Adelaide,"Crouch, Brad",26,15,5,11,1,0,0,5
Adelaide,"Crouch, Matt",24,12,5,12,0,0,0,7
Adelaide,"Gibbs, Bryce",23,15,3,8,0,0,0,2
Adelaide,"Hartigan, Kyle",12,7,5,5,0,0,0,1
Adelaide,"Jacobs, Sam",7,3,1,4,0,1,40,1
Adelaide,"Jenkins, Josh",15,12,6,3,2,0,7,3
Adelaide,"Jones, Chayce",12,9,2,3,0,3,0,0
Adelaide,"Keath, Alex",15,7,1,8,0,0,0,2
Adelaide,"Kelly, Jake",16,7,5,9,0,0,0,1
Adelaide,"Knight, Riley",12,6,3,6,2,1,0,5
Adelaide,"Laird, Rory",21,13,5,8,0,0,0,3
Adelaide,"Lynch, Tom",18,9,5,9,1,1,0,1
Adelaide,"Mackay, David",17,9,4,8,2,0,0,2
Adelaide,"Milera, Wayne",21,11,6,10,0,0,0,4
Adelaide,"Murphy, Lachlan",17,9,5,8,0,0,0,3
Adelaide,"Seedsman, Paul",17,10,7,7,1,1,0,1
Adelaide,"Sloane, Rory",23,12,5,11,0,1,0,9
Adelaide,"Smith, Brodie",23,20,5,3,0,1,0,2
Adelaide,"Talia, Daniel",12,9,5,3,0,0,0,4
Adelaide,"Walker, Taylor",16,10,6,6,1,3,0,4
Adelaide,"Atkins, Rory",12,6,3,6,1,1,0,0
Adelaide,"Betts, Eddie",15,8,2,7,0,1,0,4
Adelaide,"Crouch, Brad",35,18,4,17,1,1,0,6
Adelaide,"Crouch, Matt",27,12,2,15,1,0,0,6
Adelaide,"Gibbs, Bryce",27,19,5,8,0,0,0,4
Adelaide,"Hartigan, Kyle",7,4,3,3,0,0,0,0
Adelaide,"Jenkins, Josh",10,5,4,5,1,1,3,1
Adelaide,"Jones, Chayce",8,2,1,6,0,0,0,1
Adelaide,"Keath, Alex",19,17,8,2,0,0,0,2
Adelaide,"Kelly, Jake",11,5,2,6,0,0,0,3
Adelaide,"Knight, Riley",11,7,7,4,1,0,0,2
Adelaide,"Laird, Rory",24,12,5,12,0,0,0,2
Adelaide,"Lynch, Tom",26,21,8,5,2,3,0,1
Adelaide,"Mackay, David",13,8,2,5,0,0,0,2
Adelaide,"Milera, Wayne",21,8,3,13,0,0,0,10
Adelaide,"Murphy, Lachlan",15,5,4,10,1,0,0,3
Adelaide,"OBrien, Reilly",11,5,3,6,0,0,28,3
Adelaide,"Seedsman, Paul",9,4,5,5,0,1,0,2
Adelaide,"Sloane, Rory",26,15,5,11,1,2,0,8
Adelaide,"Smith, Brodie",22,15,2,7,0,1,0,3
Adelaide,"Talia, Daniel",13,9,9,4,0,0,0,2
Adelaide,"Walker, Taylor",7,5,4,2,1,1,0,0
Adelaide,"Atkins, Rory",21,17,6,4,0,0,0,1
Adelaide,"Betts, Eddie",11,10,3,1,3,2,0,2
Adelaide,"Crouch, Brad",24,7,2,17,1,0,0,4
Adelaide,"Crouch, Matt",29,15,6,14,0,0,0,3
Adelaide,"Ellis-Yolmen, Cam",15,6,3,9,0,0,0,3
Adelaide,"Hartigan, Kyle",4,3,2,1,0,0,0,1
Adelaide,"Jenkins, Josh",13,11,5,2,1,3,7,0
Adelaide,"Jones, Chayce",3,1,1,2,0,1,0,0
Adelaide,"Keath, Alex",20,16,14,4,0,0,0,1
Adelaide,"Kelly, Jake",15,11,5,4,0,0,0,2
Adelaide,"Knight, Riley",15,8,4,7,0,0,0,4
Adelaide,"Laird, Rory",31,16,9,15,0,0,0,2
Adelaide,"Lynch, Tom",20,12,5,8,0,1,0,3
Adelaide,"Mackay, David",17,11,5,6,0,0,0,2
Adelaide,"Milera, Wayne",18,12,8,6,1,0,0,2
Adelaide,"Murphy, Lachlan",10,7,1,3,0,1,0,2
Adelaide,"OBrien, Reilly",16,10,6,6,0,0,14,5
Adelaide,"Poholke, Myles",15,6,6,9,0,1,0,2
Adelaide,"Sloane, Rory",16,8,3,8,1,1,0,7
Adelaide,"Smith, Brodie",18,13,5,5,0,0,0,3
Adelaide,"Talia, Daniel",13,7,7,6,0,0,0,0
Adelaide,"Walker, Taylor",11,6,3,5,1,0,0,3
Adelaide,"Atkins, Rory",26,17,5,9,0,0,0,5
Adelaide,"Betts, Eddie",14,11,1,3,6,3,0,2
Adelaide,"Crouch, Brad",36,13,1,23,0,0,0,6
Adelaide,"Crouch, Matt",36,13,5,23,0,0,0,2
Adelaide,"Ellis-Yolmen, Cam",29,10,3,19,0,0,0,8
Adelaide,"Gibbs, Bryce",26,16,8,10,0,0,0,1
Adelaide,"Greenwood, Hugh",18,10,2,8,2,1,0,1
Adelaide,"Hartigan, Kyle",8,5,4,3,0,0,0,1
Adelaide,"Himmelberg, Elliott",9,4,5,5,1,0,5,3
Adelaide,"Keath, Alex",18,8,6,10,0,0,0,3
Adelaide,"Kelly, Jake",20,14,6,6,0,1,0,2
Adelaide,"Knight, Riley",18,8,5,10,0,0,0,4
Adelaide,"Laird, Rory",28,18,5,10,0,0,0,1
Adelaide,"Lynch, Tom",22,16,8,6,1,1,0,3
Adelaide,"Mackay, David",23,15,4,8,0,0,0,8
Adelaide,"Milera, Wayne",12,8,2,4,0,1,0,1
Adelaide,"Murphy, Lachlan",14,8,4,6,3,0,0,5
Adelaide,"OBrien, Reilly",12,2,4,10,0,0,34,2
Adelaide,"Sloane, Rory",32,17,7,15,0,0,0,6
Adelaide,"Smith, Brodie",27,17,5,10,2,1,0,0
Adelaide,"Talia, Daniel",13,6,8,7,0,0,0,3
Adelaide,"Walker, Taylor",14,12,8,2,3,2,0,2
Adelaide,"Atkins, Rory",27,17,6,10,0,0,0,1
Adelaide,"Betts, Eddie",10,7,3,3,2,0,0,2
Adelaide,"Crouch, Brad",30,17,5,13,0,0,0,2
Adelaide,"Crouch, Matt",36,19,2,17,0,0,0,2
Adelaide,"Ellis-Yolmen, Cam",20,11,2,9,0,0,0,4
Adelaide,"Gallucci, Jordan",12,7,3,5,1,0,0,1
Adelaide,"Greenwood, Hugh",14,6,3,8,1,1,0,5
Adelaide,"Hartigan, Kyle",11,9,7,2,0,0,0,0
Adelaide,"Himmelberg, Elliott",12,7,5,5,2,2,9,2
Adelaide,"Keath, Alex",21,18,14,3,0,0,0,0
Adelaide,"Kelly, Jake",22,15,12,7,0,0,0,3
Adelaide,"Knight, Riley",15,10,8,5,1,0,0,3
Adelaide,"Laird, Rory",33,16,5,17,0,0,0,1
Adelaide,"Lynch, Tom",15,12,9,3,1,1,0,1
Adelaide,"Mackay, David",18,10,3,8,0,0,0,1
Adelaide,"Murphy, Lachlan",7,5,3,2,3,0,0,3
Adelaide,"OBrien, Reilly",11,3,4,8,0,0,36,4
Adelaide,"Poholke, Myles",10,4,1,6,0,0,0,3
Adelaide,"Sloane, Rory",21,10,6,11,0,0,0,4
Adelaide,"Smith, Brodie",30,19,5,11,0,1,0,3
Adelaide,"Talia, Daniel",11,8,5,3,0,0,0,2
Adelaide,"Walker, Taylor",14,12,7,2,4,2,0,3
Adelaide,"Atkins, Rory",18,9,2,9,0,1,0,2
Adelaide,"Betts, Eddie",12,7,2,5,1,2,0,5
Adelaide,"Crouch, Brad",31,11,2,20,0,0,0,4
Adelaide,"Crouch, Matt",39,18,4,21,0,0,0,3
Adelaide,"Ellis-Yolmen, Cam",33,14,2,19,0,0,0,5
Adelaide,"Gallucci, Jordan",12,9,1,3,0,0,0,1
Adelaide,"Gibbs, Bryce",13,8,1,5,0,0,0,4
Adelaide,"Greenwood, Hugh",22,10,0,12,1,1,0,7
Adelaide,"Hartigan, Kyle",16,10,4,6,0,0,0,2
Adelaide,"Himmelberg, Elliott",13,9,6,4,1,0,8,2
Adelaide,"Keath, Alex",18,10,3,8,1,0,0,0
Adelaide,"Kelly, Jake",18,9,6,9,0,0,0,0
Adelaide,"Knight, Riley",16,11,4,5,0,0,0,6
Adelaide,"Laird, Rory",32,10,5,22,0,0,0,2
Adelaide,"Lynch, Tom",29,18,8,11,0,2,0,1
Adelaide,"Mackay, David",14,7,2,7,0,0,0,2
Adelaide,"Murphy, Lachlan",10,8,3,2,1,1,0,1
Adelaide,"OBrien, Reilly",22,7,5,15,0,1,44,3
Adelaide,"Sloane, Rory",33,14,4,19,0,0,0,4
Adelaide,"Smith, Brodie",25,14,3,11,1,0,0,1
Adelaide,"Talia, Daniel",12,6,3,6,0,0,0,1
Adelaide,"Walker, Taylor",11,6,2,5,1,0,0,2
Adelaide,"Atkins, Rory",21,17,7,4,1,0,0,3
Adelaide,"Betts, Eddie",10,7,1,3,0,1,0,0
Adelaide,"Brown, Luke",18,12,4,6,0,0,0,2
Adelaide,"Crouch, Brad",30,10,1,20,0,1,0,6
Adelaide,"Crouch, Matt",19,9,1,10,0,0,0,2
Adelaide,"Ellis-Yolmen, Cam",24,10,1,14,0,0,0,7
Adelaide,"Gallucci, Jordan",11,8,1,3,0,0,0,2
Adelaide,"Greenwood, Hugh",22,11,2,11,1,0,0,7
Adelaide,"Hartigan, Kyle",6,4,1,2,0,0,0,3
Adelaide,"Himmelberg, Elliott",12,6,1,6,1,1,4,5
Adelaide,"Keath, Alex",26,15,5,11,0,0,0,2
Adelaide,"Kelly, Jake",19,8,1,11,0,0,0,4
Adelaide,"Knight, Riley",10,6,2,4,2,0,0,3
Adelaide,"Laird, Rory",31,20,3,11,0,1,0,3
Adelaide,"Lynch, Tom",20,14,2,6,3,0,0,6
Adelaide,"Mackay, David",19,16,2,3,1,0,0,3
Adelaide,"Murphy, Lachlan",11,6,3,5,1,1,0,11
Adelaide,"OBrien, Reilly",10,6,0,4,0,0,34,5
Adelaide,"Sloane, Rory",26,15,3,11,1,1,0,13
Adelaide,"Smith, Brodie",17,11,4,6,0,1,0,4
Adelaide,"Talia, Daniel",13,11,5,2,0,0,0,1
Adelaide,"Walker, Taylor",10,7,5,3,2,0,0,1
Adelaide,"Atkins, Rory",16,12,8,4,1,1,0,1
Adelaide,"Betts, Eddie",10,6,1,4,3,2,0,2
Adelaide,"Brown, Luke",12,7,2,5,0,0,0,0
Adelaide,"Crouch, Brad",32,18,6,14,0,1,0,7
Adelaide,"Ellis-Yolmen, Cam",16,8,2,8,0,0,0,4
Adelaide,"Gallucci, Jordan",13,11,6,2,0,0,0,0
Adelaide,"Gibbs, Bryce",22,14,7,8,2,1,0,5
Adelaide,"Greenwood, Hugh",9,4,3,5,0,0,0,5
Adelaide,"Hartigan, Kyle",6,4,2,2,0,0,0,2
Adelaide,"Himmelberg, Elliott",6,4,3,2,1,0,4,2
Adelaide,"Jones, Chayce",15,7,1,8,0,1,0,4
Adelaide,"Keath, Alex",13,9,4,4,0,0,0,1
Adelaide,"Kelly, Jake",15,9,3,6,0,0,0,4
Adelaide,"Laird, Rory",24,17,8,7,0,0,0,1
Adelaide,"Lynch, Tom",21,13,8,8,1,0,0,2
Adelaide,"Mackay, David",19,14,3,5,0,0,0,0
Adelaide,"Murphy, Lachlan",17,11,3,6,1,3,0,3
Adelaide,"OBrien, Reilly",13,4,2,9,0,0,37,3
Adelaide,"Sloane, Rory",27,10,4,17,1,0,0,7
Adelaide,"Smith, Brodie",24,17,6,7,0,0,0,2
Adelaide,"Talia, Daniel",9,5,2,4,0,0,0,1
Adelaide,"Walker, Taylor",13,9,7,4,3,3,0,1
Adelaide,"Atkins, Rory",20,15,7,5,1,0,0,0
Adelaide,"Betts, Eddie",17,12,4,5,2,1,0,1
Adelaide,"Brown, Luke",10,7,5,3,0,0,0,3
Adelaide,"Crouch, Brad",39,26,2,13,0,1,0,1
Adelaide,"Ellis-Yolmen, Cam",30,11,5,19,1,2,0,10
Adelaide,"Gallucci, Jordan",14,11,3,3,0,0,0,3
Adelaide,"Greenwood, Hugh",24,12,1,12,0,0,0,13
Adelaide,"Hartigan, Kyle",13,7,4,6,0,0,0,1
Adelaide,"Himmelberg, Elliott",6,3,1,3,0,1,11,6
Adelaide,"Jones, Chayce",11,4,0,7,0,1,0,4
Adelaide,"Keath, Alex",14,7,2,7,0,0,0,2
Adelaide,"Kelly, Jake",19,12,3,7,0,0,0,3
Adelaide,"Knight, Riley",17,9,3,8,0,1,0,6
Adelaide,"Laird, Rory",28,16,3,12,0,0,0,3
Adelaide,"Milera, Wayne",16,12,4,4,3,0,0,4
Adelaide,"Murphy, Lachlan",12,7,1,5,1,2,0,4
Adelaide,"OBrien, Reilly",13,4,4,9,0,0,40,7
Adelaide,"Seedsman, Paul",13,8,2,5,1,0,0,3
Adelaide,"Sloane, Rory",32,17,2,15,1,1,0,8
Adelaide,"Smith, Brodie",22,15,4,7,0,1,0,2
Adelaide,"Talia, Daniel",13,8,5,5,0,0,0,3
Adelaide,"Walker, Taylor",12,5,2,7,0,0,0,5
Adelaide,"Atkins, Rory",27,17,11,10,0,0,0,2
Adelaide,"Betts, Eddie",14,8,1,6,2,0,0,5
Adelaide,"Brown, Luke",13,8,4,5,0,0,0,2
Adelaide,"Crouch, Brad",29,21,3,8,3,0,0,5
Adelaide,"Ellis-Yolmen, Cam",25,13,4,12,1,0,0,2
Adelaide,"Gallucci, Jordan",13,9,3,4,1,0,0,3
Adelaide,"Gibbs, Bryce",13,11,5,2,0,0,0,5
Adelaide,"Greenwood, Hugh",20,9,4,11,0,0,0,7
Adelaide,"Jenkins, Josh",16,13,7,3,2,3,6,0
Adelaide,"Keath, Alex",14,7,3,7,0,0,0,3
Adelaide,"Kelly, Jake",15,13,7,2,0,0,0,10
Adelaide,"Laird, Rory",31,16,6,15,0,0,0,4
Adelaide,"Lynch, Tom",26,16,13,10,3,0,0,1
Adelaide,"Mackay, David",16,9,3,7,0,0,0,5
Adelaide,"Milera, Wayne",22,13,7,9,0,0,0,1
Adelaide,"Murphy, Lachlan",4,3,1,1,1,0,0,1
Adelaide,"OBrien, Reilly",7,3,1,4,0,0,34,3
Adelaide,"Seedsman, Paul",17,4,0,13,0,0,0,2
Adelaide,"Sloane, Rory",8,6,1,2,0,0,0,1
Adelaide,"Smith, Brodie",27,17,10,10,0,0,0,1
Adelaide,"Talia, Daniel",9,7,4,2,0,0,0,6
Adelaide,"Walker, Taylor",10,6,5,4,1,1,0,0
Adelaide,"Atkins, Rory",19,11,3,8,0,0,0,2
Adelaide,"Betts, Eddie",9,6,2,3,2,0,0,2
Adelaide,"Brown, Luke",20,16,5,4,0,1,0,3
Adelaide,"Crouch, Brad",30,15,2,15,1,2,0,3
Adelaide,"Crouch, Matt",34,15,7,19,0,0,0,3
Adelaide,"Douglas, Richard",12,7,0,5,0,0,0,3
Adelaide,"Ellis-Yolmen, Cam",17,8,4,9,0,0,0,9
Adelaide,"Gallucci, Jordan",18,9,8,9,0,0,0,1
Adelaide,"Greenwood, Hugh",7,2,2,5,1,0,0,3
Adelaide,"Hartigan, Kyle",15,12,9,3,0,0,0,1
Adelaide,"Jenkins, Josh",10,8,3,2,3,2,7,4
Adelaide,"Keath, Alex",15,9,10,6,0,0,0,1
Adelaide,"Kelly, Jake",12,9,8,3,0,0,0,4
Adelaide,"Laird, Rory",28,20,3,8,0,0,0,0
Adelaide,"Milera, Wayne",21,16,9,5,0,1,0,5
Adelaide,"Murphy, Lachlan",13,10,0,3,1,1,0,2
Adelaide,"OBrien, Reilly",17,14,3,3,0,1,29,3
Adelaide,"Seedsman, Paul",15,8,5,7,0,0,0,2
Adelaide,"Sloane, Rory",17,11,4,6,2,0,0,5
Adelaide,"Smith, Brodie",12,5,3,7,0,0,0,0
Adelaide,"Talia, Daniel",15,11,7,4,0,0,0,3
Adelaide,"Walker, Taylor",15,9,6,6,2,2,0,0
Adelaide,"Atkins, Rory",29,25,11,4,1,0,0,2
Adelaide,"Betts, Eddie",13,8,0,5,2,0,0,3
Adelaide,"Brown, Luke",9,5,3,4,0,0,0,1
Adelaide,"Crouch, Brad",43,27,3,16,0,1,0,2
Adelaide,"Crouch, Matt",35,12,5,23,0,0,0,1
Adelaide,"Douglas, Richard",15,7,3,8,0,0,0,3
Adelaide,"Ellis-Yolmen, Cam",26,9,3,17,0,0,0,4
Adelaide,"Gallucci, Jordan",14,12,6,2,0,1,0,3
Adelaide,"Greenwood, Hugh",20,9,1,11,1,0,0,8
Adelaide,"Hartigan, Kyle",5,3,2,2,0,0,0,1
Adelaide,"Jenkins, Josh",17,14,7,3,4,3,8,0
Adelaide,"Keath, Alex",19,9,8,10,0,0,0,2
Adelaide,"Kelly, Jake",9,8,4,1,0,0,0,3
Adelaide,"Laird, Rory",32,12,8,20,0,0,0,4
Adelaide,"Milera, Wayne",18,8,6,10,0,0,0,2
Adelaide,"Murphy, Lachlan",0,0,0,0,0,0,0,1
Adelaide,"OBrien, Reilly",19,9,5,10,0,0,54,7
Adelaide,"Seedsman, Paul",26,17,3,9,1,0,0,1
Adelaide,"Sloane, Rory",28,18,5,10,2,0,0,2
Adelaide,"Smith, Brodie",22,16,6,6,1,1,0,2
Adelaide,"Talia, Daniel",10,9,4,1,0,0,0,2
Adelaide,"Walker, Taylor",18,11,8,7,3,3,0,2
Adelaide,"Atkins, Rory",24,18,8,6,0,1,0,1
Adelaide,"Betts, Eddie",9,5,1,4,0,1,0,2
Adelaide,"Brown, Luke",15,10,1,5,0,0,0,3
Adelaide,"Crouch, Brad",27,18,4,9,0,2,0,5
Adelaide,"Crouch, Matt",30,12,2,18,0,0,0,5
Adelaide,"Davis, Ben",7,3,2,4,0,0,0,1
Adelaide,"Douglas, Richard",15,5,4,10,0,0,0,1
Adelaide,"Gallucci, Jordan",11,10,4,1,1,0,0,0
Adelaide,"Gibbs, Bryce",13,8,1,5,0,0,0,4
Adelaide,"Greenwood, Hugh",14,9,3,5,1,0,0,7
Adelaide,"Hartigan, Kyle",13,8,5,5,0,0,0,0
Adelaide,"Himmelberg, Elliott",9,5,3,4,2,0,2,3
Adelaide,"Keath, Alex",17,10,7,7,0,0,0,2
Adelaide,"Kelly, Jake",15,9,5,6,0,0,0,2
Adelaide,"Laird, Rory",23,7,3,16,0,0,0,4
Adelaide,"Murphy, Lachlan",10,5,4,5,1,0,0,6
Adelaide,"OBrien, Reilly",18,11,2,7,1,0,39,7
Adelaide,"Seedsman, Paul",28,16,6,12,2,1,0,0
Adelaide,"Sloane, Rory",30,13,3,17,0,0,0,6
Adelaide,"Smith, Brodie",14,10,1,4,1,0,0,2
Adelaide,"Talia, Daniel",7,5,3,2,0,0,0,0
Adelaide,"Walker, Taylor",10,7,4,3,1,0,0,2
Adelaide,"Atkins, Rory",17,11,5,6,0,0,0,1
Adelaide,"Betts, Eddie",10,4,1,6,0,1,0,3
Adelaide,"Brown, Luke",14,8,1,6,0,0,0,1
Adelaide,"Crouch, Brad",23,14,5,9,0,0,0,5
Adelaide,"Crouch, Matt",29,11,1,18,1,1,0,4
Adelaide,"Douglas, Richard",11,8,2,3,0,1,0,2
Adelaide,"Gallucci, Jordan",4,4,1,0,0,1,0,1
Adelaide,"Greenwood, Hugh",18,9,2,9,1,1,0,5
Adelaide,"Hartigan, Kyle",13,8,4,5,0,0,0,1
Adelaide,"Jenkins, Josh",11,4,4,7,0,0,4,1
Adelaide,"Keath, Alex",11,9,7,2,0,0,0,3
Adelaide,"Kelly, Jake",17,15,8,2,0,0,0,3
Adelaide,"Laird, Rory",25,15,6,10,0,0,0,3
Adelaide,"Mackay, David",14,8,4,6,0,0,0,0
Adelaide,"Milera, Wayne",15,10,4,5,1,3,0,0
Adelaide,"Murphy, Lachlan",9,7,4,2,0,1,0,2
Adelaide,"OBrien, Reilly",20,10,5,10,0,0,27,4
Adelaide,"Seedsman, Paul",7,3,1,4,0,0,0,1
Adelaide,"Sloane, Rory",23,14,4,9,0,0,0,4
Adelaide,"Smith, Brodie",25,19,3,6,0,1,0,2
Adelaide,"Talia, Daniel",14,7,7,7,0,0,0,2
Adelaide,"Walker, Taylor",9,5,3,4,2,1,0,1
Adelaide,"Atkins, Rory",35,28,4,7,0,2,0,3
Adelaide,"Betts, Eddie",20,16,6,4,6,1,0,2
Adelaide,"Brown, Luke",21,15,6,6,1,0,0,2
Adelaide,"Crouch, Brad",25,10,2,15,0,1,0,16
Adelaide,"Crouch, Matt",36,11,3,25,1,1,0,3
Adelaide,"Greenwood, Hugh",22,13,7,9,1,0,0,8
Adelaide,"Hartigan, Kyle",14,7,5,7,0,0,0,0
Adelaide,"Jenkins, Josh",14,12,8,2,4,3,8,1
Adelaide,"Keath, Alex",18,14,7,4,0,0,0,1
Adelaide,"Kelly, Jake",27,13,7,14,0,0,0,2
Adelaide,"Knight, Riley",25,10,9,15,0,1,0,3
Adelaide,"Laird, Rory",30,16,8,14,0,0,0,1
Adelaide,"Mackay, David",18,6,2,12,0,0,0,3
Adelaide,"Milera, Wayne",27,13,7,14,1,0,0,1
Adelaide,"Murphy, Lachlan",15,10,5,5,2,0,0,4
Adelaide,"OBrien, Reilly",19,8,1,11,1,0,33,6
Adelaide,"Seedsman, Paul",23,6,4,17,0,0,0,0
Adelaide,"Sloane, Rory",26,8,7,18,0,1,0,3
Adelaide,"Smith, Brodie",24,15,5,9,0,1,0,2
Adelaide,"Stengle, Tyson",10,8,3,2,3,1,0,3
Adelaide,"Talia, Daniel",8,3,4,5,0,0,0,4
Adelaide,"Walker, Taylor",19,10,9,9,3,0,0,1
Adelaide,"Atkins, Rory",19,13,4,6,0,0,0,1
Adelaide,"Betts, Eddie",9,3,4,6,0,1,0,2
Adelaide,"Brown, Luke",24,18,5,6,0,0,0,1
Adelaide,"Crouch, Brad",35,19,4,16,0,1,0,7
Adelaide,"Crouch, Matt",33,11,4,22,0,1,0,2
Adelaide,"Greenwood, Hugh",13,5,2,8,1,1,0,2
Adelaide,"Hartigan, Kyle",10,7,6,3,0,0,0,0
Adelaide,"Jenkins, Josh",12,9,4,3,4,0,5,0
Adelaide,"Keath, Alex",11,7,6,4,0,0,0,2
Adelaide,"Kelly, Jake",16,6,4,10,0,0,0,2
Adelaide,"Knight, Riley",21,8,6,13,0,0,0,3
Adelaide,"Laird, Rory",27,13,3,14,0,0,0,1
Adelaide,"Lynch, Tom",24,15,12,9,1,2,0,2
Adelaide,"Mackay, David",15,10,3,5,0,0,0,2
Adelaide,"Milera, Wayne",19,13,7,6,0,1,0,1
Adelaide,"Murphy, Lachlan",11,7,7,4,0,1,0,1
Adelaide,"OBrien, Reilly",27,12,3,15,0,0,39,4
Adelaide,"Seedsman, Paul",26,20,5,6,0,0,0,2
Adelaide,"Sloane, Rory",20,12,3,8,0,0,0,7
Adelaide,"Smith, Brodie",31,19,7,12,3,1,0,4
Adelaide,"Talia, Daniel",13,8,7,5,0,0,0,3
Adelaide,"Walker, Taylor",8,7,3,1,1,1,0,0
Adelaide,"Atkins, Rory",10,5,3,5,0,0,0,2
Adelaide,"Brown, Luke",9,3,0,6,0,0,0,1
Adelaide,"Crouch, Brad",30,16,2,14,1,1,0,2
Adelaide,"Crouch, Matt",24,8,4,16,0,0,0,5
Adelaide,"Hartigan, Kyle",12,6,4,6,0,0,0,0
Adelaide,"Jenkins, Josh",6,5,3,1,1,2,9,4
Adelaide,"Kelly, Jake",12,7,3,5,0,0,0,3
Adelaide,"Knight, Riley",15,7,7,8,0,0,0,5
Adelaide,"Laird, Rory",27,15,6,12,0,0,0,2
Adelaide,"Lynch, Tom",14,11,9,3,0,0,0,2
Adelaide,"Mackay, David",19,9,4,10,0,0,0,4
Adelaide,"Milera, Wayne",13,9,6,4,0,0,0,8
Adelaide,"Murphy, Lachlan",10,5,3,5,1,0,0,7
Adelaide,"OBrien, Reilly",20,10,8,10,0,1,32,2
Adelaide,"Otten, Andy",14,8,3,6,0,0,0,4
Adelaide,"Seedsman, Paul",13,9,2,4,1,0,0,6
Adelaide,"Sloane, Rory",26,12,5,14,0,0,0,8
Adelaide,"Smith, Brodie",24,16,4,8,0,0,0,7
Adelaide,"Stengle, Tyson",7,6,2,1,2,0,0,4
Adelaide,"Talia, Daniel",12,9,2,3,0,0,0,3
Adelaide,"Walker, Taylor",11,8,5,3,3,0,0,2
Adelaide,"Wilson, Patrick",15,9,2,6,0,0,0,4
Adelaide,"Atkins, Rory",20,10,7,10,0,0,0,3
Adelaide,"Betts, Eddie",11,5,4,6,3,0,0,2
Adelaide,"Brown, Luke",17,10,8,7,0,0,0,1
Adelaide,"Crouch, Brad",29,14,3,15,0,0,0,7
Adelaide,"Crouch, Matt",35,16,6,19,2,0,0,3
Adelaide,"Douglas, Richard",19,13,1,6,1,0,0,5
Adelaide,"Fogarty, Darcy",9,6,5,3,1,1,0,0
Adelaide,"Gibbs, Bryce",29,19,5,10,0,0,0,5
Adelaide,"Hartigan, Kyle",7,3,2,4,0,0,0,0
Adelaide,"Kelly, Jake",14,12,7,2,0,0,0,1
Adelaide,"Knight, Riley",10,3,1,7,0,0,0,6
Adelaide,"Laird, Rory",38,17,12,21,0,0,0,1
Adelaide,"Lynch, Tom",22,16,9,6,1,1,0,3
Adelaide,"Mackay, David",19,16,6,3,0,1,0,7
Adelaide,"Milera, Wayne",20,15,11,5,0,0,0,0
Adelaide,"Murphy, Lachlan",8,5,1,3,1,2,0,4
Adelaide,"OBrien, Reilly",12,5,2,7,0,0,31,7
Adelaide,"Otten, Andy",14,9,8,5,0,0,3,0
Adelaide,"Sloane, Rory",23,12,9,11,0,1,0,6
Adelaide,"Smith, Brodie",23,16,8,7,1,0,0,3
Adelaide,"Talia, Daniel",15,12,8,3,0,0,0,2
Adelaide,"Walker, Taylor",12,10,6,2,4,0,0,0
Adelaide,"Atkins, Rory",18,12,5,6,0,1,0,0
Adelaide,"Betts, Eddie",9,4,3,5,1,1,0,3
Adelaide,"Brown, Luke",18,16,5,2,0,0,0,2
Adelaide,"Crouch, Brad",35,17,1,18,1,0,0,6
Adelaide,"Crouch, Matt",43,23,8,20,0,0,0,3
Adelaide,"Douglas, Richard",14,11,7,3,0,0,0,2
Adelaide,"Fogarty, Darcy",12,10,7,2,5,0,0,0
Adelaide,"Gibbs, Bryce",25,18,6,7,0,0,0,3
Adelaide,"Hartigan, Kyle",9,5,3,4,0,0,0,3
Adelaide,"Jacobs, Sam",11,6,4,5,0,0,36,6
Adelaide,"Kelly, Jake",17,8,6,9,0,0,0,3
Adelaide,"Knight, Riley",15,6,6,9,1,0,0,3
Adelaide,"Laird, Rory",27,15,8,12,0,0,0,3
Adelaide,"Lynch, Tom",14,12,6,2,0,1,0,0
Adelaide,"Mackay, David",18,10,4,8,0,0,0,3
Adelaide,"Milera, Wayne",14,6,1,8,0,0,0,6
Adelaide,"Murphy, Lachlan",11,6,2,5,1,0,0,2
Adelaide,"Otten, Andy",16,10,4,6,0,0,3,3
Adelaide,"Sloane, Rory",17,9,6,8,1,0,0,3
Adelaide,"Smith, Brodie",17,10,5,7,0,0,0,3
Adelaide,"Talia, Daniel",13,7,8,6,0,0,0,2
Adelaide,"Walker, Taylor",12,8,3,4,2,1,0,1
Adelaide,"Betts, Eddie",15,7,3,8,1,0,0,2
Adelaide,"Brown, Luke",12,9,5,3,0,1,0,1
Adelaide,"Crouch, Brad",24,12,2,12,0,0,0,7
Adelaide,"Crouch, Matt",24,12,0,12,0,1,0,4
Adelaide,"Douglas, Richard",15,9,2,6,1,0,0,3
Adelaide,"Fogarty, Darcy",11,9,5,2,3,0,0,0
Adelaide,"Gibbs, Bryce",12,8,4,4,0,0,0,4
Adelaide,"Hartigan, Kyle",14,7,7,7,0,0,0,1
Adelaide,"Jacobs, Sam",12,6,3,6,0,0,15,1
Adelaide,"Jones, Chayce",13,9,1,4,0,0,0,1
Adelaide,"Kelly, Jake",12,8,7,4,0,0,0,3
Adelaide,"Laird, Rory",23,7,7,16,0,0,0,0
Adelaide,"Lynch, Tom",9,7,4,2,1,0,0,1
Adelaide,"Mackay, David",15,8,2,7,0,0,0,0
Adelaide,"Milera, Wayne",12,9,3,3,0,0,0,0
Adelaide,"Murphy, Lachlan",10,4,2,6,0,2,0,2
Adelaide,"OBrien, Reilly",9,3,2,6,0,1,12,2
Adelaide,"Seedsman, Paul",30,20,7,10,0,1,0,2
Adelaide,"Sloane, Rory",17,6,3,11,0,1,0,3
Adelaide,"Smith, Brodie",29,20,10,9,0,1,0,2
Adelaide,"Talia, Daniel",18,14,11,4,0,0,0,0
Adelaide,"Walker, Taylor",9,6,5,3,0,1,0,0
Adelaide,"Betts, Eddie",14,8,3,6,0,3,0,2
Adelaide,"Brown, Luke",15,9,3,6,0,0,0,1
Adelaide,"Crouch, Brad",24,7,0,17,0,0,1,3
Adelaide,"Crouch, Matt",47,25,7,22,1,0,0,3
Adelaide,"Douglas, Richard",20,11,4,9,0,0,0,3
Adelaide,"Fogarty, Darcy",10,3,5,7,0,0,1,2
Adelaide,"Gibbs, Bryce",18,8,0,10,0,0,0,3
Adelaide,"Greenwood, Hugh",16,10,2,6,0,0,0,6
Adelaide,"Jacobs, Sam",15,9,2,6,0,1,56,3
Adelaide,"Jones, Chayce",18,13,7,5,2,1,0,4
Adelaide,"Keath, Alex",5,3,1,2,0,0,4,1
Adelaide,"Kelly, Jake",10,5,1,5,0,0,0,1
Adelaide,"Knight, Riley",15,7,5,8,2,1,0,3
Adelaide,"Laird, Rory",31,13,2,18,0,0,0,3
Adelaide,"Lynch, Tom",26,13,5,13,2,0,0,1
Adelaide,"Mackay, David",17,6,2,11,0,0,0,4
Adelaide,"Milera, Wayne",14,8,5,6,0,0,0,3
Adelaide,"Seedsman, Paul",24,14,7,10,0,0,0,6
Adelaide,"Sloane, Rory",34,12,4,22,0,0,0,6
Adelaide,"Smith, Brodie",27,13,3,14,1,0,0,5
Adelaide,"Talia, Daniel",7,3,2,4,0,0,0,3
Adelaide,"Walker, Taylor",10,8,5,2,5,0,0,1
Brisbane Lions,"Andrews, Harris",20,8,6,12,0,0,0,1
Brisbane Lions,"Bailey, Zac",15,10,4,5,0,1,0,1
Brisbane Lions,"Bastinac, Ryan",14,12,9,2,1,0,0,1
Brisbane Lions,"Berry, Jarrod",25,10,4,15,0,1,0,4
Brisbane Lions,"Cameron, Charlie",13,9,5,4,3,1,0,4
Brisbane Lions,"Gardiner, Darcy",15,12,6,3,0,0,0,2
Brisbane Lions,"Hipwood, Eric",8,8,2,0,0,1,0,1
Brisbane Lions,"Hodge, Luke",20,13,6,7,0,0,0,1
Brisbane Lions,"Lyons, Jarryd",26,15,1,11,0,0,0,7
Brisbane Lions,"Martin, Stefan",13,4,0,9,0,0,18,3
Brisbane Lions,"Mathieson, Rhys",25,12,2,13,1,0,0,3
Brisbane Lions,"McCarthy, Lincoln",11,7,2,4,4,0,0,4
Brisbane Lions,"McCluggage, Hugh",20,12,4,8,1,1,0,5
Brisbane Lions,"McInerney, Oscar",6,2,0,4,0,0,18,0
Brisbane Lions,"McStay, Daniel",11,5,2,6,0,0,0,2
Brisbane Lions,"Neale, Lachie",29,11,2,18,1,1,0,2
Brisbane Lions,"Rayner, Cam",14,10,4,4,2,3,0,2
Brisbane Lions,"Rich, Daniel",23,21,8,2,1,0,0,1
Brisbane Lions,"Robinson, Mitch",19,14,2,5,0,1,0,3
Brisbane Lions,"Walker, Josh",10,6,5,4,0,0,0,1
Brisbane Lions,"Witherden, Alex",25,16,7,9,0,0,0,0
Brisbane Lions,"Zorko, Dayne",20,15,2,5,1,1,0,8
Brisbane Lions,"Andrews, Harris",13,9,8,4,0,0,0,4
Brisbane Lions,"Bailey, Zac",19,13,6,6,0,0,0,2
Brisbane Lions,"Bastinac, Ryan",11,7,3,4,1,0,0,1
Brisbane Lions,"Berry, Jarrod",23,14,10,9,1,0,0,1
Brisbane Lions,"Cameron, Charlie",11,7,5,4,4,1,0,0
Brisbane Lions,"Gardiner, Darcy",11,7,3,4,0,0,0,3
Brisbane Lions,"Hipwood, Eric",9,7,4,2,1,1,0,2
Brisbane Lions,"Hodge, Luke",15,11,5,4,0,0,0,4
Brisbane Lions,"Lyons, Jarryd",19,7,4,12,0,0,0,4
Brisbane Lions,"Martin, Stefan",17,10,3,7,1,0,25,0
Brisbane Lions,"Mathieson, Rhys",18,12,8,6,0,0,0,3
Brisbane Lions,"McCarthy, Lincoln",11,8,4,3,2,0,0,2
Brisbane Lions,"McCluggage, Hugh",24,16,2,8,1,0,0,5
Brisbane Lions,"McInerney, Oscar",16,6,6,10,2,1,13,1
Brisbane Lions,"McStay, Daniel",9,6,5,3,1,0,0,1
Brisbane Lions,"Neale, Lachie",43,18,7,25,0,0,0,6
Brisbane Lions,"Rayner, Cam",11,7,5,4,1,3,0,2
Brisbane Lions,"Rich, Daniel",27,21,7,6,0,1,0,3
Brisbane Lions,"Robinson, Mitch",22,15,6,7,1,0,0,3
Brisbane Lions,"Walker, Josh",17,7,4,10,0,0,0,2
Brisbane Lions,"Witherden, Alex",18,14,7,4,0,0,0,1
Brisbane Lions,"Zorko, Dayne",19,13,3,6,0,2,0,3
Brisbane Lions,"Andrews, Harris",8,3,3,5,0,0,0,1
Brisbane Lions,"Bailey, Zac",11,10,2,1,0,0,0,0
Brisbane Lions,"Bastinac, Ryan",9,7,4,2,0,0,0,2
Brisbane Lions,"Berry, Jarrod",18,10,3,8,0,0,0,5
Brisbane Lions,"Cameron, Charlie",10,6,1,4,1,3,0,5
Brisbane Lions,"Gardiner, Darcy",14,11,5,3,0,0,0,0
Brisbane Lions,"Hipwood, Eric",14,11,10,3,6,1,0,0
Brisbane Lions,"Hodge, Luke",17,13,5,4,0,0,0,0
Brisbane Lions,"Lyons, Jarryd",17,10,1,7,0,1,0,6
Brisbane Lions,"Martin, Stefan",16,11,3,5,0,0,24,1
Brisbane Lions,"Mathieson, Rhys",15,8,2,7,0,1,0,0
Brisbane Lions,"McCarthy, Lincoln",20,11,4,9,1,0,0,4
Brisbane Lions,"McCluggage, Hugh",17,8,1,9,2,0,0,1
Brisbane Lions,"McInerney, Oscar",10,2,4,8,1,0,15,2
Brisbane Lions,"McStay, Daniel",7,3,3,4,2,0,0,0
Brisbane Lions,"Neale, Lachie",43,15,4,28,1,0,0,3
Brisbane Lions,"Rayner, Cam",5,3,1,2,2,0,0,3
Brisbane Lions,"Rich, Daniel",25,20,9,5,0,1,0,0
Brisbane Lions,"Robinson, Mitch",29,17,6,12,0,0,0,5
Brisbane Lions,"Walker, Josh",23,19,16,4,0,0,0,1
Brisbane Lions,"Witherden, Alex",27,20,9,7,0,0,0,2
Brisbane Lions,"Zorko, Dayne",25,17,3,8,0,2,0,6
Brisbane Lions,"Andrews, Harris",22,14,8,8,0,0,0,1
Brisbane Lions,"Berry, Jarrod",26,14,8,12,1,2,0,1
Brisbane Lions,"Cameron, Charlie",14,14,3,0,0,3,0,2
Brisbane Lions,"Christensen, Allen",22,9,5,13,0,0,0,1
Brisbane Lions,"Gardiner, Darcy",13,10,4,3,0,0,0,1
Brisbane Lions,"Hipwood, Eric",7,4,2,3,1,0,0,2
Brisbane Lions,"Hodge, Luke",16,12,6,4,0,0,0,2
Brisbane Lions,"Lyons, Jarryd",18,6,2,12,0,0,0,4
Brisbane Lions,"Martin, Stefan",14,8,3,6,0,0,29,2
Brisbane Lions,"Mathieson, Rhys",14,7,0,7,1,1,0,1
Brisbane Lions,"McCarthy, Lincoln",12,6,3,6,1,0,0,1
Brisbane Lions,"McCluggage, Hugh",20,11,5,9,2,0,0,2
Brisbane Lions,"McInerney, Oscar",7,1,3,6,1,0,14,2
Brisbane Lions,"McStay, Daniel",10,4,7,6,2,1,0,2
Brisbane Lions,"Neale, Lachie",40,12,7,28,0,0,0,6
Brisbane Lions,"Rayner, Cam",7,5,4,2,0,1,0,0
Brisbane Lions,"Rich, Daniel",24,16,3,8,0,0,0,1
Brisbane Lions,"Robertson, Nick",9,3,4,6,0,0,0,5
Brisbane Lions,"Robinson, Mitch",18,12,6,6,0,0,0,2
Brisbane Lions,"Walker, Josh",14,10,7,4,0,0,0,1
Brisbane Lions,"Witherden, Alex",28,20,5,8,0,0,0,1
Brisbane Lions,"Zorko, Dayne",22,18,6,4,0,0,0,4
Brisbane Lions,"Andrews, Harris",11,7,5,4,0,0,0,0
Brisbane Lions,"Berry, Jarrod",24,11,4,13,1,0,0,1
Brisbane Lions,"Cameron, Charlie",14,8,4,6,0,1,0,2
Brisbane Lions,"Christensen, Allen",15,11,6,4,1,0,0,2
Brisbane Lions,"Gardiner, Darcy",15,11,7,4,0,0,0,2
Brisbane Lions,"Hipwood, Eric",9,9,5,0,1,2,0,3
Brisbane Lions,"Hodge, Luke",18,11,9,7,0,0,0,5
Brisbane Lions,"Lyons, Jarryd",13,5,0,8,0,1,0,2
Brisbane Lions,"Martin, Stefan",13,7,2,6,1,0,13,1
Brisbane Lions,"Mathieson, Rhys",11,5,2,6,0,0,0,1
Brisbane Lions,"McCarthy, Lincoln",12,7,2,5,0,0,0,1
Brisbane Lions,"McCluggage, Hugh",21,18,6,3,2,1,0,1
Brisbane Lions,"McInerney, Oscar",5,2,3,3,0,0,5,2
Brisbane Lions,"McStay, Daniel",6,4,3,2,0,1,0,1
Brisbane Lions,"Neale, Lachie",24,8,4,16,0,1,0,2
Brisbane Lions,"Rayner, Cam",12,7,3,5,2,1,0,2
Brisbane Lions,"Rich, Daniel",24,19,9,5,0,0,0,1
Brisbane Lions,"Robertson, Nick",18,10,6,8,0,0,0,2
Brisbane Lions,"Robinson, Mitch",18,9,5,9,0,0,0,5
Brisbane Lions,"Walker, Josh",17,12,12,5,0,0,0,2
Brisbane Lions,"Witherden, Alex",25,20,8,5,0,0,0,2
Brisbane Lions,"Zorko, Dayne",17,11,3,6,0,1,0,10
Brisbane Lions,"Answerth, Noah",12,10,7,2,0,0,0,5
Brisbane Lions,"Berry, Jarrod",18,12,2,6,0,2,0,8
Brisbane Lions,"Cameron, Charlie",21,14,7,7,2,2,0,3
Brisbane Lions,"Cutler, Tom",21,10,6,11,0,1,0,1
Brisbane Lions,"Gardiner, Darcy",13,9,2,4,0,0,0,2
Brisbane Lions,"Hipwood, Eric",10,9,3,1,1,1,0,0
Brisbane Lions,"Hodge, Luke",12,11,4,1,0,0,0,2
Brisbane Lions,"Lester, Ryan",14,10,5,4,0,0,0,2
Brisbane Lions,"Lyons, Jarryd",27,13,3,14,2,0,0,5
Brisbane Lions,"Martin, Stefan",19,13,2,6,0,0,26,3
Brisbane Lions,"McCarthy, Lincoln",9,5,1,4,2,0,0,2
Brisbane Lions,"McCluggage, Hugh",25,15,5,10,0,2,0,2
Brisbane Lions,"McInerney, Oscar",8,1,1,7,0,0,17,1
Brisbane Lions,"McStay, Daniel",10,6,5,4,0,1,0,2
Brisbane Lions,"Neale, Lachie",28,11,4,17,1,1,0,6
Brisbane Lions,"Rayner, Cam",10,7,0,3,3,1,0,1
Brisbane Lions,"Rich, Daniel",25,23,8,2,0,0,0,3
Brisbane Lions,"Robinson, Mitch",26,16,8,10,3,1,0,5
Brisbane Lions,"Taylor, Lewis",18,11,3,7,1,2,0,3
Brisbane Lions,"Walker, Josh",10,9,7,1,0,0,0,3
Brisbane Lions,"Witherden, Alex",16,13,4,3,1,0,0,2
Brisbane Lions,"Zorko, Dayne",15,10,2,5,0,0,0,8
Brisbane Lions,"Answerth, Noah",14,6,1,8,0,0,0,5
Brisbane Lions,"Berry, Jarrod",25,12,3,13,1,1,0,2
Brisbane Lions,"Cameron, Charlie",16,9,1,7,2,2,0,3
Brisbane Lions,"Cutler, Tom",23,13,4,10,1,1,0,3
Brisbane Lions,"Gardiner, Darcy",13,8,4,5,0,0,0,3
Brisbane Lions,"Hipwood, Eric",8,5,1,3,2,2,0,2
Brisbane Lions,"Hodge, Luke",16,10,2,6,0,0,0,1
Brisbane Lions,"Lester, Ryan",12,9,2,3,0,0,0,1
Brisbane Lions,"Lyons, Jarryd",23,15,3,8,0,0,0,4
Brisbane Lions,"Martin, Stefan",21,13,6,8,0,2,33,4
Brisbane Lions,"McCarthy, Lincoln",14,9,1,5,0,0,0,2
Brisbane Lions,"McCluggage, Hugh",24,17,4,7,2,0,0,6
Brisbane Lions,"McInerney, Oscar",10,5,3,5,0,0,27,7
Brisbane Lions,"McStay, Daniel",11,7,3,4,2,0,4,0
Brisbane Lions,"Neale, Lachie",29,12,2,17,0,1,0,3
Brisbane Lions,"Rayner, Cam",8,4,1,4,1,1,0,0
Brisbane Lions,"Rich, Daniel",21,18,7,3,1,1,0,3
Brisbane Lions,"Robinson, Mitch",22,14,1,8,1,2,0,9
Brisbane Lions,"Taylor, Lewis",7,5,0,2,0,0,0,5
Brisbane Lions,"Walker, Josh",7,4,4,3,0,0,0,0
Brisbane Lions,"Witherden, Alex",15,12,5,3,0,0,0,2
Brisbane Lions,"Zorko, Dayne",29,22,3,7,1,0,0,11
Brisbane Lions,"Andrews, Harris",10,7,4,3,0,0,0,2
Brisbane Lions,"Answerth, Noah",12,9,1,3,0,0,0,2
Brisbane Lions,"Bailey, Zac",1,0,0,1,0,0,0,0
Brisbane Lions,"Berry, Jarrod",8,5,2,3,1,0,0,7
Brisbane Lions,"Cameron, Charlie",8,4,3,4,0,0,0,3
Brisbane Lions,"Cutler, Tom",21,17,5,4,0,0,0,2
Brisbane Lions,"Gardiner, Darcy",15,10,3,5,0,0,0,2
Brisbane Lions,"Hipwood, Eric",13,9,4,4,2,5,0,4
Brisbane Lions,"Hodge, Luke",14,10,3,4,0,0,0,1
Brisbane Lions,"Lester, Ryan",13,13,3,0,0,0,0,6
Brisbane Lions,"Lyons, Jarryd",25,10,2,15,0,0,0,5
Brisbane Lions,"Martin, Stefan",15,8,1,7,0,0,39,2
Brisbane Lions,"McCarthy, Lincoln",14,8,5,6,0,0,0,5
Brisbane Lions,"McCluggage, Hugh",26,11,2,15,1,0,0,7
Brisbane Lions,"McInerney, Oscar",8,2,0,6,0,0,17,2
Brisbane Lions,"McStay, Daniel",16,8,4,8,1,1,1,4
Brisbane Lions,"Neale, Lachie",30,14,3,16,1,0,0,2
Brisbane Lions,"Rayner, Cam",8,3,0,5,0,0,0,4
Brisbane Lions,"Rich, Daniel",21,16,3,5,0,0,0,2
Brisbane Lions,"Robinson, Mitch",16,14,5,2,3,0,0,11
Brisbane Lions,"Witherden, Alex",22,18,8,4,0,1,0,1
Brisbane Lions,"Zorko, Dayne",28,20,7,8,2,0,0,7
Brisbane Lions,"Andrews, Harris",15,10,8,5,0,0,0,3
Brisbane Lions,"Answerth, Noah",9,4,1,5,0,0,0,1
Brisbane Lions,"Berry, Jarrod",20,9,2,11,0,0,0,5
Brisbane Lions,"Cameron, Charlie",16,12,5,4,3,5,0,3
Brisbane Lions,"Gardiner, Darcy",15,10,1,5,0,0,0,3
Brisbane Lions,"Hinge, Mitch",14,4,3,10,0,0,0,0
Brisbane Lions,"Hipwood, Eric",11,10,6,1,2,3,0,2
Brisbane Lions,"Lester, Ryan",12,5,1,7,0,0,0,1
Brisbane Lions,"Lyons, Jarryd",21,12,1,9,1,1,0,11
Brisbane Lions,"Martin, Stefan",15,7,1,8,1,0,23,5
Brisbane Lions,"Mathieson, Rhys",17,7,2,10,0,1,0,5
Brisbane Lions,"McCarthy, Lincoln",6,3,0,3,1,0,0,5
Brisbane Lions,"McCluggage, Hugh",26,17,4,9,0,1,0,4
Brisbane Lions,"McInerney, Oscar",7,3,0,4,0,0,25,2
Brisbane Lions,"McStay, Daniel",14,7,6,7,3,1,0,5
Brisbane Lions,"Neale, Lachie",39,11,2,28,0,0,0,6
Brisbane Lions,"Rayner, Cam",3,2,0,1,0,0,0,2
Brisbane Lions,"Rich, Daniel",22,15,7,7,0,0,0,1
Brisbane Lions,"Robinson, Mitch",23,16,6,7,1,0,0,3
Brisbane Lions,"Walker, Josh",6,4,1,2,0,0,0,1
Brisbane Lions,"Witherden, Alex",24,20,6,4,0,0,0,2
Brisbane Lions,"Zorko, Dayne",20,16,3,4,1,1,0,12
Brisbane Lions,"Andrews, Harris",15,10,10,5,0,0,0,1
Brisbane Lions,"Answerth, Noah",13,10,7,3,0,0,0,2
Brisbane Lions,"Cameron, Charlie",12,8,4,4,3,2,0,3
Brisbane Lions,"Gardiner, Darcy",12,10,5,2,0,0,0,4
Brisbane Lions,"Hinge, Mitch",14,12,3,2,1,0,0,3
Brisbane Lions,"Hipwood, Eric",7,6,1,1,0,2,0,1
Brisbane Lions,"Hodge, Luke",12,11,3,1,0,0,0,1
Brisbane Lions,"Lester, Ryan",12,11,6,1,0,0,0,6
Brisbane Lions,"Lyons, Jarryd",18,10,1,8,0,0,0,7
Brisbane Lions,"Martin, Stefan",12,7,2,5,0,0,21,1
Brisbane Lions,"McCarthy, Lincoln",10,8,2,2,0,0,0,5
Brisbane Lions,"McCluggage, Hugh",26,17,3,9,1,0,0,2
Brisbane Lions,"McInerney, Oscar",6,2,3,4,1,0,16,0
Brisbane Lions,"McStay, Daniel",10,6,5,4,2,1,0,2
Brisbane Lions,"Neale, Lachie",26,7,5,19,0,0,0,2
Brisbane Lions,"Rayner, Cam",15,8,3,7,0,0,0,1
Brisbane Lions,"Rich, Daniel",22,18,9,4,0,0,0,2
Brisbane Lions,"Robinson, Mitch",16,9,4,7,0,1,0,7
Brisbane Lions,"Taylor, Lewis",14,7,4,7,1,1,0,0
Brisbane Lions,"Walker, Josh",15,9,7,6,0,0,0,2
Brisbane Lions,"Witherden, Alex",15,12,5,3,0,0,0,1
Brisbane Lions,"Zorko, Dayne",21,18,6,3,1,1,0,4
Brisbane Lions,"Andrews, Harris",20,9,9,11,0,0,0,2
Brisbane Lions,"Answerth, Noah",14,8,3,6,0,0,0,0
Brisbane Lions,"Cameron, Charlie",6,4,1,2,2,0,0,1
Brisbane Lions,"Gardiner, Darcy",21,15,7,6,0,0,0,0
Brisbane Lions,"Hipwood, Eric",12,7,1,5,2,2,0,1
Brisbane Lions,"Hodge, Luke",20,15,9,5,0,0,0,2
Brisbane Lions,"Keays, Ben",12,5,2,7,0,1,0,4
Brisbane Lions,"Lyons, Jarryd",33,23,8,10,0,1,0,4
Brisbane Lions,"Martin, Stefan",11,4,2,7,1,1,25,1
Brisbane Lions,"Mathieson, Rhys",12,7,3,5,2,0,0,2
Brisbane Lions,"McCarthy, Lincoln",9,6,1,3,0,1,0,6
Brisbane Lions,"McCluggage, Hugh",23,15,7,8,0,0,0,1
Brisbane Lions,"McStay, Daniel",9,5,5,4,0,2,0,2
Brisbane Lions,"Neale, Lachie",30,14,8,16,0,0,0,1
Brisbane Lions,"Rayner, Cam",7,6,4,1,2,1,0,3
Brisbane Lions,"Rich, Daniel",20,17,7,3,0,0,0,0
Brisbane Lions,"Robertson, Nick",14,9,5,5,0,0,0,1
Brisbane Lions,"Robinson, Mitch",22,15,4,7,1,0,0,4
Brisbane Lions,"Smith, Archie",11,1,2,10,0,0,23,3
Brisbane Lions,"Taylor, Lewis",28,20,7,8,1,2,0,1
Brisbane Lions,"Witherden, Alex",15,9,5,6,0,0,0,0
Brisbane Lions,"Zorko, Dayne",18,10,2,8,1,1,0,6
Brisbane Lions,"Allison, Jacob",11,10,3,1,1,0,0,1
Brisbane Lions,"Andrews, Harris",9,6,5,3,0,0,0,1
Brisbane Lions,"Answerth, Noah",12,9,6,3,0,0,0,1
Brisbane Lions,"Cameron, Charlie",10,10,5,0,1,1,0,2
Brisbane Lions,"Gardiner, Darcy",12,9,4,3,0,0,0,1
Brisbane Lions,"Hipwood, Eric",5,5,1,0,1,1,0,4
Brisbane Lions,"Hodge, Luke",16,11,5,5,0,0,0,1
Brisbane Lions,"Lyons, Jarryd",15,12,2,3,0,1,0,6
Brisbane Lions,"Martin, Stefan",11,9,2,2,0,1,19,1
Brisbane Lions,"Mathieson, Rhys",12,6,3,6,0,0,0,9
Brisbane Lions,"McCarthy, Lincoln",7,3,1,4,1,0,0,2
Brisbane Lions,"McCluggage, Hugh",20,12,6,8,1,0,0,7
Brisbane Lions,"McStay, Daniel",11,6,4,5,2,1,0,0
Brisbane Lions,"Neale, Lachie",31,15,9,16,1,0,0,0
Brisbane Lions,"Rayner, Cam",7,5,3,2,0,1,0,1
Brisbane Lions,"Rich, Daniel",22,16,6,6,0,0,0,1
Brisbane Lions,"Robertson, Nick",13,7,3,6,0,0,0,3
Brisbane Lions,"Robinson, Mitch",16,12,7,4,0,0,0,4
Brisbane Lions,"Smith, Archie",8,3,0,5,0,0,14,2
Brisbane Lions,"Taylor, Lewis",15,9,7,6,0,0,0,3
Brisbane Lions,"Witherden, Alex",18,13,5,5,0,0,0,3
Brisbane Lions,"Zorko, Dayne",14,10,2,4,1,0,0,8
Brisbane Lions,"Allison, Jacob",13,8,3,5,0,0,0,0
Brisbane Lions,"Andrews, Harris",12,7,6,5,0,0,0,1
Brisbane Lions,"Answerth, Noah",8,7,4,1,0,0,0,0
Brisbane Lions,"Cameron, Charlie",13,13,2,0,5,1,0,1
Brisbane Lions,"Christensen, Allen",18,11,6,7,2,1,0,6
Brisbane Lions,"Gardiner, Darcy",14,10,9,4,0,0,0,0
Brisbane Lions,"Hipwood, Eric",15,11,8,4,1,1,1,1
Brisbane Lions,"Hodge, Luke",18,11,5,7,0,0,0,2
Brisbane Lions,"Lester, Ryan",10,8,5,2,0,0,0,6
Brisbane Lions,"Lyons, Jarryd",24,16,5,8,2,0,0,4
Brisbane Lions,"Martin, Stefan",22,17,8,5,0,0,25,2
Brisbane Lions,"Mathieson, Rhys",13,5,1,8,0,0,0,4
Brisbane Lions,"McCarthy, Lincoln",21,13,9,8,1,2,0,2
Brisbane Lions,"McCluggage, Hugh",22,12,3,10,2,1,0,3
Brisbane Lions,"McInerney, Oscar",11,10,8,1,0,2,15,4
Brisbane Lions,"McStay, Daniel",12,7,4,5,1,2,1,4
Brisbane Lions,"Neale, Lachie",25,12,3,13,0,1,0,2
Brisbane Lions,"Rayner, Cam",13,5,2,8,0,0,0,3
Brisbane Lions,"Rich, Daniel",24,22,11,2,1,0,0,2
Brisbane Lions,"Robinson, Mitch",22,15,7,7,1,0,0,2
Brisbane Lions,"Witherden, Alex",21,19,6,2,0,0,0,3
Brisbane Lions,"Zorko, Dayne",28,24,6,4,1,0,0,4
Brisbane Lions,"Andrews, Harris",13,8,5,5,0,0,0,1
Brisbane Lions,"Answerth, Noah",13,10,3,3,1,0,0,3
Brisbane Lions,"Bailey, Zac",15,5,2,10,1,0,0,0
Brisbane Lions,"Berry, Jarrod",11,5,3,6,0,0,0,4
Brisbane Lions,"Cameron, Charlie",12,7,3,5,1,0,0,0
Brisbane Lions,"Christensen, Allen",14,7,3,7,1,2,0,1
Brisbane Lions,"Gardiner, Darcy",16,11,3,5,0,0,0,1
Brisbane Lions,"Hipwood, Eric",13,11,9,2,5,0,0,2
Brisbane Lions,"Hodge, Luke",18,15,5,3,0,0,0,2
Brisbane Lions,"Lester, Ryan",13,12,5,1,0,0,0,1
Brisbane Lions,"Lyons, Jarryd",33,18,5,15,1,1,0,7
Brisbane Lions,"Martin, Stefan",21,10,4,11,0,0,34,5
Brisbane Lions,"McCarthy, Lincoln",14,7,5,7,1,1,0,7
Brisbane Lions,"McCluggage, Hugh",23,14,2,9,0,1,0,6
Brisbane Lions,"McInerney, Oscar",4,4,1,0,0,0,3,1
Brisbane Lions,"McStay, Daniel",7,1,1,6,0,1,0,0
Brisbane Lions,"Neale, Lachie",38,14,3,24,0,0,0,5
Brisbane Lions,"Rayner, Cam",16,12,1,4,0,3,0,1
Brisbane Lions,"Rich, Daniel",25,17,6,8,0,0,0,1
Brisbane Lions,"Robinson, Mitch",21,16,5,5,1,0,0,1
Brisbane Lions,"Starcevich, Brandon",7,7,2,0,0,0,0,1
Brisbane Lions,"Zorko, Dayne",31,23,7,8,3,2,0,5
Brisbane Lions,"Adams, Marcus",6,5,5,1,0,0,0,2
Brisbane Lions,"Andrews, Harris",11,10,7,1,0,0,0,1
Brisbane Lions,"Answerth, Noah",15,10,6,5,0,0,0,5
Brisbane Lions,"Bailey, Zac",10,5,4,5,1,0,0,2
Brisbane Lions,"Berry, Jarrod",20,12,5,8,1,0,0,2
Brisbane Lions,"Cameron, Charlie",16,11,2,5,2,0,0,3
Brisbane Lions,"Christensen, Allen",7,5,1,2,1,0,0,4
Brisbane Lions,"Gardiner, Darcy",11,10,3,1,0,0,0,3
Brisbane Lions,"Hipwood, Eric",8,7,5,1,1,0,0,3
Brisbane Lions,"Hodge, Luke",17,15,10,2,0,1,0,1
Brisbane Lions,"Lester, Ryan",11,4,2,7,0,0,0,5
Brisbane Lions,"Lyons, Jarryd",21,18,2,3,1,1,0,5
Brisbane Lions,"Martin, Stefan",16,4,0,12,0,0,52,6
Brisbane Lions,"McCarthy, Lincoln",22,14,6,8,3,1,0,3
Brisbane Lions,"McCluggage, Hugh",26,15,3,11,1,1,0,8
Brisbane Lions,"McStay, Daniel",9,4,5,5,1,0,5,4
Brisbane Lions,"Neale, Lachie",31,20,6,11,1,1,0,6
Brisbane Lions,"Rayner, Cam",8,5,3,3,1,1,0,3
Brisbane Lions,"Rich, Daniel",19,16,3,3,0,0,0,1
Brisbane Lions,"Robinson, Mitch",22,17,5,5,0,0,0,4
Brisbane Lions,"Witherden, Alex",15,13,5,2,0,0,0,1
Brisbane Lions,"Zorko, Dayne",26,19,6,7,0,2,0,8
Brisbane Lions,"Adams, Marcus",4,4,0,0,0,0,0,2
Brisbane Lions,"Andrews, Harris",9,5,2,4,0,0,0,2
Brisbane Lions,"Answerth, Noah",6,4,1,2,0,0,0,5
Brisbane Lions,"Bailey, Zac",10,7,3,3,1,1,0,3
Brisbane Lions,"Berry, Jarrod",18,8,2,10,0,0,0,4
Brisbane Lions,"Cameron, Charlie",15,9,3,6,4,2,0,2
Brisbane Lions,"Christensen, Allen",10,6,1,4,0,1,0,0
Brisbane Lions,"Gardiner, Darcy",10,9,7,1,0,0,0,1
Brisbane Lions,"Keays, Ben",15,10,5,5,0,1,0,2
Brisbane Lions,"Lester, Ryan",11,9,3,2,0,0,0,2
Brisbane Lions,"Lyons, Jarryd",36,25,1,11,1,0,0,9
Brisbane Lions,"Martin, Stefan",16,8,0,8,0,0,36,2
Brisbane Lions,"McCarthy, Lincoln",20,10,1,10,2,1,0,8
Brisbane Lions,"McInerney, Oscar",12,7,3,5,0,1,16,3
Brisbane Lions,"McStay, Daniel",13,6,4,7,0,0,2,4
Brisbane Lions,"Neale, Lachie",24,11,0,13,0,0,0,7
Brisbane Lions,"Rayner, Cam",7,6,1,1,1,1,0,0
Brisbane Lions,"Rich, Daniel",23,22,3,1,0,0,0,2
Brisbane Lions,"Robinson, Mitch",21,18,5,3,1,0,0,7
Brisbane Lions,"Walker, Josh",8,3,0,5,0,0,2,1
Brisbane Lions,"Witherden, Alex",21,19,5,2,1,0,0,2
Brisbane Lions,"Zorko, Dayne",24,21,0,3,3,1,0,5
Brisbane Lions,"Adams, Marcus",14,12,4,2,0,0,0,2
Brisbane Lions,"Andrews, Harris",8,7,7,1,0,0,0,0
Brisbane Lions,"Answerth, Noah",12,10,2,2,0,0,0,4
Brisbane Lions,"Bailey, Zac",12,10,5,2,0,1,0,3
Brisbane Lions,"Berry, Jarrod",15,8,3,7,0,1,0,4
Brisbane Lions,"Cameron, Charlie",13,11,2,2,2,0,0,1
Brisbane Lions,"Christensen, Allen",11,8,0,3,3,1,0,5
Brisbane Lions,"Gardiner, Darcy",9,7,6,2,0,0,0,4
Brisbane Lions,"Hipwood, Eric",10,6,2,4,0,0,0,0
Brisbane Lions,"Hodge, Luke",17,13,10,4,0,0,0,1
Brisbane Lions,"Lyons, Jarryd",30,21,2,9,2,1,0,2
Brisbane Lions,"Martin, Stefan",14,7,1,7,0,0,27,3
Brisbane Lions,"McCarthy, Lincoln",16,9,2,7,0,1,0,2
Brisbane Lions,"McCluggage, Hugh",17,10,1,7,2,0,0,1
Brisbane Lions,"McInerney, Oscar",12,7,3,5,2,1,13,1
Brisbane Lions,"McStay, Daniel",12,5,4,7,0,2,0,3
Brisbane Lions,"Neale, Lachie",24,8,4,16,0,0,0,4
Brisbane Lions,"Rayner, Cam",6,2,1,4,0,2,0,2
Brisbane Lions,"Rich, Daniel",18,15,5,3,1,0,0,4
Brisbane Lions,"Robinson, Mitch",12,10,0,2,0,1,0,3
Brisbane Lions,"Witherden, Alex",14,14,4,0,0,1,0,1
Brisbane Lions,"Zorko, Dayne",22,18,3,4,0,1,0,7
Brisbane Lions,"Adams, Marcus",12,9,4,3,0,0,0,0
Brisbane Lions,"Answerth, Noah",15,11,4,4,1,0,0,7
Brisbane Lions,"Bailey, Zac",7,6,4,1,0,0,0,1
Brisbane Lions,"Berry, Jarrod",18,9,5,9,0,0,0,4
Brisbane Lions,"Cameron, Charlie",10,8,2,2,2,1,0,0
Brisbane Lions,"Christensen, Allen",13,9,5,4,2,1,0,5
Brisbane Lions,"Gardiner, Darcy",11,9,4,2,0,0,0,2
Brisbane Lions,"Hipwood, Eric",8,7,3,1,1,1,0,2
Brisbane Lions,"Hodge, Luke",14,14,7,0,0,0,0,3
Brisbane Lions,"Lyons, Jarryd",25,13,5,12,0,0,0,5
Brisbane Lions,"Martin, Stefan",17,11,0,6,0,0,12,1
Brisbane Lions,"McCarthy, Lincoln",14,7,5,7,0,0,0,6
Brisbane Lions,"McCluggage, Hugh",21,15,3,6,1,1,0,5
Brisbane Lions,"McInerney, Oscar",7,4,3,3,1,0,12,3
Brisbane Lions,"McStay, Daniel",14,5,5,9,0,0,0,3
Brisbane Lions,"Neale, Lachie",33,12,6,21,1,0,0,2
Brisbane Lions,"Rayner, Cam",13,10,2,3,2,1,0,3
Brisbane Lions,"Rich, Daniel",26,17,4,9,0,0,0,3
Brisbane Lions,"Robinson, Mitch",28,21,4,7,0,2,0,4
Brisbane Lions,"Walker, Josh",7,6,5,1,0,0,0,1
Brisbane Lions,"Witherden, Alex",1,1,0,0,0,0,0,0
Brisbane Lions,"Zorko, Dayne",25,20,5,5,2,0,0,6
Brisbane Lions,"Adams, Marcus",6,3,2,3,0,0,0,1
Brisbane Lions,"Andrews, Harris",12,8,3,4,0,0,0,1
Brisbane Lions,"Answerth, Noah",18,12,6,6,0,0,0,1
Brisbane Lions,"Bailey, Zac",10,4,0,6,0,0,0,2
Brisbane Lions,"Berry, Jarrod",25,16,6,9,0,0,0,2
Brisbane Lions,"Cameron, Charlie",13,13,7,0,4,0,0,3
Brisbane Lions,"Christensen, Allen",16,10,5,6,2,1,0,5
Brisbane Lions,"Gardiner, Darcy",14,13,5,1,0,0,0,3
Brisbane Lions,"Hipwood, Eric",15,12,10,3,2,1,0,1
Brisbane Lions,"Hodge, Luke",14,12,5,2,0,0,0,1
Brisbane Lions,"Lyons, Jarryd",16,11,2,5,0,0,0,12
Brisbane Lions,"Martin, Stefan",21,11,5,10,0,1,32,1
Brisbane Lions,"McCarthy, Lincoln",9,5,3,4,0,2,0,4
Brisbane Lions,"McCluggage, Hugh",16,9,4,7,1,0,0,2
Brisbane Lions,"McInerney, Oscar",9,4,4,5,1,0,19,6
Brisbane Lions,"McStay, Daniel",11,4,4,7,0,1,0,1
Brisbane Lions,"Neale, Lachie",20,12,1,8,1,0,0,8
Brisbane Lions,"Rayner, Cam",8,6,4,2,1,2,0,4
Brisbane Lions,"Rich, Daniel",17,17,3,0,0,0,0,2
Brisbane Lions,"Robinson, Mitch",24,18,8,6,2,1,0,6
Brisbane Lions,"Witherden, Alex",16,10,6,6,0,0,0,3
Brisbane Lions,"Zorko, Dayne",11,10,3,1,0,0,0,3
Brisbane Lions,"Adams, Marcus",14,9,12,5,0,0,0,0
Brisbane Lions,"Andrews, Harris",15,12,10,3,0,0,0,0
Brisbane Lions,"Answerth, Noah",10,9,2,1,0,0,0,5
Brisbane Lions,"Bailey, Zac",18,10,3,8,2,0,0,3
Brisbane Lions,"Berry, Jarrod",26,15,8,11,1,0,0,7
Brisbane Lions,"Cameron, Charlie",10,9,4,1,6,1,0,2
Brisbane Lions,"Christensen, Allen",18,10,5,8,1,2,0,7
Brisbane Lions,"Gardiner, Darcy",12,8,5,4,1,0,0,6
Brisbane Lions,"Hipwood, Eric",11,8,7,3,2,1,0,2
Brisbane Lions,"Hodge, Luke",10,8,4,2,0,0,0,3
Brisbane Lions,"Lyons, Jarryd",34,26,8,8,2,1,0,7
Brisbane Lions,"Martin, Stefan",16,9,3,7,1,1,22,4
Brisbane Lions,"McCarthy, Lincoln",20,9,3,11,0,2,0,3
Brisbane Lions,"McCluggage, Hugh",23,12,4,11,0,1,0,1
Brisbane Lions,"McInerney, Oscar",6,1,1,5,0,0,25,5
Brisbane Lions,"McStay, Daniel",8,3,4,5,2,0,0,2
Brisbane Lions,"Neale, Lachie",21,6,1,15,1,0,0,4
Brisbane Lions,"Rayner, Cam",13,5,4,8,0,0,0,2
Brisbane Lions,"Rich, Daniel",22,18,5,4,0,1,0,6
Brisbane Lions,"Robinson, Mitch",28,19,5,9,1,0,0,1
Brisbane Lions,"Witherden, Alex",21,18,10,3,0,1,0,5
Brisbane Lions,"Zorko, Dayne",25,17,8,8,2,0,0,7
Brisbane Lions,"Adams, Marcus",19,12,10,7,0,0,0,2
Brisbane Lions,"Andrews, Harris",13,6,5,7,0,0,0,5
Brisbane Lions,"Answerth, Noah",17,12,7,5,0,0,0,3
Brisbane Lions,"Bailey, Zac",13,9,3,4,0,2,0,6
Brisbane Lions,"Berry, Jarrod",13,6,5,7,0,0,0,6
Brisbane Lions,"Cameron, Charlie",17,12,4,5,5,2,0,2
Brisbane Lions,"Christensen, Allen",3,2,0,1,0,0,0,1
Brisbane Lions,"Gardiner, Darcy",18,13,5,5,0,0,0,4
Brisbane Lions,"Hipwood, Eric",10,8,4,2,0,1,0,3
Brisbane Lions,"Hodge, Luke",15,12,6,3,0,1,0,2
Brisbane Lions,"Lyons, Jarryd",28,15,4,13,1,1,0,11
Brisbane Lions,"Martin, Stefan",16,8,3,8,0,0,36,3
Brisbane Lions,"McCarthy, Lincoln",9,5,2,4,1,0,0,6
Brisbane Lions,"McCluggage, Hugh",27,21,7,6,1,1,0,6
Brisbane Lions,"McInerney, Oscar",7,2,2,5,0,0,17,2
Brisbane Lions,"McStay, Daniel",8,1,2,7,0,0,0,3
Brisbane Lions,"Neale, Lachie",29,13,4,16,1,0,0,3
Brisbane Lions,"Rayner, Cam",4,1,1,3,0,0,0,1
Brisbane Lions,"Rich, Daniel",25,19,3,6,0,0,0,2
Brisbane Lions,"Robinson, Mitch",25,16,10,9,0,0,0,4
Brisbane Lions,"Witherden, Alex",15,15,3,0,0,0,0,3
Brisbane Lions,"Zorko, Dayne",23,15,1,8,1,0,0,6
Brisbane Lions,"Adams, Marcus",13,8,7,5,0,0,0,1
Brisbane Lions,"Andrews, Harris",14,6,1,8,0,0,0,1
Brisbane Lions,"Answerth, Noah",9,5,3,4,0,0,0,1
Brisbane Lions,"Bailey, Zac",15,7,0,8,0,0,0,3
Brisbane Lions,"Berry, Jarrod",20,10,2,10,0,0,0,3
Brisbane Lions,"Cameron, Charlie",7,6,2,1,2,1,0,2
Brisbane Lions,"Cox, Cedric",9,6,4,3,0,0,0,2
Brisbane Lions,"Gardiner, Darcy",11,4,3,7,0,0,0,3
Brisbane Lions,"Hipwood, Eric",13,11,8,2,1,1,0,2
Brisbane Lions,"Hodge, Luke",24,14,5,10,0,0,0,2
Brisbane Lions,"Lyons, Jarryd",19,9,3,10,0,0,0,8
Brisbane Lions,"Martin, Stefan",18,11,4,7,0,0,27,3
Brisbane Lions,"McCarthy, Lincoln",6,2,0,4,0,0,0,4
Brisbane Lions,"McCluggage, Hugh",28,17,5,11,1,0,0,2
Brisbane Lions,"McInerney, Oscar",8,3,5,5,1,0,14,4
Brisbane Lions,"McStay, Daniel",9,6,5,3,0,0,0,1
Brisbane Lions,"Neale, Lachie",51,19,6,32,0,0,0,6
Brisbane Lions,"Rayner, Cam",11,6,5,5,0,1,0,8
Brisbane Lions,"Rich, Daniel",23,19,6,4,0,0,0,2
Brisbane Lions,"Robinson, Mitch",23,15,5,8,1,0,0,4
Brisbane Lions,"Witherden, Alex",17,13,4,4,0,0,0,1
Brisbane Lions,"Zorko, Dayne",27,21,5,6,2,0,0,9
Brisbane Lions,"Adams, Marcus",7,6,2,1,0,0,0,1
Brisbane Lions,"Andrews, Harris",8,4,2,4,0,0,0,4
Brisbane Lions,"Answerth, Noah",8,6,4,2,0,0,0,2
Brisbane Lions,"Bailey, Zac",13,7,1,6,0,0,0,1
Brisbane Lions,"Berry, Jarrod",21,15,8,6,0,2,0,3
Brisbane Lions,"Cameron, Charlie",7,5,2,2,1,2,0,0
Brisbane Lions,"Christensen, Allen",16,13,7,3,2,0,0,3
Brisbane Lions,"Gardiner, Darcy",18,14,6,4,0,0,0,0
Brisbane Lions,"Hipwood, Eric",7,4,4,3,0,0,0,2
Brisbane Lions,"Hodge, Luke",27,22,9,5,0,0,0,1
Brisbane Lions,"Lyons, Jarryd",24,11,2,13,0,0,0,5
Brisbane Lions,"Martin, Stefan",17,13,5,4,0,0,24,5
Brisbane Lions,"McCarthy, Lincoln",16,10,6,6,0,1,0,5
Brisbane Lions,"McCluggage, Hugh",23,11,5,12,1,1,0,2
Brisbane Lions,"McInerney, Oscar",7,3,1,4,0,1,15,4
Brisbane Lions,"McStay, Daniel",6,5,5,1,1,1,0,2
Brisbane Lions,"Neale, Lachie",37,17,5,20,2,0,0,1
Brisbane Lions,"Rayner, Cam",15,8,5,7,1,1,0,3
Brisbane Lions,"Rich, Daniel",17,10,3,7,0,0,0,1
Brisbane Lions,"Robinson, Mitch",22,19,7,3,0,3,0,2
Brisbane Lions,"Witherden, Alex",17,12,5,5,0,0,0,1
Brisbane Lions,"Zorko, Dayne",21,16,3,5,0,3,0,8
Brisbane Lions,"Adams, Marcus",10,6,5,4,0,0,0,1
Brisbane Lions,"Andrews, Harris",11,7,2,4,0,0,0,1
Brisbane Lions,"Answerth, Noah",7,4,2,3,0,0,0,3
Brisbane Lions,"Bailey, Zac",11,3,1,8,0,0,0,2
Brisbane Lions,"Berry, Jarrod",18,10,4,8,1,1,0,3
Brisbane Lions,"Cameron, Charlie",11,8,4,3,2,1,0,2
Brisbane Lions,"Christensen, Allen",12,8,4,4,1,0,0,4
Brisbane Lions,"Gardiner, Darcy",13,9,5,4,0,0,0,3
Brisbane Lions,"Hipwood, Eric",10,7,7,3,3,2,0,2
Brisbane Lions,"Hodge, Luke",22,14,5,8,0,0,0,1
Brisbane Lions,"Lyons, Jarryd",27,17,5,10,1,0,0,3
Brisbane Lions,"Martin, Stefan",23,16,0,7,0,1,24,0
Brisbane Lions,"McCarthy, Lincoln",12,7,2,5,0,1,0,5
Brisbane Lions,"McCluggage, Hugh",23,15,4,8,0,2,0,5
Brisbane Lions,"McInerney, Oscar",7,5,1,2,0,1,20,3
Brisbane Lions,"McStay, Daniel",9,6,5,3,1,0,0,2
Brisbane Lions,"Neale, Lachie",17,9,2,8,0,1,0,3
Brisbane Lions,"Rayner, Cam",8,6,2,2,1,1,0,1
Brisbane Lions,"Rich, Daniel",25,20,2,5,0,0,0,4
Brisbane Lions,"Robertson, Nick",13,12,3,1,0,0,0,4
Brisbane Lions,"Witherden, Alex",15,11,5,4,0,0,0,1
Brisbane Lions,"Zorko, Dayne",25,20,5,5,1,1,0,5
Carlton,"Cripps, Patrick",32,10,1,22,0,0,0,6
Carlton,"Cuningham, David",22,9,5,13,0,0,0,5
Carlton,"Curnow, Charlie",12,10,1,2,1,0,0,1
Carlton,"Curnow, Ed",25,13,12,12,0,1,0,3
Carlton,"Dow, Paddy",21,8,3,13,0,1,0,2
Carlton,"Fasolo, Alex",5,4,2,1,1,0,0,1
Carlton,"Fisher, Zac",22,14,2,8,1,1,0,6
Carlton,"Garlett, Jarrod",9,8,3,1,0,0,0,4
Carlton,"Gibbons, Michael",11,5,2,6,0,1,0,3
Carlton,"Jones, Liam",8,4,3,4,0,0,0,5
Carlton,"McGovern, Mitch",11,8,5,3,1,1,0,0
Carlton,"McKay, Harry",11,7,6,4,2,1,3,4
Carlton,"Murphy, Marc",29,16,4,13,1,0,0,1
Carlton,"Newman, Nic",26,21,9,5,1,0,0,2
Carlton,"Petrevski-Seton, Sam",18,12,8,6,0,0,0,2
Carlton,"Phillips, Andrew",9,5,3,4,0,0,27,8
Carlton,"Plowman, Lachie",13,11,6,2,0,0,0,3
Carlton,"Setterfield, Will",24,14,2,10,0,1,0,1
Carlton,"Simpson, Kade",25,14,6,11,0,0,0,1
Carlton,"Thomas, Dale",27,15,3,12,1,0,0,2
Carlton,"Walsh, Sam",24,16,6,8,0,1,0,1
Carlton,"Weitering, Jacob",17,13,7,4,0,0,0,2
Carlton,"Cripps, Patrick",31,16,2,15,0,0,0,7
Carlton,"Curnow, Charlie",3,2,1,1,0,1,0,0
Carlton,"Curnow, Ed",11,7,4,4,1,0,0,2
Carlton,"Dow, Paddy",23,14,3,9,1,0,0,3
Carlton,"Fasolo, Alex",9,5,2,4,1,0,0,5
Carlton,"Fisher, Zac",18,8,2,10,0,0,0,3
Carlton,"Garlett, Jarrod",13,7,2,6,0,0,0,3
Carlton,"Gibbons, Michael",16,11,2,5,0,1,0,6
Carlton,"Jones, Liam",9,9,3,0,0,0,0,2
Carlton,"McGovern, Mitch",9,8,5,1,2,0,0,2
Carlton,"McKay, Harry",11,8,5,3,2,0,3,2
Carlton,"Murphy, Marc",26,14,3,12,0,1,0,1
Carlton,"Newman, Nic",20,15,2,5,0,0,0,2
Carlton,"Petrevski-Seton, Sam",21,13,6,8,1,0,0,2
Carlton,"Phillips, Andrew",15,8,2,7,0,0,27,4
Carlton,"Plowman, Lachie",16,10,0,6,0,0,0,3
Carlton,"Polson, Cameron",13,9,0,4,1,1,0,2
Carlton,"Setterfield, Will",12,5,2,7,1,0,0,4
Carlton,"Simpson, Kade",19,12,2,7,1,0,0,1
Carlton,"Thomas, Dale",16,12,3,4,0,0,0,5
Carlton,"Walsh, Sam",25,16,4,9,0,0,0,1
Carlton,"Weitering, Jacob",11,10,6,1,0,0,0,1
Carlton,"Casboult, Levi",12,11,6,1,0,1,5,0
Carlton,"Cripps, Patrick",28,16,5,12,1,1,0,8
Carlton,"Curnow, Ed",19,12,4,7,4,0,0,2
Carlton,"Dow, Paddy",14,11,2,3,0,1,0,1
Carlton,"Fisher, Zac",19,10,3,9,1,1,0,3
Carlton,"Gibbons, Michael",4,3,3,1,0,0,0,1
Carlton,"Jones, Liam",7,4,1,3,0,0,0,3
Carlton,"Lobbe, Matthew",6,4,2,2,0,0,32,3
Carlton,"Marchbank, Caleb",9,7,5,2,0,0,0,1
Carlton,"McGovern, Mitch",5,4,3,1,1,1,0,0
Carlton,"McKay, Harry",10,10,6,0,1,3,1,0
Carlton,"Murphy, Marc",22,12,4,10,1,0,0,5
Carlton,"Newman, Nic",20,15,5,5,0,0,0,3
Carlton,"OBrien, Lochie",11,8,1,3,0,0,0,1
Carlton,"Petrevski-Seton, Sam",18,10,4,8,0,0,0,5
Carlton,"Plowman, Lachie",15,9,1,6,0,0,0,3
Carlton,"Polson, Cameron",4,2,0,2,0,0,0,1
Carlton,"Setterfield, Will",13,9,0,4,0,2,0,4
Carlton,"Simpson, Kade",12,8,2,4,0,0,0,2
Carlton,"Thomas, Dale",16,12,5,4,0,0,0,1
Carlton,"Walsh, Sam",28,16,5,12,1,1,0,3
Carlton,"Weitering, Jacob",11,7,3,4,0,0,0,2
Carlton,"Casboult, Levi",7,6,4,1,0,0,10,0
Carlton,"Cripps, Patrick",30,15,8,15,2,0,0,12
Carlton,"Curnow, Charlie",17,15,9,2,1,0,0,4
Carlton,"Curnow, Ed",19,12,5,7,0,1,0,5
Carlton,"Dow, Paddy",20,7,3,13,0,1,0,3
Carlton,"Fisher, Zac",20,11,3,9,1,1,0,4
Carlton,"Gibbons, Michael",16,12,3,4,0,3,0,1
Carlton,"Jones, Liam",11,11,5,0,0,0,0,6
Carlton,"Lobbe, Matthew",8,4,0,4,0,0,23,6
Carlton,"Marchbank, Caleb",13,10,6,3,0,0,0,3
Carlton,"McGovern, Mitch",6,4,4,2,3,0,0,0
Carlton,"McKay, Harry",8,5,5,3,0,1,0,0
Carlton,"Murphy, Marc",29,24,15,5,0,0,0,2
Carlton,"Newman, Nic",19,15,9,4,0,0,0,2
Carlton,"OBrien, Lochie",10,10,6,0,0,0,0,3
Carlton,"Petrevski-Seton, Sam",18,6,2,12,0,0,0,7
Carlton,"Plowman, Lachie",14,13,9,1,0,0,0,4
Carlton,"Setterfield, Will",16,14,8,2,0,1,0,2
Carlton,"Simpson, Kade",22,15,8,7,0,0,0,4
Carlton,"Thomas, Dale",20,16,10,4,0,0,0,3
Carlton,"Walsh, Sam",28,14,6,14,1,0,0,6
Carlton,"Weitering, Jacob",20,18,7,2,0,0,0,2
Carlton,"Casboult, Levi",11,7,5,4,3,0,8,1
Carlton,"Cripps, Patrick",37,5,5,32,0,0,0,2
Carlton,"Curnow, Ed",16,9,2,7,0,1,0,1
Carlton,"Dow, Paddy",17,12,2,5,1,1,0,3
Carlton,"Fisher, Zac",28,14,6,14,1,0,0,3
Carlton,"Gibbons, Michael",21,16,6,5,1,1,0,3
Carlton,"Jones, Liam",5,5,5,0,0,0,0,1
Carlton,"Kreuzer, Matthew",14,9,4,5,0,1,25,2
Carlton,"Marchbank, Caleb",12,6,3,6,0,0,0,2
Carlton,"McGovern, Mitch",9,7,4,2,1,1,0,0
Carlton,"McKay, Harry",20,15,11,5,4,3,3,2
Carlton,"Murphy, Marc",28,18,6,10,1,0,0,2
Carlton,"Newman, Nic",21,19,9,2,0,0,0,2
Carlton,"OBrien, Lochie",7,6,4,1,0,0,0,1
Carlton,"Petrevski-Seton, Sam",35,14,7,21,1,1,0,0
Carlton,"Plowman, Lachie",22,14,8,8,0,0,0,1
Carlton,"Polson, Cameron",4,0,0,4,0,0,0,2
Carlton,"Silvagni, Jack",18,11,9,7,1,1,0,3
Carlton,"Simpson, Kade",20,16,4,4,0,0,0,6
Carlton,"Thomas, Dale",14,10,5,4,0,0,0,1
Carlton,"Walsh, Sam",26,15,9,11,1,0,0,4
Carlton,"Weitering, Jacob",11,9,4,2,0,0,0,0
Carlton,"Casboult, Levi",7,6,4,1,1,0,10,2
Carlton,"Cripps, Patrick",28,11,1,17,0,0,0,9
Carlton,"Cuningham, David",16,7,0,9,1,0,0,4
Carlton,"Curnow, Ed",24,14,8,10,1,1,0,3
Carlton,"Dow, Paddy",16,7,0,9,1,0,0,4
Carlton,"Fisher, Zac",23,10,2,13,0,1,0,7
Carlton,"Gibbons, Michael",13,9,2,4,0,1,0,3
Carlton,"Jones, Liam",14,9,10,5,0,0,0,2
Carlton,"Kreuzer, Matthew",13,8,1,5,1,0,30,3
Carlton,"Marchbank, Caleb",13,8,3,5,0,0,0,1
Carlton,"McGovern, Mitch",8,4,4,4,2,1,0,3
Carlton,"McKay, Harry",11,7,6,4,2,2,2,1
Carlton,"Murphy, Marc",22,13,5,9,0,0,0,3
Carlton,"Newman, Nic",17,13,5,4,0,0,0,1
Carlton,"OBrien, Lochie",9,9,5,0,2,0,0,0
Carlton,"Petrevski-Seton, Sam",23,9,0,14,1,0,0,7
Carlton,"Plowman, Lachie",24,13,3,11,0,0,0,3
Carlton,"Silvagni, Jack",13,9,7,4,1,0,0,1
Carlton,"Simpson, Kade",11,10,3,1,0,0,0,1
Carlton,"Thomas, Dale",25,18,8,7,0,0,0,4
Carlton,"Walsh, Sam",27,12,2,15,0,1,0,1
Carlton,"Weitering, Jacob",18,13,8,5,0,0,0,1
Carlton,"Casboult, Levi",12,11,5,1,0,3,13,1
Carlton,"Cripps, Patrick",25,8,3,17,2,0,0,8
Carlton,"Cuningham, David",13,8,3,5,1,1,0,7
Carlton,"Curnow, Charlie",16,14,6,2,0,0,0,3
Carlton,"Curnow, Ed",12,5,3,7,1,1,0,0
Carlton,"Dow, Paddy",15,7,1,8,0,1,0,2
Carlton,"Fisher, Zac",26,18,3,8,0,1,0,1
Carlton,"Gibbons, Michael",13,8,5,5,1,0,0,3
Carlton,"Jones, Liam",7,5,5,2,0,0,0,1
Carlton,"Marchbank, Caleb",11,8,6,3,0,0,0,3
Carlton,"McKay, Harry",3,1,0,2,0,1,0,0
Carlton,"Murphy, Marc",20,10,3,10,0,0,0,1
Carlton,"OBrien, Lochie",11,7,4,4,1,0,0,1
Carlton,"Petrevski-Seton, Sam",16,9,1,7,0,1,0,4
Carlton,"Phillips, Andrew",13,9,7,4,0,2,28,1
Carlton,"Plowman, Lachie",12,10,1,2,0,0,0,4
Carlton,"Silvagni, Jack",9,7,2,2,2,0,0,8
Carlton,"Stocker, Liam",10,6,3,4,0,0,0,1
Carlton,"Thomas, Dale",24,17,7,7,0,0,0,2
Carlton,"Walsh, Sam",22,9,4,13,0,2,0,3
Carlton,"Weitering, Jacob",18,12,7,6,0,0,0,1
Carlton,"Williamson, Tom",10,3,2,7,0,0,0,1
Carlton,"Casboult, Levi",13,7,7,6,0,0,4,1
Carlton,"Cripps, Patrick",35,11,4,24,1,2,0,7
Carlton,"Cuningham, David",23,6,4,17,2,0,0,4
Carlton,"Curnow, Charlie",12,10,4,2,2,0,0,1
Carlton,"Curnow, Ed",26,13,6,13,0,1,0,3
Carlton,"Dow, Paddy",20,10,4,10,0,2,0,2
Carlton,"Fisher, Zac",21,8,1,13,0,0,0,0
Carlton,"Gibbons, Michael",14,6,1,8,1,0,0,8
Carlton,"Kreuzer, Matthew",14,8,1,6,0,0,22,3
Carlton,"Marchbank, Caleb",23,17,9,6,0,0,0,1
Carlton,"McGovern, Mitch",10,6,3,4,3,0,0,4
Carlton,"McKay, Harry",7,6,5,1,2,1,0,1
Carlton,"Murphy, Marc",30,16,7,14,1,0,0,4
Carlton,"Petrevski-Seton, Sam",19,10,4,9,0,1,0,8
Carlton,"Plowman, Lachie",15,10,4,5,0,0,0,1
Carlton,"Setterfield, Will",15,4,1,11,0,0,0,5
Carlton,"Silvagni, Jack",15,8,1,7,1,1,0,3
Carlton,"Stocker, Liam",16,10,3,6,0,0,0,3
Carlton,"Thomas, Dale",24,17,5,7,0,0,0,0
Carlton,"Walsh, Sam",20,6,4,14,0,0,0,3
Carlton,"Weitering, Jacob",13,9,5,4,0,0,0,1
Carlton,"Williamson, Tom",13,9,4,4,0,0,0,2
Carlton,"Casboult, Levi",8,5,3,3,0,0,3,0
Carlton,"Cripps, Patrick",12,3,2,9,0,0,0,4
Carlton,"Curnow, Charlie",14,10,2,4,0,2,0,3
Carlton,"Curnow, Ed",14,10,5,4,1,0,0,4
Carlton,"Dow, Paddy",11,5,1,6,0,0,0,3
Carlton,"Fisher, Zac",17,9,5,8,1,0,0,1
Carlton,"Gibbons, Michael",10,5,3,5,0,0,0,1
Carlton,"Kreuzer, Matthew",11,6,1,5,0,0,32,2
Carlton,"Macreadie, Harrison",2,2,0,0,0,0,0,1
Carlton,"Marchbank, Caleb",11,9,4,2,0,0,0,1
Carlton,"McGovern, Mitch",12,9,8,3,1,0,0,2
Carlton,"McKay, Harry",13,9,6,4,3,1,5,4
Carlton,"Murphy, Marc",4,2,0,2,0,0,0,0
Carlton,"Newman, Nic",29,26,6,3,0,0,0,3
Carlton,"OBrien, Lochie",14,9,6,5,0,0,0,1
Carlton,"Petrevski-Seton, Sam",14,8,2,6,0,0,0,2
Carlton,"Setterfield, Will",17,8,0,9,0,0,0,2
Carlton,"Silvagni, Jack",12,8,5,4,1,0,0,3
Carlton,"Stocker, Liam",18,10,1,8,0,0,0,1
Carlton,"Thomas, Dale",16,10,5,6,0,0,0,3
Carlton,"Walsh, Sam",18,10,6,8,0,0,0,3
Carlton,"Weitering, Jacob",11,6,3,5,0,0,0,0
Carlton,"Casboult, Levi",12,10,7,2,0,0,4,3
Carlton,"Cripps, Patrick",28,10,4,18,0,1,0,4
Carlton,"Cuningham, David",14,6,3,8,1,1,0,2
Carlton,"Curnow, Charlie",18,17,6,1,2,1,0,0
Carlton,"Curnow, Ed",20,14,5,6,0,0,0,7
Carlton,"Dow, Paddy",14,7,4,7,0,0,0,4
Carlton,"Fisher, Zac",12,3,1,9,0,0,0,5
Carlton,"Gibbons, Michael",12,5,4,7,2,0,0,3
Carlton,"Kennedy, Matthew",16,9,3,7,0,0,0,2
Carlton,"Kreuzer, Matthew",10,8,3,2,1,1,27,0
Carlton,"Marchbank, Caleb",12,11,7,1,0,0,0,4
Carlton,"McGovern, Mitch",5,3,3,2,0,0,0,3
Carlton,"McKay, Harry",11,8,5,3,1,1,1,2
Carlton,"Newman, Nic",20,18,9,2,1,0,0,1
Carlton,"Petrevski-Seton, Sam",19,13,5,6,0,0,0,7
Carlton,"Plowman, Lachie",15,14,8,1,0,0,0,3
Carlton,"Silvagni, Jack",7,5,4,2,0,1,0,4
Carlton,"Simpson, Kade",22,13,6,9,0,0,0,3
Carlton,"Stocker, Liam",12,7,4,5,0,0,0,3
Carlton,"Thomas, Dale",13,11,5,2,0,0,0,2
Carlton,"Walsh, Sam",29,16,5,13,0,0,0,1
Carlton,"Weitering, Jacob",9,7,2,2,0,0,0,2
Carlton,"Casboult, Levi",8,6,5,2,0,0,10,3
Carlton,"Cripps, Patrick",11,2,3,9,0,0,0,8
Carlton,"Cuningham, David",21,11,2,10,0,0,0,4
Carlton,"Curnow, Charlie",12,11,6,1,2,1,0,2
Carlton,"Curnow, Ed",17,5,3,12,0,0,0,6
Carlton,"Dow, Paddy",21,11,0,10,0,0,0,5
Carlton,"Fasolo, Alex",6,2,2,4,0,0,0,2
Carlton,"Fisher, Zac",14,10,3,4,0,1,0,1
Carlton,"Gibbons, Michael",15,13,3,2,0,1,0,3
Carlton,"Kennedy, Matthew",8,6,1,2,0,0,0,2
Carlton,"Kreuzer, Matthew",22,13,3,9,1,0,32,3
Carlton,"Lang, Darcy",8,4,3,4,0,2,0,2
Carlton,"Marchbank, Caleb",12,9,2,3,0,0,0,3
Carlton,"McKay, Harry",11,9,9,2,1,2,1,0
Carlton,"Newman, Nic",23,18,3,5,0,1,0,3
Carlton,"Petrevski-Seton, Sam",16,15,3,1,0,0,0,9
Carlton,"Plowman, Lachie",11,8,1,3,0,0,0,1
Carlton,"Setterfield, Will",18,10,1,8,0,0,0,4
Carlton,"Silvagni, Jack",11,8,3,3,0,0,0,5
Carlton,"Stocker, Liam",12,9,1,3,0,0,0,1
Carlton,"Walsh, Sam",21,11,5,10,0,0,0,2
Carlton,"Weitering, Jacob",13,10,5,3,0,0,0,2
Carlton,"Casboult, Levi",12,7,6,5,0,0,8,4
Carlton,"Cripps, Patrick",38,18,7,20,4,0,0,2
Carlton,"Cuningham, David",11,5,2,6,0,0,0,2
Carlton,"Curnow, Charlie",12,10,6,2,3,1,0,2
Carlton,"Curnow, Ed",30,13,4,17,0,1,0,9
Carlton,"Dow, Paddy",12,7,2,5,0,0,0,1
Carlton,"Fisher, Zac",25,9,2,16,0,0,0,0
Carlton,"Gibbons, Michael",23,11,0,12,2,0,0,3
Carlton,"Kreuzer, Matthew",8,2,2,6,0,0,27,3
Carlton,"Marchbank, Caleb",12,10,6,2,0,0,0,4
Carlton,"McGovern, Mitch",11,8,7,3,1,0,0,1
Carlton,"McKay, Harry",10,7,6,3,0,2,0,1
Carlton,"Newman, Nic",15,12,5,3,0,0,0,5
Carlton,"OBrien, Lochie",15,11,4,4,1,0,0,1
Carlton,"Petrevski-Seton, Sam",24,14,7,10,0,1,0,4
Carlton,"Plowman, Lachie",14,11,3,3,0,0,0,0
Carlton,"Setterfield, Will",18,12,8,6,0,1,0,3
Carlton,"Silvagni, Jack",10,3,1,7,0,1,0,1
Carlton,"Simpson, Kade",16,12,7,4,0,0,0,1
Carlton,"Thomas, Dale",16,10,6,6,0,0,0,3
Carlton,"Walsh, Sam",32,23,12,9,0,0,0,4
Carlton,"Weitering, Jacob",16,12,9,4,0,0,0,2
Carlton,"Casboult, Levi",17,9,7,8,0,0,7,5
Carlton,"Cripps, Patrick",22,6,2,16,0,0,0,3
Carlton,"Cuningham, David",15,10,7,5,2,2,0,2
Carlton,"Curnow, Charlie",17,15,7,2,7,1,0,1
Carlton,"Curnow, Ed",12,2,0,10,0,0,0,4
Carlton,"Dow, Paddy",9,5,4,4,1,1,0,2
Carlton,"Fisher, Zac",16,7,4,9,0,1,0,3
Carlton,"Gibbons, Michael",11,8,5,3,0,1,0,0
Carlton,"Kreuzer, Matthew",12,6,0,6,1,0,46,3
Carlton,"Marchbank, Caleb",12,4,3,8,0,0,0,1
Carlton,"McGovern, Mitch",6,4,0,2,1,0,0,0
Carlton,"McKay, Harry",6,6,4,0,1,0,0,1
Carlton,"Murphy, Marc",21,13,6,8,1,0,0,2
Carlton,"Newman, Nic",16,11,6,5,0,0,0,1
Carlton,"OBrien, Lochie",17,16,6,1,0,0,0,2
Carlton,"Petrevski-Seton, Sam",18,11,5,7,0,0,0,4
Carlton,"Plowman, Lachie",9,8,3,1,0,0,0,0
Carlton,"Setterfield, Will",24,11,5,13,0,1,0,1
Carlton,"Simpson, Kade",22,15,3,7,0,0,0,1
Carlton,"Thomas, Dale",17,13,3,4,1,2,0,4
Carlton,"Walsh, Sam",22,13,5,9,0,1,0,4
Carlton,"Weitering, Jacob",9,4,2,5,0,0,0,0
Carlton,"Casboult, Levi",13,8,6,5,1,1,14,3
Carlton,"Curnow, Charlie",2,1,1,1,0,1,0,0
Carlton,"Curnow, Ed",32,20,3,12,0,0,0,4
Carlton,"Dow, Paddy",7,4,3,3,1,1,0,3
Carlton,"Fisher, Zac",16,9,6,7,0,0,0,4
Carlton,"Gibbons, Michael",16,10,5,6,1,0,0,4
Carlton,"Jones, Liam",11,9,6,2,0,0,0,3
Carlton,"Kennedy, Matthew",13,6,4,7,2,0,0,1
Carlton,"Kreuzer, Matthew",9,6,2,3,0,0,32,5
Carlton,"Marchbank, Caleb",22,15,8,7,0,0,0,2
Carlton,"McGovern, Mitch",8,6,2,2,1,1,0,2
Carlton,"Murphy, Marc",34,21,2,13,1,1,0,3
Carlton,"Newman, Nic",25,16,7,9,0,0,0,4
Carlton,"OBrien, Lochie",18,11,6,7,0,2,0,1
Carlton,"Petrevski-Seton, Sam",23,11,5,12,1,0,0,5
Carlton,"Plowman, Lachie",19,14,6,5,0,0,0,2
Carlton,"Setterfield, Will",19,12,6,7,0,0,0,3
Carlton,"Silvagni, Jack",15,9,3,6,1,2,0,8
Carlton,"Simpson, Kade",15,12,1,3,1,0,0,1
Carlton,"Thomas, Dale",20,17,6,3,1,0,0,1
Carlton,"Walsh, Sam",30,19,4,11,0,2,0,8
Carlton,"Weitering, Jacob",14,14,6,0,0,0,0,0
Carlton,"Casboult, Levi",8,5,4,3,3,0,9,1
Carlton,"Curnow, Ed",23,16,3,7,0,0,0,11
Carlton,"Dow, Paddy",7,5,2,2,1,0,0,1
Carlton,"Fisher, Zac",14,5,2,9,1,0,0,1
Carlton,"Gibbons, Michael",12,6,3,6,1,0,0,2
Carlton,"Jones, Liam",5,4,2,1,0,0,0,1
Carlton,"Kennedy, Matthew",8,8,3,0,2,4,0,0
Carlton,"Kreuzer, Matthew",17,11,5,6,0,0,26,1
Carlton,"Lang, Darcy",10,8,5,2,0,0,0,2
Carlton,"Marchbank, Caleb",10,5,3,5,0,0,0,1
Carlton,"McGovern, Mitch",5,5,0,0,0,2,0,2
Carlton,"Murphy, Marc",24,13,1,11,0,0,0,6
Carlton,"Newman, Nic",26,19,7,7,0,1,0,5
Carlton,"OBrien, Lochie",9,5,4,4,1,0,0,1
Carlton,"Petrevski-Seton, Sam",17,8,0,9,0,0,0,4
Carlton,"Plowman, Lachie",13,7,4,6,0,0,0,4
Carlton,"Setterfield, Will",13,9,2,4,3,2,0,2
Carlton,"Silvagni, Jack",18,13,10,5,3,0,0,3
Carlton,"Simpson, Kade",15,9,1,6,0,0,0,3
Carlton,"Thomas, Dale",15,11,5,4,0,0,0,4
Carlton,"Walsh, Sam",25,11,5,14,0,0,0,7
Carlton,"Weitering, Jacob",8,6,4,2,0,0,0,1
Carlton,"Casboult, Levi",14,10,7,4,2,1,10,5
Carlton,"Cripps, Patrick",28,9,1,19,0,2,0,8
Carlton,"Curnow, Ed",28,14,2,14,0,0,0,10
Carlton,"Dow, Paddy",8,3,1,5,0,0,0,0
Carlton,"Fisher, Zac",17,12,1,5,1,0,0,6
Carlton,"Gibbons, Michael",18,12,3,6,1,1,0,2
Carlton,"Goddard, Hugh",3,1,0,2,0,0,0,3
Carlton,"Jones, Liam",3,3,2,0,0,0,0,1
Carlton,"Kennedy, Matthew",8,5,4,3,0,0,0,1
Carlton,"Kreuzer, Matthew",19,13,2,6,0,0,45,2
Carlton,"Lang, Darcy",6,5,2,1,1,0,0,3
Carlton,"McKay, Harry",12,9,9,3,1,3,0,3
Carlton,"Murphy, Marc",29,16,6,13,1,0,0,5
Carlton,"Newman, Nic",32,20,13,12,0,0,0,3
Carlton,"OBrien, Lochie",11,8,6,3,0,0,0,1
Carlton,"Petrevski-Seton, Sam",16,10,3,6,0,0,0,3
Carlton,"Plowman, Lachie",18,12,7,6,0,0,0,3
Carlton,"Setterfield, Will",13,10,2,3,0,1,0,9
Carlton,"Silvagni, Jack",17,10,6,7,1,2,0,3
Carlton,"Simpson, Kade",19,11,4,8,0,0,0,4
Carlton,"Thomas, Dale",16,11,3,5,0,0,0,3
Carlton,"Walsh, Sam",28,19,3,9,1,1,0,3
Carlton,"Casboult, Levi",10,9,10,1,1,1,14,6
Carlton,"Cripps, Patrick",18,4,2,14,1,0,0,4
Carlton,"Curnow, Ed",32,16,9,16,0,0,0,5
Carlton,"Deluca, Josh",8,3,3,5,1,0,0,1
Carlton,"Fisher, Zac",17,14,2,3,1,0,0,4
Carlton,"Gibbons, Michael",20,8,4,12,1,0,0,3
Carlton,"Jones, Liam",19,10,11,9,0,0,0,2
Carlton,"Kennedy, Matthew",11,10,1,1,4,0,0,0
Carlton,"Kreuzer, Matthew",7,4,0,3,0,0,19,2
Carlton,"Lang, Darcy",13,10,4,3,1,2,0,5
Carlton,"McKay, Harry",14,12,10,2,2,2,0,4
Carlton,"Murphy, Marc",22,10,0,12,1,0,0,4
Carlton,"Newman, Nic",18,12,7,6,0,0,0,6
Carlton,"OBrien, Lochie",16,11,2,5,1,0,0,1
Carlton,"Petrevski-Seton, Sam",22,14,5,8,0,0,0,4
Carlton,"Plowman, Lachie",17,12,7,5,0,0,0,2
Carlton,"Setterfield, Will",15,8,5,7,1,1,0,3
Carlton,"Silvagni, Jack",17,12,5,5,0,1,0,5
Carlton,"Simpson, Kade",24,19,3,5,0,0,0,3
Carlton,"Thomas, Dale",20,12,7,8,0,0,0,2
Carlton,"Walsh, Sam",27,12,5,15,0,1,0,4
Carlton,"Weitering, Jacob",19,16,10,3,0,0,0,2
Carlton,"Casboult, Levi",15,13,10,2,3,1,10,0
Carlton,"Cripps, Patrick",39,16,4,23,1,0,0,7
Carlton,"Curnow, Ed",30,12,1,18,0,1,0,4
Carlton,"Deluca, Josh",11,4,2,7,1,0,0,5
Carlton,"Dow, Paddy",4,0,0,4,0,0,0,6
Carlton,"Gibbons, Michael",22,13,7,9,1,1,0,5
Carlton,"Jones, Liam",7,6,5,1,0,0,0,1
Carlton,"Kennedy, Matthew",10,5,3,5,1,0,0,7
Carlton,"Lang, Darcy",9,7,3,2,1,0,0,3
Carlton,"McKay, Harry",4,4,5,0,1,1,0,1
Carlton,"Murphy, Marc",31,21,8,10,0,0,0,5
Carlton,"Newman, Nic",19,14,7,5,0,0,0,0
Carlton,"OBrien, Lochie",9,5,4,4,0,0,0,1
Carlton,"Petrevski-Seton, Sam",20,16,9,4,0,0,0,3
Carlton,"Phillips, Andrew",9,4,4,5,1,1,35,3
Carlton,"Plowman, Lachie",10,6,4,4,0,0,0,2
Carlton,"Setterfield, Will",24,17,4,7,1,1,0,2
Carlton,"Silvagni, Jack",15,6,3,9,1,0,0,5
Carlton,"Simpson, Kade",31,26,12,5,1,0,0,3
Carlton,"Thomas, Dale",22,14,7,8,0,0,0,3
Carlton,"Walsh, Sam",30,15,4,15,0,1,0,1
Carlton,"Weitering, Jacob",14,8,7,6,0,0,0,2
Carlton,"Casboult, Levi",12,8,3,4,0,2,9,2
Carlton,"Cripps, Patrick",24,8,3,16,0,0,0,3
Carlton,"Curnow, Ed",18,9,0,9,0,0,0,8
Carlton,"Deluca, Josh",11,4,0,7,0,0,0,3
Carlton,"Fisher, Zac",11,5,0,6,0,0,0,0
Carlton,"Gibbons, Michael",15,12,4,3,3,1,0,0
Carlton,"Goddard, Hugh",9,7,3,2,0,0,0,0
Carlton,"Kennedy, Matthew",7,2,1,5,0,1,0,1
Carlton,"Lang, Darcy",5,3,2,2,1,0,0,3
Carlton,"McKay, Harry",18,14,11,4,1,2,0,0
Carlton,"Murphy, Marc",25,14,8,11,1,0,0,4
Carlton,"Newman, Nic",24,17,11,7,4,0,0,3
Carlton,"OBrien, Lochie",18,14,6,4,0,0,0,1
Carlton,"Petrevski-Seton, Sam",22,16,5,6,0,0,0,4
Carlton,"Phillips, Andrew",11,7,2,4,0,1,30,1
Carlton,"Plowman, Lachie",10,8,4,2,0,0,0,2
Carlton,"Schumacher, Angus",13,10,4,3,0,0,0,0
Carlton,"Setterfield, Will",19,13,5,6,0,0,0,1
Carlton,"Silvagni, Jack",18,11,5,7,0,0,0,3
Carlton,"Simpson, Kade",25,20,8,5,0,0,0,2
Carlton,"Walsh, Sam",31,13,7,18,1,0,0,0
Carlton,"Weitering, Jacob",15,11,9,4,0,0,0,2
Carlton,"Casboult, Levi",9,5,5,4,1,1,6,2
Carlton,"Cripps, Patrick",37,15,2,22,0,0,0,7
Carlton,"Curnow, Ed",34,17,2,17,0,0,0,8
Carlton,"Deluca, Josh",14,7,3,7,0,0,0,5
Carlton,"Fisher, Zac",10,3,1,7,0,0,0,1
Carlton,"Gibbons, Michael",9,8,0,1,1,1,0,3
Carlton,"Jones, Liam",10,8,4,2,0,0,0,1
Carlton,"Kreuzer, Matthew",8,7,1,1,1,1,47,1
Carlton,"Lang, Darcy",4,0,0,4,0,0,0,3
Carlton,"McGovern, Mitch",11,8,2,3,2,2,0,1
Carlton,"McKay, Harry",6,5,3,1,0,0,0,3
Carlton,"Murphy, Marc",29,15,1,14,1,0,0,5
Carlton,"Newman, Nic",20,16,5,4,0,0,0,9
Carlton,"OBrien, Lochie",8,7,1,1,0,0,0,1
Carlton,"Petrevski-Seton, Sam",18,12,3,6,0,0,0,6
Carlton,"Plowman, Lachie",17,12,10,5,0,0,0,3
Carlton,"Setterfield, Will",14,8,2,6,0,0,0,3
Carlton,"Silvagni, Jack",15,13,5,2,0,0,0,3
Carlton,"Simpson, Kade",33,26,4,7,0,0,0,4
Carlton,"Thomas, Dale",32,22,4,10,0,1,0,7
Carlton,"Walsh, Sam",19,11,3,8,0,1,0,3
Carlton,"Weitering, Jacob",9,7,8,2,0,0,0,5
Carlton,"Casboult, Levi",20,14,10,6,0,0,4,4
Carlton,"Cripps, Patrick",22,5,1,17,0,0,0,6
Carlton,"Curnow, Ed",25,14,1,11,1,0,0,9
Carlton,"Deluca, Josh",15,7,3,8,1,1,0,4
Carlton,"Dow, Paddy",19,9,4,10,1,0,0,4
Carlton,"Fisher, Zac",12,4,0,8,0,0,0,5
Carlton,"Gibbons, Michael",17,15,4,2,0,1,0,0
Carlton,"Kennedy, Matthew",11,5,3,6,1,0,0,0
Carlton,"Kreuzer, Matthew",21,16,4,5,0,2,23,2
Carlton,"Lang, Darcy",8,7,5,1,1,1,0,3
Carlton,"McGovern, Mitch",12,9,7,3,3,1,0,0
Carlton,"McKay, Harry",15,14,11,1,1,3,1,1
Carlton,"Murphy, Marc",27,16,6,11,1,0,0,5
Carlton,"Newman, Nic",21,16,9,5,0,0,0,6
Carlton,"OBrien, Lochie",18,13,9,5,0,0,0,2
Carlton,"Petrevski-Seton, Sam",17,8,2,9,0,0,0,4
Carlton,"Plowman, Lachie",9,8,4,1,0,0,0,2
Carlton,"Setterfield, Will",8,6,3,2,0,0,0,1
Carlton,"Silvagni, Jack",16,8,4,8,1,1,0,3
Carlton,"Simpson, Kade",21,14,7,7,0,0,0,4
Carlton,"Thomas, Dale",19,12,4,7,0,0,0,3
Carlton,"Walsh, Sam",18,8,2,10,0,0,0,5
Carlton,"Casboult, Levi",3,2,0,1,0,0,6,1
Carlton,"Cripps, Patrick",35,24,2,11,1,0,0,8
Carlton,"Cuningham, David",9,3,2,6,0,1,0,2
Carlton,"Curnow, Ed",29,20,2,9,0,0,0,4
Carlton,"Deluca, Josh",12,6,2,6,1,0,0,5
Carlton,"Dow, Paddy",13,6,1,7,0,1,0,1
Carlton,"Fisher, Zac",10,7,0,3,1,0,0,0
Carlton,"Kennedy, Matthew",15,6,4,9,1,0,0,2
Carlton,"Kreuzer, Matthew",11,10,1,1,0,0,34,2
Carlton,"McGovern, Mitch",8,3,3,5,0,1,0,4
Carlton,"McKay, Harry",6,5,2,1,1,1,0,2
Carlton,"Murphy, Marc",31,15,3,16,1,1,0,7
Carlton,"Newman, Nic",17,15,1,2,0,0,0,5
Carlton,"OBrien, Lochie",10,9,6,1,1,2,0,0
Carlton,"Petrevski-Seton, Sam",6,6,1,0,0,0,0,2
Carlton,"Plowman, Lachie",12,10,3,2,0,0,0,2
Carlton,"Setterfield, Will",15,13,2,2,0,1,0,6
Carlton,"Silvagni, Jack",9,5,0,4,0,1,0,1
Carlton,"Simpson, Kade",14,13,4,1,0,0,0,2
Carlton,"Thomas, Dale",14,10,4,4,0,0,0,8
Carlton,"Walsh, Sam",24,12,7,12,1,1,0,2
Carlton,"Weitering, Jacob",8,7,3,1,0,0,0,1
Collingwood,"Aish, James",19,15,5,4,0,0,0,4
Collingwood,"Beams, Dayne",23,14,4,9,1,0,0,3
Collingwood,"Brown, Callum",9,4,1,5,1,0,0,3
Collingwood,"Cox, Mason",11,8,3,3,1,1,7,1
Collingwood,"Crisp, Jack",26,14,3,12,0,0,0,1
Collingwood,"Elliott, Jamie",8,7,6,1,3,0,0,5
Collingwood,"Grundy, Brodie",18,10,2,8,0,2,34,2
Collingwood,"Howe, Jeremy",15,13,5,2,0,0,0,3
Collingwood,"Langdon, Tom",14,8,5,6,0,0,0,3
Collingwood,"Maynard, Brayden",16,8,3,8,0,0,0,0
Collingwood,"Mayne, Chris",22,14,6,8,0,0,0,2
Collingwood,"Mihocek, Brody",14,9,5,5,0,0,0,0
Collingwood,"Moore, Darcy",16,13,4,3,0,0,0,0
Collingwood,"Pendlebury, Scott",24,11,7,13,0,1,0,2
Collingwood,"Phillips, Tom",24,16,7,8,0,1,0,1
Collingwood,"Roughead, Jordan",10,6,5,4,0,0,0,3
Collingwood,"Sidebottom, Steele",26,12,6,14,0,0,0,2
Collingwood,"Stephenson, Jaidyn",16,12,7,4,0,1,0,2
Collingwood,"Thomas, Josh",16,6,2,10,0,0,0,1
Collingwood,"Treloar, Adam",34,14,5,20,1,0,0,6
Collingwood,"Varcoe, Travis",9,2,4,7,0,0,0,4
Collingwood,"de Goey, Jordan",10,7,3,3,2,2,0,1
Collingwood,"Aish, James",23,13,8,10,0,0,0,3
Collingwood,"Beams, Dayne",36,18,9,18,0,0,0,3
Collingwood,"Cox, Mason",11,8,7,3,2,3,5,0
Collingwood,"Crisp, Jack",32,24,14,8,0,0,0,3
Collingwood,"Elliott, Jamie",10,6,3,4,1,1,0,1
Collingwood,"Greenwood, Levi",20,12,5,8,0,0,0,5
Collingwood,"Grundy, Brodie",23,8,7,15,0,0,27,2
Collingwood,"Howe, Jeremy",19,16,14,3,0,0,0,1
Collingwood,"Langdon, Tom",19,15,9,4,0,0,0,4
Collingwood,"Maynard, Brayden",17,11,4,6,0,0,0,6
Collingwood,"Mayne, Chris",33,18,11,15,1,0,0,2
Collingwood,"Mihocek, Brody",20,15,12,5,2,1,0,3
Collingwood,"Moore, Darcy",15,9,4,6,0,0,0,2
Collingwood,"Pendlebury, Scott",31,18,4,13,1,0,0,3
Collingwood,"Phillips, Tom",25,18,10,7,1,0,0,3
Collingwood,"Roughead, Jordan",20,15,13,5,0,0,0,3
Collingwood,"Sidebottom, Steele",21,12,12,9,0,1,0,2
Collingwood,"Stephenson, Jaidyn",17,12,9,5,2,0,0,1
Collingwood,"Thomas, Josh",16,11,5,5,1,0,0,2
Collingwood,"Treloar, Adam",39,18,6,21,1,0,0,7
Collingwood,"Varcoe, Travis",5,2,2,3,0,0,0,2
Collingwood,"de Goey, Jordan",15,12,6,3,5,1,0,0
Collingwood,"Adams, Taylor",26,17,4,9,0,0,0,0
Collingwood,"Aish, James",21,10,6,11,0,0,0,1
Collingwood,"Beams, Dayne",26,11,4,15,1,0,0,1
Collingwood,"Cox, Mason",7,5,3,2,1,1,2,1
Collingwood,"Crisp, Jack",15,6,3,9,0,0,0,1
Collingwood,"Elliott, Jamie",6,6,4,0,1,0,0,0
Collingwood,"Greenwood, Levi",6,3,0,3,0,1,0,3
Collingwood,"Grundy, Brodie",22,6,4,16,0,0,40,5
Collingwood,"Howe, Jeremy",21,18,7,3,0,0,0,1
Collingwood,"Langdon, Tom",19,11,6,8,0,0,0,1
Collingwood,"Maynard, Brayden",23,15,11,8,0,0,0,4
Collingwood,"Mayne, Chris",24,13,8,11,0,1,0,2
Collingwood,"Mihocek, Brody",13,9,9,4,1,1,0,1
Collingwood,"Moore, Darcy",17,9,6,8,0,0,0,3
Collingwood,"Pendlebury, Scott",21,10,6,11,0,0,0,3
Collingwood,"Phillips, Tom",14,10,3,4,0,1,0,1
Collingwood,"Roughead, Jordan",9,4,3,5,0,0,0,1
Collingwood,"Sidebottom, Steele",25,13,7,12,1,0,0,4
Collingwood,"Stephenson, Jaidyn",14,10,4,4,0,1,0,2
Collingwood,"Thomas, Josh",12,7,2,5,1,1,0,1
Collingwood,"Treloar, Adam",25,11,8,14,2,1,0,2
Collingwood,"de Goey, Jordan",18,15,7,3,3,1,0,3
Collingwood,"Adams, Taylor",28,18,4,10,0,1,0,8
Collingwood,"Aish, James",11,5,1,6,0,0,0,4
Collingwood,"Brown, Callum",17,9,6,8,0,1,0,3
Collingwood,"Cox, Mason",13,7,6,6,1,0,2,2
Collingwood,"Crisp, Jack",18,11,1,7,0,1,0,4
Collingwood,"Elliott, Jamie",11,9,5,2,2,1,0,1
Collingwood,"Grundy, Brodie",22,9,4,13,0,1,58,8
Collingwood,"Howe, Jeremy",17,9,3,8,0,0,0,1
Collingwood,"Langdon, Tom",20,3,4,17,0,0,0,0
Collingwood,"Maynard, Brayden",12,8,4,4,0,0,0,3
Collingwood,"Mayne, Chris",3,1,1,2,0,0,0,0
Collingwood,"Mihocek, Brody",13,10,6,3,0,2,0,1
Collingwood,"Moore, Darcy",20,10,4,10,0,0,0,1
Collingwood,"Pendlebury, Scott",27,11,2,16,0,0,0,3
Collingwood,"Phillips, Tom",29,19,8,10,2,1,0,5
Collingwood,"Roughead, Jordan",14,9,9,5,0,0,0,0
Collingwood,"Sidebottom, Steele",25,17,7,8,0,0,0,2
Collingwood,"Stephenson, Jaidyn",17,11,5,6,2,1,0,2
Collingwood,"Thomas, Josh",13,9,3,4,2,0,0,3
Collingwood,"Treloar, Adam",26,9,2,17,0,0,0,5
Collingwood,"Varcoe, Travis",20,11,6,9,1,0,0,4
Collingwood,"de Goey, Jordan",19,14,7,5,1,3,0,4
Collingwood,"Adams, Taylor",22,11,2,11,0,0,0,1
Collingwood,"Aish, James",5,3,2,2,0,0,0,0
Collingwood,"Beams, Dayne",26,12,3,14,1,0,0,3
Collingwood,"Brown, Callum",14,10,6,4,2,1,0,3
Collingwood,"Cox, Mason",9,5,6,4,2,0,5,0
Collingwood,"Crisp, Jack",27,19,9,8,0,0,0,0
Collingwood,"Elliott, Jamie",12,8,5,4,2,2,0,0
Collingwood,"Grundy, Brodie",12,4,2,8,0,0,31,4
Collingwood,"Howe, Jeremy",9,6,2,3,0,0,0,3
Collingwood,"Langdon, Tom",22,6,5,16,0,0,0,3
Collingwood,"Maynard, Brayden",19,15,2,4,0,1,0,4
Collingwood,"Mihocek, Brody",18,10,8,8,4,2,0,2
Collingwood,"Moore, Darcy",13,9,2,4,0,0,0,1
Collingwood,"Pendlebury, Scott",26,11,4,15,0,1,0,4
Collingwood,"Phillips, Tom",29,15,4,14,0,1,0,1
Collingwood,"Roughead, Jordan",7,3,3,4,0,0,0,2
Collingwood,"Sidebottom, Steele",26,14,4,12,0,0,0,2
Collingwood,"Stephenson, Jaidyn",18,14,9,4,2,1,0,1
Collingwood,"Thomas, Josh",18,8,6,10,2,0,0,0
Collingwood,"Treloar, Adam",35,20,8,15,0,0,0,1
Collingwood,"Varcoe, Travis",11,6,1,5,0,1,0,1
Collingwood,"de Goey, Jordan",19,13,6,6,3,1,0,2
Collingwood,"Adams, Taylor",23,16,6,7,1,0,0,8
Collingwood,"Beams, Dayne",28,17,6,11,0,0,0,2
Collingwood,"Brown, Callum",16,10,4,6,0,3,0,4
Collingwood,"Cox, Mason",9,5,4,4,2,1,5,0
Collingwood,"Crisp, Jack",29,13,7,16,0,0,0,6
Collingwood,"Greenwood, Levi",10,9,2,1,0,0,0,2
Collingwood,"Grundy, Brodie",24,6,6,18,0,0,39,6
Collingwood,"Hoskin-Elliott, Will",16,8,6,8,1,1,0,1
Collingwood,"Howe, Jeremy",20,14,10,6,0,0,0,4
Collingwood,"Langdon, Tom",18,5,3,13,0,0,0,2
Collingwood,"Maynard, Brayden",19,13,2,6,0,0,0,6
Collingwood,"Mihocek, Brody",6,4,2,2,1,0,0,1
Collingwood,"Moore, Darcy",17,10,6,7,0,1,0,1
Collingwood,"Pendlebury, Scott",38,25,7,13,0,0,0,6
Collingwood,"Phillips, Tom",26,16,6,10,0,1,0,1
Collingwood,"Roughead, Jordan",9,6,3,3,0,0,0,1
Collingwood,"Sidebottom, Steele",24,15,5,9,1,1,0,2
Collingwood,"Stephenson, Jaidyn",14,10,6,4,1,2,0,0
Collingwood,"Thomas, Josh",14,6,5,8,1,1,0,0
Collingwood,"Treloar, Adam",31,11,3,20,0,0,0,6
Collingwood,"Varcoe, Travis",10,4,3,6,0,0,0,6
Collingwood,"de Goey, Jordan",15,13,5,2,2,1,0,6
Collingwood,"Adams, Taylor",15,8,1,7,0,0,0,2
Collingwood,"Beams, Dayne",20,7,1,13,1,0,0,2
Collingwood,"Brown, Callum",13,7,1,6,0,0,0,7
Collingwood,"Crisp, Jack",29,14,10,15,0,0,0,1
Collingwood,"Elliott, Jamie",18,12,8,6,3,1,0,4
Collingwood,"Greenwood, Levi",21,13,7,8,0,0,0,3
Collingwood,"Grundy, Brodie",22,8,3,14,0,0,35,2
Collingwood,"Hoskin-Elliott, Will",10,9,6,1,1,0,0,0
Collingwood,"Howe, Jeremy",8,6,1,2,0,0,0,1
Collingwood,"Langdon, Tom",24,13,8,11,0,1,0,1
Collingwood,"Maynard, Brayden",27,18,6,9,0,0,0,3
Collingwood,"Mihocek, Brody",10,7,3,3,2,1,0,1
Collingwood,"Moore, Darcy",21,13,7,8,0,0,0,0
Collingwood,"Pendlebury, Scott",36,18,5,18,0,0,0,5
Collingwood,"Phillips, Tom",31,16,8,15,0,0,0,1
Collingwood,"Reid, Ben",13,10,7,3,1,4,1,0
Collingwood,"Roughead, Jordan",15,5,3,10,0,0,1,6
Collingwood,"Sidebottom, Steele",29,15,11,14,1,0,0,4
Collingwood,"Stephenson, Jaidyn",14,12,6,2,4,2,0,4
Collingwood,"Thomas, Josh",15,6,1,9,0,2,0,2
Collingwood,"Treloar, Adam",35,18,3,17,1,0,0,5
Collingwood,"de Goey, Jordan",15,13,7,2,1,3,0,1
Collingwood,"Brown, Callum",21,13,3,8,2,1,0,8
Collingwood,"Crisp, Jack",24,14,7,10,1,0,0,4
Collingwood,"Elliott, Jamie",13,8,5,5,0,0,0,4
Collingwood,"Greenwood, Levi",18,12,6,6,0,0,0,2
Collingwood,"Grundy, Brodie",25,12,8,13,2,1,48,1
Collingwood,"Hoskin-Elliott, Will",14,9,3,5,2,0,0,1
Collingwood,"Howe, Jeremy",18,13,7,5,0,0,0,2
Collingwood,"Langdon, Tom",14,3,2,11,0,0,0,3
Collingwood,"Maynard, Brayden",15,9,3,6,0,0,0,6
Collingwood,"Mayne, Chris",18,2,2,16,0,0,0,2
Collingwood,"Mihocek, Brody",15,10,7,5,1,0,0,4
Collingwood,"Moore, Darcy",13,9,5,4,0,0,0,2
Collingwood,"Pendlebury, Scott",26,15,1,11,0,0,0,5
Collingwood,"Phillips, Tom",34,21,4,13,2,2,0,2
Collingwood,"Reid, Ben",9,4,2,5,0,0,2,5
Collingwood,"Roughead, Jordan",13,6,3,7,0,0,0,2
Collingwood,"Sidebottom, Steele",34,19,4,15,0,0,0,3
Collingwood,"Stephenson, Jaidyn",14,11,7,3,2,0,0,1
Collingwood,"Thomas, Josh",13,8,1,5,1,0,0,3
Collingwood,"Treloar, Adam",34,15,3,19,1,1,0,4
Collingwood,"Wills, Rupert",12,8,3,4,0,0,0,5
Collingwood,"de Goey, Jordan",23,16,6,7,2,2,0,3
Collingwood,"Aish, James",13,8,4,5,0,0,0,2
Collingwood,"Beams, Dayne",30,15,5,15,0,3,0,2
Collingwood,"Brown, Callum",9,2,0,7,0,0,0,2
Collingwood,"Crisp, Jack",27,14,5,13,0,0,0,4
Collingwood,"Greenwood, Levi",17,10,6,7,0,0,0,3
Collingwood,"Grundy, Brodie",24,16,4,8,0,0,49,6
Collingwood,"Hoskin-Elliott, Will",13,11,8,2,1,1,0,1
Collingwood,"Howe, Jeremy",12,10,3,2,0,0,0,1
Collingwood,"Langdon, Tom",11,6,3,5,0,0,0,1
Collingwood,"Maynard, Brayden",14,8,1,6,0,1,0,6
Collingwood,"Mayne, Chris",25,12,5,13,0,0,0,3
Collingwood,"Mihocek, Brody",14,10,8,4,4,1,0,1
Collingwood,"Pendlebury, Scott",27,13,2,14,0,0,0,3
Collingwood,"Phillips, Tom",20,13,6,7,0,0,0,2
Collingwood,"Reid, Ben",16,10,7,6,3,1,4,0
Collingwood,"Roughead, Jordan",10,6,5,4,0,0,0,0
Collingwood,"Sidebottom, Steele",29,16,6,13,2,1,0,3
Collingwood,"Stephenson, Jaidyn",17,11,8,6,3,0,0,1
Collingwood,"Thomas, Josh",13,7,2,6,2,1,0,4
Collingwood,"Treloar, Adam",38,14,3,24,0,0,0,3
Collingwood,"Varcoe, Travis",13,8,2,5,2,0,0,4
Collingwood,"Wills, Rupert",14,7,3,7,0,1,0,7
Collingwood,"Aish, James",16,11,3,5,0,0,0,3
Collingwood,"Beams, Dayne",22,18,4,4,0,1,0,2
Collingwood,"Brown, Callum",15,10,1,5,2,0,0,9
Collingwood,"Crisp, Jack",27,15,3,12,0,0,0,3
Collingwood,"Greenwood, Levi",21,16,11,5,0,0,0,0
Collingwood,"Grundy, Brodie",18,10,5,8,0,1,64,8
Collingwood,"Hoskin-Elliott, Will",15,11,3,4,0,0,0,2
Collingwood,"Howe, Jeremy",12,9,4,3,0,0,0,2
Collingwood,"Madgen, Jack",7,4,2,3,0,0,0,1
Collingwood,"Maynard, Brayden",18,13,3,5,0,0,0,4
Collingwood,"Mayne, Chris",20,12,7,8,2,0,0,5
Collingwood,"Mihocek, Brody",12,11,5,1,1,3,0,1
Collingwood,"Pendlebury, Scott",29,15,2,14,1,0,0,9
Collingwood,"Phillips, Tom",23,14,2,9,0,0,0,4
Collingwood,"Reid, Ben",11,5,2,6,1,1,4,1
Collingwood,"Roughead, Jordan",8,7,2,1,0,0,0,0
Collingwood,"Sidebottom, Steele",13,8,2,5,0,0,0,3
Collingwood,"Stephenson, Jaidyn",13,9,4,4,1,1,0,6
Collingwood,"Thomas, Josh",13,8,2,5,0,3,0,2
Collingwood,"Treloar, Adam",38,17,4,21,0,1,0,2
Collingwood,"Wells, Daniel",11,6,4,5,3,0,0,2
Collingwood,"Wills, Rupert",11,5,2,6,0,0,1,3
Collingwood,"Aish, James",16,10,3,6,0,0,0,1
Collingwood,"Beams, Dayne",15,12,2,3,1,0,0,1
Collingwood,"Brown, Callum",14,6,1,8,0,2,0,3
Collingwood,"Crisp, Jack",27,15,3,12,0,1,0,2
Collingwood,"Greenwood, Levi",17,13,5,4,0,0,0,2
Collingwood,"Grundy, Brodie",21,7,3,14,0,0,46,3
Collingwood,"Hoskin-Elliott, Will",17,14,9,3,1,0,0,2
Collingwood,"Howe, Jeremy",21,17,11,4,0,0,0,0
Collingwood,"Maynard, Brayden",24,19,4,5,0,0,0,0
Collingwood,"Mayne, Chris",23,16,6,7,0,0,0,4
Collingwood,"Mihocek, Brody",18,9,9,9,0,3,0,1
Collingwood,"Moore, Darcy",9,6,5,3,0,0,0,4
Collingwood,"Pendlebury, Scott",29,19,2,10,2,0,0,8
Collingwood,"Phillips, Tom",16,9,8,7,0,0,0,2
Collingwood,"Reid, Ben",10,7,2,3,2,0,7,1
Collingwood,"Roughead, Jordan",17,8,10,9,0,0,0,1
Collingwood,"Sidebottom, Steele",20,11,5,9,0,0,0,5
Collingwood,"Stephenson, Jaidyn",12,9,4,3,1,0,0,3
Collingwood,"Thomas, Josh",12,6,2,6,1,1,0,1
Collingwood,"Treloar, Adam",23,6,4,17,0,0,0,4
Collingwood,"Varcoe, Travis",14,6,6,8,0,1,0,1
Collingwood,"de Goey, Jordan",16,12,5,4,3,1,0,2
Collingwood,"Aish, James",21,11,7,10,0,0,0,2
Collingwood,"Brown, Callum",14,4,1,10,0,0,0,7
Collingwood,"Cox, Mason",10,6,5,4,1,1,7,3
Collingwood,"Crisp, Jack",19,8,3,11,0,0,0,3
Collingwood,"Greenwood, Levi",13,7,4,6,0,0,0,4
Collingwood,"Grundy, Brodie",14,8,6,6,1,0,30,3
Collingwood,"Hoskin-Elliott, Will",19,13,12,6,3,0,0,1
Collingwood,"Howe, Jeremy",22,13,4,9,0,0,0,2
Collingwood,"Maynard, Brayden",18,11,5,7,0,0,0,4
Collingwood,"Mayne, Chris",20,13,6,7,0,0,0,4
Collingwood,"Mihocek, Brody",20,11,4,9,1,1,0,2
Collingwood,"Moore, Darcy",13,7,5,6,0,0,0,1
Collingwood,"Pendlebury, Scott",24,10,6,14,0,1,0,4
Collingwood,"Phillips, Tom",27,18,3,9,0,0,0,1
Collingwood,"Roughead, Jordan",14,9,4,5,0,0,0,2
Collingwood,"Sidebottom, Steele",27,17,4,10,1,0,0,6
Collingwood,"Sier, Brayden",23,9,2,14,0,1,0,9
Collingwood,"Stephenson, Jaidyn",19,16,9,3,3,3,0,3
Collingwood,"Thomas, Josh",14,5,3,9,1,0,0,1
Collingwood,"Treloar, Adam",34,18,2,16,1,0,0,6
Collingwood,"Varcoe, Travis",10,5,3,5,0,0,0,2
Collingwood,"de Goey, Jordan",13,8,1,5,3,0,0,0
Collingwood,"Aish, James",18,10,5,8,0,0,0,6
Collingwood,"Brown, Callum",21,8,2,13,1,0,0,0
Collingwood,"Cox, Mason",9,5,6,4,2,1,0,1
Collingwood,"Crisp, Jack",33,16,8,17,0,0,0,4
Collingwood,"Greenwood, Levi",8,4,2,4,0,0,0,2
Collingwood,"Grundy, Brodie",25,17,8,8,2,0,50,4
Collingwood,"Hoskin-Elliott, Will",19,14,10,5,0,1,0,3
Collingwood,"Howe, Jeremy",4,3,2,1,0,0,0,2
Collingwood,"Maynard, Brayden",19,14,6,5,0,0,0,2
Collingwood,"Mayne, Chris",15,8,4,7,0,0,0,4
Collingwood,"Mihocek, Brody",12,8,5,4,1,0,0,0
Collingwood,"Moore, Darcy",16,10,3,6,0,0,0,1
Collingwood,"Pendlebury, Scott",20,13,4,7,0,1,0,4
Collingwood,"Phillips, Tom",21,11,4,10,2,0,0,5
Collingwood,"Reid, Ben",14,6,5,8,3,0,6,2
Collingwood,"Roughead, Jordan",16,10,6,6,0,0,0,2
Collingwood,"Sidebottom, Steele",33,17,4,16,0,0,0,3
Collingwood,"Sier, Brayden",20,8,0,12,0,0,0,4
Collingwood,"Thomas, Josh",15,6,2,9,0,0,0,7
Collingwood,"Treloar, Adam",36,16,4,20,0,0,0,8
Collingwood,"Varcoe, Travis",16,3,1,13,0,0,0,1
Collingwood,"de Goey, Jordan",14,11,5,3,2,0,0,1
Collingwood,"Brown, Callum",14,4,0,10,0,0,0,6
Collingwood,"Cox, Mason",10,4,2,6,2,0,2,0
Collingwood,"Crisp, Jack",28,19,6,9,0,0,0,3
Collingwood,"Daicos, Josh",22,10,4,12,0,0,0,4
Collingwood,"Greenwood, Levi",15,11,5,4,0,0,0,6
Collingwood,"Grundy, Brodie",23,8,3,15,0,1,44,2
Collingwood,"Hoskin-Elliott, Will",13,6,5,7,0,0,0,0
Collingwood,"Maynard, Brayden",21,13,6,8,0,0,0,1
Collingwood,"Mayne, Chris",22,13,5,9,0,0,0,2
Collingwood,"Mihocek, Brody",14,11,3,3,1,1,0,3
Collingwood,"Moore, Darcy",13,10,5,3,0,0,0,2
Collingwood,"Pendlebury, Scott",33,17,3,16,0,0,0,1
Collingwood,"Phillips, Tom",22,14,5,8,1,0,0,0
Collingwood,"Reid, Ben",0,0,0,0,0,0,0,0
Collingwood,"Roughead, Jordan",14,9,8,5,0,0,0,2
Collingwood,"Scharenberg, Matt",15,7,5,8,0,0,0,0
Collingwood,"Sidebottom, Steele",23,10,6,13,0,0,0,4
Collingwood,"Sier, Brayden",7,3,0,4,0,0,0,0
Collingwood,"Thomas, Josh",13,4,1,9,0,0,0,2
Collingwood,"Treloar, Adam",40,14,2,26,0,0,0,7
Collingwood,"Varcoe, Travis",15,7,2,8,0,0,0,5
Collingwood,"de Goey, Jordan",17,13,5,4,1,0,0,1
Collingwood,"Aish, James",17,9,1,8,0,0,0,2
Collingwood,"Brown, Callum",15,7,0,8,0,2,0,6
Collingwood,"Cox, Mason",6,6,3,0,1,0,1,1
Collingwood,"Crisp, Jack",26,15,9,11,0,0,0,6
Collingwood,"Daicos, Josh",15,11,3,4,1,2,0,2
Collingwood,"Elliott, Jamie",7,5,3,2,0,0,0,2
Collingwood,"Grundy, Brodie",18,12,4,6,0,1,34,2
Collingwood,"Hoskin-Elliott, Will",17,12,6,5,2,0,0,4
Collingwood,"Maynard, Brayden",13,10,4,3,0,0,0,6
Collingwood,"Mayne, Chris",13,10,7,3,0,0,0,4
Collingwood,"Mihocek, Brody",12,8,7,4,1,1,0,4
Collingwood,"Moore, Darcy",21,14,6,7,0,0,0,3
Collingwood,"Pendlebury, Scott",25,11,4,14,0,1,0,2
Collingwood,"Phillips, Tom",31,18,6,13,0,1,0,3
Collingwood,"Quaynor, Isaac",18,11,7,7,0,0,0,4
Collingwood,"Roughead, Jordan",10,5,6,5,0,0,0,3
Collingwood,"Scharenberg, Matt",18,9,7,9,0,0,0,2
Collingwood,"Sidebottom, Steele",28,18,3,10,0,0,0,4
Collingwood,"Sier, Brayden",9,6,1,3,1,0,0,1
Collingwood,"Thomas, Josh",15,7,4,8,0,0,0,2
Collingwood,"Treloar, Adam",31,11,3,20,1,0,0,4
Collingwood,"de Goey, Jordan",21,13,3,8,2,0,0,2
Collingwood,"Aish, James",24,12,9,12,0,1,0,1
Collingwood,"Brown, Callum",14,3,3,11,0,2,0,1
Collingwood,"Cox, Mason",13,7,6,6,3,0,4,1
Collingwood,"Crisp, Jack",30,10,3,20,0,0,0,9
Collingwood,"Crocker, Ben",10,5,1,5,0,1,0,3
Collingwood,"Elliott, Jamie",10,6,4,4,0,0,0,3
Collingwood,"Greenwood, Levi",19,11,6,8,0,0,0,4
Collingwood,"Grundy, Brodie",22,12,4,10,0,1,32,8
Collingwood,"Hoskin-Elliott, Will",15,9,3,6,0,0,0,3
Collingwood,"Maynard, Brayden",17,14,6,3,0,0,0,2
Collingwood,"Mayne, Chris",8,4,4,4,0,0,0,1
Collingwood,"Mihocek, Brody",19,14,10,5,4,1,0,3
Collingwood,"Moore, Darcy",3,2,1,1,0,0,0,0
Collingwood,"Noble, John",17,8,2,9,0,0,0,1
Collingwood,"Pendlebury, Scott",32,18,2,14,0,0,0,3
Collingwood,"Phillips, Tom",21,12,4,9,2,0,0,2
Collingwood,"Quaynor, Isaac",11,8,3,3,0,0,0,2
Collingwood,"Roughead, Jordan",7,5,1,2,0,0,0,0
Collingwood,"Sidebottom, Steele",33,18,5,15,0,0,0,6
Collingwood,"Sier, Brayden",15,5,0,10,0,0,0,2
Collingwood,"Treloar, Adam",39,14,1,25,0,0,0,6
Collingwood,"de Goey, Jordan",22,14,2,8,2,2,0,2
Collingwood,"Adams, Taylor",32,15,3,17,0,0,0,7
Collingwood,"Aish, James",19,11,5,8,0,0,0,0
Collingwood,"Appleby, Flynn",7,3,2,4,0,0,0,1
Collingwood,"Brown, Callum",17,11,1,6,2,0,0,5
Collingwood,"Cox, Mason",4,3,3,1,0,0,6,0
Collingwood,"Crisp, Jack",29,13,5,16,0,2,0,4
Collingwood,"Crocker, Ben",7,7,5,0,2,0,0,2
Collingwood,"Grundy, Brodie",31,12,4,19,1,0,48,9
Collingwood,"Hoskin-Elliott, Will",11,6,2,5,1,1,0,3
Collingwood,"Howe, Jeremy",18,7,10,11,0,0,0,3
Collingwood,"Maynard, Brayden",20,13,3,7,0,0,0,4
Collingwood,"Mayne, Chris",8,3,2,5,0,0,0,1
Collingwood,"Mihocek, Brody",8,6,3,2,0,1,0,3
Collingwood,"Pendlebury, Scott",23,14,7,9,2,0,0,4
Collingwood,"Phillips, Tom",19,15,2,4,0,0,0,3
Collingwood,"Quaynor, Isaac",17,8,4,9,0,0,0,1
Collingwood,"Roughead, Jordan",19,9,7,10,0,0,0,1
Collingwood,"Sidebottom, Steele",26,14,7,12,1,0,0,3
Collingwood,"Sier, Brayden",12,4,1,8,1,0,0,6
Collingwood,"Treloar, Adam",34,16,3,18,0,0,0,5
Collingwood,"Varcoe, Travis",15,6,5,9,0,1,0,2
Collingwood,"de Goey, Jordan",18,10,3,8,1,2,0,3
Collingwood,"Brown, Callum",13,7,4,6,0,0,0,3
Collingwood,"Cox, Mason",11,7,4,4,0,1,6,1
Collingwood,"Crisp, Jack",26,14,5,12,0,0,0,3
Collingwood,"Crocker, Ben",6,5,3,1,1,1,0,4
Collingwood,"Daicos, Josh",11,4,2,7,0,0,0,3
Collingwood,"Elliott, Jamie",5,4,1,1,1,0,0,5
Collingwood,"Grundy, Brodie",9,6,2,3,0,2,36,3
Collingwood,"Hoskin-Elliott, Will",20,15,7,5,0,1,0,0
Collingwood,"Howe, Jeremy",18,15,5,3,0,0,0,1
Collingwood,"Maynard, Brayden",20,17,1,3,0,0,0,4
Collingwood,"Mayne, Chris",30,18,7,12,0,0,0,1
Collingwood,"Mihocek, Brody",12,8,4,4,2,0,0,0
Collingwood,"Pendlebury, Scott",28,14,4,14,2,0,0,1
Collingwood,"Phillips, Tom",19,12,2,7,0,0,0,0
Collingwood,"Quaynor, Isaac",12,8,4,4,0,0,0,3
Collingwood,"Roughead, Jordan",6,4,1,2,0,0,0,1
Collingwood,"Scharenberg, Matt",17,9,5,8,0,0,0,1
Collingwood,"Sidebottom, Steele",25,14,3,11,0,1,0,4
Collingwood,"Thomas, Josh",16,10,5,6,1,0,0,3
Collingwood,"Treloar, Adam",39,15,6,24,1,0,0,4
Collingwood,"Varcoe, Travis",15,8,4,7,0,0,0,3
Collingwood,"de Goey, Jordan",28,18,10,10,1,3,0,2
Collingwood,"Adams, Taylor",23,11,6,12,0,0,0,6
Collingwood,"Brown, Callum",14,7,5,7,1,0,0,2
Collingwood,"Cox, Mason",4,2,2,2,1,1,4,0
Collingwood,"Crisp, Jack",29,19,12,10,0,0,0,3
Collingwood,"Daicos, Josh",22,10,6,12,0,0,0,3
Collingwood,"Elliott, Jamie",12,11,7,1,2,2,0,0
Collingwood,"Greenwood, Levi",13,9,5,4,0,0,0,2
Collingwood,"Grundy, Brodie",26,15,6,11,1,0,43,5
Collingwood,"Hoskin-Elliott, Will",17,12,11,5,4,1,0,2
Collingwood,"Howe, Jeremy",21,16,11,5,0,0,0,0
Collingwood,"Maynard, Brayden",20,12,4,8,0,0,0,4
Collingwood,"Mayne, Chris",17,9,5,8,0,0,0,8
Collingwood,"Mihocek, Brody",14,7,10,7,2,2,0,2
Collingwood,"Pendlebury, Scott",24,14,4,10,1,1,0,10
Collingwood,"Phillips, Tom",25,20,8,5,0,0,0,0
Collingwood,"Roughead, Jordan",13,12,9,1,0,0,0,2
Collingwood,"Scharenberg, Matt",20,9,7,11,0,0,0,3
Collingwood,"Sidebottom, Steele",27,14,5,13,2,1,0,7
Collingwood,"Thomas, Josh",15,6,4,9,1,1,0,0
Collingwood,"Treloar, Adam",35,19,8,16,1,1,0,2
Collingwood,"Varcoe, Travis",12,6,6,6,2,1,0,1
Collingwood,"Wills, Rupert",23,5,2,18,0,0,0,6
Collingwood,"Adams, Taylor",23,14,4,9,0,0,0,7
Collingwood,"Brown, Callum",21,10,3,11,0,0,0,4
Collingwood,"Crisp, Jack",19,14,4,5,1,0,0,2
Collingwood,"Daicos, Josh",15,5,4,10,0,0,0,1
Collingwood,"Elliott, Jamie",11,8,6,3,0,3,0,3
Collingwood,"Greenwood, Levi",12,6,4,6,0,0,0,2
Collingwood,"Grundy, Brodie",16,9,2,7,0,0,44,7
Collingwood,"Hoskin-Elliott, Will",13,8,5,5,0,0,0,6
Collingwood,"Howe, Jeremy",22,15,8,7,0,0,0,0
Collingwood,"Madgen, Jack",14,11,6,3,0,0,0,1
Collingwood,"Maynard, Brayden",20,13,7,7,0,0,0,4
Collingwood,"Mayne, Chris",18,12,5,6,0,0,0,0
Collingwood,"Mihocek, Brody",12,8,7,4,4,1,0,6
Collingwood,"Pendlebury, Scott",23,11,4,12,2,0,0,4
Collingwood,"Phillips, Tom",24,18,6,6,0,0,0,4
Collingwood,"Roughead, Jordan",11,4,3,7,0,0,4,3
Collingwood,"Scharenberg, Matt",13,10,4,3,0,0,0,0
Collingwood,"Sidebottom, Steele",28,18,9,10,0,2,0,5
Collingwood,"Thomas, Josh",18,9,1,9,1,0,0,5
Collingwood,"Treloar, Adam",31,9,4,22,0,0,0,6
Collingwood,"Varcoe, Travis",10,6,6,4,2,0,0,1
Collingwood,"Wills, Rupert",16,3,1,13,0,0,0,10
Collingwood,"Adams, Taylor",24,11,3,13,2,1,0,5
Collingwood,"Brown, Callum",18,9,9,9,0,0,0,2
Collingwood,"Crisp, Jack",29,16,9,13,0,0,0,2
Collingwood,"Elliott, Jamie",19,16,10,3,5,2,0,0
Collingwood,"Greenwood, Levi",18,12,4,6,0,0,0,0
Collingwood,"Grundy, Brodie",17,6,5,11,0,0,35,2
Collingwood,"Hoskin-Elliott, Will",20,14,11,6,2,2,0,2
Collingwood,"Howe, Jeremy",23,18,11,5,0,0,0,0
Collingwood,"Madgen, Jack",9,5,5,4,0,0,0,3
Collingwood,"Maynard, Brayden",30,22,12,8,1,0,0,3
Collingwood,"Mayne, Chris",24,15,8,9,0,1,0,2
Collingwood,"Mihocek, Brody",12,9,5,3,0,1,0,2
Collingwood,"Noble, John",21,13,6,8,0,0,0,1
Collingwood,"Pendlebury, Scott",34,20,10,14,0,1,0,6
Collingwood,"Phillips, Tom",21,16,5,5,2,0,0,1
Collingwood,"Roughead, Jordan",11,4,7,7,0,0,5,2
Collingwood,"Scharenberg, Matt",15,8,3,7,0,0,0,0
Collingwood,"Sidebottom, Steele",21,11,7,10,0,0,0,0
Collingwood,"Thomas, Josh",11,7,4,4,3,1,0,1
Collingwood,"Treloar, Adam",27,13,2,14,0,0,0,5
Collingwood,"Varcoe, Travis",12,7,3,5,2,2,0,3
Collingwood,"Wills, Rupert",20,8,5,12,0,0,0,6
Collingwood,"Adams, Taylor",31,17,10,14,0,1,0,4
Collingwood,"Brown, Callum",14,10,4,4,0,1,0,3
Collingwood,"Crisp, Jack",27,16,5,11,0,0,0,2
Collingwood,"Elliott, Jamie",18,16,9,2,3,4,0,3
Collingwood,"Greenwood, Levi",16,7,3,9,0,0,0,3
Collingwood,"Grundy, Brodie",33,14,6,19,0,1,35,3
Collingwood,"Hoskin-Elliott, Will",14,10,9,4,0,0,0,0
Collingwood,"Howe, Jeremy",13,11,4,2,0,0,0,0
Collingwood,"Madgen, Jack",13,4,2,9,0,0,0,2
Collingwood,"Maynard, Brayden",13,8,2,5,0,1,0,3
Collingwood,"Mayne, Chris",31,14,8,17,0,0,0,3
Collingwood,"Mihocek, Brody",11,10,4,1,4,1,0,1
Collingwood,"Moore, Darcy",11,6,3,5,0,0,0,1
Collingwood,"Noble, John",20,12,7,8,0,0,0,1
Collingwood,"Pendlebury, Scott",33,11,5,22,0,0,0,4
Collingwood,"Phillips, Tom",24,15,4,9,0,1,0,4
Collingwood,"Roughead, Jordan",15,9,9,6,1,0,6,2
Collingwood,"Scharenberg, Matt",5,3,1,2,0,0,0,1
Collingwood,"Thomas, Josh",15,5,3,10,2,0,0,4
Collingwood,"Treloar, Adam",35,19,6,16,0,0,0,2
Collingwood,"Varcoe, Travis",12,7,5,5,0,0,0,2
Collingwood,"Wills, Rupert",16,3,2,13,0,0,0,5
Collingwood,"Adams, Taylor",26,16,3,10,2,0,0,9
Collingwood,"Brown, Callum",9,1,1,8,0,0,0,5
Collingwood,"Crisp, Jack",12,10,7,2,0,0,0,4
Collingwood,"Elliott, Jamie",18,13,7,5,2,1,0,2
Collingwood,"Greenwood, Levi",7,5,2,2,0,0,0,0
Collingwood,"Grundy, Brodie",21,11,4,10,0,0,47,5
Collingwood,"Hoskin-Elliott, Will",12,8,7,4,1,0,0,1
Collingwood,"Howe, Jeremy",23,19,13,4,1,0,0,1
Collingwood,"Maynard, Brayden",16,12,2,4,0,0,0,5
Collingwood,"Mayne, Chris",19,8,6,11,0,0,0,2
Collingwood,"Mihocek, Brody",14,7,5,7,0,2,0,4
Collingwood,"Moore, Darcy",17,12,9,5,0,0,0,2
Collingwood,"Noble, John",19,11,0,8,0,0,0,7
Collingwood,"Pendlebury, Scott",24,14,8,10,1,0,0,9
Collingwood,"Phillips, Tom",29,24,9,5,0,1,0,4
Collingwood,"Roughead, Jordan",7,5,3,2,0,0,1,3
Collingwood,"Sidebottom, Steele",33,27,15,6,1,0,0,5
Collingwood,"Stephenson, Jaidyn",18,11,10,7,1,1,0,1
Collingwood,"Thomas, Josh",15,7,3,8,0,0,0,4
Collingwood,"Treloar, Adam",28,11,5,17,0,0,0,9
Collingwood,"Wills, Rupert",13,6,4,7,0,0,0,13
Collingwood,"de Goey, Jordan",2,2,0,0,0,0,0,2
Collingwood,"Adams, Taylor",20,20,1,0,0,2,0,4
Collingwood,"Aish, James",8,5,2,3,0,0,0,6
Collingwood,"Brown, Callum",10,8,2,2,0,0,0,3
Collingwood,"Crisp, Jack",26,16,7,10,0,1,0,9
Collingwood,"Elliott, Jamie",13,9,6,4,1,1,0,4
Collingwood,"Grundy, Brodie",25,11,3,14,0,0,73,4
Collingwood,"Hoskin-Elliott, Will",8,7,5,1,0,0,0,1
Collingwood,"Howe, Jeremy",28,20,7,8,0,0,0,2
Collingwood,"Maynard, Brayden",23,14,3,9,0,0,0,8
Collingwood,"Mayne, Chris",9,4,3,5,1,0,0,4
Collingwood,"Mihocek, Brody",2,2,0,0,0,0,0,3
Collingwood,"Moore, Darcy",17,10,4,7,0,0,0,2
Collingwood,"Noble, John",16,11,5,5,0,1,0,1
Collingwood,"Pendlebury, Scott",18,12,2,6,0,1,0,9
Collingwood,"Phillips, Tom",18,12,4,6,0,0,0,3
Collingwood,"Reid, Ben",4,3,2,1,1,1,5,0
Collingwood,"Roughead, Jordan",8,7,1,1,0,0,0,1
Collingwood,"Sidebottom, Steele",16,9,4,7,0,0,0,5
Collingwood,"Stephenson, Jaidyn",16,10,5,6,2,0,0,2
Collingwood,"Thomas, Josh",14,9,4,5,2,0,0,4
Collingwood,"Treloar, Adam",22,7,0,15,0,0,0,8
Collingwood,"Wills, Rupert",16,3,1,13,0,0,0,12
Essendon,"Ambrose, Patrick",7,3,2,4,0,0,0,3
Essendon,"Baguley, Mark",8,5,5,3,1,0,0,2
Essendon,"Bellchambers, Tom",7,5,0,2,0,1,31,0
Essendon,"Brown, Mitch",9,6,4,3,0,1,0,0
Essendon,"Fantasia, Orazio",9,6,2,3,0,3,0,3
Essendon,"Francis, Aaron",11,6,4,5,1,0,0,1
Essendon,"Guelfi, Matt",7,4,1,3,0,0,0,3
Essendon,"Heppell, Dyson",25,16,8,9,0,0,0,4
Essendon,"Hurley, Michael",17,14,7,3,0,0,0,0
Essendon,"Langford, Kyle",18,12,4,6,2,1,0,2
Essendon,"McDonald-Tipungwuti, Anthony",5,3,1,2,0,0,0,5
Essendon,"McGrath, Andrew",23,14,4,9,0,0,0,3
Essendon,"McKenna, Conor",14,9,2,5,0,0,0,2
Essendon,"McKernan, Shaun",5,5,1,0,0,1,10,1
Essendon,"Merrett, Zach",16,5,1,11,0,0,0,3
Essendon,"Myers, David",12,7,2,5,0,1,0,5
Essendon,"Ridley, Jordan",14,10,6,4,0,0,0,1
Essendon,"Saad, Adam",19,12,3,7,0,0,0,5
Essendon,"Shiel, Dylan",25,10,2,15,0,1,0,2
Essendon,"Smith, Devon",23,15,6,8,0,0,0,4
Essendon,"Stringer, Jake",10,7,1,3,1,0,0,7
Essendon,"Zaharakis, David",25,13,7,12,0,0,0,2
Essendon,"Ambrose, Patrick",10,5,5,5,0,0,0,4
Essendon,"Baguley, Mark",7,5,2,2,1,0,0,3
Essendon,"Bellchambers, Tom",10,6,4,4,1,0,40,0
Essendon,"Brown, Mitch",13,10,8,3,1,0,0,2
Essendon,"Fantasia, Orazio",13,8,3,5,0,4,0,2
Essendon,"Francis, Aaron",13,11,9,2,0,0,0,1
Essendon,"Guelfi, Matt",14,10,4,4,0,0,0,4
Essendon,"Heppell, Dyson",23,10,3,13,2,0,0,4
Essendon,"Hurley, Michael",23,16,14,7,0,0,0,1
Essendon,"Langford, Kyle",15,8,4,7,0,0,0,3
Essendon,"McDonald-Tipungwuti, Anthony",7,4,1,3,0,0,0,4
Essendon,"McGrath, Andrew",20,11,6,9,0,0,0,0
Essendon,"McKenna, Conor",17,12,1,5,0,0,0,1
Essendon,"McKernan, Shaun",12,7,4,5,1,2,11,1
Essendon,"Merrett, Zach",28,15,3,13,0,1,0,4
Essendon,"Myers, David",20,12,2,8,1,0,0,4
Essendon,"Parish, Darcy",17,10,4,7,0,0,0,3
Essendon,"Saad, Adam",19,10,4,9,0,0,0,5
Essendon,"Shiel, Dylan",27,14,5,13,0,1,0,5
Essendon,"Smith, Devon",19,11,1,8,1,0,0,6
Essendon,"Stringer, Jake",16,12,2,4,1,2,0,3
Essendon,"Zaharakis, David",18,6,4,12,0,0,0,4
Essendon,"Ambrose, Patrick",10,6,3,4,0,0,0,3
Essendon,"Baguley, Mark",10,5,3,5,1,0,0,2
Essendon,"Bellchambers, Tom",10,6,1,4,0,0,21,3
Essendon,"Clarke, Zac",10,2,3,8,0,1,13,2
Essendon,"Fantasia, Orazio",21,17,10,4,2,0,0,2
Essendon,"Francis, Aaron",13,8,6,5,0,0,0,2
Essendon,"Guelfi, Matt",15,8,2,7,0,0,0,1
Essendon,"Heppell, Dyson",27,13,8,14,0,1,0,5
Essendon,"Hurley, Michael",17,16,6,1,0,0,0,0
Essendon,"McDonald-Tipungwuti, Anthony",14,9,4,5,4,0,0,3
Essendon,"McGrath, Andrew",23,10,2,13,1,0,0,3
Essendon,"McKenna, Conor",20,17,3,3,0,0,0,3
Essendon,"McKernan, Shaun",13,5,5,8,4,1,0,3
Essendon,"Merrett, Zach",26,12,1,14,0,0,0,7
Essendon,"Mutch, Kobe",0,0,0,0,0,0,0,0
Essendon,"Parish, Darcy",24,16,4,8,1,3,0,3
Essendon,"Ridley, Jordan",14,9,6,5,0,0,0,2
Essendon,"Saad, Adam",15,7,2,8,0,0,0,2
Essendon,"Shiel, Dylan",31,16,4,15,0,2,0,4
Essendon,"Smith, Devon",15,12,4,3,2,0,0,9
Essendon,"Stringer, Jake",10,9,3,1,4,1,0,6
Essendon,"Zaharakis, David",31,19,4,12,1,0,0,4
Essendon,"Ambrose, Patrick",7,5,3,2,0,0,0,2
Essendon,"Baguley, Mark",10,7,2,3,1,1,0,3
Essendon,"Bellchambers, Tom",6,4,1,2,0,0,16,1
Essendon,"Brown, Mitch",25,15,11,10,3,1,0,1
Essendon,"Clarke, Zac",11,3,3,8,0,1,9,2
Essendon,"Fantasia, Orazio",14,4,0,10,2,0,0,1
Essendon,"Heppell, Dyson",22,14,5,8,0,0,0,4
Essendon,"Hooker, Cale",23,11,13,12,0,0,0,0
Essendon,"Hurley, Michael",21,17,6,4,0,0,0,1
Essendon,"McDonald-Tipungwuti, Anthony",20,16,10,4,7,1,0,3
Essendon,"McGrath, Andrew",19,13,3,6,2,0,0,2
Essendon,"McKenna, Conor",20,12,3,8,0,0,0,0
Essendon,"Merrett, Zach",35,15,4,20,1,0,0,6
Essendon,"Myers, David",19,6,3,13,0,0,0,1
Essendon,"Parish, Darcy",19,13,5,6,0,0,0,5
Essendon,"Redman, Mason",17,11,4,6,0,0,0,4
Essendon,"Ridley, Jordan",17,11,9,6,0,0,0,1
Essendon,"Saad, Adam",12,6,0,6,0,0,0,5
Essendon,"Shiel, Dylan",28,12,2,16,0,0,0,6
Essendon,"Smith, Devon",19,10,3,9,0,1,0,6
Essendon,"Stringer, Jake",13,10,3,3,1,4,0,0
Essendon,"Zaharakis, David",30,18,10,12,0,0,0,2
Essendon,"Ambrose, Patrick",6,3,4,3,1,0,0,0
Essendon,"Baguley, Mark",10,4,1,6,0,0,0,2
Essendon,"Bellchambers, Tom",13,5,7,8,0,1,23,0
Essendon,"Brown, Mitch",20,13,7,7,3,3,0,0
Essendon,"Daniher, Joe",10,7,5,3,2,1,6,3
Essendon,"Fantasia, Orazio",18,12,3,6,4,1,0,4
Essendon,"Guelfi, Matt",21,8,4,13,0,0,0,2
Essendon,"Ham, Brayden",10,6,3,4,1,0,0,5
Essendon,"Heppell, Dyson",32,17,10,15,0,0,0,3
Essendon,"Hooker, Cale",22,15,11,7,0,0,0,0
Essendon,"Hurley, Michael",25,16,12,9,0,0,0,1
Essendon,"McDonald-Tipungwuti, Anthony",11,7,2,4,2,0,0,4
Essendon,"McGrath, Andrew",20,11,5,9,2,0,0,0
Essendon,"McKenna, Conor",26,17,2,9,0,1,0,1
Essendon,"Merrett, Zach",39,18,4,21,0,0,0,9
Essendon,"Myers, David",17,6,2,11,0,0,0,4
Essendon,"Parish, Darcy",16,11,5,5,0,1,0,4
Essendon,"Redman, Mason",15,9,4,6,0,0,0,4
Essendon,"Ridley, Jordan",13,12,6,1,0,0,0,2
Essendon,"Saad, Adam",18,9,2,9,0,0,0,2
Essendon,"Shiel, Dylan",36,23,7,13,0,1,0,3
Essendon,"Stringer, Jake",9,8,5,1,2,2,0,5
Essendon,"Ambrose, Patrick",10,5,5,5,0,0,0,2
Essendon,"Baguley, Mark",13,5,3,8,3,0,0,3
Essendon,"Bellchambers, Tom",18,9,5,9,0,0,18,5
Essendon,"Brown, Mitch",7,5,3,2,0,0,0,0
Essendon,"Daniher, Joe",16,13,8,3,4,0,1,1
Essendon,"Guelfi, Matt",17,8,3,9,1,0,0,6
Essendon,"Heppell, Dyson",28,11,3,17,0,1,0,6
Essendon,"Hooker, Cale",14,6,6,8,0,0,0,1
Essendon,"Hurley, Michael",20,14,6,6,0,0,0,1
Essendon,"McDonald-Tipungwuti, Anthony",15,5,2,10,0,0,0,8
Essendon,"McGrath, Andrew",15,5,4,10,0,0,0,6
Essendon,"McKenna, Conor",21,13,2,8,0,0,0,0
Essendon,"Merrett, Zach",30,15,8,15,0,0,0,3
Essendon,"Myers, David",14,7,1,7,0,1,0,2
Essendon,"Parish, Darcy",21,9,2,12,0,0,0,5
Essendon,"Redman, Mason",14,10,7,4,0,0,0,2
Essendon,"Ridley, Jordan",18,14,9,4,0,0,0,3
Essendon,"Saad, Adam",19,9,5,10,0,0,0,5
Essendon,"Shiel, Dylan",34,22,5,12,0,2,0,7
Essendon,"Smith, Devon",14,9,2,5,0,0,0,1
Essendon,"Stringer, Jake",16,11,7,5,2,2,0,1
Essendon,"Zaharakis, David",18,8,3,10,0,0,0,5
Essendon,"Ambrose, Patrick",8,5,2,3,0,0,0,2
Essendon,"Baguley, Mark",8,4,1,4,1,0,0,6
Essendon,"Bellchambers, Tom",11,6,2,5,1,0,21,2
Essendon,"Daniher, Joe",9,4,3,5,1,0,4,1
Essendon,"Francis, Aaron",12,9,7,3,0,2,0,2
Essendon,"Guelfi, Matt",9,4,4,5,0,0,0,3
Essendon,"Heppell, Dyson",24,13,6,11,0,0,0,2
Essendon,"Hooker, Cale",18,12,6,6,0,0,0,1
Essendon,"Hurley, Michael",21,13,9,8,0,0,0,0
Essendon,"Langford, Kyle",16,10,8,6,0,2,0,3
Essendon,"McDonald-Tipungwuti, Anthony",9,3,1,6,0,0,0,4
Essendon,"McGrath, Andrew",17,8,4,9,0,1,0,8
Essendon,"McKenna, Conor",20,10,3,10,0,0,0,0
Essendon,"Merrett, Zach",29,13,7,16,0,0,0,3
Essendon,"Parish, Darcy",25,10,3,15,1,1,0,3
Essendon,"Redman, Mason",12,7,3,5,0,0,0,4
Essendon,"Ridley, Jordan",13,9,6,4,0,0,0,2
Essendon,"Saad, Adam",19,9,4,10,0,0,0,2
Essendon,"Shiel, Dylan",33,11,3,22,0,0,0,4
Essendon,"Smith, Devon",24,18,3,6,0,1,0,4
Essendon,"Stringer, Jake",18,12,5,6,3,2,0,2
Essendon,"Zaharakis, David",16,9,4,7,0,0,0,1
Essendon,"Ambrose, Patrick",13,5,3,8,0,0,0,3
Essendon,"Bellchambers, Tom",13,8,1,5,1,0,30,4
Essendon,"Clarke, Zac",5,3,2,2,0,2,13,4
Essendon,"Fantasia, Orazio",11,7,3,4,4,0,0,2
Essendon,"Francis, Aaron",12,9,5,3,0,0,0,1
Essendon,"Guelfi, Matt",14,10,3,4,0,0,0,1
Essendon,"Ham, Brayden",5,4,1,1,0,1,0,4
Essendon,"Heppell, Dyson",30,19,4,11,0,0,0,2
Essendon,"Hooker, Cale",19,12,8,7,0,1,0,2
Essendon,"Hurley, Michael",21,16,11,5,0,0,0,1
Essendon,"McDonald-Tipungwuti, Anthony",9,4,2,5,0,0,0,8
Essendon,"McGrath, Andrew",25,14,4,11,0,0,0,4
Essendon,"McKenna, Conor",14,14,3,0,1,0,0,1
Essendon,"Merrett, Zach",28,18,5,10,1,1,0,9
Essendon,"Myers, David",11,7,2,4,0,0,0,1
Essendon,"Parish, Darcy",10,6,2,4,2,0,0,2
Essendon,"Redman, Mason",15,9,9,6,0,0,0,3
Essendon,"Saad, Adam",17,8,4,9,0,0,0,4
Essendon,"Shiel, Dylan",17,12,3,5,0,0,0,8
Essendon,"Smith, Devon",13,4,0,9,0,0,0,10
Essendon,"Stringer, Jake",8,6,2,2,1,2,0,6
Essendon,"Zaharakis, David",19,14,6,5,0,0,0,5
Essendon,"Ambrose, Patrick",10,3,3,7,0,0,0,2
Essendon,"Baguley, Mark",14,7,5,7,0,1,0,1
Essendon,"Begley, Josh",12,7,5,5,0,4,0,3
Essendon,"Bellchambers, Tom",13,4,2,9,0,1,28,1
Essendon,"Daniher, Joe",16,9,6,7,0,4,5,3
Essendon,"Francis, Aaron",15,7,6,8,1,0,0,1
Essendon,"Guelfi, Matt",17,6,5,11,0,0,0,3
Essendon,"Heppell, Dyson",27,14,2,13,0,0,0,0
Essendon,"Hooker, Cale",20,11,7,9,0,0,0,1
Essendon,"Hurley, Michael",23,14,6,9,0,0,0,1
Essendon,"Langford, Kyle",24,9,4,15,0,0,0,2
Essendon,"McDonald-Tipungwuti, Anthony",10,6,3,4,3,0,0,3
Essendon,"McGrath, Andrew",20,10,2,10,0,0,0,1
Essendon,"McKenna, Conor",20,12,2,8,0,0,0,1
Essendon,"McNiece, Ben",10,7,2,3,0,0,0,2
Essendon,"Merrett, Zach",35,11,6,24,0,0,0,6
Essendon,"Parish, Darcy",24,12,3,12,0,0,0,1
Essendon,"Redman, Mason",20,15,7,5,0,0,0,2
Essendon,"Saad, Adam",23,13,2,10,0,0,0,6
Essendon,"Shiel, Dylan",25,17,3,8,2,0,0,5
Essendon,"Stringer, Jake",17,16,5,1,1,1,0,4
Essendon,"Zaharakis, David",32,19,6,13,1,0,0,5
Essendon,"Ambrose, Patrick",13,7,4,6,0,2,0,2
Essendon,"Begley, Josh",9,7,1,2,1,2,0,1
Essendon,"Bellchambers, Tom",15,10,4,5,1,0,39,4
Essendon,"Francis, Aaron",12,3,3,9,0,0,0,4
Essendon,"Guelfi, Matt",12,9,3,3,0,0,0,5
Essendon,"Heppell, Dyson",26,13,3,13,0,1,0,1
Essendon,"Hooker, Cale",14,9,4,5,0,0,0,2
Essendon,"Hurley, Michael",17,13,2,4,0,0,0,0
Essendon,"Langford, Kyle",22,13,5,9,3,0,0,3
Essendon,"Laverde, Jayden",10,5,2,5,1,1,0,6
Essendon,"McDonald-Tipungwuti, Anthony",6,4,1,2,0,1,0,4
Essendon,"McGrath, Andrew",22,12,0,10,0,0,0,3
Essendon,"McKenna, Conor",17,12,2,5,0,0,0,0
Essendon,"McKernan, Shaun",12,8,5,4,0,0,8,2
Essendon,"McNiece, Ben",4,2,1,2,0,0,0,1
Essendon,"Merrett, Zach",30,17,3,13,0,2,0,8
Essendon,"Parish, Darcy",31,18,0,13,0,0,0,5
Essendon,"Redman, Mason",13,8,2,5,0,1,0,3
Essendon,"Saad, Adam",17,11,2,6,0,0,0,6
Essendon,"Shiel, Dylan",23,14,1,9,0,0,0,4
Essendon,"Stringer, Jake",7,4,1,3,0,2,0,4
Essendon,"Zaharakis, David",19,17,5,2,0,0,0,3
Essendon,"Ambrose, Patrick",6,5,4,1,0,0,0,1
Essendon,"Baguley, Mark",9,6,2,3,2,0,0,5
Essendon,"Begley, Josh",15,10,4,5,0,0,0,3
Essendon,"Bellchambers, Tom",2,0,2,2,0,0,39,3
Essendon,"Clarke, Dylan",23,10,4,13,0,0,0,10
Essendon,"Francis, Aaron",8,2,1,6,0,0,0,2
Essendon,"Guelfi, Matt",22,13,5,9,0,0,0,7
Essendon,"Heppell, Dyson",36,17,5,19,1,0,0,2
Essendon,"Hooker, Cale",31,16,11,15,0,0,0,1
Essendon,"Hurley, Michael",28,19,12,9,0,0,0,0
Essendon,"Langford, Kyle",16,10,3,6,1,0,0,4
Essendon,"Laverde, Jayden",12,8,5,4,2,2,0,4
Essendon,"McDonald-Tipungwuti, Anthony",13,8,2,5,3,1,0,7
Essendon,"McGrath, Andrew",32,16,6,16,0,0,0,2
Essendon,"McKenna, Conor",25,13,6,12,0,0,0,1
Essendon,"McKernan, Shaun",9,8,4,1,0,1,5,1
Essendon,"McNiece, Ben",16,9,4,7,0,0,0,2
Essendon,"Merrett, Zach",22,13,4,9,0,1,0,8
Essendon,"Parish, Darcy",31,16,2,15,2,0,0,3
Essendon,"Redman, Mason",18,16,4,2,0,0,0,0
Essendon,"Saad, Adam",19,16,5,3,0,0,0,1
Essendon,"Zaharakis, David",25,15,5,10,0,2,0,1
Essendon,"Ambrose, Patrick",10,6,2,4,0,0,0,3
Essendon,"Begley, Josh",10,7,5,3,2,0,0,2
Essendon,"Bellchambers, Tom",9,6,6,3,1,1,17,0
Essendon,"Clarke, Dylan",23,6,1,17,0,0,0,3
Essendon,"Fantasia, Orazio",14,10,3,4,2,1,0,3
Essendon,"Guelfi, Matt",15,7,4,8,1,0,0,1
Essendon,"Heppell, Dyson",28,13,9,15,0,2,0,3
Essendon,"Hooker, Cale",22,16,12,6,0,0,0,1
Essendon,"Hurley, Michael",26,23,12,3,0,0,0,0
Essendon,"Langford, Kyle",21,13,3,8,2,0,0,2
Essendon,"Laverde, Jayden",18,9,5,9,0,3,0,1
Essendon,"McDonald-Tipungwuti, Anthony",7,5,4,2,0,1,0,4
Essendon,"McGrath, Andrew",22,8,6,14,0,0,0,1
Essendon,"McKenna, Conor",25,19,4,6,0,0,0,1
Essendon,"McKernan, Shaun",15,11,6,4,1,2,3,0
Essendon,"Merrett, Zach",28,13,3,15,1,0,0,3
Essendon,"Parish, Darcy",21,13,2,8,1,1,0,5
Essendon,"Redman, Mason",14,7,6,7,0,0,0,1
Essendon,"Saad, Adam",20,13,5,7,1,0,0,2
Essendon,"Shiel, Dylan",20,15,4,5,0,0,0,3
Essendon,"Stringer, Jake",8,7,4,1,2,0,0,0
Essendon,"Zaharakis, David",19,13,7,6,0,0,0,4
Essendon,"Ambrose, Patrick",10,7,5,3,0,0,0,1
Essendon,"Begley, Josh",15,12,5,3,3,0,0,1
Essendon,"Bellchambers, Tom",17,12,5,5,1,0,27,1
Essendon,"Brown, Mitch",16,10,7,6,1,0,0,0
Essendon,"Clarke, Dylan",15,7,2,8,0,0,0,6
Essendon,"Fantasia, Orazio",6,3,3,3,0,0,0,1
Essendon,"Guelfi, Matt",3,2,1,1,0,0,0,0
Essendon,"Heppell, Dyson",30,8,6,22,0,0,0,0
Essendon,"Hooker, Cale",28,17,15,11,0,0,0,0
Essendon,"Hurley, Michael",17,13,8,4,0,0,0,0
Essendon,"Langford, Kyle",15,10,3,5,0,0,0,7
Essendon,"Laverde, Jayden",13,8,5,5,2,0,0,1
Essendon,"McDonald-Tipungwuti, Anthony",6,2,1,4,1,0,0,4
Essendon,"McGrath, Andrew",18,9,2,9,1,0,0,2
Essendon,"McKenna, Conor",17,12,4,5,0,0,0,1
Essendon,"McKernan, Shaun",9,3,1,6,0,0,9,0
Essendon,"Merrett, Zach",30,15,2,15,0,1,0,6
Essendon,"Parish, Darcy",27,15,7,12,1,0,0,0
Essendon,"Redman, Mason",22,16,5,6,0,1,0,4
Essendon,"Saad, Adam",12,11,1,1,0,0,0,1
Essendon,"Shiel, Dylan",22,12,3,10,1,1,0,6
Essendon,"Zaharakis, David",24,13,6,11,0,0,0,2
Essendon,"Begley, Josh",6,4,3,2,0,1,0,2
Essendon,"Bellchambers, Tom",11,8,4,3,0,0,27,2
Essendon,"Brown, Mitch",8,4,2,4,1,0,0,3
Essendon,"Clarke, Dylan",10,6,3,4,0,0,0,9
Essendon,"Fantasia, Orazio",8,3,3,5,1,0,0,3
Essendon,"Francis, Aaron",16,11,3,5,0,0,0,5
Essendon,"Gleeson, Martin",13,7,2,6,0,0,0,1
Essendon,"Heppell, Dyson",22,11,6,11,0,0,0,5
Essendon,"Hooker, Cale",15,6,4,9,2,0,1,0
Essendon,"Hurley, Michael",12,9,6,3,0,0,0,1
Essendon,"Langford, Kyle",21,12,3,9,1,0,0,7
Essendon,"Laverde, Jayden",9,7,1,2,2,1,0,2
Essendon,"McDonald-Tipungwuti, Anthony",11,7,2,4,0,0,0,7
Essendon,"McGrath, Andrew",13,5,2,8,0,0,0,3
Essendon,"McKenna, Conor",17,12,1,5,0,0,0,1
Essendon,"McKernan, Shaun",12,10,8,2,2,0,19,2
Essendon,"Merrett, Zach",28,17,6,11,0,1,0,2
Essendon,"Parish, Darcy",15,9,1,6,1,0,0,8
Essendon,"Redman, Mason",17,8,0,9,0,0,0,4
Essendon,"Saad, Adam",20,14,4,6,0,0,0,3
Essendon,"Shiel, Dylan",22,13,3,9,1,0,0,5
Essendon,"Zaharakis, David",19,11,6,8,1,0,0,4
Essendon,"Brown, Mitch",14,8,5,6,0,2,0,0
Essendon,"Clarke, Dylan",10,5,4,5,0,0,0,4
Essendon,"Clarke, Zac",5,3,1,2,0,0,24,0
Essendon,"Fantasia, Orazio",11,3,2,8,1,1,0,1
Essendon,"Francis, Aaron",15,10,4,5,0,0,0,2
Essendon,"Gleeson, Martin",15,8,3,7,0,0,0,1
Essendon,"Guelfi, Matt",17,12,2,5,0,0,0,1
Essendon,"Hooker, Cale",13,5,7,8,0,0,0,1
Essendon,"Hurley, Michael",23,18,12,5,0,0,0,0
Essendon,"Langford, Kyle",17,11,2,6,1,0,0,4
Essendon,"Laverde, Jayden",10,3,2,7,0,2,0,1
Essendon,"McDonald-Tipungwuti, Anthony",14,11,8,3,1,1,0,2
Essendon,"McGrath, Andrew",21,14,5,7,0,0,0,1
Essendon,"McKenna, Conor",21,13,2,8,0,0,0,1
Essendon,"McKernan, Shaun",17,12,7,5,2,1,11,2
Essendon,"Merrett, Zach",18,9,2,9,0,0,0,1
Essendon,"Parish, Darcy",22,11,3,11,1,0,0,3
Essendon,"Redman, Mason",14,10,2,4,0,0,0,4
Essendon,"Saad, Adam",19,13,2,6,0,0,0,2
Essendon,"Shiel, Dylan",29,16,3,13,0,3,0,9
Essendon,"Stringer, Jake",10,7,1,3,2,0,0,2
Essendon,"Zaharakis, David",22,16,7,6,3,0,0,2
Essendon,"Brown, Mitch",14,12,9,2,2,2,0,0
Essendon,"Clarke, Dylan",13,4,2,9,0,0,0,12
Essendon,"Clarke, Zac",12,6,6,6,0,0,35,3
Essendon,"Fantasia, Orazio",5,3,1,2,0,0,0,4
Essendon,"Francis, Aaron",10,5,3,5,0,0,0,3
Essendon,"Gleeson, Martin",21,13,8,8,0,0,0,2
Essendon,"Guelfi, Matt",16,13,3,3,0,0,0,4
Essendon,"Hooker, Cale",12,6,5,6,0,0,0,2
Essendon,"Hurley, Michael",8,7,3,1,0,0,0,0
Essendon,"Langford, Kyle",13,8,3,5,1,0,0,1
Essendon,"Laverde, Jayden",15,10,7,5,1,2,0,1
Essendon,"McDonald-Tipungwuti, Anthony",19,11,3,8,4,2,0,4
Essendon,"McGrath, Andrew",22,9,1,13,0,0,0,4
Essendon,"McKenna, Conor",25,16,1,9,1,0,0,3
Essendon,"McKernan, Shaun",10,8,5,2,0,1,4,3
Essendon,"Merrett, Zach",34,11,3,23,0,0,0,6
Essendon,"Parish, Darcy",20,11,2,9,0,1,0,4
Essendon,"Redman, Mason",15,13,3,2,0,0,0,5
Essendon,"Saad, Adam",22,14,2,8,0,0,0,4
Essendon,"Shiel, Dylan",22,11,1,11,0,0,0,5
Essendon,"Stringer, Jake",16,14,2,2,3,2,0,1
Essendon,"Zaharakis, David",14,10,3,4,0,0,0,2
Essendon,"Ambrose, Patrick",15,7,6,8,0,0,0,2
Essendon,"Brown, Mitch",23,14,8,9,4,0,0,1
Essendon,"Clarke, Dylan",19,8,2,11,0,0,0,6
Essendon,"Francis, Aaron",17,7,3,10,0,1,0,1
Essendon,"Gleeson, Martin",20,11,5,9,0,0,0,3
Essendon,"Guelfi, Matt",9,6,3,3,1,0,0,3
Essendon,"Hartley, Michael",16,8,7,8,0,0,4,3
Essendon,"Heppell, Dyson",20,7,1,13,1,0,0,5
Essendon,"Hooker, Cale",19,10,7,9,1,1,0,1
Essendon,"Langford, Kyle",13,2,3,11,0,0,0,2
Essendon,"McDonald-Tipungwuti, Anthony",13,8,3,5,1,0,0,2
Essendon,"McGrath, Andrew",17,10,2,7,1,0,0,2
Essendon,"McKenna, Conor",24,15,0,9,0,0,0,2
Essendon,"McKernan, Shaun",16,11,1,5,0,0,22,4
Essendon,"Merrett, Zach",31,20,5,11,2,3,0,3
Essendon,"Parish, Darcy",18,8,1,10,0,1,0,6
Essendon,"Redman, Mason",25,16,5,9,0,0,0,1
Essendon,"Saad, Adam",14,11,4,3,0,0,0,3
Essendon,"Shiel, Dylan",23,9,0,14,1,0,0,6
Essendon,"Snelling, Will",15,5,2,10,1,0,0,3
Essendon,"Stringer, Jake",13,7,1,6,2,0,0,5
Essendon,"Zaharakis, David",25,12,6,13,0,0,0,2
Essendon,"Ambrose, Patrick",9,6,3,3,0,0,0,4
Essendon,"Brown, Mitch",12,6,5,6,3,0,1,2
Essendon,"Clarke, Dylan",22,8,0,14,0,0,0,4
Essendon,"Clarke, Zac",14,3,0,11,0,0,24,4
Essendon,"Francis, Aaron",9,6,4,3,0,0,0,0
Essendon,"Gleeson, Martin",16,12,5,4,0,0,0,0
Essendon,"Guelfi, Matt",12,8,3,4,0,0,0,1
Essendon,"Hooker, Cale",14,10,9,4,1,0,0,0
Essendon,"Langford, Kyle",16,7,1,9,1,0,0,3
Essendon,"Laverde, Jayden",7,2,1,5,0,1,0,3
Essendon,"McDonald-Tipungwuti, Anthony",12,9,2,3,0,1,0,6
Essendon,"McGrath, Andrew",19,7,2,12,1,1,0,2
Essendon,"McKernan, Shaun",15,11,8,4,4,1,4,2
Essendon,"McNiece, Ben",13,5,1,8,0,0,0,2
Essendon,"Merrett, Zach",27,15,4,12,0,0,0,5
Essendon,"Parish, Darcy",19,9,4,10,1,0,0,4
Essendon,"Redman, Mason",24,15,4,9,0,0,0,2
Essendon,"Saad, Adam",16,9,3,7,0,0,0,7
Essendon,"Shiel, Dylan",28,14,4,14,1,0,0,7
Essendon,"Snelling, Will",18,5,2,13,0,0,0,4
Essendon,"Stringer, Jake",15,13,3,2,4,2,0,4
Essendon,"Zaharakis, David",16,8,4,8,0,0,0,2
Essendon,"Ambrose, Patrick",10,6,5,4,0,0,0,1
Essendon,"Brown, Mitch",19,12,5,7,0,3,2,1
Essendon,"Clarke, Dylan",14,6,2,8,0,0,0,3
Essendon,"Clarke, Zac",10,7,5,3,0,1,16,2
Essendon,"Fantasia, Orazio",11,7,3,4,2,0,0,1
Essendon,"Francis, Aaron",14,8,3,6,1,0,0,2
Essendon,"Gleeson, Martin",17,11,6,6,0,0,0,0
Essendon,"Guelfi, Matt",13,8,5,5,0,2,0,4
Essendon,"Hartley, Michael",16,12,6,4,0,0,0,2
Essendon,"Hooker, Cale",13,9,5,4,0,0,1,1
Essendon,"Langford, Kyle",15,7,3,8,0,0,0,1
Essendon,"McDonald-Tipungwuti, Anthony",10,5,2,5,0,2,0,2
Essendon,"McGrath, Andrew",20,8,3,12,0,1,0,1
Essendon,"McKenna, Conor",21,17,3,4,0,0,0,2
Essendon,"Merrett, Zach",31,17,5,14,1,0,0,4
Essendon,"Parish, Darcy",7,2,1,5,0,0,0,0
Essendon,"Redman, Mason",19,14,1,5,0,0,0,0
Essendon,"Saad, Adam",11,9,1,2,0,0,0,3
Essendon,"Shiel, Dylan",29,10,3,19,1,1,0,1
Essendon,"Snelling, Will",21,7,3,14,2,0,0,5
Essendon,"Stringer, Jake",14,11,3,3,2,2,0,6
Essendon,"Zaharakis, David",19,7,3,12,0,0,0,1
Essendon,"Ambrose, Patrick",11,9,4,2,0,0,0,5
Essendon,"Baguley, Mark",10,5,5,5,2,0,0,1
Essendon,"Begley, Josh",12,7,3,5,0,0,0,1
Essendon,"Brown, Mitch",10,7,5,3,0,1,0,1
Essendon,"Clarke, Dylan",13,4,2,9,0,1,0,9
Essendon,"Clarke, Zac",9,2,1,7,0,0,38,2
Essendon,"Fantasia, Orazio",8,5,2,3,0,0,0,1
Essendon,"Gleeson, Martin",14,11,3,3,0,0,0,1
Essendon,"Heppell, Dyson",21,9,2,12,0,0,0,1
Essendon,"Hooker, Cale",12,6,5,6,0,0,0,1
Essendon,"Langford, Kyle",24,11,6,13,0,0,0,4
Essendon,"McDonald-Tipungwuti, Anthony",12,9,4,3,1,0,0,2
Essendon,"McGrath, Andrew",21,11,3,10,0,0,0,5
Essendon,"McKenna, Conor",19,16,3,3,0,0,0,4
Essendon,"McKernan, Shaun",12,9,6,3,0,0,5,3
Essendon,"McNiece, Ben",9,4,2,5,0,0,0,0
Essendon,"Merrett, Zach",33,24,8,9,0,0,0,6
Essendon,"Myers, David",11,6,3,5,0,0,0,4
Essendon,"Redman, Mason",16,12,5,4,0,0,0,5
Essendon,"Shiel, Dylan",23,14,4,9,1,1,0,4
Essendon,"Stringer, Jake",7,5,1,2,0,1,0,3
Essendon,"Zaharakis, David",13,9,3,4,0,0,0,2
Essendon,"Ambrose, Patrick",7,5,3,2,0,0,0,3
Essendon,"Brown, Mitch",16,13,9,3,2,0,0,2
Essendon,"Clarke, Zac",14,4,2,10,0,1,16,4
Essendon,"Fantasia, Orazio",11,6,5,5,1,0,0,1
Essendon,"Francis, Aaron",12,5,5,7,0,0,0,1
Essendon,"Gleeson, Martin",15,9,4,6,0,1,0,1
Essendon,"Ham, Brayden",16,12,6,4,0,1,0,1
Essendon,"Heppell, Dyson",21,9,6,12,0,0,0,5
Essendon,"Hurley, Michael",19,13,7,6,0,0,0,0
Essendon,"Langford, Kyle",17,5,3,12,2,0,0,4
Essendon,"McDonald-Tipungwuti, Anthony",13,7,3,6,1,0,0,4
Essendon,"McGrath, Andrew",17,12,3,5,0,0,0,2
Essendon,"McKenna, Conor",24,16,4,8,0,0,0,4
Essendon,"McKernan, Shaun",15,13,8,2,1,0,1,0
Essendon,"Merrett, Zach",23,16,4,7,2,0,0,10
Essendon,"Parish, Darcy",22,4,1,18,1,0,0,4
Essendon,"Redman, Mason",18,11,6,7,0,0,0,7
Essendon,"Saad, Adam",27,16,4,11,0,0,0,3
Essendon,"Shiel, Dylan",27,19,3,8,1,2,0,6
Essendon,"Stringer, Jake",13,9,5,4,2,2,0,2
Essendon,"Zaharakis, David",2,1,0,1,0,0,0,3
Essendon,"Zerk-Thatcher, Brandon",11,10,6,1,0,0,0,3
Essendon,"Ambrose, Patrick",15,7,5,8,0,1,0,4
Essendon,"Begley, Josh",14,7,2,7,0,0,0,2
Essendon,"Bellchambers, Tom",12,7,5,5,0,0,14,3
Essendon,"Brown, Mitch",10,7,5,3,1,0,0,3
Essendon,"Clarke, Dylan",8,4,0,4,0,0,0,4
Essendon,"Francis, Aaron",16,8,5,8,0,0,0,2
Essendon,"Gleeson, Martin",18,10,4,8,0,0,0,1
Essendon,"Ham, Brayden",8,6,2,2,2,0,0,0
Essendon,"Hartley, Michael",11,8,4,3,0,0,0,1
Essendon,"Hurley, Michael",12,8,6,4,0,0,0,0
Essendon,"Jok, Tom",12,6,5,6,0,0,0,3
Essendon,"Langford, Kyle",16,5,2,11,1,0,0,4
Essendon,"Laverde, Jayden",11,7,6,4,2,1,0,2
Essendon,"McDonald-Tipungwuti, Anthony",18,14,2,4,2,1,0,5
Essendon,"McGrath, Andrew",28,13,6,15,0,0,0,4
Essendon,"McKenna, Conor",35,27,5,8,0,0,0,1
Essendon,"McKernan, Shaun",18,13,12,5,2,1,2,2
Essendon,"Merrett, Zach",26,16,1,10,0,0,0,5
Essendon,"Parish, Darcy",26,9,2,17,0,0,0,9
Essendon,"Redman, Mason",19,15,7,4,0,0,0,1
Essendon,"Saad, Adam",12,7,1,5,0,0,0,2
Essendon,"Shiel, Dylan",24,13,1,11,0,0,0,5
Essendon,"Ambrose, Patrick",17,14,10,3,0,0,0,1
Essendon,"Bellchambers, Tom",13,9,3,4,0,0,16,1
Essendon,"Brown, Mitch",4,4,3,0,0,0,0,0
Essendon,"Fantasia, Orazio",13,7,3,6,1,2,0,3
Essendon,"Francis, Aaron",20,14,9,6,0,0,0,0
Essendon,"Ham, Brayden",11,8,5,3,0,0,0,2
Essendon,"Heppell, Dyson",31,16,11,15,0,0,0,0
Essendon,"Hooker, Cale",4,1,1,3,0,0,0,0
Essendon,"Hurley, Michael",18,13,6,5,0,0,0,2
Essendon,"Langford, Kyle",15,9,4,6,0,0,0,0
Essendon,"Laverde, Jayden",9,7,5,2,1,0,0,0
Essendon,"McDonald-Tipungwuti, Anthony",9,9,3,0,2,2,0,4
Essendon,"McGrath, Andrew",30,18,4,12,1,0,0,1
Essendon,"McKenna, Conor",18,11,2,7,0,0,0,4
Essendon,"McKernan, Shaun",4,2,0,2,0,0,2,4
Essendon,"Merrett, Zach",24,13,1,11,0,0,0,7
Essendon,"Parish, Darcy",18,11,7,7,0,1,0,3
Essendon,"Redman, Mason",13,9,5,4,0,0,0,5
Essendon,"Saad, Adam",18,12,2,6,2,0,0,2
Essendon,"Shiel, Dylan",28,14,4,14,0,0,0,3
Essendon,"Snelling, Will",12,3,4,9,2,0,0,1
Essendon,"Stringer, Jake",13,10,3,3,0,0,0,2
Fremantle,"Ballantyne, Hayden",6,5,1,1,1,1,0,0
Fremantle,"Banfield, Bailey",20,9,7,11,0,1,0,4
Fremantle,"Brayshaw, Andrew",20,6,3,14,0,1,0,4
Fremantle,"Cerra, Adam",13,7,2,6,0,0,0,2
Fremantle,"Colyer, Travis",20,11,2,9,1,0,0,1
Fremantle,"Conca, Reece",19,11,4,8,0,0,0,2
Fremantle,"Darcy, Sean",10,6,1,4,0,2,27,4
Fremantle,"Fyfe, Nat",32,10,4,22,1,1,0,4
Fremantle,"Hamling, Joel",8,4,3,4,0,0,0,2
Fremantle,"Hill, Bradley",28,17,2,11,1,0,0,7
Fremantle,"Hughes, Ethan",14,9,4,5,0,1,0,2
Fremantle,"Langdon, Ed",25,16,8,9,0,0,0,4
Fremantle,"Lobb, Rory",11,9,4,2,2,1,6,4
Fremantle,"McCarthy, Cam",20,14,5,6,5,0,0,2
Fremantle,"Mundy, David",20,13,3,7,1,0,0,1
Fremantle,"Pearce, Alex",10,8,2,2,0,0,0,5
Fremantle,"Ryan, Luke",15,13,5,2,1,0,0,2
Fremantle,"Schultz, Lachie",17,11,6,6,2,0,0,2
Fremantle,"Taberner, Matthew",18,13,9,5,1,0,0,3
Fremantle,"Tucker, Darcy",24,17,4,7,2,1,0,7
Fremantle,"Walters, Michael",19,12,4,7,3,1,0,1
Fremantle,"Wilson, Nathan",12,10,1,2,0,0,0,1
Fremantle,"Banfield, Bailey",13,4,1,9,0,0,0,9
Fremantle,"Brayshaw, Andrew",13,5,0,8,0,1,0,10
Fremantle,"Cerra, Adam",14,9,2,5,0,0,0,0
Fremantle,"Colyer, Travis",20,11,3,9,2,1,0,3
Fremantle,"Conca, Reece",21,15,5,6,0,0,0,0
Fremantle,"Darcy, Sean",6,3,0,3,0,0,37,2
Fremantle,"Fyfe, Nat",31,16,10,15,0,0,0,3
Fremantle,"Hamling, Joel",9,5,2,4,0,0,0,2
Fremantle,"Hill, Bradley",32,25,6,7,0,1,0,5
Fremantle,"Hogan, Jesse",21,8,3,13,0,0,0,3
Fremantle,"Hughes, Ethan",14,9,5,5,0,0,0,1
Fremantle,"Langdon, Ed",26,19,8,7,0,0,0,1
Fremantle,"Lobb, Rory",7,4,1,3,1,1,11,2
Fremantle,"McCarthy, Cam",12,9,3,3,2,0,0,1
Fremantle,"Mundy, David",15,7,1,8,0,0,0,3
Fremantle,"Pearce, Alex",12,5,0,7,0,0,0,1
Fremantle,"Ryan, Luke",15,10,2,5,0,0,0,3
Fremantle,"Schultz, Lachie",13,6,1,7,0,1,0,3
Fremantle,"Taberner, Matthew",18,12,8,6,2,0,0,2
Fremantle,"Tucker, Darcy",16,5,4,11,0,0,0,2
Fremantle,"Walters, Michael",8,7,3,1,1,2,0,4
Fremantle,"Wilson, Nathan",20,14,3,6,0,0,0,1
Fremantle,"Banfield, Bailey",12,5,2,7,0,0,0,3
Fremantle,"Brayshaw, Andrew",16,7,1,9,0,0,0,5
Fremantle,"Cerra, Adam",23,14,7,9,0,0,0,5
Fremantle,"Colyer, Travis",14,11,3,3,0,1,0,3
Fremantle,"Conca, Reece",27,14,5,13,0,0,0,5
Fremantle,"Duman, Taylin",16,11,7,5,0,0,0,5
Fremantle,"Fyfe, Nat",23,10,3,13,0,0,0,6
Fremantle,"Hamling, Joel",14,10,9,4,0,0,0,4
Fremantle,"Hill, Bradley",22,17,7,5,1,1,0,1
Fremantle,"Hogan, Jesse",16,7,6,9,0,0,1,2
Fremantle,"Hughes, Ethan",12,9,4,3,1,0,0,2
Fremantle,"Langdon, Ed",29,16,7,13,0,0,0,3
Fremantle,"Lobb, Rory",17,11,4,6,1,0,28,1
Fremantle,"Matera, Brandon",16,10,2,6,3,0,0,1
Fremantle,"McCarthy, Cam",16,10,6,6,1,1,0,0
Fremantle,"Mundy, David",26,10,3,16,0,0,0,4
Fremantle,"Pearce, Alex",11,3,4,8,0,0,0,5
Fremantle,"Ryan, Luke",32,25,13,7,0,0,0,2
Fremantle,"Taberner, Matthew",14,10,5,4,2,0,2,2
Fremantle,"Tucker, Darcy",21,8,0,13,0,0,0,4
Fremantle,"Walters, Michael",27,17,0,10,2,0,0,3
Fremantle,"Wilson, Nathan",14,10,5,4,0,0,0,4
Fremantle,"Brayshaw, Andrew",22,10,1,12,0,0,0,2
Fremantle,"Cerra, Adam",13,9,5,4,0,1,0,0
Fremantle,"Colyer, Travis",13,6,2,7,0,0,0,2
Fremantle,"Conca, Reece",20,17,3,3,0,0,0,5
Fremantle,"Duman, Taylin",7,4,3,3,0,0,0,2
Fremantle,"Hamling, Joel",3,2,1,1,0,0,0,1
Fremantle,"Hill, Bradley",18,14,4,4,0,1,0,2
Fremantle,"Hogan, Jesse",13,7,8,6,1,0,0,1
Fremantle,"Hughes, Ethan",11,7,5,4,0,0,0,4
Fremantle,"Langdon, Ed",27,17,5,10,0,0,0,1
Fremantle,"Lobb, Rory",17,14,5,3,0,1,23,1
Fremantle,"Matera, Brandon",16,10,4,6,0,1,0,1
Fremantle,"McCarthy, Cam",10,4,2,6,2,0,0,3
Fremantle,"Mundy, David",36,23,4,13,0,0,0,4
Fremantle,"Pearce, Alex",14,7,4,7,0,0,0,1
Fremantle,"Ryan, Luke",19,11,5,8,0,0,0,2
Fremantle,"Schultz, Lachie",8,6,2,2,0,1,0,2
Fremantle,"Switkowski, Sam",12,6,0,6,0,0,0,6
Fremantle,"Taberner, Matthew",20,17,8,3,2,3,1,5
Fremantle,"Tucker, Darcy",15,5,4,10,0,0,0,0
Fremantle,"Walters, Michael",17,11,3,6,2,1,0,8
Fremantle,"Wilson, Nathan",14,12,3,2,0,0,0,1
Fremantle,"Brayshaw, Andrew",16,10,5,6,0,1,0,2
Fremantle,"Cerra, Adam",15,9,2,6,0,0,0,3
Fremantle,"Colyer, Travis",17,10,5,7,1,1,0,0
Fremantle,"Conca, Reece",20,12,3,8,0,0,0,2
Fremantle,"Cox, Brennan",7,3,1,4,0,0,1,2
Fremantle,"Duman, Taylin",10,8,4,2,0,0,0,0
Fremantle,"Fyfe, Nat",31,11,4,20,0,0,0,3
Fremantle,"Hamling, Joel",5,2,3,3,0,0,0,1
Fremantle,"Hill, Bradley",15,11,5,4,0,0,0,1
Fremantle,"Hogan, Jesse",22,16,14,6,3,0,0,0
Fremantle,"Hughes, Ethan",16,10,7,6,0,1,0,2
Fremantle,"Langdon, Ed",32,16,10,16,0,0,0,2
Fremantle,"Lobb, Rory",12,4,1,8,1,0,22,1
Fremantle,"Matera, Brandon",16,11,4,5,4,0,0,0
Fremantle,"Mundy, David",25,14,0,11,0,0,0,5
Fremantle,"Pearce, Alex",7,2,3,5,0,0,0,0
Fremantle,"Ryan, Luke",23,18,6,5,0,0,0,1
Fremantle,"Switkowski, Sam",14,6,4,8,1,0,0,4
Fremantle,"Taberner, Matthew",21,18,13,3,3,3,1,2
Fremantle,"Tucker, Darcy",25,16,5,9,0,0,0,1
Fremantle,"Walters, Michael",25,17,6,8,3,1,0,2
Fremantle,"Wilson, Nathan",16,13,3,3,0,1,0,1
Fremantle,"Brayshaw, Andrew",14,4,3,10,1,0,0,1
Fremantle,"Cerra, Adam",20,12,3,8,0,0,0,2
Fremantle,"Colyer, Travis",11,9,5,2,0,1,0,4
Fremantle,"Conca, Reece",12,6,2,6,0,0,0,3
Fremantle,"Fyfe, Nat",30,15,9,15,1,1,0,5
Fremantle,"Hamling, Joel",16,6,6,10,0,0,0,1
Fremantle,"Hill, Bradley",30,24,5,6,0,0,0,0
Fremantle,"Hogan, Jesse",17,12,9,5,1,3,0,1
Fremantle,"Hughes, Ethan",17,10,6,7,0,0,0,0
Fremantle,"Langdon, Ed",29,18,8,11,0,1,0,1
Fremantle,"Lobb, Rory",12,6,4,6,0,0,31,2
Fremantle,"Matera, Brandon",13,10,5,3,5,0,0,1
Fremantle,"McCarthy, Cam",11,8,5,3,0,1,0,1
Fremantle,"Mundy, David",28,14,4,14,2,0,0,7
Fremantle,"Nyhuis, Ryan",19,11,6,8,0,0,0,1
Fremantle,"Pearce, Alex",10,4,3,6,0,0,0,1
Fremantle,"Ryan, Luke",22,18,8,4,0,0,0,1
Fremantle,"Switkowski, Sam",11,8,3,3,0,0,0,4
Fremantle,"Taberner, Matthew",14,9,7,5,1,1,5,0
Fremantle,"Tucker, Darcy",18,7,1,11,0,0,0,5
Fremantle,"Walters, Michael",17,8,2,9,2,0,0,3
Fremantle,"Wilson, Nathan",25,22,3,3,0,1,0,0
Fremantle,"Brayshaw, Andrew",21,9,3,12,0,0,0,3
Fremantle,"Cerra, Adam",25,14,4,11,0,0,0,2
Fremantle,"Colyer, Travis",11,6,3,5,0,0,0,4
Fremantle,"Conca, Reece",22,16,5,6,0,0,0,7
Fremantle,"Fyfe, Nat",32,16,5,16,0,0,0,8
Fremantle,"Hamling, Joel",14,8,6,6,0,0,0,1
Fremantle,"Hill, Bradley",18,11,2,7,1,0,0,4
Fremantle,"Hogan, Jesse",11,7,6,4,0,1,1,0
Fremantle,"Hughes, Ethan",15,6,1,9,0,0,0,1
Fremantle,"Langdon, Ed",27,13,8,14,0,0,0,2
Fremantle,"Lobb, Rory",10,6,4,4,0,1,30,1
Fremantle,"Matera, Brandon",13,7,4,6,0,0,0,2
Fremantle,"McCarthy, Cam",7,2,2,5,0,0,0,2
Fremantle,"Mundy, David",35,13,2,22,0,0,0,6
Fremantle,"Nyhuis, Ryan",17,9,6,8,0,0,0,3
Fremantle,"Pearce, Alex",16,9,6,7,0,0,0,3
Fremantle,"Ryan, Luke",34,21,6,13,0,0,0,2
Fremantle,"Switkowski, Sam",5,0,1,5,0,0,0,6
Fremantle,"Taberner, Matthew",9,7,6,2,1,1,3,1
Fremantle,"Tucker, Darcy",18,8,1,10,2,0,0,3
Fremantle,"Walters, Michael",22,12,1,10,1,0,0,2
Fremantle,"Wilson, Nathan",22,19,2,3,0,0,0,2
Fremantle,"Brayshaw, Andrew",10,5,0,5,0,1,0,3
Fremantle,"Cerra, Adam",15,7,1,8,0,0,0,6
Fremantle,"Colyer, Travis",13,9,4,4,1,1,0,4
Fremantle,"Conca, Reece",21,12,2,9,0,1,0,3
Fremantle,"Cox, Brennan",12,9,7,3,0,1,0,2
Fremantle,"Fyfe, Nat",33,15,4,18,3,0,0,1
Fremantle,"Hamling, Joel",5,3,3,2,0,0,0,1
Fremantle,"Hill, Bradley",15,11,0,4,0,0,0,4
Fremantle,"Hogan, Jesse",15,7,5,8,2,0,0,0
Fremantle,"Hughes, Ethan",12,4,3,8,0,0,0,0
Fremantle,"Langdon, Ed",16,10,3,6,0,1,0,1
Fremantle,"Lobb, Rory",19,11,6,8,1,2,45,2
Fremantle,"Matera, Brandon",14,9,2,5,1,4,0,1
Fremantle,"Mundy, David",27,13,0,14,1,0,0,5
Fremantle,"Nyhuis, Ryan",5,1,1,4,0,0,0,1
Fremantle,"Pearce, Alex",5,3,1,2,0,0,0,1
Fremantle,"Ryan, Luke",21,16,1,5,0,0,0,3
Fremantle,"Switkowski, Sam",10,3,1,7,2,0,0,4
Fremantle,"Taberner, Matthew",18,8,8,10,1,1,3,1
Fremantle,"Tucker, Darcy",22,6,2,16,0,0,0,2
Fremantle,"Walters, Michael",27,12,4,15,0,1,0,5
Fremantle,"Wilson, Nathan",10,7,2,3,0,0,0,2
Fremantle,"Blakely, Connor",20,8,6,12,0,0,0,1
Fremantle,"Brayshaw, Andrew",14,8,3,6,0,0,0,5
Fremantle,"Cerra, Adam",10,5,2,5,0,1,0,3
Fremantle,"Conca, Reece",26,13,5,13,0,0,0,3
Fremantle,"Cox, Brennan",5,3,2,2,0,0,1,3
Fremantle,"Duman, Taylin",21,14,6,7,0,0,0,6
Fremantle,"Fyfe, Nat",24,11,2,13,0,0,0,3
Fremantle,"Hamling, Joel",6,6,4,0,0,0,0,1
Fremantle,"Hill, Bradley",23,21,4,2,0,1,0,3
Fremantle,"Hogan, Jesse",15,10,4,5,1,4,1,1
Fremantle,"Hughes, Ethan",15,10,7,5,0,0,0,0
Fremantle,"Langdon, Ed",20,5,5,15,1,0,0,1
Fremantle,"Lobb, Rory",16,9,4,7,0,0,33,0
Fremantle,"Matera, Brandon",13,9,4,4,2,1,0,4
Fremantle,"Mundy, David",34,14,4,20,1,0,0,6
Fremantle,"Pearce, Alex",13,6,6,7,0,0,0,3
Fremantle,"Ryan, Luke",19,13,5,6,0,0,0,2
Fremantle,"Switkowski, Sam",10,3,0,7,0,0,0,4
Fremantle,"Taberner, Matthew",17,11,8,6,0,1,1,2
Fremantle,"Tucker, Darcy",22,9,1,13,1,0,0,1
Fremantle,"Walters, Michael",21,13,2,8,1,1,0,7
Fremantle,"Wilson, Nathan",19,18,7,1,0,0,0,1
Fremantle,"Bewley, Brett",11,5,2,6,0,0,0,2
Fremantle,"Blakely, Connor",15,7,5,8,0,0,0,1
Fremantle,"Brayshaw, Andrew",15,6,3,9,1,1,0,3
Fremantle,"Cerra, Adam",11,8,3,3,2,2,0,2
Fremantle,"Conca, Reece",14,8,3,6,0,0,0,2
Fremantle,"Cox, Brennan",8,4,5,4,2,1,6,2
Fremantle,"Duman, Taylin",16,14,8,2,0,2,0,0
Fremantle,"Fyfe, Nat",26,13,6,13,1,0,0,7
Fremantle,"Hamling, Joel",10,3,2,7,0,0,0,0
Fremantle,"Hill, Bradley",31,26,6,5,0,0,0,2
Fremantle,"Hogan, Jesse",8,0,1,8,0,0,0,2
Fremantle,"Hughes, Ethan",13,5,4,8,0,0,0,2
Fremantle,"Langdon, Ed",25,12,7,13,0,2,0,1
Fremantle,"Lobb, Rory",10,7,7,3,1,0,27,3
Fremantle,"Matera, Brandon",11,7,5,4,1,1,0,0
Fremantle,"Mundy, David",23,9,3,14,0,0,0,3
Fremantle,"Pearce, Alex",14,5,5,9,0,0,0,4
Fremantle,"Ryan, Luke",32,19,5,13,0,0,0,3
Fremantle,"Switkowski, Sam",13,9,6,4,0,0,0,2
Fremantle,"Tucker, Darcy",15,6,4,9,0,2,0,2
Fremantle,"Walters, Michael",25,18,4,7,2,1,0,5
Fremantle,"Wilson, Nathan",30,18,8,12,0,0,0,1
Fremantle,"Bewley, Brett",14,6,2,8,0,2,0,6
Fremantle,"Blakely, Connor",27,15,5,12,0,0,0,3
Fremantle,"Brayshaw, Andrew",21,9,2,12,0,0,0,4
Fremantle,"Cerra, Adam",12,4,3,8,0,1,0,1
Fremantle,"Conca, Reece",24,18,2,6,0,0,0,7
Fremantle,"Cox, Brennan",7,2,3,5,0,0,1,2
Fremantle,"Duman, Taylin",16,9,9,7,0,0,0,3
Fremantle,"Fyfe, Nat",32,21,6,11,0,2,0,4
Fremantle,"Hamling, Joel",7,1,2,6,0,0,0,2
Fremantle,"Hill, Bradley",29,20,1,9,2,0,0,1
Fremantle,"Hogan, Jesse",17,6,5,11,2,1,0,0
Fremantle,"Hughes, Ethan",11,6,2,5,1,0,0,1
Fremantle,"Langdon, Ed",23,11,7,12,1,0,0,2
Fremantle,"Lobb, Rory",19,7,3,12,1,1,14,3
Fremantle,"Matera, Brandon",14,10,5,4,2,3,0,1
Fremantle,"Mundy, David",19,9,3,10,0,0,0,3
Fremantle,"Pearce, Alex",7,4,2,3,0,0,0,0
Fremantle,"Ryan, Luke",19,12,4,7,0,0,0,2
Fremantle,"Switkowski, Sam",8,1,2,7,0,0,0,7
Fremantle,"Tucker, Darcy",18,9,5,9,0,1,0,3
Fremantle,"Walters, Michael",24,13,6,11,2,0,0,3
Fremantle,"Wilson, Nathan",26,24,6,2,0,0,0,0
Fremantle,"Bewley, Brett",13,8,4,5,1,1,0,2
Fremantle,"Blakely, Connor",21,14,2,7,0,0,0,1
Fremantle,"Brayshaw, Andrew",15,3,2,12,0,0,0,7
Fremantle,"Conca, Reece",19,12,2,7,0,0,0,4
Fremantle,"Cox, Brennan",16,3,3,13,1,0,1,4
Fremantle,"Darcy, Sean",12,2,2,10,0,0,30,2
Fremantle,"Duman, Taylin",11,5,3,6,0,0,0,5
Fremantle,"Fyfe, Nat",37,16,3,21,0,0,0,2
Fremantle,"Hamling, Joel",11,7,5,4,0,0,0,1
Fremantle,"Hill, Bradley",30,23,2,7,0,1,0,1
Fremantle,"Hill, Stephen",12,4,0,8,0,0,0,1
Fremantle,"Hogan, Jesse",17,12,11,5,3,1,0,0
Fremantle,"Hughes, Ethan",17,8,5,9,0,0,0,1
Fremantle,"Langdon, Ed",27,11,4,16,1,0,0,2
Fremantle,"Logue, Griffin",24,13,8,11,0,0,0,3
Fremantle,"Matera, Brandon",11,11,6,0,3,1,0,2
Fremantle,"Mundy, David",21,12,2,9,0,2,0,3
Fremantle,"Ryan, Luke",16,12,4,4,0,0,0,4
Fremantle,"Switkowski, Sam",15,5,1,10,0,0,0,4
Fremantle,"Tucker, Darcy",20,8,2,12,0,0,0,3
Fremantle,"Walters, Michael",25,20,6,5,6,1,0,4
Fremantle,"Wilson, Nathan",16,11,2,5,0,0,0,1
Fremantle,"Bewley, Brett",16,8,4,8,0,0,0,1
Fremantle,"Blakely, Connor",18,5,4,13,0,0,0,5
Fremantle,"Brayshaw, Andrew",20,8,3,12,1,0,0,3
Fremantle,"Conca, Reece",26,19,2,7,0,0,0,3
Fremantle,"Cox, Brennan",10,4,4,6,1,0,2,1
Fremantle,"Darcy, Sean",8,4,1,4,1,0,31,4
Fremantle,"Duman, Taylin",18,11,2,7,0,0,0,2
Fremantle,"Fyfe, Nat",31,10,4,21,0,1,0,2
Fremantle,"Hamling, Joel",16,6,7,10,0,0,0,1
Fremantle,"Hill, Bradley",31,24,2,7,0,0,0,2
Fremantle,"Hill, Stephen",9,8,2,1,0,0,0,1
Fremantle,"Hogan, Jesse",5,1,0,4,0,0,0,0
Fremantle,"Hughes, Ethan",17,9,3,8,0,0,0,1
Fremantle,"Langdon, Ed",24,16,5,8,1,0,0,2
Fremantle,"Logue, Griffin",17,8,7,9,0,0,0,4
Fremantle,"Matera, Brandon",18,12,4,6,3,1,0,5
Fremantle,"Mundy, David",17,5,2,12,0,0,0,6
Fremantle,"Ryan, Luke",16,13,5,3,0,0,0,3
Fremantle,"Switkowski, Sam",15,5,5,10,0,0,0,7
Fremantle,"Tucker, Darcy",22,12,6,10,1,0,0,5
Fremantle,"Walters, Michael",18,13,2,5,3,1,0,3
Fremantle,"Wilson, Nathan",10,8,1,2,0,0,0,1
Fremantle,"Banfield, Bailey",11,5,3,6,0,0,0,6
Fremantle,"Bewley, Brett",15,12,1,3,0,0,0,2
Fremantle,"Blakely, Connor",31,14,5,17,0,0,0,4
Fremantle,"Brayshaw, Andrew",9,6,1,3,0,0,0,9
Fremantle,"Cerra, Adam",13,5,0,8,0,0,0,0
Fremantle,"Conca, Reece",22,12,2,10,0,0,0,8
Fremantle,"Cox, Brennan",11,3,4,8,1,0,4,4
Fremantle,"Darcy, Sean",7,1,1,6,0,0,37,3
Fremantle,"Fyfe, Nat",29,13,8,16,1,2,0,7
Fremantle,"Hamling, Joel",13,8,4,5,0,0,0,0
Fremantle,"Hill, Bradley",22,13,1,9,0,0,0,3
Fremantle,"Hughes, Ethan",25,13,4,12,0,0,0,3
Fremantle,"Langdon, Ed",26,22,4,4,0,1,0,3
Fremantle,"Logue, Griffin",11,5,2,6,0,0,0,3
Fremantle,"Matera, Brandon",10,8,3,2,1,0,0,0
Fremantle,"McCarthy, Cam",10,9,4,1,4,0,0,0
Fremantle,"Mundy, David",22,10,3,12,0,0,0,4
Fremantle,"Ryan, Luke",18,14,2,4,0,0,0,2
Fremantle,"Switkowski, Sam",14,6,1,8,1,0,0,5
Fremantle,"Tucker, Darcy",19,12,2,7,1,1,0,10
Fremantle,"Walters, Michael",17,12,6,5,2,1,0,1
Fremantle,"Wilson, Nathan",21,16,5,5,0,1,0,1
Fremantle,"Blakely, Connor",12,6,4,6,0,0,0,0
Fremantle,"Brayshaw, Andrew",13,6,1,7,0,0,0,6
Fremantle,"Cerra, Adam",12,7,4,5,0,1,0,5
Fremantle,"Colyer, Travis",16,11,2,5,0,1,0,0
Fremantle,"Conca, Reece",15,10,0,5,0,0,0,1
Fremantle,"Crowden, Mitch",16,6,0,10,0,1,0,6
Fremantle,"Fyfe, Nat",21,12,0,9,0,1,0,4
Fremantle,"Hamling, Joel",13,10,8,3,0,0,0,0
Fremantle,"Hill, Bradley",19,12,1,7,0,1,0,2
Fremantle,"Hughes, Ethan",17,7,6,10,0,0,0,1
Fremantle,"Langdon, Ed",15,10,4,5,0,1,0,1
Fremantle,"Lobb, Rory",9,7,1,2,0,0,13,2
Fremantle,"Logue, Griffin",9,5,2,4,0,0,0,1
Fremantle,"Matera, Brandon",13,12,4,1,0,3,0,3
Fremantle,"McCarthy, Cam",15,11,4,4,1,3,0,0
Fremantle,"Mundy, David",18,10,3,8,0,1,0,4
Fremantle,"Ryan, Luke",13,8,2,5,0,0,0,2
Fremantle,"Sandilands, Aaron",8,3,1,5,0,0,18,0
Fremantle,"Switkowski, Sam",11,7,2,4,0,0,0,1
Fremantle,"Tucker, Darcy",28,11,2,17,0,0,0,3
Fremantle,"Walters, Michael",23,16,5,7,1,0,0,5
Fremantle,"Wilson, Nathan",18,15,3,3,0,0,0,0
Fremantle,"Blakely, Connor",25,13,8,12,0,0,0,1
Fremantle,"Brayshaw, Andrew",17,7,3,10,0,0,0,8
Fremantle,"Cerra, Adam",9,5,3,4,0,1,0,2
Fremantle,"Colyer, Travis",10,7,3,3,0,0,0,2
Fremantle,"Conca, Reece",23,12,2,11,0,0,0,6
Fremantle,"Darcy, Sean",14,5,4,9,0,0,24,1
Fremantle,"Fyfe, Nat",24,13,6,11,3,0,0,8
Fremantle,"Hamling, Joel",6,2,4,4,0,0,0,1
Fremantle,"Hill, Bradley",37,22,5,15,0,0,0,2
Fremantle,"Hill, Stephen",14,5,2,9,1,0,0,3
Fremantle,"Hughes, Ethan",17,9,4,8,0,0,0,0
Fremantle,"Langdon, Ed",24,14,3,10,0,0,0,2
Fremantle,"Lobb, Rory",13,9,4,4,1,2,24,2
Fremantle,"Matera, Brandon",8,6,3,2,1,2,0,1
Fremantle,"McCarthy, Cam",10,7,4,3,1,0,0,3
Fremantle,"Mundy, David",22,10,4,12,0,0,0,6
Fremantle,"Nyhuis, Ryan",12,8,4,4,0,0,0,1
Fremantle,"Ryan, Luke",23,19,9,4,0,0,0,2
Fremantle,"Switkowski, Sam",7,2,2,5,0,0,0,6
Fremantle,"Tucker, Darcy",18,6,5,12,1,0,0,6
Fremantle,"Walters, Michael",25,14,4,11,0,0,0,2
Fremantle,"Wilson, Nathan",20,16,3,4,0,0,0,0
Fremantle,"Bewley, Brett",18,15,5,3,0,0,0,1
Fremantle,"Blakely, Connor",17,12,4,5,0,0,0,5
Fremantle,"Brayshaw, Andrew",20,13,5,7,0,1,0,8
Fremantle,"Cerra, Adam",16,13,5,3,0,0,0,0
Fremantle,"Conca, Reece",26,19,4,7,1,1,0,5
Fremantle,"Darcy, Sean",17,6,1,11,0,2,26,2
Fremantle,"Duman, Taylin",14,11,4,3,0,0,0,1
Fremantle,"Hamling, Joel",18,10,7,8,0,0,0,3
Fremantle,"Hill, Bradley",20,19,6,1,1,1,0,1
Fremantle,"Hughes, Ethan",17,8,8,9,0,0,0,2
Fremantle,"Langdon, Ed",21,15,5,6,0,1,0,2
Fremantle,"Lobb, Rory",14,9,5,5,3,0,10,0
Fremantle,"Logue, Griffin",9,6,5,3,0,0,0,5
Fremantle,"Matera, Brandon",14,10,2,4,1,1,0,3
Fremantle,"McCarthy, Cam",5,5,2,0,0,0,0,1
Fremantle,"Mundy, David",25,9,4,16,0,1,0,2
Fremantle,"Ryan, Luke",21,14,7,7,0,0,0,9
Fremantle,"Sandilands, Aaron",14,6,2,8,0,0,17,1
Fremantle,"Switkowski, Sam",12,4,4,8,0,0,0,1
Fremantle,"Tucker, Darcy",10,7,4,3,0,0,0,3
Fremantle,"Walters, Michael",21,15,5,6,1,1,0,3
Fremantle,"Wilson, Nathan",17,13,5,4,0,0,0,3
Fremantle,"Ballantyne, Hayden",14,10,5,4,0,1,0,1
Fremantle,"Bewley, Brett",9,6,4,3,0,0,0,3
Fremantle,"Blakely, Connor",22,17,9,5,0,0,0,2
Fremantle,"Brayshaw, Andrew",26,17,3,9,3,1,0,3
Fremantle,"Cerra, Adam",13,8,6,5,0,0,0,0
Fremantle,"Conca, Reece",17,9,2,8,1,0,0,2
Fremantle,"Darcy, Sean",13,4,2,9,0,1,19,1
Fremantle,"Duman, Taylin",15,9,6,6,0,0,0,0
Fremantle,"Fyfe, Nat",33,18,5,15,0,2,0,4
Fremantle,"Hamling, Joel",12,9,9,3,0,0,0,0
Fremantle,"Hill, Bradley",22,11,3,11,0,0,0,1
Fremantle,"Langdon, Ed",16,8,4,8,0,1,0,3
Fremantle,"Lobb, Rory",11,6,8,5,1,2,2,0
Fremantle,"Logue, Griffin",8,5,3,3,0,0,0,1
Fremantle,"Matera, Brandon",11,7,2,4,0,2,0,0
Fremantle,"Mundy, David",18,10,6,8,0,0,0,5
Fremantle,"Ryan, Luke",10,7,5,3,0,0,0,2
Fremantle,"Sandilands, Aaron",8,0,2,8,0,0,35,4
Fremantle,"Schultz, Lachie",11,6,2,5,1,0,0,2
Fremantle,"Tucker, Darcy",14,5,4,9,2,0,0,2
Fremantle,"Walters, Michael",21,14,3,7,1,1,0,8
Fremantle,"Wilson, Nathan",12,10,4,2,0,0,0,2
Fremantle,"Banfield, Bailey",10,6,1,4,1,0,0,6
Fremantle,"Blakely, Connor",22,15,5,7,0,0,0,4
Fremantle,"Brayshaw, Andrew",14,5,1,9,1,0,0,7
Fremantle,"Carter, Jason",9,5,2,4,0,0,0,4
Fremantle,"Cerra, Adam",15,13,7,2,0,0,0,2
Fremantle,"Conca, Reece",15,9,6,6,0,0,0,4
Fremantle,"Crowden, Mitch",9,5,2,4,2,0,0,4
Fremantle,"Darcy, Sean",8,4,3,4,1,1,22,2
Fremantle,"Duman, Taylin",14,13,4,1,1,0,0,4
Fremantle,"Fyfe, Nat",27,13,4,14,2,1,0,4
Fremantle,"Hamling, Joel",10,7,5,3,0,0,0,0
Fremantle,"Hill, Bradley",27,18,6,9,0,0,0,4
Fremantle,"Hughes, Ethan",22,10,7,12,0,0,0,3
Fremantle,"Langdon, Ed",28,16,4,12,2,1,0,5
Fremantle,"Logue, Griffin",9,5,4,4,0,0,0,0
Fremantle,"Matera, Brandon",14,13,5,1,1,4,0,5
Fremantle,"Mundy, David",8,4,3,4,2,0,0,1
Fremantle,"Sandilands, Aaron",15,3,2,12,0,0,39,1
Fremantle,"Schultz, Lachie",12,7,2,5,0,1,0,3
Fremantle,"Switkowski, Sam",13,9,5,4,0,1,0,9
Fremantle,"Tucker, Darcy",21,11,4,10,0,0,0,8
Fremantle,"Walters, Michael",29,20,5,9,1,1,0,4
Fremantle,"Banfield, Bailey",11,4,1,7,0,0,0,0
Fremantle,"Blakely, Connor",23,16,10,7,0,0,0,1
Fremantle,"Brayshaw, Andrew",18,5,1,13,0,0,0,10
Fremantle,"Carter, Jason",9,6,2,3,0,0,0,0
Fremantle,"Cerra, Adam",20,17,7,3,0,0,0,2
Fremantle,"Conca, Reece",15,8,0,7,0,1,0,3
Fremantle,"Crowden, Mitch",12,3,1,9,1,0,0,5
Fremantle,"Darcy, Sean",11,5,2,6,1,1,26,4
Fremantle,"Duman, Taylin",12,10,5,2,0,1,0,2
Fremantle,"Fyfe, Nat",35,23,5,12,2,1,0,0
Fremantle,"Hamling, Joel",12,10,7,2,0,0,0,1
Fremantle,"Hill, Bradley",27,16,4,11,0,1,0,2
Fremantle,"Hughes, Ethan",17,8,4,9,0,0,0,1
Fremantle,"Langdon, Ed",28,14,7,14,1,0,0,2
Fremantle,"Logue, Griffin",10,2,2,8,0,0,0,0
Fremantle,"Matera, Brandon",9,8,4,1,2,0,0,2
Fremantle,"Mundy, David",14,2,1,12,0,0,0,5
Fremantle,"Sandilands, Aaron",12,4,3,8,0,0,32,6
Fremantle,"Schultz, Lachie",9,6,1,3,1,0,0,3
Fremantle,"Switkowski, Sam",15,7,5,8,1,1,0,5
Fremantle,"Tucker, Darcy",23,13,3,10,0,0,0,4
Fremantle,"Walters, Michael",13,8,1,5,1,0,0,3
Fremantle,"Ballantyne, Hayden",13,8,2,5,0,1,0,5
Fremantle,"Blakely, Connor",14,8,5,6,0,0,0,1
Fremantle,"Brayshaw, Andrew",22,8,2,14,0,0,0,3
Fremantle,"Cerra, Adam",24,12,4,12,0,0,0,4
Fremantle,"Conca, Reece",21,14,4,7,0,0,0,0
Fremantle,"Crowden, Mitch",17,10,5,7,0,1,0,7
Fremantle,"Darcy, Sean",16,4,3,12,1,0,21,5
Fremantle,"Duman, Taylin",18,16,6,2,0,0,0,2
Fremantle,"Fyfe, Nat",26,11,3,15,1,0,0,1
Fremantle,"Hamling, Joel",14,10,6,4,0,0,0,1
Fremantle,"Hill, Bradley",32,21,6,11,0,0,0,0
Fremantle,"Hughes, Ethan",22,10,6,12,0,0,0,0
Fremantle,"Langdon, Ed",37,24,6,13,0,1,0,0
Fremantle,"Logue, Griffin",10,9,6,1,0,0,0,0
Fremantle,"Matera, Brandon",14,5,1,9,0,1,0,5
Fremantle,"McCarthy, Cam",14,9,8,5,3,1,0,1
Fremantle,"Mundy, David",30,12,3,18,0,2,1,2
Fremantle,"Sandilands, Aaron",16,4,3,12,0,1,36,2
Fremantle,"Schultz, Lachie",12,4,1,8,0,0,0,2
Fremantle,"Switkowski, Sam",8,5,3,3,0,0,0,10
Fremantle,"Tucker, Darcy",15,8,7,7,0,0,0,4
Fremantle,"Walters, Michael",36,22,8,14,2,2,0,0
Fremantle,"Banfield, Bailey",16,6,3,10,1,0,0,2
Fremantle,"Blakely, Connor",10,6,0,4,0,0,0,3
Fremantle,"Brayshaw, Andrew",16,10,0,6,0,0,0,7
Fremantle,"Cerra, Adam",16,9,4,7,0,0,0,3
Fremantle,"Conca, Reece",22,16,5,6,0,0,0,3
Fremantle,"Crowden, Mitch",6,3,0,3,0,0,0,2
Fremantle,"Dixon, Hugh",8,4,2,4,1,0,2,0
Fremantle,"Duman, Taylin",21,15,10,6,0,0,0,1
Fremantle,"Fyfe, Nat",26,12,5,14,1,1,0,3
Fremantle,"Hamling, Joel",12,8,8,4,0,0,0,1
Fremantle,"Hill, Bradley",24,16,3,8,0,0,0,2
Fremantle,"Hughes, Ethan",14,9,5,5,0,0,0,0
Fremantle,"Jones, Scott",14,7,2,7,0,0,24,4
Fremantle,"Langdon, Ed",25,17,9,8,2,0,0,1
Fremantle,"Logue, Griffin",13,8,6,5,0,0,0,2
Fremantle,"Matera, Brandon",13,6,3,7,0,0,0,2
Fremantle,"McCarthy, Cam",6,6,4,0,0,1,0,1
Fremantle,"Mundy, David",19,7,2,12,1,1,0,1
Fremantle,"Nyhuis, Ryan",6,4,2,2,0,0,0,0
Fremantle,"Switkowski, Sam",12,3,0,9,1,1,0,4
Fremantle,"Tucker, Darcy",16,10,3,6,0,2,0,3
Fremantle,"Walters, Michael",19,9,3,10,3,1,0,2
Gold Coast,"Ainsworth, Ben",6,3,2,3,1,1,0,0
Gold Coast,"Ballard, Charlie",24,15,4,9,0,1,0,4
Gold Coast,"Bowes, Jack",22,7,5,15,0,0,0,5
Gold Coast,"Burgess, Chris",4,3,1,1,1,0,0,1
Gold Coast,"Collins, Sam",5,4,3,1,0,0,0,1
Gold Coast,"Fiorini, Brayden",30,16,4,14,0,0,0,6
Gold Coast,"Hanley, Pearce",13,8,4,5,0,0,0,2
Gold Coast,"Harbrow, Jarrod",18,10,5,8,0,0,0,1
Gold Coast,"Hombsch, Jack",10,7,4,3,0,0,0,1
Gold Coast,"Horlin-Smith, George",17,9,3,8,0,0,0,2
Gold Coast,"Lukosius, Jack",11,7,4,4,0,1,0,2
Gold Coast,"Macpherson, Darcy",20,14,4,6,0,0,0,9
Gold Coast,"Martin, Jack",19,12,4,7,0,1,0,3
Gold Coast,"Miles, Anthony",24,14,4,10,1,1,0,3
Gold Coast,"Miller, Touk",24,7,4,17,0,0,0,8
Gold Coast,"Murdoch, Jordan",13,6,2,7,0,0,0,2
Gold Coast,"Powell, Wil",23,17,7,6,1,1,0,2
Gold Coast,"Sexton, Alex",18,11,2,7,4,0,0,1
Gold Coast,"Swallow, David",11,7,3,4,3,0,0,4
Gold Coast,"Weller, Lachie",16,11,4,5,0,0,0,0
Gold Coast,"Witts, Jarrod",13,7,2,6,0,0,44,3
Gold Coast,"Wright, Peter",14,9,1,5,2,0,6,0
Gold Coast,"Ballard, Charlie",16,10,1,6,0,0,0,1
Gold Coast,"Bowes, Jack",27,11,4,16,0,0,0,6
Gold Coast,"Burgess, Chris",12,8,6,4,0,1,0,3
Gold Coast,"Collins, Sam",18,9,8,9,0,0,0,3
Gold Coast,"Fiorini, Brayden",25,15,2,10,0,0,0,3
Gold Coast,"Hanley, Pearce",19,11,3,8,0,0,0,1
Gold Coast,"Harbrow, Jarrod",32,19,9,13,0,0,0,0
Gold Coast,"Holman, Nick",15,3,1,12,0,0,0,4
Gold Coast,"Hombsch, Jack",9,5,4,4,0,0,0,2
Gold Coast,"Joyce, Jesse",17,11,4,6,0,0,0,2
Gold Coast,"Lukosius, Jack",7,6,2,1,0,2,0,2
Gold Coast,"Macpherson, Darcy",14,7,5,7,0,0,0,7
Gold Coast,"Martin, Jack",24,18,9,6,1,3,0,3
Gold Coast,"Miles, Anthony",20,17,1,3,0,0,0,3
Gold Coast,"Miller, Touk",20,9,5,11,1,0,0,4
Gold Coast,"Murdoch, Jordan",18,12,6,6,0,0,0,2
Gold Coast,"Powell, Wil",21,12,4,9,0,1,0,2
Gold Coast,"Sexton, Alex",17,13,3,4,4,5,0,4
Gold Coast,"Swallow, David",30,16,5,14,1,0,0,5
Gold Coast,"Weller, Lachie",22,15,7,7,0,0,0,2
Gold Coast,"Witts, Jarrod",16,9,2,7,0,0,35,3
Gold Coast,"Wright, Peter",15,9,6,6,0,3,7,1
Gold Coast,"Ballard, Charlie",7,4,2,3,0,0,0,2
Gold Coast,"Bowes, Jack",25,10,2,15,1,1,0,6
Gold Coast,"Burgess, Chris",9,4,3,5,1,2,0,1
Gold Coast,"Collins, Sam",11,5,6,6,0,0,0,1
Gold Coast,"Fiorini, Brayden",27,17,6,10,0,1,0,5
Gold Coast,"Hanley, Pearce",22,15,4,7,0,0,0,1
Gold Coast,"Harbrow, Jarrod",18,13,5,5,0,0,0,1
Gold Coast,"Holman, Nick",8,1,0,7,0,0,0,0
Gold Coast,"Hombsch, Jack",16,9,2,7,0,0,0,0
Gold Coast,"Joyce, Jesse",12,7,3,5,0,0,0,1
Gold Coast,"Lukosius, Jack",9,8,4,1,0,0,0,1
Gold Coast,"Macpherson, Darcy",16,8,4,8,2,0,0,3
Gold Coast,"Martin, Jack",23,18,7,5,1,4,0,6
Gold Coast,"Miles, Anthony",21,10,5,11,1,0,0,2
Gold Coast,"Miller, Touk",24,14,5,10,0,0,0,3
Gold Coast,"Murdoch, Jordan",11,8,2,3,0,1,0,5
Gold Coast,"Powell, Wil",11,7,4,4,0,0,0,3
Gold Coast,"Sexton, Alex",13,10,5,3,2,1,0,2
Gold Coast,"Swallow, David",14,11,3,3,2,0,0,1
Gold Coast,"Weller, Lachie",26,17,6,9,0,0,0,1
Gold Coast,"Witts, Jarrod",11,7,2,4,0,0,52,3
Gold Coast,"Wright, Peter",11,9,6,2,0,1,19,2
Gold Coast,"Ainsworth, Ben",19,11,4,8,1,0,0,4
Gold Coast,"Ballard, Charlie",16,10,5,6,0,0,0,2
Gold Coast,"Bowes, Jack",19,9,5,10,1,0,0,3
Gold Coast,"Burgess, Chris",6,3,2,3,0,0,0,3
Gold Coast,"Collins, Sam",12,8,5,4,0,0,0,2
Gold Coast,"Fiorini, Brayden",30,21,6,9,0,2,0,4
Gold Coast,"Hanley, Pearce",14,9,3,5,0,0,0,3
Gold Coast,"Harbrow, Jarrod",16,15,5,1,0,0,0,5
Gold Coast,"Holman, Nick",18,10,4,8,2,0,0,3
Gold Coast,"Hombsch, Jack",5,3,2,2,0,0,0,0
Gold Coast,"Joyce, Jesse",12,8,5,4,0,0,0,3
Gold Coast,"Lukosius, Jack",6,3,1,3,0,0,0,6
Gold Coast,"Macpherson, Darcy",19,10,6,9,0,0,0,9
Gold Coast,"Martin, Jack",22,8,2,14,0,1,0,2
Gold Coast,"Miles, Anthony",20,13,5,7,0,0,0,2
Gold Coast,"Miller, Touk",31,18,6,13,0,0,0,13
Gold Coast,"Murdoch, Jordan",16,13,5,3,0,2,0,0
Gold Coast,"Powell, Wil",4,2,1,2,0,1,0,1
Gold Coast,"Sexton, Alex",13,11,8,2,2,2,0,1
Gold Coast,"Swallow, David",30,15,8,15,0,1,0,1
Gold Coast,"Witts, Jarrod",13,9,3,4,1,0,44,7
Gold Coast,"Wright, Peter",9,6,5,3,1,1,3,0
Gold Coast,"Ainsworth, Ben",19,8,2,11,0,0,0,1
Gold Coast,"Ballard, Charlie",19,13,7,6,0,0,0,3
Gold Coast,"Bowes, Jack",21,12,7,9,0,0,0,7
Gold Coast,"Brodie, Will",23,9,2,14,0,0,0,7
Gold Coast,"Burgess, Chris",2,1,1,1,0,0,0,4
Gold Coast,"Collins, Sam",11,10,5,1,0,0,0,2
Gold Coast,"Fiorini, Brayden",30,17,5,13,1,0,0,7
Gold Coast,"Hanley, Pearce",29,22,6,7,0,0,0,4
Gold Coast,"Harbrow, Jarrod",16,9,3,7,0,0,0,1
Gold Coast,"Holman, Nick",18,7,2,11,0,2,0,4
Gold Coast,"Hombsch, Jack",8,3,5,5,0,0,0,1
Gold Coast,"Horlin-Smith, George",20,9,2,11,0,0,0,3
Gold Coast,"Joyce, Jesse",12,7,2,5,0,0,0,2
Gold Coast,"Lukosius, Jack",10,10,6,0,1,0,0,3
Gold Coast,"Macpherson, Darcy",15,8,3,7,0,0,0,5
Gold Coast,"Martin, Jack",17,12,4,5,0,0,0,8
Gold Coast,"Miller, Touk",28,10,5,18,0,0,0,9
Gold Coast,"Murdoch, Jordan",23,15,5,8,0,0,0,3
Gold Coast,"Sexton, Alex",13,9,5,4,1,3,0,1
Gold Coast,"Swallow, David",23,8,5,15,0,0,0,3
Gold Coast,"Witts, Jarrod",17,9,5,8,0,0,46,5
Gold Coast,"Wright, Peter",15,12,7,3,3,3,10,0
Gold Coast,"Ainsworth, Ben",21,12,4,9,0,0,0,1
Gold Coast,"Ballard, Charlie",9,7,3,2,0,0,0,0
Gold Coast,"Bowes, Jack",16,9,2,7,0,1,0,2
Gold Coast,"Brodie, Will",21,7,4,14,0,0,0,3
Gold Coast,"Collins, Sam",13,6,4,7,0,0,0,1
Gold Coast,"Corbett, Josh",6,3,3,3,2,0,0,0
Gold Coast,"Fiorini, Brayden",31,21,6,10,0,2,0,8
Gold Coast,"Hanley, Pearce",19,12,3,7,0,0,0,1
Gold Coast,"Harbrow, Jarrod",21,12,5,9,0,0,0,1
Gold Coast,"Holman, Nick",16,8,2,8,0,0,0,4
Gold Coast,"Hombsch, Jack",11,10,2,1,0,0,0,0
Gold Coast,"Horlin-Smith, George",13,7,2,6,0,0,0,4
Gold Coast,"Joyce, Jesse",17,9,5,8,0,0,0,3
Gold Coast,"Lukosius, Jack",6,4,1,2,1,0,0,4
Gold Coast,"Macpherson, Darcy",17,11,6,6,1,1,0,5
Gold Coast,"Martin, Jack",16,7,3,9,0,0,0,7
Gold Coast,"Miller, Touk",22,13,5,9,1,0,0,5
Gold Coast,"Murdoch, Jordan",8,6,3,2,0,0,0,1
Gold Coast,"Sexton, Alex",15,8,5,7,2,2,0,0
Gold Coast,"Swallow, David",24,13,7,11,0,1,0,3
Gold Coast,"Witts, Jarrod",13,5,2,8,0,0,43,6
Gold Coast,"Wright, Peter",14,8,7,6,2,0,3,0
Gold Coast,"Ainsworth, Ben",13,6,6,7,0,0,0,2
Gold Coast,"Ballard, Charlie",16,11,3,5,0,0,0,0
Gold Coast,"Bowes, Jack",19,9,6,10,1,0,0,3
Gold Coast,"Collins, Sam",13,8,5,5,0,0,0,1
Gold Coast,"Corbett, Josh",13,9,7,4,0,2,0,0
Gold Coast,"Fiorini, Brayden",20,10,3,10,0,0,0,4
Gold Coast,"Harbrow, Jarrod",30,20,6,10,0,0,0,3
Gold Coast,"Holman, Nick",14,5,3,9,1,0,0,5
Gold Coast,"Hombsch, Jack",8,6,4,2,0,0,0,3
Gold Coast,"Horlin-Smith, George",9,3,2,6,0,0,0,1
Gold Coast,"Joyce, Jesse",13,8,2,5,0,0,0,2
Gold Coast,"Macpherson, Darcy",16,9,3,7,0,1,0,5
Gold Coast,"Martin, Jack",29,11,3,18,0,0,0,10
Gold Coast,"Miles, Anthony",26,18,7,8,1,1,0,5
Gold Coast,"Miller, Touk",17,6,4,11,0,0,0,2
Gold Coast,"Murdoch, Jordan",18,13,4,5,0,0,0,1
Gold Coast,"Powell, Wil",16,9,3,7,2,0,0,2
Gold Coast,"Sexton, Alex",8,7,4,1,1,1,0,0
Gold Coast,"Swallow, David",22,12,3,10,0,0,0,2
Gold Coast,"Witts, Jarrod",14,6,1,8,0,0,60,1
Gold Coast,"Wright, Peter",10,9,7,1,2,1,4,2
Gold Coast,"Young, Aaron",10,5,2,5,0,1,0,2
Gold Coast,"Ainsworth, Ben",20,13,8,7,2,1,0,0
Gold Coast,"Ballard, Charlie",10,7,3,3,0,0,0,0
Gold Coast,"Bowes, Jack",18,10,6,8,0,0,0,2
Gold Coast,"Collins, Sam",17,11,6,6,0,0,0,1
Gold Coast,"Corbett, Josh",13,9,5,4,1,0,0,1
Gold Coast,"Hanley, Pearce",20,15,3,5,0,0,0,5
Gold Coast,"Harbrow, Jarrod",12,10,3,2,0,0,0,2
Gold Coast,"Holman, Nick",19,9,1,10,2,0,0,12
Gold Coast,"Hombsch, Jack",12,9,5,3,0,0,0,1
Gold Coast,"Lemmens, Sean",9,5,3,4,1,0,0,3
Gold Coast,"Lukosius, Jack",7,4,3,3,0,0,0,0
Gold Coast,"Macpherson, Darcy",27,16,5,11,1,0,0,8
Gold Coast,"Martin, Jack",19,14,6,5,0,0,0,3
Gold Coast,"Miles, Anthony",17,13,3,4,0,1,0,2
Gold Coast,"Miller, Touk",20,9,7,11,0,0,0,1
Gold Coast,"Murdoch, Jordan",5,4,3,1,0,0,0,4
Gold Coast,"Powell, Wil",14,10,6,4,1,0,0,3
Gold Coast,"Sexton, Alex",10,6,2,4,0,2,0,0
Gold Coast,"Swallow, David",35,18,4,17,0,1,0,3
Gold Coast,"Weller, Lachie",23,16,4,7,0,0,0,7
Gold Coast,"Witts, Jarrod",8,3,3,5,0,0,44,2
Gold Coast,"Wright, Peter",12,9,6,3,1,0,11,0
Gold Coast,"Ainsworth, Ben",16,12,4,4,1,1,0,3
Gold Coast,"Ballard, Charlie",15,11,4,4,0,0,0,3
Gold Coast,"Bowes, Jack",24,13,1,11,1,0,0,2
Gold Coast,"Collins, Sam",9,4,1,5,0,0,0,0
Gold Coast,"Corbett, Josh",13,8,6,5,0,2,0,4
Gold Coast,"Fiorini, Brayden",38,29,4,9,1,1,0,5
Gold Coast,"Harbrow, Jarrod",22,13,8,9,0,1,0,2
Gold Coast,"Holman, Nick",13,6,2,7,0,0,0,4
Gold Coast,"Hombsch, Jack",14,8,7,6,0,0,0,1
Gold Coast,"Joyce, Jesse",12,7,2,5,0,0,0,0
Gold Coast,"King, Ben",5,1,0,4,0,0,0,0
Gold Coast,"Lukosius, Jack",12,6,2,6,0,0,0,0
Gold Coast,"Macpherson, Darcy",20,13,3,7,0,0,0,12
Gold Coast,"Martin, Jack",15,11,3,4,1,0,0,6
Gold Coast,"Miles, Anthony",21,15,4,6,0,1,0,0
Gold Coast,"Murdoch, Jordan",11,7,1,4,0,0,0,0
Gold Coast,"Powell, Wil",14,8,4,6,0,1,0,4
Gold Coast,"Sexton, Alex",13,10,2,3,2,1,0,3
Gold Coast,"Swallow, David",18,11,3,7,0,1,0,6
Gold Coast,"Weller, Lachie",24,15,4,9,0,0,0,1
Gold Coast,"Witts, Jarrod",14,11,4,3,0,0,34,2
Gold Coast,"Wright, Peter",10,7,4,3,1,0,6,3
Gold Coast,"Ainsworth, Ben",12,7,1,5,1,1,0,1
Gold Coast,"Ballard, Charlie",11,8,2,3,0,0,0,0
Gold Coast,"Bowes, Jack",11,6,0,5,1,0,0,6
Gold Coast,"Burgess, Chris",6,1,1,5,0,0,0,2
Gold Coast,"Corbett, Josh",7,4,2,3,0,1,0,5
Gold Coast,"Fiorini, Brayden",29,23,7,6,0,0,0,5
Gold Coast,"Harbrow, Jarrod",9,6,1,3,0,0,0,3
Gold Coast,"Holman, Nick",12,6,1,6,0,1,0,14
Gold Coast,"Hombsch, Jack",8,5,5,3,0,0,0,1
Gold Coast,"Joyce, Jesse",18,13,4,5,0,0,0,4
Gold Coast,"King, Ben",5,2,1,3,0,0,0,1
Gold Coast,"Lukosius, Jack",9,8,4,1,0,0,0,3
Gold Coast,"Macpherson, Darcy",22,15,2,7,0,1,0,7
Gold Coast,"Martin, Jack",20,16,1,4,1,1,0,8
Gold Coast,"Miles, Anthony",23,11,3,12,0,0,0,5
Gold Coast,"Murdoch, Jordan",17,12,2,5,0,0,0,5
Gold Coast,"Powell, Wil",16,8,7,8,0,1,0,2
Gold Coast,"Sexton, Alex",7,7,4,0,3,2,0,3
Gold Coast,"Swallow, David",29,19,3,10,1,0,0,4
Gold Coast,"Weller, Lachie",27,16,2,11,0,0,0,3
Gold Coast,"Witts, Jarrod",15,8,3,7,1,0,51,2
Gold Coast,"Wright, Peter",10,7,3,3,1,0,8,4
Gold Coast,"Ballard, Charlie",5,5,1,0,0,0,0,0
Gold Coast,"Bowes, Jack",3,1,2,2,0,1,0,0
Gold Coast,"Burgess, Chris",4,2,2,2,0,0,0,0
Gold Coast,"Corbett, Josh",8,5,5,3,0,1,0,2
Gold Coast,"Fiorini, Brayden",21,14,4,7,0,0,0,6
Gold Coast,"Holman, Nick",13,6,6,7,0,1,0,5
Gold Coast,"Hombsch, Jack",5,5,3,0,0,0,0,2
Gold Coast,"Horlin-Smith, George",8,4,4,4,1,1,0,4
Gold Coast,"Joyce, Jesse",15,11,4,4,0,0,0,2
Gold Coast,"King, Ben",8,6,7,2,1,1,0,0
Gold Coast,"Lukosius, Jack",6,4,1,2,0,0,0,4
Gold Coast,"Macpherson, Darcy",23,18,4,5,1,0,0,3
Gold Coast,"Martin, Jack",15,11,1,4,0,1,0,8
Gold Coast,"Miles, Anthony",21,12,4,9,0,0,0,2
Gold Coast,"Murdoch, Jordan",12,7,2,5,0,0,0,2
Gold Coast,"Powell, Wil",11,4,3,7,1,0,0,1
Gold Coast,"Schoenfeld, Josh",10,3,1,7,0,0,0,2
Gold Coast,"Sexton, Alex",5,5,1,0,1,0,0,2
Gold Coast,"Swallow, David",20,9,2,11,1,0,0,2
Gold Coast,"Weller, Lachie",22,15,3,7,0,1,0,2
Gold Coast,"Witts, Jarrod",15,10,1,5,0,0,49,3
Gold Coast,"Wright, Peter",15,11,7,4,0,0,10,3
Gold Coast,"Ballard, Charlie",16,11,6,5,0,0,0,0
Gold Coast,"Brodie, Will",29,19,9,10,1,0,0,9
Gold Coast,"Burgess, Chris",8,2,3,6,0,0,0,1
Gold Coast,"Corbett, Josh",5,1,3,4,0,1,0,0
Gold Coast,"Fiorini, Brayden",31,18,6,13,0,0,0,2
Gold Coast,"Harbrow, Jarrod",27,23,5,4,0,0,0,1
Gold Coast,"Holman, Nick",15,7,3,8,0,1,0,4
Gold Coast,"Hombsch, Jack",10,7,3,3,0,0,0,2
Gold Coast,"Joyce, Jesse",14,10,5,4,1,0,0,2
Gold Coast,"King, Ben",8,5,3,3,2,1,0,0
Gold Coast,"Lukosius, Jack",12,11,6,1,1,0,0,0
Gold Coast,"Macpherson, Darcy",21,15,6,6,0,1,0,6
Gold Coast,"Martin, Jack",17,11,6,6,1,0,0,5
Gold Coast,"Miles, Anthony",28,15,2,13,0,1,0,2
Gold Coast,"Miller, Touk",4,1,0,3,1,0,0,3
Gold Coast,"Murdoch, Jordan",9,7,5,2,0,0,0,2
Gold Coast,"Powell, Wil",10,5,3,5,1,0,0,4
Gold Coast,"Sexton, Alex",12,10,2,2,1,0,0,0
Gold Coast,"Swallow, David",24,11,1,13,1,0,0,5
Gold Coast,"Weller, Lachie",27,15,7,12,0,0,0,2
Gold Coast,"Witts, Jarrod",14,8,0,6,0,0,47,2
Gold Coast,"Wright, Peter",9,5,3,4,1,0,5,0
Gold Coast,"Ah Chee, Callum",17,11,5,6,0,0,0,2
Gold Coast,"Ballard, Charlie",12,9,6,3,0,0,0,1
Gold Coast,"Brodie, Will",25,5,2,20,0,0,0,3
Gold Coast,"Day, Sam",16,7,7,9,1,0,19,3
Gold Coast,"Ellis, Corey",19,11,5,8,0,1,0,1
Gold Coast,"Fiorini, Brayden",22,10,3,12,0,1,0,6
Gold Coast,"Harbrow, Jarrod",18,15,3,3,0,0,0,0
Gold Coast,"Holman, Nick",12,7,0,5,2,0,0,2
Gold Coast,"Hombsch, Jack",13,8,5,5,0,0,0,1
Gold Coast,"Horlin-Smith, George",7,4,3,3,0,1,0,0
Gold Coast,"Joyce, Jesse",18,15,9,3,0,0,0,3
Gold Coast,"King, Ben",9,8,5,1,2,1,0,0
Gold Coast,"Lukosius, Jack",10,9,3,1,0,0,0,3
Gold Coast,"Macpherson, Darcy",12,8,1,4,0,0,0,5
Gold Coast,"Martin, Jack",18,9,4,9,1,0,0,7
Gold Coast,"Miles, Anthony",27,22,7,5,1,2,0,6
Gold Coast,"Powell, Wil",14,5,3,9,1,0,0,6
Gold Coast,"Sexton, Alex",10,5,2,5,1,1,0,5
Gold Coast,"Swallow, David",31,19,8,12,0,1,0,1
Gold Coast,"Weller, Lachie",27,15,2,12,0,0,0,1
Gold Coast,"Witts, Jarrod",13,7,3,6,0,0,39,0
Gold Coast,"Wright, Peter",10,8,5,2,2,0,1,2
Gold Coast,"Ballard, Charlie",12,12,11,0,0,0,0,2
Gold Coast,"Brodie, Will",20,11,4,9,0,0,0,5
Gold Coast,"Day, Sam",11,4,3,7,1,0,4,1
Gold Coast,"Ellis, Corey",21,14,3,7,0,0,0,2
Gold Coast,"Fiorini, Brayden",21,13,4,8,0,0,0,6
Gold Coast,"Hanley, Pearce",21,15,7,6,0,0,0,0
Gold Coast,"Harbrow, Jarrod",17,16,3,1,0,0,0,1
Gold Coast,"Hombsch, Jack",5,4,2,1,0,0,0,3
Gold Coast,"Joyce, Jesse",23,11,5,12,0,0,0,3
Gold Coast,"King, Ben",7,4,2,3,0,1,0,3
Gold Coast,"Lukosius, Jack",18,13,7,5,0,0,0,1
Gold Coast,"Macpherson, Darcy",21,16,6,5,2,1,0,4
Gold Coast,"Martin, Jack",11,9,2,2,0,0,0,5
Gold Coast,"Miles, Anthony",21,14,3,7,1,0,0,10
Gold Coast,"Miller, Touk",12,6,3,6,0,0,0,6
Gold Coast,"Powell, Wil",4,1,1,3,0,0,0,4
Gold Coast,"Scheer, Brad",9,8,3,1,1,1,0,1
Gold Coast,"Sexton, Alex",10,7,1,3,1,2,0,4
Gold Coast,"Swallow, David",26,17,6,9,0,0,0,2
Gold Coast,"Weller, Lachie",22,10,3,12,0,2,0,3
Gold Coast,"Witts, Jarrod",17,10,3,7,0,0,55,2
Gold Coast,"Wright, Peter",14,12,7,2,1,2,7,2
Gold Coast,"Ballard, Charlie",12,10,8,2,0,0,0,0
Gold Coast,"Brodie, Will",22,12,7,10,1,1,0,3
Gold Coast,"Corbett, Josh",8,7,6,1,0,0,0,0
Gold Coast,"Day, Sam",15,6,7,9,1,0,9,4
Gold Coast,"Fiorini, Brayden",19,16,3,3,0,0,0,5
Gold Coast,"Hanley, Pearce",16,8,3,8,0,1,0,5
Gold Coast,"Harbrow, Jarrod",19,15,5,4,0,0,0,0
Gold Coast,"Heron, Jacob",8,5,2,3,0,0,0,2
Gold Coast,"Hombsch, Jack",5,4,4,1,0,0,0,1
Gold Coast,"Joyce, Jesse",22,13,8,9,0,0,0,0
Gold Coast,"King, Ben",4,2,1,2,0,0,0,2
Gold Coast,"Lukosius, Jack",16,10,8,6,0,0,0,0
Gold Coast,"Macpherson, Darcy",24,16,3,8,2,0,0,5
Gold Coast,"Martin, Jack",17,12,7,5,1,0,0,4
Gold Coast,"Miles, Anthony",21,12,5,9,1,0,0,3
Gold Coast,"Miller, Touk",20,7,2,13,0,0,0,6
Gold Coast,"Powell, Wil",0,0,0,0,0,0,0,1
Gold Coast,"Scheer, Brad",7,7,2,0,0,0,0,1
Gold Coast,"Sexton, Alex",12,8,4,4,0,0,0,3
Gold Coast,"Swallow, David",30,15,4,15,1,0,0,3
Gold Coast,"Weller, Lachie",23,12,7,11,1,0,0,2
Gold Coast,"Witts, Jarrod",19,11,4,8,1,1,36,2
Gold Coast,"Ballard, Charlie",13,13,9,0,0,0,0,0
Gold Coast,"Brodie, Will",8,4,2,4,0,0,0,4
Gold Coast,"Corbett, Josh",8,4,3,4,0,1,0,2
Gold Coast,"Day, Sam",9,8,3,1,2,0,7,4
Gold Coast,"Fiorini, Brayden",15,9,1,6,0,0,0,7
Gold Coast,"Hanley, Pearce",24,16,6,8,0,0,0,3
Gold Coast,"Harbrow, Jarrod",15,11,6,4,0,0,0,2
Gold Coast,"Heron, Jacob",13,7,3,6,0,0,0,3
Gold Coast,"Hombsch, Jack",9,6,4,3,0,0,0,3
Gold Coast,"Joyce, Jesse",11,5,3,6,0,0,0,3
Gold Coast,"King, Ben",8,5,4,3,0,0,0,0
Gold Coast,"Lemmens, Sean",9,7,1,2,2,1,0,5
Gold Coast,"Lukosius, Jack",13,11,7,2,0,0,0,2
Gold Coast,"Macpherson, Darcy",18,14,6,4,1,1,0,9
Gold Coast,"Miles, Anthony",19,15,1,4,0,0,0,4
Gold Coast,"Miller, Touk",24,12,6,12,0,1,0,5
Gold Coast,"Rischitelli, Michael",7,4,1,3,0,0,0,3
Gold Coast,"Scheer, Brad",12,7,4,5,0,0,0,3
Gold Coast,"Sexton, Alex",13,10,3,3,3,1,0,2
Gold Coast,"Swallow, David",23,12,2,11,0,1,0,5
Gold Coast,"Weller, Lachie",14,10,7,4,0,0,0,2
Gold Coast,"Witts, Jarrod",17,12,3,5,0,1,32,5
Gold Coast,"Ballard, Charlie",9,7,4,2,0,0,0,1
Gold Coast,"Brodie, Will",26,10,4,16,0,0,0,10
Gold Coast,"Burgess, Chris",11,5,2,6,1,0,0,1
Gold Coast,"Dawson, Jacob",11,6,5,5,0,0,0,2
Gold Coast,"Day, Sam",11,6,4,5,0,1,0,3
Gold Coast,"Ellis, Corey",20,7,2,13,0,0,0,4
Gold Coast,"Fiorini, Brayden",32,22,6,10,0,0,0,5
Gold Coast,"Hanley, Pearce",18,11,7,7,1,0,0,2
Gold Coast,"Harbrow, Jarrod",16,12,2,4,0,0,0,3
Gold Coast,"Heron, Jacob",16,2,1,14,0,0,0,6
Gold Coast,"Hombsch, Jack",5,3,3,2,0,0,0,1
Gold Coast,"Joyce, Jesse",11,6,2,5,0,0,0,1
Gold Coast,"King, Ben",12,7,6,5,1,2,0,2
Gold Coast,"Lemmens, Sean",13,8,0,5,1,0,0,8
Gold Coast,"Lukosius, Jack",15,14,6,1,0,0,0,2
Gold Coast,"Macpherson, Darcy",25,18,4,7,1,0,0,10
Gold Coast,"Miller, Touk",27,17,9,10,0,0,0,11
Gold Coast,"Rischitelli, Michael",12,6,1,6,1,0,0,5
Gold Coast,"Sexton, Alex",12,10,4,2,3,0,0,2
Gold Coast,"Swallow, David",14,11,1,3,0,0,0,7
Gold Coast,"Witts, Jarrod",12,10,2,2,0,1,46,2
Gold Coast,"Wright, Peter",16,12,6,4,2,2,5,2
Gold Coast,"Burgess, Chris",13,6,4,7,1,0,0,1
Gold Coast,"Dawson, Jacob",18,10,6,8,0,0,0,2
Gold Coast,"Day, Sam",15,7,6,8,3,0,0,0
Gold Coast,"Ellis, Corey",12,3,2,9,0,0,0,1
Gold Coast,"Fiorini, Brayden",17,12,4,5,2,0,0,3
Gold Coast,"Hanley, Pearce",26,15,5,11,0,0,0,1
Gold Coast,"Harbrow, Jarrod",14,11,5,3,0,0,0,1
Gold Coast,"Heron, Jacob",12,6,4,6,0,0,0,1
Gold Coast,"Hombsch, Jack",7,3,1,4,0,0,0,4
Gold Coast,"Joyce, Jesse",12,6,3,6,0,0,0,2
Gold Coast,"King, Ben",9,7,5,2,4,0,0,0
Gold Coast,"Lemmens, Sean",13,9,3,4,0,0,0,6
Gold Coast,"Lukosius, Jack",10,9,4,1,0,0,0,2
Gold Coast,"Macpherson, Darcy",16,12,3,4,0,0,0,3
Gold Coast,"Miles, Anthony",20,16,3,4,0,1,0,4
Gold Coast,"Miller, Touk",32,17,4,15,1,2,0,4
Gold Coast,"Rischitelli, Michael",13,6,3,7,0,2,0,4
Gold Coast,"Sexton, Alex",9,6,3,3,1,0,0,0
Gold Coast,"Swallow, David",18,11,5,7,1,1,0,5
Gold Coast,"Weller, Lachie",18,12,7,6,0,0,0,3
Gold Coast,"Witts, Jarrod",19,13,4,6,0,0,60,1
Gold Coast,"Wright, Peter",14,6,3,8,2,0,4,1
Gold Coast,"Ainsworth, Ben",14,7,5,7,0,1,0,1
Gold Coast,"Ballard, Charlie",22,21,15,1,0,0,0,0
Gold Coast,"Bowes, Jack",14,4,3,10,0,0,0,0
Gold Coast,"Burgess, Chris",11,3,3,8,0,0,0,1
Gold Coast,"Dawson, Jacob",22,14,14,8,0,0,0,0
Gold Coast,"Day, Sam",14,10,8,4,1,1,1,1
Gold Coast,"Fiorini, Brayden",23,11,5,12,0,0,0,2
Gold Coast,"Hanley, Pearce",13,5,4,8,0,0,0,1
Gold Coast,"Harbrow, Jarrod",18,15,11,3,0,0,0,1
Gold Coast,"King, Ben",5,5,3,0,3,1,0,1
Gold Coast,"Lemmens, Sean",13,10,3,3,0,0,0,4
Gold Coast,"Lukosius, Jack",21,18,9,3,0,0,0,3
Gold Coast,"Macpherson, Darcy",15,9,7,6,0,0,0,5
Gold Coast,"Martin, Jack",8,6,4,2,1,0,0,4
Gold Coast,"Miles, Anthony",24,16,5,8,0,0,0,10
Gold Coast,"Miller, Touk",26,9,4,17,0,0,0,8
Gold Coast,"Rischitelli, Michael",12,9,5,3,0,0,0,1
Gold Coast,"Sexton, Alex",10,8,2,2,3,0,0,4
Gold Coast,"Swallow, David",20,12,6,8,0,0,0,4
Gold Coast,"Weller, Lachie",20,14,6,6,0,0,0,2
Gold Coast,"Witts, Jarrod",15,7,6,8,0,0,27,4
Gold Coast,"Wright, Peter",6,5,2,1,0,0,5,4
Gold Coast,"Ainsworth, Ben",15,9,4,6,1,0,0,2
Gold Coast,"Ballard, Charlie",7,6,1,1,0,0,0,1
Gold Coast,"Bowes, Jack",21,15,6,6,0,0,0,6
Gold Coast,"Burgess, Chris",10,7,4,3,0,0,3,0
Gold Coast,"Dawson, Jacob",16,9,6,7,0,0,0,3
Gold Coast,"Day, Sam",14,7,7,7,2,0,1,2
Gold Coast,"Fiorini, Brayden",20,15,2,5,1,0,0,5
Gold Coast,"Graham, Caleb",12,5,3,7,0,0,0,0
Gold Coast,"Hanley, Pearce",17,16,1,1,0,0,0,5
Gold Coast,"Harbrow, Jarrod",9,6,0,3,0,0,0,2
Gold Coast,"Heron, Jacob",8,6,4,2,0,0,0,0
Gold Coast,"King, Ben",6,3,2,3,0,0,0,0
Gold Coast,"Lemmens, Sean",10,6,0,4,0,0,0,5
Gold Coast,"Lukosius, Jack",16,9,1,7,0,0,0,3
Gold Coast,"Macpherson, Darcy",11,6,1,5,0,0,0,6
Gold Coast,"Miles, Anthony",11,5,3,6,0,1,0,3
Gold Coast,"Miller, Touk",22,10,2,12,0,0,0,5
Gold Coast,"Rischitelli, Michael",9,6,3,3,0,1,0,1
Gold Coast,"Sexton, Alex",8,6,2,2,2,1,0,0
Gold Coast,"Swallow, David",27,16,4,11,2,0,0,5
Gold Coast,"Weller, Lachie",15,8,2,7,0,1,0,3
Gold Coast,"Witts, Jarrod",13,10,3,3,0,0,53,3
Gold Coast,"Ainsworth, Ben",18,7,5,11,1,1,0,1
Gold Coast,"Ballard, Charlie",13,12,9,1,0,0,0,3
Gold Coast,"Bowes, Jack",12,5,1,7,0,0,0,5
Gold Coast,"Burgess, Chris",9,4,4,5,0,0,4,4
Gold Coast,"Dawson, Jacob",20,12,5,8,0,0,0,3
Gold Coast,"Day, Sam",7,3,3,4,0,1,0,2
Gold Coast,"Fiorini, Brayden",30,18,3,12,0,0,0,3
Gold Coast,"Graham, Caleb",16,9,4,7,0,0,0,3
Gold Coast,"Hanley, Pearce",34,25,11,9,0,0,0,2
Gold Coast,"Harbrow, Jarrod",32,25,7,7,0,0,0,4
Gold Coast,"Horlin-Smith, George",9,5,1,4,1,0,0,3
Gold Coast,"King, Ben",8,6,5,2,1,2,0,1
Gold Coast,"Lemmens, Sean",8,5,4,3,0,0,0,2
Gold Coast,"Lukosius, Jack",9,8,4,1,0,0,0,3
Gold Coast,"Macpherson, Darcy",23,9,4,14,1,1,0,4
Gold Coast,"Miller, Touk",30,9,6,21,0,0,0,3
Gold Coast,"Murdoch, Jordan",16,12,4,4,1,0,0,3
Gold Coast,"Rischitelli, Michael",9,4,3,5,1,0,0,3
Gold Coast,"Sexton, Alex",12,9,3,3,0,1,0,2
Gold Coast,"Swallow, David",26,9,0,17,0,0,0,8
Gold Coast,"Weller, Lachie",29,14,6,15,1,0,0,2
Gold Coast,"Witts, Jarrod",12,4,3,8,0,0,42,5
Gold Coast,"Ainsworth, Ben",27,15,4,12,0,0,0,3
Gold Coast,"Ballard, Charlie",10,9,7,1,0,0,0,0
Gold Coast,"Bowes, Jack",24,18,3,6,1,0,0,2
Gold Coast,"Burgess, Chris",10,6,2,4,0,0,0,0
Gold Coast,"Dawson, Jacob",15,11,6,4,0,0,0,3
Gold Coast,"Day, Sam",4,3,2,1,0,1,3,1
Gold Coast,"Fiorini, Brayden",23,12,4,11,0,0,0,3
Gold Coast,"Graham, Caleb",7,4,4,3,0,0,0,1
Gold Coast,"Hanley, Pearce",23,17,6,6,0,0,0,1
Gold Coast,"Harbrow, Jarrod",18,16,4,2,0,0,0,0
Gold Coast,"King, Ben",5,4,4,1,3,0,0,0
Gold Coast,"Lemmens, Sean",9,5,1,4,0,0,0,3
Gold Coast,"Lukosius, Jack",14,11,7,3,0,1,0,0
Gold Coast,"Macpherson, Darcy",16,10,5,6,0,2,0,4
Gold Coast,"Miller, Touk",19,9,4,10,0,0,0,7
Gold Coast,"Murdoch, Jordan",9,7,2,2,0,0,0,2
Gold Coast,"Rischitelli, Michael",6,3,1,3,0,0,0,4
Gold Coast,"Sexton, Alex",12,11,5,1,2,4,0,3
Gold Coast,"Swallow, David",14,10,4,4,0,0,0,5
Gold Coast,"Weller, Lachie",20,12,4,8,0,1,0,11
Gold Coast,"Witts, Jarrod",20,12,5,8,0,0,69,4
Gold Coast,"Young, Aaron",11,7,2,4,1,0,0,3
Geelong,"Ablett, Gary",23,13,6,10,2,1,0,3
Geelong,"Atkins, Tom",9,5,2,4,0,0,0,5
Geelong,"Blicavs, Mark",12,6,4,6,0,0,0,2
Geelong,"Clark, Jordan",17,14,4,3,0,0,0,0
Geelong,"Constable, Charlie",21,9,4,12,1,0,0,3
Geelong,"Dahlhaus, Luke",24,8,4,16,1,1,0,6
Geelong,"Dangerfield, Patrick",27,16,5,11,1,2,0,3
Geelong,"Duncan, Mitch",19,13,8,6,1,1,0,3
Geelong,"Hawkins, Tom",12,7,6,5,2,2,0,4
Geelong,"Henry, Jack",5,3,2,2,0,0,0,1
Geelong,"Kelly, Tim",31,17,5,14,0,0,0,4
Geelong,"Kolodjashnij, Jake",9,5,1,4,0,0,0,3
Geelong,"Menegola, Sam",19,12,6,7,0,1,0,3
Geelong,"Miers, Gryan",11,6,1,5,0,0,0,3
Geelong,"OConnor, Mark",13,6,3,7,0,0,0,1
Geelong,"Parfitt, Brandan",22,13,1,9,1,0,0,6
Geelong,"Ratugolea, Esava",5,2,0,3,0,0,4,2
Geelong,"Rohan, Gary",10,9,5,1,0,0,0,2
Geelong,"Selwood, Joel",25,16,7,9,1,1,0,2
Geelong,"Stanley, Rhys",18,11,4,7,0,0,23,2
Geelong,"Stewart, Tom",26,20,7,6,0,0,0,2
Geelong,"Taylor, Harry",16,7,6,9,0,0,0,3
Geelong,"Ablett, Gary",25,12,2,13,0,3,0,3
Geelong,"Atkins, Tom",12,4,0,8,0,0,0,8
Geelong,"Blicavs, Mark",13,10,4,3,0,0,0,4
Geelong,"Clark, Jordan",15,11,3,4,1,0,0,4
Geelong,"Constable, Charlie",31,13,4,18,1,0,0,4
Geelong,"Dahlhaus, Luke",21,8,0,13,2,0,0,11
Geelong,"Dangerfield, Patrick",37,18,6,19,2,0,1,4
Geelong,"Duncan, Mitch",26,17,7,9,1,0,0,3
Geelong,"Hawkins, Tom",16,10,5,6,2,0,0,3
Geelong,"Henry, Jack",5,5,1,0,0,0,0,2
Geelong,"Kelly, Tim",30,14,2,16,1,2,0,5
Geelong,"Kolodjashnij, Jake",17,12,5,5,0,0,0,3
Geelong,"Menegola, Sam",21,8,3,13,1,0,0,7
Geelong,"Miers, Gryan",20,9,3,11,1,0,0,2
Geelong,"OConnor, Mark",11,7,4,4,1,0,0,2
Geelong,"Parfitt, Brandan",19,9,1,10,1,0,0,10
Geelong,"Ratugolea, Esava",6,5,1,1,1,0,9,4
Geelong,"Rohan, Gary",9,7,1,2,3,0,0,2
Geelong,"Selwood, Joel",18,13,1,5,2,0,0,7
Geelong,"Stanley, Rhys",14,8,3,6,0,0,27,0
Geelong,"Stewart, Tom",27,22,6,5,0,0,0,5
Geelong,"Taylor, Harry",14,7,3,7,0,0,0,2
Geelong,"Ablett, Gary",17,12,6,5,1,1,0,1
Geelong,"Atkins, Tom",6,3,1,3,1,1,0,0
Geelong,"Blicavs, Mark",22,10,6,12,0,0,0,3
Geelong,"Clark, Jordan",12,12,3,0,1,0,0,2
Geelong,"Constable, Charlie",23,13,4,10,1,1,0,1
Geelong,"Dahlhaus, Luke",21,10,4,11,0,2,0,7
Geelong,"Dangerfield, Patrick",32,21,7,11,1,1,0,7
Geelong,"Duncan, Mitch",22,17,11,5,0,0,0,3
Geelong,"Hawkins, Tom",10,7,5,3,2,0,0,0
Geelong,"Henderson, Lachie",14,11,5,3,0,0,0,1
Geelong,"Kelly, Tim",24,15,4,9,0,0,0,4
Geelong,"Kolodjashnij, Jake",10,4,3,6,0,0,0,0
Geelong,"Menegola, Sam",23,16,8,7,1,2,0,0
Geelong,"Miers, Gryan",11,7,5,4,3,1,0,2
Geelong,"OConnor, Mark",11,7,5,4,0,0,0,1
Geelong,"Parfitt, Brandan",16,10,3,6,0,2,0,1
Geelong,"Ratugolea, Esava",6,3,2,3,0,0,5,0
Geelong,"Rohan, Gary",6,5,3,1,2,1,0,2
Geelong,"Selwood, Joel",16,5,5,11,0,0,0,3
Geelong,"Stanley, Rhys",12,9,2,3,0,1,32,3
Geelong,"Stewart, Tom",23,22,8,1,0,0,0,3
Geelong,"Taylor, Harry",12,9,6,3,1,0,0,4
Geelong,"Ablett, Gary",16,8,3,8,2,2,0,8
Geelong,"Atkins, Tom",14,7,6,7,0,1,0,4
Geelong,"Blicavs, Mark",9,6,5,3,0,0,0,3
Geelong,"Clark, Jordan",7,7,4,0,0,0,0,0
Geelong,"Constable, Charlie",16,6,3,10,0,0,0,7
Geelong,"Dahlhaus, Luke",15,4,1,11,0,0,0,2
Geelong,"Dangerfield, Patrick",17,10,1,7,1,0,0,3
Geelong,"Duncan, Mitch",26,15,5,11,0,1,0,3
Geelong,"Hawkins, Tom",15,10,4,5,3,2,2,0
Geelong,"Henry, Jack",6,4,2,2,0,0,0,1
Geelong,"Kelly, Tim",9,8,0,1,1,1,0,7
Geelong,"Kolodjashnij, Jake",13,6,6,7,0,0,0,0
Geelong,"Menegola, Sam",14,6,0,8,0,1,0,2
Geelong,"Miers, Gryan",12,5,5,7,1,0,0,2
Geelong,"OConnor, Mark",13,10,7,3,0,0,0,2
Geelong,"Parfitt, Brandan",24,11,2,13,0,0,0,5
Geelong,"Ratugolea, Esava",9,7,3,2,0,1,4,2
Geelong,"Rohan, Gary",6,6,3,0,2,0,0,0
Geelong,"Selwood, Joel",18,9,5,9,0,0,0,3
Geelong,"Stanley, Rhys",9,5,4,4,0,0,31,2
Geelong,"Stewart, Tom",26,23,8,3,0,0,0,0
Geelong,"Taylor, Harry",11,8,3,3,1,0,0,1
Geelong,"Ablett, Gary",23,19,8,4,3,1,0,2
Geelong,"Atkins, Tom",17,6,1,11,0,0,0,7
Geelong,"Blicavs, Mark",16,13,8,3,0,0,0,4
Geelong,"Clark, Jordan",10,8,3,2,0,0,0,5
Geelong,"Dahlhaus, Luke",22,10,5,12,1,1,0,5
Geelong,"Dangerfield, Patrick",28,15,2,13,2,1,0,5
Geelong,"Duncan, Mitch",25,17,6,8,0,0,0,2
Geelong,"Guthrie, Cameron",22,9,4,13,0,0,0,8
Geelong,"Hawkins, Tom",14,9,7,5,1,2,0,3
Geelong,"Henry, Jack",10,4,3,6,0,0,0,2
Geelong,"Kelly, Tim",29,22,5,7,2,0,0,3
Geelong,"Kolodjashnij, Jake",12,9,6,3,0,0,0,1
Geelong,"Menegola, Sam",16,11,6,5,0,0,0,2
Geelong,"Miers, Gryan",18,15,5,3,1,1,0,2
Geelong,"OConnor, Mark",15,10,5,5,0,0,0,3
Geelong,"Parfitt, Brandan",6,3,2,3,0,0,0,4
Geelong,"Ratugolea, Esava",6,4,2,2,0,2,7,1
Geelong,"Rohan, Gary",12,10,4,2,4,1,0,2
Geelong,"Selwood, Joel",32,10,5,22,0,0,0,5
Geelong,"Stanley, Rhys",13,8,5,5,2,0,26,3
Geelong,"Stewart, Tom",21,15,6,6,0,0,0,1
Geelong,"Taylor, Harry",21,8,4,13,1,0,0,1
Geelong,"Ablett, Gary",28,16,7,12,2,1,0,2
Geelong,"Atkins, Tom",11,7,1,4,0,0,0,5
Geelong,"Blicavs, Mark",15,10,8,5,0,0,0,4
Geelong,"Constable, Charlie",21,9,6,12,1,0,0,2
Geelong,"Dahlhaus, Luke",21,6,2,15,0,0,0,1
Geelong,"Dangerfield, Patrick",30,21,9,9,1,1,0,7
Geelong,"Duncan, Mitch",28,17,12,11,0,0,0,5
Geelong,"Guthrie, Cameron",21,10,6,11,0,0,0,5
Geelong,"Hawkins, Tom",18,11,5,7,3,3,2,1
Geelong,"Henry, Jack",16,9,3,7,0,1,0,2
Geelong,"Kelly, Tim",18,9,2,9,0,2,0,11
Geelong,"Kolodjashnij, Jake",15,10,7,5,0,0,0,0
Geelong,"Menegola, Sam",22,10,6,12,0,0,0,2
Geelong,"Miers, Gryan",20,16,6,4,2,0,0,1
Geelong,"OConnor, Mark",21,13,9,8,0,0,0,2
Geelong,"Ratugolea, Esava",14,8,5,6,1,2,9,2
Geelong,"Rohan, Gary",14,13,10,1,4,0,0,1
Geelong,"Selwood, Joel",25,14,2,11,0,0,0,2
Geelong,"Stanley, Rhys",21,11,4,10,1,0,30,3
Geelong,"Stewart, Tom",25,22,13,3,0,0,0,4
Geelong,"Taylor, Harry",22,15,10,7,0,0,0,1
Geelong,"Tuohy, Zach",18,14,5,4,0,2,0,2
Geelong,"Ablett, Gary",26,16,7,10,2,0,0,5
Geelong,"Atkins, Tom",23,7,1,16,0,0,0,6
Geelong,"Blicavs, Mark",13,9,7,4,0,0,0,3
Geelong,"Clark, Jordan",7,6,4,1,0,1,0,5
Geelong,"Dahlhaus, Luke",22,9,5,13,1,1,0,5
Geelong,"Dangerfield, Patrick",8,5,4,3,0,1,0,1
Geelong,"Duncan, Mitch",22,15,10,7,3,0,0,4
Geelong,"Guthrie, Cameron",25,10,6,15,1,0,0,9
Geelong,"Guthrie, Zach",13,11,5,2,0,0,0,1
Geelong,"Hawkins, Tom",19,14,10,5,2,0,2,3
Geelong,"Henry, Jack",16,13,9,3,0,0,0,1
Geelong,"Kelly, Tim",30,19,4,11,2,0,0,2
Geelong,"Kolodjashnij, Jake",15,12,11,3,0,0,0,1
Geelong,"Menegola, Sam",28,16,8,12,0,0,0,3
Geelong,"Miers, Gryan",25,13,5,12,1,0,0,2
Geelong,"OConnor, Mark",13,5,4,8,0,0,0,3
Geelong,"Parfitt, Brandan",15,6,1,9,0,0,0,8
Geelong,"Ratugolea, Esava",4,2,1,2,0,0,3,2
Geelong,"Rohan, Gary",8,8,4,0,1,1,0,3
Geelong,"Stanley, Rhys",17,10,5,7,0,1,32,2
Geelong,"Stewart, Tom",25,21,9,4,0,0,0,0
Geelong,"Taylor, Harry",12,7,4,5,0,1,0,2
Geelong,"Ablett, Gary",16,12,6,4,4,0,0,0
Geelong,"Atkins, Tom",4,0,0,4,0,0,0,0
Geelong,"Blicavs, Mark",11,5,2,6,0,0,0,3
Geelong,"Clark, Jordan",17,14,7,3,2,1,0,4
Geelong,"Constable, Charlie",27,11,10,16,0,0,0,3
Geelong,"Dahlhaus, Luke",18,5,3,13,1,1,0,6
Geelong,"Dangerfield, Patrick",27,12,5,15,1,0,0,3
Geelong,"Duncan, Mitch",29,16,12,13,0,1,0,8
Geelong,"Guthrie, Cameron",21,8,0,13,0,0,0,3
Geelong,"Hawkins, Tom",12,9,5,3,4,0,1,2
Geelong,"Henry, Jack",10,7,4,3,0,0,0,1
Geelong,"Kelly, Tim",36,23,3,13,2,0,0,7
Geelong,"Kolodjashnij, Jake",11,6,3,5,0,1,0,0
Geelong,"Miers, Gryan",22,12,8,10,1,3,0,2
Geelong,"OConnor, Mark",17,5,3,12,0,0,0,2
Geelong,"Parfitt, Brandan",23,11,5,12,0,0,0,4
Geelong,"Ratugolea, Esava",7,4,1,3,0,0,7,1
Geelong,"Rohan, Gary",10,6,1,4,1,0,0,1
Geelong,"Stanley, Rhys",11,4,3,7,0,0,29,2
Geelong,"Stewart, Tom",23,19,8,4,0,0,0,0
Geelong,"Taylor, Harry",20,14,10,6,0,0,0,1
Geelong,"Tuohy, Zach",15,10,5,5,0,0,0,0
Geelong,"Abbott, Ryan",11,5,3,6,1,0,24,4
Geelong,"Ablett, Gary",13,10,2,3,2,2,0,5
Geelong,"Blicavs, Mark",11,6,3,5,0,0,0,1
Geelong,"Clark, Jordan",7,5,1,2,0,0,0,1
Geelong,"Constable, Charlie",11,2,0,9,1,1,0,6
Geelong,"Dahlhaus, Luke",17,7,3,10,0,1,0,4
Geelong,"Dangerfield, Patrick",23,12,4,11,1,0,0,4
Geelong,"Duncan, Mitch",25,16,11,9,3,0,0,2
Geelong,"Fort, Darcy",9,7,3,2,3,0,18,2
Geelong,"Guthrie, Cameron",11,8,3,3,1,0,0,7
Geelong,"Hawkins, Tom",10,8,4,2,4,0,0,0
Geelong,"Henry, Jack",9,6,3,3,0,0,0,1
Geelong,"Kelly, Tim",20,10,3,10,0,0,0,0
Geelong,"Kolodjashnij, Jake",9,7,3,2,0,0,0,1
Geelong,"Miers, Gryan",13,7,3,6,1,0,0,3
Geelong,"OConnor, Mark",12,10,6,2,0,0,0,2
Geelong,"Parfitt, Brandan",18,9,1,9,1,0,0,6
Geelong,"Rohan, Gary",14,11,7,3,3,2,0,2
Geelong,"Selwood, Joel",21,15,4,6,0,0,0,2
Geelong,"Stewart, Tom",22,19,6,3,0,0,0,1
Geelong,"Taylor, Harry",16,5,4,11,0,0,0,1
Geelong,"Tuohy, Zach",19,10,3,9,0,0,0,0
Geelong,"Ablett, Gary",20,10,1,10,2,1,0,1
Geelong,"Atkins, Tom",15,7,3,8,1,0,0,11
Geelong,"Blicavs, Mark",18,8,7,10,0,0,0,1
Geelong,"Clark, Jordan",18,12,5,6,1,1,0,4
Geelong,"Dahlhaus, Luke",20,7,4,13,0,0,0,7
Geelong,"Duncan, Mitch",27,16,8,11,3,0,0,2
Geelong,"Fort, Darcy",7,4,1,3,0,0,12,2
Geelong,"Guthrie, Cameron",21,12,3,9,0,1,0,11
Geelong,"Hawkins, Tom",13,9,7,4,4,3,1,3
Geelong,"Henry, Jack",11,7,3,4,0,0,0,2
Geelong,"Kelly, Tim",35,22,5,13,0,2,0,4
Geelong,"Kolodjashnij, Jake",8,6,4,2,0,0,0,3
Geelong,"Miers, Gryan",12,7,3,5,0,0,0,2
Geelong,"OConnor, Mark",8,5,3,3,0,0,0,3
Geelong,"Parfitt, Brandan",19,8,1,11,0,0,0,9
Geelong,"Parsons, James",15,12,1,3,2,0,0,4
Geelong,"Rohan, Gary",14,8,2,6,0,1,0,5
Geelong,"Selwood, Joel",22,16,3,6,0,0,0,4
Geelong,"Stanley, Rhys",13,5,2,8,0,2,33,6
Geelong,"Stewart, Tom",21,17,5,4,0,0,0,3
Geelong,"Taylor, Harry",9,4,1,5,0,0,0,4
Geelong,"Tuohy, Zach",19,15,4,4,0,0,0,3
Geelong,"Atkins, Tom",14,2,0,12,0,0,0,5
Geelong,"Blicavs, Mark",16,7,6,9,0,0,0,2
Geelong,"Clark, Jordan",20,14,4,6,1,1,0,1
Geelong,"Dahlhaus, Luke",23,11,4,12,1,1,0,2
Geelong,"Dangerfield, Patrick",29,14,4,15,2,1,0,3
Geelong,"Duncan, Mitch",22,14,5,8,1,0,0,0
Geelong,"Guthrie, Cameron",17,11,5,6,0,0,0,1
Geelong,"Hawkins, Tom",14,7,5,7,4,0,4,2
Geelong,"Henry, Jack",10,5,3,5,0,0,0,2
Geelong,"Kelly, Tim",25,16,4,9,1,1,0,4
Geelong,"Kolodjashnij, Jake",11,6,5,5,0,0,0,2
Geelong,"Miers, Gryan",11,5,1,6,1,0,0,3
Geelong,"OConnor, Mark",20,11,4,9,0,0,0,1
Geelong,"Parfitt, Brandan",23,14,2,9,0,0,0,5
Geelong,"Parsons, James",15,14,6,1,0,1,0,0
Geelong,"Ratugolea, Esava",16,6,1,10,2,0,4,3
Geelong,"Rohan, Gary",4,1,0,3,0,0,1,2
Geelong,"Selwood, Joel",17,10,2,7,0,0,0,4
Geelong,"Smith, Zac",11,6,4,5,0,0,33,2
Geelong,"Stewart, Tom",23,19,4,4,0,1,0,1
Geelong,"Taylor, Harry",13,5,3,8,0,0,0,2
Geelong,"Tuohy, Zach",20,13,1,7,0,0,0,2
Geelong,"Ablett, Gary",24,14,6,10,2,1,0,7
Geelong,"Atkins, Tom",16,8,4,8,0,0,0,1
Geelong,"Blicavs, Mark",10,5,7,5,0,0,0,0
Geelong,"Clark, Jordan",12,12,2,0,0,0,0,0
Geelong,"Dahlhaus, Luke",24,8,6,16,0,1,0,5
Geelong,"Dangerfield, Patrick",38,21,7,17,1,0,0,9
Geelong,"Duncan, Mitch",34,21,11,13,1,1,0,4
Geelong,"Guthrie, Cameron",27,19,5,8,0,0,0,4
Geelong,"Hawkins, Tom",13,6,4,7,4,1,2,2
Geelong,"Henry, Jack",11,8,4,3,0,0,0,2
Geelong,"Kelly, Tim",32,19,9,13,1,1,0,3
Geelong,"Kolodjashnij, Jake",13,9,5,4,0,0,0,2
Geelong,"Miers, Gryan",21,14,4,7,3,0,0,0
Geelong,"OConnor, Mark",16,9,6,7,0,0,0,4
Geelong,"Parfitt, Brandan",19,10,2,9,0,0,0,5
Geelong,"Ratugolea, Esava",8,6,6,2,2,0,8,0
Geelong,"Rohan, Gary",8,6,2,2,1,0,0,2
Geelong,"Selwood, Joel",18,13,3,5,0,0,0,4
Geelong,"Stanley, Rhys",14,5,0,9,1,0,33,4
Geelong,"Stewart, Tom",27,24,9,3,0,0,0,0
Geelong,"Taylor, Harry",11,9,5,2,0,0,2,1
Geelong,"Tuohy, Zach",18,13,5,5,0,0,0,1
Geelong,"Ablett, Gary",19,11,2,8,2,0,0,3
Geelong,"Atkins, Tom",15,7,1,8,0,1,0,5
Geelong,"Blicavs, Mark",10,9,6,1,0,0,2,7
Geelong,"Clark, Jordan",14,6,4,8,0,1,0,2
Geelong,"Dahlhaus, Luke",7,3,3,4,0,0,0,4
Geelong,"Dangerfield, Patrick",27,15,6,12,1,1,0,4
Geelong,"Duncan, Mitch",35,19,6,16,0,1,0,2
Geelong,"Fort, Darcy",7,5,2,2,2,0,7,1
Geelong,"Guthrie, Cameron",14,9,6,5,0,0,0,7
Geelong,"Hawkins, Tom",5,1,0,4,0,0,2,4
Geelong,"Henry, Jack",12,7,7,5,0,1,0,3
Geelong,"Kelly, Tim",17,8,1,9,1,1,0,5
Geelong,"Kolodjashnij, Jake",12,7,4,5,0,0,0,4
Geelong,"Miers, Gryan",6,4,1,2,1,0,0,2
Geelong,"OConnor, Mark",11,9,3,2,0,0,0,5
Geelong,"Parfitt, Brandan",17,8,3,9,0,0,0,9
Geelong,"Rohan, Gary",5,4,2,1,0,0,0,1
Geelong,"Selwood, Joel",19,12,2,7,0,1,0,4
Geelong,"Stanley, Rhys",7,4,1,3,1,0,23,0
Geelong,"Stewart, Tom",23,18,8,5,0,0,0,1
Geelong,"Taylor, Harry",14,7,4,7,0,0,0,1
Geelong,"Tuohy, Zach",28,20,8,8,0,1,0,0
Geelong,"Ablett, Gary",19,9,0,10,2,0,0,0
Geelong,"Atkins, Tom",7,3,1,4,0,0,0,7
Geelong,"Bews, Jed",18,11,8,7,1,0,0,4
Geelong,"Blicavs, Mark",18,9,5,9,0,0,16,6
Geelong,"Clark, Jordan",23,12,6,11,1,1,0,3
Geelong,"Dahlhaus, Luke",21,7,2,14,0,1,0,6
Geelong,"Dangerfield, Patrick",24,13,4,11,0,2,0,5
Geelong,"Duncan, Mitch",28,10,7,18,1,0,0,3
Geelong,"Fogarty, Lachie",7,3,3,4,0,0,0,7
Geelong,"Guthrie, Cameron",22,10,3,12,2,0,0,4
Geelong,"Hawkins, Tom",12,9,6,3,2,3,0,0
Geelong,"Henry, Jack",11,11,6,0,0,0,0,3
Geelong,"Kelly, Tim",33,22,6,11,2,1,0,1
Geelong,"Kolodjashnij, Jake",14,12,7,2,0,0,0,2
Geelong,"Miers, Gryan",20,14,5,6,2,0,0,2
Geelong,"OConnor, Mark",9,5,5,4,0,0,0,1
Geelong,"Parfitt, Brandan",18,10,1,8,0,0,0,4
Geelong,"Selwood, Joel",33,18,7,15,0,0,0,2
Geelong,"Stanley, Rhys",13,8,4,5,1,2,18,2
Geelong,"Stewart, Tom",26,19,11,7,0,0,0,1
Geelong,"Taylor, Harry",16,9,5,7,0,0,0,3
Geelong,"Tuohy, Zach",18,13,4,5,0,0,0,0
Geelong,"Ablett, Gary",11,5,1,6,0,0,0,7
Geelong,"Atkins, Tom",12,6,3,6,0,0,0,2
Geelong,"Bews, Jed",9,3,3,6,0,0,0,2
Geelong,"Blicavs, Mark",20,7,4,13,0,0,8,4
Geelong,"Clark, Jordan",20,11,8,9,0,1,0,3
Geelong,"Dahlhaus, Luke",18,8,1,10,0,0,0,5
Geelong,"Dangerfield, Patrick",23,11,6,12,2,1,0,7
Geelong,"Duncan, Mitch",19,11,8,8,0,0,0,2
Geelong,"Fogarty, Lachie",12,7,0,5,0,0,0,3
Geelong,"Guthrie, Cameron",12,4,2,8,0,0,0,2
Geelong,"Hawkins, Tom",8,6,3,2,2,1,1,2
Geelong,"Henry, Jack",12,9,7,3,0,1,0,0
Geelong,"Kelly, Tim",21,11,3,10,1,1,0,2
Geelong,"Kolodjashnij, Jake",3,2,2,1,0,0,0,0
Geelong,"Miers, Gryan",7,5,2,2,0,1,0,1
Geelong,"OConnor, Mark",19,15,8,4,0,0,0,2
Geelong,"Rohan, Gary",12,11,10,1,1,3,0,0
Geelong,"Selwood, Joel",21,13,3,8,1,1,0,2
Geelong,"Stanley, Rhys",20,12,4,8,0,0,28,3
Geelong,"Stewart, Tom",24,18,10,6,0,1,0,3
Geelong,"Taylor, Harry",17,10,11,7,0,1,0,1
Geelong,"Tuohy, Zach",30,25,6,5,0,1,0,1
Geelong,"Ablett, Gary",18,13,5,5,2,0,0,4
Geelong,"Atkins, Tom",9,2,1,7,1,0,0,5
Geelong,"Bews, Jed",16,12,2,4,0,1,0,2
Geelong,"Blicavs, Mark",11,7,3,4,0,0,0,3
Geelong,"Clark, Jordan",15,7,7,8,0,0,0,5
Geelong,"Dahlhaus, Luke",21,5,2,16,0,1,0,2
Geelong,"Dangerfield, Patrick",32,15,4,17,1,1,0,6
Geelong,"Duncan, Mitch",33,16,5,17,1,1,0,4
Geelong,"Guthrie, Cameron",16,10,6,6,2,1,0,3
Geelong,"Hawkins, Tom",11,5,2,6,1,0,0,4
Geelong,"Henry, Jack",6,4,0,2,0,0,0,1
Geelong,"Kelly, Tim",19,9,3,10,1,0,0,7
Geelong,"Miers, Gryan",23,11,5,12,1,1,0,4
Geelong,"OConnor, Mark",17,10,5,7,0,0,0,1
Geelong,"Parfitt, Brandan",17,10,2,7,0,0,0,6
Geelong,"Ratugolea, Esava",13,8,3,5,2,2,2,7
Geelong,"Rohan, Gary",10,7,1,3,0,0,0,1
Geelong,"Selwood, Joel",22,13,3,9,0,0,0,4
Geelong,"Stanley, Rhys",14,8,3,6,0,0,33,3
Geelong,"Stewart, Tom",21,18,6,3,0,0,0,2
Geelong,"Taylor, Harry",17,9,4,8,0,0,0,2
Geelong,"Tuohy, Zach",17,9,3,8,0,0,0,0
Geelong,"Ablett, Gary",18,8,2,10,1,1,0,7
Geelong,"Atkins, Tom",8,4,3,4,0,0,0,2
Geelong,"Bews, Jed",8,8,3,0,0,0,0,1
Geelong,"Blicavs, Mark",18,11,9,7,0,0,0,4
Geelong,"Clark, Jordan",14,7,4,7,1,1,0,0
Geelong,"Dahlhaus, Luke",17,4,1,13,1,0,0,1
Geelong,"Dangerfield, Patrick",27,16,4,11,0,0,0,4
Geelong,"Duncan, Mitch",26,13,5,13,1,0,0,5
Geelong,"Guthrie, Cameron",24,14,4,10,0,0,0,3
Geelong,"Hawkins, Tom",17,11,6,6,2,2,2,0
Geelong,"Kelly, Tim",19,15,3,4,1,0,0,4
Geelong,"Kolodjashnij, Jake",9,6,5,3,0,0,0,0
Geelong,"Miers, Gryan",15,9,4,6,0,2,0,2
Geelong,"OConnor, Mark",14,7,5,7,0,0,0,5
Geelong,"Parsons, James",14,7,4,7,0,1,0,3
Geelong,"Ratugolea, Esava",9,5,5,4,0,1,5,4
Geelong,"Rohan, Gary",7,3,1,4,1,0,0,2
Geelong,"Selwood, Joel",18,10,3,8,0,2,0,9
Geelong,"Stanley, Rhys",8,5,2,3,0,1,32,1
Geelong,"Stewart, Tom",20,15,8,5,0,0,0,2
Geelong,"Taylor, Harry",12,6,3,6,0,0,0,2
Geelong,"Tuohy, Zach",20,18,3,2,0,1,0,1
Geelong,"Ablett, Gary",21,16,4,5,0,0,0,4
Geelong,"Atkins, Tom",12,5,2,7,1,0,0,2
Geelong,"Bews, Jed",7,5,1,2,0,0,0,4
Geelong,"Blicavs, Mark",14,7,7,7,0,0,3,4
Geelong,"Clark, Jordan",14,10,6,4,2,0,0,6
Geelong,"Dahlhaus, Luke",13,5,5,8,0,1,0,2
Geelong,"Dangerfield, Patrick",25,12,5,13,2,0,0,4
Geelong,"Duncan, Mitch",26,12,5,14,2,0,0,4
Geelong,"Guthrie, Cameron",14,11,3,3,0,1,0,4
Geelong,"Hawkins, Tom",17,12,7,5,5,2,0,0
Geelong,"Henry, Jack",9,8,5,1,0,1,0,1
Geelong,"Kelly, Tim",31,16,2,15,0,2,0,2
Geelong,"Kolodjashnij, Jake",15,11,8,4,0,0,0,1
Geelong,"Miers, Gryan",11,7,6,4,0,2,0,1
Geelong,"OConnor, Mark",15,9,4,6,0,0,0,3
Geelong,"Parsons, James",18,12,5,6,1,0,0,2
Geelong,"Ratugolea, Esava",10,6,1,4,1,1,9,2
Geelong,"Selwood, Joel",24,13,3,11,1,0,0,5
Geelong,"Selwood, Scott",23,14,6,9,1,0,0,3
Geelong,"Smith, Zac",12,3,2,9,0,0,35,1
Geelong,"Stewart, Tom",19,15,4,4,0,0,0,2
Geelong,"Taylor, Harry",15,6,7,9,0,0,0,0
Geelong,"Ablett, Gary",17,9,2,8,1,1,0,8
Geelong,"Atkins, Tom",15,6,0,9,0,0,0,5
Geelong,"Bews, Jed",12,10,4,2,0,1,0,2
Geelong,"Blicavs, Mark",13,10,6,3,0,0,2,3
Geelong,"Clark, Jordan",7,3,1,4,1,0,0,3
Geelong,"Dangerfield, Patrick",16,9,5,7,0,2,0,3
Geelong,"Duncan, Mitch",23,15,9,8,0,0,0,2
Geelong,"Guthrie, Cameron",18,12,3,6,2,0,0,4
Geelong,"Hawkins, Tom",14,9,5,5,3,0,1,0
Geelong,"Henderson, Lachie",15,10,4,5,0,0,0,1
Geelong,"Henry, Jack",11,8,3,3,0,0,0,1
Geelong,"Kelly, Tim",25,15,2,10,1,1,0,4
Geelong,"Kolodjashnij, Jake",9,5,3,4,0,0,0,1
Geelong,"Menegola, Sam",16,13,4,3,0,0,0,5
Geelong,"Miers, Gryan",11,6,0,5,0,0,0,3
Geelong,"Ratugolea, Esava",5,3,3,2,0,1,8,2
Geelong,"Rohan, Gary",4,3,3,1,1,0,0,2
Geelong,"Selwood, Joel",15,11,0,4,0,0,0,5
Geelong,"Selwood, Scott",15,7,2,8,0,1,0,9
Geelong,"Smith, Zac",14,7,1,7,0,0,14,5
Geelong,"Stewart, Tom",24,19,9,5,0,0,0,1
Geelong,"Tuohy, Zach",12,9,5,3,0,0,0,1
Geelong,"Ablett, Gary",23,18,4,5,0,0,0,10
Geelong,"Atkins, Tom",9,6,0,3,0,0,0,5
Geelong,"Bews, Jed",7,5,1,2,0,0,0,2
Geelong,"Blicavs, Mark",13,6,4,7,0,1,21,5
Geelong,"Dahlhaus, Luke",16,8,4,8,1,1,0,5
Geelong,"Dangerfield, Patrick",33,15,7,18,1,0,0,3
Geelong,"Duncan, Mitch",27,15,6,12,0,0,0,5
Geelong,"Guthrie, Cameron",14,4,2,10,0,0,0,6
Geelong,"Hawkins, Tom",16,13,13,3,2,4,1,1
Geelong,"Henderson, Lachie",13,11,9,2,0,0,0,2
Geelong,"Henry, Jack",14,12,5,2,0,0,0,0
Geelong,"Kelly, Tim",24,15,4,9,0,0,0,7
Geelong,"Kolodjashnij, Jake",11,5,1,6,0,0,0,1
Geelong,"Menegola, Sam",17,9,3,8,0,0,0,3
Geelong,"Miers, Gryan",17,11,7,6,3,1,0,3
Geelong,"Narkle, Quinton",21,11,3,10,2,2,0,4
Geelong,"Parfitt, Brandan",20,11,3,9,0,1,0,2
Geelong,"Ratugolea, Esava",12,7,3,5,0,2,8,1
Geelong,"Selwood, Joel",14,6,1,8,0,0,0,1
Geelong,"Stewart, Tom",19,18,7,1,0,0,0,2
Geelong,"Taylor, Harry",8,6,2,2,0,0,0,2
Geelong,"Tuohy, Zach",22,14,4,8,0,0,0,0
Geelong,"Ablett, Gary",25,13,2,12,0,1,0,8
Geelong,"Atkins, Tom",15,11,2,4,0,1,0,11
Geelong,"Bews, Jed",8,6,2,2,1,0,0,2
Geelong,"Blicavs, Mark",10,5,1,5,0,0,25,8
Geelong,"Dahlhaus, Luke",11,7,4,4,1,0,0,10
Geelong,"Dangerfield, Patrick",36,18,3,18,1,1,0,2
Geelong,"Duncan, Mitch",23,11,4,12,1,0,0,1
Geelong,"Guthrie, Cameron",11,4,0,7,1,0,0,3
Geelong,"Hawkins, Tom",13,9,5,4,0,2,0,2
Geelong,"Henderson, Lachie",12,7,3,5,0,0,0,2
Geelong,"Henry, Jack",7,7,4,0,0,0,0,3
Geelong,"Kelly, Tim",26,15,1,11,0,1,0,3
Geelong,"Kolodjashnij, Jake",6,5,2,1,0,0,0,3
Geelong,"Miers, Gryan",12,8,2,4,2,1,0,3
Geelong,"Narkle, Quinton",14,7,1,7,1,0,0,2
Geelong,"OConnor, Mark",11,6,1,5,0,0,0,2
Geelong,"Parfitt, Brandan",12,5,0,7,0,0,0,2
Geelong,"Ratugolea, Esava",5,5,3,0,2,1,7,2
Geelong,"Selwood, Joel",22,11,2,11,0,0,0,4
Geelong,"Stewart, Tom",22,18,6,4,0,0,0,4
Geelong,"Taylor, Harry",10,6,3,4,0,0,0,3
Geelong,"Tuohy, Zach",12,10,2,2,0,2,0,5
Geelong,"Ablett, Gary",28,20,4,8,3,0,0,6
Geelong,"Bews, Jed",15,9,3,6,0,0,0,6
Geelong,"Blicavs, Mark",8,6,4,2,0,0,0,2
Geelong,"Dahlhaus, Luke",19,14,1,5,3,0,0,9
Geelong,"Dangerfield, Patrick",34,22,5,12,4,3,0,6
Geelong,"Duncan, Mitch",23,14,6,9,1,0,0,1
Geelong,"Guthrie, Cameron",13,3,1,10,1,0,0,7
Geelong,"Hawkins, Tom",7,3,2,4,0,0,3,0
Geelong,"Henderson, Lachie",16,11,3,5,0,0,0,0
Geelong,"Henry, Jack",7,5,3,2,0,0,0,0
Geelong,"Kelly, Tim",24,11,2,13,1,1,0,3
Geelong,"Miers, Gryan",16,9,4,7,1,2,0,0
Geelong,"Narkle, Quinton",27,19,3,8,1,2,0,5
Geelong,"OConnor, Mark",11,8,1,3,0,0,0,5
Geelong,"Parfitt, Brandan",22,12,2,10,0,1,0,4
Geelong,"Ratugolea, Esava",9,5,2,4,1,1,8,4
Geelong,"Rohan, Gary",6,5,4,1,0,2,0,3
Geelong,"Selwood, Joel",15,8,5,7,0,0,0,3
Geelong,"Stanley, Rhys",15,9,2,6,1,0,35,4
Geelong,"Stewart, Tom",27,22,7,5,0,0,0,3
Geelong,"Taylor, Harry",8,5,3,3,0,0,0,0
Geelong,"Tuohy, Zach",15,9,5,6,2,2,0,0
Geelong,"Ablett, Gary",17,8,1,9,0,0,0,8
Geelong,"Atkins, Tom",19,6,2,13,0,0,0,4
Geelong,"Bews, Jed",8,8,1,0,0,1,0,3
Geelong,"Blicavs, Mark",11,1,2,10,0,0,14,8
Geelong,"Dahlhaus, Luke",13,7,1,6,0,2,0,5
Geelong,"Dangerfield, Patrick",32,17,7,15,1,0,0,2
Geelong,"Duncan, Mitch",13,10,5,3,0,0,0,0
Geelong,"Hawkins, Tom",10,7,4,3,0,4,3,1
Geelong,"Henry, Jack",15,12,8,3,0,0,0,1
Geelong,"Kelly, Tim",28,14,1,14,1,0,0,7
Geelong,"Kolodjashnij, Jake",7,4,4,3,0,0,0,3
Geelong,"Menegola, Sam",16,9,6,7,1,0,0,6
Geelong,"Miers, Gryan",13,7,3,6,1,1,0,1
Geelong,"Narkle, Quinton",13,7,2,6,0,0,0,1
Geelong,"OConnor, Mark",13,9,5,4,0,0,0,3
Geelong,"Parfitt, Brandan",22,14,2,8,1,0,0,9
Geelong,"Ratugolea, Esava",10,5,2,5,0,0,10,2
Geelong,"Rohan, Gary",3,2,2,1,1,0,0,1
Geelong,"Selwood, Joel",18,7,0,11,0,0,0,8
Geelong,"Stewart, Tom",23,17,10,6,0,0,0,1
Geelong,"Taylor, Harry",10,7,3,3,0,0,0,1
Geelong,"Tuohy, Zach",14,11,3,3,1,0,0,0
Geelong,"Ablett, Gary",14,10,4,4,0,1,0,5
Geelong,"Atkins, Tom",11,6,1,5,1,0,0,8
Geelong,"Bews, Jed",13,10,3,3,1,0,0,1
Geelong,"Blicavs, Mark",14,4,2,10,0,1,0,2
Geelong,"Dahlhaus, Luke",15,7,4,8,1,1,0,1
Geelong,"Dangerfield, Patrick",18,12,6,6,0,0,0,4
Geelong,"Guthrie, Cameron",33,16,7,17,0,0,0,5
Geelong,"Hawkins, Tom",13,11,6,2,4,1,1,0
Geelong,"Henry, Jack",16,11,5,5,0,0,0,2
Geelong,"Kelly, Tim",18,12,6,6,2,0,0,3
Geelong,"Kolodjashnij, Jake",13,10,6,3,0,0,0,2
Geelong,"Menegola, Sam",18,10,4,8,0,1,0,3
Geelong,"Miers, Gryan",16,10,5,6,0,2,0,1
Geelong,"Narkle, Quinton",15,6,1,9,0,0,0,4
Geelong,"OConnor, Mark",14,6,2,8,0,0,0,5
Geelong,"Parfitt, Brandan",16,7,3,9,0,0,0,2
Geelong,"Ratugolea, Esava",12,8,5,4,3,0,1,3
Geelong,"Selwood, Joel",26,13,11,13,1,0,0,4
Geelong,"Stanley, Rhys",12,7,1,5,0,0,12,3
Geelong,"Stewart, Tom",24,18,5,6,0,0,0,0
Geelong,"Taylor, Harry",13,8,3,5,0,0,0,2
Geelong,"Tuohy, Zach",27,21,8,6,0,0,0,1
Geelong,"Ablett, Gary",21,11,4,10,1,1,0,1
Geelong,"Atkins, Tom",11,4,1,7,0,0,0,2
Geelong,"Bews, Jed",8,7,2,1,0,0,0,1
Geelong,"Blicavs, Mark",10,5,4,5,0,1,0,4
Geelong,"Dahlhaus, Luke",14,3,2,11,0,0,0,4
Geelong,"Dangerfield, Patrick",27,12,3,15,1,0,0,5
Geelong,"Guthrie, Cameron",12,7,1,5,0,1,0,2
Geelong,"Henderson, Lachie",5,3,5,2,1,0,0,2
Geelong,"Henry, Jack",12,10,7,2,0,0,0,2
Geelong,"Kelly, Tim",31,24,9,7,3,1,0,4
Geelong,"Kolodjashnij, Jake",11,8,8,3,0,0,0,0
Geelong,"Menegola, Sam",18,7,4,11,0,1,0,2
Geelong,"Miers, Gryan",22,12,5,10,2,1,0,1
Geelong,"Narkle, Quinton",13,9,4,4,1,0,0,2
Geelong,"OConnor, Mark",18,13,6,5,0,0,0,3
Geelong,"Parfitt, Brandan",16,9,2,7,0,0,0,4
Geelong,"Ratugolea, Esava",9,4,4,5,0,1,8,2
Geelong,"Selwood, Joel",30,19,2,11,0,1,0,7
Geelong,"Stanley, Rhys",18,9,4,9,0,0,24,3
Geelong,"Stewart, Tom",19,15,5,4,0,0,0,0
Geelong,"Taylor, Harry",14,9,7,5,0,0,0,0
Geelong,"Tuohy, Zach",26,18,4,8,0,1,0,0
Greater Western Sydney,"Cameron, Jeremy",13,10,5,3,4,2,0,0
Greater Western Sydney,"Coniglio, Stephen",31,24,9,7,3,1,0,7
Greater Western Sydney,"Daniels, Brent",17,9,3,8,0,2,0,7
Greater Western Sydney,"Davis, Phil",12,7,4,5,0,0,0,3
Greater Western Sydney,"Deledio, Brett",14,6,6,8,0,1,0,7
Greater Western Sydney,"Finlayson, Jeremy",9,8,5,1,0,1,0,0
Greater Western Sydney,"Greene, Toby",14,12,5,2,1,1,0,0
Greater Western Sydney,"Himmelberg, Harry",14,7,3,7,1,0,0,0
Greater Western Sydney,"Hopper, Jacob",28,17,6,11,0,2,0,3
Greater Western Sydney,"Keeffe, Lachlan",8,5,2,3,3,2,0,2
Greater Western Sydney,"Kennedy, Adam",16,12,6,4,0,0,0,1
Greater Western Sydney,"Lloyd, Daniel",13,6,4,7,2,0,0,2
Greater Western Sydney,"Perryman, Harry",6,5,3,1,0,2,0,0
Greater Western Sydney,"Reid, Sam",15,5,4,10,0,0,0,3
Greater Western Sydney,"Shaw, Heath",19,16,7,3,0,1,0,1
Greater Western Sydney,"Simpson, Dawson",8,4,2,4,0,0,32,3
Greater Western Sydney,"Taranto, Tim",30,21,3,9,2,0,0,10
Greater Western Sydney,"Taylor, Sam",17,5,3,12,0,0,0,3
Greater Western Sydney,"Tomlinson, Adam",23,16,8,7,0,0,4,1
Greater Western Sydney,"Whitfield, Lachie",30,19,7,11,0,0,0,2
Greater Western Sydney,"Williams, Zac",18,11,4,7,0,0,0,2
Greater Western Sydney,"de Boer, Matt",16,5,0,11,0,1,0,6
Greater Western Sydney,"Buntine, Matt",16,10,8,6,0,0,0,2
Greater Western Sydney,"Cameron, Jeremy",12,9,7,3,3,2,0,1
Greater Western Sydney,"Coniglio, Stephen",20,9,0,11,0,0,0,1
Greater Western Sydney,"Daniels, Brent",13,7,3,6,1,0,0,0
Greater Western Sydney,"Davis, Phil",7,5,2,2,0,0,0,0
Greater Western Sydney,"Deledio, Brett",14,10,4,4,0,0,0,2
Greater Western Sydney,"Finlayson, Jeremy",19,16,7,3,0,0,0,1
Greater Western Sydney,"Haynes, Nick",16,14,7,2,1,1,0,0
Greater Western Sydney,"Himmelberg, Harry",15,8,4,7,0,2,0,0
Greater Western Sydney,"Hopper, Jacob",21,12,5,9,0,0,0,2
Greater Western Sydney,"Keeffe, Lachlan",10,5,4,5,0,1,0,3
Greater Western Sydney,"Kennedy, Adam",23,17,10,6,0,0,0,0
Greater Western Sydney,"Lloyd, Daniel",10,2,1,8,0,2,0,0
Greater Western Sydney,"Reid, Sam",14,10,6,4,1,0,0,3
Greater Western Sydney,"Shaw, Heath",15,13,5,2,0,0,0,1
Greater Western Sydney,"Simpson, Dawson",8,2,1,6,0,0,33,3
Greater Western Sydney,"Taranto, Tim",19,12,3,7,0,1,0,5
Greater Western Sydney,"Taylor, Sam",5,2,1,3,0,0,0,1
Greater Western Sydney,"Tomlinson, Adam",19,13,6,6,0,0,2,3
Greater Western Sydney,"Whitfield, Lachie",33,26,13,7,0,0,0,0
Greater Western Sydney,"Williams, Zac",25,14,5,11,1,0,0,1
Greater Western Sydney,"de Boer, Matt",20,9,7,11,0,0,0,1
Greater Western Sydney,"Buntine, Matt",9,2,0,7,0,0,0,4
Greater Western Sydney,"Cameron, Jeremy",30,18,9,12,7,5,0,0
Greater Western Sydney,"Coniglio, Stephen",32,17,2,15,0,1,0,5
Greater Western Sydney,"Daniels, Brent",16,7,0,9,1,0,0,4
Greater Western Sydney,"Davis, Phil",15,11,7,4,0,0,0,3
Greater Western Sydney,"Finlayson, Jeremy",15,12,5,3,5,1,0,2
Greater Western Sydney,"Haynes, Nick",20,14,6,6,0,0,0,1
Greater Western Sydney,"Himmelberg, Harry",19,9,4,10,1,0,0,1
Greater Western Sydney,"Hopper, Jacob",29,11,2,18,2,0,0,2
Greater Western Sydney,"Kelly, Josh",22,11,3,11,1,1,0,7
Greater Western Sydney,"Kennedy, Adam",19,13,7,6,0,0,0,1
Greater Western Sydney,"Lloyd, Daniel",13,8,3,5,0,1,0,4
Greater Western Sydney,"Mumford, Shane",14,0,2,14,0,0,31,6
Greater Western Sydney,"Reid, Sam",9,6,4,3,0,0,0,2
Greater Western Sydney,"Shaw, Heath",17,17,6,0,0,0,0,3
Greater Western Sydney,"Sheridan, Tom",1,0,1,1,0,0,0,0
Greater Western Sydney,"Taranto, Tim",30,17,1,13,2,0,0,6
Greater Western Sydney,"Taylor, Sam",11,3,3,8,0,0,0,2
Greater Western Sydney,"Tomlinson, Adam",16,13,5,3,0,0,5,1
Greater Western Sydney,"Whitfield, Lachie",42,23,12,19,0,0,0,4
Greater Western Sydney,"Williams, Zac",25,20,7,5,0,0,0,0
Greater Western Sydney,"de Boer, Matt",21,4,3,17,0,0,0,6
Greater Western Sydney,"Buntine, Matt",11,8,4,3,1,1,0,1
Greater Western Sydney,"Cameron, Jeremy",15,11,8,4,3,2,0,0
Greater Western Sydney,"Coniglio, Stephen",34,17,4,17,0,0,0,4
Greater Western Sydney,"Daniels, Brent",12,7,3,5,0,1,0,3
Greater Western Sydney,"Davis, Phil",15,7,8,8,0,0,0,6
Greater Western Sydney,"Finlayson, Jeremy",12,11,5,1,3,1,0,0
Greater Western Sydney,"Haynes, Nick",17,12,6,5,0,0,0,2
Greater Western Sydney,"Himmelberg, Harry",11,5,4,6,2,0,0,3
Greater Western Sydney,"Hopper, Jacob",31,15,3,16,0,0,0,6
Greater Western Sydney,"Kelly, Josh",32,14,6,18,0,1,0,4
Greater Western Sydney,"Kennedy, Adam",16,11,8,5,0,0,0,3
Greater Western Sydney,"Lloyd, Daniel",14,8,7,6,2,0,0,2
Greater Western Sydney,"Mumford, Shane",13,6,5,7,0,0,40,1
Greater Western Sydney,"Reid, Sam",15,8,3,7,0,0,0,2
Greater Western Sydney,"Shaw, Heath",15,11,6,4,0,0,0,4
Greater Western Sydney,"Taranto, Tim",28,15,4,13,0,0,0,9
Greater Western Sydney,"Taylor, Sam",10,6,6,4,0,0,0,3
Greater Western Sydney,"Tomlinson, Adam",21,12,8,9,0,0,6,5
Greater Western Sydney,"Ward, Callan",1,1,0,0,0,0,0,0
Greater Western Sydney,"Whitfield, Lachie",31,20,10,11,0,0,0,3
Greater Western Sydney,"Williams, Zac",16,12,3,4,0,0,0,0
Greater Western Sydney,"de Boer, Matt",15,6,2,9,0,0,0,5
Greater Western Sydney,"Buntine, Matt",10,6,4,4,1,0,0,3
Greater Western Sydney,"Cameron, Jeremy",11,10,6,1,4,1,0,0
Greater Western Sydney,"Coniglio, Stephen",37,20,4,17,1,2,0,3
Greater Western Sydney,"Daniels, Brent",18,11,6,7,1,2,0,1
Greater Western Sydney,"Davis, Phil",15,7,11,8,0,0,0,1
Greater Western Sydney,"Finlayson, Jeremy",10,8,5,2,3,2,0,3
Greater Western Sydney,"Hately, Jackson",22,9,6,13,0,0,0,3
Greater Western Sydney,"Haynes, Nick",18,8,3,10,0,0,0,3
Greater Western Sydney,"Himmelberg, Harry",9,5,1,4,1,1,0,1
Greater Western Sydney,"Hopper, Jacob",19,7,1,12,0,0,0,2
Greater Western Sydney,"Kelly, Josh",29,15,4,14,0,0,0,5
Greater Western Sydney,"Kennedy, Adam",20,13,5,7,0,0,0,0
Greater Western Sydney,"Lloyd, Daniel",8,6,2,2,0,1,0,3
Greater Western Sydney,"Mumford, Shane",7,2,2,5,0,0,42,5
Greater Western Sydney,"Reid, Sam",24,13,4,11,0,0,0,0
Greater Western Sydney,"Shaw, Heath",12,9,7,3,0,0,0,1
Greater Western Sydney,"Taranto, Tim",22,11,3,11,0,2,0,6
Greater Western Sydney,"Taylor, Sam",10,8,4,2,0,0,0,1
Greater Western Sydney,"Tomlinson, Adam",16,10,4,6,0,0,6,4
Greater Western Sydney,"Whitfield, Lachie",25,14,10,11,0,1,0,3
Greater Western Sydney,"Williams, Zac",27,21,8,6,0,1,0,1
Greater Western Sydney,"de Boer, Matt",16,5,1,11,0,0,0,2
Greater Western Sydney,"Buntine, Matt",16,9,5,7,0,0,0,3
Greater Western Sydney,"Cameron, Jeremy",21,13,8,8,3,3,0,5
Greater Western Sydney,"Coniglio, Stephen",24,18,5,6,4,0,0,3
Greater Western Sydney,"Corr, Aidan",11,9,5,2,0,0,0,0
Greater Western Sydney,"Daniels, Brent",12,5,2,7,0,0,0,0
Greater Western Sydney,"Finlayson, Jeremy",14,9,3,5,0,0,0,3
Greater Western Sydney,"Greene, Toby",18,13,7,5,3,2,0,3
Greater Western Sydney,"Haynes, Nick",21,15,12,6,0,0,0,3
Greater Western Sydney,"Himmelberg, Harry",10,6,5,4,0,2,0,4
Greater Western Sydney,"Hopper, Jacob",33,23,7,10,0,1,0,3
Greater Western Sydney,"Kelly, Josh",31,19,2,12,1,2,0,6
Greater Western Sydney,"Kennedy, Adam",17,13,7,4,0,0,0,1
Greater Western Sydney,"Lloyd, Daniel",12,10,2,2,3,0,0,4
Greater Western Sydney,"Mumford, Shane",14,4,2,10,0,0,48,6
Greater Western Sydney,"Reid, Sam",10,3,1,7,0,0,0,3
Greater Western Sydney,"Shaw, Heath",25,19,5,6,0,0,0,1
Greater Western Sydney,"Taranto, Tim",30,21,4,9,1,0,0,10
Greater Western Sydney,"Taylor, Sam",6,2,2,4,0,0,0,2
Greater Western Sydney,"Tomlinson, Adam",20,13,9,7,0,0,7,4
Greater Western Sydney,"Whitfield, Lachie",8,4,3,4,2,0,0,1
Greater Western Sydney,"Williams, Zac",30,24,3,6,0,0,0,0
Greater Western Sydney,"de Boer, Matt",22,9,4,13,1,1,0,5
Greater Western Sydney,"Buntine, Matt",13,9,3,4,0,1,0,0
Greater Western Sydney,"Cameron, Jeremy",15,14,11,1,6,1,0,0
Greater Western Sydney,"Coniglio, Stephen",22,16,2,6,1,1,0,3
Greater Western Sydney,"Corr, Aidan",6,3,2,3,0,0,0,3
Greater Western Sydney,"Cumming, Isaac",10,6,2,4,0,0,0,0
Greater Western Sydney,"Daniels, Brent",16,8,7,8,0,0,0,0
Greater Western Sydney,"Finlayson, Jeremy",8,7,4,1,2,0,0,1
Greater Western Sydney,"Greene, Toby",19,12,5,7,2,0,0,1
Greater Western Sydney,"Hately, Jackson",21,11,6,10,0,0,0,3
Greater Western Sydney,"Haynes, Nick",26,21,9,5,0,0,0,2
Greater Western Sydney,"Himmelberg, Harry",13,7,2,6,2,0,0,1
Greater Western Sydney,"Hopper, Jacob",23,15,4,8,0,1,0,5
Greater Western Sydney,"Kennedy, Adam",10,5,3,5,0,0,0,0
Greater Western Sydney,"Lloyd, Daniel",13,8,5,5,1,0,0,4
Greater Western Sydney,"Mumford, Shane",10,4,1,6,0,1,49,3
Greater Western Sydney,"Reid, Sam",24,17,10,7,1,0,0,2
Greater Western Sydney,"Shaw, Heath",18,16,5,2,0,0,0,2
Greater Western Sydney,"Taranto, Tim",28,19,5,9,1,1,0,3
Greater Western Sydney,"Taylor, Sam",12,4,5,8,0,0,0,1
Greater Western Sydney,"Tomlinson, Adam",15,8,7,7,1,0,1,5
Greater Western Sydney,"Williams, Zac",30,25,8,5,0,0,0,1
Greater Western Sydney,"de Boer, Matt",17,3,2,14,1,0,0,6
Greater Western Sydney,"Buntine, Matt",11,10,4,1,0,0,0,0
Greater Western Sydney,"Cameron, Jeremy",11,9,4,2,0,4,0,0
Greater Western Sydney,"Coniglio, Stephen",26,17,2,9,0,0,0,0
Greater Western Sydney,"Daniels, Brent",8,5,1,3,0,0,0,2
Greater Western Sydney,"Davis, Phil",11,8,8,3,0,0,0,4
Greater Western Sydney,"Finlayson, Jeremy",17,14,9,3,3,2,0,1
Greater Western Sydney,"Greene, Toby",13,10,5,3,1,0,0,3
Greater Western Sydney,"Haynes, Nick",11,8,6,3,0,0,0,1
Greater Western Sydney,"Himmelberg, Harry",11,9,5,2,0,0,0,3
Greater Western Sydney,"Hopper, Jacob",21,9,1,12,0,1,0,0
Greater Western Sydney,"Kelly, Josh",26,16,4,10,0,0,0,9
Greater Western Sydney,"Kennedy, Adam",15,9,5,6,0,0,0,4
Greater Western Sydney,"Langdon, Zac",10,6,3,4,0,0,0,4
Greater Western Sydney,"Lloyd, Daniel",7,5,3,2,1,0,0,3
Greater Western Sydney,"Reid, Sam",15,8,4,7,0,0,0,4
Greater Western Sydney,"Shaw, Heath",30,24,11,6,0,0,0,2
Greater Western Sydney,"Simpson, Dawson",6,1,1,5,0,0,21,0
Greater Western Sydney,"Taranto, Tim",24,11,8,13,0,0,0,4
Greater Western Sydney,"Taylor, Sam",8,4,3,4,0,0,0,3
Greater Western Sydney,"Tomlinson, Adam",16,9,8,7,0,0,4,3
Greater Western Sydney,"Williams, Zac",22,19,7,3,0,0,0,1
Greater Western Sydney,"de Boer, Matt",14,5,1,9,0,0,0,4
Greater Western Sydney,"Cameron, Jeremy",27,16,8,11,0,4,0,0
Greater Western Sydney,"Daniels, Brent",12,6,1,6,2,1,0,1
Greater Western Sydney,"Davis, Phil",21,17,13,4,0,0,0,1
Greater Western Sydney,"Deledio, Brett",19,10,3,9,3,1,0,5
Greater Western Sydney,"Finlayson, Jeremy",12,9,3,3,5,1,0,4
Greater Western Sydney,"Greene, Toby",34,21,8,13,0,1,0,1
Greater Western Sydney,"Haynes, Nick",19,15,9,4,0,0,0,1
Greater Western Sydney,"Himmelberg, Harry",11,8,6,3,3,2,0,1
Greater Western Sydney,"Hopper, Jacob",21,7,1,14,0,1,0,6
Greater Western Sydney,"Kelly, Josh",35,19,7,16,0,1,0,3
Greater Western Sydney,"Kennedy, Adam",17,12,8,5,1,0,0,1
Greater Western Sydney,"Lloyd, Daniel",14,8,4,6,0,0,0,2
Greater Western Sydney,"Mumford, Shane",7,1,2,6,0,0,31,5
Greater Western Sydney,"Perryman, Harry",24,12,10,12,1,0,0,2
Greater Western Sydney,"Reid, Sam",21,13,5,8,0,0,0,3
Greater Western Sydney,"Shaw, Heath",31,20,11,11,0,0,0,4
Greater Western Sydney,"Taranto, Tim",38,26,12,12,1,1,0,4
Greater Western Sydney,"Taylor, Sam",11,5,5,6,0,0,0,1
Greater Western Sydney,"Tomlinson, Adam",24,17,14,7,1,0,1,1
Greater Western Sydney,"Whitfield, Lachie",40,21,18,19,3,1,0,4
Greater Western Sydney,"Williams, Zac",12,9,2,3,0,0,0,1
Greater Western Sydney,"de Boer, Matt",27,15,4,12,0,2,0,6
Greater Western Sydney,"Cameron, Jeremy",15,12,8,3,3,2,0,1
Greater Western Sydney,"Coniglio, Stephen",16,10,3,6,1,0,0,3
Greater Western Sydney,"Cumming, Isaac",6,2,3,4,0,0,0,5
Greater Western Sydney,"Daniels, Brent",11,6,1,5,0,0,0,5
Greater Western Sydney,"Davis, Phil",12,4,4,8,0,0,0,3
Greater Western Sydney,"Deledio, Brett",18,12,3,6,0,0,0,1
Greater Western Sydney,"Finlayson, Jeremy",16,12,9,4,1,1,0,1
Greater Western Sydney,"Greene, Toby",19,13,6,6,0,0,0,3
Greater Western Sydney,"Haynes, Nick",20,15,8,5,0,0,0,0
Greater Western Sydney,"Himmelberg, Harry",18,12,7,6,5,2,0,1
Greater Western Sydney,"Hopper, Jacob",23,9,2,14,0,0,0,3
Greater Western Sydney,"Kelly, Josh",31,16,3,15,1,0,0,10
Greater Western Sydney,"Kennedy, Adam",13,9,2,4,0,0,0,1
Greater Western Sydney,"Mumford, Shane",7,2,2,5,0,0,25,3
Greater Western Sydney,"Perryman, Harry",18,12,6,6,0,1,0,4
Greater Western Sydney,"Reid, Sam",15,10,5,5,0,0,0,2
Greater Western Sydney,"Shaw, Heath",27,24,7,3,0,0,0,1
Greater Western Sydney,"Taranto, Tim",32,14,6,18,0,2,0,8
Greater Western Sydney,"Taylor, Sam",13,6,5,7,1,0,0,2
Greater Western Sydney,"Tomlinson, Adam",18,9,5,9,0,0,3,3
Greater Western Sydney,"Whitfield, Lachie",29,17,8,12,2,0,0,2
Greater Western Sydney,"de Boer, Matt",12,6,4,6,0,0,0,6
Greater Western Sydney,"Cameron, Jeremy",20,12,8,8,5,2,0,1
Greater Western Sydney,"Coniglio, Stephen",36,29,13,7,3,0,0,8
Greater Western Sydney,"Cumming, Isaac",15,11,5,4,0,0,0,5
Greater Western Sydney,"Daniels, Brent",20,10,4,10,0,2,0,3
Greater Western Sydney,"Davis, Phil",18,15,10,3,0,0,0,1
Greater Western Sydney,"Deledio, Brett",19,7,5,12,1,1,0,2
Greater Western Sydney,"Finlayson, Jeremy",23,18,12,5,2,2,0,3
Greater Western Sydney,"Greene, Toby",12,6,3,6,1,0,0,2
Greater Western Sydney,"Haynes, Nick",13,10,7,3,0,0,0,2
Greater Western Sydney,"Himmelberg, Harry",9,7,5,2,3,0,0,2
Greater Western Sydney,"Hopper, Jacob",31,19,7,12,1,0,0,5
Greater Western Sydney,"Keeffe, Lachlan",13,8,7,5,0,0,0,2
Greater Western Sydney,"Kelly, Josh",36,21,7,15,1,0,0,5
Greater Western Sydney,"Kennedy, Adam",18,11,8,7,0,0,0,0
Greater Western Sydney,"Mumford, Shane",6,2,0,4,0,0,34,3
Greater Western Sydney,"Perryman, Harry",16,9,7,7,0,0,0,6
Greater Western Sydney,"Reid, Sam",17,11,9,6,0,0,0,3
Greater Western Sydney,"Shaw, Heath",21,17,9,4,0,0,0,0
Greater Western Sydney,"Taranto, Tim",24,14,1,10,0,0,0,4
Greater Western Sydney,"Tomlinson, Adam",14,7,4,7,0,0,2,3
Greater Western Sydney,"Whitfield, Lachie",17,8,6,9,0,1,0,3
Greater Western Sydney,"de Boer, Matt",18,6,2,12,2,1,0,9
Greater Western Sydney,"Cameron, Jeremy",13,10,6,3,1,1,0,2
Greater Western Sydney,"Coniglio, Stephen",27,17,5,10,0,1,0,3
Greater Western Sydney,"Cumming, Isaac",9,3,2,6,0,0,0,2
Greater Western Sydney,"Daniels, Brent",9,3,1,6,0,0,0,2
Greater Western Sydney,"Davis, Phil",15,11,8,4,0,0,0,1
Greater Western Sydney,"Deledio, Brett",17,8,6,9,0,0,0,1
Greater Western Sydney,"Finlayson, Jeremy",10,4,3,6,0,0,0,0
Greater Western Sydney,"Haynes, Nick",19,14,10,5,0,0,0,2
Greater Western Sydney,"Himmelberg, Harry",11,6,5,5,2,0,0,1
Greater Western Sydney,"Hopper, Jacob",22,13,4,9,1,2,0,3
Greater Western Sydney,"Kelly, Josh",34,18,5,16,2,1,0,4
Greater Western Sydney,"Kennedy, Adam",15,10,5,5,0,0,0,1
Greater Western Sydney,"Lloyd, Daniel",14,10,5,4,1,0,0,5
Greater Western Sydney,"Mumford, Shane",9,1,0,8,0,0,35,4
Greater Western Sydney,"Perryman, Harry",21,16,7,5,1,2,0,1
Greater Western Sydney,"Reid, Sam",18,11,6,7,0,0,0,2
Greater Western Sydney,"Shaw, Heath",27,22,11,5,0,0,0,0
Greater Western Sydney,"Taranto, Tim",36,18,5,18,1,0,0,7
Greater Western Sydney,"Taylor, Sam",9,3,5,6,0,0,0,3
Greater Western Sydney,"Tomlinson, Adam",14,8,7,6,0,0,5,2
Greater Western Sydney,"Williams, Zac",20,13,5,7,0,0,0,3
Greater Western Sydney,"de Boer, Matt",16,6,2,10,0,0,0,3
Greater Western Sydney,"Buntine, Matt",14,11,6,3,0,0,0,4
Greater Western Sydney,"Cameron, Jeremy",9,4,4,5,1,0,0,1
Greater Western Sydney,"Coniglio, Stephen",27,17,2,10,2,0,0,6
Greater Western Sydney,"Daniels, Brent",16,8,1,8,0,1,0,4
Greater Western Sydney,"Davis, Phil",14,9,7,5,0,0,0,0
Greater Western Sydney,"Deledio, Brett",19,13,9,6,1,0,0,1
Greater Western Sydney,"Finlayson, Jeremy",10,5,3,5,1,1,0,2
Greater Western Sydney,"Greene, Toby",20,13,5,7,3,0,0,4
Greater Western Sydney,"Himmelberg, Harry",13,8,6,5,1,0,0,2
Greater Western Sydney,"Hopper, Jacob",29,15,2,14,1,1,0,8
Greater Western Sydney,"Kelly, Josh",35,22,7,13,1,0,0,7
Greater Western Sydney,"Kennedy, Adam",10,5,1,5,0,0,0,3
Greater Western Sydney,"Mumford, Shane",10,2,1,8,0,1,53,6
Greater Western Sydney,"Perryman, Harry",20,9,6,11,0,0,0,2
Greater Western Sydney,"Reid, Sam",12,6,3,6,0,0,0,2
Greater Western Sydney,"Shaw, Heath",18,13,1,5,0,0,0,3
Greater Western Sydney,"Stein, Jake",9,4,2,5,0,0,0,8
Greater Western Sydney,"Taranto, Tim",30,21,9,9,1,0,0,10
Greater Western Sydney,"Taylor, Sam",8,5,4,3,0,0,0,2
Greater Western Sydney,"Tomlinson, Adam",12,8,1,4,1,0,2,5
Greater Western Sydney,"Williams, Zac",28,21,6,7,1,0,0,3
Greater Western Sydney,"de Boer, Matt",11,3,1,8,0,1,0,6
Greater Western Sydney,"Cameron, Jeremy",13,11,6,2,3,1,0,3
Greater Western Sydney,"Coniglio, Stephen",33,19,7,14,0,0,0,2
Greater Western Sydney,"Daniels, Brent",14,11,5,3,1,0,0,3
Greater Western Sydney,"Davis, Phil",15,9,6,6,1,0,0,2
Greater Western Sydney,"Deledio, Brett",22,13,5,9,0,0,0,2
Greater Western Sydney,"Finlayson, Jeremy",15,11,11,4,2,1,1,0
Greater Western Sydney,"Greene, Toby",19,8,4,11,1,1,0,4
Greater Western Sydney,"Hately, Jackson",13,8,6,5,0,0,0,5
Greater Western Sydney,"Haynes, Nick",13,10,2,3,0,1,0,1
Greater Western Sydney,"Himmelberg, Harry",14,11,8,3,1,0,1,1
Greater Western Sydney,"Hopper, Jacob",28,10,1,18,0,0,0,4
Greater Western Sydney,"Kelly, Josh",28,18,6,10,1,2,0,5
Greater Western Sydney,"Kennedy, Adam",18,9,2,9,0,0,0,0
Greater Western Sydney,"Langdon, Zac",9,5,2,4,0,1,0,5
Greater Western Sydney,"Mumford, Shane",9,2,2,7,0,0,35,4
Greater Western Sydney,"Perryman, Harry",13,9,4,4,0,1,0,4
Greater Western Sydney,"Reid, Sam",11,7,5,4,0,0,0,1
Greater Western Sydney,"Shaw, Heath",14,9,4,5,0,0,0,1
Greater Western Sydney,"Taranto, Tim",19,14,6,5,0,0,0,4
Greater Western Sydney,"Taylor, Sam",6,2,0,4,0,0,0,0
Greater Western Sydney,"Tomlinson, Adam",17,13,5,4,0,0,4,5
Greater Western Sydney,"Williams, Zac",29,21,7,8,0,0,0,1
Greater Western Sydney,"Cameron, Jeremy",14,13,3,1,2,4,0,2
Greater Western Sydney,"Coniglio, Stephen",34,19,5,15,0,0,0,11
Greater Western Sydney,"Daniels, Brent",12,7,4,5,0,0,0,4
Greater Western Sydney,"Davis, Phil",19,13,10,6,0,0,0,1
Greater Western Sydney,"Deledio, Brett",26,15,8,11,0,1,0,3
Greater Western Sydney,"Finlayson, Jeremy",5,2,0,3,1,0,3,0
Greater Western Sydney,"Greene, Toby",16,10,6,6,3,0,0,1
Greater Western Sydney,"Hately, Jackson",15,6,3,9,0,0,0,2
Greater Western Sydney,"Haynes, Nick",14,9,8,5,0,0,0,0
Greater Western Sydney,"Himmelberg, Harry",14,5,4,9,4,0,0,7
Greater Western Sydney,"Hopper, Jacob",28,16,4,12,0,0,0,7
Greater Western Sydney,"Kelly, Josh",26,12,1,14,0,1,0,5
Greater Western Sydney,"Kennedy, Adam",22,10,6,12,0,0,0,2
Greater Western Sydney,"Langdon, Zac",7,5,1,2,0,0,0,5
Greater Western Sydney,"Perryman, Harry",20,11,3,9,0,0,0,4
Greater Western Sydney,"Reid, Sam",13,4,4,9,0,0,0,3
Greater Western Sydney,"Shaw, Heath",13,11,3,2,0,0,0,3
Greater Western Sydney,"Simpson, Dawson",11,2,0,9,0,0,44,4
Greater Western Sydney,"Taranto, Tim",22,17,2,5,0,0,0,7
Greater Western Sydney,"Taylor, Sam",13,9,3,4,0,0,0,3
Greater Western Sydney,"Tomlinson, Adam",16,9,7,7,0,0,1,1
Greater Western Sydney,"Williams, Zac",28,21,7,7,1,0,0,4
Greater Western Sydney,"Buntine, Matt",6,3,2,3,0,0,0,2
Greater Western Sydney,"Cameron, Jeremy",19,13,6,6,3,4,0,2
Greater Western Sydney,"Coniglio, Stephen",0,0,0,0,0,0,0,0
Greater Western Sydney,"Daniels, Brent",22,13,8,9,1,2,0,2
Greater Western Sydney,"Davis, Phil",8,4,3,4,0,0,0,3
Greater Western Sydney,"Deledio, Brett",16,8,6,8,0,0,0,1
Greater Western Sydney,"Greene, Toby",34,22,6,12,2,1,0,6
Greater Western Sydney,"Haynes, Nick",20,15,11,5,0,0,0,3
Greater Western Sydney,"Hill, Bobby",15,10,1,5,3,1,0,1
Greater Western Sydney,"Himmelberg, Harry",12,5,4,7,0,1,0,1
Greater Western Sydney,"Hopper, Jacob",33,17,4,16,0,0,0,3
Greater Western Sydney,"Kennedy, Adam",15,9,2,6,0,0,0,1
Greater Western Sydney,"Lloyd, Daniel",15,9,1,6,0,0,0,0
Greater Western Sydney,"Perryman, Harry",27,15,6,12,0,0,0,2
Greater Western Sydney,"Reid, Sam",7,3,3,4,0,0,0,2
Greater Western Sydney,"Shaw, Heath",15,13,4,2,0,0,0,2
Greater Western Sydney,"Simpson, Dawson",12,4,1,8,0,0,41,1
Greater Western Sydney,"Taranto, Tim",36,19,4,17,0,0,0,4
Greater Western Sydney,"Taylor, Sam",9,3,4,6,0,0,0,2
Greater Western Sydney,"Tomlinson, Adam",22,14,7,8,0,0,4,1
Greater Western Sydney,"Whitfield, Lachie",33,20,8,13,0,1,0,3
Greater Western Sydney,"Williams, Zac",20,11,4,9,0,0,0,2
Greater Western Sydney,"Cameron, Jeremy",20,14,9,6,6,0,0,2
Greater Western Sydney,"Daniels, Brent",16,6,3,10,1,0,0,5
Greater Western Sydney,"Deledio, Brett",17,4,3,13,0,0,0,2
Greater Western Sydney,"Finlayson, Jeremy",11,10,7,1,3,1,0,2
Greater Western Sydney,"Greene, Toby",27,15,6,12,2,0,0,4
Greater Western Sydney,"Haynes, Nick",13,9,7,4,0,0,0,1
Greater Western Sydney,"Hill, Bobby",11,5,3,6,1,1,0,3
Greater Western Sydney,"Himmelberg, Harry",12,10,9,2,4,0,0,3
Greater Western Sydney,"Hopper, Jacob",26,11,1,15,0,0,0,3
Greater Western Sydney,"Keeffe, Lachlan",10,8,6,2,0,0,0,2
Greater Western Sydney,"Lloyd, Daniel",16,8,0,8,0,1,0,3
Greater Western Sydney,"Mumford, Shane",9,4,0,5,0,0,11,1
Greater Western Sydney,"Perryman, Harry",17,8,4,9,0,1,0,1
Greater Western Sydney,"Reid, Sam",17,12,6,5,1,1,0,4
Greater Western Sydney,"Shaw, Heath",26,23,10,3,0,0,0,2
Greater Western Sydney,"Simpson, Dawson",5,3,0,2,1,0,27,5
Greater Western Sydney,"Stein, Jake",6,5,3,1,0,0,0,2
Greater Western Sydney,"Taranto, Tim",32,16,5,16,0,1,0,14
Greater Western Sydney,"Taylor, Sam",17,12,7,5,0,0,0,1
Greater Western Sydney,"Tomlinson, Adam",19,14,7,5,0,1,0,4
Greater Western Sydney,"Whitfield, Lachie",29,18,4,11,0,0,0,5
Greater Western Sydney,"Williams, Zac",26,20,4,6,0,0,0,10
Greater Western Sydney,"Cameron, Jeremy",15,10,1,5,3,2,0,1
Greater Western Sydney,"Daniels, Brent",16,10,2,6,0,0,0,3
Greater Western Sydney,"Davis, Phil",17,11,13,6,0,0,0,1
Greater Western Sydney,"Finlayson, Jeremy",14,9,5,5,3,3,0,1
Greater Western Sydney,"Greene, Toby",30,19,8,11,0,0,0,6
Greater Western Sydney,"Hately, Jackson",15,9,7,6,1,1,0,2
Greater Western Sydney,"Haynes, Nick",21,16,10,5,0,0,0,1
Greater Western Sydney,"Hill, Bobby",9,3,0,6,0,0,0,4
Greater Western Sydney,"Himmelberg, Harry",15,7,2,8,1,0,0,2
Greater Western Sydney,"Hopper, Jacob",31,13,2,18,0,0,0,7
Greater Western Sydney,"Keeffe, Lachlan",9,7,4,2,0,0,0,3
Greater Western Sydney,"Lloyd, Daniel",15,8,3,7,0,0,0,3
Greater Western Sydney,"Mumford, Shane",5,2,1,3,0,0,6,2
Greater Western Sydney,"Perryman, Harry",15,13,6,2,0,0,0,2
Greater Western Sydney,"Reid, Sam",24,12,9,12,0,0,0,1
Greater Western Sydney,"Shaw, Heath",19,14,6,5,0,0,0,1
Greater Western Sydney,"Simpson, Dawson",4,1,1,3,0,0,21,2
Greater Western Sydney,"Taranto, Tim",31,18,2,13,0,0,0,5
Greater Western Sydney,"Taylor, Sam",8,5,2,3,0,0,0,0
Greater Western Sydney,"Tomlinson, Adam",13,7,6,6,0,0,0,1
Greater Western Sydney,"Whitfield, Lachie",27,19,6,8,0,1,0,2
Greater Western Sydney,"Williams, Zac",23,14,6,9,0,1,0,3
Greater Western Sydney,"Bonar, Aiden",12,7,2,5,0,0,0,3
Greater Western Sydney,"Daniels, Brent",12,8,2,4,1,1,0,2
Greater Western Sydney,"Davis, Phil",8,5,4,3,0,1,0,2
Greater Western Sydney,"Deledio, Brett",23,12,7,11,0,2,0,4
Greater Western Sydney,"Finlayson, Jeremy",13,11,6,2,2,2,0,2
Greater Western Sydney,"Greene, Toby",34,22,8,12,1,1,0,6
Greater Western Sydney,"Hately, Jackson",15,8,1,7,0,0,0,5
Greater Western Sydney,"Haynes, Nick",18,14,12,4,0,1,0,4
Greater Western Sydney,"Hill, Bobby",11,7,4,4,1,0,0,1
Greater Western Sydney,"Himmelberg, Harry",10,3,2,7,2,0,0,4
Greater Western Sydney,"Hopper, Jacob",26,16,7,10,3,1,0,4
Greater Western Sydney,"Idun, Connor",8,5,3,3,0,0,0,2
Greater Western Sydney,"Keeffe, Lachlan",4,4,3,0,1,0,4,1
Greater Western Sydney,"Mumford, Shane",13,5,1,8,0,0,54,5
Greater Western Sydney,"Perryman, Harry",17,14,4,3,0,0,0,2
Greater Western Sydney,"Reid, Sam",25,16,10,9,0,0,0,3
Greater Western Sydney,"Shaw, Heath",19,18,10,1,0,0,0,3
Greater Western Sydney,"Stein, Jake",8,4,3,4,0,0,0,4
Greater Western Sydney,"Taranto, Tim",25,13,5,12,0,0,0,4
Greater Western Sydney,"Tomlinson, Adam",19,15,7,4,0,0,0,1
Greater Western Sydney,"Whitfield, Lachie",26,18,9,8,1,0,0,3
Greater Western Sydney,"Williams, Zac",32,22,10,10,0,1,0,6
Greater Western Sydney,"Bonar, Aiden",7,4,3,3,0,0,0,2
Greater Western Sydney,"Caldwell, Jye",13,7,5,6,0,0,0,6
Greater Western Sydney,"Cameron, Jeremy",7,4,1,3,1,0,0,4
Greater Western Sydney,"Daniels, Brent",14,6,4,8,0,1,0,8
Greater Western Sydney,"Davis, Phil",16,8,5,8,0,0,0,1
Greater Western Sydney,"Deledio, Brett",9,6,2,3,1,0,0,1
Greater Western Sydney,"Greene, Toby",38,25,8,13,0,0,0,5
Greater Western Sydney,"Hately, Jackson",11,9,4,2,1,0,0,4
Greater Western Sydney,"Haynes, Nick",21,18,7,3,0,0,0,2
Greater Western Sydney,"Hill, Bobby",6,5,1,1,0,1,0,4
Greater Western Sydney,"Keeffe, Lachlan",9,6,2,3,0,0,0,1
Greater Western Sydney,"Kennedy, Adam",15,11,5,4,1,0,0,4
Greater Western Sydney,"Mumford, Shane",10,4,1,6,0,1,14,1
Greater Western Sydney,"Perryman, Harry",26,17,8,9,0,0,0,2
Greater Western Sydney,"Reid, Sam",12,8,5,4,0,0,0,4
Greater Western Sydney,"Shaw, Heath",23,20,5,3,0,0,0,5
Greater Western Sydney,"Simpson, Dawson",11,6,6,5,0,0,29,4
Greater Western Sydney,"Stein, Jake",7,6,4,1,0,0,0,5
Greater Western Sydney,"Taranto, Tim",25,20,5,5,0,1,0,6
Greater Western Sydney,"Tomlinson, Adam",13,10,2,3,0,0,0,2
Greater Western Sydney,"Whitfield, Lachie",29,21,7,8,0,0,0,1
Greater Western Sydney,"Williams, Zac",26,23,2,3,0,0,0,5
Greater Western Sydney,"Caldwell, Jye",10,6,2,4,0,0,0,3
Greater Western Sydney,"Corr, Aidan",12,8,3,4,0,0,0,3
Greater Western Sydney,"Daniels, Brent",16,6,4,10,0,2,0,4
Greater Western Sydney,"Davis, Phil",20,9,8,11,0,0,0,1
Greater Western Sydney,"Greene, Toby",24,15,2,9,2,2,0,4
Greater Western Sydney,"Haynes, Nick",26,19,9,7,0,0,0,0
Greater Western Sydney,"Hill, Bobby",8,6,3,2,0,1,0,3
Greater Western Sydney,"Himmelberg, Harry",9,7,6,2,2,0,0,1
Greater Western Sydney,"Keeffe, Lachlan",3,2,2,1,2,0,5,2
Greater Western Sydney,"Kelly, Josh",25,11,0,14,0,0,0,4
Greater Western Sydney,"Kennedy, Adam",18,10,3,8,1,0,0,4
Greater Western Sydney,"Perryman, Harry",15,8,4,7,0,0,0,2
Greater Western Sydney,"Reid, Sam",14,9,5,5,0,0,0,2
Greater Western Sydney,"Shaw, Heath",20,13,5,7,0,0,0,2
Greater Western Sydney,"Simpson, Dawson",5,0,0,5,0,0,56,2
Greater Western Sydney,"Sproule, Zach",5,4,4,1,0,0,0,0
Greater Western Sydney,"Stein, Jake",9,7,4,2,0,0,0,3
Greater Western Sydney,"Taranto, Tim",28,13,4,15,0,2,0,6
Greater Western Sydney,"Tomlinson, Adam",17,9,4,8,1,0,0,0
Greater Western Sydney,"Whitfield, Lachie",30,17,6,13,1,1,0,2
Greater Western Sydney,"Williams, Zac",27,21,4,6,0,0,0,5
Greater Western Sydney,"de Boer, Matt",17,7,3,10,0,0,0,5
Greater Western Sydney,"Cameron, Jeremy",19,16,12,3,9,5,0,1
Greater Western Sydney,"Corr, Aidan",11,9,2,2,0,0,0,0
Greater Western Sydney,"Cumming, Isaac",20,13,3,7,0,0,0,1
Greater Western Sydney,"Daniels, Brent",19,11,6,8,0,1,0,3
Greater Western Sydney,"Davis, Phil",17,8,11,9,0,0,0,4
Greater Western Sydney,"Finlayson, Jeremy",10,8,7,2,1,0,0,4
Greater Western Sydney,"Hill, Bobby",11,8,3,3,2,0,0,4
Greater Western Sydney,"Himmelberg, Harry",8,4,2,4,0,0,0,0
Greater Western Sydney,"Keeffe, Lachlan",8,2,3,6,0,0,6,1
Greater Western Sydney,"Kelly, Josh",27,19,6,8,2,0,0,4
Greater Western Sydney,"Kennedy, Adam",18,12,4,6,1,0,0,2
Greater Western Sydney,"Lloyd, Daniel",12,5,3,7,3,0,0,4
Greater Western Sydney,"Mumford, Shane",11,4,2,7,0,0,17,7
Greater Western Sydney,"Perryman, Harry",18,13,6,5,0,0,0,2
Greater Western Sydney,"Reid, Sam",14,12,8,2,0,0,0,1
Greater Western Sydney,"Shaw, Heath",23,21,8,2,0,0,0,5
Greater Western Sydney,"Taranto, Tim",31,14,4,17,1,1,0,5
Greater Western Sydney,"Taylor, Sam",14,5,5,9,0,0,0,0
Greater Western Sydney,"Tomlinson, Adam",22,12,9,10,0,0,0,3
Greater Western Sydney,"Whitfield, Lachie",27,19,8,8,1,0,0,5
Greater Western Sydney,"Williams, Zac",21,16,4,5,0,0,0,6
Greater Western Sydney,"de Boer, Matt",19,9,3,10,0,0,0,8
Greater Western Sydney,"Cameron, Jeremy",25,17,8,8,2,3,0,3
Greater Western Sydney,"Corr, Aidan",12,9,3,3,0,0,0,1
Greater Western Sydney,"Daniels, Brent",21,12,3,9,0,3,0,3
Greater Western Sydney,"Davis, Phil",8,7,4,1,0,0,0,0
Greater Western Sydney,"Deledio, Brett",11,5,4,6,0,0,0,4
Greater Western Sydney,"Finlayson, Jeremy",18,13,3,5,3,3,5,0
Greater Western Sydney,"Greene, Toby",20,14,5,6,3,1,0,3
Greater Western Sydney,"Haynes, Nick",18,10,2,8,0,0,0,1
Greater Western Sydney,"Himmelberg, Harry",12,6,2,6,2,1,0,3
Greater Western Sydney,"Hopper, Jacob",30,13,3,17,0,0,0,4
Greater Western Sydney,"Kelly, Josh",22,13,1,9,3,1,0,2
Greater Western Sydney,"Kennedy, Adam",16,11,3,5,0,1,0,1
Greater Western Sydney,"Lloyd, Daniel",9,6,3,3,2,0,0,1
Greater Western Sydney,"Mumford, Shane",9,1,0,8,0,0,39,4
Greater Western Sydney,"Perryman, Harry",19,9,4,10,0,0,0,4
Greater Western Sydney,"Reid, Sam",13,5,0,8,0,0,0,1
Greater Western Sydney,"Shaw, Heath",25,21,9,4,0,0,0,2
Greater Western Sydney,"Taranto, Tim",28,19,7,9,0,0,0,5
Greater Western Sydney,"Taylor, Sam",11,7,4,4,0,0,0,2
Greater Western Sydney,"Whitfield, Lachie",30,21,7,9,1,1,0,6
Greater Western Sydney,"Williams, Zac",20,11,2,9,0,0,0,3
Greater Western Sydney,"de Boer, Matt",18,9,1,9,0,0,1,8
Greater Western Sydney,"Cameron, Jeremy",16,13,6,3,3,0,0,2
Greater Western Sydney,"Corr, Aidan",13,12,3,1,0,0,0,3
Greater Western Sydney,"Daniels, Brent",9,3,0,6,1,0,0,5
Greater Western Sydney,"Davis, Phil",14,7,6,7,0,0,0,1
Greater Western Sydney,"Finlayson, Jeremy",12,9,3,3,2,2,1,3
Greater Western Sydney,"Greene, Toby",30,19,2,11,2,2,0,4
Greater Western Sydney,"Haynes, Nick",14,10,6,4,0,0,0,1
Greater Western Sydney,"Himmelberg, Harry",7,1,0,6,0,0,0,1
Greater Western Sydney,"Hopper, Jacob",25,11,3,14,1,0,0,3
Greater Western Sydney,"Kelly, Josh",26,17,3,9,1,1,0,2
Greater Western Sydney,"Kennedy, Adam",14,11,5,3,0,0,0,6
Greater Western Sydney,"Lloyd, Daniel",9,5,2,4,1,0,0,1
Greater Western Sydney,"Mumford, Shane",9,5,2,4,0,0,25,9
Greater Western Sydney,"Perryman, Harry",13,10,2,3,0,0,0,8
Greater Western Sydney,"Reid, Sam",11,6,1,5,0,1,0,2
Greater Western Sydney,"Shaw, Heath",6,5,3,1,0,0,0,3
Greater Western Sydney,"Taranto, Tim",17,11,2,6,0,1,0,5
Greater Western Sydney,"Taylor, Sam",10,5,3,5,0,0,0,0
Greater Western Sydney,"Tomlinson, Adam",7,4,2,3,0,1,0,3
Greater Western Sydney,"Whitfield, Lachie",13,5,1,8,0,0,0,3
Greater Western Sydney,"Williams, Zac",17,14,5,3,1,0,0,6
Greater Western Sydney,"de Boer, Matt",18,5,2,13,0,0,0,6
Greater Western Sydney,"Cameron, Jeremy",12,10,6,2,3,1,0,1
Greater Western Sydney,"Corr, Aidan",19,12,5,7,0,0,0,2
Greater Western Sydney,"Daniels, Brent",14,6,1,8,1,0,0,3
Greater Western Sydney,"Davis, Phil",4,3,1,1,0,0,0,3
Greater Western Sydney,"Finlayson, Jeremy",12,10,2,2,2,1,0,1
Greater Western Sydney,"Haynes, Nick",30,21,9,9,0,0,0,3
Greater Western Sydney,"Hill, Bobby",7,5,3,2,0,1,0,2
Greater Western Sydney,"Himmelberg, Harry",8,4,2,4,0,0,1,4
Greater Western Sydney,"Hopper, Jacob",22,13,1,9,0,1,0,3
Greater Western Sydney,"Keeffe, Lachlan",7,6,3,1,0,0,0,0
Greater Western Sydney,"Kelly, Josh",27,20,2,7,0,0,0,8
Greater Western Sydney,"Kennedy, Adam",13,10,3,3,0,0,0,3
Greater Western Sydney,"Lloyd, Daniel",19,12,3,7,0,2,0,2
Greater Western Sydney,"Mumford, Shane",8,5,0,3,0,0,14,8
Greater Western Sydney,"Perryman, Harry",23,14,6,9,0,0,0,8
Greater Western Sydney,"Reid, Sam",8,5,3,3,0,0,0,6
Greater Western Sydney,"Shaw, Heath",16,12,5,4,0,0,0,5
Greater Western Sydney,"Taranto, Tim",26,23,5,3,1,0,0,6
Greater Western Sydney,"Taylor, Sam",14,8,6,6,0,0,0,3
Greater Western Sydney,"Tomlinson, Adam",15,13,7,2,0,1,1,3
Greater Western Sydney,"Williams, Zac",25,22,6,3,1,0,0,6
Greater Western Sydney,"de Boer, Matt",9,4,1,5,0,0,0,8
Greater Western Sydney,"Cameron, Jeremy",13,11,7,2,1,1,0,1
Greater Western Sydney,"Corr, Aidan",18,15,4,3,0,0,0,1
Greater Western Sydney,"Daniels, Brent",15,9,5,6,0,1,0,4
Greater Western Sydney,"Davis, Phil",15,11,9,4,0,0,0,0
Greater Western Sydney,"Finlayson, Jeremy",1,1,1,0,0,0,1,1
Greater Western Sydney,"Greene, Toby",23,14,5,9,0,2,0,4
Greater Western Sydney,"Haynes, Nick",24,21,15,3,0,0,0,1
Greater Western Sydney,"Himmelberg, Harry",12,9,7,3,1,1,2,1
Greater Western Sydney,"Hopper, Jacob",19,11,2,8,1,0,0,9
Greater Western Sydney,"Kelly, Josh",15,6,2,9,0,0,0,6
Greater Western Sydney,"Kennedy, Adam",11,5,4,6,0,0,0,4
Greater Western Sydney,"Lloyd, Daniel",15,6,1,9,0,1,0,1
Greater Western Sydney,"Mumford, Shane",10,2,0,8,0,0,15,1
Greater Western Sydney,"Perryman, Harry",21,10,4,11,0,0,0,3
Greater Western Sydney,"Reid, Sam",12,5,2,7,0,0,0,3
Greater Western Sydney,"Shaw, Heath",29,19,14,10,0,0,0,3
Greater Western Sydney,"Taranto, Tim",30,14,5,16,0,0,0,7
Greater Western Sydney,"Taylor, Sam",14,6,4,8,0,0,0,1
Greater Western Sydney,"Tomlinson, Adam",17,11,6,6,0,0,0,0
Greater Western Sydney,"Whitfield, Lachie",14,12,3,2,0,0,0,1
Greater Western Sydney,"Williams, Zac",21,11,4,10,0,0,0,5
Greater Western Sydney,"de Boer, Matt",12,6,3,6,0,1,0,0
Hawthorn,"Breust, Luke",12,5,1,7,1,0,0,3
Hawthorn,"Burgoyne, Shaun",12,7,2,5,0,2,0,3
Hawthorn,"Ceglar, Jonathon",8,4,1,4,0,0,16,2
Hawthorn,"Cousins, James",18,14,4,4,2,0,0,6
Hawthorn,"Frawley, James",9,6,1,3,0,0,0,2
Hawthorn,"Gunston, Jack",19,14,6,5,1,4,0,3
Hawthorn,"Hardwick, Blake",22,15,4,7,0,0,0,4
Hawthorn,"Henderson, Ricky",20,13,7,7,0,0,0,4
Hawthorn,"Impey, Jarman",17,11,6,6,0,0,0,2
Hawthorn,"McEvoy, Ben",18,6,8,12,2,0,23,0
Hawthorn,"Mirra, David",16,10,7,6,0,0,0,4
Hawthorn,"Morrison, Harry",17,7,1,10,0,0,0,6
Hawthorn,"Nash, Conor",10,2,1,8,0,1,0,5
Hawthorn,"OMeara, Jaeger",24,18,3,6,2,2,0,5
Hawthorn,"Puopolo, Paul",9,2,0,7,0,0,0,5
Hawthorn,"Roughead, Jarryd",15,5,3,10,0,3,1,3
Hawthorn,"Scrimshaw, Jack",11,7,2,4,0,0,0,5
Hawthorn,"Shiels, Liam",22,14,0,8,1,1,0,4
Hawthorn,"Sicily, James",26,22,10,4,0,0,0,1
Hawthorn,"Smith, Isaac",20,17,5,3,1,0,0,3
Hawthorn,"Stratton, Ben",15,10,5,5,0,0,0,1
Hawthorn,"Worpel, James",27,16,4,11,2,0,0,3
Hawthorn,"Breust, Luke",21,14,2,7,1,2,0,2
Hawthorn,"Burgoyne, Shaun",14,10,4,4,0,0,0,4
Hawthorn,"Ceglar, Jonathon",9,6,2,3,0,0,14,5
Hawthorn,"Cousins, James",23,12,5,11,1,0,0,3
Hawthorn,"Frawley, James",9,8,1,1,0,0,0,2
Hawthorn,"Gunston, Jack",16,12,7,4,4,0,0,2
Hawthorn,"Hardwick, Blake",12,7,1,5,0,0,0,4
Hawthorn,"Henderson, Ricky",29,19,6,10,1,0,0,3
Hawthorn,"Impey, Jarman",11,3,2,8,0,0,0,3
Hawthorn,"McEvoy, Ben",15,7,5,8,0,0,31,1
Hawthorn,"Morrison, Harry",9,5,2,4,0,0,0,4
Hawthorn,"Nash, Conor",8,2,2,6,0,0,0,1
Hawthorn,"OMeara, Jaeger",30,24,4,6,1,1,0,6
Hawthorn,"Puopolo, Paul",9,7,2,2,2,1,0,5
Hawthorn,"Roughead, Jarryd",11,8,5,3,2,1,1,1
Hawthorn,"Scrimshaw, Jack",17,10,4,7,0,0,0,4
Hawthorn,"Scully, Tom",15,9,3,6,0,0,0,2
Hawthorn,"Shiels, Liam",8,6,0,2,0,0,0,3
Hawthorn,"Sicily, James",18,14,5,4,0,0,0,1
Hawthorn,"Smith, Isaac",21,12,1,9,1,1,0,3
Hawthorn,"Stratton, Ben",6,5,2,1,0,0,0,3
Hawthorn,"Worpel, James",25,14,5,11,0,0,0,6
Hawthorn,"Breust, Luke",13,9,5,4,5,0,0,3
Hawthorn,"Ceglar, Jonathon",11,4,4,7,0,1,17,5
Hawthorn,"Cousins, James",16,10,2,6,0,1,0,4
Hawthorn,"Frawley, James",13,8,4,5,0,0,0,2
Hawthorn,"Gunston, Jack",16,11,5,5,0,1,0,2
Hawthorn,"Hardwick, Blake",17,10,4,7,0,0,0,1
Hawthorn,"Henderson, Ricky",29,11,7,18,1,0,0,3
Hawthorn,"Impey, Jarman",18,15,8,3,0,0,0,3
Hawthorn,"McEvoy, Ben",16,13,9,3,2,1,22,5
Hawthorn,"Mirra, David",20,12,5,8,0,0,0,1
Hawthorn,"Moore, Dylan",9,2,1,7,0,0,0,5
Hawthorn,"Morrison, Harry",10,6,2,4,0,0,0,5
Hawthorn,"Nash, Conor",11,9,4,2,1,0,0,1
Hawthorn,"OMeara, Jaeger",32,17,3,15,0,0,0,12
Hawthorn,"Puopolo, Paul",10,4,0,6,0,1,0,1
Hawthorn,"Scrimshaw, Jack",19,10,5,9,0,0,0,1
Hawthorn,"Scully, Tom",24,9,1,15,0,1,0,4
Hawthorn,"Sicily, James",22,17,7,5,0,0,0,1
Hawthorn,"Smith, Isaac",22,15,8,7,1,0,0,4
Hawthorn,"Stratton, Ben",13,6,5,7,0,0,0,3
Hawthorn,"Wingard, Chad",10,9,3,1,3,1,0,3
Hawthorn,"Worpel, James",27,8,1,19,0,1,0,0
Hawthorn,"Breust, Luke",16,4,2,12,1,0,0,6
Hawthorn,"Ceglar, Jonathon",9,1,3,8,0,0,24,4
Hawthorn,"Cousins, James",24,14,1,10,0,1,0,2
Hawthorn,"Frawley, James",5,3,4,2,0,0,0,1
Hawthorn,"Gunston, Jack",14,9,5,5,0,2,1,1
Hawthorn,"Hardwick, Blake",19,10,2,9,0,0,0,3
Hawthorn,"Henderson, Ricky",25,15,9,10,2,0,0,2
Hawthorn,"Howe, Daniel",23,11,4,12,0,0,0,4
Hawthorn,"Impey, Jarman",15,10,4,5,0,0,0,0
Hawthorn,"McEvoy, Ben",11,4,4,7,0,0,40,3
Hawthorn,"Mirra, David",20,13,8,7,0,0,0,3
Hawthorn,"Morrison, Harry",18,10,1,8,0,0,0,4
Hawthorn,"Nash, Conor",9,4,1,5,1,1,0,1
Hawthorn,"Puopolo, Paul",13,6,3,7,1,1,0,5
Hawthorn,"Roughead, Jarryd",14,10,6,4,2,1,0,3
Hawthorn,"Scrimshaw, Jack",23,12,8,11,0,0,0,0
Hawthorn,"Scully, Tom",26,11,3,15,2,0,0,4
Hawthorn,"Sicily, James",28,23,10,5,0,0,0,1
Hawthorn,"Smith, Isaac",22,17,2,5,0,0,0,1
Hawthorn,"Stratton, Ben",5,3,3,2,0,0,0,2
Hawthorn,"Wingard, Chad",11,5,0,6,1,0,0,4
Hawthorn,"Worpel, James",25,15,4,10,0,1,0,4
Hawthorn,"Brand, Kaiden",11,8,5,3,0,0,0,0
Hawthorn,"Breust, Luke",12,10,3,2,0,2,0,2
Hawthorn,"Cousins, James",6,4,0,2,1,0,0,7
Hawthorn,"Gunston, Jack",14,9,8,5,0,0,0,5
Hawthorn,"Hardwick, Blake",18,11,3,7,0,0,0,4
Hawthorn,"Henderson, Ricky",33,21,10,12,2,1,0,2
Hawthorn,"Howe, Daniel",19,12,5,7,0,0,0,5
Hawthorn,"Impey, Jarman",15,10,5,5,0,0,0,4
Hawthorn,"Lewis, Mitch",14,9,4,5,1,1,1,0
Hawthorn,"McEvoy, Ben",16,9,6,7,2,0,37,1
Hawthorn,"Mirra, David",14,11,3,3,0,0,0,4
Hawthorn,"Morrison, Harry",10,7,6,3,0,1,0,0
Hawthorn,"Nash, Conor",2,0,0,2,0,0,0,2
Hawthorn,"OMeara, Jaeger",26,13,2,13,1,1,0,5
Hawthorn,"Puopolo, Paul",13,6,3,7,2,1,0,3
Hawthorn,"Roughead, Jarryd",13,7,3,6,2,1,8,3
Hawthorn,"Scrimshaw, Jack",17,6,5,11,0,0,0,2
Hawthorn,"Scully, Tom",19,7,2,12,0,0,0,3
Hawthorn,"Sicily, James",25,20,8,5,0,0,0,0
Hawthorn,"Smith, Isaac",20,11,2,9,1,0,0,1
Hawthorn,"Wingard, Chad",16,6,3,10,0,1,0,3
Hawthorn,"Worpel, James",24,15,6,9,1,0,0,4
Hawthorn,"Brand, Kaiden",9,5,1,4,0,0,0,2
Hawthorn,"Breust, Luke",14,9,5,5,3,0,0,4
Hawthorn,"Cousins, James",15,7,3,8,1,1,0,3
Hawthorn,"Gunston, Jack",13,9,5,4,0,2,0,3
Hawthorn,"Hardwick, Blake",18,14,3,4,0,0,0,6
Hawthorn,"Henderson, Ricky",16,11,8,5,0,1,0,1
Hawthorn,"Howe, Daniel",19,9,6,10,0,0,0,4
Hawthorn,"Impey, Jarman",16,10,5,6,0,0,0,4
Hawthorn,"Lewis, Mitch",6,5,3,1,1,1,1,3
Hawthorn,"McEvoy, Ben",15,5,2,10,0,0,41,5
Hawthorn,"OBrien, Tim",16,10,3,6,0,0,0,2
Hawthorn,"OMeara, Jaeger",42,17,8,25,1,0,0,2
Hawthorn,"Puopolo, Paul",10,4,1,6,0,0,0,5
Hawthorn,"Roughead, Jarryd",15,8,4,7,1,2,4,0
Hawthorn,"Scrimshaw, Jack",16,11,7,5,0,1,0,3
Hawthorn,"Scully, Tom",23,12,4,11,1,1,0,1
Hawthorn,"Shiels, Liam",26,19,7,7,3,0,0,9
Hawthorn,"Sicily, James",27,20,12,7,0,0,0,1
Hawthorn,"Smith, Isaac",20,15,8,5,0,0,0,2
Hawthorn,"Stratton, Ben",8,3,5,5,0,0,0,1
Hawthorn,"Wingard, Chad",17,12,5,5,2,2,0,3
Hawthorn,"Worpel, James",21,11,2,10,0,0,0,8
Hawthorn,"Brand, Kaiden",13,7,4,6,0,0,0,2
Hawthorn,"Breust, Luke",7,5,3,2,4,0,0,4
Hawthorn,"Burgoyne, Shaun",19,10,8,9,0,0,0,3
Hawthorn,"Gunston, Jack",20,14,8,6,3,1,0,1
Hawthorn,"Hardwick, Blake",19,15,7,4,0,0,0,4
Hawthorn,"Henderson, Ricky",22,12,8,10,0,0,0,0
Hawthorn,"Howe, Daniel",12,7,2,5,0,0,0,7
Hawthorn,"Impey, Jarman",22,12,2,10,0,0,0,6
Hawthorn,"Lewis, Mitch",7,5,4,2,1,1,3,3
Hawthorn,"McEvoy, Ben",16,3,6,13,0,0,26,3
Hawthorn,"Moore, Dylan",13,7,5,6,0,0,0,5
Hawthorn,"OBrien, Tim",11,8,5,3,0,0,0,3
Hawthorn,"OMeara, Jaeger",19,9,2,10,1,0,0,7
Hawthorn,"Puopolo, Paul",12,6,2,6,0,0,0,5
Hawthorn,"Roughead, Jarryd",8,8,0,0,1,0,2,4
Hawthorn,"Scully, Tom",14,9,4,5,0,0,0,2
Hawthorn,"Shiels, Liam",29,17,5,12,1,1,0,4
Hawthorn,"Sicily, James",18,12,3,6,0,0,0,2
Hawthorn,"Smith, Isaac",22,8,4,14,0,1,0,4
Hawthorn,"Stratton, Ben",10,7,4,3,0,0,0,2
Hawthorn,"Wingard, Chad",14,7,5,7,0,1,0,3
Hawthorn,"Worpel, James",24,11,2,13,0,1,0,6
Hawthorn,"Breust, Luke",13,6,4,7,1,1,0,4
Hawthorn,"Burgoyne, Shaun",14,9,4,5,0,0,0,5
Hawthorn,"Ceglar, Jonathon",13,7,6,6,2,0,16,0
Hawthorn,"Cousins, James",25,17,11,8,1,0,0,1
Hawthorn,"Frawley, James",17,13,8,4,0,0,0,2
Hawthorn,"Gunston, Jack",12,10,4,2,1,0,0,3
Hawthorn,"Hardwick, Blake",19,19,11,0,0,0,0,0
Hawthorn,"Henderson, Ricky",36,22,10,14,0,0,0,0
Hawthorn,"Impey, Jarman",18,8,6,10,2,0,0,1
Hawthorn,"Lewis, Mitch",11,8,7,3,1,2,2,1
Hawthorn,"McEvoy, Ben",15,7,8,8,0,1,33,4
Hawthorn,"Moore, Dylan",14,9,10,5,0,0,0,1
Hawthorn,"Morrison, Harry",17,10,7,7,0,0,0,1
Hawthorn,"OBrien, Tim",14,8,8,6,0,0,0,2
Hawthorn,"OMeara, Jaeger",15,10,2,5,1,0,0,7
Hawthorn,"Puopolo, Paul",16,10,4,6,0,1,0,6
Hawthorn,"Scrimshaw, Jack",15,8,2,7,0,0,0,0
Hawthorn,"Scully, Tom",18,9,3,9,0,0,0,2
Hawthorn,"Shiels, Liam",24,16,5,8,0,1,0,8
Hawthorn,"Sicily, James",27,20,9,7,1,0,0,3
Hawthorn,"Stratton, Ben",14,8,5,6,0,0,0,2
Hawthorn,"Worpel, James",22,8,2,14,0,1,0,5
Hawthorn,"Breust, Luke",14,9,7,5,3,2,0,6
Hawthorn,"Burgoyne, Shaun",18,10,6,8,0,0,0,5
Hawthorn,"Ceglar, Jonathon",26,10,8,16,0,0,15,1
Hawthorn,"Cousins, James",25,14,6,11,0,0,0,1
Hawthorn,"Glass, Conor",13,9,1,4,0,0,0,1
Hawthorn,"Gunston, Jack",14,8,5,6,1,2,0,1
Hawthorn,"Hardwick, Blake",20,16,6,4,0,0,0,3
Hawthorn,"Henderson, Ricky",30,19,6,11,0,0,0,0
Hawthorn,"Impey, Jarman",21,14,10,7,0,0,0,2
Hawthorn,"Lewis, Mitch",7,5,5,2,1,0,0,1
Hawthorn,"McEvoy, Ben",7,4,4,3,0,0,6,1
Hawthorn,"Moore, Dylan",15,7,7,8,1,1,0,0
Hawthorn,"Morrison, Harry",17,10,5,7,0,0,0,1
Hawthorn,"OBrien, Tim",16,13,3,3,0,0,1,1
Hawthorn,"OMeara, Jaeger",29,18,5,11,0,1,0,6
Hawthorn,"Puopolo, Paul",10,3,2,7,0,0,0,4
Hawthorn,"Scrimshaw, Jack",11,8,5,3,0,0,0,0
Hawthorn,"Scully, Tom",19,9,4,10,2,1,0,3
Hawthorn,"Shiels, Liam",24,11,7,13,0,1,0,2
Hawthorn,"Sicily, James",21,17,8,4,0,0,0,0
Hawthorn,"Stratton, Ben",8,4,3,4,0,0,0,0
Hawthorn,"Worpel, James",26,11,6,15,0,0,0,7
Hawthorn,"Breust, Luke",19,10,3,9,0,2,0,7
Hawthorn,"Burgoyne, Shaun",12,4,1,8,0,0,0,3
Hawthorn,"Ceglar, Jonathon",20,6,7,14,0,1,15,1
Hawthorn,"Cousins, James",20,12,8,8,1,0,0,0
Hawthorn,"Frawley, James",14,9,4,5,0,0,0,1
Hawthorn,"Glass, Conor",12,7,3,5,0,0,0,1
Hawthorn,"Gunston, Jack",21,17,9,4,6,0,2,3
Hawthorn,"Hardwick, Blake",14,7,3,7,0,0,0,2
Hawthorn,"Henderson, Ricky",37,27,11,10,0,1,0,2
Hawthorn,"Impey, Jarman",15,7,3,8,1,0,0,5
Hawthorn,"Morrison, Harry",11,6,2,5,0,0,0,3
Hawthorn,"OBrien, Tim",18,13,1,5,0,0,0,2
Hawthorn,"OMeara, Jaeger",22,5,2,17,0,1,0,3
Hawthorn,"Pittonet, Marc",8,1,0,7,0,0,29,4
Hawthorn,"Puopolo, Paul",11,8,1,3,1,0,0,8
Hawthorn,"Scrimshaw, Jack",17,10,1,7,0,0,0,2
Hawthorn,"Scully, Tom",23,7,0,16,1,0,0,1
Hawthorn,"Shiels, Liam",24,15,3,9,1,1,0,9
Hawthorn,"Sicily, James",23,18,8,5,0,0,0,4
Hawthorn,"Stratton, Ben",8,5,4,3,0,0,0,2
Hawthorn,"Wingard, Chad",20,10,6,10,0,1,0,5
Hawthorn,"Worpel, James",26,9,3,17,1,0,0,6
Hawthorn,"Breust, Luke",10,7,3,3,1,1,0,2
Hawthorn,"Burgoyne, Shaun",21,12,6,9,1,0,0,3
Hawthorn,"Ceglar, Jonathon",8,5,4,3,1,0,19,0
Hawthorn,"Cousins, James",15,8,1,7,1,0,0,1
Hawthorn,"Frawley, James",6,5,2,1,0,0,0,0
Hawthorn,"Glass, Conor",11,6,4,5,0,0,0,3
Hawthorn,"Gunston, Jack",16,10,3,6,0,0,0,3
Hawthorn,"Hardwick, Blake",13,9,4,4,0,0,0,1
Hawthorn,"Henderson, Ricky",19,9,5,10,1,0,0,4
Hawthorn,"Impey, Jarman",10,9,5,1,1,1,0,3
Hawthorn,"Lewis, Mitch",8,6,4,2,2,1,1,2
Hawthorn,"OBrien, Tim",13,7,6,6,0,0,0,0
Hawthorn,"OMeara, Jaeger",21,14,6,7,0,0,0,11
Hawthorn,"Pittonet, Marc",11,2,1,9,0,0,20,3
Hawthorn,"Puopolo, Paul",11,6,4,5,0,0,0,4
Hawthorn,"Scully, Tom",17,10,3,7,1,0,0,3
Hawthorn,"Shiels, Liam",17,9,3,8,0,1,0,8
Hawthorn,"Sicily, James",23,16,9,7,0,0,0,3
Hawthorn,"Smith, Isaac",19,14,2,5,0,0,0,1
Hawthorn,"Stratton, Ben",6,4,2,2,0,0,0,1
Hawthorn,"Wingard, Chad",8,7,1,1,1,0,0,3
Hawthorn,"Worpel, James",25,18,3,7,0,0,0,5
Hawthorn,"Brand, Kaiden",10,9,5,1,0,0,0,2
Hawthorn,"Breust, Luke",10,5,1,5,1,0,0,6
Hawthorn,"Burgoyne, Shaun",14,6,5,8,0,0,0,2
Hawthorn,"Ceglar, Jonathon",13,7,8,6,1,1,20,3
Hawthorn,"Cousins, James",13,6,6,7,0,1,0,2
Hawthorn,"Frawley, James",16,11,8,5,0,0,0,4
Hawthorn,"Glass, Conor",14,6,4,8,1,1,0,0
Hawthorn,"Gunston, Jack",13,8,4,5,1,1,0,3
Hawthorn,"Hardwick, Blake",22,17,10,5,0,0,0,5
Hawthorn,"Henderson, Ricky",31,22,11,9,1,0,0,4
Hawthorn,"Impey, Jarman",24,19,8,5,2,0,0,0
Hawthorn,"McEvoy, Ben",15,7,10,8,1,0,25,1
Hawthorn,"Moore, Dylan",10,5,4,5,1,0,0,3
Hawthorn,"OBrien, Tim",16,13,4,3,0,0,0,0
Hawthorn,"OMeara, Jaeger",24,16,4,8,0,1,0,0
Hawthorn,"Puopolo, Paul",11,5,3,6,1,0,0,2
Hawthorn,"Scully, Tom",24,15,10,9,1,1,0,2
Hawthorn,"Shiels, Liam",31,17,9,14,0,1,0,2
Hawthorn,"Sicily, James",20,12,8,8,0,0,0,3
Hawthorn,"Smith, Isaac",31,17,9,14,0,0,0,1
Hawthorn,"Stratton, Ben",11,5,3,6,0,0,0,2
Hawthorn,"Worpel, James",34,18,6,16,0,1,0,2
Hawthorn,"Brand, Kaiden",13,5,5,8,0,0,0,0
Hawthorn,"Breust, Luke",9,7,2,2,1,0,0,3
Hawthorn,"Burgoyne, Shaun",18,12,3,6,0,0,0,5
Hawthorn,"Ceglar, Jonathon",12,2,3,10,1,0,17,0
Hawthorn,"Frawley, James",12,9,4,3,0,0,0,1
Hawthorn,"Glass, Conor",20,11,3,9,0,0,0,1
Hawthorn,"Gunston, Jack",12,9,5,3,1,1,0,1
Hawthorn,"Hardwick, Blake",13,6,2,7,0,0,0,5
Hawthorn,"Henderson, Ricky",29,19,8,10,1,0,0,3
Hawthorn,"Impey, Jarman",15,11,4,4,1,0,0,0
Hawthorn,"McEvoy, Ben",6,0,0,6,0,0,24,0
Hawthorn,"Moore, Dylan",14,5,4,9,0,1,0,1
Hawthorn,"Morrison, Harry",7,3,1,4,0,0,0,5
Hawthorn,"OBrien, Tim",13,11,6,2,0,0,0,0
Hawthorn,"OMeara, Jaeger",28,19,3,9,1,0,0,6
Hawthorn,"Puopolo, Paul",9,1,1,8,0,0,0,2
Hawthorn,"Roughead, Jarryd",9,3,2,6,1,1,0,3
Hawthorn,"Scully, Tom",8,6,2,2,0,1,0,3
Hawthorn,"Shiels, Liam",25,13,1,12,1,0,0,11
Hawthorn,"Sicily, James",8,6,4,2,1,2,0,3
Hawthorn,"Smith, Isaac",24,15,5,9,0,2,0,3
Hawthorn,"Worpel, James",19,7,1,12,0,0,0,6
Hawthorn,"Breust, Luke",17,5,2,12,1,0,0,5
Hawthorn,"Burgoyne, Shaun",16,12,0,4,1,0,0,6
Hawthorn,"Ceglar, Jonathon",13,7,6,6,0,2,19,1
Hawthorn,"Frawley, James",8,7,3,1,0,0,0,1
Hawthorn,"Glass, Conor",11,10,5,1,0,0,0,2
Hawthorn,"Gunston, Jack",12,10,5,2,1,2,0,2
Hawthorn,"Hanrahan, Oliver",10,4,3,6,1,0,0,0
Hawthorn,"Hardwick, Blake",12,10,2,2,0,0,0,7
Hawthorn,"Henderson, Ricky",15,9,3,6,1,0,0,4
Hawthorn,"Howe, Daniel",8,8,2,0,1,1,0,7
Hawthorn,"Impey, Jarman",20,15,5,5,0,0,0,5
Hawthorn,"McEvoy, Ben",6,3,3,3,0,0,34,4
Hawthorn,"Moore, Dylan",8,1,0,7,0,0,0,5
Hawthorn,"Nash, Conor",7,4,0,3,1,1,0,4
Hawthorn,"OBrien, Tim",9,7,2,2,0,0,0,3
Hawthorn,"OMeara, Jaeger",36,23,0,13,0,3,0,10
Hawthorn,"Puopolo, Paul",12,5,0,7,0,1,0,8
Hawthorn,"Scully, Tom",20,12,1,8,0,0,0,1
Hawthorn,"Shiels, Liam",30,22,5,8,0,1,0,8
Hawthorn,"Sicily, James",18,13,5,5,0,0,0,0
Hawthorn,"Smith, Isaac",21,15,1,6,1,2,0,5
Hawthorn,"Worpel, James",23,15,0,8,1,1,0,9
Hawthorn,"Breust, Luke",17,8,1,9,2,2,0,4
Hawthorn,"Burgoyne, Shaun",17,7,2,10,0,0,0,5
Hawthorn,"Frawley, James",14,11,7,3,0,0,0,1
Hawthorn,"Glass, Conor",14,8,5,6,0,0,0,2
Hawthorn,"Gunston, Jack",11,10,4,1,0,0,0,2
Hawthorn,"Hanrahan, Oliver",16,8,3,8,2,0,0,3
Hawthorn,"Hardwick, Blake",23,12,5,11,1,0,0,1
Hawthorn,"Henderson, Ricky",12,6,1,6,0,0,0,3
Hawthorn,"Howe, Daniel",12,4,2,8,0,0,0,2
Hawthorn,"Impey, Jarman",25,16,6,9,0,1,0,3
Hawthorn,"Lewis, Mitch",16,12,7,4,2,1,0,2
Hawthorn,"McEvoy, Ben",11,6,5,5,1,0,29,4
Hawthorn,"Nash, Conor",9,0,0,9,0,0,0,5
Hawthorn,"OBrien, Tim",16,10,7,6,0,1,0,1
Hawthorn,"OMeara, Jaeger",23,13,2,10,0,0,0,4
Hawthorn,"Puopolo, Paul",17,7,2,10,0,1,0,7
Hawthorn,"Scully, Tom",18,4,1,14,0,0,0,3
Hawthorn,"Shiels, Liam",20,9,3,11,0,0,0,6
Hawthorn,"Sicily, James",28,23,14,5,0,0,0,1
Hawthorn,"Smith, Isaac",25,15,8,10,0,0,0,0
Hawthorn,"Stratton, Ben",11,7,3,4,0,0,0,3
Hawthorn,"Worpel, James",23,18,2,5,1,0,0,4
Hawthorn,"Birchall, Grant",21,13,8,8,0,0,0,1
Hawthorn,"Breust, Luke",12,7,3,5,3,0,0,8
Hawthorn,"Burgoyne, Shaun",17,11,6,6,0,0,0,4
Hawthorn,"Frawley, James",10,7,4,3,0,0,0,2
Hawthorn,"Hanrahan, Oliver",13,9,5,4,2,1,0,2
Hawthorn,"Hardwick, Blake",15,10,5,5,1,0,0,4
Hawthorn,"Henderson, Ricky",25,20,11,5,0,0,0,5
Hawthorn,"Howe, Daniel",18,10,6,8,0,1,0,6
Hawthorn,"Impey, Jarman",17,12,3,5,0,1,0,6
Hawthorn,"Lewis, Mitch",16,10,5,6,3,2,6,0
Hawthorn,"McEvoy, Ben",13,6,4,7,0,0,38,3
Hawthorn,"Nash, Conor",12,4,1,8,1,0,0,3
Hawthorn,"OBrien, Tim",9,6,4,3,0,2,1,1
Hawthorn,"OMeara, Jaeger",23,13,5,10,0,0,0,6
Hawthorn,"Puopolo, Paul",11,6,1,5,0,0,0,5
Hawthorn,"Scully, Tom",16,9,4,7,0,0,0,2
Hawthorn,"Shiels, Liam",21,5,1,16,0,1,0,6
Hawthorn,"Sicily, James",16,14,7,2,0,0,0,2
Hawthorn,"Smith, Isaac",23,13,4,10,0,0,0,2
Hawthorn,"Stratton, Ben",13,7,5,6,0,0,0,1
Hawthorn,"Wingard, Chad",15,8,4,7,2,0,0,6
Hawthorn,"Worpel, James",33,21,5,12,0,0,0,4
Hawthorn,"Breust, Luke",17,8,4,9,0,1,0,3
Hawthorn,"Burgoyne, Shaun",19,14,7,5,0,0,0,2
Hawthorn,"Frawley, James",15,10,4,5,0,0,0,4
Hawthorn,"Gunston, Jack",18,13,6,5,2,0,0,2
Hawthorn,"Hanrahan, Oliver",14,9,4,5,1,1,0,3
Hawthorn,"Hardwick, Blake",15,10,2,5,0,1,0,3
Hawthorn,"Henderson, Ricky",22,13,7,9,0,2,0,2
Hawthorn,"Howe, Daniel",23,15,10,8,0,0,0,3
Hawthorn,"Impey, Jarman",2,2,1,0,0,0,0,0
Hawthorn,"Lewis, Mitch",15,12,5,3,3,1,4,0
Hawthorn,"McEvoy, Ben",13,5,4,8,0,0,44,2
Hawthorn,"Nash, Conor",5,3,2,2,0,0,0,1
Hawthorn,"OBrien, Tim",11,7,5,4,3,1,3,0
Hawthorn,"OMeara, Jaeger",27,14,3,13,0,0,0,5
Hawthorn,"Puopolo, Paul",13,6,2,7,0,0,0,3
Hawthorn,"Scully, Tom",20,10,2,10,0,0,0,3
Hawthorn,"Shiels, Liam",29,18,5,11,2,1,0,9
Hawthorn,"Sicily, James",16,13,7,3,0,0,0,0
Hawthorn,"Smith, Isaac",21,14,9,7,0,0,0,0
Hawthorn,"Stratton, Ben",7,3,4,4,0,0,0,1
Hawthorn,"Wingard, Chad",21,11,1,10,0,2,0,4
Hawthorn,"Worpel, James",24,10,4,14,1,0,0,4
Hawthorn,"Birchall, Grant",24,12,4,12,0,1,0,0
Hawthorn,"Breust, Luke",8,4,1,4,0,1,0,0
Hawthorn,"Burgoyne, Shaun",18,7,3,11,2,1,0,3
Hawthorn,"Ceglar, Jonathon",11,6,6,5,0,0,6,1
Hawthorn,"Frawley, James",10,6,3,4,0,0,0,0
Hawthorn,"Gunston, Jack",15,11,4,4,1,2,0,4
Hawthorn,"Hanrahan, Oliver",10,7,3,3,0,0,0,0
Hawthorn,"Hardwick, Blake",15,10,5,5,0,0,0,7
Hawthorn,"Henderson, Ricky",22,12,6,10,0,2,0,1
Hawthorn,"Howe, Daniel",14,9,6,5,0,0,0,1
Hawthorn,"Lewis, Mitch",10,6,6,4,0,3,0,1
Hawthorn,"McEvoy, Ben",14,4,3,10,0,0,41,6
Hawthorn,"Nash, Conor",12,8,3,4,2,1,0,2
Hawthorn,"OMeara, Jaeger",26,16,2,10,0,0,0,10
Hawthorn,"Puopolo, Paul",14,6,2,8,0,2,0,6
Hawthorn,"Scully, Tom",20,11,9,9,1,0,0,1
Hawthorn,"Shiels, Liam",24,12,3,12,0,2,0,9
Hawthorn,"Sicily, James",20,14,3,6,0,0,0,2
Hawthorn,"Smith, Isaac",21,17,11,4,1,0,0,2
Hawthorn,"Stratton, Ben",6,3,2,3,0,0,0,2
Hawthorn,"Wingard, Chad",21,10,1,11,0,1,0,2
Hawthorn,"Worpel, James",34,17,4,17,0,0,0,3
Hawthorn,"Birchall, Grant",17,10,4,7,1,0,0,1
Hawthorn,"Breust, Luke",13,7,4,6,1,0,0,1
Hawthorn,"Burgoyne, Shaun",23,12,7,11,0,0,0,6
Hawthorn,"Frawley, James",11,7,5,4,0,0,0,0
Hawthorn,"Gunston, Jack",16,10,5,6,2,0,0,2
Hawthorn,"Hanrahan, Oliver",8,5,1,3,0,0,0,0
Hawthorn,"Hardwick, Blake",19,9,3,10,0,0,0,3
Hawthorn,"Henderson, Ricky",21,11,5,10,0,1,0,0
Hawthorn,"Howe, Daniel",19,10,4,9,0,0,0,2
Hawthorn,"Lewis, Mitch",16,8,4,8,3,2,1,4
Hawthorn,"McEvoy, Ben",10,3,2,7,0,0,43,2
Hawthorn,"Nash, Conor",6,3,1,3,0,0,0,5
Hawthorn,"OBrien, Tim",12,8,3,4,1,1,1,2
Hawthorn,"OMeara, Jaeger",26,15,6,11,0,1,0,4
Hawthorn,"Puopolo, Paul",9,2,1,7,1,0,0,3
Hawthorn,"Scully, Tom",17,10,5,7,0,1,0,4
Hawthorn,"Shiels, Liam",24,11,1,13,0,0,0,8
Hawthorn,"Sicily, James",17,10,3,7,0,0,0,0
Hawthorn,"Smith, Isaac",23,14,6,9,0,0,0,3
Hawthorn,"Stratton, Ben",14,4,4,10,0,0,0,2
Hawthorn,"Wingard, Chad",29,11,2,18,0,0,0,3
Hawthorn,"Worpel, James",37,21,5,16,0,1,0,5
Hawthorn,"Breust, Luke",19,11,2,8,2,1,0,0
Hawthorn,"Burgoyne, Shaun",14,13,3,1,0,0,0,2
Hawthorn,"Ceglar, Jonathon",16,6,1,10,0,0,35,3
Hawthorn,"Cousins, James",19,11,4,8,0,0,0,3
Hawthorn,"Frawley, James",16,13,4,3,0,0,0,0
Hawthorn,"Hanrahan, Oliver",16,9,2,7,0,0,0,1
Hawthorn,"Hardwick, Blake",16,9,5,7,0,0,0,1
Hawthorn,"Henderson, Ricky",24,15,5,9,1,0,0,1
Hawthorn,"Howe, Daniel",12,7,3,5,0,0,0,3
Hawthorn,"Jiath, Changkuoth",11,3,3,8,0,0,0,2
Hawthorn,"Lewis, Mitch",12,6,2,6,2,0,0,2
Hawthorn,"Nash, Conor",16,5,4,11,1,0,0,2
Hawthorn,"OBrien, Tim",8,4,4,4,2,1,3,0
Hawthorn,"OMeara, Jaeger",18,16,2,2,0,0,0,8
Hawthorn,"Puopolo, Paul",13,7,3,6,2,1,0,4
Hawthorn,"Scully, Tom",13,8,1,5,1,0,0,2
Hawthorn,"Shiels, Liam",30,20,3,10,0,0,0,6
Hawthorn,"Sicily, James",33,23,6,10,0,0,0,1
Hawthorn,"Smith, Isaac",28,19,5,9,1,0,0,4
Hawthorn,"Stratton, Ben",5,3,0,2,0,0,0,0
Hawthorn,"Wingard, Chad",27,18,2,9,1,0,0,6
Hawthorn,"Worpel, James",31,22,2,9,0,1,0,6
Hawthorn,"Breust, Luke",11,6,1,5,0,1,0,7
Hawthorn,"Burgoyne, Shaun",12,8,5,4,0,0,0,0
Hawthorn,"Ceglar, Jonathon",15,7,4,8,0,1,34,5
Hawthorn,"Frawley, James",17,12,5,5,0,0,0,2
Hawthorn,"Gunston, Jack",21,13,7,8,0,2,0,3
Hawthorn,"Hanrahan, Oliver",12,7,3,5,1,0,0,0
Hawthorn,"Hardwick, Blake",23,18,6,5,0,1,0,1
Hawthorn,"Henderson, Ricky",19,11,3,8,0,0,0,1
Hawthorn,"Jiath, Changkuoth",18,7,4,11,0,0,0,3
Hawthorn,"McEvoy, Ben",13,7,6,6,0,0,1,1
Hawthorn,"Nash, Conor",9,4,3,5,1,0,0,4
Hawthorn,"OBrien, Tim",12,8,6,4,2,3,3,3
Hawthorn,"OMeara, Jaeger",24,16,4,8,0,0,0,3
Hawthorn,"Puopolo, Paul",16,5,3,11,0,0,0,4
Hawthorn,"Roughead, Jarryd",14,11,5,3,6,1,3,2
Hawthorn,"Scully, Tom",26,14,4,12,2,0,0,1
Hawthorn,"Shiels, Liam",19,7,3,12,1,0,0,8
Hawthorn,"Sicily, James",12,10,4,2,0,0,0,0
Hawthorn,"Smith, Isaac",24,12,6,12,1,0,0,1
Hawthorn,"Stratton, Ben",11,6,3,5,0,0,0,1
Hawthorn,"Wingard, Chad",22,14,7,8,2,0,0,10
Hawthorn,"Worpel, James",34,16,3,18,2,0,0,7
Hawthorn,"Breust, Luke",18,9,2,9,3,1,0,5
Hawthorn,"Burgoyne, Shaun",14,11,5,3,3,0,0,4
Hawthorn,"Ceglar, Jonathon",16,7,6,9,0,0,39,3
Hawthorn,"Frawley, James",16,12,6,4,0,0,0,2
Hawthorn,"Gunston, Jack",17,14,6,3,2,1,0,0
Hawthorn,"Hanrahan, Oliver",19,10,3,9,0,2,0,0
Hawthorn,"Hardwick, Blake",18,14,6,4,0,0,0,0
Hawthorn,"Henderson, Ricky",25,16,12,9,1,0,0,1
Hawthorn,"Howe, Daniel",15,9,3,6,0,0,0,0
Hawthorn,"McEvoy, Ben",6,2,2,4,0,0,0,0
Hawthorn,"Nash, Conor",8,5,4,3,1,0,0,2
Hawthorn,"OBrien, Tim",10,8,4,2,4,0,5,2
Hawthorn,"OMeara, Jaeger",27,21,8,6,0,0,0,3
Hawthorn,"Puopolo, Paul",15,4,1,11,0,0,0,4
Hawthorn,"Scrimshaw, Jack",14,4,2,10,0,0,0,1
Hawthorn,"Scully, Tom",8,4,1,4,0,0,0,2
Hawthorn,"Shiels, Liam",14,8,1,6,0,0,0,6
Hawthorn,"Sicily, James",18,15,8,3,1,0,0,3
Hawthorn,"Smith, Isaac",20,13,4,7,1,2,0,1
Hawthorn,"Stratton, Ben",4,3,2,1,0,0,0,0
Hawthorn,"Wingard, Chad",28,19,5,9,0,0,0,5
Hawthorn,"Worpel, James",20,8,2,12,0,0,0,3
Melbourne,"Brayshaw, Angus",26,17,4,9,1,1,0,3
Melbourne,"Fritsch, Bayley",14,7,4,7,1,0,0,2
Melbourne,"Frost, Sam",9,4,3,5,0,0,0,2
Melbourne,"Gawn, Max",13,7,3,6,0,0,21,2
Melbourne,"Harmes, James",23,12,5,11,0,1,0,4
Melbourne,"Hibberd, Michael",15,14,5,1,0,0,0,1
Melbourne,"Hore, Marty",14,7,2,7,0,0,0,1
Melbourne,"Hunt, Jayden",14,5,0,9,0,0,0,4
Melbourne,"Jetta, Neville",10,4,3,6,0,0,0,2
Melbourne,"Jones, Nathan",19,12,6,7,1,0,0,1
Melbourne,"McDonald, Oscar",5,4,1,1,0,0,0,1
Melbourne,"McDonald, Tom",8,4,4,4,1,0,3,1
Melbourne,"Melksham, Jake",16,15,8,1,2,0,0,1
Melbourne,"Neal-Bullen, Alex",15,9,2,6,0,2,0,5
Melbourne,"Oliver, Clayton",23,13,1,10,0,0,0,3
Melbourne,"Petracca, Christian",15,5,3,10,1,1,0,3
Melbourne,"Salem, Christian",32,30,5,2,0,0,0,4
Melbourne,"Spargo, Charlie",11,6,7,5,0,0,0,0
Melbourne,"Sparrow, Tom",14,12,1,2,1,0,0,3
Melbourne,"Viney, Jack",10,6,1,4,0,0,0,4
Melbourne,"Wagner, Corey",14,11,4,3,0,0,0,4
Melbourne,"Weideman, Sam",13,6,4,7,1,1,5,2
Melbourne,"Brayshaw, Angus",33,22,2,11,1,0,0,4
Melbourne,"Fritsch, Bayley",16,8,4,8,0,2,0,8
Melbourne,"Frost, Sam",7,5,1,2,0,0,0,4
Melbourne,"Gawn, Max",13,13,1,0,0,0,53,4
Melbourne,"Harmes, James",23,12,2,11,0,1,0,9
Melbourne,"Hibberd, Michael",14,9,1,5,0,0,0,3
Melbourne,"Hunt, Jayden",9,4,0,5,0,0,0,4
Melbourne,"Jetta, Neville",8,4,2,4,0,0,0,6
Melbourne,"Jones, Nathan",22,11,5,11,0,0,0,2
Melbourne,"Kolodjashnij, Kade",5,4,2,1,0,0,0,4
Melbourne,"Lockhart, Jay",6,4,2,2,1,0,0,2
Melbourne,"May, Steven",6,6,1,0,0,0,0,0
Melbourne,"McDonald, Oscar",8,4,1,4,0,0,0,3
Melbourne,"McDonald, Tom",16,9,3,7,0,2,3,3
Melbourne,"Melksham, Jake",14,9,7,5,2,1,0,3
Melbourne,"Neal-Bullen, Alex",9,7,1,2,0,0,0,4
Melbourne,"Oliver, Clayton",44,15,2,29,0,0,0,6
Melbourne,"Petracca, Christian",16,8,1,8,0,0,0,7
Melbourne,"Salem, Christian",23,14,3,9,0,0,0,6
Melbourne,"Sparrow, Tom",8,5,1,3,0,2,0,5
Melbourne,"Viney, Jack",27,11,4,16,1,1,0,8
Melbourne,"Weideman, Sam",12,5,4,7,1,1,0,2
Melbourne,"Brayshaw, Angus",34,22,8,12,1,0,0,2
Melbourne,"Fritsch, Bayley",21,16,4,5,0,0,0,1
Melbourne,"Frost, Sam",13,10,3,3,0,0,0,0
Melbourne,"Gawn, Max",17,12,6,5,1,0,43,1
Melbourne,"Harmes, James",21,12,0,9,3,2,0,6
Melbourne,"Hibberd, Michael",16,11,2,5,0,0,0,1
Melbourne,"Hunt, Jayden",16,12,4,4,3,1,0,2
Melbourne,"Jetta, Neville",11,5,2,6,0,0,0,3
Melbourne,"Jones, Nathan",20,8,1,12,0,0,0,1
Melbourne,"Kolodjashnij, Kade",12,6,5,6,1,0,0,2
Melbourne,"Lockhart, Jay",14,9,5,5,2,0,0,2
Melbourne,"McDonald, Oscar",5,3,0,2,0,0,0,4
Melbourne,"McDonald, Tom",6,3,1,3,0,0,0,2
Melbourne,"Melksham, Jake",10,7,2,3,2,0,0,4
Melbourne,"Neal-Bullen, Alex",8,4,0,4,1,0,0,4
Melbourne,"Oliver, Clayton",29,10,2,19,0,0,0,4
Melbourne,"Petracca, Christian",16,8,5,8,1,0,0,3
Melbourne,"Salem, Christian",20,15,2,5,0,0,0,2
Melbourne,"Viney, Jack",21,11,3,10,0,0,0,6
Melbourne,"Wagner, Corey",12,5,3,7,1,0,0,4
Melbourne,"Wagner, Josh",16,7,0,9,0,0,0,3
Melbourne,"Weideman, Sam",14,7,3,7,2,0,2,2
Melbourne,"Brayshaw, Angus",19,10,2,9,1,0,0,4
Melbourne,"Fritsch, Bayley",16,10,5,6,0,0,0,4
Melbourne,"Frost, Sam",8,6,2,2,0,0,0,1
Melbourne,"Gawn, Max",19,16,5,3,0,0,55,1
Melbourne,"Harmes, James",19,13,4,6,1,1,0,2
Melbourne,"Hibberd, Michael",13,9,3,4,0,0,0,3
Melbourne,"Hore, Marty",20,14,9,6,0,0,0,3
Melbourne,"Hunt, Jayden",13,8,3,5,2,1,0,7
Melbourne,"Jones, Nathan",21,16,4,5,3,0,0,3
Melbourne,"McDonald, Oscar",8,7,3,1,0,0,0,1
Melbourne,"McDonald, Tom",16,9,6,7,1,2,5,1
Melbourne,"Melksham, Jake",14,10,3,4,1,1,0,2
Melbourne,"Oliver, Clayton",33,15,7,18,0,0,0,2
Melbourne,"Petracca, Christian",17,9,3,8,2,0,0,6
Melbourne,"Preuss, Braydon",11,10,1,1,2,0,13,0
Melbourne,"Salem, Christian",27,20,5,7,0,0,0,2
Melbourne,"Spargo, Charlie",7,5,1,2,0,0,0,1
Melbourne,"Stretch, Billy",12,9,4,3,0,0,0,2
Melbourne,"Viney, Jack",15,7,0,8,1,0,0,9
Melbourne,"Wagner, Corey",10,8,3,2,0,0,0,4
Melbourne,"Wagner, Josh",16,6,4,10,0,0,0,2
Melbourne,"Weideman, Sam",9,5,3,4,1,0,0,3
Melbourne,"Brayshaw, Angus",27,19,5,8,1,1,0,3
Melbourne,"Fritsch, Bayley",16,11,8,5,0,0,0,0
Melbourne,"Frost, Sam",19,13,7,6,0,0,0,5
Melbourne,"Gawn, Max",20,9,4,11,0,1,32,2
Melbourne,"Harmes, James",25,12,7,13,1,0,0,4
Melbourne,"Hibberd, Michael",18,11,7,7,0,0,0,1
Melbourne,"Hore, Marty",20,15,13,5,0,0,0,2
Melbourne,"Hunt, Jayden",13,8,4,5,0,2,0,1
Melbourne,"Jetta, Neville",15,9,4,6,0,0,0,0
Melbourne,"Jones, Nathan",23,10,7,13,0,1,0,1
Melbourne,"Lewis, Jordan",13,7,3,6,0,0,0,0
Melbourne,"McDonald, Tom",11,5,4,6,0,1,1,1
Melbourne,"Melksham, Jake",14,8,7,6,2,0,0,2
Melbourne,"Oliver, Clayton",31,11,6,20,0,0,0,6
Melbourne,"Petracca, Christian",21,13,6,8,1,0,0,3
Melbourne,"Preuss, Braydon",15,10,3,5,2,0,16,2
Melbourne,"Salem, Christian",29,18,8,11,0,0,0,4
Melbourne,"Spargo, Charlie",11,9,5,2,0,0,0,2
Melbourne,"Viney, Jack",23,8,4,15,0,0,0,7
Melbourne,"Wagner, Corey",6,3,0,3,0,1,0,6
Melbourne,"Wagner, Josh",13,11,2,2,0,1,0,1
Melbourne,"Weideman, Sam",12,5,5,7,0,1,0,1
Melbourne,"Brayshaw, Angus",29,19,7,10,0,0,0,1
Melbourne,"Fritsch, Bayley",12,6,4,6,1,0,0,3
Melbourne,"Frost, Sam",14,9,2,5,0,0,0,3
Melbourne,"Garlett, Jeff",11,7,3,4,0,0,0,3
Melbourne,"Gawn, Max",17,11,3,6,1,1,48,1
Melbourne,"Harmes, James",15,10,9,5,0,1,0,1
Melbourne,"Hibberd, Michael",11,7,1,4,0,0,0,3
Melbourne,"Hore, Marty",19,14,3,5,0,0,0,1
Melbourne,"Hunt, Jayden",7,3,1,4,1,0,0,1
Melbourne,"Jones, Nathan",20,11,5,9,0,1,0,2
Melbourne,"Lewis, Jordan",19,10,1,9,0,0,0,3
Melbourne,"Lockhart, Jay",8,5,3,3,1,0,0,3
Melbourne,"McDonald, Tom",15,9,5,6,0,0,0,2
Melbourne,"Melksham, Jake",25,18,8,7,0,0,0,2
Melbourne,"Neal-Bullen, Alex",10,7,3,3,1,0,0,6
Melbourne,"Oliver, Clayton",29,10,3,19,0,0,0,8
Melbourne,"Petracca, Christian",12,5,5,7,0,0,0,2
Melbourne,"Salem, Christian",24,17,3,7,0,0,0,1
Melbourne,"Smith, Tim",9,5,4,4,1,1,2,1
Melbourne,"Stretch, Billy",20,12,5,8,0,0,0,5
Melbourne,"Viney, Jack",22,12,5,10,0,0,0,4
Melbourne,"Weideman, Sam",6,4,3,2,0,0,1,1
Melbourne,"Brayshaw, Angus",21,11,2,10,1,0,0,0
Melbourne,"Fritsch, Bayley",14,11,6,3,1,1,0,0
Melbourne,"Frost, Sam",12,7,4,5,0,0,0,0
Melbourne,"Garlett, Jeff",9,5,2,4,1,2,0,2
Melbourne,"Gawn, Max",17,13,6,4,0,0,46,2
Melbourne,"Harmes, James",31,17,6,14,1,1,0,5
Melbourne,"Hibberd, Michael",26,17,8,9,0,0,0,2
Melbourne,"Hore, Marty",18,14,7,4,0,0,0,2
Melbourne,"Hunt, Jayden",15,9,5,6,2,1,0,1
Melbourne,"Jones, Nathan",20,11,1,9,1,1,0,5
Melbourne,"Keilty, Declan",6,3,2,3,0,0,3,2
Melbourne,"Lewis, Jordan",13,8,2,5,0,0,0,1
Melbourne,"Lockhart, Jay",20,13,8,7,1,0,0,4
Melbourne,"McDonald, Oscar",8,8,6,0,0,0,0,2
Melbourne,"McDonald, Tom",11,8,3,3,1,0,2,3
Melbourne,"Melksham, Jake",20,10,2,10,0,1,0,5
Melbourne,"Neal-Bullen, Alex",12,8,1,4,1,0,0,8
Melbourne,"Oliver, Clayton",30,13,8,17,0,1,0,2
Melbourne,"Petracca, Christian",11,6,2,5,0,1,0,2
Melbourne,"Salem, Christian",26,18,5,8,0,0,0,3
Melbourne,"Stretch, Billy",18,10,4,8,1,0,0,1
Melbourne,"Wagner, Josh",9,4,2,5,0,0,0,4
Melbourne,"Brayshaw, Angus",23,9,3,14,0,0,0,3
Melbourne,"Fritsch, Bayley",17,9,6,8,0,0,0,2
Melbourne,"Frost, Sam",22,13,7,9,0,1,0,0
Melbourne,"Garlett, Jeff",9,8,1,1,0,0,0,5
Melbourne,"Gawn, Max",10,8,2,2,0,0,46,4
Melbourne,"Harmes, James",22,13,1,9,1,1,0,13
Melbourne,"Hibberd, Michael",11,7,3,4,0,0,0,0
Melbourne,"Hore, Marty",19,15,4,4,1,0,0,2
Melbourne,"Hunt, Jayden",14,6,3,8,1,1,0,3
Melbourne,"Jones, Nathan",28,14,4,14,0,0,0,8
Melbourne,"Keilty, Declan",9,3,1,6,0,0,4,6
Melbourne,"Lewis, Jordan",18,10,6,8,0,0,0,2
Melbourne,"Lockhart, Jay",19,9,9,10,0,1,0,4
Melbourne,"McDonald, Oscar",8,5,2,3,0,0,0,2
Melbourne,"McDonald, Tom",11,7,3,4,3,1,2,2
Melbourne,"Melksham, Jake",22,14,11,8,1,2,0,3
Melbourne,"Oliver, Clayton",38,14,5,24,0,0,0,15
Melbourne,"Petracca, Christian",22,12,3,10,1,2,0,2
Melbourne,"Salem, Christian",23,13,6,10,0,0,0,7
Melbourne,"Stretch, Billy",19,12,2,7,0,0,0,5
Melbourne,"Viney, Jack",20,7,2,13,0,1,0,6
Melbourne,"Wagner, Josh",13,6,0,7,0,0,0,5
Melbourne,"Baker, Oskar",10,6,3,4,0,1,0,1
Melbourne,"Brayshaw, Angus",19,6,5,13,0,1,0,2
Melbourne,"Fritsch, Bayley",12,7,1,5,0,0,0,0
Melbourne,"Frost, Sam",15,14,6,1,0,0,0,1
Melbourne,"Garlett, Jeff",15,9,4,6,3,2,0,2
Melbourne,"Gawn, Max",15,11,2,4,0,0,56,4
Melbourne,"Harmes, James",30,13,1,17,0,1,0,6
Melbourne,"Hore, Marty",15,8,7,7,0,0,0,0
Melbourne,"Hunt, Jayden",19,13,6,6,2,0,0,1
Melbourne,"Jones, Nathan",21,10,1,11,1,0,0,4
Melbourne,"Lockhart, Jay",11,8,3,3,0,0,0,1
Melbourne,"McDonald, Oscar",13,9,3,4,0,0,0,5
Melbourne,"McDonald, Tom",15,11,6,4,0,2,0,2
Melbourne,"Neal-Bullen, Alex",11,6,2,5,0,0,0,1
Melbourne,"Oliver, Clayton",29,8,2,21,0,0,0,12
Melbourne,"Petracca, Christian",17,11,4,6,2,2,0,1
Melbourne,"Petty, Harry",10,5,4,5,0,0,0,1
Melbourne,"Salem, Christian",17,11,2,6,0,0,0,7
Melbourne,"Smith, Tim",8,3,3,5,1,0,3,3
Melbourne,"Stretch, Billy",17,11,4,6,0,1,0,4
Melbourne,"Viney, Jack",19,9,5,10,0,0,0,5
Melbourne,"Wagner, Josh",17,9,1,8,0,0,0,0
Melbourne,"Baker, Oskar",16,12,5,4,2,1,0,0
Melbourne,"Brayshaw, Angus",14,9,8,5,0,1,0,4
Melbourne,"Fritsch, Bayley",19,14,5,5,0,0,0,1
Melbourne,"Frost, Sam",12,6,2,6,0,0,0,1
Melbourne,"Garlett, Jeff",6,5,2,1,1,1,0,2
Melbourne,"Gawn, Max",25,17,8,8,0,0,35,1
Melbourne,"Harmes, James",23,11,4,12,0,0,0,6
Melbourne,"Hore, Marty",18,14,4,4,0,0,0,3
Melbourne,"Hunt, Jayden",7,4,3,3,1,2,0,1
Melbourne,"Jones, Nathan",12,5,1,7,0,0,0,7
Melbourne,"Lockhart, Jay",8,6,5,2,1,0,0,0
Melbourne,"McDonald, Oscar",8,4,2,4,0,0,0,1
Melbourne,"McDonald, Tom",8,7,3,1,2,1,0,1
Melbourne,"Oliver, Clayton",17,6,2,11,0,0,0,7
Melbourne,"Petracca, Christian",19,11,5,8,1,1,0,4
Melbourne,"Petty, Harry",5,4,1,1,0,0,0,1
Melbourne,"Smith, Tim",13,8,3,5,0,0,5,6
Melbourne,"Spargo, Charlie",10,5,3,5,1,0,0,4
Melbourne,"Stretch, Billy",20,12,5,8,1,0,0,2
Melbourne,"Viney, Jack",23,14,5,9,0,1,0,3
Melbourne,"Wagner, Corey",8,6,2,2,0,0,0,4
Melbourne,"Wagner, Josh",22,15,7,7,0,0,0,2
Melbourne,"Baker, Oskar",21,12,7,9,0,0,0,3
Melbourne,"Brayshaw, Angus",23,15,2,8,1,0,0,4
Melbourne,"Fritsch, Bayley",20,16,5,4,0,0,0,2
Melbourne,"Frost, Sam",12,9,5,3,0,0,0,2
Melbourne,"Garlett, Jeff",10,8,5,2,3,2,0,3
Melbourne,"Gawn, Max",25,16,7,9,0,2,30,2
Melbourne,"Hannan, Mitch",9,3,2,6,1,0,0,1
Melbourne,"Harmes, James",29,12,3,17,1,1,0,3
Melbourne,"Hibberd, Michael",22,14,5,8,0,0,0,0
Melbourne,"Hunt, Jayden",13,11,7,2,1,1,0,1
Melbourne,"Jones, Nathan",28,14,4,14,1,1,0,2
Melbourne,"Kennedy Harris, Jay",18,12,6,6,0,0,0,6
Melbourne,"McDonald, Oscar",11,9,3,2,0,0,0,3
Melbourne,"McDonald, Tom",13,7,1,6,0,0,0,0
Melbourne,"Oliver, Clayton",34,6,6,28,1,0,0,4
Melbourne,"Petracca, Christian",18,12,7,6,1,0,0,2
Melbourne,"Smith, Tim",15,9,6,6,1,1,3,2
Melbourne,"Spargo, Charlie",10,7,4,3,0,1,0,2
Melbourne,"Stretch, Billy",13,7,5,6,0,0,0,0
Melbourne,"Viney, Jack",24,13,7,11,0,0,0,6
Melbourne,"Wagner, Josh",15,11,4,4,0,0,0,2
Melbourne,"Weideman, Sam",12,7,6,5,1,2,1,2
Melbourne,"Baker, Oskar",18,12,5,6,0,0,0,3
Melbourne,"Brayshaw, Angus",32,21,5,11,0,0,0,8
Melbourne,"Fritsch, Bayley",26,17,8,9,0,0,0,1
Melbourne,"Frost, Sam",1,0,0,1,0,0,0,1
Melbourne,"Garlett, Jeff",8,5,2,3,1,2,0,5
Melbourne,"Gawn, Max",34,21,5,13,0,1,33,3
Melbourne,"Hannan, Mitch",15,6,2,9,1,1,0,3
Melbourne,"Harmes, James",35,18,3,17,0,2,0,3
Melbourne,"Hibberd, Michael",15,7,5,8,0,0,0,1
Melbourne,"Hore, Marty",21,8,4,13,0,0,0,2
Melbourne,"Hunt, Jayden",9,7,4,2,1,1,0,1
Melbourne,"Jones, Nathan",15,6,2,9,0,0,0,2
Melbourne,"Lever, Jake",16,10,7,6,0,0,0,1
Melbourne,"May, Steven",19,14,4,5,0,1,1,2
Melbourne,"McDonald, Tom",12,10,4,2,0,1,0,1
Melbourne,"Oliver, Clayton",33,7,4,26,0,0,0,4
Melbourne,"Petracca, Christian",23,14,5,9,1,1,0,1
Melbourne,"Salem, Christian",29,15,8,14,0,1,0,3
Melbourne,"Spargo, Charlie",17,8,3,9,1,0,0,2
Melbourne,"Viney, Jack",17,7,2,10,0,0,0,5
Melbourne,"Wagner, Josh",12,5,2,7,0,0,0,1
Melbourne,"Weideman, Sam",11,6,5,5,2,1,0,1
Melbourne,"Baker, Oskar",15,12,6,3,0,0,0,3
Melbourne,"Brayshaw, Angus",24,13,2,11,0,0,0,4
Melbourne,"Fritsch, Bayley",18,14,6,4,0,0,0,0
Melbourne,"Frost, Sam",18,10,8,8,0,0,0,0
Melbourne,"Gawn, Max",20,12,8,8,1,0,46,3
Melbourne,"Hannan, Mitch",7,5,2,2,0,0,0,0
Melbourne,"Harmes, James",18,10,1,8,1,0,0,6
Melbourne,"Hore, Marty",13,10,5,3,0,0,0,1
Melbourne,"Hunt, Jayden",11,5,3,6,0,0,0,2
Melbourne,"Jones, Nathan",22,12,7,10,0,0,0,0
Melbourne,"Lockhart, Jay",21,16,6,5,2,2,0,0
Melbourne,"May, Steven",18,15,5,3,0,0,0,3
Melbourne,"McDonald, Tom",28,16,7,12,3,2,0,3
Melbourne,"Neal-Bullen, Alex",15,5,2,10,0,0,0,5
Melbourne,"Oliver, Clayton",28,16,4,12,1,0,0,6
Melbourne,"Petracca, Christian",22,13,9,9,1,0,0,3
Melbourne,"Petty, Harry",10,5,4,5,0,0,0,2
Melbourne,"Salem, Christian",20,15,5,5,0,0,0,3
Melbourne,"Smith, Tim",10,7,4,3,3,3,0,4
Melbourne,"Viney, Jack",28,12,5,16,0,0,0,2
Melbourne,"Wagner, Josh",15,9,3,6,0,0,0,1
Melbourne,"Weideman, Sam",6,5,4,1,1,0,0,0
Melbourne,"Baker, Oskar",15,6,6,9,0,1,0,3
Melbourne,"Brayshaw, Angus",22,10,7,12,0,0,0,3
Melbourne,"Fritsch, Bayley",17,10,5,7,1,0,0,2
Melbourne,"Frost, Sam",18,13,4,5,0,0,0,2
Melbourne,"Gawn, Max",7,4,3,3,0,0,25,1
Melbourne,"Hannan, Mitch",15,9,7,6,2,0,0,1
Melbourne,"Harmes, James",27,8,5,19,0,2,0,1
Melbourne,"Hibberd, Michael",17,8,3,9,0,0,0,2
Melbourne,"Hore, Marty",14,8,3,6,0,0,0,1
Melbourne,"Hunt, Jayden",16,13,5,3,1,0,0,1
Melbourne,"Jones, Nathan",23,13,5,10,0,0,0,1
Melbourne,"Lockhart, Jay",16,10,6,6,1,0,0,1
Melbourne,"May, Steven",18,16,4,2,1,0,0,1
Melbourne,"McDonald, Tom",15,8,6,7,1,1,3,1
Melbourne,"Neal-Bullen, Alex",17,8,4,9,0,1,0,3
Melbourne,"Oliver, Clayton",36,13,4,23,0,0,0,5
Melbourne,"Petracca, Christian",21,9,4,12,2,1,0,0
Melbourne,"Petty, Harry",12,7,8,5,0,0,0,1
Melbourne,"Salem, Christian",32,25,5,7,0,0,0,2
Melbourne,"Smith, Tim",8,5,3,3,0,1,0,1
Melbourne,"Viney, Jack",28,10,2,18,1,0,0,3
Melbourne,"Weideman, Sam",8,3,2,5,1,1,4,0
Melbourne,"Brayshaw, Angus",15,5,1,10,0,1,0,7
Melbourne,"Dunkley, Kyle",11,7,2,4,0,0,0,5
Melbourne,"Fritsch, Bayley",26,19,12,7,0,0,0,3
Melbourne,"Frost, Sam",18,12,10,6,0,0,0,0
Melbourne,"Hannan, Mitch",12,7,3,5,0,0,0,2
Melbourne,"Harmes, James",27,13,4,14,1,1,0,2
Melbourne,"Hibberd, Michael",16,11,5,5,0,1,0,2
Melbourne,"Hore, Marty",5,4,1,1,0,0,0,0
Melbourne,"Hunt, Jayden",11,5,5,6,3,0,0,3
Melbourne,"Jones, Nathan",24,14,3,10,0,0,0,3
Melbourne,"Lewis, Jordan",19,8,5,11,0,0,0,2
Melbourne,"Lockhart, Jay",13,5,2,8,0,0,0,1
Melbourne,"May, Steven",16,13,4,3,0,0,0,0
Melbourne,"McDonald, Tom",20,15,9,5,6,2,4,0
Melbourne,"Neal-Bullen, Alex",15,11,4,4,1,3,0,5
Melbourne,"Oliver, Clayton",26,13,3,13,0,0,0,11
Melbourne,"Petracca, Christian",17,9,2,8,3,1,0,2
Melbourne,"Petty, Harry",10,6,5,4,0,0,0,1
Melbourne,"Preuss, Braydon",14,13,5,1,0,0,43,3
Melbourne,"Salem, Christian",24,15,7,9,0,1,0,1
Melbourne,"Viney, Jack",22,9,4,13,0,0,0,6
Melbourne,"Weideman, Sam",10,7,7,3,1,1,1,2
Melbourne,"Brayshaw, Angus",12,5,3,7,0,0,0,2
Melbourne,"Dunkley, Kyle",5,4,4,1,1,0,0,1
Melbourne,"Fritsch, Bayley",12,8,4,4,2,2,0,2
Melbourne,"Frost, Sam",13,8,6,5,0,0,0,4
Melbourne,"Gawn, Max",19,14,6,5,0,0,34,3
Melbourne,"Hannan, Mitch",3,2,2,1,0,0,0,1
Melbourne,"Harmes, James",22,14,4,8,0,1,0,6
Melbourne,"Hibberd, Michael",11,8,2,3,0,0,0,1
Melbourne,"Hunt, Jayden",10,9,3,1,1,0,0,5
Melbourne,"Jetta, Neville",9,6,3,3,0,0,0,2
Melbourne,"Jones, Nathan",19,14,5,5,0,0,0,0
Melbourne,"Lever, Jake",8,5,4,3,0,0,0,0
Melbourne,"Lewis, Jordan",18,7,2,11,1,0,0,3
Melbourne,"Lockhart, Jay",10,4,3,6,0,0,0,2
Melbourne,"May, Steven",16,16,4,0,0,1,0,1
Melbourne,"Neal-Bullen, Alex",16,11,3,5,0,0,0,2
Melbourne,"Oliver, Clayton",17,10,0,7,0,1,0,6
Melbourne,"Petracca, Christian",22,16,3,6,1,1,0,3
Melbourne,"Petty, Harry",10,8,5,2,3,1,1,3
Melbourne,"Preuss, Braydon",7,5,1,2,0,1,17,1
Melbourne,"Salem, Christian",25,13,2,12,0,0,0,1
Melbourne,"Viney, Jack",30,15,4,15,0,0,0,7
Melbourne,"Brayshaw, Angus",15,7,3,8,0,0,0,9
Melbourne,"Fritsch, Bayley",22,17,14,5,4,2,0,1
Melbourne,"Frost, Sam",11,6,1,5,0,0,0,1
Melbourne,"Gawn, Max",13,7,4,6,0,1,38,5
Melbourne,"Harmes, James",29,15,7,14,0,0,0,5
Melbourne,"Hibberd, Michael",20,11,4,9,0,0,0,2
Melbourne,"Hunt, Jayden",11,8,7,3,0,0,0,0
Melbourne,"Jetta, Neville",13,8,2,5,0,0,0,3
Melbourne,"Jones, Nathan",23,10,3,13,0,1,0,1
Melbourne,"Lever, Jake",17,12,9,5,0,0,0,1
Melbourne,"Lewis, Jordan",12,9,6,3,2,2,0,0
Melbourne,"Lockhart, Jay",5,1,0,4,0,0,0,3
Melbourne,"May, Steven",14,12,3,2,0,0,0,2
Melbourne,"Neal-Bullen, Alex",16,8,2,8,0,0,0,3
Melbourne,"Oliver, Clayton",34,12,2,22,1,0,0,6
Melbourne,"Petracca, Christian",18,7,4,11,0,1,0,1
Melbourne,"Petty, Harry",7,6,2,1,1,2,0,3
Melbourne,"Preuss, Braydon",7,3,1,4,0,0,18,0
Melbourne,"Salem, Christian",26,22,8,4,0,0,0,7
Melbourne,"Viney, Jack",11,6,1,5,1,1,0,5
Melbourne,"Wagner, Corey",16,10,3,6,2,1,0,3
Melbourne,"Wagner, Josh",21,12,7,9,0,0,0,3
Melbourne,"Baker, Oskar",8,5,1,3,0,1,0,1
Melbourne,"Brayshaw, Angus",17,12,4,5,0,1,0,4
Melbourne,"Fritsch, Bayley",14,4,3,10,2,0,0,2
Melbourne,"Frost, Sam",17,8,5,9,0,0,0,2
Melbourne,"Gawn, Max",18,13,8,5,0,0,40,5
Melbourne,"Harmes, James",21,16,4,5,2,0,0,6
Melbourne,"Hibberd, Michael",12,8,1,4,0,1,0,2
Melbourne,"Hunt, Jayden",14,9,4,5,0,0,0,3
Melbourne,"Jetta, Neville",9,3,3,6,0,0,0,4
Melbourne,"Jones, Nathan",15,11,2,4,0,0,0,1
Melbourne,"Lever, Jake",19,15,9,4,0,0,0,0
Melbourne,"Lewis, Jordan",11,8,2,3,1,0,0,3
Melbourne,"McDonald, Oscar",10,8,4,2,0,0,0,2
Melbourne,"Neal-Bullen, Alex",14,8,4,6,1,0,0,5
Melbourne,"Oliver, Clayton",26,9,4,17,1,0,0,8
Melbourne,"Petracca, Christian",20,8,3,12,3,0,0,2
Melbourne,"Petty, Harry",12,5,6,7,1,0,0,3
Melbourne,"Salem, Christian",24,18,4,6,0,0,0,2
Melbourne,"Smith, Tim",11,5,1,6,1,0,4,2
Melbourne,"Viney, Jack",18,8,2,10,0,0,0,2
Melbourne,"Wagner, Corey",7,3,0,4,1,0,0,2
Melbourne,"Wagner, Josh",15,8,1,7,0,1,0,2
Melbourne,"Baker, Oskar",13,8,4,5,0,0,0,0
Melbourne,"Brayshaw, Angus",11,9,3,2,1,0,0,8
Melbourne,"Dunkley, Kyle",12,10,4,2,2,0,0,3
Melbourne,"Fritsch, Bayley",16,13,10,3,3,2,0,1
Melbourne,"Frost, Sam",20,11,6,9,0,0,0,1
Melbourne,"Gawn, Max",19,12,9,7,0,0,26,1
Melbourne,"Harmes, James",20,6,2,14,0,0,0,6
Melbourne,"Hibberd, Michael",29,15,7,14,0,0,0,0
Melbourne,"Hunt, Jayden",10,7,2,3,0,0,0,2
Melbourne,"Jones, Nathan",22,14,5,8,0,0,0,0
Melbourne,"Kennedy Harris, Jay",20,10,4,10,0,0,0,1
Melbourne,"Lever, Jake",14,11,8,3,0,0,0,1
Melbourne,"Lewis, Jordan",10,7,1,3,2,0,0,0
Melbourne,"McDonald, Oscar",13,8,3,5,0,0,0,1
Melbourne,"Melksham, Jake",15,13,8,2,0,0,0,0
Melbourne,"Oliver, Clayton",32,11,6,21,0,0,0,2
Melbourne,"Petracca, Christian",20,7,2,13,0,0,0,3
Melbourne,"Petty, Harry",10,4,5,6,0,2,0,3
Melbourne,"Preuss, Braydon",6,3,1,3,0,0,17,0
Melbourne,"Salem, Christian",21,18,1,3,0,0,0,1
Melbourne,"Viney, Jack",22,9,2,13,0,0,0,0
Melbourne,"Wagner, Corey",11,7,4,4,1,1,0,5
Melbourne,"Baker, Oskar",8,6,3,2,0,0,0,1
Melbourne,"Brayshaw, Angus",26,15,4,11,1,0,0,5
Melbourne,"Dunkley, Kyle",13,9,10,4,0,0,0,1
Melbourne,"Fritsch, Bayley",15,13,10,2,1,4,0,3
Melbourne,"Frost, Sam",9,7,6,2,0,0,0,2
Melbourne,"Gawn, Max",13,9,1,4,1,0,29,3
Melbourne,"Harmes, James",26,11,1,15,0,0,0,7
Melbourne,"Hibberd, Michael",17,7,4,10,0,0,0,0
Melbourne,"Hunt, Jayden",8,5,3,3,1,0,0,2
Melbourne,"Jones, Nathan",20,11,3,9,0,0,0,1
Melbourne,"Kennedy Harris, Jay",20,12,7,8,0,0,0,0
Melbourne,"Lever, Jake",15,8,6,7,0,0,0,0
Melbourne,"Lewis, Jordan",15,11,4,4,0,0,0,5
Melbourne,"May, Steven",14,12,5,2,0,0,0,0
Melbourne,"McDonald, Oscar",10,7,3,3,1,0,2,2
Melbourne,"Melksham, Jake",12,11,5,1,0,2,0,2
Melbourne,"Oliver, Clayton",29,11,7,18,0,0,0,11
Melbourne,"Petracca, Christian",20,12,6,8,1,2,0,3
Melbourne,"Petty, Harry",7,5,3,2,1,0,0,3
Melbourne,"Salem, Christian",25,16,7,9,0,0,0,1
Melbourne,"Viney, Jack",18,8,2,10,0,0,0,8
Melbourne,"Wagner, Corey",13,9,5,4,0,2,0,7
Melbourne,"Brayshaw, Angus",24,17,4,7,0,1,0,8
Melbourne,"Chandler, Kade",7,4,2,3,0,0,0,9
Melbourne,"Dunkley, Kyle",7,4,2,3,0,0,0,0
Melbourne,"Fritsch, Bayley",9,6,2,3,1,1,0,1
Melbourne,"Frost, Sam",15,10,4,5,0,1,0,1
Melbourne,"Gawn, Max",12,11,3,1,0,0,52,3
Melbourne,"Harmes, James",20,10,6,10,0,0,0,8
Melbourne,"Hibberd, Michael",23,12,7,11,0,0,0,1
Melbourne,"Hore, Marty",12,10,4,2,0,0,0,0
Melbourne,"Jones, Nathan",16,6,3,10,0,0,0,2
Melbourne,"Kennedy Harris, Jay",12,6,3,6,0,0,0,3
Melbourne,"Lever, Jake",14,8,7,6,0,0,0,0
Melbourne,"Lewis, Jordan",21,14,5,7,0,0,0,2
Melbourne,"Melksham, Jake",15,13,3,2,3,5,0,0
Melbourne,"Neal-Bullen, Alex",11,8,5,3,1,2,0,7
Melbourne,"Oliver, Clayton",30,14,2,16,0,1,0,3
Melbourne,"Petracca, Christian",19,9,4,10,0,0,5,5
Melbourne,"Salem, Christian",17,9,3,8,0,0,0,3
Melbourne,"Spargo, Charlie",15,9,2,6,0,0,0,2
Melbourne,"Stretch, Billy",16,8,5,8,0,0,0,5
Melbourne,"Viney, Jack",25,19,5,6,0,0,0,9
Melbourne,"Wagner, Corey",16,6,1,10,0,0,0,5
Melbourne,"Brayshaw, Angus",21,5,3,16,0,0,0,8
Melbourne,"Fritsch, Bayley",12,10,6,2,3,2,0,0
Melbourne,"Frost, Sam",13,7,3,6,0,0,0,2
Melbourne,"Gawn, Max",26,17,8,9,3,1,41,0
Melbourne,"Harmes, James",32,16,3,16,0,0,0,4
Melbourne,"Hibberd, Michael",18,11,2,7,0,0,0,4
Melbourne,"Hore, Marty",10,4,3,6,0,0,0,3
Melbourne,"Hunt, Jayden",12,6,5,6,1,0,0,1
Melbourne,"Jones, Nathan",18,8,6,10,1,0,0,6
Melbourne,"Kennedy Harris, Jay",15,8,3,7,0,0,0,1
Melbourne,"Lever, Jake",14,8,5,6,0,0,0,0
Melbourne,"Lewis, Jordan",24,17,4,7,0,1,0,2
Melbourne,"Melksham, Jake",13,10,2,3,2,2,0,1
Melbourne,"Neal-Bullen, Alex",15,8,3,7,1,1,0,1
Melbourne,"Oliver, Clayton",33,11,2,22,0,1,0,8
Melbourne,"Petracca, Christian",25,8,3,17,0,0,0,7
Melbourne,"Preuss, Braydon",6,5,3,1,0,1,9,1
Melbourne,"Salem, Christian",18,12,4,6,0,0,0,0
Melbourne,"Spargo, Charlie",9,7,2,2,0,0,0,4
Melbourne,"Stretch, Billy",21,10,2,11,0,0,0,3
Melbourne,"Viney, Jack",21,9,3,12,0,0,0,5
Melbourne,"Wagner, Corey",9,4,2,5,1,0,0,1
North Melbourne,"Atley, Shaun",21,14,3,7,0,0,0,2
North Melbourne,"Brown, Ben",11,8,0,3,2,1,1,2
North Melbourne,"Cunnington, Ben",26,9,3,17,0,0,0,2
North Melbourne,"Davies-Uniacke, Luke",15,7,5,8,1,0,0,3
North Melbourne,"Dumont, Trent",22,8,3,14,0,0,0,5
North Melbourne,"Goldstein, Todd",12,5,4,7,1,0,34,4
North Melbourne,"Hall, Aaron",19,12,4,7,0,0,0,5
North Melbourne,"Higgins, Shaun",26,15,2,11,1,0,0,4
North Melbourne,"Macmillan, Jamie",37,21,4,16,0,0,0,3
North Melbourne,"McDonald, Luke",20,11,2,9,0,0,0,2
North Melbourne,"McKay, Ben",9,3,4,6,0,0,0,4
North Melbourne,"Pittard, Jasper",19,8,7,11,0,0,0,2
North Melbourne,"Polec, Jared",27,18,7,9,0,0,0,1
North Melbourne,"Scott, Bailey",21,11,8,10,2,0,0,2
North Melbourne,"Simpkin, Jy",12,8,3,4,0,0,0,4
North Melbourne,"Tarrant, Robbie",16,9,2,7,0,0,0,3
North Melbourne,"Turner, Kayne",14,10,3,4,1,0,0,2
North Melbourne,"Tyson, Dom",22,6,3,16,0,0,0,5
North Melbourne,"Vickers-Willis, Ed",1,0,0,1,0,0,0,0
North Melbourne,"Williams, Marley",20,10,3,10,0,0,0,2
North Melbourne,"Wood, Mason",8,4,3,4,0,0,0,0
North Melbourne,"Ziebell, Jack",12,8,4,4,1,1,0,3
North Melbourne,"Atley, Shaun",11,6,1,5,0,1,0,2
North Melbourne,"Brown, Ben",10,9,5,1,3,2,0,0
North Melbourne,"Campbell, Tom",8,3,2,5,1,1,6,1
North Melbourne,"Cunnington, Ben",36,9,4,27,1,0,0,3
North Melbourne,"Davies-Uniacke, Luke",26,11,5,15,0,1,0,3
North Melbourne,"Goldstein, Todd",10,3,4,7,0,0,33,0
North Melbourne,"Hall, Aaron",26,18,8,8,1,0,0,2
North Melbourne,"Higgins, Shaun",38,13,5,25,0,1,0,0
North Melbourne,"Macmillan, Jamie",20,17,4,3,0,0,0,2
North Melbourne,"McDonald, Luke",20,10,6,10,0,0,0,4
North Melbourne,"McKay, Ben",7,5,4,2,0,1,0,0
North Melbourne,"Pittard, Jasper",15,8,4,7,0,0,0,0
North Melbourne,"Polec, Jared",23,17,4,6,2,0,0,2
North Melbourne,"Scott, Bailey",9,5,2,4,0,0,0,1
North Melbourne,"Simpkin, Jy",13,2,1,11,0,0,0,2
North Melbourne,"Tarrant, Robbie",13,10,2,3,0,0,0,2
North Melbourne,"Thomas, Tarryn",10,6,3,4,1,0,0,3
North Melbourne,"Thompson, Scott",13,8,3,5,0,0,0,2
North Melbourne,"Turner, Kayne",9,4,2,5,1,0,0,2
North Melbourne,"Tyson, Dom",21,13,5,8,1,0,0,4
North Melbourne,"Williams, Marley",7,4,1,3,0,0,0,1
North Melbourne,"Ziebell, Jack",14,11,6,3,2,2,0,2
North Melbourne,"Atley, Shaun",27,16,8,11,0,0,0,5
North Melbourne,"Brown, Ben",7,4,3,3,1,2,0,0
North Melbourne,"Campbell, Tom",7,4,2,3,0,1,10,2
North Melbourne,"Cunnington, Ben",33,6,3,27,0,0,0,3
North Melbourne,"Davies-Uniacke, Luke",9,5,1,4,0,0,0,2
North Melbourne,"Dumont, Trent",23,14,8,9,2,1,0,2
North Melbourne,"Goldstein, Todd",15,2,3,13,0,0,28,0
North Melbourne,"Hall, Aaron",16,10,1,6,1,3,0,6
North Melbourne,"Higgins, Shaun",36,19,5,17,1,0,0,3
North Melbourne,"Macmillan, Jamie",28,14,7,14,0,0,0,2
North Melbourne,"McDonald, Luke",12,5,2,7,0,0,0,5
North Melbourne,"McKay, Ben",5,3,2,2,0,0,0,0
North Melbourne,"Pittard, Jasper",25,16,8,9,0,0,0,4
North Melbourne,"Polec, Jared",19,15,6,4,1,0,0,2
North Melbourne,"Scott, Bailey",12,5,2,7,1,0,0,1
North Melbourne,"Simpkin, Jy",17,7,4,10,0,0,0,3
North Melbourne,"Tarrant, Robbie",21,14,12,7,0,0,0,2
North Melbourne,"Thomas, Tarryn",8,6,4,2,0,1,0,3
North Melbourne,"Thompson, Scott",25,15,6,10,0,0,0,1
North Melbourne,"Turner, Kayne",6,3,4,3,1,1,0,2
North Melbourne,"Tyson, Dom",21,9,6,12,0,0,0,2
North Melbourne,"Ziebell, Jack",24,13,6,11,2,2,0,2
North Melbourne,"Ahern, Paul",15,11,2,4,0,1,0,3
North Melbourne,"Anderson, Jed",19,6,1,13,0,0,0,6
North Melbourne,"Atley, Shaun",22,18,8,4,0,0,0,0
North Melbourne,"Brown, Ben",15,9,4,6,4,2,2,1
North Melbourne,"Cunnington, Ben",21,7,2,14,1,1,0,2
North Melbourne,"Davies-Uniacke, Luke",17,10,4,7,0,0,0,2
North Melbourne,"Dumont, Trent",22,17,12,5,0,0,0,2
North Melbourne,"Goldstein, Todd",22,7,2,15,0,2,24,3
North Melbourne,"Hall, Aaron",21,13,4,8,0,0,0,2
North Melbourne,"Higgins, Shaun",30,15,7,15,1,1,0,3
North Melbourne,"Macmillan, Jamie",15,9,4,6,0,0,0,3
North Melbourne,"McDonald, Luke",12,4,3,8,0,0,0,0
North Melbourne,"Pittard, Jasper",21,18,14,3,0,0,0,1
North Melbourne,"Polec, Jared",26,18,8,8,0,1,0,1
North Melbourne,"Simpkin, Jy",19,10,8,9,0,1,0,1
North Melbourne,"Tarrant, Robbie",20,15,14,5,0,0,0,1
North Melbourne,"Thomas, Tarryn",8,5,2,3,0,1,0,4
North Melbourne,"Thompson, Scott",17,14,9,3,0,0,0,2
North Melbourne,"Turner, Kayne",11,9,3,2,0,1,0,7
North Melbourne,"Wood, Mason",18,10,5,8,0,2,0,2
North Melbourne,"Ziebell, Jack",15,11,3,4,2,2,0,1
North Melbourne,"Zurhaar, Cameron",8,3,1,5,1,0,3,4
North Melbourne,"Ahern, Paul",9,5,5,4,1,0,0,0
North Melbourne,"Anderson, Jed",19,3,2,16,0,0,0,10
North Melbourne,"Atley, Shaun",21,9,4,12,0,0,0,1
North Melbourne,"Brown, Ben",10,7,4,3,2,2,0,2
North Melbourne,"Cunnington, Ben",29,8,3,21,1,1,0,1
North Melbourne,"Davies-Uniacke, Luke",14,9,3,5,0,2,0,2
North Melbourne,"Dumont, Trent",31,20,5,11,0,0,0,2
North Melbourne,"Goldstein, Todd",13,4,1,9,0,2,25,1
North Melbourne,"Hall, Aaron",16,9,3,7,0,1,0,4
North Melbourne,"Higgins, Shaun",30,15,5,15,0,1,0,2
North Melbourne,"Macmillan, Jamie",24,15,8,9,0,0,0,2
North Melbourne,"Pittard, Jasper",22,16,5,6,1,0,0,1
North Melbourne,"Polec, Jared",22,15,4,7,1,1,0,1
North Melbourne,"Scott, Bailey",11,5,3,6,0,1,0,1
North Melbourne,"Simpkin, Jy",11,4,3,7,0,0,0,3
North Melbourne,"Tarrant, Robbie",17,11,8,6,0,0,0,1
North Melbourne,"Thompson, Scott",16,13,5,3,0,0,0,1
North Melbourne,"Turner, Kayne",12,5,2,7,0,0,0,3
North Melbourne,"Wood, Mason",12,9,4,3,0,3,0,0
North Melbourne,"Wright, Sam",19,8,2,11,0,0,0,1
North Melbourne,"Ziebell, Jack",6,4,1,2,0,0,0,3
North Melbourne,"Zurhaar, Cameron",14,9,6,5,1,0,1,1
North Melbourne,"Anderson, Jed",26,9,3,17,0,0,0,5
North Melbourne,"Atley, Shaun",25,13,2,12,0,0,0,5
North Melbourne,"Brown, Ben",9,5,4,4,0,1,5,2
North Melbourne,"Cunnington, Ben",35,9,4,26,0,0,0,5
North Melbourne,"Davies-Uniacke, Luke",16,5,4,11,0,0,0,4
North Melbourne,"Dumont, Trent",21,10,3,11,0,1,0,2
North Melbourne,"Goldstein, Todd",21,8,3,13,0,0,33,0
North Melbourne,"Hall, Aaron",20,10,2,10,2,1,0,4
North Melbourne,"Hrovat, Nathan",14,4,0,10,0,0,0,3
North Melbourne,"Larkey, Nick",10,7,6,3,3,0,2,4
North Melbourne,"Macmillan, Jamie",15,7,7,8,0,0,0,3
North Melbourne,"McDonald, Luke",13,6,4,7,0,0,0,3
North Melbourne,"Pittard, Jasper",23,12,5,11,0,0,0,1
North Melbourne,"Polec, Jared",17,12,4,5,1,0,0,0
North Melbourne,"Tarrant, Robbie",12,6,5,6,0,0,0,1
North Melbourne,"Thomas, Tarryn",19,9,3,10,0,1,0,2
North Melbourne,"Thompson, Scott",19,14,8,5,0,0,0,3
North Melbourne,"Turner, Kayne",14,7,4,7,1,0,0,6
North Melbourne,"Wood, Mason",21,12,7,9,1,0,0,5
North Melbourne,"Wright, Sam",13,6,3,7,0,0,0,0
North Melbourne,"Ziebell, Jack",24,18,1,6,2,0,0,6
North Melbourne,"Zurhaar, Cameron",18,8,3,10,1,1,0,2
North Melbourne,"Anderson, Jed",29,13,4,16,1,0,0,4
North Melbourne,"Atley, Shaun",14,8,5,6,0,0,0,2
North Melbourne,"Brown, Ben",10,7,4,3,4,1,2,4
North Melbourne,"Cunnington, Ben",27,9,3,18,0,0,0,3
North Melbourne,"Dumont, Trent",38,13,4,25,0,0,0,5
North Melbourne,"Garner, Taylor",16,11,7,5,1,2,0,3
North Melbourne,"Goldstein, Todd",16,4,4,12,2,0,34,2
North Melbourne,"Higgins, Shaun",37,12,2,25,0,2,0,0
North Melbourne,"Larkey, Nick",10,4,4,6,0,0,3,0
North Melbourne,"Macmillan, Jamie",24,16,9,8,0,0,0,0
North Melbourne,"Pittard, Jasper",25,16,6,9,0,0,0,2
North Melbourne,"Polec, Jared",22,14,7,8,0,0,0,2
North Melbourne,"Simpkin, Jy",27,7,1,20,2,0,0,2
North Melbourne,"Tarrant, Robbie",10,7,5,3,0,0,0,0
North Melbourne,"Thomas, Tarryn",19,5,2,14,1,0,0,7
North Melbourne,"Thompson, Scott",5,3,2,2,0,0,0,1
North Melbourne,"Turner, Kayne",18,9,3,9,0,0,0,4
North Melbourne,"Williams, Marley",16,11,2,5,0,0,0,2
North Melbourne,"Wood, Mason",24,13,5,11,1,2,0,2
North Melbourne,"Wright, Sam",23,9,6,14,0,1,0,0
North Melbourne,"Ziebell, Jack",22,15,4,7,1,1,0,7
North Melbourne,"Zurhaar, Cameron",16,12,5,4,5,2,0,4
North Melbourne,"Anderson, Jed",17,4,1,13,0,0,0,2
North Melbourne,"Atley, Shaun",24,12,5,12,0,0,0,0
North Melbourne,"Brown, Ben",11,8,8,3,5,0,4,2
North Melbourne,"Cunnington, Ben",29,7,2,22,0,1,0,4
North Melbourne,"Dumont, Trent",27,19,6,8,0,1,0,3
North Melbourne,"Durdin, Sam",7,4,4,3,0,0,0,2
North Melbourne,"Garner, Taylor",10,5,2,5,0,0,0,3
North Melbourne,"Goldstein, Todd",14,4,1,10,0,0,37,2
North Melbourne,"Higgins, Shaun",31,16,3,15,1,1,0,2
North Melbourne,"Larkey, Nick",18,8,5,10,1,2,1,2
North Melbourne,"Macmillan, Jamie",21,12,3,9,0,0,0,3
North Melbourne,"Pittard, Jasper",13,6,6,7,0,0,0,5
North Melbourne,"Polec, Jared",19,12,5,7,1,2,0,4
North Melbourne,"Simpkin, Jy",20,11,2,9,0,0,0,5
North Melbourne,"Tarrant, Robbie",21,14,9,7,0,0,0,2
North Melbourne,"Taylor, Curtis",8,4,3,4,0,0,0,2
North Melbourne,"Thomas, Tarryn",17,3,1,14,1,0,0,5
North Melbourne,"Turner, Kayne",16,6,3,10,0,0,0,1
North Melbourne,"Wood, Mason",14,8,2,6,1,1,0,0
North Melbourne,"Wright, Sam",17,7,4,10,0,0,0,2
North Melbourne,"Ziebell, Jack",17,10,4,7,0,1,0,5
North Melbourne,"Zurhaar, Cameron",11,7,4,4,1,0,0,2
North Melbourne,"Anderson, Jed",29,10,6,19,0,0,0,6
North Melbourne,"Atley, Shaun",18,7,1,11,0,1,0,0
North Melbourne,"Brown, Ben",5,3,1,2,1,0,2,0
North Melbourne,"Cunnington, Ben",23,12,6,11,1,0,0,4
North Melbourne,"Dumont, Trent",31,18,4,13,0,0,0,3
North Melbourne,"Garner, Taylor",7,5,1,2,0,1,0,2
North Melbourne,"Goldstein, Todd",12,2,1,10,0,0,39,2
North Melbourne,"Higgins, Shaun",20,11,1,9,0,1,0,3
North Melbourne,"Larkey, Nick",10,2,2,8,1,0,6,1
North Melbourne,"Macmillan, Jamie",34,20,6,14,0,0,0,2
North Melbourne,"McDonald, Luke",17,7,2,10,0,0,0,2
North Melbourne,"Pittard, Jasper",21,11,3,10,0,0,0,0
North Melbourne,"Polec, Jared",25,15,6,10,1,0,0,1
North Melbourne,"Simpkin, Jy",24,14,3,10,1,2,0,5
North Melbourne,"Tarrant, Robbie",19,11,4,8,1,0,0,5
North Melbourne,"Thomas, Tarryn",12,4,0,8,0,2,0,3
North Melbourne,"Thompson, Scott",21,14,6,7,0,0,0,2
North Melbourne,"Turner, Kayne",13,7,3,6,2,0,0,1
North Melbourne,"Williams, Marley",15,11,6,4,0,0,0,0
North Melbourne,"Wood, Mason",5,3,0,2,1,0,0,1
North Melbourne,"Ziebell, Jack",35,22,10,13,0,1,0,8
North Melbourne,"Zurhaar, Cameron",10,5,2,5,1,0,0,5
North Melbourne,"Anderson, Jed",19,8,2,11,2,0,0,4
North Melbourne,"Atley, Shaun",21,11,2,10,0,0,0,1
North Melbourne,"Brown, Ben",11,10,6,1,3,1,5,0
North Melbourne,"Cunnington, Ben",29,9,4,20,1,0,0,5
North Melbourne,"Davies-Uniacke, Luke",12,4,2,8,1,0,0,1
North Melbourne,"Dumont, Trent",24,14,3,10,0,0,0,1
North Melbourne,"Goldstein, Todd",28,14,7,14,0,0,57,1
North Melbourne,"Higgins, Shaun",34,16,2,18,0,1,0,5
North Melbourne,"Larkey, Nick",7,3,2,4,3,0,3,3
North Melbourne,"Macmillan, Jamie",11,7,2,4,0,0,0,2
North Melbourne,"McDonald, Luke",17,10,5,7,0,0,0,0
North Melbourne,"Pittard, Jasper",18,7,4,11,0,0,0,3
North Melbourne,"Polec, Jared",21,11,2,10,1,1,0,3
North Melbourne,"Simpkin, Jy",14,8,3,6,0,1,0,3
North Melbourne,"Tarrant, Robbie",13,8,6,5,0,0,0,1
North Melbourne,"Thomas, Tarryn",12,5,4,7,2,1,0,1
North Melbourne,"Thompson, Scott",16,11,6,5,0,0,0,3
North Melbourne,"Turner, Kayne",11,4,5,7,0,0,0,6
North Melbourne,"Williams, Marley",14,7,4,7,0,0,0,3
North Melbourne,"Wood, Mason",22,15,7,7,3,0,0,0
North Melbourne,"Ziebell, Jack",16,9,3,7,0,0,0,1
North Melbourne,"Zurhaar, Cameron",13,7,7,6,2,0,0,2
North Melbourne,"Anderson, Jed",20,8,1,12,2,0,0,5
North Melbourne,"Atley, Shaun",23,9,4,14,0,0,0,3
North Melbourne,"Brown, Ben",14,13,6,1,5,0,6,0
North Melbourne,"Cunnington, Ben",31,7,0,24,0,1,0,4
North Melbourne,"Davies-Uniacke, Luke",21,10,2,11,0,1,0,2
North Melbourne,"Dumont, Trent",21,12,4,9,0,0,0,8
North Melbourne,"Goldstein, Todd",11,2,1,9,0,0,28,1
North Melbourne,"Higgins, Shaun",30,12,1,18,0,2,0,4
North Melbourne,"Larkey, Nick",6,5,3,1,1,1,6,3
North Melbourne,"Macmillan, Jamie",8,5,2,3,0,0,0,1
North Melbourne,"McDonald, Luke",12,10,5,2,0,0,0,3
North Melbourne,"Pittard, Jasper",11,8,7,3,0,0,0,4
North Melbourne,"Polec, Jared",26,13,1,13,1,1,0,3
North Melbourne,"Simpkin, Jy",20,9,3,11,1,0,0,1
North Melbourne,"Tarrant, Robbie",13,7,7,6,0,0,0,2
North Melbourne,"Thomas, Tarryn",7,4,4,3,1,0,0,1
North Melbourne,"Thompson, Scott",10,8,4,2,0,0,0,1
North Melbourne,"Turner, Kayne",8,4,2,4,0,0,0,2
North Melbourne,"Williams, Marley",15,12,4,3,0,0,0,1
North Melbourne,"Wood, Mason",12,11,5,1,4,2,0,5
North Melbourne,"Ziebell, Jack",26,19,2,7,0,0,0,7
North Melbourne,"Zurhaar, Cameron",11,9,4,2,0,0,0,11
North Melbourne,"Anderson, Jed",22,13,3,9,0,0,0,3
North Melbourne,"Atley, Shaun",17,8,3,9,0,0,0,2
North Melbourne,"Brown, Ben",12,7,4,5,2,3,5,0
North Melbourne,"Cunnington, Ben",31,14,1,17,0,0,0,4
North Melbourne,"Davies-Uniacke, Luke",14,9,3,5,0,0,0,0
North Melbourne,"Dumont, Trent",24,17,1,7,0,0,0,6
North Melbourne,"Durdin, Sam",6,4,2,2,0,0,0,1
North Melbourne,"Goldstein, Todd",20,8,2,12,0,1,27,1
North Melbourne,"Higgins, Shaun",3,0,1,3,0,0,0,0
North Melbourne,"Larkey, Nick",6,4,2,2,1,1,1,1
North Melbourne,"McDonald, Luke",14,8,6,6,1,0,0,1
North Melbourne,"Pittard, Jasper",15,10,3,5,0,0,0,1
North Melbourne,"Polec, Jared",28,22,6,6,1,1,0,2
North Melbourne,"Simpkin, Jy",18,11,4,7,0,3,0,6
North Melbourne,"Tarrant, Robbie",16,9,3,7,0,0,0,0
North Melbourne,"Thomas, Tarryn",12,9,3,3,2,1,0,3
North Melbourne,"Thompson, Scott",13,11,2,2,0,0,0,1
North Melbourne,"Turner, Kayne",15,9,3,6,2,1,0,8
North Melbourne,"Williams, Marley",17,8,0,9,0,0,0,1
North Melbourne,"Wood, Mason",17,13,6,4,2,1,0,3
North Melbourne,"Ziebell, Jack",28,22,4,6,2,0,0,10
North Melbourne,"Zurhaar, Cameron",14,8,5,6,1,0,0,2
North Melbourne,"Anderson, Jed",16,11,2,5,0,1,0,12
North Melbourne,"Atley, Shaun",22,12,1,10,0,0,0,1
North Melbourne,"Brown, Ben",10,8,6,2,2,3,2,0
North Melbourne,"Cunnington, Ben",16,6,2,10,0,0,0,3
North Melbourne,"Davies-Uniacke, Luke",13,10,1,3,0,0,0,4
North Melbourne,"Dumont, Trent",17,7,1,10,1,0,0,2
North Melbourne,"Durdin, Sam",8,6,3,2,0,0,0,3
North Melbourne,"Garner, Taylor",16,7,5,9,1,0,0,3
North Melbourne,"Goldstein, Todd",13,7,4,6,0,0,42,1
North Melbourne,"Larkey, Nick",9,6,5,3,1,0,4,1
North Melbourne,"McDonald, Luke",20,12,4,8,0,0,0,3
North Melbourne,"Pittard, Jasper",15,12,7,3,0,0,0,2
North Melbourne,"Polec, Jared",18,9,0,9,0,0,0,3
North Melbourne,"Simpkin, Jy",9,6,2,3,0,0,0,3
North Melbourne,"Tarrant, Robbie",11,7,3,4,0,0,0,3
North Melbourne,"Thomas, Tarryn",12,9,3,3,2,1,0,5
North Melbourne,"Thompson, Scott",12,7,2,5,0,0,0,2
North Melbourne,"Turner, Kayne",18,9,2,9,2,0,0,1
North Melbourne,"Williams, Marley",24,11,1,13,0,0,0,3
North Melbourne,"Wood, Mason",5,2,0,3,0,1,0,5
North Melbourne,"Ziebell, Jack",16,9,1,7,1,0,0,11
North Melbourne,"Zurhaar, Cameron",10,4,1,6,0,0,0,3
North Melbourne,"Anderson, Jed",26,12,5,14,0,0,0,7
North Melbourne,"Atley, Shaun",27,7,4,20,0,0,0,0
North Melbourne,"Brown, Ben",14,12,9,2,0,4,2,1
North Melbourne,"Cunnington, Ben",37,13,2,24,0,0,0,4
North Melbourne,"Davies-Uniacke, Luke",15,4,0,11,2,0,0,1
North Melbourne,"Dumont, Trent",26,12,3,14,0,0,0,3
North Melbourne,"Durdin, Sam",18,11,4,7,0,0,0,2
North Melbourne,"Goldstein, Todd",16,3,1,13,0,0,30,0
North Melbourne,"Hayden, Kyron",4,1,0,3,0,0,0,5
North Melbourne,"Larkey, Nick",8,3,1,5,1,0,1,1
North Melbourne,"McDonald, Luke",10,7,6,3,0,0,0,2
North Melbourne,"Pittard, Jasper",25,15,9,10,0,0,0,1
North Melbourne,"Polec, Jared",27,16,4,11,1,1,0,3
North Melbourne,"Simpkin, Jy",30,16,0,14,0,0,0,4
North Melbourne,"Tarrant, Robbie",21,13,9,8,0,0,0,2
North Melbourne,"Thomas, Tarryn",16,3,3,13,1,1,0,6
North Melbourne,"Thompson, Scott",13,6,3,7,0,0,0,1
North Melbourne,"Turner, Kayne",16,4,1,12,2,0,0,3
North Melbourne,"Williams, Marley",19,9,1,10,0,0,0,5
North Melbourne,"Wood, Mason",16,6,5,10,1,3,0,2
North Melbourne,"Ziebell, Jack",25,18,5,7,3,1,0,5
North Melbourne,"Zurhaar, Cameron",11,5,3,6,0,1,0,1
North Melbourne,"Ahern, Paul",18,9,1,9,1,1,0,3
North Melbourne,"Anderson, Jed",22,4,3,18,0,0,0,7
North Melbourne,"Atley, Shaun",16,10,7,6,0,0,0,4
North Melbourne,"Brown, Ben",8,8,3,0,3,1,3,0
North Melbourne,"Cunnington, Ben",24,10,4,14,0,1,0,3
North Melbourne,"Davies-Uniacke, Luke",12,5,1,7,0,0,0,2
North Melbourne,"Dumont, Trent",24,15,4,9,0,0,0,2
North Melbourne,"Durdin, Sam",3,1,0,2,0,0,0,2
North Melbourne,"Goldstein, Todd",16,10,5,6,0,0,39,6
North Melbourne,"Larkey, Nick",11,7,5,4,5,0,5,0
North Melbourne,"McDonald, Luke",14,5,4,9,0,0,0,4
North Melbourne,"Pittard, Jasper",20,14,11,6,0,0,0,2
North Melbourne,"Polec, Jared",19,14,5,5,0,1,0,6
North Melbourne,"Simpkin, Jy",36,16,1,20,1,0,0,3
North Melbourne,"Tarrant, Robbie",15,14,10,1,0,0,0,1
North Melbourne,"Thomas, Tarryn",14,9,3,5,0,2,0,3
North Melbourne,"Thompson, Scott",19,16,8,3,0,0,0,2
North Melbourne,"Turner, Kayne",9,6,1,3,0,0,0,1
North Melbourne,"Williams, Marley",14,10,2,4,0,0,0,4
North Melbourne,"Wood, Mason",6,4,1,2,0,0,0,2
North Melbourne,"Ziebell, Jack",24,13,3,11,2,0,0,8
North Melbourne,"Zurhaar, Cameron",16,12,8,4,5,3,0,2
North Melbourne,"Ahern, Paul",12,7,0,5,0,0,0,1
North Melbourne,"Anderson, Jed",17,8,0,9,1,0,0,5
North Melbourne,"Atley, Shaun",15,10,2,5,0,0,0,0
North Melbourne,"Brown, Ben",18,15,12,3,6,2,4,1
North Melbourne,"Cunnington, Ben",15,3,0,12,0,0,0,5
North Melbourne,"Dumont, Trent",16,10,2,6,0,0,0,3
North Melbourne,"Goldstein, Todd",19,9,1,10,0,0,32,2
North Melbourne,"Hrovat, Nathan",14,6,2,8,0,0,0,2
North Melbourne,"Larkey, Nick",4,4,3,0,0,0,2,2
North Melbourne,"Macmillan, Jamie",16,8,3,8,0,0,0,1
North Melbourne,"McDonald, Luke",13,6,2,7,0,0,0,4
North Melbourne,"Pittard, Jasper",7,4,3,3,0,0,0,0
North Melbourne,"Polec, Jared",19,13,6,6,0,0,0,4
North Melbourne,"Simpkin, Jy",18,10,0,8,0,0,0,2
North Melbourne,"Tarrant, Robbie",22,15,11,7,0,0,0,4
North Melbourne,"Taylor, Curtis",4,2,0,2,0,1,0,2
North Melbourne,"Thomas, Tarryn",13,9,3,4,2,2,0,3
North Melbourne,"Thompson, Scott",13,9,3,4,0,0,0,2
North Melbourne,"Turner, Kayne",6,2,0,4,0,0,0,3
North Melbourne,"Williams, Marley",15,11,3,4,0,0,0,0
North Melbourne,"Ziebell, Jack",20,11,0,9,0,1,0,3
North Melbourne,"Zurhaar, Cameron",15,10,5,5,3,1,0,3
North Melbourne,"Anderson, Jed",19,11,3,8,0,0,0,3
North Melbourne,"Atley, Shaun",18,11,2,7,0,0,0,4
North Melbourne,"Brown, Ben",11,10,6,1,3,1,5,2
North Melbourne,"Cunnington, Ben",21,10,2,11,1,0,0,8
North Melbourne,"Dumont, Trent",19,10,4,9,0,0,0,2
North Melbourne,"Durdin, Sam",9,8,4,1,0,0,0,4
North Melbourne,"Goldstein, Todd",16,6,3,10,0,0,40,0
North Melbourne,"Higgins, Shaun",27,18,9,9,1,0,0,4
North Melbourne,"Hrovat, Nathan",11,6,4,5,0,0,0,1
North Melbourne,"Larkey, Nick",10,5,2,5,2,0,5,1
North Melbourne,"Macmillan, Jamie",12,7,2,5,0,0,0,5
North Melbourne,"Pittard, Jasper",12,10,4,2,0,0,0,1
North Melbourne,"Polec, Jared",20,13,5,7,1,0,0,2
North Melbourne,"Simpkin, Jy",19,12,3,7,0,0,0,5
North Melbourne,"Tarrant, Robbie",14,11,7,3,0,0,0,0
North Melbourne,"Thomas, Tarryn",8,6,1,2,2,0,0,4
North Melbourne,"Thompson, Scott",13,7,3,6,0,0,0,5
North Melbourne,"Turner, Kayne",11,7,2,4,0,0,0,4
North Melbourne,"Williams, Marley",12,8,3,4,0,0,0,2
North Melbourne,"Wood, Mason",14,8,4,6,2,0,0,1
North Melbourne,"Ziebell, Jack",20,12,6,8,0,0,0,2
North Melbourne,"Zurhaar, Cameron",11,5,4,6,0,1,0,6
North Melbourne,"Ahern, Paul",27,17,5,10,0,1,0,0
North Melbourne,"Anderson, Jed",20,11,2,9,0,2,0,3
North Melbourne,"Atley, Shaun",15,8,2,7,0,0,0,1
North Melbourne,"Brown, Ben",8,6,3,2,2,1,5,1
North Melbourne,"Cunnington, Ben",21,6,2,15,0,0,0,4
North Melbourne,"Davies-Uniacke, Luke",16,8,5,8,0,1,0,1
North Melbourne,"Dumont, Trent",26,18,12,8,0,0,0,1
North Melbourne,"Durdin, Sam",3,2,2,1,0,0,0,1
North Melbourne,"Garner, Taylor",15,7,5,8,0,1,0,2
North Melbourne,"Goldstein, Todd",17,7,2,10,0,2,33,2
North Melbourne,"Higgins, Shaun",19,9,3,10,0,0,0,3
North Melbourne,"Larkey, Nick",12,7,4,5,1,0,4,1
North Melbourne,"Macmillan, Jamie",14,10,5,4,0,0,0,1
North Melbourne,"Pittard, Jasper",14,4,2,10,0,0,0,1
North Melbourne,"Polec, Jared",31,22,5,9,1,0,0,1
North Melbourne,"Simpkin, Jy",12,7,1,5,0,1,0,4
North Melbourne,"Tarrant, Robbie",8,6,2,2,0,0,0,1
North Melbourne,"Thomas, Tarryn",11,5,0,6,1,1,0,3
North Melbourne,"Williams, Marley",17,9,3,8,0,0,0,1
North Melbourne,"Wood, Mason",11,6,6,5,2,0,0,2
North Melbourne,"Ziebell, Jack",12,6,2,6,0,0,0,6
North Melbourne,"Zurhaar, Cameron",14,9,8,5,3,1,0,2
North Melbourne,"Ahern, Paul",26,18,3,8,0,0,0,1
North Melbourne,"Brown, Ben",14,12,6,2,4,3,5,4
North Melbourne,"Cunnington, Ben",21,7,1,14,0,0,0,2
North Melbourne,"Davies-Uniacke, Luke",8,5,3,3,0,0,0,3
North Melbourne,"Dumont, Trent",19,8,4,11,0,1,0,8
North Melbourne,"Durdin, Sam",9,7,3,2,0,0,0,0
North Melbourne,"Garner, Taylor",13,8,3,5,0,1,0,4
North Melbourne,"Goldstein, Todd",22,14,5,8,0,0,28,2
North Melbourne,"Higgins, Shaun",28,15,5,13,2,0,0,2
North Melbourne,"Larkey, Nick",8,4,4,4,0,2,3,2
North Melbourne,"Macmillan, Jamie",18,11,6,7,0,0,0,4
North Melbourne,"Pittard, Jasper",19,12,8,7,0,0,0,2
North Melbourne,"Polec, Jared",23,16,2,7,0,0,0,2
North Melbourne,"Simpkin, Jy",15,8,0,7,0,0,0,6
North Melbourne,"Tarrant, Robbie",15,7,2,8,0,0,0,3
North Melbourne,"Thomas, Tarryn",12,5,2,7,0,0,0,1
North Melbourne,"Thompson, Scott",10,6,2,4,0,0,0,1
North Melbourne,"Turner, Kayne",9,3,0,6,0,1,0,3
North Melbourne,"Williams, Marley",18,8,0,10,0,0,0,2
North Melbourne,"Wood, Mason",12,8,2,4,2,3,0,1
North Melbourne,"Ziebell, Jack",18,13,3,5,3,1,0,5
North Melbourne,"Zurhaar, Cameron",12,5,1,7,1,0,0,9
North Melbourne,"Ahern, Paul",17,13,4,4,0,0,0,0
North Melbourne,"Anderson, Jed",14,10,3,4,0,0,0,9
North Melbourne,"Atley, Shaun",15,7,0,8,0,0,0,2
North Melbourne,"Brown, Ben",5,4,2,1,0,0,0,1
North Melbourne,"Cunnington, Ben",30,13,1,17,0,0,0,4
North Melbourne,"Dumont, Trent",16,6,3,10,0,0,0,4
North Melbourne,"Garner, Taylor",13,6,2,7,0,0,0,6
North Melbourne,"Goldstein, Todd",10,5,1,5,1,0,42,5
North Melbourne,"Higgins, Shaun",22,10,3,12,0,1,0,7
North Melbourne,"Larkey, Nick",7,4,5,3,0,1,3,2
North Melbourne,"Macmillan, Jamie",24,15,6,9,0,0,0,4
North Melbourne,"Pittard, Jasper",12,7,3,5,0,0,0,1
North Melbourne,"Polec, Jared",16,11,5,5,0,0,0,3
North Melbourne,"Simpkin, Jy",12,10,1,2,0,0,0,4
North Melbourne,"Tarrant, Robbie",21,17,7,4,0,0,0,1
North Melbourne,"Thomas, Tarryn",12,4,1,8,0,0,0,4
North Melbourne,"Thompson, Scott",16,13,9,3,0,0,0,2
North Melbourne,"Turner, Kayne",12,6,1,6,0,0,0,4
North Melbourne,"Williams, Marley",15,10,2,5,0,0,0,1
North Melbourne,"Wood, Mason",8,4,2,4,0,2,0,2
North Melbourne,"Ziebell, Jack",24,12,7,12,0,1,0,2
North Melbourne,"Zurhaar, Cameron",8,5,2,3,0,1,0,1
North Melbourne,"Anderson, Jed",16,5,3,11,0,0,0,2
North Melbourne,"Atley, Shaun",29,13,4,16,0,1,0,3
North Melbourne,"Brown, Ben",14,11,6,3,10,1,0,1
North Melbourne,"Cunnington, Ben",37,9,2,28,0,0,0,3
North Melbourne,"Dumont, Trent",25,10,4,15,0,1,0,7
North Melbourne,"Durdin, Sam",12,4,2,8,0,0,0,1
North Melbourne,"Garner, Taylor",16,8,2,8,1,1,0,0
North Melbourne,"Goldstein, Todd",34,12,3,22,1,0,28,1
North Melbourne,"Higgins, Shaun",38,15,7,23,1,0,0,4
North Melbourne,"Hrovat, Nathan",21,8,5,13,0,1,0,0
North Melbourne,"Larkey, Nick",11,8,7,3,5,0,2,1
North Melbourne,"Macmillan, Jamie",34,16,7,18,0,0,0,0
North Melbourne,"Pittard, Jasper",29,13,6,16,0,0,0,1
North Melbourne,"Polec, Jared",32,20,6,12,1,1,0,2
North Melbourne,"Simpkin, Jy",33,15,6,18,1,0,0,5
North Melbourne,"Tarrant, Robbie",10,5,4,5,0,0,0,1
North Melbourne,"Thomas, Tarryn",11,5,2,6,0,1,0,4
North Melbourne,"Thompson, Scott",24,14,4,10,0,0,0,0
North Melbourne,"Turner, Kayne",17,9,5,8,0,0,0,3
North Melbourne,"Williams, Marley",23,8,2,15,0,0,0,0
North Melbourne,"Ziebell, Jack",33,19,5,14,1,2,0,2
North Melbourne,"Zurhaar, Cameron",15,9,6,6,1,1,0,1
North Melbourne,"Atley, Shaun",22,13,3,9,0,0,0,0
North Melbourne,"Brown, Ben",17,11,6,6,2,3,0,1
North Melbourne,"Cunnington, Ben",14,6,2,8,0,0,0,2
North Melbourne,"Dumont, Trent",23,13,1,10,0,0,0,6
North Melbourne,"Durdin, Sam",13,8,6,5,0,0,0,1
North Melbourne,"Garner, Taylor",13,8,5,5,2,0,0,2
North Melbourne,"Goldstein, Todd",12,3,4,9,0,0,24,2
North Melbourne,"Higgins, Shaun",34,11,3,23,2,0,0,3
North Melbourne,"Hrovat, Nathan",17,5,2,12,0,1,0,2
North Melbourne,"Larkey, Nick",10,5,3,5,1,1,2,2
North Melbourne,"Macmillan, Jamie",13,7,3,6,0,0,0,1
North Melbourne,"Pittard, Jasper",22,11,6,11,0,0,0,2
North Melbourne,"Polec, Jared",29,22,3,7,2,2,0,5
North Melbourne,"Simpkin, Jy",11,9,0,2,0,0,0,4
North Melbourne,"Tarrant, Robbie",19,15,5,4,0,0,0,1
North Melbourne,"Thomas, Tarryn",7,3,3,4,0,0,0,3
North Melbourne,"Thompson, Scott",14,6,4,8,0,0,0,3
North Melbourne,"Turner, Kayne",17,11,7,6,0,1,0,7
North Melbourne,"Williams, Marley",19,7,1,12,1,0,0,2
North Melbourne,"Wood, Mason",17,8,5,9,1,1,0,2
North Melbourne,"Ziebell, Jack",19,7,4,12,2,0,0,6
North Melbourne,"Zurhaar, Cameron",9,6,3,3,0,0,0,1
Port Adelaide,"Amon, Karl",21,7,3,14,0,0,0,2
Port Adelaide,"Boak, Travis",34,17,9,17,1,2,0,8
Port Adelaide,"Bonner, Riley",18,11,4,7,0,0,0,3
Port Adelaide,"Burton, Ryan",26,19,3,7,0,2,0,5
Port Adelaide,"Butters, Zak",13,7,2,6,2,0,0,3
Port Adelaide,"Byrne-Jones, Darcy",19,11,5,8,0,0,0,2
Port Adelaide,"Clurey, Tom",15,11,3,4,0,0,0,1
Port Adelaide,"Drew, Willem",21,10,5,11,0,0,0,5
Port Adelaide,"Duursma, Xavier",16,9,5,7,1,1,0,2
Port Adelaide,"Ebert, Brad",23,12,9,11,1,0,0,6
Port Adelaide,"Gray, Robbie",23,10,4,13,1,3,0,2
Port Adelaide,"Houston, Dan",16,10,3,6,0,0,0,4
Port Adelaide,"Jonas, Tom",12,6,2,6,0,0,0,2
Port Adelaide,"Lycett, Scott",10,3,0,7,0,0,16,1
Port Adelaide,"Marshall, Todd",10,8,4,2,1,1,0,0
Port Adelaide,"Motlop, Steven",19,10,3,9,0,0,0,1
Port Adelaide,"Powell-Pepper, Sam",20,12,3,8,0,3,0,2
Port Adelaide,"Rockliff, Tom",44,24,10,20,0,0,0,8
Port Adelaide,"Rozee, Connor",18,6,5,12,0,0,0,5
Port Adelaide,"Ryder, Paddy",8,4,2,4,0,1,16,1
Port Adelaide,"Watts, Jack",22,12,9,10,0,0,0,3
Port Adelaide,"Westhoff, Justin",18,12,9,6,5,0,0,5
Port Adelaide,"Amon, Karl",1,1,1,0,0,0,0,1
Port Adelaide,"Boak, Travis",33,17,6,16,0,0,0,9
Port Adelaide,"Bonner, Riley",21,15,0,6,0,0,0,1
Port Adelaide,"Burton, Ryan",21,15,5,6,0,0,0,2
Port Adelaide,"Butters, Zak",22,10,4,12,1,1,0,1
Port Adelaide,"Byrne-Jones, Darcy",27,17,6,10,0,1,0,4
Port Adelaide,"Clurey, Tom",13,7,6,6,0,0,0,2
Port Adelaide,"Drew, Willem",24,14,3,10,0,0,0,5
Port Adelaide,"Duursma, Xavier",23,14,9,9,0,1,0,2
Port Adelaide,"Ebert, Brad",23,16,7,7,3,1,0,6
Port Adelaide,"Gray, Robbie",27,10,2,17,1,0,0,5
Port Adelaide,"Houston, Dan",21,15,3,6,0,1,0,3
Port Adelaide,"Jonas, Tom",17,9,7,8,0,0,0,2
Port Adelaide,"Lycett, Scott",23,10,5,13,1,0,33,2
Port Adelaide,"Marshall, Todd",7,5,2,2,0,0,0,3
Port Adelaide,"Motlop, Steven",22,11,3,11,3,0,0,5
Port Adelaide,"Powell-Pepper, Sam",21,7,3,14,2,1,0,7
Port Adelaide,"Rockliff, Tom",37,23,5,14,0,0,0,2
Port Adelaide,"Rozee, Connor",16,6,4,10,2,1,0,3
Port Adelaide,"Ryder, Paddy",8,6,3,2,0,0,24,2
Port Adelaide,"Watts, Jack",19,12,5,7,0,0,0,2
Port Adelaide,"Westhoff, Justin",14,12,4,2,0,1,0,3
Port Adelaide,"Boak, Travis",35,14,5,21,2,0,0,4
Port Adelaide,"Bonner, Riley",16,15,2,1,0,0,0,2
Port Adelaide,"Burton, Ryan",21,15,5,6,0,0,0,1
Port Adelaide,"Butters, Zak",20,9,2,11,0,0,0,3
Port Adelaide,"Byrne-Jones, Darcy",18,15,6,3,0,0,0,7
Port Adelaide,"Clurey, Tom",9,9,5,0,0,0,0,1
Port Adelaide,"Drew, Willem",9,6,1,3,0,0,0,6
Port Adelaide,"Duursma, Xavier",16,5,3,11,0,0,0,3
Port Adelaide,"Ebert, Brad",14,8,3,6,0,2,0,4
Port Adelaide,"Gray, Robbie",21,8,2,13,2,3,0,1
Port Adelaide,"Gray, Sam",10,4,2,6,0,0,0,3
Port Adelaide,"Houston, Dan",16,11,5,5,0,1,0,3
Port Adelaide,"Howard, Dougal",8,5,2,3,0,0,0,1
Port Adelaide,"Jonas, Tom",15,10,4,5,0,0,0,1
Port Adelaide,"Lycett, Scott",15,6,1,9,0,0,19,2
Port Adelaide,"Motlop, Steven",14,7,2,7,0,0,0,4
Port Adelaide,"Powell-Pepper, Sam",29,18,3,11,0,0,0,4
Port Adelaide,"Rockliff, Tom",15,8,0,7,0,0,0,1
Port Adelaide,"Rozee, Connor",21,17,7,4,5,2,0,2
Port Adelaide,"Ryder, Paddy",10,6,3,4,3,0,24,2
Port Adelaide,"Westhoff, Justin",15,9,3,6,0,1,0,1
Port Adelaide,"Wines, Ollie",19,10,1,9,1,0,0,3
Port Adelaide,"Boak, Travis",33,18,3,15,0,1,0,4
Port Adelaide,"Bonner, Riley",18,13,7,5,0,0,0,0
Port Adelaide,"Burton, Ryan",23,19,9,4,1,0,0,2
Port Adelaide,"Butters, Zak",11,9,6,2,0,0,0,1
Port Adelaide,"Byrne-Jones, Darcy",19,16,8,3,0,0,0,1
Port Adelaide,"Clurey, Tom",15,12,9,3,0,0,0,3
Port Adelaide,"Drew, Willem",16,7,5,9,1,0,0,0
Port Adelaide,"Duursma, Xavier",17,9,4,8,0,1,0,2
Port Adelaide,"Ebert, Brad",23,14,9,9,2,1,0,5
Port Adelaide,"Gray, Robbie",16,8,4,8,2,0,0,1
Port Adelaide,"Gray, Sam",15,7,2,8,3,0,0,1
Port Adelaide,"Houston, Dan",23,15,8,8,1,0,0,1
Port Adelaide,"Howard, Dougal",14,9,5,5,0,0,0,0
Port Adelaide,"Jonas, Tom",19,15,9,4,0,0,0,1
Port Adelaide,"Lycett, Scott",19,7,3,12,0,1,22,0
Port Adelaide,"Motlop, Steven",7,4,2,3,0,0,0,2
Port Adelaide,"Powell-Pepper, Sam",13,6,0,7,1,0,0,3
Port Adelaide,"Rockliff, Tom",37,19,6,18,0,0,0,5
Port Adelaide,"Rozee, Connor",12,3,1,9,0,0,0,4
Port Adelaide,"Ryder, Paddy",12,9,2,3,1,1,19,1
Port Adelaide,"Westhoff, Justin",14,5,4,9,0,1,0,1
Port Adelaide,"Wines, Ollie",20,10,6,10,2,0,0,1
Port Adelaide,"Boak, Travis",23,12,3,11,0,1,0,4
Port Adelaide,"Bonner, Riley",20,15,4,5,0,0,0,1
Port Adelaide,"Burton, Ryan",22,15,2,7,0,1,0,2
Port Adelaide,"Butters, Zak",19,10,4,9,0,0,0,0
Port Adelaide,"Byrne-Jones, Darcy",18,11,5,7,0,0,0,1
Port Adelaide,"Clurey, Tom",11,8,2,3,0,0,0,4
Port Adelaide,"Drew, Willem",20,9,1,11,1,0,0,5
Port Adelaide,"Duursma, Xavier",12,5,3,7,2,0,0,0
Port Adelaide,"Ebert, Brad",16,10,5,6,2,1,0,7
Port Adelaide,"Gray, Robbie",14,6,3,8,0,1,0,2
Port Adelaide,"Gray, Sam",26,10,8,16,2,1,0,5
Port Adelaide,"Houston, Dan",17,13,2,4,1,0,0,2
Port Adelaide,"Howard, Dougal",20,13,5,7,0,0,0,2
Port Adelaide,"Jonas, Tom",13,9,4,4,0,0,0,1
Port Adelaide,"Lycett, Scott",12,7,6,5,0,1,27,0
Port Adelaide,"Marshall, Todd",10,8,3,2,1,2,0,1
Port Adelaide,"Powell-Pepper, Sam",19,16,1,3,1,2,0,3
Port Adelaide,"Rockliff, Tom",32,14,2,18,0,1,0,3
Port Adelaide,"Rozee, Connor",13,8,4,5,1,1,0,3
Port Adelaide,"Ryder, Paddy",13,8,5,5,1,2,19,1
Port Adelaide,"Westhoff, Justin",17,9,6,8,0,0,0,4
Port Adelaide,"Wines, Ollie",35,21,4,14,1,0,0,3
Port Adelaide,"Boak, Travis",38,19,4,19,1,1,0,4
Port Adelaide,"Bonner, Riley",17,9,1,8,0,0,0,2
Port Adelaide,"Burton, Ryan",21,11,3,10,0,0,0,2
Port Adelaide,"Butters, Zak",13,11,3,2,0,0,0,4
Port Adelaide,"Byrne-Jones, Darcy",12,8,3,4,0,0,0,4
Port Adelaide,"Clurey, Tom",15,10,5,5,0,0,0,1
Port Adelaide,"Drew, Willem",14,4,2,10,0,0,0,6
Port Adelaide,"Duursma, Xavier",24,10,8,14,1,1,0,0
Port Adelaide,"Ebert, Brad",21,12,3,9,2,3,0,6
Port Adelaide,"Gray, Robbie",18,7,6,11,0,0,0,0
Port Adelaide,"Gray, Sam",28,13,3,15,4,2,0,5
Port Adelaide,"Houston, Dan",21,12,3,9,0,0,0,1
Port Adelaide,"Howard, Dougal",12,7,6,5,0,0,0,3
Port Adelaide,"Lienert, Jarrod",16,12,5,4,0,1,0,2
Port Adelaide,"Lycett, Scott",10,5,2,5,1,0,25,6
Port Adelaide,"Marshall, Todd",10,7,2,3,0,0,0,0
Port Adelaide,"Powell-Pepper, Sam",21,8,2,13,0,2,0,5
Port Adelaide,"Rockliff, Tom",27,13,2,14,0,0,0,9
Port Adelaide,"Rozee, Connor",22,12,4,10,1,2,0,4
Port Adelaide,"Ryder, Paddy",7,5,0,2,1,1,17,4
Port Adelaide,"Westhoff, Justin",17,13,9,4,1,2,0,3
Port Adelaide,"Wines, Ollie",26,6,4,20,0,0,0,7
Port Adelaide,"Amon, Karl",15,10,2,5,0,0,0,4
Port Adelaide,"Boak, Travis",32,14,1,18,1,0,0,6
Port Adelaide,"Bonner, Riley",14,13,3,1,0,0,0,1
Port Adelaide,"Burton, Ryan",19,8,5,11,1,0,0,1
Port Adelaide,"Butters, Zak",9,6,3,3,0,0,0,0
Port Adelaide,"Byrne-Jones, Darcy",20,14,6,6,0,0,0,6
Port Adelaide,"Clurey, Tom",13,10,2,3,0,0,0,2
Port Adelaide,"Drew, Willem",12,4,1,8,0,0,0,8
Port Adelaide,"Duursma, Xavier",16,9,4,7,0,0,0,5
Port Adelaide,"Ebert, Brad",5,3,2,2,0,0,0,3
Port Adelaide,"Gray, Sam",10,5,1,5,1,0,0,6
Port Adelaide,"Houston, Dan",19,15,5,4,0,0,0,1
Port Adelaide,"Howard, Dougal",12,8,7,4,0,0,0,2
Port Adelaide,"Lienert, Jarrod",17,13,6,4,0,0,0,2
Port Adelaide,"Lycett, Scott",11,6,1,5,2,0,14,1
Port Adelaide,"Marshall, Todd",10,7,4,3,1,0,0,3
Port Adelaide,"Powell-Pepper, Sam",14,12,5,2,1,2,0,4
Port Adelaide,"Rockliff, Tom",22,13,2,9,0,0,0,2
Port Adelaide,"Rozee, Connor",14,6,3,8,1,1,0,6
Port Adelaide,"Ryder, Paddy",14,10,3,4,1,0,25,3
Port Adelaide,"Westhoff, Justin",29,18,8,11,1,3,0,1
Port Adelaide,"Wines, Ollie",28,9,4,19,0,1,0,5
Port Adelaide,"Amon, Karl",17,14,3,3,1,1,0,3
Port Adelaide,"Boak, Travis",28,18,1,10,0,0,0,9
Port Adelaide,"Broadbent, Matthew",22,14,2,8,0,0,0,0
Port Adelaide,"Burton, Ryan",3,2,0,1,0,0,0,0
Port Adelaide,"Byrne-Jones, Darcy",23,13,2,10,0,0,0,2
Port Adelaide,"Clurey, Tom",14,11,3,3,0,0,0,2
Port Adelaide,"Drew, Willem",11,7,0,4,0,1,0,7
Port Adelaide,"Duursma, Xavier",22,12,5,10,1,1,0,2
Port Adelaide,"Farrell, Kane",11,6,2,5,1,1,0,1
Port Adelaide,"Gray, Sam",19,13,8,6,1,2,0,0
Port Adelaide,"Houston, Dan",25,18,7,7,0,0,0,5
Port Adelaide,"Howard, Dougal",14,12,3,2,2,2,0,1
Port Adelaide,"Johnson, Aidyn",12,4,1,8,0,0,0,5
Port Adelaide,"Lienert, Jarrod",26,19,10,7,0,0,0,3
Port Adelaide,"Lycett, Scott",13,7,1,6,0,1,17,3
Port Adelaide,"Marshall, Todd",7,6,2,1,0,0,0,3
Port Adelaide,"Motlop, Steven",16,9,6,7,0,0,0,3
Port Adelaide,"Powell-Pepper, Sam",19,13,1,6,2,1,0,10
Port Adelaide,"Rockliff, Tom",41,23,6,18,0,1,0,6
Port Adelaide,"Rozee, Connor",13,6,3,7,1,1,0,6
Port Adelaide,"Ryder, Paddy",9,6,0,3,0,0,33,6
Port Adelaide,"Westhoff, Justin",12,8,2,4,0,1,0,1
Port Adelaide,"Amon, Karl",19,9,5,10,1,1,0,4
Port Adelaide,"Atley, Joe",19,4,2,15,0,0,0,4
Port Adelaide,"Boak, Travis",36,18,2,18,0,1,1,4
Port Adelaide,"Broadbent, Matthew",22,18,7,4,0,0,0,1
Port Adelaide,"Butters, Zak",15,10,4,5,1,2,0,3
Port Adelaide,"Byrne-Jones, Darcy",25,19,3,6,0,0,0,4
Port Adelaide,"Clurey, Tom",12,10,4,2,0,0,0,0
Port Adelaide,"Duursma, Xavier",19,13,4,6,0,1,0,1
Port Adelaide,"Farrell, Kane",14,9,4,5,3,0,0,3
Port Adelaide,"Frampton, Billy",14,9,3,5,3,1,0,2
Port Adelaide,"Garner, Joel",13,11,5,2,0,0,0,2
Port Adelaide,"Gray, Sam",23,10,8,13,1,1,0,7
Port Adelaide,"Houston, Dan",18,14,2,4,0,0,0,1
Port Adelaide,"Howard, Dougal",11,8,6,3,0,0,0,2
Port Adelaide,"Lienert, Jarrod",16,14,4,2,0,0,0,0
Port Adelaide,"Lycett, Scott",8,4,3,4,0,0,23,1
Port Adelaide,"Motlop, Steven",11,8,1,3,1,1,0,2
Port Adelaide,"Powell-Pepper, Sam",22,8,0,14,0,0,0,5
Port Adelaide,"Rockliff, Tom",31,21,5,10,0,0,0,6
Port Adelaide,"Rozee, Connor",18,8,1,10,2,0,0,7
Port Adelaide,"Ryder, Paddy",9,5,3,4,1,1,27,2
Port Adelaide,"Westhoff, Justin",15,11,3,4,0,0,0,2
Port Adelaide,"Amon, Karl",20,13,4,7,1,0,0,9
Port Adelaide,"Boak, Travis",26,10,1,16,0,0,0,5
Port Adelaide,"Broadbent, Matthew",28,18,7,10,0,0,0,1
Port Adelaide,"Butters, Zak",17,5,2,12,0,2,0,4
Port Adelaide,"Byrne-Jones, Darcy",28,20,8,8,0,0,0,6
Port Adelaide,"Clurey, Tom",11,7,6,4,0,0,0,1
Port Adelaide,"Duursma, Xavier",22,12,5,10,1,2,0,4
Port Adelaide,"Farrell, Kane",9,4,1,5,0,0,0,2
Port Adelaide,"Frampton, Billy",9,2,0,7,0,1,1,1
Port Adelaide,"Gray, Robbie",27,11,7,16,1,0,0,2
Port Adelaide,"Gray, Sam",21,8,3,13,0,0,0,4
Port Adelaide,"Houston, Dan",27,16,5,11,0,0,0,1
Port Adelaide,"Howard, Dougal",17,9,5,8,0,1,0,3
Port Adelaide,"Jonas, Tom",18,12,3,6,0,0,0,5
Port Adelaide,"Ladhams, Peter",13,6,1,7,1,1,9,0
Port Adelaide,"Lienert, Jarrod",24,17,7,7,0,1,0,0
Port Adelaide,"Motlop, Steven",16,8,4,8,0,2,0,2
Port Adelaide,"Powell-Pepper, Sam",21,7,4,14,1,0,0,8
Port Adelaide,"Rockliff, Tom",25,12,2,13,0,0,0,6
Port Adelaide,"Rozee, Connor",12,4,2,8,1,0,0,1
Port Adelaide,"Ryder, Paddy",9,5,4,4,0,0,24,3
Port Adelaide,"Westhoff, Justin",17,12,4,5,0,2,2,7
Port Adelaide,"Amon, Karl",28,13,7,15,0,0,0,1
Port Adelaide,"Boak, Travis",33,14,4,19,2,0,0,6
Port Adelaide,"Bonner, Riley",19,15,5,4,3,1,0,2
Port Adelaide,"Broadbent, Matthew",17,13,3,4,0,0,0,1
Port Adelaide,"Burton, Ryan",22,20,5,2,0,0,0,2
Port Adelaide,"Butters, Zak",19,9,2,10,2,0,0,3
Port Adelaide,"Byrne-Jones, Darcy",26,17,5,9,0,0,0,2
Port Adelaide,"Clurey, Tom",10,8,7,2,0,0,0,3
Port Adelaide,"Duursma, Xavier",23,9,10,14,1,0,0,2
Port Adelaide,"Farrell, Kane",7,5,2,2,2,0,0,1
Port Adelaide,"Gray, Robbie",28,13,4,15,3,2,0,5
Port Adelaide,"Gray, Sam",17,9,4,8,1,1,0,4
Port Adelaide,"Houston, Dan",28,11,5,17,0,0,0,2
Port Adelaide,"Howard, Dougal",15,10,9,5,2,0,0,2
Port Adelaide,"Jonas, Tom",19,16,13,3,0,0,0,2
Port Adelaide,"Lienert, Jarrod",31,22,8,9,0,0,0,2
Port Adelaide,"Lycett, Scott",12,6,3,6,1,0,32,6
Port Adelaide,"Motlop, Steven",19,13,6,6,1,0,0,3
Port Adelaide,"Powell-Pepper, Sam",15,8,2,7,0,2,0,2
Port Adelaide,"Rozee, Connor",11,5,3,6,1,1,0,6
Port Adelaide,"Ryder, Paddy",6,6,4,0,2,0,20,3
Port Adelaide,"Westhoff, Justin",18,11,5,7,1,0,0,1
Port Adelaide,"Amon, Karl",14,5,5,9,0,0,0,4
Port Adelaide,"Boak, Travis",36,15,2,21,1,0,0,1
Port Adelaide,"Bonner, Riley",14,11,3,3,0,0,0,1
Port Adelaide,"Burton, Ryan",25,17,5,8,0,0,0,4
Port Adelaide,"Butters, Zak",14,5,1,9,1,0,0,1
Port Adelaide,"Byrne-Jones, Darcy",17,11,5,6,0,0,0,4
Port Adelaide,"Clurey, Tom",11,9,3,2,0,0,0,0
Port Adelaide,"Duursma, Xavier",21,10,10,11,0,0,0,1
Port Adelaide,"Farrell, Kane",10,6,2,4,4,1,0,1
Port Adelaide,"Gray, Robbie",26,9,3,17,0,0,0,1
Port Adelaide,"Gray, Sam",18,9,1,9,0,1,0,2
Port Adelaide,"Hartlett, Hamish",23,10,5,13,0,0,0,3
Port Adelaide,"Houston, Dan",22,14,3,8,0,1,0,7
Port Adelaide,"Howard, Dougal",6,2,4,4,1,0,0,2
Port Adelaide,"Jonas, Tom",17,11,7,6,0,0,0,3
Port Adelaide,"Lienert, Jarrod",17,9,3,8,0,0,0,2
Port Adelaide,"Lycett, Scott",17,11,4,6,0,1,21,3
Port Adelaide,"Motlop, Steven",16,7,3,9,1,1,0,2
Port Adelaide,"Powell-Pepper, Sam",14,5,3,9,1,0,0,5
Port Adelaide,"Rozee, Connor",13,10,6,3,0,1,0,3
Port Adelaide,"Ryder, Paddy",7,2,4,5,2,0,22,2
Port Adelaide,"Westhoff, Justin",18,8,4,10,1,1,0,4
Port Adelaide,"Amon, Karl",23,17,4,6,0,0,0,5
Port Adelaide,"Boak, Travis",30,16,5,14,0,0,0,8
Port Adelaide,"Bonner, Riley",15,12,1,3,0,0,0,3
Port Adelaide,"Burton, Ryan",21,17,6,4,1,0,0,6
Port Adelaide,"Butters, Zak",13,3,1,10,0,0,0,4
Port Adelaide,"Byrne-Jones, Darcy",18,12,3,6,0,0,0,3
Port Adelaide,"Clurey, Tom",10,9,7,1,0,0,0,2
Port Adelaide,"Dixon, Charlie",8,4,2,4,1,1,7,4
Port Adelaide,"Duursma, Xavier",20,10,5,10,0,0,0,2
Port Adelaide,"Ebert, Brad",12,8,3,4,0,3,0,5
Port Adelaide,"Farrell, Kane",4,3,2,1,1,0,0,1
Port Adelaide,"Garner, Joel",12,6,3,6,0,0,0,0
Port Adelaide,"Gray, Robbie",31,18,5,13,2,0,0,2
Port Adelaide,"Gray, Sam",21,8,4,13,1,2,0,3
Port Adelaide,"Hartlett, Hamish",16,9,6,7,0,0,0,3
Port Adelaide,"Houston, Dan",26,12,3,14,0,0,0,6
Port Adelaide,"Howard, Dougal",10,7,3,3,0,1,1,1
Port Adelaide,"Jonas, Tom",7,5,3,2,0,0,0,1
Port Adelaide,"Lycett, Scott",24,13,5,11,0,0,41,3
Port Adelaide,"Motlop, Steven",17,12,1,5,0,0,0,4
Port Adelaide,"Rozee, Connor",16,9,5,7,2,0,0,3
Port Adelaide,"Wines, Ollie",20,9,2,11,1,0,0,4
Port Adelaide,"Boak, Travis",32,19,1,13,0,1,0,5
Port Adelaide,"Bonner, Riley",11,10,2,1,0,1,0,0
Port Adelaide,"Burton, Ryan",26,14,0,12,0,0,0,2
Port Adelaide,"Butters, Zak",21,9,1,12,0,0,0,5
Port Adelaide,"Byrne-Jones, Darcy",26,16,4,10,0,0,0,2
Port Adelaide,"Clurey, Tom",18,12,6,6,0,0,0,1
Port Adelaide,"Dixon, Charlie",15,9,1,6,2,2,3,2
Port Adelaide,"Drew, Willem",10,3,0,7,0,0,0,6
Port Adelaide,"Duursma, Xavier",11,8,3,3,0,0,0,3
Port Adelaide,"Ebert, Brad",13,10,3,3,0,0,0,0
Port Adelaide,"Farrell, Kane",4,3,1,1,0,1,0,5
Port Adelaide,"Garner, Joel",9,8,3,1,0,0,0,2
Port Adelaide,"Gray, Robbie",24,13,3,11,1,0,0,1
Port Adelaide,"Gray, Sam",18,11,3,7,0,1,0,7
Port Adelaide,"Hartlett, Hamish",29,22,7,7,0,1,0,2
Port Adelaide,"Houston, Dan",15,10,0,5,0,0,0,3
Port Adelaide,"Jonas, Tom",18,15,1,3,0,0,0,3
Port Adelaide,"Ladhams, Peter",12,4,2,8,1,0,15,3
Port Adelaide,"Lycett, Scott",21,11,4,10,0,0,43,9
Port Adelaide,"Motlop, Steven",19,12,2,7,0,1,0,3
Port Adelaide,"Rozee, Connor",12,9,5,3,1,2,0,6
Port Adelaide,"Wines, Ollie",12,6,1,6,0,0,0,7
Port Adelaide,"Amon, Karl",24,12,6,12,0,1,0,1
Port Adelaide,"Bonner, Riley",27,15,10,12,0,1,0,3
Port Adelaide,"Burton, Ryan",23,19,8,4,1,0,0,0
Port Adelaide,"Butters, Zak",10,5,2,5,1,0,0,2
Port Adelaide,"Byrne-Jones, Darcy",31,21,11,10,0,0,0,0
Port Adelaide,"Clurey, Tom",18,16,12,2,0,0,0,2
Port Adelaide,"Dixon, Charlie",4,2,2,2,1,1,3,3
Port Adelaide,"Duursma, Xavier",22,15,8,7,0,3,0,0
Port Adelaide,"Ebert, Brad",14,11,9,3,3,0,0,5
Port Adelaide,"Gray, Robbie",35,15,3,20,0,0,0,3
Port Adelaide,"Gray, Sam",22,13,4,9,2,1,0,2
Port Adelaide,"Hartlett, Hamish",17,9,4,8,0,0,0,2
Port Adelaide,"Houston, Dan",14,8,3,6,0,0,0,2
Port Adelaide,"Howard, Dougal",10,7,4,3,2,1,3,2
Port Adelaide,"Jonas, Tom",12,9,5,3,0,0,0,1
Port Adelaide,"Lycett, Scott",19,9,4,10,1,0,32,3
Port Adelaide,"Motlop, Steven",19,11,7,8,1,0,0,2
Port Adelaide,"Powell-Pepper, Sam",24,14,2,10,0,1,0,6
Port Adelaide,"Rockliff, Tom",36,23,11,13,0,0,0,5
Port Adelaide,"Rozee, Connor",12,5,2,7,2,0,0,2
Port Adelaide,"Westhoff, Justin",23,16,16,7,1,0,4,3
Port Adelaide,"Wines, Ollie",34,10,3,24,0,1,0,5
Port Adelaide,"Amon, Karl",18,13,2,5,0,2,0,2
Port Adelaide,"Boak, Travis",32,16,2,16,0,0,0,1
Port Adelaide,"Bonner, Riley",16,12,5,4,1,0,0,3
Port Adelaide,"Burton, Ryan",12,8,1,4,0,0,0,2
Port Adelaide,"Butters, Zak",10,5,1,5,1,0,0,4
Port Adelaide,"Byrne-Jones, Darcy",30,24,6,6,0,0,0,3
Port Adelaide,"Clurey, Tom",10,5,3,5,0,0,0,2
Port Adelaide,"Dixon, Charlie",12,7,3,5,1,2,3,0
Port Adelaide,"Ebert, Brad",8,5,0,3,0,0,0,3
Port Adelaide,"Gray, Robbie",32,12,3,20,1,1,0,4
Port Adelaide,"Gray, Sam",19,12,4,7,2,1,0,5
Port Adelaide,"Hartlett, Hamish",19,15,3,4,0,0,0,7
Port Adelaide,"Howard, Dougal",11,8,2,3,0,0,5,1
Port Adelaide,"Jonas, Tom",18,12,8,6,0,0,0,2
Port Adelaide,"Lycett, Scott",10,6,1,4,0,0,32,6
Port Adelaide,"Motlop, Steven",13,8,7,5,0,0,0,3
Port Adelaide,"Powell-Pepper, Sam",18,7,1,11,0,2,0,2
Port Adelaide,"Rockliff, Tom",29,16,2,13,0,0,0,3
Port Adelaide,"Rozee, Connor",13,6,1,7,0,0,0,7
Port Adelaide,"Sutcliffe, Cam",10,6,0,4,0,0,0,4
Port Adelaide,"Westhoff, Justin",15,11,4,4,0,0,0,3
Port Adelaide,"Wines, Ollie",32,19,5,13,0,1,0,8
Port Adelaide,"Amon, Karl",28,14,5,14,2,0,0,1
Port Adelaide,"Boak, Travis",29,11,3,18,0,1,0,6
Port Adelaide,"Bonner, Riley",20,14,4,6,0,0,0,0
Port Adelaide,"Broadbent, Matthew",26,21,9,5,0,0,0,0
Port Adelaide,"Butters, Zak",13,11,6,2,2,1,0,1
Port Adelaide,"Byrne-Jones, Darcy",29,16,6,13,0,0,0,1
Port Adelaide,"Clurey, Tom",11,10,5,1,0,0,0,2
Port Adelaide,"Dixon, Charlie",17,10,4,7,1,2,0,1
Port Adelaide,"Duursma, Xavier",24,9,4,15,1,0,0,2
Port Adelaide,"Gray, Robbie",18,4,4,14,0,0,0,6
Port Adelaide,"Gray, Sam",9,3,1,6,0,0,0,3
Port Adelaide,"Hartlett, Hamish",14,6,2,8,0,1,0,0
Port Adelaide,"Houston, Dan",17,9,3,8,0,0,0,1
Port Adelaide,"Howard, Dougal",9,5,4,4,1,1,2,0
Port Adelaide,"Jonas, Tom",15,12,9,3,0,0,0,5
Port Adelaide,"Lycett, Scott",18,7,4,11,0,0,21,2
Port Adelaide,"Motlop, Steven",16,9,2,7,0,0,0,3
Port Adelaide,"Powell-Pepper, Sam",13,6,5,7,0,0,0,4
Port Adelaide,"Rockliff, Tom",26,12,2,14,1,0,0,5
Port Adelaide,"Rozee, Connor",14,5,3,9,0,2,0,5
Port Adelaide,"Sutcliffe, Cam",9,6,2,3,1,0,0,2
Port Adelaide,"Westhoff, Justin",19,8,11,11,0,0,1,3
Port Adelaide,"Amon, Karl",22,13,2,9,0,3,0,7
Port Adelaide,"Boak, Travis",40,16,5,24,0,0,0,1
Port Adelaide,"Bonner, Riley",28,19,8,9,0,0,0,3
Port Adelaide,"Broadbent, Matthew",21,14,9,7,0,0,0,1
Port Adelaide,"Butters, Zak",16,7,3,9,0,1,0,3
Port Adelaide,"Byrne-Jones, Darcy",19,14,3,5,0,1,0,5
Port Adelaide,"Clurey, Tom",16,10,7,6,0,0,0,2
Port Adelaide,"Duursma, Xavier",18,10,6,8,0,1,0,2
Port Adelaide,"Garner, Joel",14,10,3,4,0,0,0,1
Port Adelaide,"Gray, Robbie",14,9,5,5,3,0,0,2
Port Adelaide,"Gray, Sam",13,6,5,7,1,1,0,5
Port Adelaide,"Hartlett, Hamish",22,15,7,7,0,0,0,4
Port Adelaide,"Houston, Dan",29,12,3,17,0,0,0,7
Port Adelaide,"Howard, Dougal",5,4,2,1,2,0,0,0
Port Adelaide,"Jonas, Tom",19,13,5,6,0,0,0,3
Port Adelaide,"Lycett, Scott",20,4,5,16,0,0,22,4
Port Adelaide,"Powell-Pepper, Sam",17,11,3,6,0,1,0,6
Port Adelaide,"Rockliff, Tom",31,11,3,20,0,0,0,5
Port Adelaide,"Rozee, Connor",14,8,5,6,1,0,0,1
Port Adelaide,"Ryder, Paddy",13,9,5,4,0,1,20,1
Port Adelaide,"Sutcliffe, Cam",11,4,2,7,0,1,0,2
Port Adelaide,"Westhoff, Justin",20,9,6,11,0,0,0,2
Port Adelaide,"Amon, Karl",23,12,7,11,1,1,0,3
Port Adelaide,"Boak, Travis",23,13,3,10,1,0,0,4
Port Adelaide,"Bonner, Riley",19,14,4,5,0,0,0,0
Port Adelaide,"Broadbent, Matthew",22,14,7,8,0,0,0,0
Port Adelaide,"Butters, Zak",8,3,2,5,1,0,0,2
Port Adelaide,"Byrne-Jones, Darcy",25,19,7,6,0,0,0,5
Port Adelaide,"Clurey, Tom",11,11,8,0,0,0,0,1
Port Adelaide,"Dixon, Charlie",5,5,3,0,0,0,2,1
Port Adelaide,"Duursma, Xavier",26,13,6,13,1,0,0,2
Port Adelaide,"Gray, Robbie",19,10,5,9,4,1,0,0
Port Adelaide,"Gray, Sam",19,11,8,8,1,1,0,2
Port Adelaide,"Hartlett, Hamish",23,16,5,7,0,0,0,2
Port Adelaide,"Houston, Dan",29,17,10,12,2,0,0,2
Port Adelaide,"Jonas, Tom",14,10,3,4,0,0,0,1
Port Adelaide,"Ladhams, Peter",18,7,2,11,0,0,22,2
Port Adelaide,"Marshall, Todd",11,10,6,1,3,0,1,1
Port Adelaide,"Powell-Pepper, Sam",22,14,9,8,1,1,0,5
Port Adelaide,"Rockliff, Tom",27,16,4,11,0,0,0,4
Port Adelaide,"Rozee, Connor",22,13,5,9,2,5,0,3
Port Adelaide,"Ryder, Paddy",10,3,1,7,1,0,20,0
Port Adelaide,"Sutcliffe, Cam",17,11,5,6,1,1,0,2
Port Adelaide,"Westhoff, Justin",17,13,7,4,0,0,0,1
Port Adelaide,"Amon, Karl",22,10,2,12,1,0,0,1
Port Adelaide,"Boak, Travis",13,6,2,7,0,4,0,5
Port Adelaide,"Bonner, Riley",19,15,8,4,0,1,0,1
Port Adelaide,"Broadbent, Matthew",19,16,7,3,0,0,0,1
Port Adelaide,"Byrne-Jones, Darcy",28,20,7,8,0,0,0,2
Port Adelaide,"Clurey, Tom",18,11,8,7,0,0,0,2
Port Adelaide,"Dixon, Charlie",12,9,3,3,3,0,3,2
Port Adelaide,"Duursma, Xavier",19,11,6,8,0,0,0,0
Port Adelaide,"Gray, Robbie",22,11,2,11,0,0,0,4
Port Adelaide,"Gray, Sam",13,3,0,10,0,0,0,3
Port Adelaide,"Hartlett, Hamish",18,13,2,5,0,0,0,4
Port Adelaide,"Houston, Dan",17,9,6,8,1,0,0,9
Port Adelaide,"Jonas, Tom",24,17,6,7,0,0,0,0
Port Adelaide,"Ladhams, Peter",23,12,4,11,0,1,19,2
Port Adelaide,"Marshall, Todd",11,7,2,4,2,0,0,8
Port Adelaide,"Powell-Pepper, Sam",20,9,2,11,0,0,0,6
Port Adelaide,"Rockliff, Tom",19,9,1,10,0,0,0,6
Port Adelaide,"Rozee, Connor",20,10,4,10,3,1,0,3
Port Adelaide,"Ryder, Paddy",12,10,4,2,1,2,27,2
Port Adelaide,"Sutcliffe, Cam",6,6,2,0,2,0,0,4
Port Adelaide,"Westhoff, Justin",13,10,3,3,0,0,0,4
Port Adelaide,"Wines, Ollie",22,10,3,12,2,0,0,5
Port Adelaide,"Amon, Karl",16,11,4,5,2,1,0,1
Port Adelaide,"Boak, Travis",28,13,3,15,0,0,0,6
Port Adelaide,"Bonner, Riley",11,8,5,3,0,0,0,0
Port Adelaide,"Broadbent, Matthew",9,8,3,1,0,0,0,1
Port Adelaide,"Burton, Ryan",16,11,2,5,0,0,0,0
Port Adelaide,"Butters, Zak",6,3,2,3,0,0,0,4
Port Adelaide,"Byrne-Jones, Darcy",5,1,0,4,0,0,0,0
Port Adelaide,"Clurey, Tom",14,11,6,3,0,0,0,2
Port Adelaide,"Dixon, Charlie",12,4,3,8,1,1,0,5
Port Adelaide,"Gray, Robbie",13,9,3,4,3,2,0,1
Port Adelaide,"Gray, Sam",16,7,3,9,0,1,0,1
Port Adelaide,"Hartlett, Hamish",11,7,2,4,0,0,0,4
Port Adelaide,"Houston, Dan",29,20,5,9,0,2,0,1
Port Adelaide,"Jonas, Tom",15,10,2,5,0,0,0,0
Port Adelaide,"Ladhams, Peter",7,3,0,4,0,0,9,3
Port Adelaide,"Marshall, Todd",6,2,3,4,0,0,0,2
Port Adelaide,"Powell-Pepper, Sam",16,6,1,10,0,0,0,5
Port Adelaide,"Rockliff, Tom",16,7,0,9,0,0,0,3
Port Adelaide,"Rozee, Connor",17,6,1,11,1,0,0,4
Port Adelaide,"Ryder, Paddy",8,5,1,3,1,1,26,4
Port Adelaide,"Westhoff, Justin",14,9,3,5,0,0,0,2
Port Adelaide,"Wines, Ollie",22,10,5,12,0,0,0,3
Port Adelaide,"Amon, Karl",23,14,1,9,0,1,0,3
Port Adelaide,"Boak, Travis",23,10,5,13,1,1,0,2
Port Adelaide,"Bonner, Riley",17,11,6,6,1,1,0,1
Port Adelaide,"Broadbent, Matthew",13,9,4,4,0,0,0,2
Port Adelaide,"Burton, Ryan",14,10,2,4,0,1,0,2
Port Adelaide,"Byrne-Jones, Darcy",29,17,3,12,0,1,0,2
Port Adelaide,"Dixon, Charlie",16,11,8,5,3,2,2,1
Port Adelaide,"Drew, Willem",22,8,4,14,0,0,0,8
Port Adelaide,"Duursma, Xavier",21,11,6,10,2,1,0,6
Port Adelaide,"Gray, Robbie",13,6,3,7,0,1,0,0
Port Adelaide,"Gray, Sam",11,5,4,6,0,1,0,2
Port Adelaide,"Hartlett, Hamish",20,10,5,10,0,0,0,4
Port Adelaide,"Houston, Dan",21,10,6,11,1,0,0,3
Port Adelaide,"Jonas, Tom",11,6,4,5,0,0,0,3
Port Adelaide,"Lycett, Scott",22,13,4,9,0,1,22,1
Port Adelaide,"Marshall, Todd",12,8,7,4,2,1,0,2
Port Adelaide,"McKenzie, Trent",21,15,4,6,0,0,0,0
Port Adelaide,"Rockliff, Tom",18,9,3,9,1,0,0,4
Port Adelaide,"Rozee, Connor",13,6,2,7,2,2,0,4
Port Adelaide,"Ryder, Paddy",11,6,4,5,0,2,18,3
Port Adelaide,"Westhoff, Justin",23,13,6,10,2,1,0,5
Port Adelaide,"Wines, Ollie",33,15,3,18,0,1,0,8
Richmond,"Astbury, David",9,5,1,4,0,0,0,0
Richmond,"Balta, Noah",5,5,2,0,1,0,6,1
Richmond,"Broad, Nathan",8,4,1,4,0,0,0,2
Richmond,"Butler, Dan",13,8,1,5,1,0,0,7
Richmond,"Cotchin, Trent",31,20,6,11,0,1,0,4
Richmond,"Edwards, Shane",22,8,0,14,0,0,0,4
Richmond,"Graham, Jack",23,16,7,7,0,1,0,6
Richmond,"Grimes, Dylan",9,5,1,4,0,0,0,4
Richmond,"Higgins, Jack",17,9,6,8,3,0,0,1
Richmond,"Houli, Bachar",24,16,6,8,0,0,0,4
Richmond,"Lambert, Kane",30,12,7,18,0,1,0,4
Richmond,"Lynch, Tom",7,4,1,3,3,1,0,2
Richmond,"Martin, Dustin",30,18,4,12,0,0,0,0
Richmond,"McIntosh, Kamdyn",13,9,3,4,1,0,0,4
Richmond,"Nankervis, Toby",17,13,2,4,3,0,34,2
Richmond,"Prestia, Dion",20,10,1,10,0,0,0,7
Richmond,"Rance, Alex",6,3,2,3,0,0,0,2
Richmond,"Riewoldt, Jack",8,6,2,2,1,1,0,2
Richmond,"Rioli, Daniel",17,10,4,7,0,2,0,2
Richmond,"Short, Jayden",20,18,5,2,0,1,0,3
Richmond,"Vlastuin, Nick",14,10,5,4,0,0,0,1
Richmond,"Weller, Maverick",15,9,2,6,1,1,0,1
Richmond,"Astbury, David",9,6,4,3,0,0,0,0
Richmond,"Broad, Nathan",8,5,2,3,0,0,0,1
Richmond,"Butler, Dan",8,5,1,3,0,0,0,3
Richmond,"Castagna, Jason",12,6,3,6,0,1,0,1
Richmond,"Cotchin, Trent",22,18,2,4,0,0,0,1
Richmond,"Edwards, Shane",20,11,3,9,2,0,0,0
Richmond,"Ellis, Brandon",24,12,4,12,0,0,0,1
Richmond,"Graham, Jack",16,7,2,9,0,0,0,4
Richmond,"Grimes, Dylan",11,5,7,6,0,0,0,2
Richmond,"Higgins, Jack",9,5,2,4,2,0,0,1
Richmond,"Lambert, Kane",14,8,3,6,0,0,0,1
Richmond,"Lynch, Tom",10,9,4,1,3,1,0,0
Richmond,"Markov, Oleg",8,6,4,2,0,2,0,1
Richmond,"Martin, Dustin",18,11,4,7,0,1,0,0
Richmond,"McIntosh, Kamdyn",11,8,6,3,0,0,0,5
Richmond,"Nankervis, Toby",15,8,4,7,0,0,21,4
Richmond,"Prestia, Dion",17,10,6,7,0,0,0,4
Richmond,"Riewoldt, Jack",11,8,2,3,0,0,1,0
Richmond,"Rioli, Daniel",12,4,1,8,1,0,0,1
Richmond,"Short, Jayden",16,15,5,1,2,0,0,1
Richmond,"Vlastuin, Nick",15,9,5,6,0,0,0,1
Richmond,"Weller, Maverick",16,8,4,8,0,0,0,0
Richmond,"Astbury, David",16,11,6,5,0,0,0,0
Richmond,"Balta, Noah",5,3,0,2,0,0,8,2
Richmond,"Broad, Nathan",13,10,6,3,0,0,0,1
Richmond,"Butler, Dan",10,8,0,2,0,0,0,0
Richmond,"Castagna, Jason",19,11,3,8,0,2,0,3
Richmond,"Cotchin, Trent",22,13,1,9,0,0,0,3
Richmond,"Edwards, Shane",25,13,4,12,0,0,0,3
Richmond,"Ellis, Brandon",21,15,8,6,0,0,0,1
Richmond,"Garthwaite, Ryan",7,6,4,1,0,0,0,1
Richmond,"Graham, Jack",17,10,2,7,0,0,0,5
Richmond,"Higgins, Jack",21,13,4,8,1,0,0,1
Richmond,"Lambert, Kane",34,17,11,17,1,0,0,5
Richmond,"Lynch, Tom",9,8,3,1,4,1,0,1
Richmond,"Markov, Oleg",20,9,5,11,0,0,0,2
Richmond,"Martin, Dustin",15,8,4,7,0,2,0,6
Richmond,"McIntosh, Kamdyn",19,13,6,6,0,1,2,3
Richmond,"Nankervis, Toby",15,8,2,7,0,0,22,5
Richmond,"Prestia, Dion",33,22,3,11,0,3,0,4
Richmond,"Rioli, Daniel",13,9,1,4,3,0,0,3
Richmond,"Short, Jayden",1,1,0,0,0,0,0,0
Richmond,"Stack, Sydney",17,11,8,6,1,0,0,3
Richmond,"Vlastuin, Nick",14,9,5,5,0,0,0,7
Richmond,"Astbury, David",12,10,8,2,0,0,0,1
Richmond,"Baker, Liam",17,10,3,7,1,1,0,1
Richmond,"Balta, Noah",10,5,3,5,0,1,5,0
Richmond,"Bolton, Shai",11,6,1,5,1,0,0,5
Richmond,"Broad, Nathan",6,6,3,0,0,0,0,2
Richmond,"Caddy, Josh",9,8,0,1,3,0,0,2
Richmond,"Castagna, Jason",11,2,0,9,0,0,0,6
Richmond,"Edwards, Shane",23,14,5,9,0,0,0,2
Richmond,"Ellis, Brandon",28,17,9,11,1,0,0,2
Richmond,"Graham, Jack",14,11,3,3,0,0,0,6
Richmond,"Grimes, Dylan",17,11,7,6,0,0,0,1
Richmond,"Higgins, Jack",17,13,5,4,0,1,0,4
Richmond,"Lambert, Kane",24,9,7,15,0,1,0,1
Richmond,"Lynch, Tom",10,9,6,1,6,2,0,1
Richmond,"McIntosh, Kamdyn",14,9,4,5,1,0,0,3
Richmond,"Menadue, Connor",13,7,3,6,0,0,0,0
Richmond,"Nankervis, Toby",14,9,4,5,1,0,17,5
Richmond,"Prestia, Dion",20,11,2,9,1,0,0,4
Richmond,"Rioli, Daniel",10,8,4,2,0,2,0,2
Richmond,"Ross, Jack",25,12,4,13,0,0,0,5
Richmond,"Stack, Sydney",11,6,5,5,0,0,0,0
Richmond,"Vlastuin, Nick",15,8,5,7,0,0,0,1
Richmond,"Astbury, David",15,7,7,8,0,0,0,1
Richmond,"Baker, Liam",21,6,1,15,1,1,0,4
Richmond,"Balta, Noah",9,8,3,1,2,0,4,1
Richmond,"Bolton, Shai",10,8,3,2,0,2,0,2
Richmond,"Broad, Nathan",13,6,3,7,0,0,0,4
Richmond,"Caddy, Josh",15,8,3,7,2,0,0,5
Richmond,"Castagna, Jason",14,4,2,10,1,1,0,8
Richmond,"Edwards, Shane",28,13,3,15,0,0,0,1
Richmond,"Ellis, Brandon",21,13,5,8,1,0,0,3
Richmond,"Grimes, Dylan",15,5,3,10,0,0,0,2
Richmond,"Higgins, Jack",25,13,6,12,0,0,0,5
Richmond,"Houli, Bachar",23,12,4,11,0,0,0,3
Richmond,"Lambert, Kane",13,6,2,7,2,0,0,3
Richmond,"Lynch, Tom",7,4,2,3,0,2,0,4
Richmond,"Martin, Dustin",25,18,5,7,3,2,0,2
Richmond,"McIntosh, Kamdyn",14,11,5,3,0,0,0,6
Richmond,"Nankervis, Toby",16,6,2,10,0,0,21,2
Richmond,"Prestia, Dion",32,19,4,13,0,0,0,4
Richmond,"Rioli, Daniel",13,7,3,6,1,0,0,3
Richmond,"Ross, Jack",17,10,3,7,0,0,0,2
Richmond,"Stack, Sydney",22,6,5,16,0,0,0,4
Richmond,"Vlastuin, Nick",20,12,10,8,0,0,0,2
Richmond,"Astbury, David",10,6,5,4,0,0,0,0
Richmond,"Baker, Liam",19,12,3,7,2,0,0,5
Richmond,"Balta, Noah",6,4,1,2,0,0,7,5
Richmond,"Broad, Nathan",14,10,5,4,0,0,0,0
Richmond,"Caddy, Josh",19,11,4,8,0,2,0,3
Richmond,"Castagna, Jason",11,8,3,3,3,2,0,4
Richmond,"Edwards, Shane",18,7,4,11,0,0,0,1
Richmond,"Ellis, Brandon",22,10,4,12,2,1,0,8
Richmond,"Grimes, Dylan",14,8,7,6,0,0,0,0
Richmond,"Higgins, Jack",25,16,3,9,0,0,0,6
Richmond,"Houli, Bachar",32,20,7,12,0,0,0,5
Richmond,"Lambert, Kane",29,13,0,16,0,0,0,7
Richmond,"Lynch, Tom",8,5,4,3,1,1,0,1
Richmond,"Martin, Dustin",17,11,0,6,1,0,0,4
Richmond,"McIntosh, Kamdyn",14,9,4,5,1,0,0,1
Richmond,"Nankervis, Toby",13,8,3,5,0,0,21,4
Richmond,"Prestia, Dion",30,14,3,16,0,1,0,6
Richmond,"Riewoldt, Jack",16,9,6,7,2,1,0,2
Richmond,"Rioli, Daniel",6,3,1,3,0,2,0,5
Richmond,"Ross, Jack",28,10,4,18,0,1,0,3
Richmond,"Stack, Sydney",12,5,3,7,0,0,0,4
Richmond,"Vlastuin, Nick",28,18,13,10,0,0,0,2
Richmond,"Baker, Liam",18,10,6,8,1,1,0,6
Richmond,"Balta, Noah",11,10,5,1,1,0,5,2
Richmond,"Bolton, Shai",17,8,4,9,0,0,0,2
Richmond,"Broad, Nathan",11,5,2,6,0,0,0,1
Richmond,"Caddy, Josh",11,5,3,6,1,1,0,2
Richmond,"Castagna, Jason",11,4,1,7,0,1,0,1
Richmond,"Edwards, Shane",12,8,1,4,0,0,0,3
Richmond,"Ellis, Brandon",14,6,4,8,0,0,0,0
Richmond,"Grimes, Dylan",10,5,2,5,0,0,0,2
Richmond,"Higgins, Jack",15,6,1,9,0,0,0,2
Richmond,"Houli, Bachar",18,10,2,8,1,0,0,2
Richmond,"Lambert, Kane",23,15,3,8,0,0,0,3
Richmond,"Lynch, Tom",5,3,3,2,0,1,0,3
Richmond,"Martin, Dustin",25,15,4,10,0,0,0,2
Richmond,"McIntosh, Kamdyn",12,10,4,2,1,1,0,2
Richmond,"Menadue, Connor",15,11,4,4,0,0,0,3
Richmond,"Nankervis, Toby",15,6,2,9,0,1,26,4
Richmond,"Prestia, Dion",22,10,1,12,0,1,0,4
Richmond,"Rioli, Daniel",8,3,3,5,0,1,0,2
Richmond,"Ross, Jack",15,6,2,9,1,0,0,3
Richmond,"Stack, Sydney",19,8,7,11,1,0,0,4
Richmond,"Vlastuin, Nick",21,11,8,10,0,0,0,1
Richmond,"Astbury, David",17,14,11,3,0,0,0,0
Richmond,"Baker, Liam",19,6,1,13,1,2,0,3
Richmond,"Balta, Noah",13,10,2,3,1,0,12,2
Richmond,"Bolton, Shai",16,10,2,6,4,0,0,7
Richmond,"Broad, Nathan",8,7,3,1,1,0,3,3
Richmond,"Caddy, Josh",25,17,5,8,1,1,0,7
Richmond,"Castagna, Jason",15,10,9,5,2,1,0,5
Richmond,"Edwards, Shane",23,12,7,11,0,0,0,3
Richmond,"Ellis, Brandon",25,13,7,12,1,0,0,6
Richmond,"Garthwaite, Ryan",11,8,8,3,0,0,0,1
Richmond,"Grimes, Dylan",26,13,11,13,0,0,0,2
Richmond,"Higgins, Jack",16,8,1,8,0,0,0,2
Richmond,"Houli, Bachar",30,21,10,9,0,0,0,1
Richmond,"Lambert, Kane",26,9,6,17,1,0,0,1
Richmond,"Lynch, Tom",15,10,8,5,2,2,0,0
Richmond,"Martin, Dustin",23,13,1,10,1,1,0,3
Richmond,"McIntosh, Kamdyn",19,16,9,3,1,0,0,2
Richmond,"Menadue, Connor",23,19,5,4,0,0,0,3
Richmond,"Nankervis, Toby",8,3,2,5,0,0,8,2
Richmond,"Prestia, Dion",23,9,2,14,0,0,0,6
Richmond,"Ross, Jack",4,2,0,2,0,0,0,1
Richmond,"Stack, Sydney",18,9,7,9,1,0,0,6
Richmond,"Astbury, David",20,19,12,1,0,0,0,1
Richmond,"Baker, Liam",13,9,8,4,1,1,0,0
Richmond,"Balta, Noah",14,10,6,4,1,1,6,3
Richmond,"Bolton, Shai",11,6,3,5,0,1,0,2
Richmond,"Broad, Nathan",20,15,6,5,0,0,0,2
Richmond,"Caddy, Josh",17,11,3,6,3,0,0,1
Richmond,"Castagna, Jason",7,4,3,3,1,0,0,2
Richmond,"Edwards, Shane",26,14,7,12,0,0,0,3
Richmond,"Ellis, Brandon",35,20,13,15,0,0,0,0
Richmond,"Garthwaite, Ryan",12,9,4,3,0,0,0,1
Richmond,"Grimes, Dylan",14,10,5,4,0,0,0,1
Richmond,"Higgins, Jack",17,11,6,6,1,1,0,2
Richmond,"Houli, Bachar",35,14,9,21,0,0,0,1
Richmond,"Lambert, Kane",22,10,9,12,0,1,0,3
Richmond,"Lynch, Tom",8,7,6,1,3,0,0,2
Richmond,"Martin, Dustin",37,24,6,13,2,2,0,3
Richmond,"McIntosh, Kamdyn",13,8,4,5,1,1,0,3
Richmond,"Menadue, Connor",14,10,4,4,0,0,0,2
Richmond,"Prestia, Dion",29,17,6,12,0,1,0,1
Richmond,"Soldo, Ivan",8,5,2,3,0,0,35,3
Richmond,"Stack, Sydney",17,11,7,6,0,0,0,1
Richmond,"Vlastuin, Nick",24,11,4,13,1,0,0,9
Richmond,"Astbury, David",16,15,6,1,0,0,0,0
Richmond,"Baker, Liam",24,15,4,9,1,0,0,9
Richmond,"Balta, Noah",18,14,2,4,0,1,12,5
Richmond,"Bolton, Shai",11,7,3,4,1,0,0,4
Richmond,"Broad, Nathan",8,5,2,3,0,0,0,5
Richmond,"Caddy, Josh",24,15,2,9,0,2,0,5
Richmond,"Castagna, Jason",17,10,2,7,2,1,0,2
Richmond,"Coleman-Jones, Callum",13,6,3,7,0,1,10,5
Richmond,"Edwards, Shane",26,14,4,12,0,0,0,2
Richmond,"Ellis, Brandon",23,12,4,11,0,0,0,4
Richmond,"Garthwaite, Ryan",7,5,2,2,0,0,0,1
Richmond,"Grimes, Dylan",9,5,1,4,0,0,0,7
Richmond,"Higgins, Jack",16,9,2,7,2,1,0,4
Richmond,"Houli, Bachar",37,28,6,9,0,0,0,5
Richmond,"Lynch, Tom",5,3,1,2,2,0,0,4
Richmond,"Martin, Dustin",35,26,7,9,0,0,0,1
Richmond,"McIntosh, Kamdyn",12,8,3,4,0,0,0,4
Richmond,"Menadue, Connor",9,6,1,3,0,0,0,2
Richmond,"Prestia, Dion",25,19,3,6,1,1,0,6
Richmond,"Rioli, Daniel",13,7,3,6,1,2,0,2
Richmond,"Stack, Sydney",16,6,5,10,0,0,0,2
Richmond,"Vlastuin, Nick",18,9,4,9,0,1,0,8
Richmond,"Astbury, David",12,9,6,3,1,0,2,0
Richmond,"Baker, Liam",17,13,6,4,0,2,0,5
Richmond,"Balta, Noah",11,8,2,3,0,0,7,2
Richmond,"Bolton, Shai",10,6,3,4,0,0,0,1
Richmond,"Broad, Nathan",8,6,4,2,0,0,0,1
Richmond,"Butler, Dan",6,4,3,2,2,0,0,2
Richmond,"Caddy, Josh",22,11,5,11,0,0,0,1
Richmond,"Castagna, Jason",13,9,6,4,1,1,0,1
Richmond,"Cotchin, Trent",23,15,4,8,0,0,0,1
Richmond,"Edwards, Shane",16,5,1,11,0,0,0,2
Richmond,"Ellis, Brandon",21,13,5,8,0,0,0,3
Richmond,"Garthwaite, Ryan",4,2,1,2,0,0,0,1
Richmond,"Grimes, Dylan",8,4,1,4,0,0,0,1
Richmond,"Higgins, Jack",11,8,2,3,0,0,0,2
Richmond,"Houli, Bachar",38,22,4,16,0,0,0,6
Richmond,"Lynch, Tom",5,5,3,0,1,1,2,2
Richmond,"Martin, Dustin",21,15,3,6,3,1,0,5
Richmond,"McIntosh, Kamdyn",14,7,4,7,0,0,0,1
Richmond,"Prestia, Dion",23,12,3,11,1,0,0,4
Richmond,"Soldo, Ivan",4,1,2,3,0,0,28,7
Richmond,"Stack, Sydney",24,11,5,13,0,1,0,4
Richmond,"Vlastuin, Nick",15,4,3,11,0,0,0,3
Richmond,"Baker, Liam",13,10,3,3,0,1,0,5
Richmond,"Balta, Noah",7,7,4,0,0,0,0,1
Richmond,"Butler, Dan",7,6,3,1,1,0,0,11
Richmond,"Caddy, Josh",17,8,2,9,0,1,0,6
Richmond,"Castagna, Jason",11,9,7,2,1,0,0,5
Richmond,"Cotchin, Trent",22,11,1,11,0,0,0,5
Richmond,"Edwards, Shane",18,9,4,9,0,0,0,5
Richmond,"Garthwaite, Ryan",9,5,4,4,0,0,0,3
Richmond,"Graham, Jack",11,6,3,5,0,0,0,9
Richmond,"Grimes, Dylan",14,6,4,8,0,0,0,1
Richmond,"Higgins, Jack",14,4,1,10,0,1,0,2
Richmond,"Houli, Bachar",27,20,8,7,0,0,0,3
Richmond,"Lynch, Tom",9,7,4,2,1,2,0,1
Richmond,"Martin, Dustin",26,17,4,9,1,1,0,4
Richmond,"McIntosh, Kamdyn",16,12,4,4,0,0,0,3
Richmond,"Naish, Patrick",20,15,5,5,1,0,0,2
Richmond,"Prestia, Dion",30,16,2,14,0,0,0,6
Richmond,"Rioli, Daniel",13,7,4,6,0,0,0,2
Richmond,"Soldo, Ivan",7,2,0,5,0,0,33,7
Richmond,"Stack, Sydney",12,4,4,8,0,0,0,3
Richmond,"Townsend, Jacob",3,1,1,2,0,0,0,4
Richmond,"Vlastuin, Nick",15,11,7,4,0,0,0,0
Richmond,"Baker, Liam",16,6,1,10,0,1,0,7
Richmond,"Balta, Noah",7,0,0,7,0,0,9,4
Richmond,"Broad, Nathan",13,9,3,4,0,0,0,3
Richmond,"Butler, Dan",11,6,3,5,1,2,0,0
Richmond,"Caddy, Josh",10,7,3,3,1,0,0,4
Richmond,"Castagna, Jason",14,10,5,4,0,1,0,5
Richmond,"Chol, Mabior",8,6,2,2,1,1,13,2
Richmond,"Ellis, Brandon",23,15,7,8,0,0,0,4
Richmond,"Garthwaite, Ryan",13,8,5,5,0,0,0,4
Richmond,"Graham, Jack",23,8,3,15,0,0,0,11
Richmond,"Grimes, Dylan",13,6,8,7,0,0,0,3
Richmond,"Higgins, Jack",14,5,0,9,0,0,0,7
Richmond,"Houli, Bachar",23,11,6,12,0,0,0,4
Richmond,"Lynch, Tom",11,10,8,1,2,1,0,1
Richmond,"Martin, Dustin",32,21,9,11,2,0,0,4
Richmond,"McIntosh, Kamdyn",11,6,2,5,0,0,0,3
Richmond,"Menadue, Connor",11,9,2,2,0,0,0,3
Richmond,"Naish, Patrick",19,10,4,9,0,0,0,2
Richmond,"Prestia, Dion",29,20,7,9,0,2,0,8
Richmond,"Rioli, Daniel",11,6,3,5,2,0,0,2
Richmond,"Stack, Sydney",22,12,6,10,0,2,0,4
Richmond,"Vlastuin, Nick",24,10,6,14,0,0,0,4
Richmond,"Astbury, David",20,12,9,8,0,0,0,2
Richmond,"Bolton, Shai",13,5,3,8,1,0,0,0
Richmond,"Broad, Nathan",9,5,4,4,0,0,0,4
Richmond,"Caddy, Josh",17,9,4,8,1,0,0,2
Richmond,"Castagna, Jason",12,6,3,6,1,0,0,1
Richmond,"Chol, Mabior",16,13,9,3,3,0,7,2
Richmond,"Cotchin, Trent",19,10,2,9,0,0,0,3
Richmond,"Edwards, Shane",14,5,2,9,0,0,0,1
Richmond,"Ellis, Brandon",11,4,2,7,1,0,0,3
Richmond,"Graham, Jack",18,7,4,11,1,0,0,9
Richmond,"Grimes, Dylan",13,6,5,7,0,0,0,3
Richmond,"Houli, Bachar",21,9,7,12,0,0,0,0
Richmond,"Lambert, Kane",23,8,4,15,0,0,0,4
Richmond,"Lynch, Tom",9,8,6,1,3,3,0,1
Richmond,"Martin, Dustin",36,25,7,11,0,1,0,3
Richmond,"McIntosh, Kamdyn",14,6,2,8,0,0,0,3
Richmond,"Prestia, Dion",29,15,5,14,0,1,0,5
Richmond,"Rioli, Daniel",10,4,2,6,1,0,0,5
Richmond,"Short, Jayden",22,19,3,3,0,0,0,0
Richmond,"Soldo, Ivan",10,4,2,6,0,0,20,1
Richmond,"Stack, Sydney",15,8,5,7,4,0,0,4
Richmond,"Vlastuin, Nick",26,12,11,14,0,0,0,3
Richmond,"Astbury, David",10,6,1,4,0,0,0,0
Richmond,"Bolton, Shai",26,15,9,11,2,0,0,4
Richmond,"Broad, Nathan",17,9,8,8,0,0,0,1
Richmond,"Castagna, Jason",18,12,10,6,5,2,0,2
Richmond,"Chol, Mabior",10,7,3,3,1,1,9,2
Richmond,"Cotchin, Trent",27,13,4,14,2,0,0,2
Richmond,"Edwards, Shane",25,10,5,15,0,0,0,4
Richmond,"Eggmolesse-Smith, Derek",19,11,2,8,0,0,0,3
Richmond,"Ellis, Brandon",23,14,7,9,1,0,0,0
Richmond,"Graham, Jack",23,8,4,15,0,0,0,7
Richmond,"Grimes, Dylan",16,8,5,8,0,0,0,2
Richmond,"Houli, Bachar",24,13,2,11,0,0,0,2
Richmond,"Lambert, Kane",24,13,6,11,3,0,0,4
Richmond,"Lynch, Tom",8,6,6,2,3,2,0,0
Richmond,"Martin, Dustin",19,10,1,9,0,0,0,2
Richmond,"McIntosh, Kamdyn",18,11,2,7,1,0,0,2
Richmond,"Prestia, Dion",28,12,4,16,1,0,0,9
Richmond,"Rioli, Daniel",14,11,7,3,2,3,0,1
Richmond,"Short, Jayden",22,13,5,9,0,0,0,0
Richmond,"Soldo, Ivan",8,5,4,3,1,0,25,6
Richmond,"Stack, Sydney",19,9,3,10,1,1,0,2
Richmond,"Vlastuin, Nick",17,8,5,9,0,0,0,3
Richmond,"Astbury, David",17,10,6,7,0,0,0,1
Richmond,"Bolton, Shai",29,14,6,15,1,0,0,6
Richmond,"Broad, Nathan",20,8,5,12,0,0,0,1
Richmond,"Castagna, Jason",17,10,4,7,2,2,0,2
Richmond,"Chol, Mabior",10,6,1,4,1,1,8,2
Richmond,"Cotchin, Trent",20,9,3,11,0,0,0,9
Richmond,"Edwards, Shane",16,7,1,9,1,1,0,1
Richmond,"Eggmolesse-Smith, Derek",16,8,2,8,0,0,0,1
Richmond,"Ellis, Brandon",29,18,4,11,0,2,0,4
Richmond,"Grimes, Dylan",15,7,4,8,0,0,0,1
Richmond,"Houli, Bachar",30,20,8,10,0,0,0,3
Richmond,"Lambert, Kane",19,10,6,9,3,2,0,3
Richmond,"Lynch, Tom",18,9,4,9,3,0,0,1
Richmond,"Martin, Dustin",25,15,3,10,0,1,0,2
Richmond,"McIntosh, Kamdyn",12,9,2,3,0,0,0,1
Richmond,"Prestia, Dion",24,11,3,13,0,0,0,4
Richmond,"Riewoldt, Jack",10,9,3,1,1,1,0,2
Richmond,"Rioli, Daniel",18,8,6,10,0,1,0,3
Richmond,"Short, Jayden",16,11,1,5,0,0,0,6
Richmond,"Soldo, Ivan",8,5,1,3,0,2,25,6
Richmond,"Stack, Sydney",18,10,4,8,1,1,0,3
Richmond,"Vlastuin, Nick",18,13,7,5,0,0,0,1
Richmond,"Astbury, David",16,10,5,6,0,0,0,1
Richmond,"Baker, Liam",20,6,1,14,0,0,0,3
Richmond,"Bolton, Shai",22,6,3,16,0,0,0,3
Richmond,"Broad, Nathan",17,8,5,9,0,0,0,0
Richmond,"Castagna, Jason",19,10,4,9,1,1,0,4
Richmond,"Chol, Mabior",10,5,2,5,1,0,7,5
Richmond,"Cotchin, Trent",22,12,2,10,0,0,0,6
Richmond,"Edwards, Shane",19,6,5,13,1,0,0,1
Richmond,"Ellis, Brandon",27,13,5,14,1,0,0,0
Richmond,"Graham, Jack",18,9,2,9,1,0,0,6
Richmond,"Grimes, Dylan",13,9,8,4,0,0,0,3
Richmond,"Houli, Bachar",28,10,4,18,0,0,0,1
Richmond,"Lambert, Kane",22,9,3,13,0,0,0,4
Richmond,"Lynch, Tom",19,13,9,6,3,4,0,1
Richmond,"Martin, Dustin",30,15,3,15,1,0,0,1
Richmond,"Prestia, Dion",30,16,6,14,1,1,0,4
Richmond,"Riewoldt, Jack",10,10,5,0,3,1,0,1
Richmond,"Rioli, Daniel",16,6,3,10,1,0,0,3
Richmond,"Short, Jayden",15,8,1,7,0,0,0,2
Richmond,"Soldo, Ivan",10,6,5,4,1,0,27,2
Richmond,"Stack, Sydney",18,3,3,15,0,2,0,4
Richmond,"Vlastuin, Nick",21,12,8,9,0,0,0,2
Richmond,"Astbury, David",12,9,6,3,0,0,0,1
Richmond,"Baker, Liam",15,7,2,8,0,0,0,2
Richmond,"Bolton, Shai",16,9,1,7,1,2,0,7
Richmond,"Broad, Nathan",12,7,4,5,0,0,0,1
Richmond,"Castagna, Jason",19,9,3,10,0,2,0,1
Richmond,"Chol, Mabior",7,7,2,0,1,1,6,1
Richmond,"Cotchin, Trent",6,5,1,1,0,0,0,0
Richmond,"Edwards, Shane",19,6,5,13,0,0,0,2
Richmond,"Ellis, Brandon",14,8,4,6,0,0,0,2
Richmond,"Graham, Jack",18,10,0,8,0,0,0,13
Richmond,"Grimes, Dylan",14,11,8,3,0,0,0,1
Richmond,"Houli, Bachar",31,21,10,10,0,0,0,1
Richmond,"Lambert, Kane",21,12,7,9,2,0,0,4
Richmond,"Lynch, Tom",16,13,6,3,5,1,0,0
Richmond,"Martin, Dustin",38,22,6,16,2,0,0,2
Richmond,"Prestia, Dion",35,23,4,12,0,0,0,4
Richmond,"Riewoldt, Jack",12,10,5,2,1,1,0,1
Richmond,"Rioli, Daniel",16,9,1,7,0,2,0,4
Richmond,"Short, Jayden",26,19,9,7,0,0,0,2
Richmond,"Soldo, Ivan",10,6,2,4,1,0,15,3
Richmond,"Stack, Sydney",20,8,3,12,1,2,0,3
Richmond,"Vlastuin, Nick",27,17,6,10,0,0,0,4
Richmond,"Astbury, David",16,12,8,4,0,0,0,0
Richmond,"Baker, Liam",10,3,3,7,0,0,0,0
Richmond,"Bolton, Shai",11,9,6,2,1,4,0,2
Richmond,"Broad, Nathan",12,7,4,5,0,0,0,3
Richmond,"Butler, Dan",8,7,3,1,0,1,0,4
Richmond,"Caddy, Josh",13,5,4,8,1,0,0,2
Richmond,"Castagna, Jason",17,10,5,7,1,0,0,1
Richmond,"Chol, Mabior",3,2,2,1,1,0,6,3
Richmond,"Edwards, Shane",31,13,2,18,0,1,0,2
Richmond,"Ellis, Brandon",21,13,5,8,0,0,0,1
Richmond,"Graham, Jack",18,9,1,9,2,0,0,5
Richmond,"Grimes, Dylan",9,5,6,4,0,0,0,0
Richmond,"Houli, Bachar",32,21,7,11,0,0,0,3
Richmond,"Lambert, Kane",16,12,5,4,1,0,0,3
Richmond,"Lynch, Tom",11,10,4,1,3,0,0,1
Richmond,"Martin, Dustin",34,18,6,16,1,1,0,2
Richmond,"Prestia, Dion",31,16,6,15,0,1,0,2
Richmond,"Riewoldt, Jack",14,12,6,2,0,3,0,0
Richmond,"Rioli, Daniel",12,5,3,7,1,1,0,4
Richmond,"Short, Jayden",24,15,10,9,0,0,0,0
Richmond,"Soldo, Ivan",13,8,1,5,1,0,14,4
Richmond,"Vlastuin, Nick",24,13,7,11,0,0,0,1
Richmond,"Astbury, David",12,6,3,6,0,0,0,0
Richmond,"Baker, Liam",22,11,4,11,0,0,0,2
Richmond,"Bolton, Shai",11,6,0,5,0,0,0,5
Richmond,"Broad, Nathan",19,8,3,11,0,0,0,3
Richmond,"Caddy, Josh",18,13,2,5,1,0,0,5
Richmond,"Castagna, Jason",22,9,5,13,1,1,0,6
Richmond,"Chol, Mabior",4,1,0,3,0,0,6,6
Richmond,"Edwards, Shane",27,11,6,16,1,0,0,9
Richmond,"Ellis, Brandon",22,14,5,8,0,0,0,7
Richmond,"Graham, Jack",22,19,2,3,4,0,0,14
Richmond,"Grimes, Dylan",6,6,2,0,0,0,0,5
Richmond,"Houli, Bachar",22,14,6,8,0,0,0,1
Richmond,"Lambert, Kane",25,10,3,15,0,0,0,2
Richmond,"Lynch, Tom",10,10,4,0,2,3,0,4
Richmond,"Nankervis, Toby",15,7,2,8,0,0,34,5
Richmond,"Prestia, Dion",35,19,3,16,0,1,0,4
Richmond,"Riewoldt, Jack",6,6,2,0,2,1,0,2
Richmond,"Rioli, Daniel",10,4,4,6,0,0,0,2
Richmond,"Ross, Jack",21,10,1,11,0,0,0,7
Richmond,"Short, Jayden",18,16,6,2,0,0,0,2
Richmond,"Stack, Sydney",12,5,3,7,0,0,0,0
Richmond,"Vlastuin, Nick",17,13,6,4,0,0,0,2
Richmond,"Astbury, David",13,10,4,3,0,0,0,0
Richmond,"Baker, Liam",11,6,1,5,0,0,0,1
Richmond,"Bolton, Shai",11,6,2,5,1,1,0,6
Richmond,"Broad, Nathan",10,8,4,2,0,0,0,3
Richmond,"Caddy, Josh",12,8,4,4,1,1,0,1
Richmond,"Castagna, Jason",10,4,1,6,1,1,0,8
Richmond,"Chol, Mabior",4,2,1,2,0,1,10,5
Richmond,"Edwards, Shane",29,21,1,8,1,0,0,2
Richmond,"Ellis, Brandon",21,9,5,12,0,0,0,1
Richmond,"Graham, Jack",11,9,0,2,0,0,0,2
Richmond,"Grimes, Dylan",17,8,8,9,0,0,0,1
Richmond,"Houli, Bachar",34,21,9,13,0,0,0,2
Richmond,"Lambert, Kane",14,10,2,4,1,1,0,2
Richmond,"Lynch, Tom",17,11,4,6,3,1,0,4
Richmond,"Martin, Dustin",35,27,4,8,1,0,0,4
Richmond,"Prestia, Dion",29,13,4,16,0,0,0,5
Richmond,"Riewoldt, Jack",15,14,4,1,2,1,0,3
Richmond,"Rioli, Daniel",11,6,4,5,0,0,0,1
Richmond,"Ross, Jack",11,8,3,3,0,1,0,1
Richmond,"Short, Jayden",15,9,3,6,1,0,0,2
Richmond,"Soldo, Ivan",12,5,0,7,1,0,40,2
Richmond,"Vlastuin, Nick",13,8,2,5,0,0,0,3
Richmond,"Astbury, David",9,5,2,4,0,0,0,2
Richmond,"Baker, Liam",20,11,7,9,0,0,0,4
Richmond,"Balta, Noah",5,3,0,2,0,1,10,1
Richmond,"Bolton, Shai",7,4,3,3,0,1,0,1
Richmond,"Broad, Nathan",7,4,2,3,0,0,0,1
Richmond,"Caddy, Josh",19,9,7,10,0,0,0,3
Richmond,"Castagna, Jason",18,10,5,8,1,1,0,3
Richmond,"Cotchin, Trent",15,5,2,10,0,0,0,0
Richmond,"Edwards, Shane",21,5,1,16,0,0,0,6
Richmond,"Ellis, Brandon",14,5,1,9,1,0,0,2
Richmond,"Graham, Jack",19,12,2,7,0,1,0,3
Richmond,"Grimes, Dylan",12,5,4,7,0,0,0,3
Richmond,"Houli, Bachar",30,15,5,15,0,0,0,2
Richmond,"Lambert, Kane",19,9,4,10,2,0,0,1
Richmond,"Lynch, Tom",9,7,7,2,1,1,0,1
Richmond,"Martin, Dustin",21,10,4,11,2,0,0,1
Richmond,"Prestia, Dion",30,19,0,11,0,1,0,4
Richmond,"Riewoldt, Jack",14,10,7,4,4,0,0,1
Richmond,"Rioli, Daniel",11,7,3,4,1,1,0,2
Richmond,"Short, Jayden",23,16,7,7,0,0,0,1
Richmond,"Soldo, Ivan",14,7,5,7,0,0,29,3
Richmond,"Vlastuin, Nick",19,13,9,6,0,0,0,2
Richmond,"Astbury, David",14,8,7,6,0,0,0,2
Richmond,"Baker, Liam",16,6,2,10,0,0,0,1
Richmond,"Bolton, Shai",13,6,2,7,1,0,0,4
Richmond,"Broad, Nathan",2,2,1,0,0,0,0,0
Richmond,"Caddy, Josh",14,9,2,5,2,0,0,2
Richmond,"Castagna, Jason",14,10,4,4,1,0,0,3
Richmond,"Cotchin, Trent",19,12,2,7,0,1,0,2
Richmond,"Edwards, Shane",29,13,6,16,1,0,0,6
Richmond,"Ellis, Brandon",17,11,4,6,0,0,0,3
Richmond,"Graham, Jack",14,7,1,7,0,0,0,8
Richmond,"Grimes, Dylan",12,7,6,5,0,0,0,1
Richmond,"Houli, Bachar",15,8,3,7,0,0,0,1
Richmond,"Lambert, Kane",20,12,2,8,0,0,0,5
Richmond,"Lynch, Tom",12,7,6,5,2,0,0,1
Richmond,"Martin, Dustin",14,9,1,5,6,0,0,3
Richmond,"Nankervis, Toby",5,1,0,4,0,0,24,5
Richmond,"Prestia, Dion",32,15,2,17,0,0,0,10
Richmond,"Riewoldt, Jack",6,6,1,0,3,0,0,4
Richmond,"Rioli, Daniel",7,6,0,1,2,1,0,6
Richmond,"Short, Jayden",15,13,3,2,0,0,0,3
Richmond,"Soldo, Ivan",7,4,1,3,0,0,25,4
Richmond,"Vlastuin, Nick",18,14,3,4,0,0,0,4
Richmond,"Astbury, David",13,10,8,3,0,0,0,0
Richmond,"Baker, Liam",18,13,3,5,0,0,0,3
Richmond,"Bolton, Shai",10,6,1,4,0,1,0,0
Richmond,"Broad, Nathan",3,1,1,2,0,0,0,2
Richmond,"Caddy, Josh",13,8,3,5,0,1,0,3
Richmond,"Castagna, Jason",12,9,5,3,2,2,0,1
Richmond,"Cotchin, Trent",14,7,2,7,0,0,0,6
Richmond,"Edwards, Shane",18,5,0,13,0,0,0,6
Richmond,"Ellis, Brandon",18,9,3,9,0,0,0,2
Richmond,"Graham, Jack",7,5,0,2,0,1,0,5
Richmond,"Grimes, Dylan",9,7,5,2,0,0,0,2
Richmond,"Houli, Bachar",32,22,11,10,0,0,0,2
Richmond,"Lambert, Kane",18,10,4,8,1,0,0,7
Richmond,"Lynch, Tom",19,11,10,8,5,1,0,0
Richmond,"Martin, Dustin",22,18,6,4,2,2,0,1
Richmond,"Nankervis, Toby",5,1,0,4,0,0,11,2
Richmond,"Prestia, Dion",28,19,5,9,2,0,0,5
Richmond,"Riewoldt, Jack",6,4,4,2,0,3,0,4
Richmond,"Rioli, Daniel",9,2,0,7,0,0,0,2
Richmond,"Short, Jayden",13,12,2,1,0,0,0,0
Richmond,"Soldo, Ivan",10,6,4,4,0,0,23,5
Richmond,"Vlastuin, Nick",14,11,5,3,0,0,0,2
Richmond,"Astbury, David",11,9,7,2,0,0,0,0
Richmond,"Baker, Liam",12,6,4,6,0,0,0,0
Richmond,"Bolton, Shai",11,6,3,5,1,0,0,4
Richmond,"Broad, Nathan",13,10,5,3,0,0,0,0
Richmond,"Caddy, Josh",19,16,8,3,0,0,0,6
Richmond,"Castagna, Jason",20,14,6,6,0,5,0,0
Richmond,"Cotchin, Trent",15,9,5,6,1,0,0,2
Richmond,"Edwards, Shane",21,9,2,12,0,0,0,6
Richmond,"Ellis, Brandon",11,5,1,6,0,0,0,0
Richmond,"Grimes, Dylan",14,10,11,4,0,0,0,4
Richmond,"Houli, Bachar",26,14,7,12,0,0,0,6
Richmond,"Lambert, Kane",19,7,3,12,1,0,0,3
Richmond,"Lynch, Tom",13,9,7,4,2,0,0,1
Richmond,"Martin, Dustin",22,11,4,11,4,0,0,1
Richmond,"Nankervis, Toby",17,6,5,11,0,1,22,3
Richmond,"Pickett, Marlion",22,13,2,9,1,0,0,1
Richmond,"Prestia, Dion",22,19,1,3,0,1,0,3
Richmond,"Riewoldt, Jack",13,11,8,2,5,1,0,0
Richmond,"Rioli, Daniel",12,6,2,6,1,1,0,4
Richmond,"Short, Jayden",19,12,6,7,0,0,0,4
Richmond,"Soldo, Ivan",7,4,4,3,1,0,20,2
Richmond,"Vlastuin, Nick",22,17,12,5,0,0,0,3
St Kilda,"Battle, Josh",18,11,6,7,0,0,0,1
St Kilda,"Billings, Jack",28,14,4,14,0,0,0,1
St Kilda,"Bruce, Josh",18,9,4,9,3,1,6,2
St Kilda,"Dunstan, Luke",18,11,3,7,0,0,0,7
St Kilda,"Geary, Jarryn",18,8,3,10,0,1,0,3
St Kilda,"Gresham, Jade",19,12,2,7,1,0,0,2
St Kilda,"Joyce, Darragh",18,10,3,8,0,0,0,2
St Kilda,"Kent, Dean",8,6,3,2,1,0,0,3
St Kilda,"Long, Ben",12,9,4,3,1,0,0,5
St Kilda,"Lonie, Jack",22,14,6,8,1,1,0,4
St Kilda,"McKenzie, Daniel",14,6,2,8,0,0,0,5
St Kilda,"Membrey, Tim",11,8,7,3,2,0,0,3
St Kilda,"Newnes, Jack",23,18,4,5,0,0,0,5
St Kilda,"Parker, Matthew",17,11,5,6,2,0,0,3
St Kilda,"Pierce, Lewis",6,2,0,4,0,0,27,2
St Kilda,"Ross, Sebastian",27,16,4,11,0,0,0,0
St Kilda,"Savage, Shane",15,12,5,3,0,0,0,1
St Kilda,"Sinclair, Jack",20,13,4,7,1,0,0,4
St Kilda,"Steele, Jack",22,11,5,11,1,0,0,10
St Kilda,"Steven, Jack",23,14,2,9,0,0,0,5
St Kilda,"Webster, Jimmy",20,13,1,7,0,0,0,1
St Kilda,"Wilkie, Callum",11,6,4,5,0,0,0,2
St Kilda,"Acres, Blake",12,6,3,6,0,1,0,1
St Kilda,"Battle, Josh",7,6,3,1,0,0,0,2
St Kilda,"Billings, Jack",28,13,6,15,0,1,0,2
St Kilda,"Brown, Nathan",7,4,4,3,0,0,0,2
St Kilda,"Bruce, Josh",15,6,3,9,2,2,3,4
St Kilda,"Dunstan, Luke",16,5,2,11,1,0,0,3
St Kilda,"Geary, Jarryn",20,10,5,10,0,0,0,1
St Kilda,"Gresham, Jade",25,16,5,9,2,0,0,1
St Kilda,"Kent, Dean",15,10,3,5,1,3,0,1
St Kilda,"Lonie, Jack",12,8,1,4,0,0,0,3
St Kilda,"Marshall, Rowan",14,9,5,5,0,0,21,6
St Kilda,"McKenzie, Daniel",7,5,1,2,0,0,0,3
St Kilda,"Membrey, Tim",9,4,1,5,2,2,0,2
St Kilda,"Newnes, Jack",25,17,5,8,0,2,0,4
St Kilda,"Parker, Matthew",11,5,3,6,1,0,0,5
St Kilda,"Ross, Sebastian",23,12,2,11,0,0,0,6
St Kilda,"Savage, Shane",16,13,6,3,0,0,0,0
St Kilda,"Sinclair, Jack",13,8,2,5,1,1,0,9
St Kilda,"Steele, Jack",23,12,3,11,0,1,0,7
St Kilda,"Steven, Jack",19,10,2,9,0,1,0,5
St Kilda,"Webster, Jimmy",21,13,1,8,0,0,0,0
St Kilda,"Wilkie, Callum",9,7,4,2,0,0,0,3
St Kilda,"Acres, Blake",8,5,1,3,1,0,5,3
St Kilda,"Battle, Josh",17,13,9,4,0,0,0,2
St Kilda,"Billings, Jack",32,15,5,17,2,0,0,1
St Kilda,"Brown, Nathan",13,6,3,7,0,0,0,0
St Kilda,"Bruce, Josh",10,5,3,5,1,1,1,1
St Kilda,"Clark, Hunter",15,6,1,9,0,1,0,1
St Kilda,"Dunstan, Luke",20,14,4,6,0,1,0,8
St Kilda,"Geary, Jarryn",21,14,7,7,0,0,0,5
St Kilda,"Gresham, Jade",20,13,3,7,2,1,0,2
St Kilda,"Kent, Dean",15,10,3,5,0,1,0,0
St Kilda,"Lonie, Jack",15,7,2,8,1,0,0,4
St Kilda,"Marshall, Rowan",16,12,5,4,0,0,40,6
St Kilda,"McKenzie, Daniel",13,8,4,5,0,0,0,3
St Kilda,"Membrey, Tim",16,11,5,5,2,1,0,3
St Kilda,"Newnes, Jack",25,12,4,13,0,0,0,3
St Kilda,"Parker, Matthew",11,6,2,5,0,1,0,4
St Kilda,"Ross, Sebastian",21,10,1,11,0,1,0,2
St Kilda,"Savage, Shane",17,11,5,6,0,0,0,4
St Kilda,"Sinclair, Jack",9,0,0,9,0,0,0,4
St Kilda,"Steele, Jack",22,17,8,5,0,1,0,8
St Kilda,"Webster, Jimmy",19,13,2,6,0,0,0,3
St Kilda,"Wilkie, Callum",12,7,4,5,0,0,0,1
St Kilda,"Acres, Blake",26,14,7,12,1,0,2,1
St Kilda,"Battle, Josh",16,11,7,5,0,0,0,2
St Kilda,"Billings, Jack",34,17,6,17,0,1,0,5
St Kilda,"Brown, Nathan",5,3,2,2,0,0,0,1
St Kilda,"Bruce, Josh",7,5,5,2,1,0,0,2
St Kilda,"Clark, Hunter",14,6,4,8,0,0,0,2
St Kilda,"Gresham, Jade",26,15,1,11,0,0,0,2
St Kilda,"Kent, Dean",8,6,4,2,0,0,0,1
St Kilda,"Long, Ben",11,7,3,4,2,0,0,4
St Kilda,"Lonie, Jack",17,12,1,5,3,5,0,5
St Kilda,"Marshall, Rowan",17,8,3,9,1,1,28,1
St Kilda,"McKenzie, Daniel",4,3,1,1,0,0,0,3
St Kilda,"Membrey, Tim",9,5,3,4,0,1,0,3
St Kilda,"Newnes, Jack",26,18,7,8,1,1,0,2
St Kilda,"Parker, Matthew",5,3,0,2,0,1,0,4
St Kilda,"Paton, Ben",15,9,3,6,0,0,0,1
St Kilda,"Ross, Sebastian",39,21,2,18,1,0,0,4
St Kilda,"Savage, Shane",27,14,3,13,0,0,0,3
St Kilda,"Sinclair, Jack",22,11,2,11,0,1,0,6
St Kilda,"Steele, Jack",27,8,3,19,0,0,0,7
St Kilda,"Webster, Jimmy",14,7,4,7,0,0,0,2
St Kilda,"Wilkie, Callum",21,12,3,9,0,0,0,3
St Kilda,"Acres, Blake",19,10,5,9,1,0,0,6
St Kilda,"Battle, Josh",13,8,7,5,0,0,0,1
St Kilda,"Billings, Jack",28,12,7,16,2,0,0,1
St Kilda,"Brown, Nathan",9,4,5,5,0,0,2,1
St Kilda,"Bruce, Josh",10,5,2,5,2,0,0,3
St Kilda,"Geary, Jarryn",22,11,4,11,0,0,0,3
St Kilda,"Gresham, Jade",23,11,5,12,0,1,0,1
St Kilda,"Kent, Dean",20,16,7,4,3,0,0,2
St Kilda,"Long, Ben",10,7,3,3,1,0,0,2
St Kilda,"Lonie, Jack",15,12,8,3,1,0,0,0
St Kilda,"Marshall, Rowan",13,5,2,8,0,0,14,2
St Kilda,"Membrey, Tim",12,8,8,4,4,1,0,4
St Kilda,"Newnes, Jack",23,14,7,9,0,1,0,0
St Kilda,"Parker, Matthew",8,5,2,3,1,0,0,3
St Kilda,"Paton, Ben",23,11,2,12,0,0,0,3
St Kilda,"Ross, Sebastian",27,17,4,10,0,0,0,6
St Kilda,"Savage, Shane",27,18,7,9,0,0,0,2
St Kilda,"Sinclair, Jack",22,9,3,13,0,0,0,2
St Kilda,"Steele, Jack",20,11,4,9,0,0,0,8
St Kilda,"Steven, Jack",20,14,0,6,0,1,0,4
St Kilda,"Webster, Jimmy",20,13,5,7,0,0,0,2
St Kilda,"Wilkie, Callum",17,10,8,7,0,0,0,2
St Kilda,"Acres, Blake",15,7,1,8,0,0,0,4
St Kilda,"Battle, Josh",21,17,9,4,0,0,0,4
St Kilda,"Billings, Jack",24,11,7,13,0,0,0,3
St Kilda,"Brown, Nathan",9,2,1,7,0,0,0,4
St Kilda,"Bruce, Josh",7,3,2,4,0,1,0,0
St Kilda,"Gresham, Jade",19,10,2,9,1,1,0,2
St Kilda,"Kent, Dean",7,4,1,3,1,0,0,2
St Kilda,"Long, Ben",9,5,2,4,1,0,0,6
St Kilda,"Longer, Billy",10,5,5,5,0,0,24,2
St Kilda,"Lonie, Jack",4,4,3,0,0,2,0,0
St Kilda,"McKenzie, Daniel",19,12,12,7,0,0,0,0
St Kilda,"Membrey, Tim",11,6,5,5,2,0,0,1
St Kilda,"Newnes, Jack",23,14,9,9,0,0,0,1
St Kilda,"Parker, Matthew",10,6,5,4,3,0,0,2
St Kilda,"Paton, Ben",18,11,5,7,1,0,0,5
St Kilda,"Ross, Sebastian",26,21,5,5,0,1,0,8
St Kilda,"Savage, Shane",30,17,10,13,0,0,0,3
St Kilda,"Sinclair, Jack",19,8,6,11,0,0,0,8
St Kilda,"Steele, Jack",21,8,3,13,0,1,0,8
St Kilda,"Steven, Jack",22,14,4,8,1,1,0,3
St Kilda,"Webster, Jimmy",15,6,2,9,0,0,0,5
St Kilda,"Wilkie, Callum",14,6,2,8,0,0,0,1
St Kilda,"Acres, Blake",9,5,0,4,1,0,1,3
St Kilda,"Battle, Josh",13,8,2,5,0,0,0,0
St Kilda,"Billings, Jack",19,8,6,11,0,0,0,2
St Kilda,"Bruce, Josh",7,5,3,2,0,1,2,1
St Kilda,"Clark, Hunter",10,4,2,6,0,0,0,6
St Kilda,"Gresham, Jade",18,10,2,8,0,0,0,1
St Kilda,"Joyce, Darragh",11,6,0,5,0,0,0,2
St Kilda,"Kent, Dean",16,12,8,4,2,4,0,4
St Kilda,"Long, Ben",5,1,1,4,0,0,0,0
St Kilda,"Marsh, Jonathon",6,5,3,1,1,1,0,1
St Kilda,"Marshall, Rowan",22,15,1,7,2,0,27,3
St Kilda,"McKenzie, Daniel",10,4,3,6,0,0,0,2
St Kilda,"Membrey, Tim",10,7,4,3,1,0,0,1
St Kilda,"Newnes, Jack",19,15,5,4,0,1,0,3
St Kilda,"Parker, Matthew",12,8,2,4,2,1,0,2
St Kilda,"Paton, Ben",14,6,2,8,0,0,0,0
St Kilda,"Ross, Sebastian",26,15,1,11,0,1,0,5
St Kilda,"Savage, Shane",19,12,5,7,0,0,0,4
St Kilda,"Sinclair, Jack",15,11,5,4,1,0,0,2
St Kilda,"Steele, Jack",24,11,3,13,0,0,0,3
St Kilda,"Webster, Jimmy",9,6,2,3,0,0,0,0
St Kilda,"Wilkie, Callum",13,6,1,7,0,0,0,0
St Kilda,"Acres, Blake",18,10,5,8,0,0,0,3
St Kilda,"Battle, Josh",21,17,9,4,0,0,0,4
St Kilda,"Billings, Jack",25,11,6,14,2,0,0,1
St Kilda,"Brown, Nathan",7,7,3,0,0,0,0,0
St Kilda,"Bruce, Josh",15,9,10,6,1,1,2,1
St Kilda,"Dunstan, Luke",26,15,4,11,0,1,0,5
St Kilda,"Gresham, Jade",20,14,5,6,1,2,0,2
St Kilda,"Kent, Dean",13,12,4,1,2,1,0,1
St Kilda,"Long, Ben",3,2,1,1,0,1,0,3
St Kilda,"Marshall, Rowan",14,6,1,8,0,0,23,2
St Kilda,"McKenzie, Daniel",15,7,4,8,0,0,0,1
St Kilda,"Membrey, Tim",15,8,7,7,1,1,0,1
St Kilda,"Newnes, Jack",14,7,2,7,0,1,0,3
St Kilda,"Parker, Matthew",8,4,3,4,0,1,0,2
St Kilda,"Paton, Ben",19,11,4,8,0,0,0,2
St Kilda,"Phillips, Ed",23,12,4,11,0,0,0,0
St Kilda,"Ross, Sebastian",31,16,5,15,0,0,0,0
St Kilda,"Savage, Shane",25,16,8,9,1,0,0,0
St Kilda,"Sinclair, Jack",17,10,4,7,1,0,0,4
St Kilda,"Steele, Jack",22,8,6,14,1,0,0,4
St Kilda,"Webster, Jimmy",18,14,4,4,0,0,0,2
St Kilda,"Wilkie, Callum",19,15,5,4,0,0,0,0
St Kilda,"Acres, Blake",13,5,1,8,0,1,0,5
St Kilda,"Battle, Josh",12,7,4,5,1,0,0,2
St Kilda,"Billings, Jack",29,18,8,11,0,0,0,1
St Kilda,"Brown, Nathan",8,5,4,3,0,0,0,2
St Kilda,"Bruce, Josh",7,5,3,2,1,0,0,3
St Kilda,"Dunstan, Luke",30,15,1,15,0,0,0,5
St Kilda,"Gresham, Jade",23,13,3,10,0,0,0,3
St Kilda,"Kent, Dean",11,8,6,3,0,1,0,5
St Kilda,"Marsh, Jonathon",12,9,6,3,0,0,0,2
St Kilda,"Marshall, Rowan",16,7,3,9,1,0,24,2
St Kilda,"McKenzie, Daniel",14,8,5,6,0,0,0,1
St Kilda,"Membrey, Tim",11,6,6,5,4,0,0,4
St Kilda,"Newnes, Jack",11,6,3,5,0,1,0,4
St Kilda,"Parker, Matthew",8,5,1,3,0,0,0,5
St Kilda,"Paton, Ben",11,7,2,4,0,0,0,3
St Kilda,"Phillips, Ed",13,6,3,7,0,0,0,0
St Kilda,"Ross, Sebastian",22,13,1,9,0,1,0,4
St Kilda,"Savage, Shane",25,16,4,9,1,2,0,4
St Kilda,"Sinclair, Jack",14,8,3,6,0,2,0,4
St Kilda,"Steele, Jack",25,6,4,19,0,0,0,7
St Kilda,"Wilkie, Callum",13,9,6,4,0,0,0,2
St Kilda,"Young, Robbie",8,6,2,2,2,1,0,4
St Kilda,"Acres, Blake",20,11,6,9,0,0,0,5
St Kilda,"Battle, Josh",15,12,8,3,0,0,0,3
St Kilda,"Billings, Jack",19,9,6,10,0,1,0,0
St Kilda,"Brown, Nathan",9,5,3,4,0,0,0,3
St Kilda,"Bruce, Josh",13,10,4,3,2,2,0,0
St Kilda,"Dunstan, Luke",20,10,4,10,1,0,0,4
St Kilda,"Gresham, Jade",29,15,6,14,0,0,0,2
St Kilda,"Kent, Dean",14,11,4,3,0,0,0,0
St Kilda,"Long, Ben",14,9,3,5,0,2,0,3
St Kilda,"Marsh, Jonathon",12,9,4,3,0,0,0,3
St Kilda,"Marshall, Rowan",13,7,3,6,0,0,34,6
St Kilda,"McKenzie, Daniel",14,4,2,10,0,0,0,3
St Kilda,"Membrey, Tim",11,7,6,4,2,2,0,3
St Kilda,"Newnes, Jack",13,9,4,4,1,0,0,2
St Kilda,"Parker, Matthew",13,11,5,2,2,1,0,1
St Kilda,"Phillips, Ed",12,7,4,5,1,0,0,3
St Kilda,"Ross, Sebastian",21,15,5,6,0,0,0,4
St Kilda,"Savage, Shane",20,13,1,7,0,1,0,1
St Kilda,"Sinclair, Jack",14,9,3,5,0,1,0,5
St Kilda,"Steele, Jack",28,10,5,18,0,0,0,10
St Kilda,"Wilkie, Callum",19,10,6,9,0,0,0,2
St Kilda,"Young, Robbie",5,4,1,1,0,0,0,0
St Kilda,"Battle, Josh",17,12,4,5,0,0,0,3
St Kilda,"Billings, Jack",14,11,5,3,1,0,0,1
St Kilda,"Brown, Nathan",7,1,0,6,0,0,0,0
St Kilda,"Bruce, Josh",14,11,5,3,0,1,3,3
St Kilda,"Coffield, Nick",10,7,3,3,0,0,0,0
St Kilda,"Dunstan, Luke",25,10,3,15,0,1,0,1
St Kilda,"Geary, Jarryn",13,4,1,9,0,0,0,1
St Kilda,"Gresham, Jade",20,13,0,7,3,1,0,5
St Kilda,"Joyce, Darragh",15,11,2,4,0,0,0,2
St Kilda,"Kent, Dean",12,10,6,2,0,3,0,1
St Kilda,"Long, Ben",11,8,6,3,1,0,0,3
St Kilda,"Marshall, Rowan",24,15,7,9,1,1,24,4
St Kilda,"Membrey, Tim",16,8,5,8,1,0,0,2
St Kilda,"Newnes, Jack",19,12,5,7,1,1,0,2
St Kilda,"Parker, Matthew",14,9,2,5,1,2,0,3
St Kilda,"Phillips, Ed",13,9,5,4,0,1,0,2
St Kilda,"Ross, Sebastian",23,16,2,7,0,0,0,1
St Kilda,"Savage, Shane",11,8,4,3,0,0,0,3
St Kilda,"Sinclair, Jack",20,11,2,9,0,3,0,1
St Kilda,"Steele, Jack",20,10,3,10,0,0,0,3
St Kilda,"Wilkie, Callum",13,7,5,6,0,0,0,2
St Kilda,"Young, Robbie",7,6,1,1,0,0,0,3
St Kilda,"Acres, Blake",22,10,4,12,0,0,0,4
St Kilda,"Armitage, David",17,11,5,6,0,0,0,2
St Kilda,"Battle, Josh",12,9,6,3,1,0,0,2
St Kilda,"Billings, Jack",33,20,8,13,2,1,0,11
St Kilda,"Brown, Nathan",6,3,2,3,0,0,0,2
St Kilda,"Bruce, Josh",10,5,4,5,0,0,3,0
St Kilda,"Clark, Hunter",18,7,2,11,0,0,0,1
St Kilda,"Dunstan, Luke",22,12,4,10,1,0,0,10
St Kilda,"Gresham, Jade",20,12,5,8,1,2,0,8
St Kilda,"Hind, Nick",7,4,2,3,1,0,0,2
St Kilda,"Kent, Dean",20,15,7,5,2,1,0,1
St Kilda,"Marsh, Jonathon",6,3,1,3,0,0,0,4
St Kilda,"Marshall, Rowan",18,13,5,5,0,0,40,4
St Kilda,"McKenzie, Daniel",10,6,4,4,0,0,0,5
St Kilda,"Membrey, Tim",17,12,10,5,3,2,0,1
St Kilda,"Newnes, Jack",17,11,3,6,0,0,0,3
St Kilda,"Parker, Matthew",11,8,3,3,0,2,0,5
St Kilda,"Ross, Sebastian",31,14,4,17,0,1,0,3
St Kilda,"Savage, Shane",18,12,3,6,0,0,0,2
St Kilda,"Sinclair, Jack",15,10,2,5,0,0,0,3
St Kilda,"White, Brandon",10,7,3,3,0,2,0,4
St Kilda,"Wilkie, Callum",17,12,6,5,0,0,0,1
St Kilda,"Acres, Blake",21,8,4,13,0,1,0,3
St Kilda,"Armitage, David",16,9,3,7,0,0,0,4
St Kilda,"Battle, Josh",16,15,8,1,0,0,0,7
St Kilda,"Billings, Jack",23,13,5,10,0,1,0,9
St Kilda,"Bruce, Josh",15,8,7,7,2,2,2,3
St Kilda,"Carlisle, Jake",11,6,4,5,0,1,0,0
St Kilda,"Clark, Hunter",19,8,7,11,0,0,0,1
St Kilda,"Dunstan, Luke",19,10,1,9,0,2,0,5
St Kilda,"Gresham, Jade",24,14,3,10,1,0,0,6
St Kilda,"Hannebery, Dan",27,15,4,12,0,1,0,5
St Kilda,"Hind, Nick",13,10,2,3,3,0,0,4
St Kilda,"Kent, Dean",7,4,3,3,0,0,0,3
St Kilda,"Marsh, Jonathon",5,3,1,2,0,0,0,1
St Kilda,"Marshall, Rowan",12,7,7,5,0,0,37,5
St Kilda,"McKenzie, Daniel",8,1,0,7,0,0,0,2
St Kilda,"Membrey, Tim",11,8,3,3,1,0,0,0
St Kilda,"Newnes, Jack",8,1,0,7,0,0,0,4
St Kilda,"Parker, Matthew",12,9,4,3,1,1,0,4
St Kilda,"Ross, Sebastian",30,17,5,13,0,1,0,4
St Kilda,"Savage, Shane",14,6,4,8,0,0,0,4
St Kilda,"Sinclair, Jack",18,15,5,3,0,0,0,3
St Kilda,"Wilkie, Callum",16,14,4,2,0,0,0,3
St Kilda,"Acres, Blake",17,12,7,5,1,0,0,4
St Kilda,"Battle, Josh",20,17,11,3,0,0,0,5
St Kilda,"Billings, Jack",26,16,6,10,0,1,0,1
St Kilda,"Bruce, Josh",13,9,4,4,3,0,0,0
St Kilda,"Carlisle, Jake",11,10,8,1,0,0,0,0
St Kilda,"Clark, Hunter",23,14,8,9,0,0,0,2
St Kilda,"Coffield, Nick",16,10,9,6,0,0,0,1
St Kilda,"Dunstan, Luke",18,11,5,7,0,1,0,3
St Kilda,"Gresham, Jade",22,11,7,11,0,1,0,2
St Kilda,"Hannebery, Dan",23,16,6,7,0,0,0,1
St Kilda,"Hind, Nick",15,10,4,5,2,2,0,0
St Kilda,"Long, Ben",14,9,8,5,1,1,0,3
St Kilda,"Marshall, Rowan",19,10,9,9,1,0,33,3
St Kilda,"McKenzie, Daniel",9,5,6,4,0,0,0,0
St Kilda,"Membrey, Tim",16,8,8,8,1,0,0,0
St Kilda,"Parker, Matthew",11,9,5,2,1,1,0,1
St Kilda,"Paton, Ben",13,9,4,4,0,0,0,3
St Kilda,"Ross, Sebastian",27,19,7,8,0,0,0,3
St Kilda,"Savage, Shane",19,15,11,4,0,0,0,0
St Kilda,"Sinclair, Jack",13,10,3,3,0,0,0,0
St Kilda,"Steele, Jack",11,7,3,4,0,1,0,8
St Kilda,"Wilkie, Callum",14,12,8,2,0,0,0,2
St Kilda,"Acres, Blake",19,7,5,12,0,1,0,4
St Kilda,"Battle, Josh",0,0,0,0,0,0,0,1
St Kilda,"Billings, Jack",35,24,5,11,0,0,0,6
St Kilda,"Bruce, Josh",17,12,7,5,6,0,0,4
St Kilda,"Carlisle, Jake",10,8,7,2,0,0,5,1
St Kilda,"Clark, Hunter",19,12,6,7,0,1,0,3
St Kilda,"Coffield, Nick",13,9,3,4,0,0,0,0
St Kilda,"Dunstan, Luke",27,16,6,11,0,0,0,9
St Kilda,"Gresham, Jade",18,6,1,12,1,0,0,4
St Kilda,"Hind, Nick",6,5,1,1,1,1,0,3
St Kilda,"Long, Ben",9,8,5,1,0,1,0,3
St Kilda,"Marshall, Rowan",21,8,2,13,1,0,31,6
St Kilda,"McKenzie, Daniel",12,8,3,4,0,0,0,3
St Kilda,"Membrey, Tim",15,6,2,9,2,0,0,1
St Kilda,"Newnes, Jack",19,15,5,4,0,0,0,5
St Kilda,"Parker, Matthew",7,2,0,5,0,0,0,5
St Kilda,"Paton, Ben",16,5,2,11,0,0,0,6
St Kilda,"Ross, Sebastian",15,10,4,5,0,0,0,2
St Kilda,"Savage, Shane",17,10,5,7,0,0,0,4
St Kilda,"Sinclair, Jack",15,8,0,7,0,1,0,2
St Kilda,"Steele, Jack",18,10,5,8,0,0,0,18
St Kilda,"Wilkie, Callum",12,9,9,3,0,0,1,2
St Kilda,"Acres, Blake",10,4,4,6,1,0,0,6
St Kilda,"Billings, Jack",24,17,5,7,0,0,0,8
St Kilda,"Brown, Nathan",4,0,0,4,0,0,0,2
St Kilda,"Bruce, Josh",10,6,4,4,3,2,1,3
St Kilda,"Carlisle, Jake",9,9,3,0,0,0,7,1
St Kilda,"Clark, Hunter",25,13,7,12,0,0,0,9
St Kilda,"Coffield, Nick",15,10,5,5,0,0,0,3
St Kilda,"Dunstan, Luke",30,17,4,13,0,1,0,2
St Kilda,"Gresham, Jade",28,16,5,12,0,0,0,6
St Kilda,"Hind, Nick",10,7,1,3,0,1,0,2
St Kilda,"Long, Ben",6,5,1,1,2,1,0,4
St Kilda,"Lonie, Jack",5,3,2,2,1,0,0,2
St Kilda,"Marshall, Rowan",21,13,5,8,1,0,32,3
St Kilda,"McKenzie, Daniel",4,2,2,2,0,0,0,2
St Kilda,"Membrey, Tim",10,5,4,5,0,1,0,1
St Kilda,"Newnes, Jack",18,12,6,6,0,1,0,4
St Kilda,"Paton, Ben",8,5,4,3,0,0,0,1
St Kilda,"Ross, Sebastian",22,14,2,8,0,0,0,5
St Kilda,"Savage, Shane",27,17,7,10,0,0,0,5
St Kilda,"Sinclair, Jack",14,9,2,5,0,0,0,2
St Kilda,"Steele, Jack",28,9,3,19,0,0,0,8
St Kilda,"Wilkie, Callum",13,12,6,1,0,0,0,4
St Kilda,"Acres, Blake",21,11,5,10,0,0,0,4
St Kilda,"Billings, Jack",27,15,8,12,2,1,0,1
St Kilda,"Brown, Nathan",10,5,4,5,0,0,0,4
St Kilda,"Bruce, Josh",11,5,4,6,1,1,2,2
St Kilda,"Carlisle, Jake",18,12,8,6,0,0,3,2
St Kilda,"Clark, Hunter",26,18,6,8,2,1,0,3
St Kilda,"Coffield, Nick",21,12,8,9,0,0,0,1
St Kilda,"Dunstan, Luke",22,9,3,13,0,1,1,5
St Kilda,"Gresham, Jade",22,17,3,5,1,1,0,3
St Kilda,"Hind, Nick",8,7,0,1,0,1,0,1
St Kilda,"Langlands, Doulton",12,4,4,8,1,0,0,3
St Kilda,"Lonie, Jack",20,17,8,3,4,3,0,2
St Kilda,"Marshall, Rowan",21,12,6,9,0,0,31,2
St Kilda,"Membrey, Tim",14,9,4,5,4,0,0,1
St Kilda,"Newnes, Jack",8,4,3,4,1,1,0,4
St Kilda,"Parker, Matthew",11,8,4,3,1,1,0,2
St Kilda,"Paton, Ben",19,15,8,4,0,0,0,3
St Kilda,"Ross, Sebastian",21,13,7,8,0,0,0,3
St Kilda,"Savage, Shane",23,17,8,6,0,1,0,1
St Kilda,"Sinclair, Jack",22,10,4,12,0,0,0,2
St Kilda,"Steele, Jack",15,7,2,8,0,0,0,7
St Kilda,"Wilkie, Callum",18,13,5,5,0,0,0,0
St Kilda,"Acres, Blake",15,9,7,6,0,0,0,9
St Kilda,"Billings, Jack",21,15,5,6,1,2,0,2
St Kilda,"Brown, Nathan",8,5,3,3,0,0,0,2
St Kilda,"Bruce, Josh",10,7,5,3,4,0,4,2
St Kilda,"Carlisle, Jake",14,9,7,5,0,0,0,1
St Kilda,"Clark, Hunter",23,10,3,13,0,1,0,6
St Kilda,"Coffield, Nick",18,13,9,5,0,0,0,2
St Kilda,"Dunstan, Luke",18,7,1,11,0,1,0,8
St Kilda,"Gresham, Jade",32,23,5,9,0,1,0,1
St Kilda,"Hind, Nick",14,10,2,4,1,1,0,1
St Kilda,"Langlands, Doulton",14,8,7,6,1,0,0,3
St Kilda,"Long, Ben",11,9,6,2,2,1,0,3
St Kilda,"Lonie, Jack",15,11,6,4,1,3,0,5
St Kilda,"Marshall, Rowan",16,11,1,5,0,0,22,3
St Kilda,"Membrey, Tim",11,8,4,3,3,1,0,0
St Kilda,"Newnes, Jack",12,7,2,5,0,0,0,1
St Kilda,"Paton, Ben",14,7,5,7,0,0,0,3
St Kilda,"Ross, Sebastian",31,14,7,17,2,0,0,9
St Kilda,"Savage, Shane",11,10,2,1,0,0,0,4
St Kilda,"Sinclair, Jack",26,11,3,15,0,0,0,1
St Kilda,"Steele, Jack",22,10,5,12,0,0,0,12
St Kilda,"Wilkie, Callum",15,9,5,6,0,0,0,1
St Kilda,"Battle, Josh",15,11,6,4,0,0,0,4
St Kilda,"Billings, Jack",26,14,7,12,0,0,0,4
St Kilda,"Brown, Nathan",8,4,4,4,0,0,0,0
St Kilda,"Bruce, Josh",11,6,3,5,1,3,1,1
St Kilda,"Carlisle, Jake",11,9,6,2,0,0,1,0
St Kilda,"Clark, Hunter",26,12,5,14,0,0,0,2
St Kilda,"Coffield, Nick",18,14,6,4,0,0,0,1
St Kilda,"Dunstan, Luke",24,10,1,14,0,0,0,5
St Kilda,"Gresham, Jade",22,16,8,6,1,2,0,2
St Kilda,"Hind, Nick",10,5,2,5,1,0,0,3
St Kilda,"Langlands, Doulton",11,6,3,5,0,0,0,2
St Kilda,"Long, Ben",4,2,2,2,1,0,0,1
St Kilda,"Lonie, Jack",8,7,3,1,1,1,0,3
St Kilda,"Marshall, Rowan",20,9,5,11,0,0,32,2
St Kilda,"McKenzie, Daniel",10,5,1,5,0,0,0,1
St Kilda,"Membrey, Tim",17,13,8,4,3,1,0,2
St Kilda,"Parker, Matthew",11,10,4,1,1,1,0,0
St Kilda,"Ross, Sebastian",25,12,6,13,1,0,0,4
St Kilda,"Savage, Shane",17,13,8,4,0,0,0,4
St Kilda,"Sinclair, Jack",13,8,2,5,0,0,0,4
St Kilda,"Steele, Jack",26,13,2,13,0,0,0,7
St Kilda,"Wilkie, Callum",14,11,9,3,0,0,0,2
St Kilda,"Acres, Blake",11,6,1,5,0,0,0,3
St Kilda,"Battle, Josh",16,12,6,4,1,0,0,5
St Kilda,"Billings, Jack",27,16,8,11,0,0,0,1
St Kilda,"Bruce, Josh",13,4,4,9,1,0,1,2
St Kilda,"Carlisle, Jake",11,6,4,5,0,0,1,1
St Kilda,"Clark, Hunter",26,14,6,12,0,0,0,4
St Kilda,"Coffield, Nick",8,5,3,3,0,0,0,1
St Kilda,"Dunstan, Luke",24,14,4,10,1,1,0,2
St Kilda,"Hannebery, Dan",23,15,6,8,2,0,0,6
St Kilda,"Hind, Nick",17,12,5,5,0,1,0,2
St Kilda,"Long, Ben",18,11,6,7,0,1,0,2
St Kilda,"Lonie, Jack",15,12,3,3,0,3,0,1
St Kilda,"Marshall, Rowan",20,9,5,11,0,0,16,1
St Kilda,"Membrey, Tim",16,9,6,7,2,1,0,1
St Kilda,"Newnes, Jack",21,13,7,8,0,0,0,0
St Kilda,"Paton, Ben",10,4,3,6,0,0,0,3
St Kilda,"Ross, Sebastian",28,13,2,15,0,1,0,9
St Kilda,"Savage, Shane",23,17,6,6,0,0,0,3
St Kilda,"Sinclair, Jack",14,8,3,6,0,0,0,5
St Kilda,"Steele, Jack",17,7,5,10,0,0,0,8
St Kilda,"Steven, Jack",22,12,7,10,3,1,0,2
St Kilda,"Wilkie, Callum",17,14,9,3,0,0,0,1
St Kilda,"Acres, Blake",21,11,3,10,0,1,0,2
St Kilda,"Battle, Josh",16,8,4,8,0,0,0,2
St Kilda,"Billings, Jack",26,17,7,9,1,1,0,2
St Kilda,"Brown, Nathan",12,5,2,7,0,0,0,1
St Kilda,"Bruce, Josh",16,9,5,7,0,1,2,1
St Kilda,"Carlisle, Jake",9,6,3,3,1,0,1,0
St Kilda,"Clark, Hunter",21,13,4,8,0,0,0,2
St Kilda,"Dunstan, Luke",16,9,4,7,0,0,0,3
St Kilda,"Hannebery, Dan",24,12,3,12,1,0,0,4
St Kilda,"Hind, Nick",13,11,1,2,2,1,0,2
St Kilda,"Long, Ben",9,5,5,4,1,1,0,1
St Kilda,"Lonie, Jack",16,11,3,5,0,0,0,3
St Kilda,"Marshall, Rowan",17,10,3,7,0,0,33,7
St Kilda,"Membrey, Tim",15,13,10,2,3,2,0,1
St Kilda,"Newnes, Jack",13,8,6,5,1,0,0,2
St Kilda,"Paton, Ben",11,9,6,2,0,0,0,2
St Kilda,"Ross, Sebastian",29,16,4,13,0,0,0,4
St Kilda,"Savage, Shane",14,8,3,6,0,0,0,0
St Kilda,"Sinclair, Jack",18,8,1,10,0,1,0,4
St Kilda,"Steele, Jack",20,6,3,14,0,0,0,14
St Kilda,"Steven, Jack",10,6,0,4,0,0,0,4
St Kilda,"Wilkie, Callum",16,11,1,5,0,0,0,3
St Kilda,"Acres, Blake",11,3,1,8,0,0,1,3
St Kilda,"Battle, Josh",15,10,6,5,0,1,0,2
St Kilda,"Billings, Jack",18,10,2,8,0,0,0,2
St Kilda,"Brown, Nathan",8,5,2,3,0,0,0,2
St Kilda,"Bruce, Josh",11,7,5,4,2,1,0,2
St Kilda,"Carlisle, Jake",12,9,7,3,0,0,0,1
St Kilda,"Clark, Hunter",22,16,3,6,0,0,0,1
St Kilda,"Dunstan, Luke",27,13,5,14,0,2,0,2
St Kilda,"Hannebery, Dan",28,14,3,14,0,1,0,5
St Kilda,"Hind, Nick",7,5,2,2,0,2,0,1
St Kilda,"Long, Ben",6,4,3,2,1,0,0,3
St Kilda,"Lonie, Jack",12,9,4,3,0,1,0,2
St Kilda,"Marshall, Rowan",21,12,5,9,0,0,27,1
St Kilda,"Membrey, Tim",13,12,8,1,1,1,0,2
St Kilda,"Newnes, Jack",9,5,2,4,0,0,0,1
St Kilda,"Ross, Sebastian",27,9,4,18,2,0,0,4
St Kilda,"Rowe, Sam",9,4,2,5,0,1,8,0
St Kilda,"Savage, Shane",17,13,2,4,0,0,0,2
St Kilda,"Sinclair, Jack",16,9,3,7,0,1,0,2
St Kilda,"Steele, Jack",27,14,5,13,1,2,0,7
St Kilda,"Steven, Jack",17,8,4,9,1,0,0,0
St Kilda,"Wilkie, Callum",11,9,3,2,0,0,0,5
Sydney,"Aliir, Aliir",15,9,4,6,0,0,2,1
Sydney,"Blakey, Nick",10,6,1,4,1,1,0,1
Sydney,"Clarke, Ryan",17,4,2,13,0,0,0,3
Sydney,"Cunningham, Harry",23,13,6,10,0,0,0,1
Sydney,"Dawson, Jordan",14,4,2,10,0,0,0,2
Sydney,"Florent, Oliver",13,6,4,7,0,0,0,2
Sydney,"Franklin, Lance",7,6,5,1,1,2,0,2
Sydney,"Grundy, Heath",11,7,3,4,0,0,3,2
Sydney,"Hayward, Will",9,6,3,3,1,1,0,6
Sydney,"Heeney, Isaac",19,6,5,13,2,0,0,5
Sydney,"Hewett, George",21,13,2,8,0,0,0,2
Sydney,"Jones, Zak",24,16,5,8,0,2,0,4
Sydney,"Kennedy, Josh",22,13,3,9,0,3,0,7
Sydney,"Lloyd, Jake",35,24,10,11,0,0,0,1
Sydney,"McVeigh, Jarrad",22,10,1,12,0,0,0,0
Sydney,"Melican, Lewis",8,5,3,3,0,0,0,4
Sydney,"Mills, Callum",20,11,3,9,1,0,0,2
Sydney,"Papley, Tom",19,11,6,8,1,0,0,6
Sydney,"Parker, Luke",22,12,3,10,0,0,0,7
Sydney,"Rampe, Dane",17,12,4,5,0,0,0,7
Sydney,"Reid, Sam",10,7,7,3,2,1,0,0
Sydney,"Sinclair, Callum",11,6,6,5,0,0,44,5
Sydney,"Aliir, Aliir",17,11,7,6,0,0,1,1
Sydney,"Blakey, Nick",7,4,2,3,1,0,0,0
Sydney,"Clarke, Ryan",9,6,4,3,0,0,0,0
Sydney,"Cunningham, Harry",20,11,7,9,0,0,0,3
Sydney,"Florent, Oliver",17,12,5,5,0,0,0,0
Sydney,"Franklin, Lance",16,11,2,5,3,3,0,1
Sydney,"Hayward, Will",14,5,2,9,2,0,0,4
Sydney,"Heeney, Isaac",15,5,3,10,0,1,1,3
Sydney,"Hewett, George",16,5,1,11,0,0,0,3
Sydney,"Jones, Zak",22,14,3,8,0,0,0,4
Sydney,"Kennedy, Josh",36,21,7,15,0,2,0,1
Sydney,"Lloyd, Jake",34,19,11,15,0,0,0,2
Sydney,"McVeigh, Jarrad",25,14,4,11,0,0,0,0
Sydney,"Melican, Lewis",13,7,5,6,0,0,0,2
Sydney,"Mills, Callum",16,7,7,9,0,0,0,1
Sydney,"ORiordan, Colin",15,8,5,7,0,0,0,2
Sydney,"Papley, Tom",17,14,4,3,0,2,0,6
Sydney,"Parker, Luke",26,15,4,11,0,1,0,5
Sydney,"Rampe, Dane",17,9,4,8,0,1,0,6
Sydney,"Reid, Sam",9,4,2,5,1,0,4,5
Sydney,"Ronke, Ben",7,6,1,1,1,1,0,3
Sydney,"Sinclair, Callum",13,6,2,7,0,0,22,1
Sydney,"Aliir, Aliir",14,10,9,4,0,0,0,1
Sydney,"Blakey, Nick",8,8,1,0,1,1,0,4
Sydney,"Cunningham, Harry",20,12,5,8,0,0,0,3
Sydney,"Dawson, Jordan",14,7,8,7,0,0,0,3
Sydney,"Florent, Oliver",19,11,4,8,0,0,0,2
Sydney,"Franklin, Lance",12,6,4,6,2,1,0,1
Sydney,"Hayward, Will",5,4,3,1,2,0,0,0
Sydney,"Heeney, Isaac",26,13,8,13,4,1,0,2
Sydney,"Hewett, George",17,6,2,11,0,0,0,6
Sydney,"Jones, Zak",31,16,6,15,0,1,0,3
Sydney,"Kennedy, Josh",31,15,3,16,1,0,0,8
Sydney,"Lloyd, Jake",32,20,9,12,0,0,0,2
Sydney,"McCartin, Tom",14,8,3,6,0,0,0,6
Sydney,"McVeigh, Jarrad",24,18,5,6,0,0,0,2
Sydney,"Mills, Callum",28,14,6,14,0,0,0,2
Sydney,"Papley, Tom",19,11,5,8,2,1,0,4
Sydney,"Parker, Luke",18,9,1,9,1,0,0,6
Sydney,"Rampe, Dane",20,13,5,7,0,0,0,3
Sydney,"Reid, Sam",14,8,5,6,0,1,6,5
Sydney,"Ronke, Ben",9,5,2,4,0,1,0,1
Sydney,"Sinclair, Callum",16,10,8,6,1,0,40,3
Sydney,"Thurlow, Jackson",19,12,4,7,0,0,0,3
Sydney,"Aliir, Aliir",18,9,7,9,0,0,0,2
Sydney,"Blakey, Nick",5,4,1,1,0,0,0,1
Sydney,"Cunningham, Harry",25,19,8,6,0,0,0,10
Sydney,"Dawson, Jordan",18,14,7,4,2,0,0,2
Sydney,"Florent, Oliver",25,15,4,10,2,1,0,3
Sydney,"Franklin, Lance",16,16,9,0,1,3,0,1
Sydney,"Heeney, Isaac",23,10,5,13,1,0,0,8
Sydney,"Hewett, George",10,2,1,8,0,0,0,5
Sydney,"Jack, Kieren",14,12,3,2,2,1,0,2
Sydney,"Jones, Zak",24,13,6,11,1,0,0,4
Sydney,"Kennedy, Josh",24,8,2,16,0,0,0,6
Sydney,"Lloyd, Jake",34,26,9,8,0,0,0,0
Sydney,"McCartin, Tom",9,8,3,1,0,0,0,0
Sydney,"McInerney, Justin",1,1,0,0,0,0,0,2
Sydney,"Mills, Callum",15,7,7,8,0,0,0,3
Sydney,"Papley, Tom",15,11,4,4,0,3,0,3
Sydney,"Parker, Luke",22,13,4,9,0,0,0,4
Sydney,"Rampe, Dane",25,18,8,7,0,0,0,1
Sydney,"Reid, Sam",11,8,6,3,0,1,4,2
Sydney,"Ronke, Ben",11,6,2,5,1,1,0,3
Sydney,"Sinclair, Callum",6,4,1,2,1,0,9,2
Sydney,"Thurlow, Jackson",18,10,5,8,0,0,0,1
Sydney,"Aliir, Aliir",9,6,4,3,0,0,1,0
Sydney,"Clarke, Ryan",19,14,6,5,0,1,0,5
Sydney,"Cunningham, Harry",30,21,9,9,0,0,0,3
Sydney,"Dawson, Jordan",31,20,11,11,0,0,0,1
Sydney,"Florent, Oliver",31,15,6,16,0,0,0,1
Sydney,"Franklin, Lance",11,10,6,1,4,1,0,2
Sydney,"Heeney, Isaac",25,9,8,16,2,1,0,1
Sydney,"Hewett, George",23,8,2,15,0,0,0,7
Sydney,"Jack, Kieren",11,8,5,3,0,1,0,3
Sydney,"Jones, Zak",32,18,6,14,0,0,0,2
Sydney,"Kennedy, Josh",29,12,3,17,1,0,0,5
Sydney,"Lloyd, Jake",37,28,9,9,0,0,0,3
Sydney,"McCartin, Tom",12,5,5,7,0,0,0,2
Sydney,"Mills, Callum",22,9,6,13,0,0,0,1
Sydney,"Papley, Tom",24,12,9,12,1,1,0,4
Sydney,"Parker, Luke",31,13,5,18,1,0,0,2
Sydney,"Rampe, Dane",22,13,4,9,0,0,0,1
Sydney,"Reid, Sam",16,3,4,13,1,1,7,0
Sydney,"Ronke, Ben",9,7,3,2,0,0,0,0
Sydney,"Rowbottom, James",13,6,4,7,0,0,0,4
Sydney,"Sinclair, Callum",12,8,2,4,0,0,24,1
Sydney,"Thurlow, Jackson",15,9,5,6,0,0,0,8
Sydney,"Aliir, Aliir",9,6,7,3,0,0,0,2
Sydney,"Blakey, Nick",6,4,1,2,2,0,0,0
Sydney,"Clarke, Ryan",11,8,2,3,0,0,0,3
Sydney,"Cunningham, Harry",22,18,5,4,0,1,0,1
Sydney,"Dawson, Jordan",18,13,4,5,2,0,0,5
Sydney,"Florent, Oliver",16,9,2,7,0,0,0,2
Sydney,"Heeney, Isaac",16,8,3,8,1,1,0,5
Sydney,"Hewett, George",23,6,1,17,0,0,0,6
Sydney,"Jones, Zak",27,13,2,14,0,0,0,7
Sydney,"Kennedy, Josh",32,15,1,17,0,0,0,6
Sydney,"Lloyd, Jake",25,14,4,11,0,0,0,3
Sydney,"McCartin, Tom",6,5,4,1,1,0,0,2
Sydney,"Melican, Lewis",5,4,2,1,0,0,0,2
Sydney,"Mills, Callum",22,10,7,12,0,0,0,2
Sydney,"Papley, Tom",11,6,2,5,1,1,0,3
Sydney,"Parker, Luke",25,17,5,8,2,0,0,3
Sydney,"Rampe, Dane",11,7,3,4,0,0,0,3
Sydney,"Reid, Sam",12,6,5,6,2,0,9,3
Sydney,"Ronke, Ben",8,4,1,4,0,0,0,1
Sydney,"Rowbottom, James",10,6,4,4,0,2,0,1
Sydney,"Sinclair, Callum",13,9,2,4,1,0,19,3
Sydney,"Thurlow, Jackson",15,9,5,6,0,0,0,3
Sydney,"Aliir, Aliir",21,14,4,7,0,0,8,2
Sydney,"Blakey, Nick",11,6,0,5,0,1,0,3
Sydney,"Cunningham, Harry",14,10,2,4,0,0,0,0
Sydney,"Dawson, Jordan",13,7,4,6,1,0,0,3
Sydney,"Florent, Oliver",7,6,2,1,1,0,0,4
Sydney,"Fox, Robbie",7,6,2,1,0,0,0,2
Sydney,"Hayward, Will",12,7,3,5,2,1,0,4
Sydney,"Heeney, Isaac",20,10,2,10,1,0,0,2
Sydney,"Hewett, George",34,9,2,25,0,0,0,6
Sydney,"Jack, Kieren",7,6,2,1,0,0,0,5
Sydney,"Jones, Zak",18,12,2,6,0,1,0,2
Sydney,"Kennedy, Josh",31,19,2,12,1,0,0,9
Sydney,"Lloyd, Jake",26,16,3,10,1,0,0,2
Sydney,"McCartin, Tom",8,7,4,1,1,0,0,1
Sydney,"Melican, Lewis",5,3,1,2,0,0,0,0
Sydney,"Mills, Callum",17,12,9,5,0,0,0,1
Sydney,"Papley, Tom",18,13,4,5,4,3,0,4
Sydney,"Parker, Luke",20,10,4,10,0,0,0,5
Sydney,"Rampe, Dane",12,9,4,3,0,0,0,4
Sydney,"Reid, Sam",8,4,3,4,0,1,6,8
Sydney,"Sinclair, Callum",15,11,0,4,0,0,23,7
Sydney,"Thurlow, Jackson",19,15,4,4,0,0,0,0
Sydney,"Aliir, Aliir",12,10,2,2,0,0,0,1
Sydney,"Blakey, Nick",17,12,2,5,1,1,0,5
Sydney,"Dawson, Jordan",15,12,5,3,2,0,0,1
Sydney,"Florent, Oliver",17,11,3,6,1,0,0,3
Sydney,"Fox, Robbie",16,8,2,8,1,1,0,7
Sydney,"Hayward, Will",16,9,4,7,1,3,0,1
Sydney,"Heeney, Isaac",14,5,3,9,1,0,0,5
Sydney,"Hewett, George",19,5,1,14,0,0,0,4
Sydney,"Jack, Kieren",8,6,0,2,0,1,0,3
Sydney,"Jones, Zak",18,11,0,7,0,1,0,4
Sydney,"Kennedy, Josh",24,11,1,13,0,2,0,10
Sydney,"Lloyd, Jake",23,16,2,7,0,0,0,1
Sydney,"McCartin, Tom",7,7,5,0,1,1,0,2
Sydney,"Melican, Lewis",11,5,1,6,0,0,0,1
Sydney,"Mills, Callum",18,9,6,9,0,0,0,5
Sydney,"ORiordan, Colin",17,9,4,8,1,1,0,4
Sydney,"Papley, Tom",8,7,4,1,1,0,0,2
Sydney,"Parker, Luke",33,14,2,19,0,0,0,5
Sydney,"Rampe, Dane",13,5,3,8,0,0,0,1
Sydney,"Reid, Sam",9,4,3,5,1,0,5,3
Sydney,"Sinclair, Callum",16,12,1,4,0,0,34,3
Sydney,"Thurlow, Jackson",16,13,3,3,0,0,0,2
Sydney,"Aliir, Aliir",18,7,3,11,0,0,0,1
Sydney,"Blakey, Nick",8,7,0,1,1,1,0,6
Sydney,"Clarke, Ryan",18,14,1,4,0,0,0,4
Sydney,"Dawson, Jordan",24,15,7,9,1,1,0,5
Sydney,"Florent, Oliver",22,16,4,6,2,1,0,1
Sydney,"Fox, Robbie",10,3,1,7,0,0,0,5
Sydney,"Hayward, Will",10,5,2,5,0,1,0,4
Sydney,"Heeney, Isaac",19,11,6,8,1,1,0,5
Sydney,"Hewett, George",29,14,2,15,0,0,0,5
Sydney,"Jones, Zak",9,5,1,4,0,0,0,6
Sydney,"Lloyd, Jake",28,21,4,7,1,0,0,4
Sydney,"McCartin, Tom",14,9,5,5,1,2,0,0
Sydney,"Melican, Lewis",7,6,5,1,0,0,0,0
Sydney,"Mills, Callum",8,4,3,4,0,0,0,3
Sydney,"ORiordan, Colin",14,8,2,6,0,0,0,2
Sydney,"Papley, Tom",15,12,3,3,4,0,0,3
Sydney,"Parker, Luke",28,19,6,9,0,1,0,9
Sydney,"Rampe, Dane",18,12,4,6,0,0,0,2
Sydney,"Reid, Sam",9,6,5,3,0,0,5,5
Sydney,"Rowbottom, James",4,2,2,2,0,1,0,2
Sydney,"Sinclair, Callum",12,7,2,5,0,1,35,6
Sydney,"Thurlow, Jackson",12,8,3,4,0,0,0,1
Sydney,"Aliir, Aliir",16,9,5,7,0,0,0,3
Sydney,"Blakey, Nick",8,8,1,0,1,1,0,2
Sydney,"Clarke, Ryan",15,10,1,5,0,0,0,2
Sydney,"Dawson, Jordan",13,7,1,6,0,0,0,7
Sydney,"Florent, Oliver",17,11,2,6,0,0,0,5
Sydney,"Fox, Robbie",6,3,0,3,1,0,0,6
Sydney,"Franklin, Lance",6,6,3,0,2,0,0,2
Sydney,"Hayward, Will",5,3,1,2,0,2,0,3
Sydney,"Heeney, Isaac",19,11,6,8,0,0,0,5
Sydney,"Hewett, George",12,4,2,8,0,0,0,1
Sydney,"Kennedy, Josh",22,15,1,7,0,0,0,3
Sydney,"Lloyd, Jake",35,21,4,14,0,0,0,1
Sydney,"McCartin, Tom",9,6,2,3,0,1,0,1
Sydney,"Melican, Lewis",9,6,6,3,0,0,0,3
Sydney,"Mills, Callum",18,11,5,7,0,0,0,2
Sydney,"ORiordan, Colin",12,7,1,5,0,0,0,2
Sydney,"Papley, Tom",10,10,4,0,1,0,0,2
Sydney,"Parker, Luke",28,19,5,9,0,0,0,4
Sydney,"Rampe, Dane",23,14,9,9,0,0,0,4
Sydney,"Reid, Sam",15,12,9,3,6,0,7,3
Sydney,"Sinclair, Callum",11,7,3,4,0,1,20,7
Sydney,"Thurlow, Jackson",9,7,3,2,0,0,0,2
Sydney,"Aliir, Aliir",20,14,9,6,0,0,0,2
Sydney,"Blakey, Nick",7,6,1,1,1,0,0,1
Sydney,"Clarke, Ryan",8,4,2,4,0,0,0,2
Sydney,"Dawson, Jordan",18,14,7,4,0,0,0,1
Sydney,"Florent, Oliver",22,12,6,10,0,0,0,3
Sydney,"Fox, Robbie",11,4,1,7,0,0,0,8
Sydney,"Franklin, Lance",12,6,4,6,1,2,0,3
Sydney,"Hayward, Will",13,10,6,3,2,2,0,3
Sydney,"Heeney, Isaac",18,10,3,8,1,0,0,2
Sydney,"Hewett, George",29,15,8,14,0,0,0,4
Sydney,"Lloyd, Jake",34,18,13,16,0,0,0,1
Sydney,"McCartin, Tom",13,6,6,7,0,0,0,2
Sydney,"McVeigh, Jarrad",13,5,5,8,0,0,0,1
Sydney,"Melican, Lewis",13,7,3,6,0,0,0,3
Sydney,"Menzel, Daniel",7,4,1,3,1,1,0,2
Sydney,"Mills, Callum",15,12,5,3,0,0,0,4
Sydney,"ORiordan, Colin",20,12,7,8,0,0,0,2
Sydney,"Papley, Tom",17,7,4,10,1,3,0,2
Sydney,"Parker, Luke",28,20,7,8,0,2,0,4
Sydney,"Rampe, Dane",25,19,8,6,0,0,0,3
Sydney,"Reid, Sam",16,10,7,6,1,2,6,1
Sydney,"Sinclair, Callum",12,5,0,7,0,0,28,1
Sydney,"Aliir, Aliir",22,13,8,9,0,0,0,4
Sydney,"Blakey, Nick",10,7,2,3,0,0,0,3
Sydney,"Clarke, Ryan",22,5,5,17,0,0,0,7
Sydney,"Dawson, Jordan",20,11,3,9,0,0,0,2
Sydney,"Florent, Oliver",23,16,7,7,0,0,0,2
Sydney,"Franklin, Lance",18,17,9,1,5,4,0,1
Sydney,"Heeney, Isaac",28,16,8,12,0,0,0,4
Sydney,"Hewett, George",29,15,3,14,1,0,0,2
Sydney,"Lloyd, Jake",42,27,9,15,0,1,0,3
Sydney,"McCartin, Tom",5,2,2,3,1,0,0,1
Sydney,"McVeigh, Jarrad",13,6,4,7,0,0,0,3
Sydney,"Melican, Lewis",15,12,3,3,0,0,0,5
Sydney,"Menzel, Daniel",12,7,3,5,0,0,0,0
Sydney,"Mills, Callum",25,17,11,8,0,0,0,2
Sydney,"ORiordan, Colin",4,1,1,3,0,0,0,0
Sydney,"Papley, Tom",27,19,7,8,5,2,0,0
Sydney,"Parker, Luke",29,15,7,14,1,0,0,3
Sydney,"Rampe, Dane",32,25,12,7,0,0,0,1
Sydney,"Reid, Sam",9,6,4,3,3,0,3,1
Sydney,"Rose, James",15,10,3,5,1,0,0,0
Sydney,"Sinclair, Callum",12,7,4,5,1,0,28,1
Sydney,"Thurlow, Jackson",8,6,5,2,0,0,0,1
Sydney,"Aliir, Aliir",16,12,4,4,0,0,3,0
Sydney,"Blakey, Nick",11,9,7,2,2,0,0,1
Sydney,"Clarke, Ryan",20,9,6,11,0,0,0,7
Sydney,"Dawson, Jordan",22,17,11,5,0,0,0,3
Sydney,"Florent, Oliver",11,6,4,5,0,1,0,2
Sydney,"Franklin, Lance",5,5,3,0,4,0,0,0
Sydney,"Hayward, Will",9,8,5,1,1,2,0,1
Sydney,"Heeney, Isaac",23,12,4,11,0,1,0,6
Sydney,"Hewett, George",18,7,2,11,0,0,0,6
Sydney,"Jones, Zak",27,15,4,12,0,1,0,6
Sydney,"Kennedy, Josh",19,9,3,10,0,1,0,6
Sydney,"Lloyd, Jake",28,20,7,8,0,0,0,3
Sydney,"Melican, Lewis",14,12,8,2,0,0,0,0
Sydney,"Menzel, Daniel",9,5,3,4,1,0,0,1
Sydney,"Mills, Callum",21,14,13,7,0,0,0,2
Sydney,"ORiordan, Colin",14,11,9,3,0,0,0,0
Sydney,"Papley, Tom",12,10,7,2,2,0,0,4
Sydney,"Parker, Luke",31,20,7,11,1,0,0,12
Sydney,"Rampe, Dane",17,9,4,8,0,0,0,3
Sydney,"Reid, Sam",5,3,3,2,0,1,10,4
Sydney,"Rose, James",17,13,5,4,0,1,0,3
Sydney,"Sinclair, Callum",17,13,7,4,1,0,20,3
Sydney,"Aliir, Aliir",16,8,3,8,1,0,8,3
Sydney,"Blakey, Nick",13,10,2,3,2,1,0,3
Sydney,"Dawson, Jordan",28,21,3,7,0,0,0,3
Sydney,"Florent, Oliver",22,11,2,11,0,0,0,1
Sydney,"Hayward, Will",18,10,4,8,1,1,0,3
Sydney,"Heeney, Isaac",25,13,11,12,2,1,0,2
Sydney,"Hewett, George",22,8,3,14,0,0,0,12
Sydney,"Jones, Zak",25,10,7,15,1,0,0,4
Sydney,"Kennedy, Josh",27,11,5,16,1,0,0,8
Sydney,"Lloyd, Jake",16,8,0,8,0,0,0,2
Sydney,"McCartin, Tom",9,7,4,2,0,0,0,2
Sydney,"Melican, Lewis",9,4,4,5,0,0,0,2
Sydney,"Mills, Callum",20,10,8,10,0,0,0,3
Sydney,"ORiordan, Colin",11,6,1,5,0,0,0,4
Sydney,"Papley, Tom",18,15,7,3,2,2,0,1
Sydney,"Parker, Luke",31,14,3,17,0,0,0,6
Sydney,"Rampe, Dane",24,11,6,13,0,0,0,1
Sydney,"Reid, Sam",9,5,5,4,2,0,14,5
Sydney,"Ronke, Ben",11,8,2,3,2,0,0,4
Sydney,"Rose, James",19,12,3,7,0,1,0,2
Sydney,"Rowbottom, James",21,11,1,10,0,0,0,9
Sydney,"Sinclair, Callum",2,1,0,1,0,0,4,1
Sydney,"Aliir, Aliir",17,13,3,4,0,0,23,1
Sydney,"Blakey, Nick",10,6,5,4,1,2,0,1
Sydney,"Cunningham, Harry",18,7,8,11,0,0,0,2
Sydney,"Dawson, Jordan",17,14,6,3,0,0,0,1
Sydney,"Florent, Oliver",10,7,3,3,0,0,0,0
Sydney,"Hayward, Will",15,10,6,5,0,2,0,1
Sydney,"Heeney, Isaac",33,20,10,13,0,2,0,3
Sydney,"Hewett, George",26,13,5,13,0,0,0,1
Sydney,"Jones, Zak",22,15,7,7,1,0,0,1
Sydney,"Kennedy, Josh",35,11,3,24,0,0,0,2
Sydney,"Lloyd, Jake",32,23,8,9,0,1,0,1
Sydney,"McCartin, Tom",14,10,6,4,1,1,0,1
Sydney,"Melican, Lewis",11,7,3,4,0,0,0,4
Sydney,"Mills, Callum",14,10,6,4,0,0,0,1
Sydney,"ORiordan, Colin",14,7,3,7,0,0,0,3
Sydney,"Papley, Tom",14,12,4,2,1,2,0,1
Sydney,"Parker, Luke",19,11,7,8,2,0,0,4
Sydney,"Rampe, Dane",23,15,8,8,0,0,0,2
Sydney,"Reid, Sam",14,8,6,6,2,0,0,2
Sydney,"Ronke, Ben",11,4,3,7,0,0,0,1
Sydney,"Rose, James",11,5,4,6,1,0,0,3
Sydney,"Rowbottom, James",24,14,4,10,0,0,0,3
Sydney,"Aliir, Aliir",15,12,3,3,0,0,12,0
Sydney,"Blakey, Nick",9,6,4,3,0,3,0,0
Sydney,"Cunningham, Harry",12,10,2,2,0,0,0,2
Sydney,"Dawson, Jordan",16,11,3,5,1,0,0,3
Sydney,"Florent, Oliver",15,4,4,11,0,0,0,0
Sydney,"Hayward, Will",8,6,1,2,0,1,0,1
Sydney,"Heeney, Isaac",20,11,5,9,1,2,0,2
Sydney,"Hewett, George",22,10,1,12,0,0,0,7
Sydney,"Jack, Kieren",7,6,2,1,1,0,0,3
Sydney,"Jones, Zak",20,11,4,9,0,0,0,5
Sydney,"Kennedy, Josh",23,8,2,15,0,0,0,10
Sydney,"Lloyd, Jake",34,24,5,10,1,0,0,1
Sydney,"McCartin, Tom",15,11,5,4,0,2,0,1
Sydney,"Melican, Lewis",9,2,2,7,0,0,0,2
Sydney,"Mills, Callum",16,7,5,9,0,0,0,6
Sydney,"ORiordan, Colin",12,6,8,6,0,0,0,4
Sydney,"Papley, Tom",17,14,6,3,1,1,0,4
Sydney,"Parker, Luke",23,10,1,13,1,0,0,1
Sydney,"Rampe, Dane",14,8,4,6,0,0,0,2
Sydney,"Reid, Sam",15,10,6,5,1,1,8,0
Sydney,"Ronke, Ben",9,3,0,6,0,0,0,2
Sydney,"Rowbottom, James",12,4,0,8,1,1,0,12
Sydney,"Aliir, Aliir",16,12,6,4,0,0,2,3
Sydney,"Blakey, Nick",10,5,2,5,1,0,0,4
Sydney,"Clarke, Ryan",22,11,2,11,0,0,0,1
Sydney,"Florent, Oliver",16,12,2,4,0,0,0,1
Sydney,"Fox, Robbie",13,7,3,6,1,0,0,3
Sydney,"Hayward, Will",13,6,3,7,0,0,0,4
Sydney,"Heeney, Isaac",16,8,5,8,0,0,0,5
Sydney,"Hewett, George",27,15,4,12,0,0,0,3
Sydney,"Jones, Zak",25,11,4,14,0,0,0,2
Sydney,"Kennedy, Josh",23,7,3,16,0,0,0,8
Sydney,"Lloyd, Jake",42,21,8,21,0,2,0,0
Sydney,"McCartin, Tom",5,5,3,0,0,2,0,1
Sydney,"McLean, Hayden",13,8,5,5,0,0,16,8
Sydney,"Melican, Lewis",16,10,1,6,0,0,0,3
Sydney,"Mills, Callum",19,12,6,7,0,0,0,4
Sydney,"ORiordan, Colin",18,4,5,14,0,0,0,2
Sydney,"Papley, Tom",23,18,6,5,1,3,0,1
Sydney,"Parker, Luke",28,16,6,12,1,1,0,4
Sydney,"Rampe, Dane",22,17,9,5,0,0,0,5
Sydney,"Reid, Sam",11,7,6,4,3,1,0,1
Sydney,"Rowbottom, James",16,10,5,6,0,0,0,6
Sydney,"Stoddart, Ryley",7,2,0,5,0,0,0,1
Sydney,"Aliir, Aliir",14,9,4,5,0,0,1,5
Sydney,"Blakey, Nick",13,5,1,8,1,0,0,5
Sydney,"Clarke, Ryan",11,4,3,7,0,0,0,2
Sydney,"Dawson, Jordan",17,10,6,7,3,0,0,2
Sydney,"Fox, Robbie",6,1,0,5,0,0,1,3
Sydney,"Heeney, Isaac",15,14,6,1,3,1,0,6
Sydney,"Hewett, George",27,10,2,17,0,0,0,2
Sydney,"Jones, Zak",19,14,3,5,0,0,0,1
Sydney,"Kennedy, Josh",28,12,1,16,1,0,0,7
Sydney,"Lloyd, Jake",25,15,5,10,0,0,0,2
Sydney,"McCartin, Tom",8,5,4,3,0,0,0,1
Sydney,"McLean, Hayden",11,4,2,7,0,1,10,3
Sydney,"Melican, Lewis",9,6,2,3,0,0,0,2
Sydney,"Mills, Callum",26,19,6,7,0,0,0,4
Sydney,"ORiordan, Colin",18,7,6,11,0,0,0,2
Sydney,"Papley, Tom",4,3,1,1,1,0,0,2
Sydney,"Parker, Luke",29,15,4,14,1,1,0,3
Sydney,"Rampe, Dane",25,16,8,9,0,0,0,3
Sydney,"Reid, Sam",8,2,0,6,0,1,2,2
Sydney,"Ronke, Ben",13,11,5,2,2,4,0,4
Sydney,"Rowbottom, James",13,7,1,6,0,0,0,7
Sydney,"Stoddart, Ryley",5,3,2,2,0,0,0,1
Sydney,"Aliir, Aliir",19,11,5,8,0,0,0,1
Sydney,"Blakey, Nick",9,7,5,2,1,0,0,2
Sydney,"Clarke, Ryan",26,12,3,14,1,0,0,4
Sydney,"Dawson, Jordan",20,13,6,7,1,0,0,3
Sydney,"Florent, Oliver",28,17,3,11,0,0,0,2
Sydney,"Fox, Robbie",16,5,3,11,0,0,0,2
Sydney,"Heeney, Isaac",18,12,7,6,4,2,0,2
Sydney,"Hewett, George",17,6,4,11,0,0,0,4
Sydney,"Jack, Kieren",12,8,2,4,0,0,0,2
Sydney,"Jones, Zak",20,14,5,6,0,0,0,7
Sydney,"Kennedy, Josh",21,7,1,14,0,0,0,10
Sydney,"Lloyd, Jake",31,13,5,18,0,0,0,1
Sydney,"McCartin, Tom",14,6,5,8,0,0,0,1
Sydney,"McLean, Hayden",14,8,4,6,0,0,18,5
Sydney,"Menzel, Daniel",14,9,6,5,1,2,0,0
Sydney,"Mills, Callum",15,8,4,7,0,0,0,1
Sydney,"Papley, Tom",17,13,9,4,2,2,0,4
Sydney,"Parker, Luke",22,11,3,11,0,0,0,6
Sydney,"Reid, Sam",8,5,5,3,0,0,10,5
Sydney,"Ronke, Ben",10,5,4,5,2,1,0,1
Sydney,"Rose, James",5,5,2,0,0,0,0,2
Sydney,"Rowbottom, James",13,10,2,3,0,0,0,2
Sydney,"Aliir, Aliir",17,10,1,7,0,0,10,1
Sydney,"Bell, James",6,4,3,2,0,1,0,2
Sydney,"Blakey, Nick",20,13,2,7,0,1,0,2
Sydney,"Clarke, Ryan",22,10,2,12,0,0,0,2
Sydney,"Dawson, Jordan",18,11,3,7,0,0,0,6
Sydney,"Florent, Oliver",29,25,2,4,0,2,0,5
Sydney,"Fox, Robbie",10,4,3,6,0,0,0,3
Sydney,"Heeney, Isaac",20,13,6,7,2,1,0,5
Sydney,"Hewett, George",17,2,3,15,0,0,0,4
Sydney,"Jones, Zak",17,9,3,8,0,1,0,4
Sydney,"Kennedy, Josh",24,13,1,11,0,1,0,4
Sydney,"Lloyd, Jake",30,20,5,10,0,0,0,2
Sydney,"McCartin, Tom",8,5,1,3,0,0,0,1
Sydney,"McLean, Hayden",5,3,1,2,0,0,9,3
Sydney,"Menzel, Daniel",11,10,7,1,2,3,0,2
Sydney,"Mills, Callum",14,7,3,7,0,0,0,2
Sydney,"Papley, Tom",12,7,2,5,2,0,0,1
Sydney,"Parker, Luke",12,6,2,6,0,0,0,8
Sydney,"Rampe, Dane",20,9,5,11,0,0,0,5
Sydney,"Reid, Sam",16,7,6,9,0,1,5,4
Sydney,"Ronke, Ben",12,8,4,4,1,0,0,3
Sydney,"Rowbottom, James",12,5,3,7,0,1,0,5
Sydney,"Aliir, Aliir",13,10,4,3,0,0,12,5
Sydney,"Bell, James",8,5,4,3,1,0,0,3
Sydney,"Blakey, Nick",17,12,6,5,1,1,0,2
Sydney,"Clarke, Ryan",20,11,2,9,0,0,0,2
Sydney,"Dawson, Jordan",15,9,4,6,2,0,1,3
Sydney,"Florent, Oliver",28,15,4,13,0,1,0,4
Sydney,"Fox, Robbie",18,14,4,4,0,0,0,4
Sydney,"Heeney, Isaac",12,9,7,3,0,0,0,7
Sydney,"Hewett, George",21,7,2,14,0,0,0,6
Sydney,"Jack, Kieren",10,5,1,5,0,0,0,5
Sydney,"Kennedy, Josh",21,8,5,13,0,0,0,7
Sydney,"Lloyd, Jake",26,18,1,8,0,0,0,2
Sydney,"McCartin, Tom",10,6,4,4,2,0,0,2
Sydney,"Melican, Lewis",14,7,5,7,0,0,0,1
Sydney,"Menzel, Daniel",9,6,4,3,2,1,0,3
Sydney,"Mills, Callum",17,8,4,9,0,0,0,3
Sydney,"Papley, Tom",7,6,3,1,2,1,0,5
Sydney,"Parker, Luke",25,8,1,17,0,1,0,8
Sydney,"Rampe, Dane",22,14,8,8,0,0,0,1
Sydney,"Reid, Sam",14,11,7,3,3,0,6,3
Sydney,"Ronke, Ben",10,7,1,3,0,0,0,1
Sydney,"Rowbottom, James",14,8,3,6,2,0,0,6
Sydney,"Aliir, Aliir",12,7,2,5,0,0,10,5
Sydney,"Blakey, Nick",12,8,4,4,1,0,0,2
Sydney,"Dawson, Jordan",25,19,8,6,0,0,0,4
Sydney,"Florent, Oliver",16,11,5,5,0,0,0,0
Sydney,"Fox, Robbie",15,10,6,5,0,0,0,4
Sydney,"Franklin, Lance",14,13,10,1,4,2,0,3
Sydney,"Heeney, Isaac",17,11,5,6,0,0,0,0
Sydney,"Hewett, George",22,10,3,12,0,0,0,2
Sydney,"Jack, Kieren",11,5,2,6,1,0,0,2
Sydney,"Kennedy, Josh",32,18,5,14,2,0,0,9
Sydney,"Lloyd, Jake",28,19,6,9,0,0,0,0
Sydney,"McCartin, Tom",11,9,8,2,3,1,0,1
Sydney,"McVeigh, Jarrad",11,4,5,7,1,0,0,1
Sydney,"Melican, Lewis",7,6,2,1,0,0,0,2
Sydney,"Menzel, Daniel",7,6,3,1,0,1,0,1
Sydney,"Mills, Callum",19,13,6,6,0,0,0,4
Sydney,"Papley, Tom",16,10,5,6,2,1,0,0
Sydney,"Parker, Luke",28,15,4,13,2,0,0,5
Sydney,"Rampe, Dane",18,10,3,8,0,0,0,2
Sydney,"Reid, Sam",14,7,6,7,0,1,9,1
Sydney,"Ronke, Ben",15,12,8,3,0,0,0,4
Sydney,"Rowbottom, James",12,7,3,5,1,0,0,2
West Coast,"Allen, Oscar",8,4,2,4,2,0,0,2
West Coast,"Barrass, Tom",9,8,3,1,0,0,12,0
West Coast,"Brander, Jarrod",8,8,7,0,0,2,0,1
West Coast,"Cole, Tom",7,4,2,3,0,0,0,3
West Coast,"Darling, Jack",10,8,4,2,2,1,0,3
West Coast,"Duggan, Liam",15,12,2,3,0,0,0,1
West Coast,"Hickey, Tom",2,2,1,0,0,0,20,2
West Coast,"Hurn, Shannon",20,17,5,3,0,0,0,3
West Coast,"Hutchings, Mark",11,8,1,3,0,1,0,4
West Coast,"Jetta, Lewis",14,9,3,5,0,0,0,1
West Coast,"Masten, Chris",11,4,2,7,0,0,0,1
West Coast,"McGovern, Jeremy",12,8,5,4,0,0,3,1
West Coast,"Petruccelle, Jack",10,7,2,3,0,0,0,3
West Coast,"Redden, Jack",22,10,4,12,0,0,0,5
West Coast,"Ryan, Liam",8,4,2,4,1,1,0,6
West Coast,"Sheed, Dom",38,20,7,18,1,0,0,3
West Coast,"Sheppard, Brad",18,14,5,4,0,0,0,5
West Coast,"Shuey, Luke",26,23,2,3,0,0,0,3
West Coast,"Vardy, Nathan",3,1,0,2,0,0,14,1
West Coast,"Venables, Daniel",9,3,0,6,1,0,0,5
West Coast,"Waterman, Jake",8,4,4,4,0,1,0,1
West Coast,"Yeo, Elliot",25,20,5,5,1,1,0,1
West Coast,"Allen, Oscar",7,7,5,0,3,1,0,0
West Coast,"Barrass, Tom",17,14,6,3,0,0,0,0
West Coast,"Cole, Tom",18,14,9,4,0,0,0,3
West Coast,"Darling, Jack",12,10,6,2,4,1,0,3
West Coast,"Duggan, Liam",21,13,11,8,0,0,0,0
West Coast,"Hickey, Tom",18,11,8,7,1,0,20,1
West Coast,"Hurn, Shannon",20,16,8,4,0,0,0,1
West Coast,"Hutchings, Mark",15,9,2,6,1,0,0,2
West Coast,"Jetta, Lewis",16,13,6,3,0,0,0,0
West Coast,"Kennedy, Josh",11,8,8,3,1,3,0,0
West Coast,"Masten, Chris",21,16,10,5,0,0,0,3
West Coast,"McGovern, Jeremy",18,15,11,3,0,0,0,1
West Coast,"Petruccelle, Jack",13,9,9,4,1,0,0,1
West Coast,"Redden, Jack",19,13,8,6,0,0,0,3
West Coast,"Ryan, Liam",10,6,1,4,0,0,0,1
West Coast,"Sheed, Dom",28,19,9,9,1,0,0,0
West Coast,"Sheppard, Brad",20,14,7,6,0,0,0,4
West Coast,"Shuey, Luke",28,16,2,12,2,0,0,5
West Coast,"Smith, Josh",13,7,7,6,1,1,0,0
West Coast,"Vardy, Nathan",9,5,5,4,0,0,13,1
West Coast,"Venables, Daniel",13,7,5,6,0,0,0,0
West Coast,"Yeo, Elliot",23,12,3,11,1,0,0,5
West Coast,"Allen, Oscar",7,5,4,2,1,0,0,3
West Coast,"Barrass, Tom",11,9,8,2,0,0,0,0
West Coast,"Cole, Tom",10,7,6,3,0,0,0,5
West Coast,"Cripps, Jamie",18,10,3,8,4,0,0,1
West Coast,"Darling, Jack",7,5,1,2,1,0,0,2
West Coast,"Gaff, Andrew",35,19,5,16,0,0,0,1
West Coast,"Hickey, Tom",12,5,3,7,1,0,7,0
West Coast,"Hurn, Shannon",28,20,6,8,0,0,0,0
West Coast,"Hutchings, Mark",10,5,1,5,0,1,0,1
West Coast,"Jetta, Lewis",19,15,7,4,0,0,0,0
West Coast,"Kennedy, Josh",10,6,4,4,3,1,1,0
West Coast,"Masten, Chris",11,8,5,3,0,0,0,2
West Coast,"McGovern, Jeremy",11,8,7,3,0,0,0,0
West Coast,"Petruccelle, Jack",14,13,5,1,1,2,0,2
West Coast,"Redden, Jack",17,9,2,8,0,0,0,2
West Coast,"Rotham, Josh",9,7,4,2,0,0,0,2
West Coast,"Ryan, Liam",11,8,3,3,1,0,0,1
West Coast,"Sheed, Dom",24,14,5,10,3,0,0,0
West Coast,"Sheppard, Brad",18,16,13,2,0,0,0,1
West Coast,"Shuey, Luke",24,20,3,4,0,0,0,6
West Coast,"Vardy, Nathan",5,2,0,3,0,0,11,6
West Coast,"Yeo, Elliot",21,9,2,12,0,1,0,3
West Coast,"Allen, Oscar",8,6,4,2,1,2,1,2
West Coast,"Barrass, Tom",17,16,11,1,0,0,0,1
West Coast,"Cole, Tom",12,6,3,6,0,0,0,5
West Coast,"Cripps, Jamie",21,14,10,7,0,1,0,0
West Coast,"Darling, Jack",13,9,2,4,3,2,0,4
West Coast,"Duggan, Liam",17,14,7,3,0,0,0,4
West Coast,"Gaff, Andrew",35,23,9,12,0,0,0,4
West Coast,"Hickey, Tom",13,7,0,6,0,0,21,2
West Coast,"Hurn, Shannon",32,26,8,6,0,0,0,3
West Coast,"Hutchings, Mark",13,6,5,7,0,0,0,1
West Coast,"Kennedy, Josh",12,10,6,2,3,1,0,2
West Coast,"Masten, Chris",16,11,7,5,0,0,0,2
West Coast,"McGovern, Jeremy",16,13,9,3,0,0,0,0
West Coast,"Petruccelle, Jack",7,6,2,1,2,0,0,1
West Coast,"Redden, Jack",33,20,10,13,0,0,0,4
West Coast,"Rotham, Josh",17,13,7,4,0,0,0,1
West Coast,"Ryan, Liam",7,5,3,2,1,1,0,2
West Coast,"Sheed, Dom",17,7,4,10,0,0,0,3
West Coast,"Sheppard, Brad",27,17,14,10,0,0,0,0
West Coast,"Shuey, Luke",24,15,5,9,0,0,0,4
West Coast,"Vardy, Nathan",10,7,2,3,0,0,20,3
West Coast,"Yeo, Elliot",30,17,7,13,0,0,0,2
West Coast,"Allen, Oscar",9,7,2,2,0,0,1,2
West Coast,"Cole, Tom",18,11,4,7,0,0,0,2
West Coast,"Cripps, Jamie",5,1,1,4,0,0,0,3
West Coast,"Darling, Jack",6,3,2,3,0,0,0,0
West Coast,"Duggan, Liam",12,7,4,5,0,0,0,1
West Coast,"Gaff, Andrew",32,17,6,15,1,0,0,2
West Coast,"Hickey, Tom",9,6,2,3,0,0,17,5
West Coast,"Hurn, Shannon",33,24,7,9,0,0,0,3
West Coast,"Hutchings, Mark",14,9,4,5,0,0,0,5
West Coast,"Jetta, Lewis",24,16,7,8,0,0,0,2
West Coast,"Kennedy, Josh",7,4,1,3,1,0,0,1
West Coast,"Masten, Chris",15,8,1,7,0,0,0,0
West Coast,"McGovern, Jeremy",19,12,7,7,0,0,0,0
West Coast,"Petruccelle, Jack",18,14,7,4,5,2,0,3
West Coast,"Redden, Jack",23,12,5,11,0,0,0,1
West Coast,"Ryan, Liam",15,12,4,3,1,0,0,3
West Coast,"Schofield, Will",14,10,6,4,0,0,0,2
West Coast,"Sheed, Dom",27,15,6,12,0,0,0,0
West Coast,"Sheppard, Brad",26,20,7,6,0,0,0,4
West Coast,"Shuey, Luke",27,12,4,15,0,0,0,1
West Coast,"Vardy, Nathan",3,1,1,2,0,0,18,1
West Coast,"Yeo, Elliot",17,10,1,7,0,0,0,7
West Coast,"Allen, Oscar",5,4,0,1,1,1,5,4
West Coast,"Brander, Jarrod",10,6,1,4,0,0,0,0
West Coast,"Cole, Tom",4,3,2,1,0,0,0,2
West Coast,"Cripps, Jamie",7,3,2,4,0,0,0,3
West Coast,"Darling, Jack",10,3,1,7,0,0,0,1
West Coast,"Duggan, Liam",17,11,2,6,0,0,0,3
West Coast,"Gaff, Andrew",29,18,3,11,0,0,0,3
West Coast,"Hickey, Tom",25,16,7,9,1,0,32,5
West Coast,"Hurn, Shannon",26,23,10,3,0,0,0,1
West Coast,"Hutchings, Mark",9,7,2,2,0,0,0,4
West Coast,"Jetta, Lewis",14,13,4,1,0,0,0,0
West Coast,"Kennedy, Josh",7,5,4,2,2,1,0,3
West Coast,"Masten, Chris",15,8,6,7,1,0,0,3
West Coast,"McGovern, Jeremy",17,9,6,8,0,0,4,1
West Coast,"Petruccelle, Jack",6,2,1,4,1,0,0,3
West Coast,"Ryan, Liam",7,5,1,2,0,1,0,6
West Coast,"Schofield, Will",4,1,2,3,0,0,0,0
West Coast,"Sheed, Dom",20,9,3,11,0,0,0,1
West Coast,"Sheppard, Brad",13,6,4,7,0,0,0,0
West Coast,"Shuey, Luke",22,11,1,11,0,0,0,5
West Coast,"Venables, Daniel",8,4,4,4,0,0,0,3
West Coast,"Yeo, Elliot",24,14,2,10,1,0,0,8
West Coast,"Allen, Oscar",10,6,5,4,0,2,2,2
West Coast,"Cole, Tom",16,9,5,7,0,0,0,3
West Coast,"Cripps, Jamie",16,6,4,10,1,1,0,6
West Coast,"Darling, Jack",11,9,4,2,4,2,0,5
West Coast,"Duggan, Liam",19,16,7,3,0,0,0,2
West Coast,"Gaff, Andrew",35,23,10,12,0,0,0,6
West Coast,"Hurn, Shannon",26,17,5,9,0,0,0,0
West Coast,"Hutchings, Mark",12,7,4,5,0,0,0,9
West Coast,"Jetta, Lewis",15,11,2,4,0,0,0,3
West Coast,"Kennedy, Josh",9,7,6,2,2,2,0,1
West Coast,"Masten, Chris",12,8,4,4,0,0,0,1
West Coast,"McGovern, Jeremy",18,12,11,6,0,0,0,2
West Coast,"Petruccelle, Jack",12,8,3,4,0,2,0,3
West Coast,"Redden, Jack",21,10,5,11,0,1,0,13
West Coast,"Ryan, Liam",12,10,3,2,1,1,0,2
West Coast,"Schofield, Will",10,6,4,4,0,0,0,2
West Coast,"Sheed, Dom",32,13,9,19,2,0,0,0
West Coast,"Sheppard, Brad",25,16,7,9,0,0,0,0
West Coast,"Shuey, Luke",31,21,5,10,0,1,0,8
West Coast,"Vardy, Nathan",4,1,1,3,0,0,30,5
West Coast,"Venables, Daniel",9,5,5,4,0,1,0,2
West Coast,"Yeo, Elliot",28,17,7,11,1,0,0,12
West Coast,"Allen, Oscar",13,9,5,4,2,0,6,3
West Coast,"Cole, Tom",8,5,1,3,0,0,0,5
West Coast,"Cripps, Jamie",21,8,3,13,2,1,0,5
West Coast,"Darling, Jack",13,9,8,4,1,1,0,0
West Coast,"Duggan, Liam",22,15,8,7,0,1,0,0
West Coast,"Gaff, Andrew",30,19,5,11,0,1,0,3
West Coast,"Hurn, Shannon",25,23,9,2,0,1,0,1
West Coast,"Hutchings, Mark",17,14,5,3,0,0,0,2
West Coast,"Jetta, Lewis",8,7,3,1,0,0,0,1
West Coast,"Kennedy, Josh",6,4,2,2,2,2,1,4
West Coast,"McGovern, Jeremy",13,8,6,5,0,0,0,2
West Coast,"Petruccelle, Jack",10,8,4,2,2,1,0,0
West Coast,"Redden, Jack",19,7,3,12,0,0,0,3
West Coast,"Ryan, Liam",17,14,6,3,1,4,0,3
West Coast,"Schofield, Will",5,4,2,1,0,0,0,1
West Coast,"Sheed, Dom",28,15,3,13,1,2,0,1
West Coast,"Sheppard, Brad",18,12,9,6,0,0,0,1
West Coast,"Shuey, Luke",27,15,2,12,0,0,0,3
West Coast,"Vardy, Nathan",9,3,2,6,0,0,31,2
West Coast,"Venables, Daniel",15,8,4,7,1,0,0,4
West Coast,"Waterman, Jake",13,11,7,2,0,1,0,1
West Coast,"Yeo, Elliot",23,14,5,9,0,1,0,6
West Coast,"Allen, Oscar",8,6,3,2,0,0,0,3
West Coast,"Cole, Tom",15,12,7,3,0,0,0,1
West Coast,"Cripps, Jamie",18,9,3,9,2,1,0,2
West Coast,"Darling, Jack",11,6,3,5,1,0,0,4
West Coast,"Duggan, Liam",17,13,8,4,0,0,0,0
West Coast,"Gaff, Andrew",30,18,10,12,0,0,0,5
West Coast,"Hickey, Tom",10,2,2,8,0,0,11,3
West Coast,"Hurn, Shannon",33,26,13,7,0,0,0,2
West Coast,"Hutchings, Mark",12,6,4,6,0,0,0,0
West Coast,"Jetta, Lewis",16,11,3,5,0,0,0,1
West Coast,"Kennedy, Josh",15,9,6,6,4,0,0,1
West Coast,"McGovern, Jeremy",17,14,12,3,0,0,2,4
West Coast,"Petruccelle, Jack",10,6,4,4,0,1,0,4
West Coast,"Redden, Jack",20,10,6,10,0,0,0,2
West Coast,"Rioli, Willie",9,8,3,1,2,1,0,3
West Coast,"Ryan, Liam",13,9,7,4,1,0,0,3
West Coast,"Sheed, Dom",33,22,12,11,1,2,0,0
West Coast,"Sheppard, Brad",14,9,5,5,0,0,0,4
West Coast,"Shuey, Luke",19,13,1,6,2,0,0,12
West Coast,"Vardy, Nathan",5,2,1,3,0,0,7,3
West Coast,"Venables, Daniel",2,0,0,2,0,0,0,2
West Coast,"Yeo, Elliot",26,16,3,10,0,0,0,16
West Coast,"Allen, Oscar",9,8,1,1,1,1,9,6
West Coast,"Cole, Tom",6,4,1,2,0,0,0,1
West Coast,"Cripps, Jamie",12,7,4,5,3,0,0,4
West Coast,"Darling, Jack",16,14,5,2,3,0,4,4
West Coast,"Duggan, Liam",11,9,2,2,0,0,0,2
West Coast,"Gaff, Andrew",33,20,9,13,0,0,0,3
West Coast,"Hurn, Shannon",25,22,3,3,0,0,0,1
West Coast,"Hutchings, Mark",14,10,0,4,0,1,0,3
West Coast,"Kennedy, Josh",8,5,4,3,3,0,0,6
West Coast,"McGovern, Jeremy",14,7,4,7,0,0,0,1
West Coast,"Nelson, Jackson",4,4,1,0,0,0,0,3
West Coast,"Petruccelle, Jack",8,3,0,5,1,0,0,3
West Coast,"Redden, Jack",27,14,4,13,0,0,0,15
West Coast,"Rioli, Willie",11,7,1,4,1,1,0,3
West Coast,"Ryan, Liam",10,8,0,2,0,0,0,3
West Coast,"Schofield, Will",5,4,1,1,0,0,0,3
West Coast,"Sheed, Dom",31,16,1,15,1,2,0,5
West Coast,"Sheppard, Brad",16,15,9,1,0,1,0,1
West Coast,"Shuey, Luke",33,22,3,11,0,0,0,10
West Coast,"Vardy, Nathan",8,2,1,6,0,0,48,4
West Coast,"Waterman, Jake",8,7,4,1,0,0,0,4
West Coast,"Yeo, Elliot",27,14,2,13,0,1,0,15
West Coast,"Allen, Oscar",13,10,5,3,1,1,7,2
West Coast,"Cole, Tom",10,7,7,3,0,0,0,3
West Coast,"Cripps, Jamie",19,13,5,6,2,0,0,4
West Coast,"Darling, Jack",15,11,6,4,6,1,3,1
West Coast,"Duggan, Liam",21,15,4,6,0,0,0,1
West Coast,"Gaff, Andrew",36,19,8,17,0,0,0,2
West Coast,"Hurn, Shannon",18,14,8,4,0,0,0,0
West Coast,"Hutchings, Mark",21,11,5,10,0,0,0,2
West Coast,"Jetta, Lewis",23,16,5,7,0,0,0,2
West Coast,"Kennedy, Josh",9,7,4,2,3,2,1,0
West Coast,"McGovern, Jeremy",16,11,8,5,0,0,0,2
West Coast,"Petruccelle, Jack",10,8,4,2,0,0,0,1
West Coast,"Redden, Jack",18,9,7,9,0,0,0,4
West Coast,"Rioli, Willie",16,9,6,7,1,1,0,2
West Coast,"Ryan, Liam",12,8,4,4,3,1,0,0
West Coast,"Schofield, Will",9,8,7,1,0,0,0,0
West Coast,"Sheed, Dom",25,11,7,14,1,0,0,0
West Coast,"Sheppard, Brad",22,14,10,8,0,0,0,0
West Coast,"Shuey, Luke",30,18,5,12,0,0,0,3
West Coast,"Vardy, Nathan",11,3,3,8,0,0,28,3
West Coast,"Waterman, Jake",22,12,7,10,3,0,0,2
West Coast,"Yeo, Elliot",23,14,3,9,1,0,0,3
West Coast,"Cole, Tom",10,6,6,4,0,0,0,5
West Coast,"Cripps, Jamie",12,10,1,2,0,3,0,3
West Coast,"Darling, Jack",11,10,5,1,1,1,0,1
West Coast,"Duggan, Liam",12,9,5,3,0,0,0,2
West Coast,"Gaff, Andrew",28,19,4,9,0,0,0,1
West Coast,"Hickey, Tom",10,4,2,6,0,0,22,1
West Coast,"Hutchings, Mark",14,7,1,7,0,0,0,1
West Coast,"Jetta, Lewis",22,16,3,6,0,0,0,1
West Coast,"Kennedy, Josh",7,6,5,1,3,1,0,0
West Coast,"McGovern, Jeremy",16,11,7,5,1,0,0,0
West Coast,"Petruccelle, Jack",6,5,2,1,0,1,0,2
West Coast,"Redden, Jack",19,13,5,6,0,0,0,9
West Coast,"Rioli, Willie",14,10,2,4,2,0,0,3
West Coast,"Rotham, Josh",10,7,6,3,0,0,0,1
West Coast,"Ryan, Liam",16,11,5,5,2,0,0,2
West Coast,"Schofield, Will",14,9,5,5,0,0,0,1
West Coast,"Sheed, Dom",26,16,4,10,0,1,0,4
West Coast,"Sheppard, Brad",19,12,11,7,0,0,0,2
West Coast,"Shuey, Luke",24,15,3,9,0,0,0,4
West Coast,"Smith, Josh",10,6,2,4,0,0,0,0
West Coast,"Vardy, Nathan",5,3,1,2,0,0,8,1
West Coast,"Waterman, Jake",10,8,4,2,1,0,0,0
West Coast,"Allen, Oscar",15,6,3,9,0,2,4,4
West Coast,"Cameron, Jarrod",7,6,2,1,2,2,0,7
West Coast,"Cripps, Jamie",19,12,6,7,2,1,0,2
West Coast,"Darling, Jack",10,6,5,4,1,0,0,1
West Coast,"Duggan, Liam",12,9,5,3,0,0,0,3
West Coast,"Gaff, Andrew",31,18,4,13,0,0,0,0
West Coast,"Hickey, Tom",18,7,4,11,0,0,26,3
West Coast,"Hurn, Shannon",17,11,5,6,0,0,0,0
West Coast,"Hutchings, Mark",10,8,3,2,0,2,0,0
West Coast,"Jetta, Lewis",18,12,4,6,0,0,0,2
West Coast,"Kennedy, Josh",9,9,8,0,3,5,0,1
West Coast,"Masten, Chris",13,10,7,3,0,0,0,2
West Coast,"McGovern, Jeremy",16,11,7,5,0,1,0,0
West Coast,"Nelson, Jackson",9,9,4,0,0,0,0,1
West Coast,"Petruccelle, Jack",10,9,2,1,2,2,0,1
West Coast,"Redden, Jack",30,12,5,18,0,2,0,6
West Coast,"Ryan, Liam",15,9,3,6,1,2,0,1
West Coast,"Schofield, Will",8,5,3,3,0,0,0,2
West Coast,"Sheed, Dom",36,13,5,23,2,0,0,1
West Coast,"Sheppard, Brad",19,14,11,5,0,0,0,0
West Coast,"Shuey, Luke",26,12,7,14,0,0,0,7
West Coast,"Yeo, Elliot",25,17,3,8,1,0,0,12
West Coast,"Allen, Oscar",9,6,4,3,0,0,0,2
West Coast,"Cameron, Jarrod",6,6,2,0,0,0,0,2
West Coast,"Cripps, Jamie",13,9,1,4,3,0,0,6
West Coast,"Darling, Jack",17,11,6,6,5,2,0,3
West Coast,"Duggan, Liam",10,7,1,3,0,0,0,0
West Coast,"Gaff, Andrew",34,28,6,6,0,0,0,1
West Coast,"Hickey, Tom",11,3,1,8,0,0,20,7
West Coast,"Hurn, Shannon",19,16,4,3,0,0,0,4
West Coast,"Hutchings, Mark",7,1,0,6,0,0,0,5
West Coast,"Jetta, Lewis",15,10,0,5,0,0,0,5
West Coast,"Kennedy, Josh",7,4,1,3,0,1,0,0
West Coast,"Masten, Chris",10,7,3,3,0,0,0,2
West Coast,"Naitanui, Nic",6,5,0,1,0,1,42,4
West Coast,"Nelson, Jackson",21,10,2,11,0,0,0,4
West Coast,"Redden, Jack",30,10,3,20,0,0,0,6
West Coast,"Rioli, Willie",6,3,0,3,0,0,0,5
West Coast,"Ryan, Liam",14,11,3,3,2,0,0,3
West Coast,"Schofield, Will",6,6,1,0,0,0,0,5
West Coast,"Sheed, Dom",27,16,5,11,0,0,0,3
West Coast,"Sheppard, Brad",15,14,4,1,0,1,0,3
West Coast,"Shuey, Luke",39,27,2,12,1,0,0,9
West Coast,"Yeo, Elliot",16,8,1,8,0,0,0,12
West Coast,"Ah Chee, Brendon",15,11,7,4,1,0,0,0
West Coast,"Allen, Oscar",10,6,3,4,0,0,0,6
West Coast,"Barrass, Tom",7,6,5,1,0,0,0,1
West Coast,"Cameron, Jarrod",7,4,0,3,4,0,0,3
West Coast,"Cripps, Jamie",14,5,3,9,4,1,0,4
West Coast,"Darling, Jack",10,8,4,2,4,1,0,4
West Coast,"Duggan, Liam",14,9,7,5,0,0,0,5
West Coast,"Gaff, Andrew",35,19,3,16,0,0,0,1
West Coast,"Hickey, Tom",11,5,4,6,2,0,23,5
West Coast,"Hurn, Shannon",22,19,8,3,0,0,0,3
West Coast,"Jetta, Lewis",16,11,3,5,0,0,0,1
West Coast,"Masten, Chris",25,12,7,13,1,0,0,2
West Coast,"McGovern, Jeremy",15,14,7,1,0,0,0,3
West Coast,"Naitanui, Nic",14,8,1,6,0,0,23,0
West Coast,"Nelson, Jackson",7,5,3,2,0,0,0,3
West Coast,"Redden, Jack",25,10,2,15,0,0,0,6
West Coast,"Rioli, Willie",9,6,2,3,1,1,0,1
West Coast,"Ryan, Liam",10,8,1,2,0,2,0,4
West Coast,"Sheed, Dom",28,15,4,13,0,0,0,1
West Coast,"Sheppard, Brad",25,19,7,6,0,0,0,2
West Coast,"Shuey, Luke",28,18,1,10,1,0,0,8
West Coast,"Yeo, Elliot",20,13,1,7,1,0,0,7
West Coast,"Allen, Oscar",12,8,7,4,1,0,0,2
West Coast,"Barrass, Tom",12,11,8,1,0,0,0,0
West Coast,"Cameron, Jarrod",13,10,5,3,4,0,0,7
West Coast,"Cole, Tom",15,12,10,3,0,0,0,5
West Coast,"Cripps, Jamie",1,1,0,0,0,0,0,2
West Coast,"Darling, Jack",11,8,5,3,3,1,0,3
West Coast,"Gaff, Andrew",32,16,6,16,0,0,0,2
West Coast,"Hickey, Tom",11,4,3,7,1,0,14,2
West Coast,"Hurn, Shannon",17,14,3,3,0,0,0,4
West Coast,"Jetta, Lewis",17,11,2,6,0,0,0,3
West Coast,"Kennedy, Josh",5,3,1,2,0,0,0,2
West Coast,"Masten, Chris",21,9,4,12,0,0,0,1
West Coast,"McGovern, Jeremy",16,9,7,7,0,0,0,2
West Coast,"Naitanui, Nic",14,8,1,6,0,0,28,4
West Coast,"Nelson, Jackson",14,11,5,3,0,0,0,0
West Coast,"Redden, Jack",27,14,8,13,0,0,0,6
West Coast,"Rioli, Willie",13,8,2,5,0,1,0,2
West Coast,"Ryan, Liam",11,7,1,4,1,0,0,0
West Coast,"Sheed, Dom",27,13,6,14,0,1,0,4
West Coast,"Sheppard, Brad",19,15,7,4,0,0,0,3
West Coast,"Shuey, Luke",22,16,2,6,0,0,0,4
West Coast,"Yeo, Elliot",26,14,4,12,2,0,0,8
West Coast,"Allen, Oscar",12,5,3,7,1,0,1,4
West Coast,"Barrass, Tom",9,8,4,1,0,0,0,1
West Coast,"Cameron, Jarrod",7,2,1,5,0,0,0,3
West Coast,"Cole, Tom",11,7,4,4,0,0,0,4
West Coast,"Darling, Jack",16,12,9,4,4,0,0,2
West Coast,"Gaff, Andrew",27,18,7,9,0,0,0,4
West Coast,"Hickey, Tom",11,6,2,5,0,0,20,2
West Coast,"Jetta, Lewis",13,12,2,1,0,0,0,2
West Coast,"Kennedy, Josh",6,5,2,1,2,1,0,1
West Coast,"Masten, Chris",21,15,8,6,0,0,0,2
West Coast,"McGovern, Jeremy",11,10,5,1,0,0,0,1
West Coast,"Nelson, Jackson",7,7,3,0,0,0,0,1
West Coast,"Petruccelle, Jack",8,6,1,2,2,1,0,2
West Coast,"Redden, Jack",20,7,3,13,0,0,0,6
West Coast,"Rioli, Willie",16,10,7,6,1,1,0,3
West Coast,"Ryan, Liam",10,7,3,3,1,1,0,1
West Coast,"Sheed, Dom",34,18,8,16,1,1,0,2
West Coast,"Sheppard, Brad",22,14,10,8,0,0,0,1
West Coast,"Shuey, Luke",23,13,3,10,0,0,0,8
West Coast,"Waterman, Jake",7,6,3,1,1,0,0,3
West Coast,"Watson, Francis",14,11,8,3,0,0,0,2
West Coast,"Yeo, Elliot",16,10,3,6,1,0,0,9
West Coast,"Allen, Oscar",11,7,5,4,1,0,7,1
West Coast,"Barrass, Tom",10,7,5,3,0,0,1,0
West Coast,"Cameron, Jarrod",5,2,1,3,0,0,0,3
West Coast,"Darling, Jack",21,12,7,9,2,2,1,5
West Coast,"Gaff, Andrew",33,19,5,14,0,0,0,1
West Coast,"Hickey, Tom",13,5,2,8,1,0,12,2
West Coast,"Jetta, Lewis",21,17,3,4,0,0,0,3
West Coast,"Kennedy, Josh",11,10,8,1,7,0,0,1
West Coast,"Masten, Chris",19,12,4,7,0,0,0,2
West Coast,"McGovern, Jeremy",12,6,3,6,0,0,1,1
West Coast,"Nelson, Jackson",22,10,4,12,0,0,0,3
West Coast,"Petruccelle, Jack",12,7,6,5,1,1,0,2
West Coast,"Redden, Jack",27,11,7,16,0,0,0,7
West Coast,"Rioli, Willie",19,14,6,5,2,1,0,2
West Coast,"Ryan, Liam",9,8,3,1,1,2,0,0
West Coast,"Schofield, Will",8,5,4,3,0,0,5,1
West Coast,"Sheed, Dom",31,15,7,16,0,0,0,5
West Coast,"Sheppard, Brad",21,9,5,12,0,0,0,0
West Coast,"Shuey, Luke",23,12,2,11,0,0,0,7
West Coast,"Waterman, Jake",9,6,4,3,2,0,0,0
West Coast,"Watson, Francis",13,8,4,5,0,0,0,3
West Coast,"Yeo, Elliot",26,14,2,12,1,1,0,7
West Coast,"Allen, Oscar",15,6,2,9,1,1,7,1
West Coast,"Barrass, Tom",12,11,6,1,0,0,0,0
West Coast,"Cameron, Jarrod",8,5,3,3,1,0,0,3
West Coast,"Darling, Jack",13,10,5,3,2,2,1,1
West Coast,"Gaff, Andrew",28,18,7,10,0,0,0,3
West Coast,"Hickey, Tom",19,7,5,12,0,0,23,2
West Coast,"Hurn, Shannon",21,18,7,3,0,0,0,0
West Coast,"Jetta, Lewis",14,10,3,4,0,0,0,1
West Coast,"Kennedy, Josh",5,4,3,1,1,3,0,2
West Coast,"Masten, Chris",19,10,5,9,0,0,0,1
West Coast,"McGovern, Jeremy",18,14,13,4,0,0,0,1
West Coast,"Nelson, Jackson",13,8,5,5,0,0,0,0
West Coast,"Petruccelle, Jack",15,11,7,4,1,0,0,1
West Coast,"Redden, Jack",21,9,4,12,0,0,0,8
West Coast,"Rioli, Willie",10,4,1,6,1,0,0,2
West Coast,"Ryan, Liam",16,15,4,1,4,0,0,1
West Coast,"Schofield, Will",8,5,3,3,0,0,0,1
West Coast,"Sheed, Dom",18,11,3,7,0,1,0,0
West Coast,"Sheppard, Brad",22,16,8,6,0,0,0,1
West Coast,"Shuey, Luke",27,16,4,11,2,0,0,2
West Coast,"Waterman, Jake",14,8,7,6,2,0,0,1
West Coast,"Yeo, Elliot",25,15,6,10,0,0,0,10
West Coast,"Allen, Oscar",10,5,3,5,3,0,5,6
West Coast,"Barrass, Tom",15,12,10,3,0,0,0,1
West Coast,"Cripps, Jamie",11,7,2,4,0,0,0,5
West Coast,"Darling, Jack",16,11,9,5,3,1,1,7
West Coast,"Gaff, Andrew",29,17,6,12,0,0,0,3
West Coast,"Hickey, Tom",15,8,5,7,0,1,24,2
West Coast,"Hurn, Shannon",19,17,5,2,0,0,0,1
West Coast,"Hutchings, Mark",16,12,8,4,0,0,0,1
West Coast,"Jetta, Lewis",10,8,2,2,0,0,0,0
West Coast,"Kennedy, Josh",6,5,0,1,1,1,0,1
West Coast,"McGovern, Jeremy",16,8,4,8,0,0,0,4
West Coast,"Nelson, Jackson",9,4,2,5,0,0,0,0
West Coast,"Petruccelle, Jack",12,8,6,4,0,0,0,0
West Coast,"Redden, Jack",23,11,5,12,0,0,0,4
West Coast,"Rioli, Willie",21,14,5,7,1,1,0,7
West Coast,"Ryan, Liam",12,10,5,2,1,0,0,3
West Coast,"Schofield, Will",11,6,3,5,0,0,0,1
West Coast,"Sheed, Dom",26,15,6,11,1,2,0,2
West Coast,"Sheppard, Brad",15,10,7,5,0,0,0,1
West Coast,"Shuey, Luke",29,14,6,15,0,0,0,5
West Coast,"Waterman, Jake",12,10,7,2,3,0,0,3
West Coast,"Yeo, Elliot",26,13,2,13,0,2,0,5
West Coast,"Allen, Oscar",9,5,2,4,1,0,1,1
West Coast,"Barrass, Tom",14,8,5,6,0,0,0,3
West Coast,"Cripps, Jamie",13,9,1,4,3,0,0,4
West Coast,"Darling, Jack",9,7,3,2,2,0,4,3
West Coast,"Gaff, Andrew",29,20,5,9,0,0,0,3
West Coast,"Hickey, Tom",11,7,2,4,1,0,31,1
West Coast,"Hurn, Shannon",24,20,10,4,0,1,0,2
West Coast,"Hutchings, Mark",3,2,1,1,0,0,0,0
West Coast,"Jetta, Lewis",19,16,5,3,0,0,0,1
West Coast,"Kennedy, Josh",8,5,4,3,1,1,0,5
West Coast,"McGovern, Jeremy",15,14,8,1,0,0,0,4
West Coast,"Nelson, Jackson",14,9,6,5,0,0,0,1
West Coast,"Petruccelle, Jack",6,2,0,4,1,0,0,2
West Coast,"Redden, Jack",17,9,1,8,0,0,0,3
West Coast,"Rioli, Willie",12,8,1,4,2,1,0,2
West Coast,"Rotham, Josh",13,7,7,6,0,0,0,2
West Coast,"Ryan, Liam",11,9,3,2,1,0,0,1
West Coast,"Sheed, Dom",14,10,3,4,0,0,0,0
West Coast,"Sheppard, Brad",21,15,7,6,0,0,0,1
West Coast,"Shuey, Luke",25,19,4,6,0,1,0,3
West Coast,"Waterman, Jake",8,6,2,2,1,0,0,0
West Coast,"Yeo, Elliot",26,17,5,9,0,0,0,9
West Coast,"Allen, Oscar",13,8,7,5,0,0,3,2
West Coast,"Barrass, Tom",9,7,6,2,0,0,0,2
West Coast,"Cripps, Jamie",7,3,2,4,0,1,0,4
West Coast,"Darling, Jack",9,5,3,4,2,0,0,1
West Coast,"Duggan, Liam",19,15,12,4,0,0,0,2
West Coast,"Gaff, Andrew",37,25,7,12,0,0,0,2
West Coast,"Hickey, Tom",15,5,0,10,0,0,20,1
West Coast,"Hurn, Shannon",24,10,10,14,0,0,0,0
West Coast,"Jetta, Lewis",23,17,3,6,0,0,0,2
West Coast,"Kennedy, Josh",6,4,4,2,2,2,0,4
West Coast,"Masten, Chris",19,11,6,8,0,0,0,3
West Coast,"McGovern, Jeremy",12,6,5,6,0,0,2,3
West Coast,"Nelson, Jackson",13,10,4,3,0,0,0,3
West Coast,"Petruccelle, Jack",7,3,1,4,0,1,0,3
West Coast,"Redden, Jack",23,9,5,14,0,1,0,5
West Coast,"Rioli, Willie",15,10,4,5,3,0,0,6
West Coast,"Ryan, Liam",13,10,2,3,2,2,0,1
West Coast,"Sheed, Dom",26,15,6,11,0,2,0,0
West Coast,"Sheppard, Brad",15,11,5,4,0,0,0,1
West Coast,"Shuey, Luke",29,19,4,10,0,0,0,6
West Coast,"Waterman, Jake",20,16,11,4,0,2,0,0
West Coast,"Yeo, Elliot",26,15,7,11,0,2,0,5
West Coast,"Barrass, Tom",15,11,8,4,0,0,0,1
West Coast,"Cripps, Jamie",22,13,4,9,4,3,0,3
West Coast,"Darling, Jack",11,7,4,4,2,0,1,1
West Coast,"Gaff, Andrew",34,22,9,12,0,0,0,1
West Coast,"Hickey, Tom",6,4,2,2,0,1,13,3
West Coast,"Hurn, Shannon",18,15,6,3,0,0,0,1
West Coast,"Hutchings, Mark",10,4,4,6,0,0,0,1
West Coast,"Jetta, Lewis",19,14,5,5,0,0,0,1
West Coast,"Kennedy, Josh",10,7,6,3,4,2,0,1
West Coast,"Masten, Chris",21,12,8,9,0,1,0,0
West Coast,"McGovern, Jeremy",10,9,5,1,0,0,0,2
West Coast,"Naitanui, Nic",14,7,2,7,0,0,24,4
West Coast,"Nelson, Jackson",10,9,5,1,0,0,0,1
West Coast,"Redden, Jack",29,15,9,14,0,0,0,6
West Coast,"Rioli, Willie",15,10,7,5,1,1,0,1
West Coast,"Ryan, Liam",13,9,4,4,3,0,0,1
West Coast,"Schofield, Will",10,7,5,3,0,0,0,2
West Coast,"Sheed, Dom",22,16,4,6,1,1,0,3
West Coast,"Sheppard, Brad",19,15,11,4,0,0,0,1
West Coast,"Shuey, Luke",35,23,4,12,0,0,0,4
West Coast,"Waterman, Jake",16,10,10,6,2,1,0,0
West Coast,"Yeo, Elliot",22,18,6,4,0,1,0,5
West Coast,"Barrass, Tom",4,3,1,1,0,0,0,1
West Coast,"Cripps, Jamie",9,5,4,4,0,0,0,3
West Coast,"Darling, Jack",9,9,5,0,3,0,2,5
West Coast,"Gaff, Andrew",30,22,7,8,2,0,0,1
West Coast,"Hickey, Tom",9,6,3,3,1,0,12,2
West Coast,"Hurn, Shannon",23,18,14,5,0,0,0,1
West Coast,"Hutchings, Mark",7,4,2,3,0,0,0,1
West Coast,"Jetta, Lewis",20,18,7,2,0,0,0,1
West Coast,"Kennedy, Josh",9,5,2,4,1,0,0,3
West Coast,"Masten, Chris",13,7,6,6,1,0,0,3
West Coast,"McGovern, Jeremy",15,13,7,2,0,0,0,1
West Coast,"Naitanui, Nic",14,9,3,5,0,1,29,5
West Coast,"Nelson, Jackson",9,7,3,2,0,0,0,3
West Coast,"Petruccelle, Jack",9,8,4,1,1,1,0,1
West Coast,"Redden, Jack",18,7,0,11,0,0,0,5
West Coast,"Ryan, Liam",9,8,1,1,1,1,0,3
West Coast,"Schofield, Will",5,4,2,1,0,0,0,1
West Coast,"Sheed, Dom",17,10,1,7,0,0,0,1
West Coast,"Sheppard, Brad",14,7,5,7,0,0,0,1
West Coast,"Shuey, Luke",26,19,6,7,0,0,0,2
West Coast,"Waterman, Jake",10,8,5,2,0,0,0,1
West Coast,"Yeo, Elliot",25,12,4,13,0,2,0,2
Western Bulldogs,"Bontempelli, Marcus",29,17,5,12,1,2,0,7
Western Bulldogs,"Cordy, Zaine",13,7,3,6,0,0,0,0
Western Bulldogs,"Crozier, Hayden",7,4,2,3,0,0,0,1
Western Bulldogs,"Daniel, Caleb",20,12,1,8,0,0,0,5
Western Bulldogs,"Dickson, Tory",11,9,4,2,0,1,0,3
Western Bulldogs,"Dunkley, Josh",20,9,0,11,0,1,0,7
Western Bulldogs,"Duryea, Taylor",15,11,1,4,1,0,0,1
Western Bulldogs,"English, Tim",8,5,1,3,0,0,19,7
Western Bulldogs,"Gowers, Billy",11,10,4,1,2,2,0,2
Western Bulldogs,"Hunter, Lachie",26,10,5,16,0,1,0,8
Western Bulldogs,"Liberatore, Tom",28,18,1,10,0,2,0,3
Western Bulldogs,"Lloyd, Sam",22,12,2,10,2,1,0,3
Western Bulldogs,"Macrae, Jack",32,15,5,17,0,0,0,3
Western Bulldogs,"McLean, Toby",22,11,4,11,0,0,0,3
Western Bulldogs,"Naughton, Aaron",15,11,6,4,3,2,0,1
Western Bulldogs,"Richards, Ed",12,6,1,6,1,0,0,0
Western Bulldogs,"Schache, Josh",10,4,0,6,1,1,1,1
Western Bulldogs,"Smith, Bailey",8,4,1,4,0,0,0,4
Western Bulldogs,"Suckling, Matt",22,16,5,6,0,0,0,1
Western Bulldogs,"Wallis, Mitch",26,10,4,16,0,1,0,4
Western Bulldogs,"Williams, Bailey",12,11,4,1,0,0,0,1
Western Bulldogs,"Wood, Easton",5,5,3,0,0,0,0,1
Western Bulldogs,"Bontempelli, Marcus",26,16,4,10,0,1,0,7
Western Bulldogs,"Cordy, Zaine",13,6,5,7,0,0,0,0
Western Bulldogs,"Crozier, Hayden",22,11,7,11,0,0,0,1
Western Bulldogs,"Daniel, Caleb",32,17,2,15,0,0,0,3
Western Bulldogs,"Dickson, Tory",20,13,6,7,3,0,0,4
Western Bulldogs,"Dunkley, Josh",18,9,2,9,0,0,0,4
Western Bulldogs,"Duryea, Taylor",17,12,5,5,0,0,0,1
Western Bulldogs,"English, Tim",14,5,4,9,0,1,15,4
Western Bulldogs,"Gowers, Billy",9,5,3,4,3,1,0,0
Western Bulldogs,"Hunter, Lachie",33,16,8,17,0,0,0,4
Western Bulldogs,"Liberatore, Tom",28,12,3,16,1,0,0,7
Western Bulldogs,"Lloyd, Sam",16,12,6,4,0,0,0,1
Western Bulldogs,"Macrae, Jack",36,14,7,22,1,1,0,3
Western Bulldogs,"McLean, Toby",18,8,2,10,2,0,0,4
Western Bulldogs,"Naughton, Aaron",8,5,3,3,1,1,0,4
Western Bulldogs,"Richards, Ed",14,6,1,8,0,1,0,1
Western Bulldogs,"Schache, Josh",15,9,5,6,4,2,2,1
Western Bulldogs,"Smith, Bailey",13,6,0,7,0,0,0,2
Western Bulldogs,"Suckling, Matt",29,25,9,4,0,0,0,2
Western Bulldogs,"Wallis, Mitch",29,13,5,16,1,0,0,1
Western Bulldogs,"Wood, Easton",9,7,4,2,0,0,0,2
Western Bulldogs,"Young, Lewis",9,8,5,1,0,0,0,1
Western Bulldogs,"Bontempelli, Marcus",34,22,7,12,0,3,0,4
Western Bulldogs,"Cordy, Zaine",9,7,4,2,0,0,0,1
Western Bulldogs,"Crozier, Hayden",11,9,5,2,0,0,0,0
Western Bulldogs,"Daniel, Caleb",24,20,4,4,0,0,0,4
Western Bulldogs,"Dickson, Tory",7,4,4,3,1,0,0,3
Western Bulldogs,"Dunkley, Josh",16,12,6,4,2,1,0,2
Western Bulldogs,"Duryea, Taylor",18,16,3,2,0,0,0,4
Western Bulldogs,"English, Tim",9,3,2,6,0,0,15,3
Western Bulldogs,"Gowers, Billy",13,8,6,5,1,2,0,1
Western Bulldogs,"Hunter, Lachie",27,14,8,13,0,0,0,0
Western Bulldogs,"Liberatore, Tom",30,14,3,16,0,0,0,9
Western Bulldogs,"Lloyd, Sam",13,7,4,6,1,2,0,0
Western Bulldogs,"Macrae, Jack",33,15,4,18,0,0,0,9
Western Bulldogs,"McLean, Toby",11,7,2,4,1,1,0,2
Western Bulldogs,"Naughton, Aaron",13,8,9,5,1,1,0,0
Western Bulldogs,"Richards, Ed",8,6,3,2,0,0,0,2
Western Bulldogs,"Schache, Josh",7,4,3,3,0,0,1,2
Western Bulldogs,"Smith, Bailey",22,8,2,14,0,1,0,6
Western Bulldogs,"Suckling, Matt",19,14,6,5,1,0,0,2
Western Bulldogs,"Wallis, Mitch",23,12,2,11,1,0,0,1
Western Bulldogs,"Wood, Easton",12,9,5,3,0,0,0,1
Western Bulldogs,"Young, Lewis",10,7,3,3,0,0,0,0
Western Bulldogs,"Bontempelli, Marcus",36,15,3,21,0,1,0,7
Western Bulldogs,"Cordy, Zaine",8,1,2,7,0,0,0,2
Western Bulldogs,"Crozier, Hayden",13,12,7,1,0,0,0,3
Western Bulldogs,"Daniel, Caleb",30,21,6,9,0,0,0,3
Western Bulldogs,"Dickson, Tory",13,6,4,7,1,1,0,2
Western Bulldogs,"Dunkley, Josh",15,6,5,9,1,0,0,3
Western Bulldogs,"Duryea, Taylor",21,13,6,8,0,0,0,1
Western Bulldogs,"English, Tim",17,6,6,11,0,1,6,6
Western Bulldogs,"Gowers, Billy",5,1,0,4,0,0,0,3
Western Bulldogs,"Hunter, Lachie",29,13,12,16,0,0,0,0
Western Bulldogs,"Johannisen, Jason",25,18,8,7,0,0,0,3
Western Bulldogs,"Liberatore, Tom",25,12,5,13,0,1,0,7
Western Bulldogs,"Lloyd, Sam",12,10,6,2,2,1,0,3
Western Bulldogs,"Macrae, Jack",33,14,5,19,0,0,0,3
Western Bulldogs,"McLean, Toby",15,6,7,9,1,0,0,4
Western Bulldogs,"Naughton, Aaron",11,6,5,5,1,1,0,0
Western Bulldogs,"Richards, Ed",12,6,3,6,0,0,0,1
Western Bulldogs,"Schache, Josh",4,1,1,3,0,0,0,0
Western Bulldogs,"Smith, Bailey",13,10,4,3,1,1,0,2
Western Bulldogs,"Suckling, Matt",27,21,8,6,1,1,0,1
Western Bulldogs,"Wallis, Mitch",19,8,4,11,1,0,0,2
Western Bulldogs,"Wood, Easton",15,13,7,2,0,0,0,2
Western Bulldogs,"Bontempelli, Marcus",24,16,3,8,0,2,1,2
Western Bulldogs,"Cordy, Zaine",6,2,1,4,0,0,0,3
Western Bulldogs,"Crozier, Hayden",18,16,8,2,0,0,0,2
Western Bulldogs,"Daniel, Caleb",31,14,2,17,0,0,0,1
Western Bulldogs,"Dickson, Tory",12,8,2,4,2,0,0,1
Western Bulldogs,"Dunkley, Josh",15,4,4,11,0,0,1,9
Western Bulldogs,"English, Tim",13,9,5,4,0,1,28,7
Western Bulldogs,"Gowers, Billy",13,8,6,5,1,2,0,1
Western Bulldogs,"Hayes, Will",21,7,7,14,0,0,0,1
Western Bulldogs,"Hunter, Lachie",18,6,6,12,0,1,0,1
Western Bulldogs,"Johannisen, Jason",26,21,6,5,0,0,0,0
Western Bulldogs,"Liberatore, Tom",19,6,3,13,1,2,0,3
Western Bulldogs,"Lloyd, Sam",11,7,3,4,2,1,0,0
Western Bulldogs,"Macrae, Jack",24,11,5,13,0,0,0,6
Western Bulldogs,"McLean, Toby",17,10,7,7,1,1,0,5
Western Bulldogs,"Naughton, Aaron",5,4,2,1,0,0,0,1
Western Bulldogs,"Richards, Ed",16,12,4,4,0,0,0,1
Western Bulldogs,"Smith, Bailey",18,10,3,8,0,0,0,3
Western Bulldogs,"Wallis, Mitch",16,7,1,9,0,0,0,4
Western Bulldogs,"Williams, Bailey",9,5,3,4,0,1,0,4
Western Bulldogs,"Wood, Easton",11,3,4,8,0,2,0,1
Western Bulldogs,"Young, Lachie",12,7,3,5,0,0,0,4
Western Bulldogs,"Bontempelli, Marcus",22,10,6,12,1,0,0,3
Western Bulldogs,"Cordy, Zaine",10,4,2,6,0,0,0,4
Western Bulldogs,"Crozier, Hayden",22,12,6,10,0,0,0,5
Western Bulldogs,"Daniel, Caleb",30,22,6,8,0,0,0,1
Western Bulldogs,"Dickson, Tory",12,7,4,5,1,2,0,1
Western Bulldogs,"Dunkley, Josh",24,11,4,13,0,1,0,3
Western Bulldogs,"English, Tim",17,7,7,10,0,1,21,1
Western Bulldogs,"Gowers, Billy",9,4,0,5,1,2,0,0
Western Bulldogs,"Hayes, Will",15,11,5,4,1,1,0,3
Western Bulldogs,"Hunter, Lachie",32,23,8,9,1,0,0,1
Western Bulldogs,"Johannisen, Jason",23,17,5,6,0,0,0,2
Western Bulldogs,"Liberatore, Tom",21,12,2,9,0,0,0,1
Western Bulldogs,"Lloyd, Sam",10,6,6,4,2,0,0,2
Western Bulldogs,"Macrae, Jack",29,12,4,17,0,0,0,3
Western Bulldogs,"McLean, Toby",18,12,5,6,0,0,0,4
Western Bulldogs,"Naughton, Aaron",12,6,5,6,0,0,0,0
Western Bulldogs,"Richards, Ed",12,9,4,3,0,2,0,2
Western Bulldogs,"Smith, Bailey",23,11,5,12,1,0,0,3
Western Bulldogs,"Trengove, Jackson",12,7,4,5,0,0,6,1
Western Bulldogs,"Wallis, Mitch",21,9,3,12,1,3,0,4
Western Bulldogs,"Wood, Easton",10,4,2,6,0,0,0,0
Western Bulldogs,"Young, Lachie",12,6,7,6,0,0,0,0
Western Bulldogs,"Bontempelli, Marcus",27,16,9,11,3,0,0,0
Western Bulldogs,"Cordy, Zaine",13,4,5,9,0,0,6,1
Western Bulldogs,"Crozier, Hayden",28,19,9,9,0,0,0,4
Western Bulldogs,"Daniel, Caleb",36,22,3,14,0,0,0,6
Western Bulldogs,"Dickson, Tory",12,7,4,5,0,1,0,1
Western Bulldogs,"Dunkley, Josh",35,16,8,19,0,0,0,8
Western Bulldogs,"English, Tim",14,8,7,6,0,0,26,2
Western Bulldogs,"Gowers, Billy",6,5,4,1,2,1,0,0
Western Bulldogs,"Hayes, Will",15,9,5,6,0,0,0,2
Western Bulldogs,"Hunter, Lachie",22,11,5,11,0,0,0,3
Western Bulldogs,"Johannisen, Jason",21,11,4,10,1,1,0,4
Western Bulldogs,"Liberatore, Tom",14,4,1,10,0,0,0,1
Western Bulldogs,"Lloyd, Sam",20,15,7,5,1,3,0,4
Western Bulldogs,"Macrae, Jack",36,12,2,24,0,0,0,2
Western Bulldogs,"McLean, Toby",24,11,8,13,1,0,0,3
Western Bulldogs,"Naughton, Aaron",16,14,14,2,5,3,0,1
Western Bulldogs,"Richards, Ed",12,9,6,3,1,0,0,4
Western Bulldogs,"Smith, Bailey",22,10,6,12,1,0,0,3
Western Bulldogs,"Trengove, Jackson",14,9,5,5,0,0,0,3
Western Bulldogs,"Wallis, Mitch",23,10,6,13,0,0,0,4
Western Bulldogs,"Wood, Easton",12,7,8,5,0,0,0,2
Western Bulldogs,"Young, Lachie",18,11,8,7,0,0,0,1
Western Bulldogs,"Bontempelli, Marcus",26,16,3,10,1,2,0,4
Western Bulldogs,"Cordy, Zaine",10,5,2,5,0,0,4,1
Western Bulldogs,"Crozier, Hayden",13,9,5,4,0,0,0,5
Western Bulldogs,"Daniel, Caleb",16,13,2,3,0,0,0,3
Western Bulldogs,"Dunkley, Josh",36,15,2,21,1,1,0,8
Western Bulldogs,"Gowers, Billy",6,5,2,1,0,2,0,5
Western Bulldogs,"Hayes, Will",15,9,2,6,1,0,0,4
Western Bulldogs,"Hunter, Lachie",32,22,9,10,0,0,0,2
Western Bulldogs,"Johannisen, Jason",19,14,5,5,0,0,0,2
Western Bulldogs,"Liberatore, Tom",23,12,2,11,0,1,0,5
Western Bulldogs,"Lloyd, Sam",19,17,6,2,2,1,0,5
Western Bulldogs,"Macrae, Jack",28,12,3,16,1,0,0,3
Western Bulldogs,"McLean, Toby",11,5,1,6,0,2,0,2
Western Bulldogs,"Naughton, Aaron",15,11,7,4,3,2,0,2
Western Bulldogs,"Richards, Ed",12,6,2,6,2,1,0,3
Western Bulldogs,"Roberts, Fletcher",9,5,2,4,0,0,0,1
Western Bulldogs,"Smith, Bailey",10,3,0,7,0,0,0,9
Western Bulldogs,"Suckling, Matt",21,14,4,7,1,0,0,6
Western Bulldogs,"Trengove, Jackson",21,11,2,10,0,0,27,6
Western Bulldogs,"Wallis, Mitch",17,10,3,7,1,0,0,5
Western Bulldogs,"Wood, Easton",8,7,2,1,0,0,0,3
Western Bulldogs,"Young, Lachie",7,3,0,4,0,0,0,2
Western Bulldogs,"Bontempelli, Marcus",20,9,3,11,2,1,0,1
Western Bulldogs,"Cordy, Zaine",8,5,2,3,0,0,2,3
Western Bulldogs,"Crozier, Hayden",15,8,6,7,0,0,0,1
Western Bulldogs,"Daniel, Caleb",17,13,5,4,0,0,0,1
Western Bulldogs,"Dunkley, Josh",21,5,4,16,0,1,0,5
Western Bulldogs,"Gowers, Billy",8,4,1,4,1,1,0,1
Western Bulldogs,"Hayes, Will",13,6,2,7,0,0,0,3
Western Bulldogs,"Hunter, Lachie",26,16,6,10,1,0,0,0
Western Bulldogs,"Johannisen, Jason",18,13,3,5,1,0,0,2
Western Bulldogs,"Liberatore, Tom",16,5,2,11,1,0,0,4
Western Bulldogs,"Lloyd, Sam",16,15,3,1,1,0,0,5
Western Bulldogs,"Macrae, Jack",29,9,4,20,0,0,0,8
Western Bulldogs,"McLean, Toby",23,13,5,10,1,2,0,2
Western Bulldogs,"Naughton, Aaron",10,5,3,5,1,2,2,0
Western Bulldogs,"Richards, Ed",7,5,2,2,1,1,0,3
Western Bulldogs,"Roberts, Fletcher",9,5,2,4,0,0,0,2
Western Bulldogs,"Smith, Bailey",28,9,1,19,0,1,0,3
Western Bulldogs,"Suckling, Matt",12,9,3,3,0,1,0,0
Western Bulldogs,"Trengove, Jackson",18,7,1,11,1,0,23,6
Western Bulldogs,"Wallis, Mitch",29,15,4,14,2,0,0,0
Western Bulldogs,"Wood, Easton",11,6,0,5,0,0,0,1
Western Bulldogs,"Young, Lachie",7,4,1,3,0,0,0,2
Western Bulldogs,"Bontempelli, Marcus",25,16,8,9,1,2,0,1
Western Bulldogs,"Cordy, Zaine",8,5,1,3,0,0,8,1
Western Bulldogs,"Crozier, Hayden",16,12,6,4,0,0,0,1
Western Bulldogs,"Dale, Bailey",12,7,1,5,0,0,0,0
Western Bulldogs,"Daniel, Caleb",29,21,9,8,0,0,0,0
Western Bulldogs,"Dunkley, Josh",29,16,6,13,0,1,0,6
Western Bulldogs,"English, Tim",11,7,5,4,2,1,7,1
Western Bulldogs,"Hunter, Lachie",23,11,5,12,0,0,0,2
Western Bulldogs,"Johannisen, Jason",20,9,6,11,1,0,0,4
Western Bulldogs,"Liberatore, Tom",23,10,1,13,2,0,0,8
Western Bulldogs,"Lipinski, Patrick",23,10,6,13,0,0,0,1
Western Bulldogs,"Lloyd, Sam",16,13,6,3,3,3,0,0
Western Bulldogs,"Macrae, Jack",22,10,2,12,0,0,0,5
Western Bulldogs,"McLean, Toby",14,4,3,10,0,0,0,3
Western Bulldogs,"Naughton, Aaron",8,6,3,2,1,0,0,4
Western Bulldogs,"Richards, Ed",9,4,1,5,0,1,0,2
Western Bulldogs,"Smith, Bailey",21,9,5,12,1,0,0,5
Western Bulldogs,"Suckling, Matt",18,13,4,5,1,2,0,1
Western Bulldogs,"Trengove, Jackson",7,5,3,2,0,0,1,3
Western Bulldogs,"Wallis, Mitch",15,5,4,10,1,1,0,2
Western Bulldogs,"Williams, Bailey",16,10,5,6,0,0,0,0
Western Bulldogs,"Wood, Easton",12,10,4,2,0,0,0,1
Western Bulldogs,"Bontempelli, Marcus",27,11,3,16,1,3,0,4
Western Bulldogs,"Cordy, Zaine",14,8,5,6,0,0,0,0
Western Bulldogs,"Dale, Bailey",21,9,7,12,1,1,0,0
Western Bulldogs,"Daniel, Caleb",34,20,4,14,0,0,0,2
Western Bulldogs,"Dunkley, Josh",33,15,5,18,1,0,0,4
Western Bulldogs,"English, Tim",10,5,5,5,0,0,27,4
Western Bulldogs,"Gardner, Ryan",9,3,2,6,1,1,0,1
Western Bulldogs,"Gowers, Billy",9,6,4,3,2,1,0,0
Western Bulldogs,"Hunter, Lachie",28,11,6,17,0,0,0,1
Western Bulldogs,"Johannisen, Jason",32,19,2,13,0,0,0,0
Western Bulldogs,"Liberatore, Tom",27,10,7,17,1,1,0,2
Western Bulldogs,"Lipinski, Patrick",23,8,7,15,0,0,0,2
Western Bulldogs,"Lloyd, Sam",21,15,8,6,1,1,0,3
Western Bulldogs,"Macrae, Jack",26,11,2,15,0,0,0,0
Western Bulldogs,"McLean, Toby",16,8,4,8,0,0,0,4
Western Bulldogs,"Naughton, Aaron",7,5,5,2,1,1,0,0
Western Bulldogs,"Smith, Bailey",16,8,2,8,0,1,0,1
Western Bulldogs,"Suckling, Matt",22,15,7,7,1,0,0,0
Western Bulldogs,"Trengove, Jackson",7,4,4,3,0,0,0,1
Western Bulldogs,"Williams, Bailey",15,13,5,2,0,0,0,1
Western Bulldogs,"Wood, Easton",14,10,4,4,0,0,0,2
Western Bulldogs,"Young, Lachie",10,9,5,1,0,0,0,1
Western Bulldogs,"Bontempelli, Marcus",27,16,5,11,0,1,0,2
Western Bulldogs,"Cordy, Zaine",8,7,5,1,0,0,0,5
Western Bulldogs,"Crozier, Hayden",14,10,7,4,0,0,0,1
Western Bulldogs,"Dale, Bailey",4,1,0,3,0,1,0,3
Western Bulldogs,"Daniel, Caleb",32,20,5,12,0,0,0,3
Western Bulldogs,"Dickson, Tory",10,5,5,5,2,0,0,2
Western Bulldogs,"Dunkley, Josh",41,19,5,22,1,0,0,10
Western Bulldogs,"English, Tim",15,8,4,7,2,2,29,0
Western Bulldogs,"Gardner, Ryan",3,1,0,2,1,0,4,0
Western Bulldogs,"Hunter, Lachie",24,12,4,12,0,0,0,3
Western Bulldogs,"Johannisen, Jason",21,10,5,11,0,1,0,1
Western Bulldogs,"Liberatore, Tom",11,5,3,6,0,0,0,0
Western Bulldogs,"Lipinski, Patrick",29,15,8,14,2,0,0,5
Western Bulldogs,"Lloyd, Sam",16,10,5,6,3,1,0,2
Western Bulldogs,"Macrae, Jack",37,19,6,18,0,0,0,8
Western Bulldogs,"McLean, Toby",18,10,4,8,1,0,0,3
Western Bulldogs,"Naughton, Aaron",12,10,7,2,1,3,0,2
Western Bulldogs,"Smith, Bailey",13,3,2,10,1,0,0,5
Western Bulldogs,"Suckling, Matt",21,18,7,3,1,2,0,1
Western Bulldogs,"Trengove, Jackson",12,7,7,5,0,0,0,1
Western Bulldogs,"Williams, Bailey",16,12,5,4,0,0,0,1
Western Bulldogs,"Wood, Easton",18,13,7,5,0,0,0,1
Western Bulldogs,"Bontempelli, Marcus",30,15,1,15,0,1,0,7
Western Bulldogs,"Cordy, Zaine",10,8,4,2,0,0,0,2
Western Bulldogs,"Crozier, Hayden",13,7,5,6,0,0,0,1
Western Bulldogs,"Daniel, Caleb",35,24,6,11,1,0,0,4
Western Bulldogs,"Dickson, Tory",20,7,5,13,2,0,0,2
Western Bulldogs,"Dunkley, Josh",35,17,6,18,0,0,0,3
Western Bulldogs,"Duryea, Taylor",22,13,7,9,0,1,0,1
Western Bulldogs,"English, Tim",14,5,5,9,0,0,16,3
Western Bulldogs,"Hunter, Lachie",33,14,5,19,0,0,0,3
Western Bulldogs,"Johannisen, Jason",19,12,5,7,0,0,0,3
Western Bulldogs,"Lipinski, Patrick",32,7,7,25,1,0,0,1
Western Bulldogs,"Lloyd, Sam",16,11,6,5,2,3,0,2
Western Bulldogs,"Macrae, Jack",41,19,8,22,0,0,0,13
Western Bulldogs,"Naughton, Aaron",10,5,3,5,0,1,0,1
Western Bulldogs,"Richards, Ed",23,15,6,8,0,0,0,2
Western Bulldogs,"Schache, Josh",9,6,3,3,3,0,1,2
Western Bulldogs,"Smith, Bailey",11,4,1,7,0,0,0,2
Western Bulldogs,"Smith, Roarke",12,7,5,5,0,1,0,3
Western Bulldogs,"Suckling, Matt",21,16,8,5,1,2,0,5
Western Bulldogs,"Trengove, Jackson",19,15,7,4,0,0,0,3
Western Bulldogs,"Williams, Bailey",17,10,1,7,0,2,0,5
Western Bulldogs,"Wood, Easton",13,4,3,9,0,0,0,0
Western Bulldogs,"Bontempelli, Marcus",27,20,0,7,0,0,0,10
Western Bulldogs,"Cordy, Zaine",9,9,3,0,0,0,0,2
Western Bulldogs,"Crozier, Hayden",14,11,5,3,0,0,0,2
Western Bulldogs,"Daniel, Caleb",17,14,2,3,0,0,0,8
Western Bulldogs,"Dickson, Tory",7,2,1,5,2,0,0,4
Western Bulldogs,"Dunkley, Josh",29,20,5,9,0,1,1,7
Western Bulldogs,"Duryea, Taylor",14,13,2,1,0,0,0,0
Western Bulldogs,"English, Tim",10,7,2,3,0,0,9,4
Western Bulldogs,"Hunter, Lachie",17,11,2,6,0,0,0,2
Western Bulldogs,"Johannisen, Jason",25,21,1,4,0,0,0,4
Western Bulldogs,"Lipinski, Patrick",17,11,1,6,2,0,0,7
Western Bulldogs,"Lloyd, Sam",13,10,4,3,0,1,0,8
Western Bulldogs,"Macrae, Jack",36,18,5,18,1,0,0,6
Western Bulldogs,"Naughton, Aaron",6,3,3,3,0,0,7,7
Western Bulldogs,"Richards, Ed",6,2,1,4,0,0,0,7
Western Bulldogs,"Schache, Josh",12,10,4,2,3,0,0,2
Western Bulldogs,"Smith, Bailey",22,8,0,14,0,2,0,14
Western Bulldogs,"Smith, Roarke",24,15,2,9,1,0,0,5
Western Bulldogs,"Suckling, Matt",11,7,5,4,1,1,0,3
Western Bulldogs,"Trengove, Jackson",9,8,2,1,0,0,1,4
Western Bulldogs,"Williams, Bailey",17,13,4,4,0,1,0,3
Western Bulldogs,"Wood, Easton",5,5,2,0,0,0,0,1
Western Bulldogs,"Bontempelli, Marcus",27,20,6,7,1,1,0,6
Western Bulldogs,"Cordy, Zaine",12,9,5,3,0,0,0,0
Western Bulldogs,"Crozier, Hayden",14,10,3,4,0,0,0,2
Western Bulldogs,"Dickson, Tory",8,5,1,3,1,1,0,2
Western Bulldogs,"Dunkley, Josh",27,15,4,12,0,0,1,9
Western Bulldogs,"Duryea, Taylor",15,12,5,3,0,0,0,2
Western Bulldogs,"English, Tim",10,4,3,6,0,1,18,4
Western Bulldogs,"Hunter, Lachie",32,18,9,14,0,1,0,3
Western Bulldogs,"Johannisen, Jason",22,15,5,7,0,0,0,3
Western Bulldogs,"Lipinski, Patrick",17,11,4,6,0,2,0,5
Western Bulldogs,"Lloyd, Sam",13,9,5,4,3,0,0,3
Western Bulldogs,"Macrae, Jack",34,15,5,19,0,0,0,2
Western Bulldogs,"McLean, Toby",23,7,3,16,0,1,0,4
Western Bulldogs,"Naughton, Aaron",14,13,9,1,4,1,2,3
Western Bulldogs,"Richards, Ed",12,7,4,5,0,1,0,5
Western Bulldogs,"Schache, Josh",8,4,1,4,0,0,3,1
Western Bulldogs,"Smith, Bailey",16,5,2,11,1,0,0,2
Western Bulldogs,"Smith, Roarke",4,1,1,3,0,0,0,1
Western Bulldogs,"Suckling, Matt",13,11,4,2,0,0,0,2
Western Bulldogs,"Trengove, Jackson",14,10,6,4,0,0,3,1
Western Bulldogs,"Williams, Bailey",17,11,6,6,0,0,0,3
Western Bulldogs,"Wood, Easton",7,4,2,3,0,0,0,1
Western Bulldogs,"Bontempelli, Marcus",21,13,5,8,0,2,0,5
Western Bulldogs,"Cordy, Zaine",9,6,4,3,0,0,0,2
Western Bulldogs,"Crozier, Hayden",19,16,8,3,0,0,0,2
Western Bulldogs,"Dickson, Tory",13,5,4,8,0,0,0,3
Western Bulldogs,"Dunkley, Josh",39,22,6,17,2,0,0,15
Western Bulldogs,"Duryea, Taylor",31,24,13,7,0,0,0,1
Western Bulldogs,"English, Tim",14,6,5,8,0,1,7,3
Western Bulldogs,"Hunter, Lachie",37,20,10,17,1,2,0,5
Western Bulldogs,"Johannisen, Jason",17,12,5,5,0,0,0,0
Western Bulldogs,"Lipinski, Patrick",17,6,2,11,0,0,0,4
Western Bulldogs,"Lloyd, Sam",17,12,6,5,2,2,0,1
Western Bulldogs,"Macrae, Jack",30,16,4,14,0,1,0,6
Western Bulldogs,"McLean, Toby",3,1,0,2,0,0,0,2
Western Bulldogs,"Naughton, Aaron",10,7,4,3,0,1,3,1
Western Bulldogs,"Richards, Ed",9,3,1,6,1,0,0,2
Western Bulldogs,"Schache, Josh",15,9,4,6,1,2,1,4
Western Bulldogs,"Smith, Bailey",11,7,2,4,1,1,0,5
Western Bulldogs,"Smith, Roarke",7,6,3,1,2,0,0,2
Western Bulldogs,"Suckling, Matt",21,12,3,9,0,0,0,3
Western Bulldogs,"Trengove, Jackson",9,4,5,5,0,0,9,1
Western Bulldogs,"Williams, Bailey",19,14,8,5,0,0,0,2
Western Bulldogs,"Wood, Easton",9,6,5,3,0,0,0,2
Western Bulldogs,"Bontempelli, Marcus",19,16,2,3,0,0,0,2
Western Bulldogs,"Cordy, Zaine",10,6,4,4,0,0,0,2
Western Bulldogs,"Crozier, Hayden",21,18,7,3,0,0,0,2
Western Bulldogs,"Dale, Bailey",14,9,4,5,5,0,0,1
Western Bulldogs,"Daniel, Caleb",17,11,3,6,0,0,0,2
Western Bulldogs,"Dickson, Tory",11,8,3,3,4,0,0,2
Western Bulldogs,"Dunkley, Josh",38,13,3,25,0,1,3,5
Western Bulldogs,"Duryea, Taylor",20,13,6,7,0,0,0,1
Western Bulldogs,"English, Tim",13,6,4,7,1,0,23,3
Western Bulldogs,"Hunter, Lachie",14,11,6,3,0,1,0,4
Western Bulldogs,"Johannisen, Jason",14,7,1,7,0,0,0,4
Western Bulldogs,"Liberatore, Tom",12,5,3,7,0,0,0,4
Western Bulldogs,"Lipinski, Patrick",18,8,1,10,0,0,0,0
Western Bulldogs,"Lloyd, Sam",17,11,6,6,2,1,0,3
Western Bulldogs,"Macrae, Jack",34,16,7,18,0,0,0,6
Western Bulldogs,"Naughton, Aaron",8,5,2,3,0,1,1,1
Western Bulldogs,"Schache, Josh",4,2,1,2,1,0,1,1
Western Bulldogs,"Smith, Bailey",16,6,1,10,0,0,0,0
Western Bulldogs,"Smith, Roarke",12,6,2,6,1,0,0,1
Western Bulldogs,"Suckling, Matt",22,17,5,5,0,0,0,2
Western Bulldogs,"Trengove, Jackson",7,3,2,4,0,0,2,1
Western Bulldogs,"Wood, Easton",23,15,10,8,0,0,0,1
Western Bulldogs,"Bontempelli, Marcus",28,21,7,7,2,1,0,5
Western Bulldogs,"Cordy, Zaine",13,7,2,6,0,1,0,2
Western Bulldogs,"Crozier, Hayden",20,12,8,8,0,0,0,1
Western Bulldogs,"Dale, Bailey",13,10,6,3,4,2,0,2
Western Bulldogs,"Daniel, Caleb",29,15,2,14,0,0,0,3
Western Bulldogs,"Dickson, Tory",14,10,8,4,0,2,0,0
Western Bulldogs,"Dunkley, Josh",26,11,2,15,0,0,0,1
Western Bulldogs,"Duryea, Taylor",18,12,9,6,0,0,0,2
Western Bulldogs,"English, Tim",13,6,2,7,0,0,14,4
Western Bulldogs,"Hunter, Lachie",27,17,5,10,1,0,0,1
Western Bulldogs,"Johannisen, Jason",24,13,4,11,1,0,0,2
Western Bulldogs,"Liberatore, Tom",19,7,3,12,0,1,0,1
Western Bulldogs,"Lipinski, Patrick",19,12,6,7,1,0,0,0
Western Bulldogs,"Lloyd, Sam",16,13,7,3,3,1,0,2
Western Bulldogs,"Macrae, Jack",38,19,7,19,0,0,0,5
Western Bulldogs,"Morris, Dale",6,3,2,3,0,0,0,0
Western Bulldogs,"Naughton, Aaron",20,11,10,9,1,2,0,1
Western Bulldogs,"Richards, Ed",15,10,5,5,0,3,0,0
Western Bulldogs,"Smith, Bailey",20,14,4,6,2,2,0,4
Western Bulldogs,"Trengove, Jackson",15,10,4,5,0,0,0,2
Western Bulldogs,"West, Rhylee",14,8,3,6,1,0,0,1
Western Bulldogs,"Wood, Easton",10,7,6,3,0,0,0,2
Western Bulldogs,"Bontempelli, Marcus",35,17,5,18,1,1,0,7
Western Bulldogs,"Cordy, Zaine",7,5,3,2,0,0,0,1
Western Bulldogs,"Crozier, Hayden",18,12,11,6,0,0,0,2
Western Bulldogs,"Dale, Bailey",10,7,4,3,1,0,0,4
Western Bulldogs,"Daniel, Caleb",22,15,5,7,0,0,0,4
Western Bulldogs,"Dickson, Tory",10,4,1,6,0,0,0,5
Western Bulldogs,"Dunkley, Josh",31,14,2,17,0,0,0,9
Western Bulldogs,"English, Tim",12,6,3,6,1,0,27,0
Western Bulldogs,"Hunter, Lachie",18,12,6,6,0,1,0,3
Western Bulldogs,"Johannisen, Jason",20,16,4,4,1,0,0,1
Western Bulldogs,"Liberatore, Tom",18,7,2,11,0,0,0,4
Western Bulldogs,"Lipinski, Patrick",19,9,4,10,1,0,0,5
Western Bulldogs,"Lloyd, Sam",12,8,5,4,0,3,0,3
Western Bulldogs,"Macrae, Jack",45,21,4,24,0,0,0,7
Western Bulldogs,"McLean, Toby",14,7,4,7,0,1,0,3
Western Bulldogs,"Naughton, Aaron",14,9,10,5,2,2,1,0
Western Bulldogs,"Richards, Ed",8,7,5,1,1,2,0,4
Western Bulldogs,"Schache, Josh",14,8,4,6,2,1,2,2
Western Bulldogs,"Smith, Bailey",27,13,2,14,0,1,0,1
Western Bulldogs,"Suckling, Matt",18,13,5,5,1,0,0,2
Western Bulldogs,"Trengove, Jackson",11,6,4,5,0,0,0,3
Western Bulldogs,"Wood, Easton",12,9,4,3,0,0,0,1
Western Bulldogs,"Bontempelli, Marcus",26,13,3,13,0,0,2,8
Western Bulldogs,"Cordy, Zaine",8,3,4,5,0,0,0,2
Western Bulldogs,"Crozier, Hayden",19,13,4,6,0,0,0,4
Western Bulldogs,"Dale, Bailey",19,10,4,9,3,2,0,3
Western Bulldogs,"Dickson, Tory",11,7,4,4,3,0,0,5
Western Bulldogs,"Dunkley, Josh",39,18,4,21,1,0,0,3
Western Bulldogs,"Duryea, Taylor",22,14,7,8,0,0,0,3
Western Bulldogs,"English, Tim",17,13,5,4,0,0,20,4
Western Bulldogs,"Hayes, Will",22,14,7,8,2,0,0,3
Western Bulldogs,"Hunter, Lachie",34,23,9,11,0,0,0,1
Western Bulldogs,"Johannisen, Jason",21,13,4,8,1,1,0,0
Western Bulldogs,"Lipinski, Patrick",27,12,4,15,0,0,0,4
Western Bulldogs,"Lloyd, Sam",13,10,6,3,1,3,0,1
Western Bulldogs,"Macrae, Jack",38,19,2,19,1,0,0,8
Western Bulldogs,"McLean, Toby",22,9,5,13,3,1,0,4
Western Bulldogs,"Naughton, Aaron",14,10,9,4,2,0,0,3
Western Bulldogs,"Richards, Ed",13,8,2,5,0,1,0,1
Western Bulldogs,"Schache, Josh",13,8,4,5,3,0,2,2
Western Bulldogs,"Smith, Bailey",23,7,6,16,1,0,0,3
Western Bulldogs,"Suckling, Matt",22,15,5,7,0,0,0,2
Western Bulldogs,"Trengove, Jackson",12,5,4,7,0,0,0,1
Western Bulldogs,"Wood, Easton",10,8,4,2,0,0,0,1
Western Bulldogs,"Bontempelli, Marcus",26,11,2,15,0,0,1,7
Western Bulldogs,"Cordy, Zaine",7,4,2,3,0,0,0,2
Western Bulldogs,"Crozier, Hayden",13,13,5,0,0,0,0,1
Western Bulldogs,"Dale, Bailey",10,9,5,1,2,1,0,4
Western Bulldogs,"Dickson, Tory",3,2,0,1,2,0,0,1
Western Bulldogs,"Dunkley, Josh",31,17,6,14,2,0,0,10
Western Bulldogs,"Duryea, Taylor",19,15,7,4,1,0,0,2
Western Bulldogs,"Hayes, Will",16,9,1,7,0,0,0,7
Western Bulldogs,"Hunter, Lachie",25,14,5,11,1,1,0,1
Western Bulldogs,"Johannisen, Jason",27,15,1,12,0,0,0,4
Western Bulldogs,"Lipinski, Patrick",27,12,7,15,2,0,0,7
Western Bulldogs,"Lloyd, Sam",19,13,5,6,2,3,0,1
Western Bulldogs,"Macrae, Jack",39,12,1,27,0,0,1,3
Western Bulldogs,"McLean, Toby",14,5,4,9,0,0,0,4
Western Bulldogs,"Naughton, Aaron",8,7,5,1,2,2,4,4
Western Bulldogs,"Richards, Ed",10,6,1,4,1,0,0,5
Western Bulldogs,"Schache, Josh",7,5,2,2,3,0,2,2
Western Bulldogs,"Smith, Bailey",15,9,0,6,1,0,0,9
Western Bulldogs,"Suckling, Matt",26,18,3,8,0,2,0,2
Western Bulldogs,"Trengove, Jackson",14,10,2,4,0,1,24,2
Western Bulldogs,"Wood, Easton",16,9,6,7,0,0,0,2
Western Bulldogs,"Young, Lewis",17,12,7,5,0,0,0,0
Western Bulldogs,"Bontempelli, Marcus",31,12,2,19,1,1,0,10
Western Bulldogs,"Cordy, Zaine",9,4,1,5,0,0,0,3
Western Bulldogs,"Crozier, Hayden",20,11,7,9,0,0,0,1
Western Bulldogs,"Dale, Bailey",17,11,6,6,5,3,0,1
Western Bulldogs,"Dunkley, Josh",33,13,4,20,0,0,1,3
Western Bulldogs,"Duryea, Taylor",16,12,9,4,0,0,0,3
Western Bulldogs,"English, Tim",16,7,3,9,1,0,25,4
Western Bulldogs,"Hayes, Will",16,11,6,5,0,0,0,4
Western Bulldogs,"Hunter, Lachie",30,17,9,13,0,0,0,1
Western Bulldogs,"Johannisen, Jason",26,19,8,7,0,3,0,2
Western Bulldogs,"Lipinski, Patrick",15,9,2,6,2,1,0,8
Western Bulldogs,"Lloyd, Sam",16,8,4,8,2,0,0,1
Western Bulldogs,"Macrae, Jack",35,19,4,16,1,0,1,1
Western Bulldogs,"McLean, Toby",7,3,1,4,2,0,0,2
Western Bulldogs,"Naughton, Aaron",9,5,5,4,1,1,0,3
Western Bulldogs,"Richards, Ed",11,7,3,4,0,0,0,2
Western Bulldogs,"Schache, Josh",16,11,3,5,2,2,3,2
Western Bulldogs,"Smith, Bailey",22,13,5,9,0,0,0,4
Western Bulldogs,"Suckling, Matt",29,23,9,6,0,0,0,2
Western Bulldogs,"West, Rhylee",14,5,2,9,1,0,0,2
Western Bulldogs,"Wood, Easton",11,5,2,6,0,0,0,1
Western Bulldogs,"Young, Lewis",14,11,5,3,0,0,0,1
Western Bulldogs,"Bontempelli, Marcus",13,9,2,4,0,2,3,7
Western Bulldogs,"Cordy, Zaine",10,7,3,3,0,0,0,1
Western Bulldogs,"Crozier, Hayden",15,12,5,3,0,0,0,2
Western Bulldogs,"Dale, Bailey",7,4,2,3,0,1,0,1
Western Bulldogs,"Dunkley, Josh",20,10,2,10,0,0,4,7
Western Bulldogs,"Duryea, Taylor",17,13,2,4,0,0,0,6
Western Bulldogs,"English, Tim",17,12,3,5,1,1,30,4
Western Bulldogs,"Hayes, Will",7,1,1,6,0,0,0,3
Western Bulldogs,"Hunter, Lachie",24,10,2,14,0,1,0,4
Western Bulldogs,"Johannisen, Jason",17,10,1,7,0,0,0,3
Western Bulldogs,"Lipinski, Patrick",24,7,6,17,0,1,0,1
Western Bulldogs,"Lloyd, Sam",10,6,3,4,1,0,0,1
Western Bulldogs,"Macrae, Jack",32,14,5,18,0,0,0,10
Western Bulldogs,"McLean, Toby",8,5,3,3,1,1,0,4
Western Bulldogs,"Naughton, Aaron",5,4,3,1,2,0,0,3
Western Bulldogs,"Richards, Ed",12,4,1,8,1,0,0,0
Western Bulldogs,"Schache, Josh",7,5,2,2,1,0,0,3
Western Bulldogs,"Smith, Bailey",16,7,4,9,0,0,0,3
Western Bulldogs,"Suckling, Matt",23,19,4,4,1,0,0,1
Western Bulldogs,"West, Rhylee",10,3,2,7,0,0,0,0
Western Bulldogs,"Wood, Easton",14,9,6,5,0,0,0,2
Western Bulldogs,"Young, Lewis",11,9,1,2,0,0,0,2
Adelaide,"Atkins, Rory",14,8,1,6,0,2,0,2
Adelaide,"Betts, Eddie",14,7,2,7,0,2,0,2
Adelaide,"Brown, Luke",15,10,2,5,0,0,0,0
Adelaide,"Crouch, Matt",41,18,6,23,0,0,0,2
Adelaide,"Doedee, Tom",21,7,7,14,0,0,0,2
Adelaide,"Douglas, Richard",13,7,3,6,1,2,0,0
Adelaide,"Ellis-Yolmen, Cam",17,7,5,10,1,0,0,1
Adelaide,"Fogarty, Darcy",6,3,3,3,2,0,0,4
Adelaide,"Gibbs, Bryce",35,21,7,14,2,1,0,4
Adelaide,"Greenwood, Hugh",13,8,1,5,1,1,0,2
Adelaide,"Hampton, Curtly",9,6,4,3,1,0,0,3
Adelaide,"Hartigan, Kyle",11,4,4,7,0,0,0,0
Adelaide,"Jacobs, Sam",13,5,3,8,0,0,33,1
Adelaide,"Jenkins, Josh",11,6,5,5,2,2,4,3
Adelaide,"Kelly, Jake",18,11,6,7,0,0,0,2
Adelaide,"Laird, Rory",40,15,8,25,0,0,0,1
Adelaide,"Mackay, David",20,15,1,5,0,1,0,4
Adelaide,"McGovern, Mitch",9,6,4,3,1,1,0,3
Adelaide,"Murphy, Lachlan",6,4,1,2,1,1,0,2
Adelaide,"Seedsman, Paul",24,14,4,10,0,1,0,4
Adelaide,"Sloane, Rory",23,11,2,12,0,0,0,7
Adelaide,"Talia, Daniel",14,11,4,3,0,0,0,1
Adelaide,"Atkins, Rory",17,13,5,4,0,0,0,3
Adelaide,"Betts, Eddie",20,6,2,14,0,0,0,4
Adelaide,"Brown, Luke",23,17,5,6,0,0,0,3
Adelaide,"Crouch, Matt",13,6,1,7,0,0,0,0
Adelaide,"Doedee, Tom",25,10,6,15,0,0,0,0
Adelaide,"Ellis-Yolmen, Cam",28,10,8,18,1,0,0,7
Adelaide,"Fogarty, Darcy",7,5,5,2,2,0,0,3
Adelaide,"Gibbs, Bryce",28,20,3,8,1,2,0,4
Adelaide,"Greenwood, Hugh",26,11,1,15,1,1,0,2
Adelaide,"Hartigan, Kyle",20,10,8,10,0,0,0,1
Adelaide,"Jacobs, Sam",20,13,6,7,0,0,40,2
Adelaide,"Jenkins, Josh",16,12,6,4,5,2,8,2
Adelaide,"Kelly, Jake",28,16,6,12,0,0,0,1
Adelaide,"Laird, Rory",42,29,9,13,0,0,0,0
Adelaide,"Mackay, David",13,7,3,6,0,0,0,1
Adelaide,"McGovern, Mitch",12,9,5,3,0,0,0,0
Adelaide,"Milera, Wayne",19,13,6,6,0,0,0,2
Adelaide,"Murphy, Lachlan",10,8,2,2,2,2,0,3
Adelaide,"Seedsman, Paul",28,15,2,13,0,2,0,3
Adelaide,"Sloane, Rory",25,13,4,12,2,0,0,7
Adelaide,"Talia, Daniel",18,9,8,9,0,0,0,0
Adelaide,"Walker, Taylor",11,9,5,2,4,0,0,0
Adelaide,"Atkins, Rory",22,12,8,10,2,0,0,2
Adelaide,"Betts, Eddie",16,10,6,6,3,2,0,2
Adelaide,"Brown, Luke",23,17,6,6,0,0,0,4
Adelaide,"Doedee, Tom",15,10,5,5,0,0,0,2
Adelaide,"Douglas, Richard",22,11,4,11,1,1,0,5
Adelaide,"Ellis-Yolmen, Cam",16,11,3,5,0,0,0,3
Adelaide,"Gibbs, Bryce",26,14,5,12,1,1,0,10
Adelaide,"Greenwood, Hugh",17,7,3,10,0,0,0,6
Adelaide,"Hartigan, Kyle",11,8,5,3,0,0,0,2
Adelaide,"Jacobs, Sam",20,13,4,7,0,1,37,1
Adelaide,"Jenkins, Josh",10,7,6,3,1,1,5,4
Adelaide,"Kelly, Jake",19,7,5,12,0,0,0,1
Adelaide,"Laird, Rory",32,16,7,16,0,0,0,6
Adelaide,"Lynch, Tom",21,17,5,4,0,1,0,3
Adelaide,"Mackay, David",21,12,5,9,0,1,0,2
Adelaide,"McGovern, Mitch",15,15,8,0,2,1,0,3
Adelaide,"Milera, Wayne",10,7,3,3,0,0,0,2
Adelaide,"Murphy, Lachlan",12,7,5,5,0,1,0,6
Adelaide,"Seedsman, Paul",26,15,8,11,2,0,0,2
Adelaide,"Sloane, Rory",15,7,3,8,0,1,0,5
Adelaide,"Talia, Daniel",18,7,5,11,0,0,0,4
Adelaide,"Walker, Taylor",10,6,2,4,3,1,0,4
Adelaide,"Atkins, Rory",28,16,8,12,1,0,0,1
Adelaide,"Betts, Eddie",6,2,1,4,0,0,0,3
Adelaide,"Brown, Luke",16,10,3,6,0,0,0,2
Adelaide,"Doedee, Tom",13,7,4,6,0,0,0,2
Adelaide,"Douglas, Richard",14,7,3,7,0,0,0,8
Adelaide,"Ellis-Yolmen, Cam",19,11,2,8,1,0,0,9
Adelaide,"Fogarty, Darcy",9,5,2,4,0,0,0,1
Adelaide,"Gibbs, Bryce",27,19,4,8,2,1,0,3
Adelaide,"Greenwood, Hugh",24,13,3,11,0,0,0,5
Adelaide,"Hartigan, Kyle",11,8,6,3,0,0,0,1
Adelaide,"Jacobs, Sam",10,8,1,2,0,0,33,5
Adelaide,"Jenkins, Josh",10,6,3,4,0,0,4,2
Adelaide,"Kelly, Jake",14,9,4,5,0,0,0,0
Adelaide,"Laird, Rory",37,18,5,19,0,0,0,3
Adelaide,"Lynch, Tom",14,7,3,7,0,0,0,1
Adelaide,"Mackay, David",16,9,2,7,0,0,0,1
Adelaide,"McGovern, Mitch",12,11,3,1,2,1,0,3
Adelaide,"Milera, Wayne",16,10,1,6,0,0,0,4
Adelaide,"Seedsman, Paul",29,16,7,13,1,0,0,6
Adelaide,"Sloane, Rory",16,4,3,12,0,0,0,0
Adelaide,"Talia, Daniel",18,8,9,10,0,0,0,4
Adelaide,"Walker, Taylor",13,7,3,6,2,1,0,3
Adelaide,"Atkins, Rory",24,17,2,7,3,0,0,1
Adelaide,"Brown, Luke",16,11,6,5,0,0,0,2
Adelaide,"Doedee, Tom",25,18,11,7,0,0,0,1
Adelaide,"Douglas, Richard",17,8,1,9,0,1,0,7
Adelaide,"Ellis-Yolmen, Cam",20,8,3,12,0,0,0,8
Adelaide,"Gallucci, Jordan",11,9,2,2,1,1,0,1
Adelaide,"Gibbs, Bryce",22,14,0,8,0,1,0,3
Adelaide,"Greenwood, Hugh",16,9,2,7,0,1,0,11
Adelaide,"Hartigan, Kyle",1,1,0,0,0,0,0,1
Adelaide,"Jacobs, Sam",8,7,2,1,0,0,42,1
Adelaide,"Jenkins, Josh",11,7,3,4,3,0,6,1
Adelaide,"Kelly, Jake",20,10,6,10,0,0,0,4
Adelaide,"Knight, Riley",9,2,1,7,0,0,0,4
Adelaide,"Laird, Rory",30,15,4,15,0,1,0,0
Adelaide,"Lynch, Tom",25,15,9,10,0,0,0,0
Adelaide,"McGovern, Mitch",20,13,11,7,0,1,0,0
Adelaide,"Milera, Wayne",17,16,5,1,0,1,0,2
Adelaide,"Otten, Andy",18,12,7,6,0,0,0,1
Adelaide,"Poholke, Myles",10,5,4,5,0,0,0,4
Adelaide,"Seedsman, Paul",26,18,3,8,1,2,0,3
Adelaide,"Talia, Daniel",9,3,2,6,0,0,0,3
Adelaide,"Walker, Taylor",16,12,7,4,4,1,0,2
Adelaide,"Atkins, Rory",28,18,5,10,0,2,0,2
Adelaide,"Brown, Luke",24,16,5,8,0,2,0,5
Adelaide,"Crouch, Matt",30,14,2,16,1,0,0,1
Adelaide,"Doedee, Tom",18,8,8,10,0,0,0,4
Adelaide,"Douglas, Richard",21,14,6,7,3,0,0,5
Adelaide,"Ellis-Yolmen, Cam",29,12,3,17,1,0,0,4
Adelaide,"Gallucci, Jordan",20,17,5,3,2,1,0,2
Adelaide,"Gibbs, Bryce",31,16,7,15,0,0,0,1
Adelaide,"Greenwood, Hugh",15,8,1,7,0,0,0,8
Adelaide,"Jacobs, Sam",14,4,3,10,0,0,33,4
Adelaide,"Jenkins, Josh",12,10,7,2,0,3,3,0
Adelaide,"Knight, Riley",17,8,3,9,2,0,0,0
Adelaide,"Laird, Rory",34,11,10,23,0,0,0,1
Adelaide,"Lynch, Tom",25,15,7,10,3,0,0,4
Adelaide,"Mackay, David",19,10,4,9,0,0,0,3
Adelaide,"McGovern, Mitch",14,13,7,1,1,2,0,1
Adelaide,"Milera, Wayne",33,19,5,14,0,0,0,2
Adelaide,"Otten, Andy",9,3,3,6,0,0,0,2
Adelaide,"Poholke, Myles",8,4,3,4,0,0,0,1
Adelaide,"Seedsman, Paul",26,16,8,10,1,0,0,5
Adelaide,"Talia, Daniel",19,10,8,9,0,0,0,2
Adelaide,"Walker, Taylor",11,6,3,5,2,2,0,1
Adelaide,"Atkins, Rory",16,10,3,6,0,1,0,4
Adelaide,"Betts, Eddie",10,7,1,3,2,0,0,4
Adelaide,"Brown, Luke",11,9,5,2,0,0,0,2
Adelaide,"Crouch, Matt",32,16,3,16,0,0,0,4
Adelaide,"Doedee, Tom",13,5,2,8,0,0,0,2
Adelaide,"Douglas, Richard",28,15,7,13,2,1,0,2
Adelaide,"Ellis-Yolmen, Cam",25,9,4,16,0,0,0,6
Adelaide,"Fogarty, Darcy",11,8,6,3,0,1,0,4
Adelaide,"Gallucci, Jordan",12,7,2,5,0,0,0,3
Adelaide,"Gibbs, Bryce",21,12,4,9,1,0,0,7
Adelaide,"Greenwood, Hugh",19,9,3,10,2,1,0,8
Adelaide,"Jacobs, Sam",16,11,5,5,0,1,32,3
Adelaide,"Jenkins, Josh",10,7,7,3,3,2,6,2
Adelaide,"Kelly, Jake",21,9,5,12,0,0,0,1
Adelaide,"Laird, Rory",32,14,6,18,1,0,0,1
Adelaide,"Lynch, Tom",18,11,5,7,2,0,0,0
Adelaide,"Mackay, David",19,13,4,6,1,0,0,2
Adelaide,"McGovern, Mitch",16,13,9,3,5,3,0,2
Adelaide,"Milera, Wayne",7,3,2,4,0,0,0,0
Adelaide,"Otten, Andy",11,4,4,7,0,0,0,0
Adelaide,"Seedsman, Paul",23,16,4,7,0,1,0,2
Adelaide,"Talia, Daniel",15,8,4,7,0,0,0,1
Adelaide,"Atkins, Rory",29,20,11,9,1,0,0,2
Adelaide,"Betts, Eddie",16,13,1,3,3,0,0,1
Adelaide,"Brown, Luke",15,14,6,1,0,0,0,5
Adelaide,"Crouch, Matt",27,17,6,10,0,0,0,5
Adelaide,"Doedee, Tom",15,7,4,8,0,0,0,1
Adelaide,"Douglas, Richard",15,13,3,2,1,0,0,4
Adelaide,"Ellis-Yolmen, Cam",20,11,3,9,2,1,0,7
Adelaide,"Gallucci, Jordan",6,4,0,2,0,0,0,3
Adelaide,"Gibbs, Bryce",24,11,2,13,0,1,0,2
Adelaide,"Greenwood, Hugh",16,12,5,4,0,0,0,12
Adelaide,"Jacobs, Sam",8,4,0,4,0,0,32,0
Adelaide,"Jenkins, Josh",11,10,6,1,1,1,3,1
Adelaide,"Kelly, Jake",14,11,7,3,0,0,0,3
Adelaide,"Laird, Rory",27,15,5,12,0,0,0,0
Adelaide,"Lynch, Tom",20,11,10,9,1,0,0,1
Adelaide,"Mackay, David",11,7,5,4,0,1,0,3
Adelaide,"McGovern, Mitch",8,6,5,2,2,0,0,1
Adelaide,"Otten, Andy",17,10,9,7,0,0,0,0
Adelaide,"Poholke, Myles",7,5,4,2,0,0,0,0
Adelaide,"Seedsman, Paul",16,11,6,5,1,0,0,2
Adelaide,"Talia, Daniel",8,5,1,3,0,0,0,3
Adelaide,"Walker, Taylor",6,4,3,2,2,0,0,0
Adelaide,"Atkins, Rory",9,7,2,2,0,0,0,3
Adelaide,"Betts, Eddie",15,9,3,6,4,0,0,1
Adelaide,"Doedee, Tom",15,11,2,4,0,0,0,7
Adelaide,"Douglas, Richard",21,21,3,0,0,0,0,5
Adelaide,"Ellis-Yolmen, Cam",27,17,1,10,0,0,0,6
Adelaide,"Fogarty, Darcy",7,6,1,1,1,0,0,1
Adelaide,"Gallucci, Jordan",8,7,2,1,0,1,0,6
Adelaide,"Gibbs, Bryce",26,19,2,7,0,1,0,8
Adelaide,"Gibson, Sam",20,11,2,9,0,0,0,8
Adelaide,"Greenwood, Hugh",20,15,2,5,0,0,0,11
Adelaide,"Hartigan, Kyle",10,9,3,1,0,0,0,1
Adelaide,"Jacobs, Sam",5,5,1,0,0,0,54,3
Adelaide,"Jenkins, Josh",8,6,0,2,1,0,1,9
Adelaide,"Kelly, Jake",11,7,1,4,0,0,0,3
Adelaide,"Laird, Rory",28,16,4,12,0,0,0,4
Adelaide,"Lynch, Tom",15,6,1,9,1,1,0,4
Adelaide,"Mackay, David",15,14,4,1,0,0,0,8
Adelaide,"Murphy, Lachlan",8,6,0,2,1,1,0,6
Adelaide,"Otten, Andy",14,8,5,6,0,0,2,5
Adelaide,"Poholke, Myles",12,7,2,5,1,0,0,5
Adelaide,"Seedsman, Paul",22,18,1,4,0,2,0,6
Adelaide,"Talia, Daniel",14,9,3,5,0,0,0,4
Adelaide,"Atkins, Rory",22,14,4,8,0,0,0,2
Adelaide,"Betts, Eddie",7,6,1,1,2,0,0,2
Adelaide,"Brown, Luke",2,1,0,1,0,0,0,1
Adelaide,"Crouch, Matt",34,14,5,20,0,0,0,3
Adelaide,"Doedee, Tom",21,6,5,15,0,0,0,4
Adelaide,"Douglas, Richard",18,11,3,7,2,1,0,2
Adelaide,"Ellis-Yolmen, Cam",14,9,1,5,0,0,0,5
Adelaide,"Fogarty, Darcy",9,7,6,2,1,1,0,1
Adelaide,"Gallucci, Jordan",7,7,1,0,1,1,0,4
Adelaide,"Gibbs, Bryce",19,11,4,8,0,1,0,7
Adelaide,"Gibson, Sam",22,12,3,10,1,0,0,4
Adelaide,"Greenwood, Hugh",21,14,2,7,0,0,0,10
Adelaide,"Hartigan, Kyle",10,4,2,6,0,0,2,0
Adelaide,"Jacobs, Sam",6,4,1,2,0,0,21,3
Adelaide,"Jenkins, Josh",14,12,7,2,1,1,3,4
Adelaide,"Kelly, Jake",9,7,4,2,0,0,0,1
Adelaide,"Laird, Rory",30,13,10,17,0,1,0,5
Adelaide,"Lynch, Tom",18,11,7,7,0,0,0,1
Adelaide,"Mackay, David",18,11,6,7,0,0,0,3
Adelaide,"Milera, Wayne",17,12,4,5,0,0,0,1
Adelaide,"Poholke, Myles",9,6,6,3,0,1,0,1
Adelaide,"Talia, Daniel",18,9,8,9,0,0,0,2
Adelaide,"Atkins, Rory",14,12,1,2,1,1,0,3
Adelaide,"Betts, Eddie",15,8,1,7,2,2,0,0
Adelaide,"Brown, Luke",12,7,3,5,0,0,0,4
Adelaide,"Crouch, Matt",36,13,3,23,0,0,0,5
Adelaide,"Doedee, Tom",18,9,1,9,0,0,0,3
Adelaide,"Douglas, Richard",19,11,0,8,2,4,0,3
Adelaide,"Ellis-Yolmen, Cam",18,6,1,12,0,0,2,3
Adelaide,"Fogarty, Darcy",11,8,4,3,1,0,0,2
Adelaide,"Gibbs, Bryce",36,21,5,15,0,0,0,9
Adelaide,"Gibson, Sam",25,14,5,11,0,1,0,3
Adelaide,"Greenwood, Hugh",20,9,3,11,0,2,0,7
Adelaide,"Hartigan, Kyle",9,6,3,3,0,0,0,2
Adelaide,"Jacobs, Sam",11,6,0,5,0,0,39,3
Adelaide,"Jenkins, Josh",13,10,6,3,1,3,8,5
Adelaide,"Kelly, Jake",13,8,5,5,0,0,0,8
Adelaide,"Laird, Rory",30,17,6,13,0,0,0,3
Adelaide,"Lynch, Tom",10,6,1,4,0,0,0,3
Adelaide,"Mackay, David",14,10,3,4,0,0,0,3
Adelaide,"Milera, Wayne",14,12,6,2,1,1,0,1
Adelaide,"Murphy, Lachlan",9,6,1,3,1,0,0,1
Adelaide,"Seedsman, Paul",16,7,1,9,2,0,0,2
Adelaide,"Talia, Daniel",14,8,6,6,0,0,0,3
Adelaide,"Atkins, Rory",14,5,2,9,0,0,0,0
Adelaide,"Betts, Eddie",15,11,4,4,2,6,0,4
Adelaide,"Brown, Luke",16,12,6,4,0,0,0,1
Adelaide,"Crouch, Matt",25,11,2,14,0,0,0,0
Adelaide,"Doedee, Tom",17,9,6,8,0,0,0,5
Adelaide,"Douglas, Richard",20,16,4,4,1,0,0,2
Adelaide,"Ellis-Yolmen, Cam",11,4,1,7,0,0,0,6
Adelaide,"Fogarty, Darcy",8,7,0,1,0,1,0,2
Adelaide,"Gibbs, Bryce",28,14,1,14,0,0,0,9
Adelaide,"Gibson, Sam",23,18,7,5,1,0,0,1
Adelaide,"Greenwood, Hugh",14,6,1,8,1,0,0,4
Adelaide,"Hartigan, Kyle",11,7,7,4,0,0,0,2
Adelaide,"Jacobs, Sam",8,4,2,4,0,0,41,2
Adelaide,"Jenkins, Josh",16,9,8,7,2,0,1,1
Adelaide,"Kelly, Jake",15,7,3,8,0,0,0,0
Adelaide,"Mackay, David",16,7,2,9,0,0,0,3
Adelaide,"Milera, Wayne",22,12,3,10,0,0,0,4
Adelaide,"Murphy, Lachlan",12,8,3,4,0,0,0,4
Adelaide,"Poholke, Myles",18,13,7,5,1,1,0,1
Adelaide,"Seedsman, Paul",24,11,4,13,0,0,0,0
Adelaide,"Talia, Daniel",16,8,4,8,0,0,0,2
Adelaide,"Walker, Taylor",11,6,4,5,1,2,0,1
Adelaide,"Atkins, Rory",12,6,5,6,0,0,0,1
Adelaide,"Betts, Eddie",13,9,3,4,1,1,0,5
Adelaide,"Cheney, Kyle",13,10,3,3,0,0,0,0
Adelaide,"Crouch, Matt",30,14,6,16,0,0,0,4
Adelaide,"Doedee, Tom",14,8,6,6,0,0,0,5
Adelaide,"Douglas, Richard",13,10,0,3,0,0,0,2
Adelaide,"Gallucci, Jordan",16,11,3,5,0,0,0,1
Adelaide,"Gibbs, Bryce",28,20,4,8,0,1,0,5
Adelaide,"Gibson, Sam",23,12,5,11,0,0,0,1
Adelaide,"Greenwood, Hugh",12,4,2,8,0,0,0,5
Adelaide,"Hartigan, Kyle",16,13,12,3,0,0,0,1
Adelaide,"Jacobs, Sam",13,8,3,5,2,0,28,1
Adelaide,"Jenkins, Josh",11,7,1,4,1,1,2,2
Adelaide,"Kelly, Jake",23,15,10,8,0,0,0,3
Adelaide,"Mackay, David",16,11,4,5,0,0,0,2
Adelaide,"Milera, Wayne",17,12,7,5,0,0,0,1
Adelaide,"Otten, Andy",18,16,12,2,0,0,2,2
Adelaide,"Poholke, Myles",8,4,5,4,0,0,0,1
Adelaide,"Seedsman, Paul",12,8,5,4,0,0,0,0
Adelaide,"Talia, Daniel",19,11,11,8,0,0,0,0
Adelaide,"Walker, Taylor",10,4,3,6,0,1,0,2
Adelaide,"Wilson, Patrick",12,7,5,5,0,0,0,2
Adelaide,"Brown, Luke",11,9,3,2,0,0,0,1
Adelaide,"Cheney, Kyle",9,7,4,2,0,0,0,0
Adelaide,"Crouch, Matt",32,12,1,20,0,1,0,9
Adelaide,"Doedee, Tom",22,11,5,11,1,0,0,3
Adelaide,"Douglas, Richard",22,13,4,9,0,1,0,3
Adelaide,"Fogarty, Darcy",8,4,3,4,1,0,0,0
Adelaide,"Gallucci, Jordan",10,9,2,1,0,0,0,1
Adelaide,"Gibbs, Bryce",28,17,2,11,0,1,0,4
Adelaide,"Greenwood, Hugh",18,12,3,6,1,1,0,5
Adelaide,"Hampton, Curtly",14,7,3,7,1,0,0,5
Adelaide,"Hartigan, Kyle",10,5,6,5,0,0,0,1
Adelaide,"Jacobs, Sam",18,11,2,7,1,2,39,2
Adelaide,"Jenkins, Josh",11,8,3,3,2,2,1,0
Adelaide,"Kelly, Jake",9,5,2,4,0,0,0,1
Adelaide,"Laird, Rory",32,13,8,19,0,0,0,1
Adelaide,"Mackay, David",12,10,3,2,0,0,0,2
Adelaide,"Milera, Wayne",18,11,5,7,0,0,0,3
Adelaide,"Poholke, Myles",12,7,4,5,1,1,0,0
Adelaide,"Seedsman, Paul",18,13,3,5,1,1,0,3
Adelaide,"Sloane, Rory",14,5,0,9,0,0,0,8
Adelaide,"Talia, Daniel",15,9,3,6,0,0,0,0
Adelaide,"Walker, Taylor",22,17,10,5,3,4,0,1
Adelaide,"Brown, Luke",13,10,6,3,0,0,0,1
Adelaide,"Cheney, Kyle",19,14,5,5,0,0,0,1
Adelaide,"Crouch, Matt",38,17,5,21,0,0,0,3
Adelaide,"Doedee, Tom",28,8,8,20,0,0,0,4
Adelaide,"Douglas, Richard",17,12,4,5,0,1,0,1
Adelaide,"Fogarty, Darcy",8,4,2,4,1,0,0,2
Adelaide,"Gallucci, Jordan",10,9,1,1,1,2,0,1
Adelaide,"Gibbs, Bryce",25,16,4,9,0,0,0,5
Adelaide,"Greenwood, Hugh",22,10,1,12,1,0,1,3
Adelaide,"Hampton, Curtly",2,0,0,2,0,0,0,4
Adelaide,"Hartigan, Kyle",15,10,7,5,0,0,0,1
Adelaide,"Jacobs, Sam",11,8,5,3,0,0,42,3
Adelaide,"Jenkins, Josh",10,7,4,3,3,0,7,3
Adelaide,"Kelly, Jake",16,10,5,6,0,0,0,0
Adelaide,"Laird, Rory",35,19,6,16,0,0,0,1
Adelaide,"Lynch, Tom",19,14,8,5,0,0,0,2
Adelaide,"Milera, Wayne",20,8,3,12,0,0,0,3
Adelaide,"Poholke, Myles",8,6,3,2,0,1,0,5
Adelaide,"Seedsman, Paul",18,8,4,10,1,0,0,1
Adelaide,"Sloane, Rory",31,15,2,16,0,1,0,7
Adelaide,"Talia, Daniel",18,10,8,8,0,0,0,1
Adelaide,"Walker, Taylor",11,6,5,5,1,1,0,4
Adelaide,"Atkins, Rory",28,16,6,12,1,0,0,1
Adelaide,"Betts, Eddie",14,9,3,5,1,1,0,7
Adelaide,"Brown, Luke",15,11,4,4,1,0,0,2
Adelaide,"Cheney, Kyle",18,14,10,4,0,0,0,0
Adelaide,"Crouch, Matt",30,12,5,18,0,1,0,3
Adelaide,"Doedee, Tom",20,5,5,15,0,0,0,3
Adelaide,"Gallucci, Jordan",15,13,3,2,2,1,0,2
Adelaide,"Gibbs, Bryce",17,11,5,6,0,1,0,6
Adelaide,"Greenwood, Hugh",12,4,4,8,0,2,0,6
Adelaide,"Hartigan, Kyle",14,11,6,3,0,0,0,1
Adelaide,"Jacobs, Sam",16,6,3,10,0,0,39,0
Adelaide,"Jenkins, Josh",14,10,6,4,2,2,5,3
Adelaide,"Keath, Alex",12,9,5,3,0,0,0,0
Adelaide,"Kelly, Jake",17,10,6,7,0,0,0,0
Adelaide,"Knight, Riley",14,8,1,6,0,2,0,7
Adelaide,"Laird, Rory",43,15,4,28,0,0,0,2
Adelaide,"Lynch, Tom",22,10,5,12,4,1,0,0
Adelaide,"Milera, Wayne",23,12,3,11,0,0,0,3
Adelaide,"Murphy, Lachlan",11,7,2,4,3,0,0,3
Adelaide,"Seedsman, Paul",18,9,3,9,0,2,0,3
Adelaide,"Sloane, Rory",27,16,2,11,1,0,0,7
Adelaide,"Walker, Taylor",10,5,1,5,1,1,0,3
Adelaide,"Atkins, Rory",18,13,3,5,0,0,0,1
Adelaide,"Betts, Eddie",15,7,4,8,1,1,0,5
Adelaide,"Brown, Luke",15,8,3,7,0,0,0,2
Adelaide,"Cheney, Kyle",13,9,8,4,0,0,0,1
Adelaide,"Crouch, Matt",40,14,4,26,0,0,0,4
Adelaide,"Doedee, Tom",8,4,1,4,0,0,0,1
Adelaide,"Gallucci, Jordan",9,6,3,3,1,0,0,2
Adelaide,"Gibbs, Bryce",21,16,7,5,1,0,0,3
Adelaide,"Greenwood, Hugh",17,11,4,6,4,3,0,4
Adelaide,"Jacobs, Sam",6,6,0,0,0,0,33,2
Adelaide,"Jenkins, Josh",19,13,5,6,2,2,5,0
Adelaide,"Keath, Alex",12,10,5,2,0,0,0,0
Adelaide,"Kelly, Jake",21,12,7,9,0,0,0,1
Adelaide,"Knight, Riley",17,12,1,5,2,0,0,3
Adelaide,"Laird, Rory",29,14,3,15,1,1,0,0
Adelaide,"Lynch, Tom",23,13,1,10,0,3,0,2
Adelaide,"McGovern, Mitch",9,7,5,2,0,2,0,3
Adelaide,"Milera, Wayne",22,14,7,8,0,0,0,1
Adelaide,"Murphy, Lachlan",4,0,1,4,0,0,0,6
Adelaide,"Seedsman, Paul",18,11,4,7,1,0,0,0
Adelaide,"Sloane, Rory",16,8,2,8,0,1,0,7
Adelaide,"Talia, Daniel",10,6,5,4,0,0,0,2
Adelaide,"Atkins, Rory",21,16,3,5,1,0,0,6
Adelaide,"Betts, Eddie",20,13,2,7,2,3,0,3
Adelaide,"Brown, Luke",16,13,3,3,0,0,0,3
Adelaide,"Cheney, Kyle",18,16,7,2,0,0,0,0
Adelaide,"Crouch, Matt",32,14,3,18,0,1,0,8
Adelaide,"Gallucci, Jordan",9,7,3,2,1,1,0,2
Adelaide,"Gibbs, Bryce",27,15,3,12,1,0,0,7
Adelaide,"Greenwood, Hugh",21,17,1,4,2,1,0,9
Adelaide,"Jacobs, Sam",6,5,3,1,0,0,36,3
Adelaide,"Jenkins, Josh",15,9,1,6,0,0,8,3
Adelaide,"Keath, Alex",15,10,5,5,0,0,0,2
Adelaide,"Kelly, Jake",13,5,1,8,0,0,0,8
Adelaide,"Knight, Riley",22,9,5,13,0,1,0,9
Adelaide,"Laird, Rory",25,11,1,14,0,1,0,4
Adelaide,"Lynch, Tom",22,18,7,4,0,0,0,2
Adelaide,"McGovern, Mitch",9,7,5,2,0,1,0,3
Adelaide,"Milera, Wayne",26,17,7,9,0,0,0,6
Adelaide,"Murphy, Lachlan",10,5,3,5,1,1,0,5
Adelaide,"Seedsman, Paul",3,1,0,2,1,0,0,1
Adelaide,"Sloane, Rory",17,11,3,6,0,0,0,12
Adelaide,"Talia, Daniel",10,6,2,4,0,0,0,3
Adelaide,"Walker, Taylor",14,11,2,3,1,1,0,4
Adelaide,"Atkins, Rory",29,23,11,6,0,1,0,5
Adelaide,"Betts, Eddie",12,8,3,4,1,1,0,2
Adelaide,"Brown, Luke",19,13,8,6,0,0,0,0
Adelaide,"Crouch, Matt",35,16,3,19,1,0,0,8
Adelaide,"Doedee, Tom",21,10,9,11,1,0,0,2
Adelaide,"Ellis-Yolmen, Cam",19,11,5,8,0,2,0,7
Adelaide,"Gallucci, Jordan",10,6,2,4,1,1,0,2
Adelaide,"Gibbs, Bryce",29,22,5,7,0,1,0,1
Adelaide,"Greenwood, Hugh",17,11,4,6,1,0,0,6
Adelaide,"Jacobs, Sam",11,6,2,5,0,0,28,2
Adelaide,"Jenkins, Josh",18,14,8,4,3,0,6,7
Adelaide,"Keath, Alex",18,6,3,12,0,0,0,2
Adelaide,"Knight, Riley",15,8,2,7,0,1,0,2
Adelaide,"Laird, Rory",18,10,3,8,0,0,0,3
Adelaide,"Lynch, Tom",19,9,3,10,1,0,0,3
Adelaide,"Mackay, David",16,11,2,5,0,0,0,2
Adelaide,"Milera, Wayne",22,14,4,8,0,0,0,4
Adelaide,"Murphy, Lachlan",7,4,0,3,1,1,0,2
Adelaide,"Sloane, Rory",26,14,6,12,2,1,0,3
Adelaide,"Smith, Brodie",14,5,4,9,0,0,0,3
Adelaide,"Talia, Daniel",5,2,1,3,0,0,0,2
Adelaide,"Walker, Taylor",10,8,7,2,1,1,0,2
Adelaide,"Atkins, Rory",10,7,2,3,0,1,0,1
Adelaide,"Betts, Eddie",9,6,1,3,1,1,0,0
Adelaide,"Brown, Luke",12,10,3,2,0,0,0,2
Adelaide,"Cheney, Kyle",13,7,4,6,0,0,0,1
Adelaide,"Crouch, Matt",30,18,5,12,0,0,0,3
Adelaide,"Doedee, Tom",12,5,7,7,0,0,0,5
Adelaide,"Douglas, Richard",16,9,2,7,1,0,0,3
Adelaide,"Ellis-Yolmen, Cam",15,4,1,11,0,0,0,2
Adelaide,"Gallucci, Jordan",11,10,3,1,0,0,0,3
Adelaide,"Gibbs, Bryce",20,13,2,7,2,1,0,7
Adelaide,"Greenwood, Hugh",10,5,0,5,0,1,0,4
Adelaide,"Jacobs, Sam",13,6,4,7,0,1,55,1
Adelaide,"Jenkins, Josh",11,8,4,3,3,2,8,7
Adelaide,"Keath, Alex",11,6,2,5,0,0,0,2
Adelaide,"Laird, Rory",25,16,6,9,0,0,0,3
Adelaide,"Lynch, Tom",22,12,10,10,2,1,0,0
Adelaide,"Mackay, David",17,12,2,5,1,1,0,2
Adelaide,"Milera, Wayne",17,12,6,5,0,0,0,3
Adelaide,"Murphy, Lachlan",7,5,2,2,2,1,0,3
Adelaide,"Sloane, Rory",24,16,3,8,0,1,0,6
Adelaide,"Smith, Brodie",29,12,6,17,0,0,0,4
Adelaide,"Walker, Taylor",6,5,4,1,1,1,0,3
Adelaide,"Atkins, Rory",27,15,6,12,0,0,0,3
Adelaide,"Betts, Eddie",10,5,1,5,1,0,0,2
Adelaide,"Brown, Luke",12,8,2,4,0,0,0,2
Adelaide,"Cheney, Kyle",9,7,3,2,0,0,0,1
Adelaide,"Crouch, Matt",46,11,4,35,0,0,0,5
Adelaide,"Doedee, Tom",20,10,9,10,0,0,0,4
Adelaide,"Douglas, Richard",20,12,6,8,0,0,0,1
Adelaide,"Gallucci, Jordan",15,11,4,4,1,1,0,2
Adelaide,"Gibbs, Bryce",27,14,3,13,1,1,0,5
Adelaide,"Greenwood, Hugh",21,7,4,14,2,1,0,7
Adelaide,"Jacobs, Sam",17,7,5,10,0,2,27,2
Adelaide,"Jenkins, Josh",13,7,6,6,3,1,3,0
Adelaide,"Kelly, Jake",19,10,9,9,0,0,0,1
Adelaide,"Knight, Riley",13,6,7,7,1,0,0,3
Adelaide,"Laird, Rory",41,21,9,20,0,0,0,2
Adelaide,"Lynch, Tom",23,17,8,6,1,1,0,0
Adelaide,"Mackay, David",22,12,3,10,0,1,0,1
Adelaide,"McGovern, Mitch",15,12,9,3,2,1,0,2
Adelaide,"Milera, Wayne",23,14,7,9,0,0,0,3
Adelaide,"Otten, Andy",19,10,5,9,0,0,0,1
Adelaide,"Seedsman, Paul",23,16,7,7,0,2,0,4
Adelaide,"Sloane, Rory",29,6,3,23,0,0,0,6
Adelaide,"Atkins, Rory",22,16,10,6,3,0,0,3
Adelaide,"Betts, Eddie",12,7,4,5,3,0,0,3
Adelaide,"Brown, Luke",16,8,4,8,0,0,0,1
Adelaide,"Crouch, Matt",29,12,5,17,0,0,0,3
Adelaide,"Douglas, Richard",17,8,6,9,0,0,0,2
Adelaide,"Ellis-Yolmen, Cam",24,4,5,20,0,0,0,8
Adelaide,"Gallucci, Jordan",17,13,6,4,4,1,0,4
Adelaide,"Gibbs, Bryce",24,18,3,6,1,0,0,8
Adelaide,"Greenwood, Hugh",13,4,4,9,0,2,0,10
Adelaide,"Himmelberg, Elliott",13,5,5,8,1,1,0,3
Adelaide,"Jacobs, Sam",10,5,1,5,0,0,34,1
Adelaide,"Jenkins, Josh",19,15,9,4,7,2,0,2
Adelaide,"Keath, Alex",19,15,7,4,0,0,0,3
Adelaide,"Kelly, Jake",15,9,4,6,1,0,0,0
Adelaide,"Knight, Riley",13,7,4,6,2,0,0,4
Adelaide,"Laird, Rory",34,21,10,13,1,0,0,3
Adelaide,"Lynch, Tom",16,9,7,7,1,0,0,2
Adelaide,"Mackay, David",18,9,4,9,0,1,0,4
Adelaide,"McGovern, Mitch",16,12,7,4,0,0,0,1
Adelaide,"Milera, Wayne",25,13,5,12,1,0,0,4
Adelaide,"Otten, Andy",21,11,10,10,0,0,0,1
Adelaide,"Seedsman, Paul",20,10,3,10,1,0,0,2
Brisbane Lions,"Andrews, Harris",11,7,5,4,0,0,0,1
Brisbane Lions,"Beams, Dayne",26,14,6,12,0,1,0,3
Brisbane Lions,"Bell, Tom",16,8,1,8,1,1,0,0
Brisbane Lions,"Berry, Jarrod",19,13,8,6,3,0,0,3
Brisbane Lions,"Cameron, Charlie",17,12,5,5,3,2,0,2
Brisbane Lions,"Christensen, Allen",21,9,3,12,1,0,0,0
Brisbane Lions,"Gardiner, Darcy",13,8,5,5,0,0,0,1
Brisbane Lions,"Hipwood, Eric",7,6,3,1,1,0,0,2
Brisbane Lions,"Hodge, Luke",25,14,5,11,0,0,0,2
Brisbane Lions,"Lester, Ryan",18,10,4,8,0,0,0,7
Brisbane Lions,"Martin, Stefan",19,8,0,11,0,0,42,1
Brisbane Lions,"Mayes, Sam",19,13,4,6,0,1,0,2
Brisbane Lions,"McCluggage, Hugh",18,11,4,7,0,1,0,1
Brisbane Lions,"McStay, Daniel",11,5,3,6,0,0,0,0
Brisbane Lions,"Rayner, Cam",8,5,2,3,1,1,0,1
Brisbane Lions,"Rich, Daniel",7,4,1,3,0,0,0,0
Brisbane Lions,"Robertson, Nick",27,12,4,15,0,0,0,6
Brisbane Lions,"Robinson, Mitch",23,12,7,11,1,0,0,2
Brisbane Lions,"Taylor, Lewis",27,15,9,12,0,0,0,2
Brisbane Lions,"Walker, Josh",8,6,3,2,1,0,2,2
Brisbane Lions,"Witherden, Alex",21,12,3,9,0,0,0,2
Brisbane Lions,"Zorko, Dayne",14,11,2,3,0,2,0,4
Brisbane Lions,"Andrews, Harris",15,8,4,7,0,0,0,2
Brisbane Lions,"Beams, Dayne",16,9,4,7,0,2,0,5
Brisbane Lions,"Berry, Jarrod",16,5,1,11,0,0,0,7
Brisbane Lions,"Bewick, Rohan",20,13,5,7,1,1,0,2
Brisbane Lions,"Cameron, Charlie",16,11,7,5,3,0,0,3
Brisbane Lions,"Christensen, Allen",16,9,0,7,3,1,0,6
Brisbane Lions,"Cox, Cedric",15,7,1,8,1,0,0,2
Brisbane Lions,"Gardiner, Darcy",11,6,3,5,0,0,0,4
Brisbane Lions,"Hipwood, Eric",14,7,3,7,1,1,0,1
Brisbane Lions,"Hodge, Luke",17,15,3,2,0,0,0,0
Brisbane Lions,"Lester, Ryan",16,8,2,8,0,2,0,3
Brisbane Lions,"Martin, Stefan",9,3,0,6,0,1,35,4
Brisbane Lions,"Mathieson, Rhys",15,10,4,5,0,0,0,7
Brisbane Lions,"Mayes, Sam",13,7,2,6,0,0,0,2
Brisbane Lions,"McCluggage, Hugh",18,11,2,7,0,0,0,4
Brisbane Lions,"McStay, Daniel",15,7,4,8,0,0,0,2
Brisbane Lions,"Rayner, Cam",4,2,1,2,0,1,0,3
Brisbane Lions,"Robertson, Nick",18,6,1,12,0,0,0,7
Brisbane Lions,"Taylor, Lewis",23,13,5,10,0,0,0,5
Brisbane Lions,"Walker, Josh",8,6,1,2,0,2,4,2
Brisbane Lions,"Witherden, Alex",24,16,5,8,0,0,0,1
Brisbane Lions,"Zorko, Dayne",20,11,1,9,1,2,0,11
Brisbane Lions,"Andrews, Harris",13,7,4,6,0,1,0,0
Brisbane Lions,"Berry, Jarrod",12,7,3,5,0,0,0,5
Brisbane Lions,"Bewick, Rohan",15,12,2,3,0,2,0,2
Brisbane Lions,"Cameron, Charlie",9,8,5,1,3,0,0,1
Brisbane Lions,"Christensen, Allen",21,16,4,5,1,1,0,4
Brisbane Lions,"Cox, Cedric",8,4,2,4,1,0,0,1
Brisbane Lions,"Cutler, Tom",21,14,7,7,1,2,0,2
Brisbane Lions,"Gardiner, Darcy",18,9,8,9,0,0,0,2
Brisbane Lions,"Hipwood, Eric",14,7,5,7,3,0,1,0
Brisbane Lions,"Hodge, Luke",11,8,6,3,0,0,0,3
Brisbane Lions,"Lester, Ryan",10,6,1,4,0,0,0,4
Brisbane Lions,"Martin, Stefan",30,16,7,14,0,0,49,7
Brisbane Lions,"Mathieson, Rhys",13,6,0,7,0,0,0,2
Brisbane Lions,"Mayes, Sam",19,9,4,10,0,0,0,2
Brisbane Lions,"McCluggage, Hugh",14,10,5,4,2,0,0,5
Brisbane Lions,"Rayner, Cam",9,6,3,3,1,0,0,4
Brisbane Lions,"Robertson, Nick",10,7,5,3,1,0,0,2
Brisbane Lions,"Robinson, Mitch",22,11,4,11,0,0,0,11
Brisbane Lions,"Taylor, Lewis",15,8,2,7,0,0,0,0
Brisbane Lions,"Walker, Josh",9,5,3,4,0,1,5,0
Brisbane Lions,"Witherden, Alex",20,18,7,2,0,0,0,0
Brisbane Lions,"Zorko, Dayne",19,9,0,10,1,1,0,4
Brisbane Lions,"Andrews, Harris",17,8,7,9,0,0,0,1
Brisbane Lions,"Bailey, Zac",7,2,2,5,0,1,0,1
Brisbane Lions,"Beams, Dayne",25,13,4,12,0,0,0,4
Brisbane Lions,"Berry, Jarrod",17,7,2,10,0,1,0,2
Brisbane Lions,"Bewick, Rohan",20,12,7,8,0,0,0,2
Brisbane Lions,"Cameron, Charlie",7,7,4,0,0,1,0,3
Brisbane Lions,"Christensen, Allen",23,12,3,11,0,0,0,2
Brisbane Lions,"Cutler, Tom",13,10,3,3,0,0,0,0
Brisbane Lions,"Gardiner, Darcy",20,8,5,12,0,0,0,1
Brisbane Lions,"Hipwood, Eric",8,6,5,2,0,0,2,1
Brisbane Lions,"Hodge, Luke",24,13,4,11,0,0,0,1
Brisbane Lions,"Martin, Stefan",24,6,3,18,0,0,20,3
Brisbane Lions,"Mathieson, Rhys",15,7,4,8,0,0,0,2
Brisbane Lions,"Mayes, Sam",15,8,4,7,0,0,0,1
Brisbane Lions,"McCluggage, Hugh",16,13,2,3,0,1,0,2
Brisbane Lions,"Rayner, Cam",22,13,4,9,1,0,0,3
Brisbane Lions,"Robertson, Nick",15,8,4,7,0,0,0,2
Brisbane Lions,"Robinson, Mitch",21,15,7,6,0,0,0,5
Brisbane Lions,"Taylor, Lewis",23,11,5,12,0,0,0,2
Brisbane Lions,"Walker, Josh",10,5,3,5,0,1,3,2
Brisbane Lions,"Witherden, Alex",27,19,8,8,0,0,0,0
Brisbane Lions,"Zorko, Dayne",17,7,4,10,1,0,0,2
Brisbane Lions,"Allison, Jacob",16,9,5,7,0,0,0,0
Brisbane Lions,"Andrews, Harris",19,12,7,7,0,0,0,4
Brisbane Lions,"Bailey, Zac",10,4,3,6,1,0,0,3
Brisbane Lions,"Bastinac, Ryan",16,8,5,8,0,1,0,0
Brisbane Lions,"Beams, Dayne",28,11,4,17,0,0,0,2
Brisbane Lions,"Berry, Jarrod",25,12,9,13,0,1,0,8
Brisbane Lions,"Cameron, Charlie",18,13,5,5,2,0,0,1
Brisbane Lions,"Christensen, Allen",17,9,0,8,0,2,0,2
Brisbane Lions,"Cutler, Tom",26,19,5,7,0,0,0,5
Brisbane Lions,"Gardiner, Darcy",11,4,2,7,0,0,0,4
Brisbane Lions,"Hipwood, Eric",11,8,1,3,3,0,0,0
Brisbane Lions,"Hodge, Luke",19,12,6,7,0,0,0,2
Brisbane Lions,"Lester, Ryan",15,4,1,11,0,0,0,3
Brisbane Lions,"Martin, Stefan",19,13,6,6,0,1,30,1
Brisbane Lions,"McCluggage, Hugh",26,11,5,15,0,0,0,5
Brisbane Lions,"McStay, Daniel",11,6,5,5,1,3,0,1
Brisbane Lions,"Rayner, Cam",11,6,2,5,1,2,0,0
Brisbane Lions,"Robertson, Nick",21,16,7,5,0,0,0,0
Brisbane Lions,"Robinson, Mitch",24,13,7,11,0,0,0,4
Brisbane Lions,"Taylor, Lewis",20,14,6,6,1,1,0,2
Brisbane Lions,"Witherden, Alex",27,17,14,10,0,0,0,3
Brisbane Lions,"Zorko, Dayne",10,6,3,4,1,0,0,8
Brisbane Lions,"Allison, Jacob",15,5,7,10,0,0,0,1
Brisbane Lions,"Andrews, Harris",16,11,9,5,0,0,0,0
Brisbane Lions,"Bailey, Zac",16,9,4,7,0,2,0,2
Brisbane Lions,"Beams, Dayne",29,18,8,11,1,1,0,3
Brisbane Lions,"Berry, Jarrod",20,9,4,11,0,0,0,4
Brisbane Lions,"Cameron, Charlie",14,11,4,3,0,0,0,3
Brisbane Lions,"Christensen, Allen",20,9,2,11,0,0,0,4
Brisbane Lions,"Cutler, Tom",20,16,6,4,0,0,0,2
Brisbane Lions,"Gardiner, Darcy",16,10,6,6,0,0,0,4
Brisbane Lions,"Hipwood, Eric",7,4,1,3,1,0,0,1
Brisbane Lions,"Lester, Ryan",8,6,3,2,0,0,0,0
Brisbane Lions,"Martin, Stefan",12,9,6,3,0,0,38,1
Brisbane Lions,"McCluggage, Hugh",16,10,7,6,0,0,0,0
Brisbane Lions,"McInerney, Oscar",7,3,1,4,0,1,9,3
Brisbane Lions,"McStay, Daniel",6,4,3,2,1,0,0,1
Brisbane Lions,"Rayner, Cam",14,4,3,10,0,1,0,3
Brisbane Lions,"Rich, Daniel",28,20,4,8,0,1,0,2
Brisbane Lions,"Robertson, Nick",16,8,2,8,0,0,0,5
Brisbane Lions,"Robinson, Mitch",28,9,2,19,0,0,0,6
Brisbane Lions,"Taylor, Lewis",17,8,8,9,1,1,0,1
Brisbane Lions,"Witherden, Alex",22,14,5,8,0,1,0,3
Brisbane Lions,"Zorko, Dayne",10,6,1,4,1,2,0,2
Brisbane Lions,"Allison, Jacob",9,4,3,5,0,0,0,0
Brisbane Lions,"Andrews, Harris",18,9,9,9,0,0,0,0
Brisbane Lions,"Bailey, Zac",17,10,3,7,1,0,0,4
Brisbane Lions,"Beams, Dayne",31,16,5,15,2,0,0,5
Brisbane Lions,"Berry, Jarrod",11,5,2,6,1,0,0,1
Brisbane Lions,"Cameron, Charlie",16,10,3,6,1,1,0,0
Brisbane Lions,"Christensen, Allen",19,11,6,8,0,1,0,2
Brisbane Lions,"Cutler, Tom",10,6,3,4,0,0,0,2
Brisbane Lions,"Eagles, Matt",11,7,4,4,0,0,0,0
Brisbane Lions,"Gardiner, Darcy",11,8,5,3,0,0,0,1
Brisbane Lions,"Hipwood, Eric",11,6,3,5,0,0,0,3
Brisbane Lions,"Hodge, Luke",21,16,13,5,0,0,0,1
Brisbane Lions,"Martin, Stefan",28,18,8,10,0,0,24,2
Brisbane Lions,"McCluggage, Hugh",15,11,8,4,1,0,0,1
Brisbane Lions,"McInerney, Oscar",4,3,2,1,1,0,10,7
Brisbane Lions,"McStay, Daniel",7,3,3,4,2,0,0,3
Brisbane Lions,"Rayner, Cam",18,6,4,12,0,0,0,2
Brisbane Lions,"Rich, Daniel",24,19,4,5,0,0,0,3
Brisbane Lions,"Robinson, Mitch",23,8,2,15,1,0,0,7
Brisbane Lions,"Taylor, Lewis",18,11,3,7,4,2,0,1
Brisbane Lions,"Witherden, Alex",17,12,9,5,0,0,0,1
Brisbane Lions,"Zorko, Dayne",34,22,7,12,4,0,0,10
Brisbane Lions,"Andrews, Harris",20,14,4,6,0,0,0,4
Brisbane Lions,"Bailey, Zac",17,8,4,9,0,0,0,4
Brisbane Lions,"Beams, Dayne",17,11,4,6,0,0,0,5
Brisbane Lions,"Berry, Jarrod",20,9,3,11,0,0,0,5
Brisbane Lions,"Cameron, Charlie",18,14,8,4,3,0,0,8
Brisbane Lions,"Christensen, Allen",14,11,2,3,0,1,0,4
Brisbane Lions,"Cutler, Tom",22,16,10,6,0,1,0,4
Brisbane Lions,"Eagles, Matt",7,6,4,1,0,0,0,1
Brisbane Lions,"Gardiner, Darcy",12,7,4,5,0,0,0,2
Brisbane Lions,"Hipwood, Eric",14,11,4,3,1,2,1,1
Brisbane Lions,"Hodge, Luke",13,9,3,4,0,0,0,4
Brisbane Lions,"Martin, Stefan",20,6,5,14,0,0,50,2
Brisbane Lions,"McCluggage, Hugh",15,9,5,6,1,0,0,1
Brisbane Lions,"McInerney, Oscar",13,7,4,6,2,1,12,4
Brisbane Lions,"McStay, Daniel",10,6,6,4,2,1,0,8
Brisbane Lions,"Rayner, Cam",9,4,1,5,1,0,0,1
Brisbane Lions,"Rich, Daniel",15,6,2,9,0,0,0,1
Brisbane Lions,"Robertson, Nick",10,6,0,4,0,0,0,3
Brisbane Lions,"Robinson, Mitch",17,6,2,11,0,0,0,12
Brisbane Lions,"Taylor, Lewis",10,3,3,7,0,0,0,2
Brisbane Lions,"Witherden, Alex",18,18,8,0,0,1,0,3
Brisbane Lions,"Zorko, Dayne",24,18,0,6,4,0,0,7
Brisbane Lions,"Andrews, Harris",18,11,8,7,0,0,0,3
Brisbane Lions,"Bailey, Zac",11,4,3,7,0,0,0,3
Brisbane Lions,"Beams, Dayne",28,17,8,11,2,1,0,3
Brisbane Lions,"Berry, Jarrod",12,4,4,8,0,0,0,7
Brisbane Lions,"Cameron, Charlie",13,10,5,3,2,0,0,3
Brisbane Lions,"Christensen, Allen",24,11,5,13,1,0,0,3
Brisbane Lions,"Cutler, Tom",26,18,10,8,3,0,0,2
Brisbane Lions,"Eagles, Matt",8,4,1,4,1,0,0,0
Brisbane Lions,"Gardiner, Darcy",17,10,7,7,0,0,0,1
Brisbane Lions,"Hipwood, Eric",12,11,5,1,4,3,0,0
Brisbane Lions,"Hodge, Luke",19,14,7,5,0,0,0,1
Brisbane Lions,"Martin, Stefan",19,7,3,12,0,0,28,3
Brisbane Lions,"McCluggage, Hugh",27,13,2,14,0,1,0,2
Brisbane Lions,"McInerney, Oscar",9,4,2,5,1,1,11,3
Brisbane Lions,"McStay, Daniel",7,3,3,4,0,1,0,2
Brisbane Lions,"Rayner, Cam",11,4,2,7,2,0,0,3
Brisbane Lions,"Rich, Daniel",13,10,3,3,1,0,0,1
Brisbane Lions,"Robertson, Nick",15,6,5,9,0,0,0,1
Brisbane Lions,"Robinson, Mitch",23,12,7,11,1,0,0,3
Brisbane Lions,"Taylor, Lewis",18,11,4,7,1,0,0,1
Brisbane Lions,"Witherden, Alex",24,14,6,10,0,0,0,2
Brisbane Lions,"Zorko, Dayne",30,20,1,10,1,0,0,12
Brisbane Lions,"Andrews, Harris",14,6,4,8,0,0,0,1
Brisbane Lions,"Bailey, Zac",8,4,0,4,0,0,0,3
Brisbane Lions,"Beams, Dayne",38,18,3,20,1,1,0,4
Brisbane Lions,"Berry, Jarrod",20,10,3,10,1,1,0,6
Brisbane Lions,"Cameron, Charlie",9,7,1,2,0,0,0,2
Brisbane Lions,"Christensen, Allen",27,14,3,13,1,0,0,5
Brisbane Lions,"Cutler, Tom",19,10,4,9,1,0,0,2
Brisbane Lions,"Eagles, Matt",3,2,1,1,0,0,0,2
Brisbane Lions,"Gardiner, Darcy",12,7,5,5,0,0,0,4
Brisbane Lions,"Hipwood, Eric",10,8,3,2,0,2,0,0
Brisbane Lions,"Hodge, Luke",12,7,4,5,0,0,0,1
Brisbane Lions,"Martin, Stefan",15,9,4,6,0,0,58,6
Brisbane Lions,"McCluggage, Hugh",17,13,3,4,0,0,0,6
Brisbane Lions,"McInerney, Oscar",5,3,2,2,0,0,14,4
Brisbane Lions,"McStay, Daniel",6,5,3,1,0,3,0,3
Brisbane Lions,"Rayner, Cam",10,3,3,7,1,1,0,3
Brisbane Lions,"Rich, Daniel",16,10,1,6,0,0,0,3
Brisbane Lions,"Robertson, Nick",15,9,4,6,0,0,0,3
Brisbane Lions,"Robinson, Mitch",35,18,2,17,0,0,0,7
Brisbane Lions,"Taylor, Lewis",19,9,0,10,0,0,0,3
Brisbane Lions,"Witherden, Alex",15,12,4,3,0,0,0,1
Brisbane Lions,"Zorko, Dayne",21,14,2,7,1,0,0,12
Brisbane Lions,"Andrews, Harris",18,11,5,7,0,0,0,5
Brisbane Lions,"Bailey, Zac",14,6,5,8,1,0,0,3
Brisbane Lions,"Beams, Dayne",32,20,6,12,5,1,0,2
Brisbane Lions,"Cameron, Charlie",4,1,0,3,0,0,0,1
Brisbane Lions,"Christensen, Allen",0,0,0,0,0,0,0,0
Brisbane Lions,"Cutler, Tom",19,12,6,7,0,1,0,1
Brisbane Lions,"Gardiner, Darcy",10,6,0,4,0,0,0,2
Brisbane Lions,"Hipwood, Eric",16,10,4,6,0,2,0,0
Brisbane Lions,"Hodge, Luke",26,14,5,12,0,0,0,1
Brisbane Lions,"Keays, Ben",17,7,4,10,1,1,0,4
Brisbane Lions,"Lester, Ryan",15,9,9,6,0,0,0,6
Brisbane Lions,"Martin, Stefan",21,7,5,14,0,0,28,1
Brisbane Lions,"McCluggage, Hugh",9,4,2,5,0,0,0,0
Brisbane Lions,"McInerney, Oscar",12,8,1,4,1,1,10,0
Brisbane Lions,"McStay, Daniel",10,9,8,1,2,2,0,3
Brisbane Lions,"Rayner, Cam",21,14,6,7,0,2,0,7
Brisbane Lions,"Rich, Daniel",24,13,6,11,0,0,0,4
Brisbane Lions,"Robertson, Nick",22,12,6,10,0,0,0,1
Brisbane Lions,"Robinson, Mitch",24,11,4,13,0,1,0,4
Brisbane Lions,"Taylor, Lewis",17,9,5,8,1,0,0,2
Brisbane Lions,"Witherden, Alex",22,11,5,11,0,0,0,2
Brisbane Lions,"Zorko, Dayne",22,16,8,6,1,2,0,9
Brisbane Lions,"Andrews, Harris",24,16,12,8,0,0,0,5
Brisbane Lions,"Bailey, Zac",16,6,3,10,0,0,0,1
Brisbane Lions,"Beams, Dayne",14,7,3,7,0,0,0,2
Brisbane Lions,"Berry, Jarrod",16,5,1,11,1,0,0,5
Brisbane Lions,"Christensen, Allen",21,14,7,7,0,2,0,5
Brisbane Lions,"Cutler, Tom",16,11,4,5,0,3,0,1
Brisbane Lions,"Gardiner, Darcy",23,12,8,11,0,0,0,0
Brisbane Lions,"Hipwood, Eric",5,4,2,1,2,1,0,2
Brisbane Lions,"Hodge, Luke",14,6,3,8,0,1,0,4
Brisbane Lions,"Keays, Ben",12,4,1,8,0,0,0,4
Brisbane Lions,"Lester, Ryan",18,13,5,5,0,0,0,0
Brisbane Lions,"Martin, Stefan",22,9,7,13,1,0,25,0
Brisbane Lions,"Mayes, Sam",13,5,5,8,0,0,0,0
Brisbane Lions,"McCluggage, Hugh",12,8,6,4,0,3,0,4
Brisbane Lions,"McInerney, Oscar",7,3,3,4,1,0,18,1
Brisbane Lions,"McStay, Daniel",9,6,4,3,1,2,0,4
Brisbane Lions,"Rayner, Cam",18,8,3,10,0,0,0,4
Brisbane Lions,"Rich, Daniel",29,17,7,12,0,0,0,2
Brisbane Lions,"Robertson, Nick",18,11,9,7,0,0,0,4
Brisbane Lions,"Taylor, Lewis",21,14,4,7,0,0,0,2
Brisbane Lions,"Witherden, Alex",29,25,12,4,0,1,0,2
Brisbane Lions,"Zorko, Dayne",20,14,3,6,2,0,0,8
Brisbane Lions,"Andrews, Harris",5,2,1,3,0,0,0,0
Brisbane Lions,"Bailey, Zac",12,6,2,6,1,0,0,1
Brisbane Lions,"Beams, Dayne",27,20,10,7,1,0,0,0
Brisbane Lions,"Berry, Jarrod",14,7,2,7,1,0,0,8
Brisbane Lions,"Christensen, Allen",17,6,3,11,2,1,0,0
Brisbane Lions,"Cutler, Tom",21,13,12,8,1,0,0,0
Brisbane Lions,"Gardiner, Darcy",11,7,2,4,0,0,0,2
Brisbane Lions,"Hipwood, Eric",9,9,4,0,3,0,0,0
Brisbane Lions,"Hodge, Luke",30,23,11,7,1,0,0,4
Brisbane Lions,"Lester, Ryan",25,14,10,11,0,0,0,0
Brisbane Lions,"Martin, Stefan",14,6,1,8,0,0,33,0
Brisbane Lions,"Mathieson, Rhys",22,8,7,14,0,0,0,2
Brisbane Lions,"Mayes, Sam",18,9,5,9,0,0,0,2
Brisbane Lions,"McCluggage, Hugh",27,15,8,12,0,0,0,5
Brisbane Lions,"McInerney, Oscar",7,2,1,5,1,1,14,2
Brisbane Lions,"Rayner, Cam",10,7,4,3,0,1,0,0
Brisbane Lions,"Rich, Daniel",30,18,6,12,0,0,0,1
Brisbane Lions,"Robertson, Nick",19,12,8,7,0,0,0,0
Brisbane Lions,"Taylor, Lewis",22,13,9,9,0,0,0,1
Brisbane Lions,"Walker, Josh",17,12,9,5,0,0,0,1
Brisbane Lions,"Witherden, Alex",19,10,9,9,0,0,0,0
Brisbane Lions,"Zorko, Dayne",22,16,3,6,1,3,0,5
Brisbane Lions,"Barrett, Jake",14,5,3,9,0,0,0,2
Brisbane Lions,"Beams, Dayne",33,14,6,19,0,0,0,3
Brisbane Lions,"Berry, Jarrod",24,10,4,14,1,0,0,5
Brisbane Lions,"Christensen, Allen",17,10,5,7,1,0,0,2
Brisbane Lions,"Cutler, Tom",19,14,9,5,2,1,0,3
Brisbane Lions,"Gardiner, Darcy",13,10,8,3,0,0,0,1
Brisbane Lions,"Hipwood, Eric",15,12,6,3,2,4,0,1
Brisbane Lions,"Hodge, Luke",17,11,4,6,0,0,0,0
Brisbane Lions,"Lester, Ryan",15,10,3,5,0,0,0,1
Brisbane Lions,"Martin, Stefan",19,8,5,11,0,0,46,3
Brisbane Lions,"Mathieson, Rhys",14,6,5,8,0,1,0,4
Brisbane Lions,"McCluggage, Hugh",24,15,5,9,0,1,0,6
Brisbane Lions,"McInerney, Oscar",9,4,6,5,2,0,10,1
Brisbane Lions,"McStay, Daniel",11,8,6,3,3,1,0,2
Brisbane Lions,"Rayner, Cam",19,11,6,8,2,1,0,5
Brisbane Lions,"Rich, Daniel",15,11,5,4,0,0,0,1
Brisbane Lions,"Robertson, Nick",26,15,11,11,0,0,0,1
Brisbane Lions,"Robinson, Mitch",18,5,4,13,0,0,0,3
Brisbane Lions,"Taylor, Lewis",17,11,3,6,3,0,0,2
Brisbane Lions,"Walker, Josh",14,8,3,6,0,0,0,1
Brisbane Lions,"Witherden, Alex",21,15,5,6,1,0,0,0
Brisbane Lions,"Zorko, Dayne",19,13,0,6,1,0,0,7
Brisbane Lions,"Barrett, Jake",19,9,5,10,2,0,0,3
Brisbane Lions,"Beams, Dayne",40,22,9,18,1,0,0,1
Brisbane Lions,"Berry, Jarrod",17,4,4,13,0,0,0,4
Brisbane Lions,"Christensen, Allen",15,8,6,7,1,2,0,1
Brisbane Lions,"Cutler, Tom",28,20,14,8,2,3,0,3
Brisbane Lions,"Gardiner, Darcy",27,15,15,12,0,0,0,1
Brisbane Lions,"Hipwood, Eric",15,12,7,3,6,2,2,2
Brisbane Lions,"Hodge, Luke",25,18,13,7,0,0,0,1
Brisbane Lions,"Lester, Ryan",22,10,5,12,0,0,0,3
Brisbane Lions,"Martin, Stefan",22,11,6,11,0,0,21,1
Brisbane Lions,"Mathieson, Rhys",22,6,2,16,0,1,0,5
Brisbane Lions,"McCluggage, Hugh",20,12,6,8,1,1,0,4
Brisbane Lions,"McInerney, Oscar",8,5,4,3,0,0,12,1
Brisbane Lions,"McStay, Daniel",7,5,4,2,1,0,0,0
Brisbane Lions,"Rayner, Cam",15,7,5,8,1,1,0,1
Brisbane Lions,"Rich, Daniel",28,15,7,13,0,0,0,4
Brisbane Lions,"Robertson, Nick",13,9,4,4,0,0,0,1
Brisbane Lions,"Robinson, Mitch",12,6,5,6,1,0,0,5
Brisbane Lions,"Taylor, Lewis",14,7,5,7,1,0,0,1
Brisbane Lions,"Walker, Josh",17,8,9,9,0,0,0,0
Brisbane Lions,"Witherden, Alex",31,23,9,8,0,0,0,1
Brisbane Lions,"Zorko, Dayne",25,20,3,5,1,0,0,6
Brisbane Lions,"Barrett, Jake",13,2,2,11,0,0,0,2
Brisbane Lions,"Beams, Dayne",33,23,7,10,0,1,0,2
Brisbane Lions,"Berry, Jarrod",24,7,6,17,1,0,0,6
Brisbane Lions,"Christensen, Allen",15,6,1,9,1,1,0,3
Brisbane Lions,"Cox, Cedric",10,3,2,7,0,0,0,3
Brisbane Lions,"Cutler, Tom",20,13,3,7,0,0,0,0
Brisbane Lions,"Gardiner, Darcy",10,6,4,4,0,0,0,2
Brisbane Lions,"Hipwood, Eric",12,12,7,0,3,2,0,1
Brisbane Lions,"Lester, Ryan",16,11,5,5,0,0,0,2
Brisbane Lions,"Martin, Stefan",17,6,3,11,0,0,33,4
Brisbane Lions,"Mathieson, Rhys",15,4,0,11,0,0,0,4
Brisbane Lions,"McCluggage, Hugh",29,8,3,21,1,0,0,4
Brisbane Lions,"McInerney, Oscar",12,7,3,5,0,0,7,3
Brisbane Lions,"McStay, Daniel",10,4,3,6,2,0,0,1
Brisbane Lions,"Rayner, Cam",19,10,4,9,3,0,0,2
Brisbane Lions,"Rich, Daniel",19,11,3,8,0,0,0,7
Brisbane Lions,"Robertson, Nick",14,6,3,8,0,0,0,2
Brisbane Lions,"Robinson, Mitch",17,10,1,7,2,1,0,5
Brisbane Lions,"Taylor, Lewis",13,7,3,6,1,0,0,2
Brisbane Lions,"Walker, Josh",20,12,8,8,0,0,0,2
Brisbane Lions,"Witherden, Alex",27,19,6,8,0,0,0,2
Brisbane Lions,"Zorko, Dayne",24,19,0,5,1,2,0,7
Brisbane Lions,"Barrett, Jake",7,3,4,4,1,0,0,4
Brisbane Lions,"Beams, Dayne",26,12,3,14,0,0,0,5
Brisbane Lions,"Berry, Jarrod",17,11,5,6,2,1,0,2
Brisbane Lions,"Christensen, Allen",17,8,3,9,1,1,0,1
Brisbane Lions,"Cox, Cedric",7,1,3,6,0,0,0,1
Brisbane Lions,"Cutler, Tom",24,14,4,10,0,2,0,5
Brisbane Lions,"Gardiner, Darcy",21,15,11,6,0,0,0,3
Brisbane Lions,"Hipwood, Eric",7,5,4,2,1,1,0,0
Brisbane Lions,"Lester, Ryan",17,10,8,7,0,0,0,2
Brisbane Lions,"Martin, Stefan",14,7,3,7,0,0,39,3
Brisbane Lions,"Mathieson, Rhys",14,7,2,7,0,0,0,1
Brisbane Lions,"McCluggage, Hugh",20,10,1,10,0,0,0,1
Brisbane Lions,"McInerney, Oscar",11,8,5,3,2,0,10,2
Brisbane Lions,"McStay, Daniel",9,9,3,0,2,0,0,1
Brisbane Lions,"Rayner, Cam",14,7,5,7,2,0,0,1
Brisbane Lions,"Rich, Daniel",17,14,1,3,0,2,0,2
Brisbane Lions,"Robertson, Nick",18,10,5,8,0,0,0,1
Brisbane Lions,"Robinson, Mitch",11,7,1,4,0,1,0,4
Brisbane Lions,"Taylor, Lewis",12,6,4,6,1,0,0,2
Brisbane Lions,"Walker, Josh",11,8,7,3,0,0,0,1
Brisbane Lions,"Witherden, Alex",31,26,12,5,0,0,0,4
Brisbane Lions,"Zorko, Dayne",21,13,5,8,1,2,0,5
Brisbane Lions,"Andrews, Harris",11,6,5,5,0,0,2,4
Brisbane Lions,"Barrett, Jake",13,2,3,11,1,0,0,1
Brisbane Lions,"Beams, Dayne",37,16,4,21,1,1,0,4
Brisbane Lions,"Berry, Jarrod",15,8,5,7,0,1,0,2
Brisbane Lions,"Christensen, Allen",12,5,1,7,1,0,0,2
Brisbane Lions,"Gardiner, Darcy",24,11,4,13,0,0,0,2
Brisbane Lions,"Hipwood, Eric",11,9,9,2,1,1,1,2
Brisbane Lions,"Hodge, Luke",18,14,5,4,0,0,0,1
Brisbane Lions,"Lester, Ryan",12,6,4,6,0,0,0,2
Brisbane Lions,"Martin, Stefan",18,6,5,12,0,0,24,1
Brisbane Lions,"Mathieson, Rhys",18,8,2,10,0,0,0,4
Brisbane Lions,"McCluggage, Hugh",16,7,1,9,0,0,0,0
Brisbane Lions,"McInerney, Oscar",4,4,1,0,0,1,8,2
Brisbane Lions,"McStay, Daniel",14,9,9,5,2,1,0,2
Brisbane Lions,"Rayner, Cam",12,5,2,7,1,0,0,1
Brisbane Lions,"Rich, Daniel",14,9,3,5,0,0,0,5
Brisbane Lions,"Robertson, Nick",15,7,2,8,1,0,0,1
Brisbane Lions,"Robinson, Mitch",17,7,2,10,1,1,0,8
Brisbane Lions,"Taylor, Lewis",23,9,5,14,1,0,0,4
Brisbane Lions,"Walker, Josh",18,12,8,6,0,0,0,2
Brisbane Lions,"Witherden, Alex",20,12,4,8,0,0,0,4
Brisbane Lions,"Zorko, Dayne",23,16,5,7,1,1,0,5
Brisbane Lions,"Andrews, Harris",14,13,10,1,0,0,0,3
Brisbane Lions,"Bastinac, Ryan",11,8,6,3,0,0,0,3
Brisbane Lions,"Beams, Dayne",29,16,4,13,0,1,0,1
Brisbane Lions,"Berry, Jarrod",28,11,5,17,0,0,0,6
Brisbane Lions,"Christensen, Allen",18,12,3,6,1,1,0,4
Brisbane Lions,"Gardiner, Darcy",14,10,8,4,0,0,0,1
Brisbane Lions,"Hipwood, Eric",7,5,3,2,1,0,0,2
Brisbane Lions,"Hodge, Luke",19,12,8,7,0,0,0,5
Brisbane Lions,"Martin, Stefan",12,8,2,4,0,0,24,1
Brisbane Lions,"Mathieson, Rhys",15,7,1,8,2,0,0,2
Brisbane Lions,"McCluggage, Hugh",26,15,7,11,3,0,0,5
Brisbane Lions,"McInerney, Oscar",10,7,3,3,2,1,17,1
Brisbane Lions,"McStay, Daniel",7,3,4,4,0,1,0,3
Brisbane Lions,"Rayner, Cam",14,8,6,6,2,1,0,1
Brisbane Lions,"Rich, Daniel",11,6,2,5,0,0,0,1
Brisbane Lions,"Robertson, Nick",18,8,6,10,0,0,0,1
Brisbane Lions,"Robinson, Mitch",23,15,9,8,2,2,0,4
Brisbane Lions,"Starcevich, Brandon",9,5,0,4,0,1,0,5
Brisbane Lions,"Taylor, Lewis",10,3,1,7,1,0,0,2
Brisbane Lions,"Walker, Josh",23,15,13,8,0,0,0,0
Brisbane Lions,"Witherden, Alex",22,17,9,5,0,0,0,1
Brisbane Lions,"Zorko, Dayne",35,24,4,11,2,0,0,10
Brisbane Lions,"Andrews, Harris",18,12,11,6,0,0,0,1
Brisbane Lions,"Beams, Dayne",33,20,5,13,1,1,0,2
Brisbane Lions,"Berry, Jarrod",18,11,4,7,0,0,0,6
Brisbane Lions,"Christensen, Allen",21,13,10,8,0,0,0,2
Brisbane Lions,"Cutler, Tom",19,14,3,5,1,1,0,2
Brisbane Lions,"Gardiner, Darcy",4,3,3,1,0,0,0,1
Brisbane Lions,"Hipwood, Eric",9,7,6,2,3,2,1,2
Brisbane Lions,"Hodge, Luke",24,17,7,7,0,0,0,2
Brisbane Lions,"Martin, Stefan",18,7,4,11,0,0,24,2
Brisbane Lions,"Mathieson, Rhys",19,7,4,12,0,0,0,3
Brisbane Lions,"McCluggage, Hugh",18,10,3,8,0,0,0,3
Brisbane Lions,"McInerney, Oscar",7,5,4,2,0,1,3,1
Brisbane Lions,"McStay, Daniel",7,6,3,1,2,0,0,1
Brisbane Lions,"Rayner, Cam",12,3,3,9,0,0,0,1
Brisbane Lions,"Rich, Daniel",18,10,3,8,0,0,0,3
Brisbane Lions,"Robertson, Nick",12,6,5,6,0,0,0,2
Brisbane Lions,"Robinson, Mitch",22,15,5,7,2,1,0,2
Brisbane Lions,"Starcevich, Brandon",7,4,3,3,0,0,0,1
Brisbane Lions,"Taylor, Lewis",15,9,7,6,2,0,0,1
Brisbane Lions,"Walker, Josh",16,9,10,7,0,0,0,1
Brisbane Lions,"Witherden, Alex",30,22,11,8,0,0,0,2
Brisbane Lions,"Zorko, Dayne",14,6,1,8,0,1,0,7
Brisbane Lions,"Andrews, Harris",14,7,7,7,1,0,0,3
Brisbane Lions,"Bailey, Zac",14,7,3,7,0,0,0,1
Brisbane Lions,"Beams, Dayne",38,20,8,18,1,2,0,2
Brisbane Lions,"Berry, Jarrod",21,9,4,12,0,0,0,3
Brisbane Lions,"Christensen, Allen",22,19,10,3,1,0,0,2
Brisbane Lions,"Cutler, Tom",19,13,4,6,0,1,0,0
Brisbane Lions,"Hipwood, Eric",11,10,4,1,0,4,0,0
Brisbane Lions,"Hodge, Luke",21,17,8,4,0,0,0,3
Brisbane Lions,"Lester, Ryan",16,9,4,7,0,0,0,5
Brisbane Lions,"Martin, Stefan",21,10,4,11,0,0,38,5
Brisbane Lions,"Mathieson, Rhys",15,5,2,10,1,0,0,2
Brisbane Lions,"McCluggage, Hugh",22,11,5,11,1,1,0,5
Brisbane Lions,"McStay, Daniel",5,4,2,1,0,2,0,3
Brisbane Lions,"Rayner, Cam",14,8,3,6,1,2,0,3
Brisbane Lions,"Rich, Daniel",21,13,5,8,0,1,0,2
Brisbane Lions,"Robertson, Nick",16,7,7,9,0,0,0,0
Brisbane Lions,"Robinson, Mitch",21,11,5,10,0,0,0,1
Brisbane Lions,"Starcevich, Brandon",10,5,1,5,1,0,0,2
Brisbane Lions,"Taylor, Lewis",17,15,5,2,2,1,0,2
Brisbane Lions,"Walker, Josh",15,11,10,4,1,1,4,1
Brisbane Lions,"Witherden, Alex",4,4,1,0,0,0,0,0
Brisbane Lions,"Zorko, Dayne",17,10,0,7,0,0,0,9
Brisbane Lions,"Andrews, Harris",16,8,7,8,0,0,0,2
Brisbane Lions,"Bailey, Zac",20,10,4,10,2,1,0,2
Brisbane Lions,"Beams, Dayne",32,13,3,19,2,0,0,4
Brisbane Lions,"Berry, Jarrod",22,11,4,11,1,0,0,5
Brisbane Lions,"Christensen, Allen",26,21,7,5,0,0,0,0
Brisbane Lions,"Cutler, Tom",26,18,10,8,0,0,0,1
Brisbane Lions,"Hipwood, Eric",8,7,4,1,1,0,0,3
Brisbane Lions,"Hodge, Luke",15,8,6,7,0,0,0,2
Brisbane Lions,"Lester, Ryan",17,7,5,10,0,0,0,2
Brisbane Lions,"Martin, Stefan",19,14,2,5,0,0,37,5
Brisbane Lions,"Mathieson, Rhys",14,6,6,8,1,0,0,1
Brisbane Lions,"McCluggage, Hugh",21,13,6,8,0,0,0,4
Brisbane Lions,"McInerney, Oscar",9,4,3,5,1,0,11,2
Brisbane Lions,"McStay, Daniel",10,4,5,6,1,1,0,2
Brisbane Lions,"Rayner, Cam",13,8,4,5,0,0,0,3
Brisbane Lions,"Rich, Daniel",23,13,5,10,0,0,0,0
Brisbane Lions,"Robertson, Nick",26,18,10,8,1,0,0,0
Brisbane Lions,"Robinson, Mitch",19,8,2,11,0,0,0,10
Brisbane Lions,"Starcevich, Brandon",10,6,1,4,0,1,0,0
Brisbane Lions,"Taylor, Lewis",19,9,2,10,1,2,0,3
Brisbane Lions,"Walker, Josh",13,10,7,3,0,0,0,2
Brisbane Lions,"Zorko, Dayne",16,11,1,5,0,0,0,9
Carlton,"Byrne, Ciaran",14,6,4,8,0,0,0,1
Carlton,"Casboult, Levi",10,7,4,3,1,0,19,1
Carlton,"Cripps, Patrick",36,13,5,23,0,1,0,7
Carlton,"Curnow, Charlie",19,14,10,5,5,0,0,2
Carlton,"Curnow, Ed",29,15,2,14,0,0,0,4
Carlton,"Dow, Paddy",11,5,1,6,0,0,0,5
Carlton,"Fisher, Zac",21,13,2,8,1,0,0,1
Carlton,"Garlett, Jarrod",17,9,7,8,2,0,0,0
Carlton,"Jones, Liam",10,6,2,4,0,0,0,1
Carlton,"Kennedy, Matthew",4,2,2,2,0,0,0,0
Carlton,"Kreuzer, Matthew",17,7,1,10,0,1,23,1
Carlton,"Lamb, Jed",16,10,5,6,0,1,0,0
Carlton,"Marchbank, Caleb",19,13,6,6,0,0,0,4
Carlton,"Mullett, Aaron",16,10,3,6,0,0,0,1
Carlton,"Murphy, Marc",23,10,3,13,0,0,0,1
Carlton,"Petrevski-Seton, Sam",16,11,4,5,1,0,0,5
Carlton,"Plowman, Lachie",13,7,5,6,0,0,0,3
Carlton,"Silvagni, Jack",6,3,3,3,0,0,0,2
Carlton,"Simpson, Kade",35,24,6,11,0,0,0,4
Carlton,"Thomas, Dale",24,10,5,14,0,0,0,1
Carlton,"Weitering, Jacob",9,4,3,5,0,0,0,3
Carlton,"Wright, Matthew",11,8,5,3,5,0,0,2
Carlton,"Byrne, Ciaran",14,13,3,1,0,0,0,2
Carlton,"Casboult, Levi",7,4,3,3,0,1,16,1
Carlton,"Cripps, Patrick",24,10,2,14,1,2,0,6
Carlton,"Cuningham, David",21,7,4,14,0,0,0,3
Carlton,"Curnow, Charlie",18,12,6,6,2,1,1,1
Carlton,"Curnow, Ed",38,19,7,19,0,2,0,10
Carlton,"Dow, Paddy",11,4,1,7,0,0,0,2
Carlton,"Fisher, Zac",18,9,1,9,1,0,0,8
Carlton,"Garlett, Jarrod",11,8,1,3,0,0,0,3
Carlton,"Jones, Liam",13,6,7,7,0,0,0,1
Carlton,"Lamb, Jed",11,7,3,4,1,1,0,3
Carlton,"Marchbank, Caleb",17,12,5,5,0,0,0,2
Carlton,"Mullett, Aaron",28,22,6,6,0,1,0,2
Carlton,"Murphy, Marc",30,16,7,14,1,0,0,3
Carlton,"OShea, Cameron",14,6,2,8,0,0,2,3
Carlton,"Petrevski-Seton, Sam",24,19,6,5,0,0,0,3
Carlton,"Plowman, Lachie",17,12,6,5,0,0,0,2
Carlton,"Polson, Cameron",7,3,0,4,0,1,0,6
Carlton,"Simpson, Kade",29,22,4,7,0,0,0,1
Carlton,"Thomas, Dale",14,5,4,9,0,0,0,1
Carlton,"Weitering, Jacob",5,4,4,1,1,0,0,2
Carlton,"Wright, Matthew",16,11,4,5,2,1,0,2
Carlton,"Casboult, Levi",14,11,3,3,4,2,11,2
Carlton,"Cripps, Patrick",26,14,7,12,1,1,0,1
Carlton,"Cuningham, David",14,7,4,7,0,0,0,1
Carlton,"Curnow, Charlie",20,15,9,5,2,2,0,0
Carlton,"Curnow, Ed",25,17,3,8,0,0,0,7
Carlton,"Dow, Paddy",15,9,4,6,0,1,0,2
Carlton,"Fisher, Zac",16,9,1,7,1,0,0,6
Carlton,"Garlett, Jarrod",12,9,4,3,1,1,0,5
Carlton,"Jones, Liam",10,6,4,4,0,0,0,1
Carlton,"Kennedy, Matthew",13,5,2,8,0,0,0,5
Carlton,"Kreuzer, Matthew",23,16,5,7,1,0,25,5
Carlton,"Lamb, Jed",9,5,1,4,0,0,0,1
Carlton,"Marchbank, Caleb",7,4,0,3,0,0,0,0
Carlton,"Mullett, Aaron",6,6,3,0,0,0,0,1
Carlton,"Murphy, Marc",29,19,9,10,0,1,0,8
Carlton,"Petrevski-Seton, Sam",15,4,2,11,0,0,0,2
Carlton,"Plowman, Lachie",13,7,4,6,0,0,0,0
Carlton,"Polson, Cameron",5,2,0,3,0,2,0,0
Carlton,"Simpson, Kade",20,16,7,4,0,0,0,3
Carlton,"Thomas, Dale",21,13,7,8,1,0,0,2
Carlton,"Weitering, Jacob",11,9,3,2,0,0,0,2
Carlton,"Wright, Matthew",12,5,2,7,0,0,0,1
Carlton,"Casboult, Levi",11,7,2,4,0,0,10,3
Carlton,"Cripps, Patrick",19,10,1,9,0,0,0,6
Carlton,"Cuningham, David",10,3,0,7,0,0,0,2
Carlton,"Curnow, Charlie",11,7,6,4,0,0,0,3
Carlton,"Curnow, Ed",26,13,7,13,0,0,0,7
Carlton,"Dow, Paddy",10,5,1,5,0,0,0,2
Carlton,"Fisher, Zac",13,11,3,2,0,2,0,2
Carlton,"Garlett, Jarrod",8,8,3,0,2,0,0,5
Carlton,"Graham, Nick",12,4,3,8,0,0,0,2
Carlton,"Jones, Liam",10,5,6,5,0,0,0,0
Carlton,"Kennedy, Matthew",19,9,7,10,0,0,0,5
Carlton,"Kreuzer, Matthew",8,6,0,2,0,0,23,4
Carlton,"Mullett, Aaron",19,14,4,5,0,0,0,2
Carlton,"OBrien, Lochie",11,7,4,4,0,0,0,2
Carlton,"OShea, Cameron",13,8,5,5,0,0,0,4
Carlton,"Petrevski-Seton, Sam",12,10,5,2,0,0,0,3
Carlton,"Plowman, Lachie",9,6,3,3,0,0,0,0
Carlton,"Silvagni, Jack",12,9,4,3,1,1,0,3
Carlton,"Simpson, Kade",17,13,2,4,0,0,0,4
Carlton,"Thomas, Dale",22,18,5,4,0,0,0,0
Carlton,"Weitering, Jacob",11,8,4,3,0,0,0,3
Carlton,"Wright, Matthew",15,11,3,4,1,0,0,3
Carlton,"Casboult, Levi",10,7,6,3,2,0,6,1
Carlton,"Cripps, Patrick",34,12,5,22,0,0,0,11
Carlton,"Curnow, Charlie",17,10,4,7,0,1,0,4
Carlton,"Curnow, Ed",25,12,5,13,1,1,0,12
Carlton,"Dow, Paddy",15,6,1,9,0,0,0,3
Carlton,"Fisher, Zac",27,15,2,12,1,0,0,4
Carlton,"Garlett, Jarrod",5,5,2,0,0,0,0,3
Carlton,"Jones, Liam",15,13,10,2,0,0,0,1
Carlton,"Kerridge, Sam",14,8,6,6,1,1,0,2
Carlton,"Lamb, Jed",9,6,3,3,0,0,0,2
Carlton,"McKay, Harry",10,9,6,1,4,0,0,1
Carlton,"Mullett, Aaron",16,11,7,5,0,0,0,3
Carlton,"OBrien, Lochie",15,11,5,4,0,0,0,3
Carlton,"OShea, Cameron",10,7,3,3,0,0,0,2
Carlton,"Petrevski-Seton, Sam",15,10,6,5,1,0,0,3
Carlton,"Phillips, Andrew",6,5,3,1,0,0,24,6
Carlton,"Plowman, Lachie",13,8,6,5,0,0,0,1
Carlton,"Rowe, Sam",8,7,3,1,0,0,0,3
Carlton,"Silvagni, Jack",8,5,5,3,0,1,0,2
Carlton,"Simpson, Kade",31,30,10,1,0,0,0,2
Carlton,"Thomas, Dale",26,14,3,12,0,0,0,1
Carlton,"Wright, Matthew",12,8,3,4,0,1,0,0
Carlton,"Casboult, Levi",10,7,6,3,2,3,6,1
Carlton,"Cripps, Patrick",32,12,2,20,0,0,0,9
Carlton,"Curnow, Charlie",19,13,11,6,1,4,0,1
Carlton,"Curnow, Ed",21,10,2,11,0,0,0,7
Carlton,"Dow, Paddy",14,8,4,6,0,1,0,1
Carlton,"Fisher, Zac",28,17,2,11,1,1,0,5
Carlton,"Jones, Liam",10,7,7,3,0,0,0,3
Carlton,"Kennedy, Matthew",18,8,2,10,0,0,0,8
Carlton,"Kerridge, Sam",28,14,7,14,0,1,0,4
Carlton,"Marchbank, Caleb",11,5,2,6,0,0,0,2
Carlton,"McKay, Harry",10,7,5,3,1,0,0,1
Carlton,"Mullett, Aaron",8,5,2,3,0,0,0,2
Carlton,"OBrien, Lochie",9,6,1,3,0,0,0,1
Carlton,"OShea, Cameron",14,7,5,7,0,0,0,4
Carlton,"Petrevski-Seton, Sam",14,10,2,4,0,1,0,5
Carlton,"Phillips, Andrew",7,4,1,3,1,0,48,2
Carlton,"Plowman, Lachie",8,7,5,1,0,0,0,2
Carlton,"Rowe, Sam",6,5,1,1,0,0,0,1
Carlton,"Silvagni, Jack",8,4,1,4,1,0,0,1
Carlton,"Simpson, Kade",20,12,3,8,0,0,0,2
Carlton,"Thomas, Dale",27,14,4,13,0,0,0,2
Carlton,"Wright, Matthew",17,7,3,10,1,0,0,4
Carlton,"Casboult, Levi",6,4,3,2,2,0,0,1
Carlton,"Cripps, Patrick",25,10,3,15,0,2,0,3
Carlton,"Curnow, Ed",26,13,3,13,1,0,0,14
Carlton,"Dow, Paddy",15,11,2,4,1,0,0,5
Carlton,"Fisher, Zac",17,8,1,9,0,0,0,3
Carlton,"Garlett, Jarrod",10,10,6,0,0,1,0,5
Carlton,"Graham, Nick",13,11,5,2,1,0,0,0
Carlton,"Jones, Liam",11,8,7,3,0,0,0,3
Carlton,"Kennedy, Matthew",11,5,1,6,0,0,0,4
Carlton,"Kerridge, Sam",21,8,9,13,0,0,0,3
Carlton,"Kreuzer, Matthew",11,7,0,4,1,0,19,6
Carlton,"McKay, Harry",9,7,4,2,2,0,0,1
Carlton,"Mullett, Aaron",17,15,7,2,0,1,0,1
Carlton,"OBrien, Lochie",15,12,8,3,0,0,0,0
Carlton,"OShea, Cameron",16,12,8,4,0,0,0,2
Carlton,"Petrevski-Seton, Sam",14,12,4,2,0,1,0,3
Carlton,"Phillips, Andrew",7,4,0,3,1,0,22,0
Carlton,"Plowman, Lachie",11,10,7,1,0,0,0,2
Carlton,"Rowe, Sam",9,5,5,4,0,0,0,1
Carlton,"Simpson, Kade",26,19,11,7,0,0,0,2
Carlton,"Thomas, Dale",26,20,10,6,0,0,0,5
Carlton,"Wright, Matthew",16,9,3,7,1,1,0,2
Carlton,"Cripps, Patrick",27,10,1,17,0,0,0,7
Carlton,"Curnow, Charlie",9,8,5,1,3,2,0,4
Carlton,"Curnow, Ed",24,15,5,9,2,1,0,13
Carlton,"Dow, Paddy",11,3,1,8,0,0,0,4
Carlton,"Fisher, Zac",15,8,3,7,1,0,0,5
Carlton,"Garlett, Jarrod",6,4,2,2,0,0,0,5
Carlton,"Graham, Nick",14,9,5,5,0,2,0,7
Carlton,"Jones, Liam",12,8,3,4,0,0,0,2
Carlton,"Kerridge, Sam",17,9,4,8,1,0,0,7
Carlton,"Kreuzer, Matthew",20,15,3,5,0,1,31,7
Carlton,"Lamb, Jed",15,8,3,7,2,0,0,3
Carlton,"Lang, Darcy",13,11,5,2,2,0,0,4
Carlton,"McKay, Harry",7,7,4,0,2,1,3,3
Carlton,"Mullett, Aaron",14,12,5,2,0,0,0,2
Carlton,"OBrien, Lochie",15,13,8,2,0,0,0,1
Carlton,"OShea, Cameron",10,6,3,4,0,0,0,3
Carlton,"Petrevski-Seton, Sam",10,5,1,5,1,0,0,8
Carlton,"Plowman, Lachie",9,6,3,3,0,0,0,2
Carlton,"Rowe, Sam",7,6,3,1,0,0,0,1
Carlton,"Simpson, Kade",28,21,8,7,0,0,0,0
Carlton,"Thomas, Dale",29,26,14,3,0,0,0,2
Carlton,"Wright, Matthew",17,9,3,8,0,0,0,1
Carlton,"Cripps, Patrick",31,12,8,19,1,1,0,9
Carlton,"Dow, Paddy",14,7,3,7,0,0,0,4
Carlton,"Fisher, Zac",20,10,3,10,1,1,0,6
Carlton,"Garlett, Jarrod",13,7,1,6,0,0,0,4
Carlton,"Graham, Nick",28,15,4,13,0,0,0,3
Carlton,"Jones, Liam",8,4,3,4,0,0,0,2
Carlton,"Kerr, Pat",7,6,2,1,0,0,0,1
Carlton,"Kerridge, Sam",22,14,6,8,0,0,0,2
Carlton,"Kreuzer, Matthew",12,7,1,5,0,2,22,4
Carlton,"Lamb, Jed",11,10,3,1,2,0,0,4
Carlton,"Lang, Darcy",16,11,3,5,0,0,0,6
Carlton,"McKay, Harry",7,6,5,1,2,1,3,4
Carlton,"Mullett, Aaron",16,8,5,8,0,0,0,2
Carlton,"Murphy, Marc",19,10,3,9,1,0,0,11
Carlton,"OBrien, Lochie",11,7,2,4,0,1,0,2
Carlton,"OShea, Cameron",10,7,1,3,0,0,0,3
Carlton,"Petrevski-Seton, Sam",22,11,4,11,0,0,0,6
Carlton,"Plowman, Lachie",15,9,4,6,0,0,0,3
Carlton,"Rowe, Sam",7,5,4,2,0,0,0,2
Carlton,"Simpson, Kade",19,8,1,11,0,0,0,3
Carlton,"Thomas, Dale",23,14,6,9,0,0,0,2
Carlton,"Wright, Matthew",15,8,3,7,0,0,0,6
Carlton,"Cripps, Patrick",31,12,7,19,0,0,0,4
Carlton,"Cuningham, David",5,4,1,1,1,0,0,2
Carlton,"Curnow, Charlie",8,7,3,1,1,0,0,3
Carlton,"Curnow, Ed",30,15,5,15,0,0,0,3
Carlton,"Dow, Paddy",18,14,6,4,0,2,0,6
Carlton,"Fisher, Zac",25,9,1,16,0,0,0,2
Carlton,"Jones, Liam",9,9,2,0,0,0,0,4
Carlton,"Kerr, Pat",9,6,3,3,1,2,0,1
Carlton,"Kerridge, Sam",11,7,2,4,0,0,0,4
Carlton,"Kreuzer, Matthew",16,7,2,9,0,0,39,6
Carlton,"Lamb, Jed",9,5,2,4,0,0,0,3
Carlton,"Lang, Darcy",12,11,5,1,0,1,0,3
Carlton,"McKay, Harry",6,4,0,2,1,1,4,4
Carlton,"OBrien, Lochie",11,6,2,5,0,0,0,3
Carlton,"OShea, Cameron",12,9,2,3,0,0,0,6
Carlton,"Petrevski-Seton, Sam",15,7,2,8,0,3,0,8
Carlton,"Plowman, Lachie",20,13,5,7,0,0,0,1
Carlton,"Rowe, Sam",11,9,3,2,0,0,2,1
Carlton,"Simpson, Kade",33,23,7,10,0,0,0,3
Carlton,"Thomas, Dale",20,13,10,7,0,0,0,3
Carlton,"Weitering, Jacob",11,8,6,3,0,0,0,2
Carlton,"Wright, Matthew",15,12,5,3,1,0,0,3
Carlton,"Cripps, Patrick",17,7,3,10,0,1,0,4
Carlton,"Cuningham, David",11,3,3,8,0,0,0,0
Carlton,"Curnow, Charlie",14,12,4,2,2,1,0,3
Carlton,"Curnow, Ed",23,11,4,12,1,0,0,7
Carlton,"Dow, Paddy",13,5,0,8,1,0,0,3
Carlton,"Fisher, Zac",19,12,0,7,0,0,0,2
Carlton,"Jones, Liam",11,9,9,2,0,0,0,1
Carlton,"Kerr, Pat",11,9,4,2,1,2,6,1
Carlton,"Kerridge, Sam",29,17,8,12,0,1,0,4
Carlton,"Kreuzer, Matthew",14,10,3,4,0,0,37,2
Carlton,"Lamb, Jed",5,4,2,1,0,0,0,4
Carlton,"Lang, Darcy",12,9,3,3,1,0,0,1
Carlton,"OBrien, Lochie",12,7,4,5,0,0,0,1
Carlton,"OShea, Cameron",15,13,7,2,0,0,0,1
Carlton,"Petrevski-Seton, Sam",14,9,3,5,0,0,0,4
Carlton,"Plowman, Lachie",6,3,2,3,0,0,0,1
Carlton,"Rowe, Sam",8,7,2,1,0,0,0,2
Carlton,"Silvagni, Jack",14,9,4,5,2,1,0,4
Carlton,"Simpson, Kade",27,16,4,11,0,0,0,0
Carlton,"Thomas, Dale",15,10,5,5,0,0,0,2
Carlton,"Weitering, Jacob",15,13,9,2,0,0,0,1
Carlton,"Wright, Matthew",6,5,2,1,1,1,0,1
Carlton,"Casboult, Levi",9,7,5,2,1,1,6,0
Carlton,"Cripps, Patrick",38,12,7,26,0,0,0,1
Carlton,"Curnow, Charlie",12,8,7,4,0,1,0,1
Carlton,"Curnow, Ed",26,9,4,17,0,1,0,5
Carlton,"Dow, Paddy",15,6,4,9,0,0,0,4
Carlton,"Fisher, Zac",19,9,3,10,0,1,0,4
Carlton,"Graham, Nick",17,9,6,8,0,1,0,2
Carlton,"Jones, Liam",10,5,7,5,0,0,0,1
Carlton,"Kerr, Pat",10,7,8,3,0,1,0,0
Carlton,"Kerridge, Sam",18,13,7,5,1,0,0,4
Carlton,"Kreuzer, Matthew",16,12,4,4,2,1,18,2
Carlton,"Lamb, Jed",19,10,2,9,0,0,0,5
Carlton,"Lang, Darcy",12,8,5,4,0,0,0,1
Carlton,"OBrien, Lochie",17,13,5,4,0,0,0,1
Carlton,"Petrevski-Seton, Sam",15,8,5,7,0,1,0,7
Carlton,"Plowman, Lachie",18,7,5,11,0,0,0,0
Carlton,"Rowe, Sam",12,4,4,8,0,0,0,2
Carlton,"Silvagni, Jack",13,6,3,7,0,0,0,5
Carlton,"Simpson, Kade",32,21,7,11,0,0,0,1
Carlton,"Thomas, Dale",20,11,10,9,0,0,0,4
Carlton,"Weitering, Jacob",22,13,7,9,0,0,0,2
Carlton,"Wright, Matthew",14,11,6,3,2,1,0,3
Carlton,"Cripps, Patrick",29,15,7,14,3,0,0,9
Carlton,"Curnow, Charlie",19,16,10,3,3,1,0,1
Carlton,"Curnow, Ed",16,10,4,6,0,0,0,6
Carlton,"Dow, Paddy",20,8,2,12,0,0,0,4
Carlton,"Fisher, Zac",17,10,1,7,0,0,0,1
Carlton,"Garlett, Jarrod",10,5,4,5,0,2,0,0
Carlton,"Jones, Liam",17,14,14,3,0,0,0,3
Carlton,"Kennedy, Matthew",21,7,6,14,0,0,0,3
Carlton,"Kreuzer, Matthew",9,5,3,4,1,0,6,0
Carlton,"Lamb, Jed",20,15,5,5,0,0,0,2
Carlton,"Mullett, Aaron",15,10,6,5,1,0,0,2
Carlton,"OBrien, Lochie",9,7,5,2,0,0,0,3
Carlton,"OShea, Cameron",10,6,3,4,0,0,0,2
Carlton,"Petrevski-Seton, Sam",16,11,6,5,0,0,0,2
Carlton,"Plowman, Lachie",3,3,2,0,0,0,0,0
Carlton,"Polson, Cameron",4,1,0,3,0,0,0,5
Carlton,"Rowe, Sam",7,4,3,3,1,0,8,4
Carlton,"Silvagni, Jack",11,8,5,3,0,0,0,3
Carlton,"Simpson, Kade",31,18,11,13,0,0,0,4
Carlton,"Thomas, Dale",25,16,12,9,0,0,0,1
Carlton,"Weitering, Jacob",11,9,9,2,0,0,0,2
Carlton,"Wright, Matthew",16,9,6,7,0,0,0,1
Carlton,"Casboult, Levi",4,4,3,0,0,3,2,1
Carlton,"Cripps, Patrick",33,16,2,17,1,1,0,3
Carlton,"Curnow, Charlie",17,13,9,4,4,1,0,0
Carlton,"Curnow, Ed",33,17,3,16,0,0,0,2
Carlton,"Dow, Paddy",14,7,0,7,1,0,0,2
Carlton,"Fisher, Zac",23,11,1,12,0,0,0,2
Carlton,"Garlett, Jarrod",17,7,3,10,0,2,0,3
Carlton,"Graham, Nick",20,5,4,15,0,0,0,4
Carlton,"Jones, Liam",14,11,4,3,0,0,0,4
Carlton,"Kennedy, Matthew",19,9,5,10,1,1,0,2
Carlton,"Lamb, Jed",14,9,1,5,0,0,0,1
Carlton,"Mullett, Aaron",13,8,5,5,0,0,0,2
Carlton,"Murphy, Marc",28,16,4,12,1,1,0,5
Carlton,"Petrevski-Seton, Sam",14,4,2,10,0,0,0,7
Carlton,"Phillips, Andrew",12,7,3,5,1,0,42,2
Carlton,"Pickett, Jarrod",7,5,1,2,1,0,0,2
Carlton,"Polson, Cameron",7,5,1,2,0,0,0,2
Carlton,"Rowe, Sam",18,7,4,11,0,0,0,1
Carlton,"Silvagni, Jack",10,4,3,6,0,0,0,1
Carlton,"Simpson, Kade",37,21,3,16,0,0,0,2
Carlton,"Weitering, Jacob",13,8,6,5,0,0,0,1
Carlton,"Wright, Matthew",13,10,8,3,0,0,0,2
Carlton,"Cripps, Patrick",21,6,2,15,0,0,0,10
Carlton,"Curnow, Charlie",6,6,3,0,3,1,0,1
Carlton,"Curnow, Ed",26,12,0,14,0,0,0,2
Carlton,"Fisher, Zac",17,9,1,8,0,1,0,1
Carlton,"Graham, Nick",13,6,4,7,0,1,0,3
Carlton,"Jones, Liam",6,3,4,3,0,0,0,3
Carlton,"Kennedy, Matthew",21,5,3,16,0,1,0,2
Carlton,"Kreuzer, Matthew",13,7,2,6,0,0,30,2
Carlton,"Lamb, Jed",22,12,4,10,1,0,0,2
Carlton,"Lang, Darcy",17,8,2,9,0,1,0,5
Carlton,"Marchbank, Caleb",11,6,5,5,0,0,0,0
Carlton,"Murphy, Marc",22,13,2,9,0,0,0,2
Carlton,"OBrien, Lochie",16,10,7,6,1,0,0,2
Carlton,"Petrevski-Seton, Sam",10,7,3,3,2,0,0,3
Carlton,"Phillips, Andrew",2,2,2,0,0,0,3,0
Carlton,"Pickett, Jarrod",7,6,2,1,0,0,0,3
Carlton,"Polson, Cameron",9,5,0,4,0,1,0,2
Carlton,"Rowe, Sam",7,4,5,3,0,0,1,0
Carlton,"Silvagni, Jack",9,3,1,6,0,0,0,7
Carlton,"Thomas, Dale",22,13,7,9,0,0,0,6
Carlton,"Weitering, Jacob",13,10,5,3,0,0,0,0
Carlton,"Wright, Matthew",7,4,1,3,0,1,0,2
Carlton,"Cripps, Patrick",35,11,7,24,1,0,0,4
Carlton,"Curnow, Charlie",16,11,5,5,1,0,1,4
Carlton,"Curnow, Ed",31,15,5,16,0,0,0,6
Carlton,"Dow, Paddy",17,8,1,9,0,0,0,2
Carlton,"Fisher, Zac",22,6,3,16,1,0,0,5
Carlton,"Garlett, Jarrod",14,8,2,6,0,1,0,3
Carlton,"Jones, Liam",9,6,2,3,0,1,9,6
Carlton,"Kennedy, Matthew",15,1,2,14,1,0,0,3
Carlton,"Kreuzer, Matthew",0,0,0,0,0,0,3,2
Carlton,"Lamb, Jed",16,13,2,3,0,0,0,2
Carlton,"Marchbank, Caleb",7,2,4,5,0,0,0,2
Carlton,"McKay, Harry",15,8,7,7,0,1,5,0
Carlton,"Murphy, Marc",24,10,4,14,0,1,0,3
Carlton,"OBrien, Lochie",19,5,3,14,0,0,0,2
Carlton,"Petrevski-Seton, Sam",20,8,4,12,0,1,0,1
Carlton,"Pickett, Jarrod",9,5,2,4,1,0,0,1
Carlton,"Polson, Cameron",3,2,0,1,0,0,0,3
Carlton,"Rowe, Sam",11,5,5,6,0,0,6,1
Carlton,"Shaw, Matt",15,7,2,8,0,0,0,1
Carlton,"Silvagni, Jack",14,6,4,8,0,1,0,2
Carlton,"Simpson, Kade",21,14,3,7,1,0,0,0
Carlton,"Thomas, Dale",24,12,7,12,1,0,0,0
Carlton,"Casboult, Levi",5,3,2,2,0,0,0,1
Carlton,"Cripps, Patrick",30,10,3,20,2,1,0,7
Carlton,"Curnow, Charlie",14,9,4,5,1,1,0,1
Carlton,"Curnow, Ed",20,7,4,13,0,1,0,6
Carlton,"Dow, Paddy",14,5,5,9,0,1,0,2
Carlton,"Fisher, Zac",9,4,1,5,0,0,0,2
Carlton,"Graham, Nick",23,12,2,11,0,0,0,5
Carlton,"Jones, Liam",5,4,1,1,0,0,0,3
Carlton,"Kennedy, Matthew",29,12,4,17,1,1,0,4
Carlton,"Lobbe, Matthew",13,9,1,4,0,0,37,3
Carlton,"Marchbank, Caleb",21,11,7,10,0,0,0,1
Carlton,"McKay, Harry",15,12,8,3,0,1,2,1
Carlton,"Murphy, Marc",35,15,6,20,0,1,0,0
Carlton,"OBrien, Lochie",18,12,6,6,0,0,0,1
Carlton,"Petrevski-Seton, Sam",19,11,3,8,0,0,0,3
Carlton,"Pickett, Jarrod",12,8,1,4,0,1,0,4
Carlton,"Polson, Cameron",15,9,1,6,1,0,0,3
Carlton,"Shaw, Matt",21,9,7,12,0,0,0,1
Carlton,"Silvagni, Jack",18,11,4,7,0,0,0,1
Carlton,"Simpson, Kade",20,12,8,8,1,0,0,0
Carlton,"Weitering, Jacob",23,12,8,11,0,0,0,0
Carlton,"Wright, Matthew",18,10,4,8,1,1,0,5
Carlton,"Byrne, Ciaran",13,8,4,5,0,1,0,2
Carlton,"Cripps, Patrick",37,16,6,21,1,1,0,11
Carlton,"Curnow, Charlie",18,16,10,2,1,1,0,5
Carlton,"Curnow, Ed",28,13,3,15,0,0,0,6
Carlton,"Dow, Paddy",18,7,0,11,2,0,0,4
Carlton,"Kennedy, Matthew",23,14,4,9,0,0,0,2
Carlton,"Lamb, Jed",15,11,4,4,1,0,0,1
Carlton,"Lang, Darcy",20,13,5,7,2,0,0,9
Carlton,"Lobbe, Matthew",5,3,0,2,0,0,46,6
Carlton,"Marchbank, Caleb",16,13,4,3,0,0,0,8
Carlton,"McKay, Harry",9,8,6,1,1,0,0,0
Carlton,"Murphy, Marc",36,23,7,13,1,0,0,4
Carlton,"OBrien, Lochie",12,12,5,0,1,0,0,1
Carlton,"Petrevski-Seton, Sam",26,14,3,12,0,0,0,1
Carlton,"Pickett, Jarrod",6,3,2,3,0,0,0,5
Carlton,"Polson, Cameron",4,2,0,2,0,0,0,4
Carlton,"Rowe, Sam",6,3,0,3,0,0,6,1
Carlton,"Silvagni, Jack",11,8,1,3,1,0,0,4
Carlton,"Simpson, Kade",29,22,6,7,0,0,0,2
Carlton,"Thomas, Dale",22,14,7,8,0,0,0,1
Carlton,"Weitering, Jacob",15,10,5,5,0,0,0,2
Carlton,"Wright, Matthew",14,6,4,8,1,1,0,3
Carlton,"Byrne, Ciaran",16,10,4,6,0,0,0,4
Carlton,"Cripps, Patrick",29,11,4,18,0,0,0,9
Carlton,"Curnow, Charlie",11,9,4,2,1,1,0,3
Carlton,"Curnow, Ed",22,12,2,10,0,0,0,4
Carlton,"Dow, Paddy",11,2,1,9,1,0,0,3
Carlton,"Graham, Nick",9,4,1,5,0,0,0,1
Carlton,"Kennedy, Matthew",13,6,2,7,0,0,0,2
Carlton,"Lamb, Jed",17,13,5,4,0,0,0,1
Carlton,"Lang, Darcy",13,8,4,5,0,0,0,4
Carlton,"Lobbe, Matthew",5,3,2,2,0,0,39,5
Carlton,"Marchbank, Caleb",12,10,2,2,0,0,0,2
Carlton,"McKay, Harry",15,9,8,6,3,2,2,1
Carlton,"Murphy, Marc",24,11,8,13,0,0,0,7
Carlton,"OBrien, Lochie",10,7,2,3,0,0,0,0
Carlton,"OShea, Cameron",5,4,1,1,0,0,0,3
Carlton,"Petrevski-Seton, Sam",17,12,6,5,0,0,0,3
Carlton,"Pickett, Jarrod",9,7,1,2,0,0,0,2
Carlton,"Polson, Cameron",7,5,1,2,0,0,0,5
Carlton,"Rowe, Sam",8,4,2,4,0,0,0,4
Carlton,"Simpson, Kade",21,10,3,11,0,0,0,0
Carlton,"Thomas, Dale",14,9,5,5,0,0,0,2
Carlton,"Wright, Matthew",18,15,7,3,2,1,0,2
Carlton,"Byrne, Ciaran",16,7,2,9,0,0,0,2
Carlton,"Cripps, Patrick",32,13,5,19,0,2,0,4
Carlton,"Curnow, Charlie",13,11,9,2,2,2,0,3
Carlton,"Curnow, Ed",20,11,1,9,0,0,0,8
Carlton,"Dow, Paddy",15,10,2,5,0,2,0,2
Carlton,"Graham, Nick",18,13,3,5,0,1,0,2
Carlton,"Kerridge, Sam",29,16,5,13,0,0,0,1
Carlton,"Lamb, Jed",16,13,2,3,0,0,0,3
Carlton,"Lang, Darcy",14,5,4,9,1,0,0,1
Carlton,"Lobbe, Matthew",14,8,5,6,1,0,28,5
Carlton,"Marchbank, Caleb",8,7,3,1,0,0,0,1
Carlton,"McKay, Harry",12,8,4,4,2,0,4,4
Carlton,"Murphy, Marc",22,15,5,7,1,0,0,5
Carlton,"OBrien, Lochie",9,5,2,4,0,0,0,0
Carlton,"Petrevski-Seton, Sam",19,9,3,10,0,0,0,6
Carlton,"Pickett, Jarrod",8,6,4,2,0,0,0,3
Carlton,"Polson, Cameron",5,4,1,1,0,0,0,2
Carlton,"Rowe, Sam",11,7,4,4,0,0,0,2
Carlton,"Silvagni, Jack",4,3,1,1,0,0,0,2
Carlton,"Simpson, Kade",20,12,2,8,0,0,0,3
Carlton,"Thomas, Dale",30,15,6,15,1,0,0,0
Carlton,"Wright, Matthew",9,7,3,2,2,1,0,0
Carlton,"Byrne, Ciaran",22,10,4,12,0,0,0,6
Carlton,"Cripps, Patrick",29,13,3,16,0,0,0,6
Carlton,"Curnow, Charlie",9,6,3,3,2,0,0,1
Carlton,"Curnow, Ed",28,13,9,15,0,0,0,7
Carlton,"De Koning, Tom",11,5,5,6,1,0,3,3
Carlton,"Dow, Paddy",13,6,1,7,1,0,0,4
Carlton,"Lamb, Jed",21,17,4,4,0,0,0,1
Carlton,"Lang, Darcy",13,7,6,6,0,0,0,1
Carlton,"Lobbe, Matthew",13,6,3,7,0,1,27,3
Carlton,"Marchbank, Caleb",21,13,11,8,0,0,0,1
Carlton,"McKay, Harry",13,11,6,2,0,2,0,2
Carlton,"Mullett, Aaron",9,6,0,3,0,1,0,4
Carlton,"Murphy, Marc",22,14,3,8,0,0,0,2
Carlton,"OBrien, Lochie",20,12,6,8,0,0,0,2
Carlton,"Petrevski-Seton, Sam",9,3,1,6,0,0,0,6
Carlton,"Polson, Cameron",10,2,0,8,0,0,0,0
Carlton,"Rowe, Sam",10,3,2,7,0,0,0,1
Carlton,"Silvagni, Jack",11,6,3,5,1,0,0,4
Carlton,"Simpson, Kade",35,25,3,10,1,0,0,4
Carlton,"Thomas, Dale",23,11,5,12,0,0,0,2
Carlton,"Weitering, Jacob",16,9,7,7,0,0,0,0
Carlton,"Wright, Matthew",9,6,4,3,1,0,0,1
Carlton,"Byrne, Ciaran",21,13,5,8,0,0,0,3
Carlton,"Cripps, Patrick",37,14,2,23,0,2,0,7
Carlton,"Curnow, Charlie",7,3,1,4,0,0,0,1
Carlton,"Curnow, Ed",17,7,3,10,0,0,0,2
Carlton,"De Koning, Tom",5,1,1,4,0,0,0,1
Carlton,"Kerridge, Sam",22,11,6,11,1,0,0,0
Carlton,"Lamb, Jed",17,11,2,6,0,1,0,1
Carlton,"Lang, Darcy",10,3,2,7,0,0,0,5
Carlton,"Lobbe, Matthew",9,3,3,6,0,0,35,7
Carlton,"Marchbank, Caleb",10,4,4,6,0,1,0,1
Carlton,"McKay, Harry",10,7,7,3,3,2,1,1
Carlton,"Mullett, Aaron",18,16,3,2,1,1,0,0
Carlton,"Murphy, Marc",24,12,1,12,0,0,0,1
Carlton,"OBrien, Lochie",22,16,4,6,0,0,0,1
Carlton,"Petrevski-Seton, Sam",18,11,4,7,0,1,0,6
Carlton,"Polson, Cameron",15,10,3,5,2,1,0,7
Carlton,"Rowe, Sam",11,7,2,4,0,0,0,1
Carlton,"Silvagni, Jack",12,8,3,4,0,0,0,1
Carlton,"Simpson, Kade",18,10,6,8,1,0,0,2
Carlton,"Thomas, Dale",22,12,7,10,0,1,0,2
Carlton,"Weitering, Jacob",14,10,6,4,0,0,0,2
Carlton,"Wright, Matthew",13,8,2,5,0,2,0,2
Collingwood,"Adams, Taylor",20,9,2,11,0,0,0,4
Collingwood,"Aish, James",17,8,1,9,1,0,0,0
Collingwood,"Cox, Mason",6,4,0,2,0,0,18,1
Collingwood,"Crisp, Jack",17,10,3,7,0,0,0,4
Collingwood,"Crocker, Ben",9,6,2,3,2,3,0,3
Collingwood,"Dunn, Lynden",12,9,3,3,0,0,0,4
Collingwood,"Grundy, Brodie",12,7,4,5,0,0,28,3
Collingwood,"Hoskin-Elliott, Will",16,12,4,4,1,0,0,1
Collingwood,"Howe, Jeremy",12,9,2,3,1,0,0,3
Collingwood,"Langdon, Tom",14,4,4,10,0,0,0,2
Collingwood,"Maynard, Brayden",19,16,6,3,0,1,0,2
Collingwood,"Moore, Darcy",15,11,8,4,1,0,0,3
Collingwood,"Murray, Sam",19,12,4,7,0,0,0,3
Collingwood,"Pendlebury, Scott",26,12,2,14,0,1,0,9
Collingwood,"Phillips, Tom",20,10,3,10,0,0,0,2
Collingwood,"Reid, Ben",11,8,6,3,1,0,0,3
Collingwood,"Sidebottom, Steele",31,15,5,16,1,0,0,4
Collingwood,"Smith, Josh",14,7,3,7,0,1,0,3
Collingwood,"Stephenson, Jaidyn",16,10,4,6,0,0,0,3
Collingwood,"Thomas, Josh",17,10,3,7,1,1,0,4
Collingwood,"Treloar, Adam",33,14,1,19,0,1,0,6
Collingwood,"Varcoe, Travis",7,2,0,5,0,0,0,4
Collingwood,"Adams, Taylor",25,6,2,19,0,0,0,7
Collingwood,"Aish, James",23,14,6,9,1,0,0,4
Collingwood,"Broomhead, Tim",0,0,0,0,0,0,0,0
Collingwood,"Brown, Callum",12,4,1,8,0,0,0,4
Collingwood,"Crisp, Jack",20,13,4,7,1,1,0,3
Collingwood,"Crocker, Ben",11,10,4,1,1,1,0,0
Collingwood,"Dunn, Lynden",15,7,5,8,0,0,0,2
Collingwood,"Grundy, Brodie",20,7,3,13,2,0,45,3
Collingwood,"Hoskin-Elliott, Will",11,5,4,6,1,1,0,3
Collingwood,"Howe, Jeremy",27,19,9,8,0,0,0,2
Collingwood,"Langdon, Tom",24,15,6,9,0,0,0,1
Collingwood,"Maynard, Brayden",15,7,0,8,0,0,0,7
Collingwood,"Moore, Darcy",6,4,1,2,1,0,2,2
Collingwood,"Murray, Sam",20,11,2,9,0,0,0,0
Collingwood,"Pendlebury, Scott",30,11,5,19,0,0,1,9
Collingwood,"Phillips, Tom",32,21,10,11,1,1,0,2
Collingwood,"Scharenberg, Matt",23,13,8,10,0,0,0,3
Collingwood,"Sidebottom, Steele",24,11,6,13,0,0,0,5
Collingwood,"Stephenson, Jaidyn",13,8,2,5,0,0,0,4
Collingwood,"Thomas, Josh",20,9,2,11,1,2,0,2
Collingwood,"Treloar, Adam",24,8,3,16,2,0,0,5
Collingwood,"Varcoe, Travis",12,8,2,4,1,1,0,4
Collingwood,"Adams, Taylor",27,14,4,13,0,0,0,1
Collingwood,"Aish, James",20,12,7,8,1,0,0,1
Collingwood,"Brown, Callum",20,8,2,12,0,0,0,5
Collingwood,"Cox, Mason",9,3,6,6,0,0,4,3
Collingwood,"Crisp, Jack",32,18,9,14,0,0,0,2
Collingwood,"Crocker, Ben",10,5,4,5,0,0,0,2
Collingwood,"Dunn, Lynden",13,9,5,4,0,0,0,3
Collingwood,"Grundy, Brodie",25,11,6,14,0,0,32,8
Collingwood,"Hoskin-Elliott, Will",18,14,7,4,3,1,0,1
Collingwood,"Howe, Jeremy",18,14,7,4,0,0,0,1
Collingwood,"Langdon, Tom",22,14,7,8,0,0,0,2
Collingwood,"Maynard, Brayden",18,8,3,10,0,0,0,3
Collingwood,"Murray, Sam",21,13,7,8,0,0,0,4
Collingwood,"Pendlebury, Scott",21,11,4,10,0,0,0,12
Collingwood,"Phillips, Tom",20,9,6,11,0,0,0,6
Collingwood,"Reid, Ben",12,10,7,2,3,0,1,1
Collingwood,"Scharenberg, Matt",18,6,3,12,0,0,0,0
Collingwood,"Sidebottom, Steele",34,16,7,18,3,0,0,4
Collingwood,"Stephenson, Jaidyn",6,3,2,3,0,0,0,3
Collingwood,"Thomas, Josh",15,11,5,4,5,0,0,6
Collingwood,"Treloar, Adam",26,12,5,14,1,2,0,0
Collingwood,"Varcoe, Travis",12,6,0,6,0,1,0,1
Collingwood,"Aish, James",15,10,2,5,1,0,0,7
Collingwood,"Brown, Callum",15,7,1,8,0,0,0,8
Collingwood,"Cox, Mason",5,3,1,2,0,0,10,1
Collingwood,"Crisp, Jack",21,10,3,11,0,0,0,0
Collingwood,"Crocker, Ben",11,9,4,2,1,1,0,3
Collingwood,"Dunn, Lynden",9,6,2,3,0,0,0,1
Collingwood,"Grundy, Brodie",33,10,1,23,1,0,40,2
Collingwood,"Hoskin-Elliott, Will",23,12,1,11,2,1,0,4
Collingwood,"Howe, Jeremy",12,9,4,3,0,0,0,0
Collingwood,"Langdon, Tom",14,4,1,10,0,0,0,4
Collingwood,"Maynard, Brayden",18,11,0,7,0,1,0,2
Collingwood,"Murray, Sam",23,7,3,16,0,1,0,6
Collingwood,"Pendlebury, Scott",30,19,4,11,0,1,0,3
Collingwood,"Phillips, Tom",31,15,1,16,1,0,0,4
Collingwood,"Reid, Ben",15,10,4,5,1,3,0,1
Collingwood,"Scharenberg, Matt",17,9,4,8,0,0,0,1
Collingwood,"Sidebottom, Steele",43,19,2,24,0,1,0,7
Collingwood,"Stephenson, Jaidyn",13,7,4,6,5,1,0,3
Collingwood,"Thomas, Josh",20,10,3,10,2,0,0,4
Collingwood,"Treloar, Adam",36,13,2,23,0,0,0,11
Collingwood,"Varcoe, Travis",13,7,3,6,1,0,0,0
Collingwood,"de Goey, Jordan",15,8,2,7,1,0,0,5
Collingwood,"Aish, James",20,11,6,9,0,1,0,1
Collingwood,"Brown, Callum",22,5,2,17,0,0,0,2
Collingwood,"Cox, Mason",12,7,8,5,2,2,4,2
Collingwood,"Crisp, Jack",14,7,4,7,0,0,0,2
Collingwood,"Crocker, Ben",11,7,6,4,0,1,0,2
Collingwood,"Dunn, Lynden",11,9,4,2,0,0,0,3
Collingwood,"Grundy, Brodie",22,9,4,13,0,0,32,3
Collingwood,"Hoskin-Elliott, Will",12,8,5,4,2,2,0,0
Collingwood,"Howe, Jeremy",16,13,8,3,0,0,0,3
Collingwood,"Langdon, Tom",19,12,5,7,0,0,0,4
Collingwood,"Maynard, Brayden",15,13,3,2,0,0,0,6
Collingwood,"Murray, Sam",21,10,4,11,0,0,0,1
Collingwood,"Pendlebury, Scott",27,11,6,16,0,0,0,5
Collingwood,"Phillips, Tom",25,8,2,17,1,1,0,0
Collingwood,"Reid, Ben",9,6,3,3,1,2,1,1
Collingwood,"Scharenberg, Matt",19,8,3,11,0,0,0,0
Collingwood,"Sidebottom, Steele",25,11,1,14,3,0,0,1
Collingwood,"Stephenson, Jaidyn",15,12,5,3,2,2,0,4
Collingwood,"Thomas, Josh",17,7,1,10,0,0,0,2
Collingwood,"Treloar, Adam",34,13,6,21,2,2,0,2
Collingwood,"Varcoe, Travis",18,8,2,10,0,1,0,2
Collingwood,"de Goey, Jordan",23,11,2,12,1,0,0,2
Collingwood,"Aish, James",13,4,1,9,0,0,0,1
Collingwood,"Appleby, Flynn",8,4,1,4,0,0,0,3
Collingwood,"Blair, Jarryd",20,8,4,12,0,0,0,4
Collingwood,"Brown, Callum",18,8,4,10,0,0,0,6
Collingwood,"Cox, Mason",10,6,6,4,2,1,11,1
Collingwood,"Crisp, Jack",22,10,3,12,0,0,0,4
Collingwood,"Dunn, Lynden",16,7,0,9,0,0,0,0
Collingwood,"Grundy, Brodie",24,4,5,20,0,0,33,4
Collingwood,"Hoskin-Elliott, Will",17,10,9,7,2,0,0,1
Collingwood,"Howe, Jeremy",30,18,12,12,0,0,0,4
Collingwood,"Maynard, Brayden",16,10,2,6,0,0,0,4
Collingwood,"Mayne, Chris",11,7,5,4,0,1,0,2
Collingwood,"Murray, Sam",19,11,8,8,0,0,0,2
Collingwood,"Pendlebury, Scott",29,12,5,17,1,0,0,8
Collingwood,"Phillips, Tom",38,16,9,22,0,0,0,3
Collingwood,"Reid, Ben",11,10,6,1,2,1,0,1
Collingwood,"Scharenberg, Matt",25,13,7,12,0,0,0,2
Collingwood,"Sidebottom, Steele",25,13,5,12,0,1,0,2
Collingwood,"Stephenson, Jaidyn",13,7,2,6,1,0,0,6
Collingwood,"Thomas, Josh",16,9,4,7,0,0,0,3
Collingwood,"Treloar, Adam",42,17,6,25,1,0,0,5
Collingwood,"de Goey, Jordan",9,5,1,4,1,0,0,3
Collingwood,"Adams, Taylor",14,8,3,6,0,0,0,2
Collingwood,"Appleby, Flynn",13,10,4,3,0,0,0,1
Collingwood,"Blair, Jarryd",16,8,3,8,0,0,0,4
Collingwood,"Cox, Mason",10,6,4,4,1,0,10,2
Collingwood,"Crisp, Jack",19,14,5,5,0,0,0,4
Collingwood,"Crocker, Ben",10,6,1,4,0,0,0,2
Collingwood,"Dunn, Lynden",7,5,3,2,0,0,0,1
Collingwood,"Grundy, Brodie",16,4,1,12,0,0,39,11
Collingwood,"Hoskin-Elliott, Will",13,10,5,3,1,0,0,0
Collingwood,"Howe, Jeremy",17,12,7,5,1,0,0,2
Collingwood,"Mayne, Chris",18,10,5,8,1,2,0,3
Collingwood,"Moore, Darcy",5,3,3,2,1,0,0,0
Collingwood,"Murray, Sam",24,17,10,7,0,0,0,2
Collingwood,"Pendlebury, Scott",20,9,1,11,1,0,0,4
Collingwood,"Phillips, Tom",28,18,10,10,1,0,0,1
Collingwood,"Scharenberg, Matt",14,6,3,8,0,0,0,1
Collingwood,"Sidebottom, Steele",34,17,6,17,0,1,0,2
Collingwood,"Stephenson, Jaidyn",21,13,6,8,2,0,0,1
Collingwood,"Thomas, Josh",22,12,7,10,3,0,0,2
Collingwood,"Treloar, Adam",26,12,1,14,1,1,0,7
Collingwood,"Varcoe, Travis",19,10,4,9,1,0,0,1
Collingwood,"de Goey, Jordan",20,13,7,7,5,2,0,3
Collingwood,"Adams, Taylor",25,13,6,12,0,0,0,12
Collingwood,"Appleby, Flynn",15,12,6,3,0,0,0,1
Collingwood,"Brown, Callum",14,5,1,9,0,1,0,0
Collingwood,"Cox, Mason",9,2,3,7,0,0,8,3
Collingwood,"Crisp, Jack",32,20,7,12,0,1,0,11
Collingwood,"Crocker, Ben",11,8,3,3,0,0,0,0
Collingwood,"Dunn, Lynden",9,7,2,2,0,0,0,5
Collingwood,"Grundy, Brodie",19,9,5,10,1,0,42,5
Collingwood,"Hoskin-Elliott, Will",16,10,5,6,1,1,0,1
Collingwood,"Howe, Jeremy",30,19,11,11,0,1,0,3
Collingwood,"Mayne, Chris",25,10,10,15,0,1,0,9
Collingwood,"Moore, Darcy",3,2,3,1,0,0,0,0
Collingwood,"Murray, Sam",19,12,5,7,0,0,0,2
Collingwood,"Phillips, Tom",11,7,1,4,2,0,0,1
Collingwood,"Scharenberg, Matt",29,14,14,15,0,0,0,5
Collingwood,"Sidebottom, Steele",30,10,6,20,0,0,0,4
Collingwood,"Stephenson, Jaidyn",11,4,2,7,0,0,0,2
Collingwood,"Thomas, Josh",18,5,4,13,0,0,0,5
Collingwood,"Treloar, Adam",34,19,3,15,0,3,0,5
Collingwood,"Varcoe, Travis",10,6,2,4,0,0,0,3
Collingwood,"Wells, Daniel",13,11,5,2,0,3,0,5
Collingwood,"de Goey, Jordan",22,13,7,9,1,1,0,2
Collingwood,"Adams, Taylor",23,13,5,10,0,0,0,2
Collingwood,"Appleby, Flynn",16,12,8,4,0,0,0,1
Collingwood,"Cox, Mason",9,4,2,5,0,1,2,0
Collingwood,"Crisp, Jack",30,18,8,12,0,0,0,4
Collingwood,"Dunn, Lynden",15,12,6,3,0,0,0,2
Collingwood,"Fasolo, Alex",2,1,1,1,0,0,0,1
Collingwood,"Grundy, Brodie",23,13,7,10,0,1,42,5
Collingwood,"Hoskin-Elliott, Will",16,11,7,5,2,2,0,2
Collingwood,"Howe, Jeremy",30,22,11,8,0,0,0,3
Collingwood,"Langdon, Tom",25,14,7,11,0,0,0,7
Collingwood,"Mayne, Chris",16,6,4,10,0,0,0,1
Collingwood,"Murray, Sam",23,7,6,16,0,0,0,0
Collingwood,"Pendlebury, Scott",30,12,2,18,1,0,0,5
Collingwood,"Phillips, Tom",30,18,11,12,1,0,0,2
Collingwood,"Scharenberg, Matt",25,16,9,9,0,0,0,1
Collingwood,"Sidebottom, Steele",38,11,3,27,0,1,0,4
Collingwood,"Stephenson, Jaidyn",18,8,6,10,2,1,0,2
Collingwood,"Thomas, Josh",23,11,3,12,1,0,0,1
Collingwood,"Treloar, Adam",24,11,5,13,0,0,0,7
Collingwood,"Varcoe, Travis",8,6,2,2,0,2,0,5
Collingwood,"Wells, Daniel",16,9,3,7,2,0,0,3
Collingwood,"de Goey, Jordan",13,9,6,4,6,0,0,1
Collingwood,"Adams, Taylor",26,13,4,13,1,1,0,4
Collingwood,"Appleby, Flynn",11,6,2,5,0,0,0,1
Collingwood,"Cox, Mason",10,4,5,6,0,0,4,1
Collingwood,"Crisp, Jack",32,16,10,16,0,0,0,1
Collingwood,"Daicos, Josh",16,11,4,5,1,1,0,1
Collingwood,"Dunn, Lynden",23,15,9,8,0,0,0,2
Collingwood,"Greenwood, Levi",22,8,6,14,0,0,0,1
Collingwood,"Grundy, Brodie",26,9,7,17,0,0,38,2
Collingwood,"Hoskin-Elliott, Will",18,14,9,4,2,1,0,6
Collingwood,"Howe, Jeremy",14,10,6,4,0,0,0,1
Collingwood,"Langdon, Tom",29,13,4,16,1,0,0,1
Collingwood,"Mayne, Chris",20,14,6,6,0,0,0,4
Collingwood,"Pendlebury, Scott",32,14,1,18,1,0,0,5
Collingwood,"Phillips, Tom",36,22,6,14,1,1,0,1
Collingwood,"Reid, Ben",11,8,8,3,0,0,0,0
Collingwood,"Scharenberg, Matt",26,11,5,15,0,0,0,4
Collingwood,"Sidebottom, Steele",24,15,5,9,1,1,0,4
Collingwood,"Stephenson, Jaidyn",11,6,4,5,1,1,0,3
Collingwood,"Thomas, Josh",14,8,2,6,2,0,0,4
Collingwood,"Treloar, Adam",40,13,2,27,2,2,0,5
Collingwood,"Varcoe, Travis",13,3,2,10,0,0,0,3
Collingwood,"de Goey, Jordan",15,9,2,6,0,1,0,4
Collingwood,"Adams, Taylor",28,13,5,15,0,0,0,5
Collingwood,"Appleby, Flynn",12,6,5,6,0,1,0,0
Collingwood,"Cox, Mason",8,4,4,4,1,0,14,1
Collingwood,"Crisp, Jack",30,15,8,15,0,0,0,5
Collingwood,"Daicos, Josh",15,7,5,8,1,0,0,5
Collingwood,"Dunn, Lynden",9,9,6,0,0,0,0,0
Collingwood,"Greenwood, Levi",13,8,4,5,0,0,0,5
Collingwood,"Grundy, Brodie",18,8,3,10,0,0,48,8
Collingwood,"Hoskin-Elliott, Will",11,11,8,0,6,0,0,1
Collingwood,"Langdon, Tom",22,11,7,11,0,0,0,0
Collingwood,"Maynard, Brayden",27,20,9,7,1,1,0,8
Collingwood,"Mayne, Chris",14,5,4,9,0,0,0,1
Collingwood,"Mihocek, Brody",12,8,5,4,4,0,0,2
Collingwood,"Pendlebury, Scott",30,14,5,16,1,0,0,3
Collingwood,"Phillips, Tom",36,23,10,13,3,0,0,0
Collingwood,"Scharenberg, Matt",23,11,8,12,0,0,0,2
Collingwood,"Sidebottom, Steele",37,16,9,21,0,1,0,4
Collingwood,"Stephenson, Jaidyn",5,3,2,2,1,0,0,4
Collingwood,"Thomas, Josh",20,12,5,8,2,2,0,5
Collingwood,"Treloar, Adam",34,17,4,17,0,1,0,4
Collingwood,"Wells, Daniel",13,7,2,6,0,1,0,2
Collingwood,"de Goey, Jordan",15,8,1,7,1,1,0,2
Collingwood,"Adams, Taylor",27,14,1,13,1,1,0,5
Collingwood,"Cox, Mason",16,12,8,4,5,1,9,1
Collingwood,"Crisp, Jack",23,12,5,11,0,0,0,6
Collingwood,"Daicos, Josh",16,10,3,6,0,0,0,3
Collingwood,"Dunn, Lynden",11,6,2,5,0,0,0,4
Collingwood,"Greenwood, Levi",6,3,1,3,0,0,0,3
Collingwood,"Grundy, Brodie",13,4,1,9,0,0,38,7
Collingwood,"Hoskin-Elliott, Will",11,10,8,1,4,0,0,1
Collingwood,"Howe, Jeremy",17,13,8,4,0,1,0,4
Collingwood,"Langdon, Tom",20,10,9,10,0,0,0,3
Collingwood,"Maynard, Brayden",16,10,1,6,0,0,0,0
Collingwood,"Mayne, Chris",19,10,6,9,0,1,0,6
Collingwood,"Mihocek, Brody",9,8,5,1,1,1,0,0
Collingwood,"Pendlebury, Scott",23,13,2,10,1,0,0,5
Collingwood,"Phillips, Tom",19,11,2,8,0,0,0,2
Collingwood,"Scharenberg, Matt",13,6,6,7,0,0,0,1
Collingwood,"Sidebottom, Steele",32,13,8,19,0,3,0,5
Collingwood,"Stephenson, Jaidyn",12,10,5,2,4,3,0,6
Collingwood,"Thomas, Josh",15,9,5,6,3,1,0,0
Collingwood,"Treloar, Adam",32,14,7,18,1,0,0,2
Collingwood,"Wells, Daniel",8,5,4,3,0,0,0,0
Collingwood,"de Goey, Jordan",30,19,3,11,0,0,0,7
Collingwood,"Adams, Taylor",24,12,5,12,0,0,0,3
Collingwood,"Appleby, Flynn",12,6,3,6,0,0,0,3
Collingwood,"Cox, Mason",9,5,4,4,1,0,6,0
Collingwood,"Crisp, Jack",22,16,8,6,0,0,0,4
Collingwood,"Daicos, Josh",16,8,3,8,0,0,0,0
Collingwood,"Dunn, Lynden",16,11,7,5,0,0,0,0
Collingwood,"Greenwood, Levi",8,6,2,2,0,2,0,1
Collingwood,"Grundy, Brodie",20,7,6,13,0,1,34,1
Collingwood,"Hoskin-Elliott, Will",13,11,6,2,3,1,0,2
Collingwood,"Howe, Jeremy",21,13,9,8,0,0,0,0
Collingwood,"Langdon, Tom",21,12,5,9,0,1,0,4
Collingwood,"Maynard, Brayden",21,12,5,9,0,0,0,3
Collingwood,"Mayne, Chris",14,5,2,9,0,0,0,2
Collingwood,"Mihocek, Brody",8,5,6,3,1,1,0,4
Collingwood,"Pendlebury, Scott",29,12,3,17,1,0,0,5
Collingwood,"Phillips, Tom",28,18,8,10,0,0,0,2
Collingwood,"Scharenberg, Matt",21,13,6,8,0,0,0,3
Collingwood,"Sidebottom, Steele",31,14,6,17,0,1,0,4
Collingwood,"Stephenson, Jaidyn",8,5,5,3,3,1,0,2
Collingwood,"Thomas, Josh",8,6,3,2,0,0,0,0
Collingwood,"Treloar, Adam",19,9,0,10,1,0,0,4
Collingwood,"de Goey, Jordan",18,13,6,5,1,1,0,4
Collingwood,"Adams, Taylor",30,18,4,12,0,1,0,2
Collingwood,"Appleby, Flynn",10,7,3,3,0,0,0,2
Collingwood,"Cox, Mason",8,5,3,3,1,0,6,1
Collingwood,"Crisp, Jack",22,12,2,10,0,0,0,4
Collingwood,"Crocker, Ben",18,12,9,6,1,1,0,2
Collingwood,"Daicos, Josh",18,8,2,10,0,0,0,5
Collingwood,"Dunn, Lynden",13,7,3,6,0,0,0,1
Collingwood,"Grundy, Brodie",23,8,3,15,0,2,49,9
Collingwood,"Hoskin-Elliott, Will",11,4,3,7,0,1,1,2
Collingwood,"Howe, Jeremy",20,13,4,7,0,0,0,2
Collingwood,"Langdon, Tom",21,10,4,11,0,0,0,1
Collingwood,"Maynard, Brayden",16,9,1,7,1,0,0,4
Collingwood,"Mayne, Chris",23,10,8,13,0,1,0,4
Collingwood,"Mihocek, Brody",15,7,4,8,1,1,0,3
Collingwood,"Pendlebury, Scott",25,10,0,15,1,0,0,7
Collingwood,"Phillips, Tom",26,16,7,10,0,1,0,2
Collingwood,"Scharenberg, Matt",20,12,9,8,0,0,0,2
Collingwood,"Sidebottom, Steele",24,11,2,13,0,1,0,5
Collingwood,"Sier, Brayden",19,10,3,9,0,0,0,6
Collingwood,"Stephenson, Jaidyn",13,9,2,4,3,2,0,2
Collingwood,"Thomas, Josh",22,9,3,13,4,2,0,3
Collingwood,"de Goey, Jordan",14,12,5,2,2,0,0,0
Collingwood,"Adams, Taylor",27,15,3,12,1,1,0,3
Collingwood,"Appleby, Flynn",12,9,4,3,0,0,0,0
Collingwood,"Cox, Mason",12,4,7,8,1,0,7,1
Collingwood,"Crisp, Jack",22,11,3,11,0,0,0,2
Collingwood,"Crocker, Ben",6,6,5,0,0,0,0,1
Collingwood,"Daicos, Josh",13,9,5,4,1,0,0,5
Collingwood,"Greenwood, Levi",11,8,2,3,0,0,0,3
Collingwood,"Grundy, Brodie",24,6,2,18,1,0,34,6
Collingwood,"Hoskin-Elliott, Will",2,2,2,0,1,0,0,0
Collingwood,"Howe, Jeremy",22,12,9,10,0,0,0,2
Collingwood,"Langdon, Tom",22,12,4,10,0,0,0,3
Collingwood,"Maynard, Brayden",22,12,3,10,0,0,0,4
Collingwood,"Mayne, Chris",17,6,3,11,0,0,0,1
Collingwood,"Mihocek, Brody",7,4,3,3,1,0,0,0
Collingwood,"Pendlebury, Scott",34,14,1,20,0,0,0,9
Collingwood,"Phillips, Tom",21,11,5,10,0,0,0,3
Collingwood,"Scharenberg, Matt",18,8,6,10,0,0,0,1
Collingwood,"Sidebottom, Steele",28,14,6,14,2,0,0,3
Collingwood,"Sier, Brayden",14,6,1,8,0,0,0,3
Collingwood,"Stephenson, Jaidyn",15,10,8,5,1,2,0,1
Collingwood,"Thomas, Josh",11,7,1,4,0,1,0,2
Collingwood,"de Goey, Jordan",20,17,5,3,3,2,0,3
Collingwood,"Adams, Taylor",28,12,2,16,0,1,0,3
Collingwood,"Crisp, Jack",21,15,6,6,0,0,0,2
Collingwood,"Crocker, Ben",8,5,4,3,0,1,0,1
Collingwood,"Daicos, Josh",11,4,3,7,0,1,0,3
Collingwood,"Greenwood, Levi",18,16,6,2,0,1,0,5
Collingwood,"Grundy, Brodie",14,3,0,11,0,0,30,4
Collingwood,"Hoskin-Elliott, Will",7,4,3,3,0,0,0,0
Collingwood,"Howe, Jeremy",24,17,11,7,0,0,0,0
Collingwood,"Langdon, Tom",15,9,6,6,0,0,0,2
Collingwood,"Maynard, Brayden",21,13,4,8,0,1,0,2
Collingwood,"Mayne, Chris",16,4,3,12,0,0,0,2
Collingwood,"Mihocek, Brody",15,13,8,2,2,3,3,2
Collingwood,"Moore, Darcy",14,8,6,6,0,0,0,2
Collingwood,"Pendlebury, Scott",25,7,3,18,0,0,0,3
Collingwood,"Phillips, Tom",27,19,7,8,0,0,0,1
Collingwood,"Scharenberg, Matt",17,9,3,8,0,0,0,0
Collingwood,"Sidebottom, Steele",18,7,0,11,0,0,0,2
Collingwood,"Sier, Brayden",13,5,2,8,0,0,0,4
Collingwood,"Stephenson, Jaidyn",11,6,6,5,0,1,0,0
Collingwood,"Thomas, Josh",12,9,5,3,3,0,0,3
Collingwood,"Varcoe, Travis",17,8,2,9,0,0,0,1
Collingwood,"de Goey, Jordan",12,11,4,1,4,1,0,0
Collingwood,"Adams, Taylor",28,20,5,8,1,0,0,10
Collingwood,"Cox, Mason",10,8,6,2,1,0,5,1
Collingwood,"Crisp, Jack",11,6,4,5,0,0,0,1
Collingwood,"Daicos, Josh",23,14,5,9,0,0,0,7
Collingwood,"Greenwood, Levi",10,6,0,4,1,0,0,0
Collingwood,"Grundy, Brodie",17,9,6,8,1,1,27,5
Collingwood,"Hoskin-Elliott, Will",14,10,7,4,3,1,0,1
Collingwood,"Howe, Jeremy",15,8,6,7,0,0,0,2
Collingwood,"Langdon, Tom",16,4,4,12,0,0,0,3
Collingwood,"Maynard, Brayden",21,13,4,8,0,0,0,7
Collingwood,"Mayne, Chris",15,9,5,6,0,0,0,2
Collingwood,"Mihocek, Brody",12,8,7,4,4,1,0,2
Collingwood,"Murray, Sam",24,16,7,8,0,0,0,0
Collingwood,"Pendlebury, Scott",30,14,4,16,0,1,0,6
Collingwood,"Phillips, Tom",22,11,5,11,1,0,0,3
Collingwood,"Scharenberg, Matt",16,10,6,6,0,0,0,2
Collingwood,"Sidebottom, Steele",24,12,6,12,0,1,0,5
Collingwood,"Sier, Brayden",13,4,1,9,0,0,0,9
Collingwood,"Stephenson, Jaidyn",11,8,3,3,3,0,0,2
Collingwood,"Thomas, Josh",24,10,5,14,1,0,0,4
Collingwood,"Varcoe, Travis",11,6,2,5,0,1,0,5
Collingwood,"de Goey, Jordan",19,13,6,6,4,1,0,6
Collingwood,"Adams, Taylor",30,12,1,18,0,0,0,7
Collingwood,"Brown, Callum",19,9,0,10,1,0,0,3
Collingwood,"Cox, Mason",11,6,6,5,2,1,2,2
Collingwood,"Crisp, Jack",22,10,1,12,0,0,0,2
Collingwood,"Daicos, Josh",15,7,4,8,1,0,0,4
Collingwood,"Greenwood, Levi",16,10,3,6,0,0,0,1
Collingwood,"Grundy, Brodie",23,4,3,19,0,0,48,10
Collingwood,"Hoskin-Elliott, Will",10,5,5,5,3,0,0,3
Collingwood,"Howe, Jeremy",4,3,2,1,0,0,0,0
Collingwood,"Langdon, Tom",22,14,5,8,0,0,0,7
Collingwood,"Maynard, Brayden",18,8,2,10,0,0,0,7
Collingwood,"Mayne, Chris",15,9,5,6,0,1,0,2
Collingwood,"Mihocek, Brody",8,5,3,3,1,0,0,2
Collingwood,"Moore, Darcy",12,6,5,6,0,0,0,1
Collingwood,"Murray, Sam",19,13,5,6,0,0,0,0
Collingwood,"Pendlebury, Scott",37,15,2,22,0,1,0,7
Collingwood,"Phillips, Tom",33,16,10,17,0,0,0,4
Collingwood,"Scharenberg, Matt",11,5,6,6,0,0,0,1
Collingwood,"Sidebottom, Steele",38,17,5,21,0,0,0,3
Collingwood,"Stephenson, Jaidyn",9,7,1,2,0,2,0,3
Collingwood,"Thomas, Josh",16,10,4,6,4,0,0,3
Collingwood,"Varcoe, Travis",11,8,4,3,0,0,0,0
Collingwood,"Adams, Taylor",32,18,3,14,0,1,0,11
Collingwood,"Brown, Callum",5,3,2,2,0,0,0,10
Collingwood,"Cox, Mason",11,7,5,4,1,3,6,1
Collingwood,"Crisp, Jack",29,17,4,12,0,0,0,5
Collingwood,"Daicos, Josh",12,9,0,3,1,0,0,4
Collingwood,"Greenwood, Levi",15,11,6,4,0,0,0,2
Collingwood,"Grundy, Brodie",24,15,3,9,1,2,57,4
Collingwood,"Hoskin-Elliott, Will",8,6,1,2,2,0,0,0
Collingwood,"Langdon, Tom",26,12,8,14,0,0,0,1
Collingwood,"Madgen, Jack",13,5,1,8,0,0,0,2
Collingwood,"Maynard, Brayden",20,12,4,8,0,0,0,3
Collingwood,"Mayne, Chris",21,10,7,11,0,2,0,2
Collingwood,"Mihocek, Brody",10,9,6,1,0,0,0,1
Collingwood,"Moore, Darcy",6,3,3,3,0,0,0,0
Collingwood,"Murray, Sam",18,17,2,1,0,0,0,0
Collingwood,"Pendlebury, Scott",22,8,0,14,0,0,0,6
Collingwood,"Phillips, Tom",23,10,4,13,0,1,0,2
Collingwood,"Sidebottom, Steele",18,8,1,10,1,0,0,4
Collingwood,"Sier, Brayden",23,11,1,12,0,0,0,7
Collingwood,"Stephenson, Jaidyn",9,7,4,2,0,1,0,8
Collingwood,"Thomas, Josh",18,3,3,15,0,0,0,3
Collingwood,"Varcoe, Travis",11,7,3,4,4,0,0,2
Collingwood,"Adams, Taylor",33,16,2,17,0,1,0,2
Collingwood,"Aish, James",23,14,5,9,0,0,0,3
Collingwood,"Cox, Mason",8,5,4,3,0,1,2,1
Collingwood,"Crisp, Jack",26,14,8,12,0,1,0,4
Collingwood,"Greenwood, Levi",15,11,1,4,0,2,0,8
Collingwood,"Grundy, Brodie",13,7,2,6,0,1,35,3
Collingwood,"Hoskin-Elliott, Will",9,7,5,2,0,0,0,1
Collingwood,"Langdon, Tom",15,8,6,7,0,0,0,2
Collingwood,"Madgen, Jack",16,8,4,8,0,0,0,3
Collingwood,"Maynard, Brayden",16,6,3,10,0,0,0,1
Collingwood,"Mayne, Chris",15,7,5,8,2,1,0,2
Collingwood,"Mihocek, Brody",10,8,5,2,3,1,0,2
Collingwood,"Murray, Sam",21,12,4,9,0,0,0,1
Collingwood,"Oxley, Adam",11,5,3,6,0,1,0,3
Collingwood,"Pendlebury, Scott",28,13,1,15,0,0,0,1
Collingwood,"Phillips, Tom",22,13,7,9,0,1,0,0
Collingwood,"Sidebottom, Steele",28,13,5,15,0,1,0,3
Collingwood,"Sier, Brayden",27,12,2,15,1,0,0,5
Collingwood,"Stephenson, Jaidyn",25,19,8,6,2,0,0,2
Collingwood,"Thomas, Josh",12,7,2,5,1,1,0,4
Collingwood,"Varcoe, Travis",11,5,1,6,1,0,0,6
Collingwood,"de Goey, Jordan",12,9,4,3,4,3,0,1
Collingwood,"Adams, Taylor",30,15,5,15,1,1,0,7
Collingwood,"Aish, James",17,11,3,6,0,0,0,4
Collingwood,"Cox, Mason",11,10,8,1,1,1,11,2
Collingwood,"Crisp, Jack",24,6,3,18,0,0,0,3
Collingwood,"Greenwood, Levi",14,10,5,4,0,0,0,3
Collingwood,"Grundy, Brodie",25,9,2,16,1,0,42,9
Collingwood,"Hoskin-Elliott, Will",13,6,3,7,0,1,0,4
Collingwood,"Langdon, Tom",18,5,3,13,0,0,0,1
Collingwood,"Madgen, Jack",17,7,2,10,0,0,0,0
Collingwood,"Maynard, Brayden",23,13,2,10,0,0,0,7
Collingwood,"Mayne, Chris",27,12,7,15,1,0,0,5
Collingwood,"Mihocek, Brody",13,8,2,5,2,2,0,4
Collingwood,"Murphy, Nathan",14,7,2,7,0,0,0,2
Collingwood,"Oxley, Adam",12,10,4,2,1,0,0,6
Collingwood,"Pendlebury, Scott",26,9,0,17,0,0,0,7
Collingwood,"Phillips, Tom",20,13,3,7,2,0,0,0
Collingwood,"Sidebottom, Steele",33,13,4,20,1,0,0,5
Collingwood,"Sier, Brayden",16,11,1,5,1,0,0,7
Collingwood,"Stephenson, Jaidyn",9,8,3,1,2,2,0,1
Collingwood,"Thomas, Josh",11,5,3,6,1,0,0,3
Collingwood,"Varcoe, Travis",12,6,2,6,1,0,0,2
Collingwood,"de Goey, Jordan",14,10,6,4,2,2,0,1
Collingwood,"Adams, Taylor",26,17,3,9,1,1,0,3
Collingwood,"Aish, James",16,7,0,9,0,1,0,5
Collingwood,"Cox, Mason",13,10,6,3,1,0,6,2
Collingwood,"Crisp, Jack",20,11,3,9,1,0,0,6
Collingwood,"Greenwood, Levi",12,8,1,4,0,0,0,6
Collingwood,"Grundy, Brodie",24,11,6,13,0,0,34,4
Collingwood,"Hoskin-Elliott, Will",11,6,4,5,0,0,0,2
Collingwood,"Langdon, Tom",13,8,3,5,0,0,0,2
Collingwood,"Madgen, Jack",14,7,4,7,0,0,0,1
Collingwood,"Maynard, Brayden",17,11,3,6,0,0,0,6
Collingwood,"Mayne, Chris",9,6,3,3,0,1,0,1
Collingwood,"Mihocek, Brody",15,8,6,7,3,2,0,3
Collingwood,"Murphy, Nathan",9,6,3,3,0,0,0,1
Collingwood,"Oxley, Adam",11,6,2,5,0,0,0,2
Collingwood,"Pendlebury, Scott",30,16,4,14,1,0,0,5
Collingwood,"Phillips, Tom",20,15,2,5,1,0,0,5
Collingwood,"Sidebottom, Steele",32,20,7,12,0,1,0,4
Collingwood,"Sier, Brayden",23,7,2,16,0,0,0,5
Collingwood,"Stephenson, Jaidyn",8,6,3,2,2,1,0,3
Collingwood,"Thomas, Josh",17,11,4,6,1,0,0,3
Collingwood,"Varcoe, Travis",13,6,1,7,0,0,0,3
Collingwood,"de Goey, Jordan",19,16,5,3,0,1,0,1
Collingwood,"Adams, Taylor",26,18,4,8,2,0,0,7
Collingwood,"Aish, James",21,12,3,9,0,0,0,2
Collingwood,"Cox, Mason",5,4,2,1,0,0,1,0
Collingwood,"Crisp, Jack",21,13,4,8,0,0,0,3
Collingwood,"Goldsack, Tyson",6,1,0,5,0,0,0,1
Collingwood,"Greenwood, Levi",13,10,3,3,0,0,0,0
Collingwood,"Grundy, Brodie",18,7,2,11,0,0,48,3
Collingwood,"Hoskin-Elliott, Will",15,10,6,5,0,2,0,4
Collingwood,"Howe, Jeremy",16,10,6,6,0,0,0,2
Collingwood,"Langdon, Tom",12,3,2,9,0,0,0,3
Collingwood,"Maynard, Brayden",17,14,2,3,0,0,0,1
Collingwood,"Mayne, Chris",11,6,3,5,1,0,0,8
Collingwood,"Mihocek, Brody",13,11,6,2,2,3,0,2
Collingwood,"Pendlebury, Scott",17,8,3,9,0,1,0,5
Collingwood,"Phillips, Tom",26,17,8,9,0,0,0,3
Collingwood,"Sidebottom, Steele",27,17,5,10,0,0,0,2
Collingwood,"Sier, Brayden",26,8,1,18,0,0,0,2
Collingwood,"Stephenson, Jaidyn",15,9,5,6,1,1,0,2
Collingwood,"Thomas, Josh",21,10,1,11,1,0,0,4
Collingwood,"Treloar, Adam",24,12,0,12,0,0,0,1
Collingwood,"Varcoe, Travis",9,7,2,2,1,0,0,6
Collingwood,"de Goey, Jordan",11,5,3,6,2,1,0,3
Collingwood,"Adams, Taylor",24,15,3,9,0,0,0,10
Collingwood,"Aish, James",19,12,7,7,0,1,0,3
Collingwood,"Cox, Mason",11,7,3,4,0,0,6,5
Collingwood,"Crisp, Jack",14,7,4,7,0,0,0,0
Collingwood,"Goldsack, Tyson",7,4,2,3,0,0,0,2
Collingwood,"Greenwood, Levi",18,12,3,6,0,0,0,2
Collingwood,"Grundy, Brodie",18,10,2,8,0,0,38,5
Collingwood,"Hoskin-Elliott, Will",19,12,10,7,2,0,0,3
Collingwood,"Howe, Jeremy",23,14,4,9,0,0,0,1
Collingwood,"Langdon, Tom",21,9,10,12,0,0,0,2
Collingwood,"Maynard, Brayden",16,10,5,6,0,0,0,1
Collingwood,"Mayne, Chris",19,9,7,10,0,0,0,4
Collingwood,"Mihocek, Brody",9,7,3,2,1,1,0,2
Collingwood,"Pendlebury, Scott",25,12,1,13,0,0,0,11
Collingwood,"Phillips, Tom",29,23,5,6,0,2,0,2
Collingwood,"Sidebottom, Steele",31,20,6,11,0,0,0,3
Collingwood,"Sier, Brayden",19,7,1,12,0,0,0,0
Collingwood,"Stephenson, Jaidyn",10,7,2,3,0,3,0,3
Collingwood,"Thomas, Josh",15,9,4,6,2,1,0,3
Collingwood,"Treloar, Adam",29,11,4,18,0,2,0,5
Collingwood,"Varcoe, Travis",9,4,1,5,1,0,0,3
Collingwood,"de Goey, Jordan",14,11,8,3,3,2,0,0
Collingwood,"Adams, Taylor",36,17,2,19,0,0,0,5
Collingwood,"Aish, James",11,10,4,1,0,0,0,2
Collingwood,"Cox, Mason",15,13,11,2,3,1,4,2
Collingwood,"Crisp, Jack",30,18,8,12,2,0,0,2
Collingwood,"Goldsack, Tyson",8,5,3,3,0,1,0,3
Collingwood,"Greenwood, Levi",16,14,3,2,0,0,0,10
Collingwood,"Grundy, Brodie",21,10,4,11,1,0,56,4
Collingwood,"Hoskin-Elliott, Will",11,3,3,8,0,0,0,2
Collingwood,"Howe, Jeremy",13,9,5,4,0,0,0,1
Collingwood,"Langdon, Tom",24,16,13,8,0,0,0,2
Collingwood,"Maynard, Brayden",18,12,5,6,0,0,0,4
Collingwood,"Mayne, Chris",20,10,6,10,0,0,0,9
Collingwood,"Mihocek, Brody",14,8,4,6,2,1,0,2
Collingwood,"Pendlebury, Scott",24,9,0,15,0,0,0,4
Collingwood,"Phillips, Tom",20,16,1,4,0,0,0,6
Collingwood,"Sidebottom, Steele",41,21,13,20,0,0,0,2
Collingwood,"Sier, Brayden",20,7,3,13,0,0,0,3
Collingwood,"Stephenson, Jaidyn",14,7,5,7,1,0,0,2
Collingwood,"Thomas, Josh",14,8,3,6,0,0,0,2
Collingwood,"Treloar, Adam",19,8,2,11,1,1,0,3
Collingwood,"Varcoe, Travis",10,6,5,4,1,0,0,2
Collingwood,"de Goey, Jordan",10,8,4,2,4,2,0,0
Collingwood,"Adams, Taylor",31,22,4,9,1,0,0,5
Collingwood,"Aish, James",7,5,2,2,0,0,0,5
Collingwood,"Cox, Mason",9,9,7,0,2,0,8,4
Collingwood,"Crisp, Jack",25,18,9,7,0,0,0,2
Collingwood,"Goldsack, Tyson",9,1,0,8,0,0,0,3
Collingwood,"Greenwood, Levi",8,4,1,4,0,0,0,5
Collingwood,"Grundy, Brodie",10,5,4,5,0,0,49,6
Collingwood,"Hoskin-Elliott, Will",18,13,5,5,1,1,0,0
Collingwood,"Howe, Jeremy",13,12,6,1,0,0,0,5
Collingwood,"Langdon, Tom",23,10,7,13,0,0,0,1
Collingwood,"Maynard, Brayden",9,7,2,2,0,0,0,7
Collingwood,"Mayne, Chris",15,7,4,8,0,0,0,14
Collingwood,"Mihocek, Brody",15,10,6,5,1,1,0,2
Collingwood,"Pendlebury, Scott",20,9,1,11,0,0,0,3
Collingwood,"Phillips, Tom",21,15,4,6,0,0,0,5
Collingwood,"Sidebottom, Steele",14,7,4,7,0,0,0,5
Collingwood,"Sier, Brayden",21,9,0,12,0,0,0,4
Collingwood,"Stephenson, Jaidyn",9,6,2,3,2,0,0,3
Collingwood,"Thomas, Josh",13,6,1,7,0,2,0,5
Collingwood,"Treloar, Adam",26,12,3,14,0,0,0,11
Collingwood,"Varcoe, Travis",11,8,2,3,1,1,0,9
Collingwood,"de Goey, Jordan",13,12,5,1,3,1,0,0
Essendon,"Begley, Josh",11,7,1,4,1,2,0,5
Essendon,"Bellchambers, Tom",9,5,3,4,1,0,33,1
Essendon,"Brown, Mitch",13,8,8,5,0,0,0,0
Essendon,"Daniher, Joe",15,9,7,6,2,1,0,1
Essendon,"Dea, Matt",11,2,1,9,0,0,0,0
Essendon,"Goddard, Brendon",29,15,6,14,1,1,0,3
Essendon,"Green, Josh",11,10,1,1,2,2,0,2
Essendon,"Hartley, Michael",9,8,5,1,0,0,0,2
Essendon,"Heppell, Dyson",35,21,13,14,0,0,0,5
Essendon,"Hooker, Cale",15,8,9,7,3,1,0,3
Essendon,"Hurley, Michael",28,15,7,13,0,0,0,1
Essendon,"Langford, Kyle",23,11,3,12,0,0,0,2
Essendon,"McDonald-Tipungwuti, Anthony",14,9,6,5,0,1,0,5
Essendon,"McGrath, Andrew",26,9,3,17,1,0,0,4
Essendon,"McKenna, Conor",14,8,1,6,0,0,0,5
Essendon,"Merrett, Zach",7,3,0,4,0,0,0,1
Essendon,"Parish, Darcy",19,11,0,8,0,2,0,7
Essendon,"Saad, Adam",12,3,2,9,0,0,0,2
Essendon,"Smith, Devon",23,14,3,9,0,1,0,5
Essendon,"Stewart, James",16,10,7,6,3,2,6,4
Essendon,"Stringer, Jake",16,6,2,10,0,1,0,7
Essendon,"Zaharakis, David",35,22,4,13,0,0,0,4
Essendon,"Begley, Josh",12,5,3,7,2,1,0,2
Essendon,"Bellchambers, Tom",11,6,2,5,2,0,16,3
Essendon,"Brown, Mitch",16,8,6,8,0,0,0,3
Essendon,"Daniher, Joe",14,9,3,5,0,1,2,2
Essendon,"Dea, Matt",15,7,5,8,0,0,0,1
Essendon,"Goddard, Brendon",21,10,6,11,0,0,0,0
Essendon,"Green, Josh",12,9,2,3,2,1,0,4
Essendon,"Hartley, Michael",11,7,3,4,0,0,0,1
Essendon,"Heppell, Dyson",24,12,5,12,1,0,0,7
Essendon,"Hooker, Cale",12,7,4,5,1,1,0,2
Essendon,"Hurley, Michael",25,18,8,7,0,0,0,0
Essendon,"Langford, Kyle",15,11,2,4,1,0,0,3
Essendon,"McDonald-Tipungwuti, Anthony",7,5,1,2,1,0,0,1
Essendon,"McGrath, Andrew",16,7,0,9,0,0,0,3
Essendon,"McKenna, Conor",24,10,3,14,1,0,0,2
Essendon,"Merrett, Zach",21,10,0,11,0,0,0,6
Essendon,"Parish, Darcy",22,8,5,14,0,0,0,3
Essendon,"Saad, Adam",16,6,2,10,0,0,0,2
Essendon,"Smith, Devon",20,11,2,9,1,0,0,13
Essendon,"Stewart, James",12,8,6,4,2,1,0,0
Essendon,"Stringer, Jake",9,4,1,5,0,0,0,5
Essendon,"Zaharakis, David",24,14,2,10,0,0,0,9
Essendon,"Baguley, Mark",9,3,1,6,0,0,0,6
Essendon,"Begley, Josh",13,9,6,4,0,0,0,2
Essendon,"Bellchambers, Tom",10,7,3,3,0,0,33,0
Essendon,"Brown, Mitch",7,4,2,3,0,0,0,0
Essendon,"Daniher, Joe",12,9,6,3,2,2,3,1
Essendon,"Fantasia, Orazio",15,9,2,6,0,2,0,3
Essendon,"Goddard, Brendon",18,6,7,12,0,0,0,2
Essendon,"Green, Josh",14,9,2,5,2,0,0,3
Essendon,"Heppell, Dyson",21,16,5,5,0,0,0,3
Essendon,"Hooker, Cale",12,5,7,7,1,1,0,0
Essendon,"Hurley, Michael",21,15,4,6,0,0,0,0
Essendon,"McDonald-Tipungwuti, Anthony",12,6,2,6,1,1,0,4
Essendon,"McGrath, Andrew",20,11,5,9,0,0,0,3
Essendon,"McKenna, Conor",15,9,5,6,0,1,0,2
Essendon,"Merrett, Zach",13,10,3,3,1,1,0,3
Essendon,"Myers, David",16,9,2,7,0,0,0,2
Essendon,"Parish, Darcy",14,9,2,5,1,0,0,1
Essendon,"Saad, Adam",12,4,2,8,0,0,0,0
Essendon,"Smith, Devon",20,11,2,9,1,0,0,2
Essendon,"Stewart, James",7,6,5,1,2,0,2,1
Essendon,"Stringer, Jake",16,6,3,10,1,0,0,2
Essendon,"Zaharakis, David",26,13,4,13,0,0,0,3
Essendon,"Baguley, Mark",12,8,5,4,1,1,0,1
Essendon,"Begley, Josh",9,3,1,6,0,0,0,0
Essendon,"Bellchambers, Tom",15,7,3,8,0,0,45,1
Essendon,"Daniher, Joe",12,9,4,3,2,1,1,1
Essendon,"Fantasia, Orazio",11,7,2,4,1,1,0,6
Essendon,"Goddard, Brendon",28,17,6,11,1,0,0,1
Essendon,"Green, Josh",12,9,3,3,1,1,0,4
Essendon,"Guelfi, Matt",17,11,3,6,0,1,0,2
Essendon,"Hartley, Michael",14,8,5,6,0,0,0,2
Essendon,"Heppell, Dyson",31,14,6,17,0,0,0,7
Essendon,"Hooker, Cale",23,9,8,14,0,0,0,2
Essendon,"Hurley, Michael",29,24,15,5,0,0,0,1
Essendon,"McDonald-Tipungwuti, Anthony",11,7,5,4,1,0,0,4
Essendon,"McGrath, Andrew",15,8,2,7,0,0,0,2
Essendon,"Merrett, Zach",29,18,5,11,0,0,0,8
Essendon,"Myers, David",24,15,3,9,2,0,0,3
Essendon,"Parish, Darcy",19,11,4,8,0,1,0,3
Essendon,"Saad, Adam",9,3,3,6,0,0,0,3
Essendon,"Smith, Devon",17,9,0,8,0,1,0,11
Essendon,"Stewart, James",9,7,4,2,3,1,0,0
Essendon,"Stringer, Jake",13,11,3,2,4,1,0,1
Essendon,"Zaharakis, David",28,12,6,16,0,0,0,1
Essendon,"Baguley, Mark",15,6,7,9,0,0,0,1
Essendon,"Begley, Josh",2,1,0,1,0,0,0,0
Essendon,"Bellchambers, Tom",13,6,5,7,0,0,20,0
Essendon,"Daniher, Joe",22,19,10,3,1,1,1,3
Essendon,"Goddard, Brendon",33,16,9,17,0,0,0,5
Essendon,"Green, Josh",2,0,0,2,0,0,0,0
Essendon,"Guelfi, Matt",15,9,9,6,0,1,0,2
Essendon,"Hartley, Michael",16,12,8,4,0,0,0,1
Essendon,"Heppell, Dyson",27,17,7,10,1,0,0,2
Essendon,"Hooker, Cale",18,9,8,9,1,1,0,1
Essendon,"Hurley, Michael",29,17,10,12,0,0,0,1
Essendon,"McDonald-Tipungwuti, Anthony",14,8,6,6,1,0,0,1
Essendon,"McGrath, Andrew",10,5,5,5,0,0,0,2
Essendon,"Merrett, Jackson",15,9,7,6,0,0,0,3
Essendon,"Merrett, Zach",33,14,4,19,0,1,0,4
Essendon,"Myers, David",20,9,4,11,0,0,0,4
Essendon,"Parish, Darcy",28,9,2,19,0,0,0,4
Essendon,"Saad, Adam",23,12,2,11,0,1,0,3
Essendon,"Smith, Devon",20,13,4,7,0,0,0,6
Essendon,"Stewart, James",11,8,8,3,1,1,2,0
Essendon,"Stringer, Jake",13,10,6,3,2,1,0,3
Essendon,"Zaharakis, David",34,16,6,18,0,2,0,2
Essendon,"Ambrose, Patrick",15,5,3,10,0,0,0,2
Essendon,"Baguley, Mark",9,5,3,4,0,0,0,5
Essendon,"Daniher, Joe",11,10,5,1,0,3,1,1
Essendon,"Goddard, Brendon",24,6,8,18,0,1,0,6
Essendon,"Guelfi, Matt",19,9,4,10,0,0,0,3
Essendon,"Heppell, Dyson",18,11,2,7,0,0,0,6
Essendon,"Hooker, Cale",20,3,3,17,0,0,0,1
Essendon,"Hurley, Michael",26,20,7,6,0,0,0,0
Essendon,"Laverde, Jayden",21,12,10,9,1,1,0,2
Essendon,"Leuenberger, Matthew",19,9,0,10,0,0,23,3
Essendon,"McDonald-Tipungwuti, Anthony",13,8,2,5,2,2,0,2
Essendon,"McGrath, Andrew",26,12,5,14,0,0,0,2
Essendon,"McNiece, Ben",16,7,3,9,0,0,0,3
Essendon,"Merrett, Jackson",8,3,0,5,0,0,0,1
Essendon,"Merrett, Zach",29,15,2,14,0,0,0,10
Essendon,"Mutch, Kobe",20,12,6,8,0,0,0,1
Essendon,"Parish, Darcy",20,10,4,10,0,0,0,7
Essendon,"Saad, Adam",14,7,3,7,0,0,0,5
Essendon,"Smith, Devon",22,12,2,10,2,1,0,6
Essendon,"Stewart, James",14,8,1,6,1,1,2,3
Essendon,"Stringer, Jake",9,8,5,1,3,3,0,2
Essendon,"Zaharakis, David",28,12,3,16,1,0,0,7
Essendon,"Ambrose, Patrick",12,7,1,5,1,0,0,2
Essendon,"Baguley, Mark",13,5,7,8,1,0,0,3
Essendon,"Bellchambers, Tom",20,12,8,8,1,0,32,0
Essendon,"Daniher, Joe",11,8,4,3,1,0,1,0
Essendon,"Goddard, Brendon",27,13,6,14,0,0,0,0
Essendon,"Heppell, Dyson",28,13,6,15,1,0,0,5
Essendon,"Hooker, Cale",22,10,4,12,1,0,0,0
Essendon,"Hurley, Michael",27,11,5,16,0,0,0,2
Essendon,"Laverde, Jayden",7,3,3,4,0,1,0,4
Essendon,"McDonald-Tipungwuti, Anthony",7,3,2,4,1,0,0,2
Essendon,"McGrath, Andrew",27,8,3,19,0,0,0,2
Essendon,"McKenna, Conor",19,9,2,10,0,0,0,2
Essendon,"McNiece, Ben",11,7,4,4,0,0,0,4
Essendon,"Merrett, Zach",17,12,1,5,0,0,0,3
Essendon,"Mutch, Kobe",17,9,4,8,1,0,0,1
Essendon,"Myers, David",19,6,3,13,0,0,0,3
Essendon,"Parish, Darcy",15,5,1,10,1,0,0,1
Essendon,"Saad, Adam",14,6,1,8,0,0,0,1
Essendon,"Smith, Devon",21,11,4,10,0,1,0,7
Essendon,"Stewart, James",20,10,7,10,1,3,2,0
Essendon,"Stringer, Jake",11,4,2,7,0,0,0,1
Essendon,"Zaharakis, David",25,13,6,12,0,0,0,2
Essendon,"Ambrose, Patrick",8,7,3,1,1,0,0,9
Essendon,"Baguley, Mark",14,5,5,9,0,0,0,5
Essendon,"Bellchambers, Tom",9,6,1,3,0,1,55,3
Essendon,"Fantasia, Orazio",18,8,4,10,2,2,0,5
Essendon,"Goddard, Brendon",16,6,2,10,0,0,0,0
Essendon,"Heppell, Dyson",27,14,5,13,1,0,0,1
Essendon,"Hooker, Cale",23,14,8,9,0,1,0,3
Essendon,"Hurley, Michael",17,10,3,7,0,0,0,1
Essendon,"Laverde, Jayden",9,5,2,4,0,1,0,0
Essendon,"McDonald-Tipungwuti, Anthony",9,5,3,4,1,1,0,7
Essendon,"McKenna, Conor",19,19,3,0,1,0,0,3
Essendon,"McKernan, Shaun",16,11,8,5,2,2,8,4
Essendon,"McNiece, Ben",10,7,2,3,0,0,0,4
Essendon,"Merrett, Zach",16,9,1,7,1,1,0,8
Essendon,"Mutch, Kobe",11,8,4,3,0,0,0,1
Essendon,"Myers, David",20,12,3,8,0,0,0,7
Essendon,"Parish, Darcy",13,4,2,9,0,2,0,3
Essendon,"Saad, Adam",18,9,1,9,0,0,0,3
Essendon,"Smith, Devon",21,11,2,10,0,0,0,15
Essendon,"Stewart, James",11,5,3,6,0,1,0,2
Essendon,"Stringer, Jake",14,11,2,3,0,1,0,1
Essendon,"Zaharakis, David",25,15,7,10,1,0,0,6
Essendon,"Ambrose, Patrick",15,10,8,5,0,0,0,1
Essendon,"Baguley, Mark",16,11,6,5,1,0,0,7
Essendon,"Bellchambers, Tom",8,6,2,2,0,1,24,0
Essendon,"Clarke, Dylan",9,5,1,4,0,0,0,5
Essendon,"Dea, Matt",15,10,8,5,0,0,0,3
Essendon,"Fantasia, Orazio",18,8,7,10,2,0,0,8
Essendon,"Goddard, Brendon",24,16,10,8,0,0,0,1
Essendon,"Guelfi, Matt",14,10,5,4,1,0,0,3
Essendon,"Heppell, Dyson",28,16,6,12,1,0,0,4
Essendon,"Hooker, Cale",21,10,11,11,0,0,0,2
Essendon,"Langford, Kyle",16,11,5,5,0,0,0,8
Essendon,"Laverde, Jayden",8,6,2,2,0,0,0,3
Essendon,"McDonald-Tipungwuti, Anthony",15,11,4,4,0,1,0,6
Essendon,"McKenna, Conor",18,15,2,3,1,2,0,2
Essendon,"McKernan, Shaun",16,13,6,3,4,4,11,1
Essendon,"Merrett, Zach",32,16,1,16,0,0,0,6
Essendon,"Ridley, Jordan",25,16,7,9,0,0,0,0
Essendon,"Saad, Adam",18,9,5,9,0,0,0,4
Essendon,"Smith, Devon",18,11,4,7,0,2,0,10
Essendon,"Stewart, James",16,9,7,7,1,1,2,4
Essendon,"Stringer, Jake",19,12,5,7,1,0,0,7
Essendon,"Zaharakis, David",33,18,8,15,0,0,0,6
Essendon,"Ambrose, Patrick",4,3,2,1,0,0,0,0
Essendon,"Baguley, Mark",13,11,4,2,3,1,0,7
Essendon,"Bellchambers, Tom",3,3,1,0,0,0,45,2
Essendon,"Dea, Matt",8,4,2,4,0,0,0,1
Essendon,"Fantasia, Orazio",15,10,2,5,1,1,0,6
Essendon,"Goddard, Brendon",21,13,8,8,1,0,0,3
Essendon,"Guelfi, Matt",21,16,4,5,0,0,0,5
Essendon,"Heppell, Dyson",28,20,3,8,0,1,0,5
Essendon,"Hooker, Cale",11,2,2,9,0,0,0,0
Essendon,"Langford, Kyle",17,8,1,9,1,0,0,6
Essendon,"Laverde, Jayden",17,9,3,8,0,0,0,1
Essendon,"McDonald-Tipungwuti, Anthony",7,4,3,3,0,0,0,6
Essendon,"McGrath, Andrew",18,13,2,5,1,0,0,3
Essendon,"McKenna, Conor",20,16,5,4,0,0,0,1
Essendon,"McKernan, Shaun",12,7,3,5,1,1,15,2
Essendon,"Merrett, Zach",24,11,3,13,0,0,0,8
Essendon,"Ridley, Jordan",9,7,4,2,0,0,0,3
Essendon,"Saad, Adam",22,16,4,6,0,0,0,3
Essendon,"Smith, Devon",21,13,2,8,1,0,0,13
Essendon,"Stewart, James",11,5,3,6,1,0,0,3
Essendon,"Stringer, Jake",16,11,1,5,3,2,0,2
Essendon,"Zaharakis, David",33,27,7,6,1,2,0,5
Essendon,"Baguley, Mark",9,6,6,3,0,0,0,4
Essendon,"Bellchambers, Tom",17,11,5,6,0,0,39,2
Essendon,"Dea, Matt",19,13,7,6,0,0,0,1
Essendon,"Fantasia, Orazio",8,3,0,5,1,0,0,7
Essendon,"Goddard, Brendon",22,10,5,12,0,0,0,3
Essendon,"Guelfi, Matt",16,11,4,5,0,1,0,4
Essendon,"Heppell, Dyson",22,14,4,8,0,0,0,4
Essendon,"Hooker, Cale",16,8,7,8,0,0,0,1
Essendon,"Hurley, Michael",21,14,4,7,0,0,0,0
Essendon,"Langford, Kyle",20,10,4,10,0,0,0,5
Essendon,"Laverde, Jayden",12,9,4,3,1,0,0,5
Essendon,"McDonald-Tipungwuti, Anthony",10,8,4,2,2,2,0,4
Essendon,"McGrath, Andrew",15,7,4,8,0,0,0,5
Essendon,"McKenna, Conor",18,10,2,8,0,0,0,0
Essendon,"McKernan, Shaun",13,10,7,3,0,0,9,3
Essendon,"Merrett, Zach",25,13,4,12,1,0,0,5
Essendon,"Ridley, Jordan",7,6,3,1,0,0,0,1
Essendon,"Saad, Adam",22,10,3,12,0,0,0,3
Essendon,"Smith, Devon",26,19,9,7,1,0,0,6
Essendon,"Stewart, James",11,7,4,4,0,2,0,0
Essendon,"Stringer, Jake",29,15,5,14,0,1,0,1
Essendon,"Zaharakis, David",3,3,1,0,0,0,0,0
Essendon,"Baguley, Mark",9,6,5,3,0,0,0,3
Essendon,"Bellchambers, Tom",8,4,0,4,0,0,21,2
Essendon,"Brown, Mitch",13,10,5,3,2,2,0,2
Essendon,"Dea, Matt",10,5,4,5,0,0,0,0
Essendon,"Fantasia, Orazio",12,6,4,6,0,1,0,6
Essendon,"Goddard, Brendon",20,7,4,13,0,0,0,0
Essendon,"Green, Josh",12,4,2,8,1,1,0,2
Essendon,"Guelfi, Matt",17,9,2,8,1,0,0,3
Essendon,"Heppell, Dyson",9,5,1,4,2,0,0,1
Essendon,"Hooker, Cale",20,15,11,5,0,0,0,1
Essendon,"Hurley, Michael",17,14,11,3,0,0,0,4
Essendon,"Langford, Kyle",18,7,1,11,0,0,0,6
Essendon,"McDonald-Tipungwuti, Anthony",12,6,3,6,2,1,0,5
Essendon,"McGrath, Andrew",22,9,5,13,0,0,0,2
Essendon,"McKenna, Conor",14,9,2,5,0,0,0,1
Essendon,"McKernan, Shaun",12,9,3,3,1,1,6,3
Essendon,"Merrett, Zach",29,13,7,16,0,0,0,8
Essendon,"Myers, David",28,16,6,12,0,1,0,3
Essendon,"Redman, Mason",24,14,7,10,0,0,0,3
Essendon,"Saad, Adam",24,13,5,11,0,0,0,5
Essendon,"Smith, Devon",20,13,6,7,0,1,0,6
Essendon,"Stringer, Jake",22,17,8,5,3,1,0,9
Essendon,"Baguley, Mark",13,8,7,5,1,0,0,3
Essendon,"Bellchambers, Tom",13,9,7,4,1,1,22,2
Essendon,"Brown, Mitch",12,10,9,2,1,0,0,2
Essendon,"Dea, Matt",15,12,8,3,0,0,0,2
Essendon,"Fantasia, Orazio",14,8,2,6,0,0,0,3
Essendon,"Goddard, Brendon",26,13,7,13,0,0,0,4
Essendon,"Green, Josh",4,3,2,1,0,1,0,3
Essendon,"Guelfi, Matt",13,8,1,5,1,0,0,6
Essendon,"Heppell, Dyson",27,15,11,12,0,0,0,2
Essendon,"Hooker, Cale",20,14,9,6,0,0,0,2
Essendon,"Hurley, Michael",22,18,11,4,0,0,0,0
Essendon,"Langford, Kyle",24,15,6,9,1,1,0,2
Essendon,"McDonald-Tipungwuti, Anthony",16,10,2,6,1,0,0,6
Essendon,"McGrath, Andrew",24,12,7,12,0,0,0,1
Essendon,"McKenna, Conor",15,12,3,3,0,0,0,4
Essendon,"McKernan, Shaun",8,6,4,2,0,0,8,3
Essendon,"Merrett, Zach",30,14,3,16,0,1,0,4
Essendon,"Myers, David",19,10,3,9,0,0,0,4
Essendon,"Redman, Mason",17,11,8,6,0,0,0,1
Essendon,"Saad, Adam",26,11,4,15,0,0,0,0
Essendon,"Smith, Devon",23,14,3,9,3,0,0,6
Essendon,"Stringer, Jake",11,8,4,3,3,2,0,1
Essendon,"Ambrose, Patrick",8,3,2,5,0,0,0,4
Essendon,"Baguley, Mark",8,4,2,4,1,0,0,5
Essendon,"Bellchambers, Tom",9,5,4,4,1,0,28,2
Essendon,"Brown, Mitch",17,7,5,10,0,0,0,1
Essendon,"Colyer, Travis",15,9,5,6,0,0,0,1
Essendon,"Dea, Matt",16,7,4,9,0,0,0,1
Essendon,"Fantasia, Orazio",17,9,5,8,4,1,0,5
Essendon,"Goddard, Brendon",24,11,9,13,0,0,0,3
Essendon,"Guelfi, Matt",14,6,1,8,0,3,0,2
Essendon,"Heppell, Dyson",34,19,5,15,0,0,0,4
Essendon,"Hooker, Cale",15,7,7,8,0,0,0,0
Essendon,"Hurley, Michael",25,20,9,5,0,0,0,0
Essendon,"Langford, Kyle",22,13,5,9,0,2,0,7
Essendon,"McDonald-Tipungwuti, Anthony",16,9,4,7,1,1,0,3
Essendon,"McGrath, Andrew",24,17,2,7,1,0,0,4
Essendon,"McKenna, Conor",16,7,1,9,0,0,0,1
Essendon,"McKernan, Shaun",18,13,7,5,4,0,6,2
Essendon,"Merrett, Zach",32,7,2,25,1,0,0,7
Essendon,"Myers, David",25,13,3,12,2,0,0,4
Essendon,"Saad, Adam",16,10,2,6,0,0,0,4
Essendon,"Smith, Devon",15,7,1,8,1,1,0,7
Essendon,"Stringer, Jake",15,11,6,4,3,1,0,1
Essendon,"Ambrose, Patrick",6,4,2,2,0,0,0,2
Essendon,"Baguley, Mark",13,6,6,7,1,0,0,3
Essendon,"Bellchambers, Tom",15,9,4,6,0,0,28,1
Essendon,"Brown, Mitch",10,7,5,3,3,0,0,2
Essendon,"Colyer, Travis",9,3,1,6,0,1,0,1
Essendon,"Goddard, Brendon",25,12,7,13,0,0,0,0
Essendon,"Guelfi, Matt",14,10,4,4,0,0,0,2
Essendon,"Heppell, Dyson",33,17,4,16,0,0,0,3
Essendon,"Hooker, Cale",15,6,8,9,0,0,0,2
Essendon,"Hurley, Michael",22,17,8,5,0,0,0,0
Essendon,"Langford, Kyle",14,8,3,6,1,0,0,1
Essendon,"Long, Jake",17,7,5,10,0,0,0,5
Essendon,"McDonald-Tipungwuti, Anthony",8,4,3,4,1,1,0,6
Essendon,"McGrath, Andrew",24,10,3,14,1,0,0,1
Essendon,"McKenna, Conor",17,12,0,5,0,0,0,1
Essendon,"McKernan, Shaun",18,12,7,6,2,2,7,1
Essendon,"McNiece, Ben",11,5,3,6,0,0,0,0
Essendon,"Merrett, Zach",33,13,4,20,0,0,0,8
Essendon,"Myers, David",16,10,2,6,0,0,0,4
Essendon,"Saad, Adam",14,9,2,5,0,0,0,0
Essendon,"Smith, Devon",31,17,8,14,0,1,0,13
Essendon,"Stringer, Jake",18,9,3,9,0,1,1,0
Essendon,"Baguley, Mark",11,9,6,2,3,2,0,6
Essendon,"Bellchambers, Tom",10,10,5,0,0,2,28,4
Essendon,"Brown, Mitch",14,9,7,5,1,1,0,0
Essendon,"Colyer, Travis",9,4,3,5,0,0,0,2
Essendon,"Dea, Matt",18,13,4,5,0,0,0,2
Essendon,"Goddard, Brendon",18,11,5,7,0,0,0,3
Essendon,"Guelfi, Matt",17,10,5,7,2,0,0,5
Essendon,"Heppell, Dyson",36,17,5,19,0,1,0,5
Essendon,"Hooker, Cale",19,10,9,9,0,0,0,1
Essendon,"Hurley, Michael",24,15,10,9,0,0,0,1
Essendon,"Langford, Kyle",26,15,6,11,0,2,0,5
Essendon,"Long, Jake",10,7,2,3,1,0,0,5
Essendon,"McDonald-Tipungwuti, Anthony",21,12,7,9,1,2,0,1
Essendon,"McGrath, Andrew",25,15,9,10,0,1,0,4
Essendon,"McKenna, Conor",17,14,6,3,0,1,0,0
Essendon,"McKernan, Shaun",14,8,7,6,2,0,10,1
Essendon,"McNiece, Ben",7,2,0,5,0,0,0,0
Essendon,"Merrett, Zach",37,19,7,18,0,0,0,7
Essendon,"Myers, David",24,11,8,13,1,0,0,3
Essendon,"Parish, Darcy",26,13,2,13,1,1,0,2
Essendon,"Saad, Adam",19,15,3,4,0,0,0,3
Essendon,"Smith, Devon",23,17,5,6,1,2,0,9
Essendon,"Baguley, Mark",12,8,6,4,1,2,0,1
Essendon,"Bellchambers, Tom",15,10,4,5,0,1,49,2
Essendon,"Brown, Mitch",10,7,7,3,3,1,0,1
Essendon,"Colyer, Travis",9,4,2,5,0,0,0,6
Essendon,"Dea, Matt",20,13,6,7,0,0,0,1
Essendon,"Fantasia, Orazio",19,10,9,9,5,1,0,3
Essendon,"Goddard, Brendon",23,7,3,16,0,0,0,0
Essendon,"Guelfi, Matt",12,5,0,7,0,0,0,5
Essendon,"Heppell, Dyson",26,12,3,14,0,0,0,4
Essendon,"Hooker, Cale",14,8,6,6,0,3,0,1
Essendon,"Hurley, Michael",17,9,4,8,0,0,0,1
Essendon,"Langford, Kyle",16,11,4,5,0,1,0,3
Essendon,"McDonald-Tipungwuti, Anthony",17,9,5,8,0,1,0,7
Essendon,"McGrath, Andrew",11,6,3,5,0,0,0,1
Essendon,"McKernan, Shaun",6,6,4,0,0,1,1,1
Essendon,"McNiece, Ben",21,10,4,11,0,0,0,4
Essendon,"Merrett, Zach",28,15,2,13,0,1,0,8
Essendon,"Myers, David",18,10,1,8,1,1,0,0
Essendon,"Parish, Darcy",18,11,2,7,0,2,0,3
Essendon,"Saad, Adam",19,8,2,11,0,1,0,5
Essendon,"Smith, Devon",23,15,3,8,2,0,0,10
Essendon,"Zaharakis, David",25,14,6,11,1,1,0,2
Essendon,"Baguley, Mark",11,7,5,4,2,1,0,3
Essendon,"Bellchambers, Tom",11,8,4,3,0,1,34,0
Essendon,"Brown, Mitch",14,11,8,3,2,2,0,2
Essendon,"Dea, Matt",4,1,2,3,0,0,0,0
Essendon,"Fantasia, Orazio",19,11,8,8,1,3,0,3
Essendon,"Francis, Aaron",14,9,4,5,0,0,0,2
Essendon,"Goddard, Brendon",22,11,6,11,0,0,0,0
Essendon,"Guelfi, Matt",12,4,3,8,0,0,0,3
Essendon,"Heppell, Dyson",31,16,8,15,0,0,0,3
Essendon,"Hooker, Cale",15,12,9,3,0,0,0,0
Essendon,"Hurley, Michael",12,7,3,5,0,0,0,0
Essendon,"Langford, Kyle",15,12,3,3,0,0,0,6
Essendon,"McDonald-Tipungwuti, Anthony",13,7,3,6,2,0,0,8
Essendon,"McGrath, Andrew",18,12,4,6,0,0,0,1
Essendon,"McKenna, Conor",17,13,4,4,1,0,0,2
Essendon,"Merrett, Zach",24,10,2,14,1,0,0,7
Essendon,"Myers, David",25,15,2,10,1,3,0,6
Essendon,"Parish, Darcy",26,9,5,17,1,0,0,2
Essendon,"Saad, Adam",24,13,2,11,0,1,0,0
Essendon,"Smith, Devon",17,10,2,7,2,3,0,8
Essendon,"Stringer, Jake",12,10,1,2,1,0,4,3
Essendon,"Zaharakis, David",22,14,2,8,1,0,0,6
Essendon,"Baguley, Mark",12,8,3,4,3,1,0,2
Essendon,"Bellchambers, Tom",7,5,3,2,1,0,40,3
Essendon,"Brown, Mitch",16,10,6,6,1,0,0,3
Essendon,"Colyer, Travis",23,17,8,6,1,0,0,3
Essendon,"Fantasia, Orazio",21,10,5,11,1,1,0,4
Essendon,"Francis, Aaron",7,5,5,2,0,0,0,1
Essendon,"Goddard, Brendon",17,10,4,7,0,0,0,1
Essendon,"Heppell, Dyson",25,11,5,14,0,0,0,6
Essendon,"Hooker, Cale",21,10,13,11,2,0,0,0
Essendon,"Hurley, Michael",18,13,9,5,0,0,0,0
Essendon,"Langford, Kyle",10,7,5,3,0,0,1,6
Essendon,"McDonald-Tipungwuti, Anthony",14,9,4,5,1,0,0,6
Essendon,"McGrath, Andrew",10,8,3,2,1,0,0,1
Essendon,"McKenna, Conor",18,15,4,3,2,0,0,1
Essendon,"McNiece, Ben",13,7,5,6,0,0,0,0
Essendon,"Merrett, Zach",41,20,5,21,0,1,0,4
Essendon,"Myers, David",15,9,2,6,0,0,0,6
Essendon,"Parish, Darcy",22,8,4,14,0,0,0,1
Essendon,"Saad, Adam",17,11,1,6,0,0,0,3
Essendon,"Smith, Devon",22,13,2,9,0,1,0,8
Essendon,"Stringer, Jake",14,9,5,5,3,1,0,0
Essendon,"Zaharakis, David",21,9,4,12,0,0,0,1
Essendon,"Baguley, Mark",14,9,5,5,0,1,0,3
Essendon,"Bellchambers, Tom",13,3,3,10,0,1,25,0
Essendon,"Brown, Mitch",15,9,10,6,0,1,0,0
Essendon,"Colyer, Travis",17,10,5,7,0,1,0,0
Essendon,"Fantasia, Orazio",14,10,4,4,2,3,0,5
Essendon,"Francis, Aaron",13,10,4,3,1,0,0,3
Essendon,"Goddard, Brendon",4,2,0,2,0,0,0,0
Essendon,"Heppell, Dyson",29,22,11,7,1,2,0,2
Essendon,"Hooker, Cale",7,4,1,3,1,0,0,0
Essendon,"Hurley, Michael",21,16,13,5,0,0,0,1
Essendon,"Langford, Kyle",22,11,7,11,2,2,0,6
Essendon,"McDonald-Tipungwuti, Anthony",15,9,3,6,5,0,0,7
Essendon,"McGrath, Andrew",33,19,8,14,0,0,0,1
Essendon,"McKenna, Conor",20,13,3,7,1,0,0,2
Essendon,"McNiece, Ben",13,6,5,7,0,0,0,0
Essendon,"Merrett, Zach",36,15,4,21,0,0,0,5
Essendon,"Myers, David",29,21,9,8,2,0,0,5
Essendon,"Parish, Darcy",23,9,2,14,0,0,0,5
Essendon,"Saad, Adam",2,0,0,2,0,0,0,0
Essendon,"Smith, Devon",24,17,7,7,1,0,0,8
Essendon,"Stringer, Jake",12,10,7,2,2,2,0,1
Essendon,"Zaharakis, David",18,10,6,8,0,0,0,1
Essendon,"Baguley, Mark",7,4,4,3,1,0,0,1
Essendon,"Bellchambers, Tom",13,6,7,7,1,0,39,1
Essendon,"Brown, Mitch",10,9,4,1,2,0,0,4
Essendon,"Colyer, Travis",11,6,2,5,1,0,0,0
Essendon,"Dea, Matt",16,13,6,3,0,0,0,2
Essendon,"Francis, Aaron",13,12,8,1,0,0,0,1
Essendon,"Goddard, Brendon",21,10,7,11,0,0,0,0
Essendon,"Guelfi, Matt",13,4,3,9,0,0,0,0
Essendon,"Heppell, Dyson",25,14,6,11,0,0,0,6
Essendon,"Hooker, Cale",14,8,3,6,3,1,0,3
Essendon,"Hurley, Michael",16,11,6,5,0,0,0,1
Essendon,"Langford, Kyle",15,5,4,10,0,0,0,1
Essendon,"McDonald-Tipungwuti, Anthony",7,4,1,3,0,0,0,5
Essendon,"McGrath, Andrew",21,11,4,10,0,0,0,2
Essendon,"McKenna, Conor",23,10,4,13,0,0,0,1
Essendon,"Merrett, Zach",25,11,6,14,0,1,0,4
Essendon,"Myers, David",15,10,1,5,0,0,0,4
Essendon,"Parish, Darcy",18,11,5,7,1,1,0,5
Essendon,"Saad, Adam",17,11,1,6,0,0,0,3
Essendon,"Smith, Devon",28,15,6,13,1,0,0,5
Essendon,"Stringer, Jake",13,11,3,2,1,2,3,3
Essendon,"Zaharakis, David",30,14,6,16,0,1,0,4
Essendon,"Baguley, Mark",12,7,4,5,1,0,0,4
Essendon,"Brown, Mitch",21,15,10,6,3,0,1,2
Essendon,"Colyer, Travis",14,7,5,7,0,0,0,3
Essendon,"Francis, Aaron",19,15,11,4,0,0,0,4
Essendon,"Goddard, Brendon",27,17,12,10,0,0,0,2
Essendon,"Guelfi, Matt",13,7,2,6,0,0,0,1
Essendon,"Heppell, Dyson",26,11,1,15,2,0,0,2
Essendon,"Hooker, Cale",19,12,8,7,0,0,0,2
Essendon,"Hurley, Michael",17,9,9,8,0,0,0,1
Essendon,"Langford, Kyle",15,13,5,2,3,0,0,11
Essendon,"Laverde, Jayden",17,10,3,7,3,3,0,3
Essendon,"Leuenberger, Matthew",3,1,1,2,0,0,22,4
Essendon,"McDonald-Tipungwuti, Anthony",12,7,2,5,2,0,0,3
Essendon,"McGrath, Andrew",13,4,0,9,0,0,0,4
Essendon,"McKenna, Conor",18,12,7,6,0,0,0,0
Essendon,"Merrett, Zach",29,13,3,16,0,0,0,8
Essendon,"Myers, David",16,6,1,10,1,0,0,3
Essendon,"Parish, Darcy",22,13,5,9,0,0,0,5
Essendon,"Saad, Adam",19,13,6,6,0,0,0,3
Essendon,"Smith, Devon",29,17,6,12,0,1,0,12
Essendon,"Stringer, Jake",9,8,2,1,0,3,4,3
Essendon,"Zaharakis, David",25,14,7,11,2,0,0,3
Fremantle,"Ballantyne, Hayden",10,6,2,4,0,0,0,3
Fremantle,"Banfield, Bailey",12,8,3,4,0,0,0,3
Fremantle,"Blakely, Connor",17,11,4,6,0,0,0,1
Fremantle,"Brayshaw, Andrew",12,4,3,8,0,0,0,2
Fremantle,"Fyfe, Nat",22,10,1,12,1,0,0,3
Fremantle,"Hill, Bradley",15,13,5,2,1,0,0,2
Fremantle,"Johnson, Michael",14,10,7,4,0,0,0,1
Fremantle,"Kersten, Shane",12,6,3,6,0,2,0,0
Fremantle,"Langdon, Ed",17,8,2,9,1,0,0,3
Fremantle,"Matera, Brandon",19,13,7,6,1,0,0,3
Fremantle,"McCarthy, Cam",13,10,7,3,1,3,0,3
Fremantle,"Mundy, David",21,7,4,14,0,0,0,3
Fremantle,"Neale, Lachie",38,14,4,24,0,0,0,1
Fremantle,"Pearce, Alex",10,6,6,4,0,0,0,1
Fremantle,"Pearce, Danyle",12,5,3,7,0,0,0,2
Fremantle,"Ryan, Luke",16,13,6,3,0,0,0,2
Fremantle,"Sandilands, Aaron",16,5,5,11,1,0,52,2
Fremantle,"Sutcliffe, Cam",17,6,6,11,0,0,0,0
Fremantle,"Taberner, Matthew",20,14,9,6,1,0,5,1
Fremantle,"Tucker, Darcy",12,7,1,5,0,0,0,2
Fremantle,"Walters, Michael",18,11,4,7,1,0,0,6
Fremantle,"Wilson, Nathan",15,11,3,4,1,0,0,0
Fremantle,"Ballantyne, Hayden",11,8,3,3,1,1,0,4
Fremantle,"Banfield, Bailey",14,9,6,5,0,0,0,3
Fremantle,"Blakely, Connor",30,19,12,11,0,0,0,1
Fremantle,"Brayshaw, Andrew",16,11,3,5,0,0,0,5
Fremantle,"Cerra, Adam",9,6,4,3,2,1,0,4
Fremantle,"Crowden, Mitch",11,4,2,7,0,1,0,2
Fremantle,"Fyfe, Nat",29,19,7,10,1,1,0,5
Fremantle,"Hamling, Joel",12,4,3,8,0,0,0,2
Fremantle,"Hill, Bradley",19,13,6,6,0,0,0,6
Fremantle,"Hill, Stephen",26,16,3,10,1,0,0,1
Fremantle,"Johnson, Michael",17,7,5,10,0,0,0,0
Fremantle,"Langdon, Ed",13,10,3,3,2,0,0,2
Fremantle,"Matera, Brandon",20,15,2,5,1,1,0,3
Fremantle,"McCarthy, Cam",12,4,4,8,1,0,0,2
Fremantle,"Mundy, David",22,13,4,9,2,2,0,2
Fremantle,"Neale, Lachie",28,14,1,14,0,0,0,6
Fremantle,"Pearce, Alex",13,6,4,7,0,0,0,1
Fremantle,"Ryan, Luke",22,19,12,3,0,0,0,4
Fremantle,"Sandilands, Aaron",10,1,1,9,0,0,32,0
Fremantle,"Taberner, Matthew",16,10,4,6,4,0,10,2
Fremantle,"Walters, Michael",26,13,5,13,1,1,0,8
Fremantle,"Wilson, Nathan",23,20,11,3,0,1,0,2
Fremantle,"Ballantyne, Hayden",18,10,4,8,2,0,0,1
Fremantle,"Banfield, Bailey",11,6,2,5,0,0,0,4
Fremantle,"Blakely, Connor",21,13,9,8,0,0,0,1
Fremantle,"Brayshaw, Andrew",7,4,2,3,0,2,0,4
Fremantle,"Cerra, Adam",10,9,5,1,0,0,0,1
Fremantle,"Crowden, Mitch",13,7,6,6,1,1,0,3
Fremantle,"Fyfe, Nat",38,20,5,18,1,2,0,8
Fremantle,"Hamling, Joel",11,7,1,4,0,0,0,2
Fremantle,"Hill, Stephen",18,10,3,8,0,0,0,3
Fremantle,"Johnson, Michael",11,9,5,2,0,0,0,0
Fremantle,"Langdon, Ed",27,21,5,6,0,1,0,5
Fremantle,"Matera, Brandon",15,9,7,6,1,1,0,1
Fremantle,"McCarthy, Cam",17,11,7,6,3,1,0,0
Fremantle,"Mundy, David",23,11,9,12,1,1,0,3
Fremantle,"Neale, Lachie",29,13,5,16,0,2,0,1
Fremantle,"Pearce, Alex",10,5,3,5,0,0,0,4
Fremantle,"Ryan, Luke",21,14,5,7,0,0,0,1
Fremantle,"Sandilands, Aaron",14,5,4,9,1,1,33,0
Fremantle,"Sheridan, Tom",14,8,4,6,1,0,0,2
Fremantle,"Taberner, Matthew",18,12,7,6,0,3,4,1
Fremantle,"Walters, Michael",23,16,4,7,2,1,1,6
Fremantle,"Wilson, Nathan",18,12,3,6,0,0,0,2
Fremantle,"Ballantyne, Hayden",9,5,1,4,0,0,0,2
Fremantle,"Banfield, Bailey",17,7,5,10,1,0,0,3
Fremantle,"Blakely, Connor",16,9,4,7,0,0,0,2
Fremantle,"Brayshaw, Andrew",11,4,1,7,0,0,0,4
Fremantle,"Cerra, Adam",7,2,2,5,0,0,0,2
Fremantle,"Crowden, Mitch",15,10,5,5,0,0,0,7
Fremantle,"Fyfe, Nat",25,12,4,13,1,1,0,4
Fremantle,"Hamling, Joel",16,10,5,6,0,0,0,0
Fremantle,"Hill, Stephen",28,21,9,7,1,0,0,2
Fremantle,"Johnson, Michael",20,12,9,8,0,0,0,1
Fremantle,"Matera, Brandon",12,4,2,8,2,0,0,1
Fremantle,"McCarthy, Cam",6,4,3,2,0,1,0,1
Fremantle,"Mundy, David",32,17,3,15,1,0,0,3
Fremantle,"Neale, Lachie",29,16,5,13,0,1,0,3
Fremantle,"Pearce, Alex",10,6,4,4,0,0,0,3
Fremantle,"Ryan, Luke",14,11,6,3,0,0,0,1
Fremantle,"Sandilands, Aaron",15,5,4,10,1,0,40,1
Fremantle,"Sheridan, Tom",11,6,1,5,0,0,0,5
Fremantle,"Taberner, Matthew",19,12,5,7,0,0,8,2
Fremantle,"Tucker, Darcy",15,8,5,7,0,0,0,1
Fremantle,"Walters, Michael",21,8,2,13,0,0,0,5
Fremantle,"Wilson, Nathan",14,11,4,3,0,1,0,3
Fremantle,"Ballantyne, Hayden",14,13,6,1,2,1,0,0
Fremantle,"Banfield, Bailey",18,8,3,10,0,0,0,3
Fremantle,"Blakely, Connor",23,17,12,6,0,0,0,2
Fremantle,"Brayshaw, Andrew",17,7,4,10,0,1,0,5
Fremantle,"Cerra, Adam",15,10,5,5,2,1,0,4
Fremantle,"Crowden, Mitch",17,4,2,13,0,0,0,5
Fremantle,"Duman, Taylin",15,9,4,6,0,0,0,2
Fremantle,"Fyfe, Nat",43,18,7,25,1,0,0,3
Fremantle,"Hamling, Joel",11,4,5,7,0,0,0,1
Fremantle,"Hill, Stephen",13,7,5,6,1,0,0,5
Fremantle,"Langdon, Ed",26,12,4,14,0,1,0,1
Fremantle,"Matera, Brandon",18,12,3,6,1,0,0,0
Fremantle,"McCarthy, Cam",16,13,10,3,2,3,0,1
Fremantle,"Mundy, David",21,12,4,9,1,1,0,8
Fremantle,"Neale, Lachie",29,9,2,20,0,0,0,4
Fremantle,"Pearce, Alex",13,3,3,10,0,0,6,2
Fremantle,"Ryan, Luke",21,13,9,8,0,0,0,0
Fremantle,"Sandilands, Aaron",9,3,1,6,0,0,53,2
Fremantle,"Taberner, Matthew",6,3,5,3,1,0,2,0
Fremantle,"Tucker, Darcy",17,10,6,7,0,0,0,5
Fremantle,"Walters, Michael",18,13,5,5,5,1,0,0
Fremantle,"Wilson, Nathan",27,24,5,3,0,0,0,1
Fremantle,"Ballantyne, Hayden",6,3,2,3,2,0,0,2
Fremantle,"Banfield, Bailey",14,8,2,6,0,0,0,4
Fremantle,"Blakely, Connor",31,15,8,16,0,0,0,4
Fremantle,"Brayshaw, Andrew",14,5,2,9,1,0,0,4
Fremantle,"Cerra, Adam",11,6,4,5,0,0,0,1
Fremantle,"Crowden, Mitch",11,5,2,6,0,0,0,3
Fremantle,"Duman, Taylin",12,8,2,4,0,0,0,3
Fremantle,"Fyfe, Nat",27,13,5,14,0,1,0,5
Fremantle,"Hamling, Joel",9,4,4,5,0,0,0,3
Fremantle,"Hill, Stephen",19,12,1,7,0,1,0,4
Fremantle,"Johnson, Michael",18,7,6,11,0,0,2,0
Fremantle,"Langdon, Ed",26,15,9,11,2,1,0,3
Fremantle,"Matera, Brandon",17,12,8,5,1,0,0,3
Fremantle,"McCarthy, Cam",7,5,4,2,2,1,0,2
Fremantle,"Mundy, David",23,10,4,13,1,1,0,6
Fremantle,"Neale, Lachie",35,13,8,22,0,0,0,8
Fremantle,"Pearce, Alex",14,9,2,5,0,0,0,2
Fremantle,"Ryan, Luke",18,16,6,2,0,0,0,2
Fremantle,"Sandilands, Aaron",10,6,3,4,0,0,33,2
Fremantle,"Tucker, Darcy",17,6,2,11,2,0,0,6
Fremantle,"Walters, Michael",2,1,0,1,1,0,0,0
Fremantle,"Wilson, Nathan",15,10,8,5,0,1,0,0
Fremantle,"Ballantyne, Hayden",14,11,4,3,1,2,0,2
Fremantle,"Banfield, Bailey",20,12,5,8,0,0,0,2
Fremantle,"Blakely, Connor",21,6,3,15,0,0,0,2
Fremantle,"Brayshaw, Andrew",14,8,5,6,1,0,0,6
Fremantle,"Cerra, Adam",18,10,3,8,0,0,0,6
Fremantle,"Cox, Brennan",8,6,4,2,1,0,1,1
Fremantle,"Crowden, Mitch",8,2,0,6,0,0,0,2
Fremantle,"Duman, Taylin",8,6,2,2,0,0,0,1
Fremantle,"Fyfe, Nat",33,17,8,16,0,1,7,4
Fremantle,"Hamling, Joel",12,7,3,5,0,0,0,1
Fremantle,"Hill, Stephen",12,7,1,5,0,0,0,0
Fremantle,"Hughes, Ethan",12,5,2,7,0,0,0,1
Fremantle,"Langdon, Ed",22,11,3,11,0,0,0,2
Fremantle,"Matera, Brandon",14,9,1,5,0,1,0,2
Fremantle,"McCarthy, Cam",7,5,2,2,1,1,0,1
Fremantle,"Mundy, David",18,6,4,12,0,1,0,1
Fremantle,"Neale, Lachie",35,14,3,21,0,0,0,2
Fremantle,"Pearce, Alex",12,6,5,6,0,0,0,2
Fremantle,"Ryan, Luke",13,9,5,4,0,0,0,0
Fremantle,"Sandilands, Aaron",11,2,1,9,0,0,49,0
Fremantle,"Tucker, Darcy",15,7,3,8,0,2,0,3
Fremantle,"Wilson, Nathan",19,14,6,5,0,0,0,0
Fremantle,"Ballantyne, Hayden",11,9,2,2,1,2,0,1
Fremantle,"Banfield, Bailey",12,5,1,7,0,0,0,5
Fremantle,"Blakely, Connor",35,21,11,14,0,0,0,1
Fremantle,"Brayshaw, Andrew",16,9,5,7,0,0,0,6
Fremantle,"Cerra, Adam",14,4,1,10,2,0,0,3
Fremantle,"Cox, Brennan",12,7,5,5,1,2,3,1
Fremantle,"Crowden, Mitch",10,1,1,9,0,0,0,3
Fremantle,"Duman, Taylin",15,9,6,6,0,0,0,1
Fremantle,"Fyfe, Nat",36,10,2,26,1,1,0,4
Fremantle,"Hamling, Joel",18,8,8,10,0,0,0,1
Fremantle,"Johnson, Michael",18,14,8,4,0,0,0,3
Fremantle,"Langdon, Ed",33,16,9,17,0,1,0,5
Fremantle,"Matera, Brandon",13,11,4,2,2,1,0,2
Fremantle,"McCarthy, Cam",7,4,2,3,1,1,0,1
Fremantle,"Mundy, David",19,13,6,6,1,0,0,1
Fremantle,"Neale, Lachie",32,12,3,20,1,1,0,4
Fremantle,"Nyhuis, Ryan",17,8,4,9,0,0,0,1
Fremantle,"Pearce, Alex",15,6,4,9,0,0,0,2
Fremantle,"Pearce, Danyle",18,13,5,5,1,0,0,4
Fremantle,"Ryan, Luke",27,20,10,7,0,1,0,2
Fremantle,"Sandilands, Aaron",13,7,4,6,1,0,41,2
Fremantle,"Tucker, Darcy",13,8,3,5,1,0,0,0
Fremantle,"Ballantyne, Hayden",11,6,2,5,1,0,0,0
Fremantle,"Banfield, Bailey",13,9,2,4,0,1,0,6
Fremantle,"Blakely, Connor",22,9,5,13,0,0,0,4
Fremantle,"Brayshaw, Andrew",13,6,3,7,0,0,0,4
Fremantle,"Cerra, Adam",15,5,2,10,0,0,0,1
Fremantle,"Cox, Brennan",17,9,10,8,0,1,2,1
Fremantle,"Crowden, Mitch",5,2,1,3,0,0,0,2
Fremantle,"Fyfe, Nat",28,12,1,16,1,0,8,4
Fremantle,"Hamling, Joel",3,3,1,0,0,0,0,1
Fremantle,"Johnson, Michael",12,8,6,4,0,0,0,4
Fremantle,"Langdon, Ed",29,18,9,11,1,1,0,1
Fremantle,"Matera, Brandon",15,12,4,3,0,0,0,2
Fremantle,"McCarthy, Cam",11,5,2,6,0,1,0,4
Fremantle,"Mundy, David",22,9,3,13,0,1,4,6
Fremantle,"Neale, Lachie",30,9,4,21,0,0,0,4
Fremantle,"Nyhuis, Ryan",11,10,6,1,0,0,0,2
Fremantle,"Pearce, Alex",7,2,3,5,0,0,0,1
Fremantle,"Ryan, Luke",23,18,10,5,0,0,0,3
Fremantle,"Sandilands, Aaron",6,2,2,4,2,0,37,1
Fremantle,"Tucker, Darcy",18,14,4,4,0,1,0,9
Fremantle,"Walters, Michael",21,15,5,6,2,3,0,2
Fremantle,"Wilson, Nathan",23,19,9,4,0,0,0,1
Fremantle,"Ballantyne, Hayden",10,7,4,3,0,0,0,1
Fremantle,"Banfield, Bailey",15,10,5,5,0,0,0,3
Fremantle,"Blakely, Connor",12,9,5,3,0,0,0,5
Fremantle,"Brayshaw, Andrew",17,9,1,8,1,0,0,3
Fremantle,"Cerra, Adam",15,6,3,9,0,1,0,9
Fremantle,"Cox, Brennan",10,6,4,4,1,2,6,2
Fremantle,"Fyfe, Nat",31,14,4,17,1,0,1,8
Fremantle,"Hamling, Joel",10,6,7,4,0,0,0,0
Fremantle,"Hill, Stephen",12,11,5,1,0,0,0,4
Fremantle,"Johnson, Michael",15,11,8,4,1,0,0,4
Fremantle,"Langdon, Ed",26,19,6,7,0,0,0,6
Fremantle,"Matera, Brandon",13,7,2,6,0,0,0,2
Fremantle,"McCarthy, Cam",9,5,1,4,1,1,0,2
Fremantle,"Mundy, David",24,15,6,9,1,0,0,4
Fremantle,"Neale, Lachie",20,7,0,13,0,0,0,6
Fremantle,"Pearce, Alex",9,4,1,5,0,0,0,2
Fremantle,"Pearce, Danyle",13,5,3,8,0,0,0,5
Fremantle,"Ryan, Luke",28,22,10,6,0,0,0,4
Fremantle,"Sandilands, Aaron",7,0,0,7,0,0,35,2
Fremantle,"Tucker, Darcy",14,9,0,5,0,0,0,4
Fremantle,"Walters, Michael",27,16,8,11,2,1,0,6
Fremantle,"Wilson, Nathan",14,11,5,3,0,0,0,1
Fremantle,"Apeness, Michael",17,7,1,10,1,0,17,5
Fremantle,"Banfield, Bailey",15,9,6,6,1,1,0,5
Fremantle,"Blakely, Connor",24,13,8,11,0,0,0,1
Fremantle,"Brayshaw, Andrew",19,8,3,11,0,1,0,5
Fremantle,"Cerra, Adam",11,8,3,3,0,0,0,0
Fremantle,"Cox, Brennan",10,4,5,6,1,1,0,0
Fremantle,"Duman, Taylin",13,8,6,5,0,0,0,2
Fremantle,"Fyfe, Nat",24,10,5,14,0,0,0,2
Fremantle,"Giro, Stefan",10,5,2,5,1,1,0,4
Fremantle,"Hamling, Joel",21,9,11,12,0,0,0,2
Fremantle,"Jones, Scott",6,3,3,3,1,0,8,4
Fremantle,"Kersten, Shane",18,13,9,5,0,0,0,0
Fremantle,"Langdon, Ed",16,9,4,7,0,0,0,2
Fremantle,"McCarthy, Cam",8,3,2,5,0,0,0,1
Fremantle,"Mundy, David",18,11,5,7,2,0,0,3
Fremantle,"Neale, Lachie",29,8,5,21,2,0,0,6
Fremantle,"Pearce, Alex",6,5,4,1,0,0,0,0
Fremantle,"Ryan, Luke",14,14,8,0,0,0,0,2
Fremantle,"Sheridan, Tom",25,12,5,13,1,0,0,4
Fremantle,"Tucker, Darcy",17,10,7,7,2,0,0,4
Fremantle,"Walters, Michael",29,17,5,12,0,1,0,4
Fremantle,"Wilson, Nathan",19,13,6,6,0,0,0,2
Fremantle,"Apeness, Michael",10,4,5,6,0,0,18,2
Fremantle,"Ballantyne, Hayden",10,8,6,2,1,2,0,4
Fremantle,"Banfield, Bailey",16,13,4,3,1,2,0,4
Fremantle,"Blakely, Connor",30,14,6,16,0,1,0,5
Fremantle,"Brayshaw, Andrew",20,4,0,16,0,0,0,2
Fremantle,"Cerra, Adam",30,19,6,11,0,0,0,4
Fremantle,"Cox, Brennan",19,9,7,10,4,0,0,5
Fremantle,"Giro, Stefan",18,7,2,11,0,0,0,2
Fremantle,"Hamling, Joel",20,10,11,10,0,0,0,1
Fremantle,"Jones, Scott",5,2,1,3,0,0,13,1
Fremantle,"Kersten, Shane",18,10,5,8,0,0,0,1
Fremantle,"Langdon, Ed",25,19,5,6,1,2,0,3
Fremantle,"Matera, Brandon",17,7,1,10,0,0,0,1
Fremantle,"Mundy, David",22,10,2,12,0,0,0,8
Fremantle,"Neale, Lachie",32,9,6,23,0,0,0,4
Fremantle,"Nyhuis, Ryan",21,17,9,4,0,0,0,0
Fremantle,"Pearce, Alex",17,12,5,5,0,0,0,3
Fremantle,"Ryan, Luke",23,14,9,9,0,0,0,6
Fremantle,"Sheridan, Tom",20,8,4,12,2,1,0,3
Fremantle,"Tucker, Darcy",15,6,2,9,1,1,0,1
Fremantle,"Walters, Michael",17,10,4,7,0,0,0,3
Fremantle,"Wilson, Nathan",22,18,6,4,0,0,0,1
Fremantle,"Apeness, Michael",10,3,4,7,1,0,8,3
Fremantle,"Ballantyne, Hayden",10,7,3,3,1,1,0,5
Fremantle,"Banfield, Bailey",11,7,4,4,1,0,0,5
Fremantle,"Blakely, Connor",27,16,5,11,0,0,0,4
Fremantle,"Brayshaw, Andrew",20,12,5,8,1,1,0,5
Fremantle,"Cerra, Adam",14,8,8,6,0,1,0,3
Fremantle,"Cox, Brennan",14,6,5,8,1,1,0,1
Fremantle,"Fyfe, Nat",30,14,8,16,2,1,0,4
Fremantle,"Giro, Stefan",17,8,3,9,0,0,0,5
Fremantle,"Hamling, Joel",12,9,8,3,0,0,0,1
Fremantle,"Hill, Stephen",16,11,3,5,0,1,0,3
Fremantle,"Kersten, Shane",14,12,8,2,0,0,0,1
Fremantle,"Langdon, Ed",18,12,9,6,0,1,0,3
Fremantle,"Matera, Brandon",17,11,4,6,1,2,0,1
Fremantle,"Mundy, David",20,8,4,12,1,1,0,4
Fremantle,"Neale, Lachie",33,15,6,18,3,0,0,4
Fremantle,"Nyhuis, Ryan",8,8,5,0,0,0,0,1
Fremantle,"Ryan, Luke",15,9,5,6,1,0,0,5
Fremantle,"Sandilands, Aaron",13,3,1,10,0,0,41,0
Fremantle,"Sheridan, Tom",16,8,3,8,1,0,0,8
Fremantle,"Tucker, Darcy",10,6,3,4,1,0,0,2
Fremantle,"Wilson, Nathan",16,14,3,2,0,0,0,3
Fremantle,"Apeness, Michael",13,4,3,9,1,1,26,3
Fremantle,"Ballantyne, Hayden",10,7,5,3,2,2,0,4
Fremantle,"Banfield, Bailey",8,3,2,5,0,0,0,4
Fremantle,"Brayshaw, Andrew",18,10,5,8,0,0,0,4
Fremantle,"Cerra, Adam",13,6,2,7,0,0,0,2
Fremantle,"Cox, Brennan",8,5,3,3,2,0,4,3
Fremantle,"Fyfe, Nat",8,4,4,4,0,0,0,1
Fremantle,"Giro, Stefan",15,3,2,12,1,0,0,5
Fremantle,"Hamling, Joel",11,4,7,7,0,0,0,1
Fremantle,"Hill, Stephen",16,11,3,5,0,0,0,1
Fremantle,"Kersten, Shane",14,9,6,5,1,0,0,1
Fremantle,"Langdon, Ed",26,19,9,7,1,0,0,3
Fremantle,"Matera, Brandon",9,7,2,2,0,0,0,3
Fremantle,"Mundy, David",19,13,5,6,1,1,0,3
Fremantle,"Neale, Lachie",31,14,2,17,0,2,0,6
Fremantle,"Nyhuis, Ryan",8,4,0,4,0,1,0,2
Fremantle,"Pearce, Alex",6,5,2,1,0,0,1,4
Fremantle,"Ryan, Luke",10,6,2,4,0,0,0,1
Fremantle,"Sheridan, Tom",16,10,6,6,0,0,0,3
Fremantle,"Tucker, Darcy",15,9,4,6,0,1,0,5
Fremantle,"Walters, Michael",26,11,2,15,0,2,0,2
Fremantle,"Wilson, Nathan",16,10,3,6,0,0,0,2
Fremantle,"Apeness, Michael",5,3,2,2,0,0,8,6
Fremantle,"Banfield, Bailey",14,6,3,8,0,0,0,2
Fremantle,"Brayshaw, Andrew",16,8,3,8,0,0,0,8
Fremantle,"Cerra, Adam",23,16,7,7,0,1,0,3
Fremantle,"Cox, Brennan",10,4,3,6,2,0,0,3
Fremantle,"Darcy, Sean",13,4,0,9,0,1,24,3
Fremantle,"Giro, Stefan",17,9,1,8,0,0,0,3
Fremantle,"Hamling, Joel",14,13,5,1,0,0,0,2
Fremantle,"Hill, Bradley",19,14,1,5,0,0,0,2
Fremantle,"Hill, Stephen",25,12,4,13,0,0,0,11
Fremantle,"Hughes, Ethan",12,7,4,5,0,0,0,2
Fremantle,"Kersten, Shane",12,7,5,5,0,0,0,1
Fremantle,"Langdon, Ed",14,12,7,2,0,0,0,3
Fremantle,"Matera, Brandon",12,7,1,5,0,0,0,4
Fremantle,"Mundy, David",19,7,4,12,1,0,0,5
Fremantle,"Neale, Lachie",18,5,3,13,0,0,0,3
Fremantle,"Pearce, Alex",11,4,3,7,0,0,0,6
Fremantle,"Ryan, Luke",15,9,1,6,0,0,0,2
Fremantle,"Sheridan, Tom",23,11,4,12,2,0,0,5
Fremantle,"Tucker, Darcy",8,3,1,5,0,0,0,1
Fremantle,"Walters, Michael",22,11,3,11,2,0,0,2
Fremantle,"Wilson, Nathan",17,16,5,1,0,0,0,1
Fremantle,"Banfield, Bailey",18,11,0,7,0,0,0,9
Fremantle,"Cerra, Adam",17,11,3,6,0,0,0,8
Fremantle,"Cox, Brennan",16,9,3,7,2,0,0,6
Fremantle,"Darcy, Sean",15,6,5,9,0,2,33,5
Fremantle,"Giro, Stefan",19,8,2,11,0,0,0,6
Fremantle,"Hamling, Joel",11,7,5,4,0,0,0,2
Fremantle,"Hill, Bradley",21,18,6,3,0,0,0,4
Fremantle,"Hill, Stephen",17,10,6,7,0,0,0,4
Fremantle,"Hughes, Ethan",12,7,3,5,1,0,0,2
Fremantle,"Jones, Scott",9,5,2,4,1,0,11,3
Fremantle,"Langdon, Ed",28,13,4,15,0,1,0,4
Fremantle,"Matera, Brandon",16,7,0,9,0,1,0,2
Fremantle,"McCarthy, Cam",4,2,0,2,1,0,0,0
Fremantle,"Mundy, David",29,22,5,7,1,1,0,5
Fremantle,"Neale, Lachie",33,15,4,18,0,0,0,1
Fremantle,"Nyhuis, Ryan",11,9,3,2,0,0,0,1
Fremantle,"Pearce, Alex",9,5,2,4,0,0,0,1
Fremantle,"Ryan, Luke",28,20,7,8,0,0,0,3
Fremantle,"Sheridan, Tom",12,9,3,3,0,1,0,2
Fremantle,"Sutcliffe, Cam",11,8,2,3,1,2,0,6
Fremantle,"Walters, Michael",14,8,3,6,1,1,0,3
Fremantle,"Wilson, Nathan",18,13,5,5,0,0,0,1
Fremantle,"Banfield, Bailey",22,14,6,8,0,0,0,2
Fremantle,"Cerra, Adam",13,8,1,5,1,0,0,7
Fremantle,"Cox, Brennan",7,3,1,4,0,0,0,0
Fremantle,"Duman, Taylin",16,12,4,4,0,0,0,3
Fremantle,"Giro, Stefan",13,6,1,7,0,0,0,5
Fremantle,"Hamling, Joel",15,8,6,7,0,0,0,0
Fremantle,"Hill, Bradley",17,14,6,3,0,0,0,3
Fremantle,"Hughes, Ethan",13,7,4,6,0,0,0,0
Fremantle,"Johnson, Michael",15,8,5,7,2,0,4,3
Fremantle,"Jones, Scott",5,2,1,3,0,0,17,6
Fremantle,"Langdon, Ed",7,3,0,4,0,0,0,2
Fremantle,"Matera, Brandon",16,13,4,3,1,0,0,3
Fremantle,"McCarthy, Cam",9,4,2,5,1,0,0,1
Fremantle,"Mundy, David",15,7,3,8,1,0,0,2
Fremantle,"Neale, Lachie",30,12,3,18,1,0,0,5
Fremantle,"Pearce, Alex",11,3,2,8,0,0,0,0
Fremantle,"Ryan, Luke",15,4,3,11,0,0,0,1
Fremantle,"Sheridan, Tom",15,7,1,8,0,0,0,1
Fremantle,"Sutcliffe, Cam",13,7,7,6,1,0,0,2
Fremantle,"Tucker, Darcy",13,3,2,10,0,0,0,7
Fremantle,"Walters, Michael",18,11,3,7,3,2,0,1
Fremantle,"Wilson, Nathan",20,16,3,4,0,0,0,0
Fremantle,"Banfield, Bailey",19,9,4,10,1,1,0,6
Fremantle,"Brayshaw, Andrew",25,12,3,13,1,0,0,4
Fremantle,"Cerra, Adam",12,8,3,4,0,0,0,1
Fremantle,"Cox, Brennan",7,4,0,3,0,2,0,1
Fremantle,"Darcy, Sean",9,2,1,7,1,0,28,4
Fremantle,"Duman, Taylin",17,10,6,7,0,0,0,1
Fremantle,"Giro, Stefan",17,7,1,10,0,2,0,1
Fremantle,"Hamling, Joel",18,6,8,12,0,0,0,0
Fremantle,"Hill, Bradley",19,12,3,7,0,0,0,2
Fremantle,"Hill, Stephen",18,14,3,4,0,0,0,1
Fremantle,"Jones, Scott",11,4,7,7,0,0,11,2
Fremantle,"Langdon, Ed",26,14,5,12,1,0,0,4
Fremantle,"Matera, Brandon",18,10,3,8,0,1,0,5
Fremantle,"Mundy, David",34,17,6,17,1,3,0,4
Fremantle,"Neale, Lachie",36,12,3,24,0,0,0,3
Fremantle,"Pearce, Alex",8,1,1,7,0,0,0,1
Fremantle,"Ryan, Luke",10,6,4,4,1,0,0,3
Fremantle,"Sheridan, Tom",16,7,7,9,0,1,0,2
Fremantle,"Sutcliffe, Cam",9,5,2,4,0,0,0,1
Fremantle,"Tucker, Darcy",22,8,5,14,1,0,0,1
Fremantle,"Walters, Michael",22,15,6,7,0,0,0,0
Fremantle,"Wilson, Nathan",18,14,8,4,0,0,0,0
Fremantle,"Ballantyne, Hayden",11,6,3,5,1,0,0,0
Fremantle,"Banfield, Bailey",11,4,1,7,0,0,0,2
Fremantle,"Brayshaw, Andrew",16,6,1,10,0,0,0,4
Fremantle,"Cerra, Adam",7,2,1,5,0,0,0,1
Fremantle,"Cox, Brennan",11,6,4,5,1,2,5,4
Fremantle,"Crowden, Mitch",7,3,2,4,0,0,0,2
Fremantle,"Darcy, Sean",5,2,1,3,1,0,33,3
Fremantle,"Grey, Brady",13,9,3,4,0,1,0,3
Fremantle,"Hill, Bradley",30,17,7,13,0,0,0,2
Fremantle,"Hill, Stephen",19,11,6,8,0,0,0,1
Fremantle,"Johnson, Michael",11,4,3,7,0,0,0,0
Fremantle,"Langdon, Ed",10,6,3,4,1,0,0,4
Fremantle,"Matera, Brandon",17,13,2,4,2,1,0,4
Fremantle,"McCarthy, Cam",10,8,6,2,2,0,0,4
Fremantle,"Mundy, David",27,8,4,19,0,0,0,10
Fremantle,"Neale, Lachie",26,7,3,19,1,0,0,6
Fremantle,"Pearce, Alex",6,1,1,5,0,0,0,0
Fremantle,"Ryan, Luke",14,12,9,2,0,0,0,0
Fremantle,"Taberner, Matthew",11,8,4,3,2,1,1,1
Fremantle,"Tucker, Darcy",11,7,4,4,0,0,0,2
Fremantle,"Walters, Michael",22,14,3,8,2,1,0,5
Fremantle,"Wilson, Nathan",17,13,2,4,0,0,0,0
Fremantle,"Ballantyne, Hayden",14,11,6,3,2,1,0,4
Fremantle,"Cerra, Adam",8,3,0,5,0,0,0,2
Fremantle,"Cox, Brennan",14,12,9,2,2,3,1,3
Fremantle,"Darcy, Sean",9,1,2,8,0,0,42,8
Fremantle,"Duman, Taylin",27,20,8,7,0,0,0,2
Fremantle,"Giro, Stefan",8,4,3,4,1,1,0,3
Fremantle,"Grey, Brady",9,4,2,5,1,0,0,6
Fremantle,"Hill, Bradley",16,10,3,6,0,1,0,1
Fremantle,"Johnson, Michael",12,10,6,2,0,0,0,2
Fremantle,"Kersten, Shane",14,11,8,3,1,0,0,3
Fremantle,"Langdon, Ed",31,16,12,15,1,0,0,1
Fremantle,"McCarthy, Cam",12,10,7,2,3,1,0,1
Fremantle,"Mundy, David",28,12,7,16,1,0,0,3
Fremantle,"Neale, Lachie",34,13,3,21,1,0,0,1
Fremantle,"Nyhuis, Ryan",11,7,1,4,0,0,0,2
Fremantle,"Pearce, Alex",13,6,7,7,0,0,0,0
Fremantle,"Ryan, Luke",15,11,4,4,0,0,0,1
Fremantle,"Sheridan, Tom",18,10,6,8,1,0,0,3
Fremantle,"Switkowski, Sam",13,6,3,7,0,0,0,3
Fremantle,"Taberner, Matthew",17,11,6,6,1,1,5,1
Fremantle,"Walters, Michael",15,10,2,5,0,0,0,5
Fremantle,"Wilson, Nathan",24,22,11,2,0,0,0,1
Fremantle,"Ballantyne, Hayden",4,2,1,2,0,1,0,2
Fremantle,"Banfield, Bailey",11,4,1,7,0,0,0,6
Fremantle,"Cerra, Adam",14,9,4,5,0,0,0,3
Fremantle,"Cox, Brennan",11,8,5,3,0,0,0,3
Fremantle,"Darcy, Sean",6,3,2,3,0,0,38,3
Fremantle,"Duman, Taylin",10,5,2,5,0,0,0,4
Fremantle,"Fyfe, Nat",37,23,6,14,0,1,0,2
Fremantle,"Giro, Stefan",13,8,4,5,0,0,0,1
Fremantle,"Grey, Brady",9,4,0,5,0,1,0,1
Fremantle,"Hill, Bradley",16,11,6,5,1,0,0,3
Fremantle,"Johnson, Michael",11,7,4,4,0,0,1,2
Fremantle,"Kersten, Shane",17,10,6,7,0,0,0,0
Fremantle,"Langdon, Ed",18,11,3,7,0,0,0,0
Fremantle,"McCarthy, Cam",4,3,3,1,0,2,0,5
Fremantle,"Mundy, David",22,13,4,9,1,0,0,4
Fremantle,"Neale, Lachie",26,8,2,18,0,0,0,11
Fremantle,"Nyhuis, Ryan",8,6,2,2,0,0,0,3
Fremantle,"Pearce, Alex",5,3,2,2,0,0,0,1
Fremantle,"Sheridan, Tom",12,6,1,6,1,0,0,3
Fremantle,"Taberner, Matthew",13,8,2,5,0,1,2,2
Fremantle,"Walters, Michael",15,6,1,9,0,0,0,1
Fremantle,"Wilson, Nathan",16,12,1,4,0,0,0,1
Fremantle,"Ballantyne, Hayden",14,8,3,6,4,1,0,2
Fremantle,"Cerra, Adam",11,7,3,4,0,0,0,6
Fremantle,"Cox, Brennan",11,7,2,4,0,0,0,5
Fremantle,"Darcy, Sean",8,2,4,6,0,0,35,3
Fremantle,"Duman, Taylin",24,15,8,9,0,0,0,7
Fremantle,"Fyfe, Nat",19,8,3,11,1,2,0,3
Fremantle,"Grey, Brady",15,6,3,9,0,1,0,3
Fremantle,"Hamling, Joel",19,10,8,9,0,0,0,1
Fremantle,"Hill, Bradley",35,26,5,9,0,1,0,2
Fremantle,"Hughes, Ethan",17,11,5,6,0,0,0,0
Fremantle,"Johnson, Michael",15,11,9,4,0,0,0,0
Fremantle,"Kersten, Shane",12,12,6,0,0,0,0,3
Fremantle,"Langdon, Ed",32,15,10,17,0,2,0,4
Fremantle,"McCarthy, Cam",17,11,3,6,0,1,0,1
Fremantle,"Mundy, David",16,8,1,8,1,0,0,3
Fremantle,"Neale, Lachie",34,12,4,22,1,0,0,4
Fremantle,"Pearce, Alex",22,11,8,11,0,0,0,0
Fremantle,"Sheridan, Tom",21,8,6,13,0,1,0,3
Fremantle,"Switkowski, Sam",17,10,5,7,1,1,0,3
Fremantle,"Taberner, Matthew",15,10,6,5,1,1,3,2
Fremantle,"Tucker, Darcy",11,3,0,8,0,1,0,2
Fremantle,"Wilson, Nathan",18,17,3,1,0,0,0,1
Gold Coast,"Ainsworth, Ben",11,5,1,6,2,0,0,4
Gold Coast,"Bowes, Jack",21,17,2,4,1,0,0,1
Gold Coast,"Day, Sam",10,6,2,4,0,0,8,3
Gold Coast,"Fiorini, Brayden",21,17,3,4,0,0,0,6
Gold Coast,"Harbrow, Jarrod",23,23,3,0,0,0,0,5
Gold Coast,"Holman, Nick",12,7,2,5,0,1,0,14
Gold Coast,"Joyce, Jesse",8,5,1,3,0,0,0,3
Gold Coast,"Kolodjashnij, Kade",17,14,6,3,0,0,0,1
Gold Coast,"Lynch, Tom",16,12,4,4,0,1,0,7
Gold Coast,"Lyons, Jarryd",22,18,2,4,1,0,0,2
Gold Coast,"Macpherson, Darcy",18,15,3,3,1,1,0,9
Gold Coast,"Martin, Jack",21,14,4,7,0,0,0,8
Gold Coast,"May, Steven",15,14,6,1,0,0,0,2
Gold Coast,"Miller, Touk",21,12,1,9,0,1,0,6
Gold Coast,"Rischitelli, Michael",17,14,5,3,0,0,0,3
Gold Coast,"Rosa, Matt",26,15,2,11,0,0,0,2
Gold Coast,"Sexton, Alex",18,14,1,4,1,3,0,2
Gold Coast,"Swallow, David",32,22,4,10,0,0,0,3
Gold Coast,"Thompson, Rory",4,3,0,1,0,0,0,2
Gold Coast,"Weller, Lachie",19,11,0,8,0,1,0,3
Gold Coast,"Witts, Jarrod",25,21,4,4,0,1,34,5
Gold Coast,"Young, Aaron",27,16,3,11,1,1,0,9
Gold Coast,"Ainsworth, Ben",11,5,0,6,1,1,0,4
Gold Coast,"Bowes, Jack",15,9,4,6,0,1,0,3
Gold Coast,"Day, Sam",12,8,6,4,0,1,9,1
Gold Coast,"Fiorini, Brayden",20,15,4,5,0,1,0,1
Gold Coast,"Hall, Aaron",20,14,4,6,0,1,0,4
Gold Coast,"Harbrow, Jarrod",17,11,2,6,0,0,0,3
Gold Coast,"Holman, Nick",15,6,2,9,0,0,0,11
Gold Coast,"Joyce, Jesse",16,12,6,4,0,0,0,3
Gold Coast,"Kolodjashnij, Kade",17,13,3,4,0,0,0,4
Gold Coast,"Lynch, Tom",21,16,4,5,8,1,0,4
Gold Coast,"Lyons, Jarryd",36,27,2,9,1,0,0,6
Gold Coast,"Macpherson, Darcy",15,13,7,2,1,0,0,10
Gold Coast,"Martin, Jack",15,12,2,3,3,1,0,6
Gold Coast,"May, Steven",13,8,7,5,0,0,1,3
Gold Coast,"Miller, Touk",17,5,5,12,0,1,0,8
Gold Coast,"Rischitelli, Michael",14,10,4,4,0,0,0,3
Gold Coast,"Sexton, Alex",9,5,2,4,0,0,0,4
Gold Coast,"Swallow, David",24,13,5,11,0,0,0,8
Gold Coast,"Thompson, Rory",7,5,3,2,0,0,0,0
Gold Coast,"Weller, Lachie",14,3,1,11,0,0,0,2
Gold Coast,"Witts, Jarrod",13,7,2,6,0,0,48,3
Gold Coast,"Young, Aaron",9,4,2,5,1,0,0,2
Gold Coast,"Ainsworth, Ben",13,10,3,3,0,0,0,2
Gold Coast,"Day, Sam",10,7,5,3,3,0,2,4
Gold Coast,"Fiorini, Brayden",19,13,4,6,0,1,0,3
Gold Coast,"Hall, Aaron",5,3,0,2,0,0,0,1
Gold Coast,"Hanley, Pearce",7,5,2,2,0,0,0,1
Gold Coast,"Harbrow, Jarrod",14,8,5,6,0,0,0,0
Gold Coast,"Holman, Nick",14,6,5,8,0,0,0,6
Gold Coast,"Joyce, Jesse",14,10,7,4,0,0,0,3
Gold Coast,"Kolodjashnij, Kade",22,16,7,6,0,0,0,2
Gold Coast,"Lynch, Tom",11,9,4,2,1,1,0,1
Gold Coast,"Lyons, Jarryd",30,18,6,12,2,0,0,10
Gold Coast,"Macpherson, Darcy",12,10,3,2,0,0,0,4
Gold Coast,"Martin, Jack",21,13,6,8,1,2,0,1
Gold Coast,"May, Steven",15,10,6,5,0,0,0,3
Gold Coast,"Miller, Touk",19,9,3,10,0,0,0,6
Gold Coast,"Rischitelli, Michael",9,8,4,1,0,0,0,1
Gold Coast,"Sexton, Alex",12,9,3,3,3,0,0,0
Gold Coast,"Swallow, David",21,14,4,7,0,0,0,6
Gold Coast,"Thompson, Rory",13,11,6,2,0,0,0,1
Gold Coast,"Weller, Lachie",19,14,7,5,0,2,0,1
Gold Coast,"Witts, Jarrod",11,8,3,3,0,0,27,0
Gold Coast,"Young, Aaron",13,9,2,4,0,2,0,3
Gold Coast,"Ainsworth, Ben",9,8,4,1,0,0,0,0
Gold Coast,"Bowes, Jack",12,8,7,4,0,0,0,1
Gold Coast,"Day, Sam",5,3,3,2,0,1,1,3
Gold Coast,"Fiorini, Brayden",20,16,8,4,1,1,0,3
Gold Coast,"Hall, Aaron",26,14,5,12,0,0,0,1
Gold Coast,"Harbrow, Jarrod",17,15,3,2,0,0,0,2
Gold Coast,"Holman, Nick",7,3,1,4,0,0,0,3
Gold Coast,"Joyce, Jesse",17,11,5,6,0,0,0,1
Gold Coast,"Kolodjashnij, Kade",14,13,9,1,0,0,0,2
Gold Coast,"Lynch, Tom",8,7,4,1,3,1,0,0
Gold Coast,"Lyons, Jarryd",26,10,1,16,0,1,0,4
Gold Coast,"Macpherson, Darcy",16,9,3,7,0,0,0,2
Gold Coast,"Martin, Jack",19,15,4,4,1,0,0,2
Gold Coast,"May, Steven",11,6,2,5,0,0,0,1
Gold Coast,"Miller, Touk",16,6,2,10,0,0,0,6
Gold Coast,"Rischitelli, Michael",7,3,0,4,0,0,0,1
Gold Coast,"Sexton, Alex",13,10,4,3,1,0,0,0
Gold Coast,"Swallow, David",29,14,7,15,1,0,0,3
Gold Coast,"Thompson, Rory",9,6,4,3,0,0,0,2
Gold Coast,"Weller, Lachie",23,17,6,6,0,0,0,3
Gold Coast,"Witts, Jarrod",11,7,0,4,0,0,17,4
Gold Coast,"Young, Aaron",17,8,7,9,2,0,0,1
Gold Coast,"Ainsworth, Ben",14,6,2,8,0,2,0,0
Gold Coast,"Bowes, Jack",12,8,4,4,0,1,0,4
Gold Coast,"Day, Sam",11,5,1,6,1,0,7,1
Gold Coast,"Fiorini, Brayden",27,20,9,7,2,0,0,1
Gold Coast,"Harbrow, Jarrod",25,20,6,5,0,0,0,3
Gold Coast,"Holman, Nick",18,9,2,9,1,1,0,2
Gold Coast,"Joyce, Jesse",11,4,1,7,0,0,0,2
Gold Coast,"Lonergan, Jesse",15,6,1,9,0,0,0,4
Gold Coast,"Lynch, Tom",13,9,4,4,2,1,0,1
Gold Coast,"Lyons, Jarryd",22,13,2,9,1,0,0,3
Gold Coast,"Macpherson, Darcy",9,7,0,2,2,1,0,2
Gold Coast,"Martin, Jack",19,16,9,3,0,0,0,2
Gold Coast,"May, Steven",17,13,8,4,1,0,0,1
Gold Coast,"Miller, Touk",21,13,5,8,0,0,0,4
Gold Coast,"Rischitelli, Michael",12,8,2,4,0,0,0,0
Gold Coast,"Rosa, Matt",21,10,4,11,0,0,0,4
Gold Coast,"Sexton, Alex",14,11,7,3,0,0,0,4
Gold Coast,"Swallow, David",21,14,6,7,0,1,0,3
Gold Coast,"Thompson, Rory",8,4,3,4,0,0,0,2
Gold Coast,"Weller, Lachie",23,12,9,11,0,0,0,1
Gold Coast,"Witts, Jarrod",16,7,1,9,0,0,27,7
Gold Coast,"Young, Aaron",19,12,5,7,1,0,0,3
Gold Coast,"Ainsworth, Ben",9,3,1,6,1,0,0,5
Gold Coast,"Barlow, Michael",23,9,6,14,1,0,0,3
Gold Coast,"Bowes, Jack",15,9,3,6,0,0,0,4
Gold Coast,"Day, Sam",11,7,3,4,0,0,5,2
Gold Coast,"Fiorini, Brayden",22,11,3,11,0,0,0,3
Gold Coast,"Harbrow, Jarrod",13,9,4,4,0,0,0,0
Gold Coast,"Holman, Nick",8,4,0,4,0,1,0,3
Gold Coast,"Joyce, Jesse",17,12,8,5,0,0,0,1
Gold Coast,"Lonergan, Jesse",16,4,5,12,1,0,0,9
Gold Coast,"Lynch, Tom",10,5,5,5,0,0,0,1
Gold Coast,"Lyons, Jarryd",25,16,5,9,0,1,0,13
Gold Coast,"Martin, Jack",12,9,4,3,1,2,0,4
Gold Coast,"May, Steven",22,16,10,6,0,0,0,2
Gold Coast,"Miller, Touk",20,10,4,10,1,0,0,10
Gold Coast,"Rosa, Matt",17,7,2,10,0,0,0,1
Gold Coast,"Sexton, Alex",12,8,3,4,1,0,0,7
Gold Coast,"Spencer, Max",7,4,3,3,0,1,0,3
Gold Coast,"Swallow, David",32,21,4,11,3,0,0,4
Gold Coast,"Thompson, Rory",8,4,4,4,0,0,0,0
Gold Coast,"Weller, Lachie",25,13,4,12,0,1,0,1
Gold Coast,"Witts, Jarrod",12,6,0,6,0,0,31,4
Gold Coast,"Young, Aaron",13,9,1,4,0,0,0,4
Gold Coast,"Ah Chee, Callum",17,11,5,6,0,0,0,2
Gold Coast,"Ainsworth, Ben",26,14,4,12,0,2,0,2
Gold Coast,"Ballard, Charlie",7,6,4,1,1,0,0,2
Gold Coast,"Bowes, Jack",21,14,5,7,0,0,0,2
Gold Coast,"Crossley, Brayden",13,7,2,6,1,1,7,5
Gold Coast,"Day, Sam",16,6,4,10,2,1,0,2
Gold Coast,"Harbrow, Jarrod",20,14,2,6,0,0,0,1
Gold Coast,"Holman, Nick",14,4,2,10,0,0,0,11
Gold Coast,"Joyce, Jesse",11,5,3,6,0,0,0,2
Gold Coast,"Lyons, Jarryd",11,5,0,6,0,1,0,8
Gold Coast,"Martin, Jack",23,11,7,12,2,0,0,6
Gold Coast,"Miller, Touk",26,13,2,13,1,0,0,9
Gold Coast,"Rischitelli, Michael",11,7,1,4,0,0,0,7
Gold Coast,"Rosa, Matt",24,13,2,11,0,1,0,4
Gold Coast,"Scheer, Brad",14,7,3,7,0,1,0,7
Gold Coast,"Sexton, Alex",13,7,0,6,1,1,0,3
Gold Coast,"Spencer, Max",8,4,1,4,0,0,0,2
Gold Coast,"Swallow, David",25,12,0,13,0,0,0,3
Gold Coast,"Thompson, Rory",13,6,2,7,0,0,0,3
Gold Coast,"Weller, Lachie",22,12,4,10,0,0,0,2
Gold Coast,"Witts, Jarrod",21,8,3,13,0,0,58,3
Gold Coast,"Young, Aaron",22,10,4,12,2,1,0,5
Gold Coast,"Ah Chee, Callum",16,13,3,3,0,0,0,1
Gold Coast,"Ainsworth, Ben",19,8,2,11,0,1,0,4
Gold Coast,"Ballard, Charlie",9,7,5,2,0,1,0,1
Gold Coast,"Bowes, Jack",9,7,3,2,0,0,0,2
Gold Coast,"Crossley, Brayden",8,4,3,4,0,0,8,1
Gold Coast,"Day, Sam",14,6,5,8,2,2,1,4
Gold Coast,"Hall, Aaron",23,18,8,5,1,0,0,3
Gold Coast,"Harbrow, Jarrod",18,8,0,10,0,0,0,4
Gold Coast,"Holman, Nick",10,3,4,7,1,0,0,1
Gold Coast,"Leslie, Jack",6,4,3,2,0,0,0,3
Gold Coast,"Lyons, Jarryd",22,11,6,11,0,0,0,4
Gold Coast,"Martin, Jack",19,15,5,4,4,0,0,2
Gold Coast,"May, Steven",21,16,8,5,1,0,0,2
Gold Coast,"Miller, Touk",28,10,4,18,0,1,0,8
Gold Coast,"Rischitelli, Michael",12,8,2,4,0,0,0,1
Gold Coast,"Scheer, Brad",18,13,3,5,0,0,0,1
Gold Coast,"Sexton, Alex",12,9,6,3,1,2,0,0
Gold Coast,"Swallow, David",12,5,0,7,0,0,0,3
Gold Coast,"Thompson, Rory",5,3,1,2,0,0,0,1
Gold Coast,"Weller, Lachie",19,16,4,3,0,0,0,2
Gold Coast,"Witts, Jarrod",11,4,2,7,0,0,29,6
Gold Coast,"Young, Aaron",18,9,2,9,1,2,0,1
Gold Coast,"Ah Chee, Callum",11,8,3,3,0,1,0,4
Gold Coast,"Ainsworth, Ben",19,13,5,6,0,0,0,7
Gold Coast,"Ballard, Charlie",6,3,0,3,0,0,0,1
Gold Coast,"Bowes, Jack",7,4,1,3,1,0,0,3
Gold Coast,"Crossley, Brayden",7,5,0,2,0,0,6,2
Gold Coast,"Hall, Aaron",29,18,7,11,0,0,0,5
Gold Coast,"Harbrow, Jarrod",27,22,6,5,0,0,0,9
Gold Coast,"Heron, Jacob",10,4,0,6,1,0,0,3
Gold Coast,"Holman, Nick",25,12,3,13,0,1,0,8
Gold Coast,"Leslie, Jack",5,5,2,0,0,0,0,2
Gold Coast,"Lyons, Jarryd",22,13,3,9,0,0,0,4
Gold Coast,"May, Steven",16,12,4,4,0,0,0,2
Gold Coast,"Miller, Touk",21,6,4,15,1,0,0,5
Gold Coast,"Rischitelli, Michael",15,12,2,3,0,0,0,1
Gold Coast,"Rosa, Matt",8,4,1,4,1,0,0,1
Gold Coast,"Scheer, Brad",13,7,2,6,0,0,0,3
Gold Coast,"Sexton, Alex",10,6,0,4,0,1,0,5
Gold Coast,"Swallow, David",18,11,3,7,0,0,0,5
Gold Coast,"Thompson, Rory",11,6,1,5,0,0,0,0
Gold Coast,"Weller, Lachie",19,11,2,8,1,0,0,6
Gold Coast,"Witts, Jarrod",22,12,2,10,1,2,43,3
Gold Coast,"Young, Aaron",15,11,1,4,0,0,0,4
Gold Coast,"Ah Chee, Callum",12,9,6,3,1,2,0,3
Gold Coast,"Ainsworth, Ben",20,16,5,4,0,1,0,3
Gold Coast,"Ballard, Charlie",13,11,5,2,0,1,0,1
Gold Coast,"Bowes, Jack",12,9,6,3,0,0,0,2
Gold Coast,"Brodie, Will",14,10,6,4,0,0,0,2
Gold Coast,"Day, Sam",9,5,4,4,1,0,5,2
Gold Coast,"Hall, Aaron",8,8,5,0,0,0,0,0
Gold Coast,"Harbrow, Jarrod",18,13,6,5,0,0,0,2
Gold Coast,"Heron, Jacob",8,3,2,5,0,0,0,0
Gold Coast,"Holman, Nick",19,10,6,9,0,0,0,6
Gold Coast,"Joyce, Jesse",9,6,7,3,0,0,0,0
Gold Coast,"Lynch, Tom",11,7,6,4,1,3,0,0
Gold Coast,"Martin, Jack",14,10,5,4,0,3,0,1
Gold Coast,"May, Steven",15,14,10,1,0,0,0,2
Gold Coast,"Miller, Touk",27,15,3,12,1,0,0,3
Gold Coast,"Rischitelli, Michael",11,7,5,4,0,0,0,3
Gold Coast,"Sexton, Alex",12,9,7,3,0,0,0,0
Gold Coast,"Swallow, David",23,12,9,11,0,0,0,3
Gold Coast,"Thompson, Rory",11,9,4,2,0,0,0,2
Gold Coast,"Weller, Lachie",14,7,4,7,0,0,0,4
Gold Coast,"Witts, Jarrod",11,6,2,5,0,0,47,0
Gold Coast,"Young, Aaron",6,4,3,2,0,1,0,2
Gold Coast,"Ah Chee, Callum",16,10,3,6,0,0,0,4
Gold Coast,"Ainsworth, Ben",16,9,3,7,0,0,0,7
Gold Coast,"Ballard, Charlie",12,8,4,4,0,0,0,2
Gold Coast,"Bowes, Jack",15,9,2,6,0,0,0,2
Gold Coast,"Brodie, Will",14,7,3,7,1,0,0,7
Gold Coast,"Day, Sam",7,1,2,6,0,0,12,2
Gold Coast,"Harbrow, Jarrod",27,24,4,3,1,0,0,3
Gold Coast,"Heron, Jacob",7,4,1,3,0,0,0,3
Gold Coast,"Holman, Nick",7,5,2,2,0,0,0,9
Gold Coast,"Joyce, Jesse",14,5,4,9,0,0,0,3
Gold Coast,"Leslie, Jack",14,11,2,3,0,0,0,4
Gold Coast,"Lynch, Tom",8,5,2,3,0,0,0,2
Gold Coast,"Martin, Jack",8,5,1,3,0,0,0,8
Gold Coast,"Miller, Touk",21,5,2,16,0,0,0,8
Gold Coast,"Rischitelli, Michael",11,10,3,1,0,0,0,3
Gold Coast,"Scheer, Brad",8,6,2,2,0,0,0,6
Gold Coast,"Sexton, Alex",14,11,4,3,0,0,0,1
Gold Coast,"Swallow, David",20,15,1,5,0,0,0,3
Gold Coast,"Thompson, Rory",5,4,2,1,0,0,0,2
Gold Coast,"Weller, Lachie",13,9,3,4,0,0,0,1
Gold Coast,"Witts, Jarrod",16,7,1,9,0,0,64,3
Gold Coast,"Young, Aaron",15,12,4,3,2,1,0,6
Gold Coast,"Ah Chee, Callum",13,10,3,3,1,0,0,2
Gold Coast,"Ainsworth, Ben",15,11,6,4,1,1,0,5
Gold Coast,"Ballard, Charlie",16,10,8,6,0,0,0,1
Gold Coast,"Bowes, Jack",16,12,6,4,0,1,0,1
Gold Coast,"Day, Sam",6,2,3,4,0,0,1,3
Gold Coast,"Harbrow, Jarrod",22,18,3,4,0,0,0,1
Gold Coast,"Holman, Nick",14,7,2,7,2,0,0,5
Gold Coast,"Joyce, Jesse",13,9,2,4,0,0,0,1
Gold Coast,"Lemmens, Sean",12,10,5,2,1,0,0,5
Gold Coast,"Leslie, Jack",12,10,8,2,0,0,0,1
Gold Coast,"Lynch, Tom",16,8,6,8,3,1,0,4
Gold Coast,"Lyons, Jarryd",23,12,2,11,0,1,0,8
Gold Coast,"Martin, Jack",16,10,5,6,0,1,0,9
Gold Coast,"Miller, Touk",12,3,4,9,0,0,0,4
Gold Coast,"Rischitelli, Michael",6,3,1,3,0,0,0,1
Gold Coast,"Schoenfeld, Josh",11,7,4,4,0,1,0,5
Gold Coast,"Sexton, Alex",9,7,2,2,3,0,0,2
Gold Coast,"Swallow, David",21,11,5,10,0,0,0,9
Gold Coast,"Thompson, Rory",3,1,1,2,0,0,0,0
Gold Coast,"Weller, Lachie",19,15,5,4,0,1,0,1
Gold Coast,"Witts, Jarrod",9,6,2,3,0,0,40,3
Gold Coast,"Young, Aaron",11,9,3,2,0,1,0,2
Gold Coast,"Ah Chee, Callum",15,13,4,2,0,1,0,6
Gold Coast,"Ainsworth, Ben",11,5,2,6,0,1,0,1
Gold Coast,"Ballard, Charlie",10,7,1,3,0,0,0,0
Gold Coast,"Dawson, Jacob",11,4,2,7,0,0,0,1
Gold Coast,"Day, Sam",7,5,2,2,0,0,0,1
Gold Coast,"Harbrow, Jarrod",23,17,3,6,0,0,0,2
Gold Coast,"Holman, Nick",9,2,1,7,0,1,0,6
Gold Coast,"Joyce, Jesse",11,5,6,6,0,0,0,2
Gold Coast,"Lemmens, Sean",10,9,2,1,0,1,0,4
Gold Coast,"Leslie, Jack",9,2,6,7,0,0,0,3
Gold Coast,"Lynch, Tom",13,11,8,2,2,1,0,2
Gold Coast,"Lyons, Jarryd",29,19,2,10,0,0,0,3
Gold Coast,"Martin, Jack",16,12,3,4,0,1,0,9
Gold Coast,"Miller, Touk",21,9,1,12,0,0,0,8
Gold Coast,"Rischitelli, Michael",16,9,4,7,0,0,0,3
Gold Coast,"Schoenfeld, Josh",20,10,5,10,0,1,0,3
Gold Coast,"Sexton, Alex",14,6,2,8,1,1,0,2
Gold Coast,"Swallow, David",22,11,2,11,0,1,0,7
Gold Coast,"Weller, Lachie",14,10,2,4,0,0,0,3
Gold Coast,"Witts, Jarrod",5,1,0,4,0,0,35,3
Gold Coast,"Wright, Peter",11,6,5,5,2,2,8,1
Gold Coast,"Young, Aaron",17,11,4,6,0,1,0,1
Gold Coast,"Ainsworth, Ben",12,4,2,8,0,1,0,3
Gold Coast,"Ballard, Charlie",6,5,1,1,0,0,0,2
Gold Coast,"Crossley, Brayden",9,5,3,4,1,2,5,3
Gold Coast,"Dawson, Jacob",17,5,2,12,1,0,0,3
Gold Coast,"Harbrow, Jarrod",29,25,12,4,0,0,0,1
Gold Coast,"Holman, Nick",18,10,3,8,2,1,0,5
Gold Coast,"Joyce, Jesse",18,14,7,4,0,0,0,2
Gold Coast,"Lemmens, Sean",14,8,2,6,0,0,0,5
Gold Coast,"Lyons, Jarryd",32,17,3,15,0,1,0,6
Gold Coast,"Martin, Jack",22,12,4,10,1,1,0,4
Gold Coast,"May, Steven",25,18,14,7,0,0,0,1
Gold Coast,"Miller, Touk",33,16,6,17,0,1,0,3
Gold Coast,"Powell, Wil",10,7,4,3,1,0,0,1
Gold Coast,"Rischitelli, Michael",10,6,4,4,0,0,0,1
Gold Coast,"Schoenfeld, Josh",17,5,3,12,1,1,0,2
Gold Coast,"Sexton, Alex",16,8,5,8,0,0,0,1
Gold Coast,"Swallow, David",32,17,6,15,0,1,0,6
Gold Coast,"Thompson, Rory",12,6,1,6,0,0,0,0
Gold Coast,"Weller, Lachie",26,22,10,4,0,0,0,3
Gold Coast,"Witts, Jarrod",15,6,3,9,0,0,25,3
Gold Coast,"Wright, Peter",7,3,2,4,0,0,4,4
Gold Coast,"Young, Aaron",18,10,4,8,1,1,0,3
Gold Coast,"Ah Chee, Callum",18,5,5,13,0,1,0,2
Gold Coast,"Ballard, Charlie",8,4,3,4,0,0,0,1
Gold Coast,"Brodie, Will",24,7,2,17,0,0,0,4
Gold Coast,"Crossley, Brayden",9,4,2,5,1,1,9,0
Gold Coast,"Harbrow, Jarrod",25,22,3,3,0,0,0,2
Gold Coast,"Holman, Nick",9,3,1,6,1,1,0,6
Gold Coast,"Joyce, Jesse",12,11,4,1,0,0,0,0
Gold Coast,"Lemmens, Sean",8,5,2,3,0,1,0,3
Gold Coast,"Lyons, Jarryd",26,15,1,11,0,2,0,7
Gold Coast,"Martin, Jack",22,9,7,13,1,0,0,4
Gold Coast,"May, Steven",15,11,5,4,0,0,0,0
Gold Coast,"Miller, Touk",24,7,7,17,1,0,0,6
Gold Coast,"Powell, Wil",15,9,5,6,0,0,0,1
Gold Coast,"Rischitelli, Michael",7,2,0,5,0,0,0,0
Gold Coast,"Schoenfeld, Josh",15,8,6,7,0,2,0,3
Gold Coast,"Sexton, Alex",15,9,3,6,1,0,0,1
Gold Coast,"Swallow, David",14,2,1,12,0,0,0,5
Gold Coast,"Thompson, Rory",9,7,3,2,0,0,0,2
Gold Coast,"Weller, Lachie",25,14,5,11,0,0,0,2
Gold Coast,"Witts, Jarrod",19,8,7,11,1,1,36,5
Gold Coast,"Wright, Peter",15,10,9,5,1,1,0,2
Gold Coast,"Young, Aaron",16,9,2,7,1,0,0,4
Gold Coast,"Ah Chee, Callum",8,4,3,4,0,0,0,2
Gold Coast,"Ballard, Charlie",13,9,6,4,0,0,0,2
Gold Coast,"Brodie, Will",14,5,2,9,0,0,0,3
Gold Coast,"Crossley, Brayden",7,2,2,5,0,0,7,4
Gold Coast,"Harbrow, Jarrod",25,19,4,6,0,0,0,0
Gold Coast,"Holman, Nick",11,6,7,5,3,0,0,1
Gold Coast,"Joyce, Jesse",13,10,5,3,0,0,0,1
Gold Coast,"Lemmens, Sean",16,8,1,8,0,0,0,2
Gold Coast,"Lyons, Jarryd",23,17,2,6,0,3,0,6
Gold Coast,"Martin, Jack",20,11,4,9,0,0,0,7
Gold Coast,"May, Steven",19,17,10,2,0,1,0,1
Gold Coast,"Miller, Touk",24,11,3,13,0,1,0,2
Gold Coast,"Powell, Wil",3,2,2,1,0,1,0,2
Gold Coast,"Rischitelli, Michael",7,7,2,0,0,0,0,2
Gold Coast,"Schoenfeld, Josh",6,2,1,4,0,1,0,1
Gold Coast,"Sexton, Alex",20,12,5,8,1,4,0,2
Gold Coast,"Swallow, David",15,6,0,9,0,1,0,5
Gold Coast,"Thompson, Rory",12,7,5,5,0,0,0,3
Gold Coast,"Weller, Lachie",21,10,4,11,0,0,0,2
Gold Coast,"Witts, Jarrod",12,7,2,5,0,0,30,4
Gold Coast,"Wright, Peter",9,7,4,2,0,1,0,5
Gold Coast,"Young, Aaron",11,10,3,1,2,1,0,4
Gold Coast,"Ah Chee, Callum",10,8,3,2,0,0,0,3
Gold Coast,"Ballard, Charlie",13,9,2,4,0,0,0,2
Gold Coast,"Brodie, Will",27,10,2,17,0,0,0,6
Gold Coast,"Crossley, Brayden",10,3,1,7,0,1,3,5
Gold Coast,"Harbrow, Jarrod",13,10,3,3,0,0,0,1
Gold Coast,"Heron, Jacob",12,8,4,4,1,3,0,1
Gold Coast,"Holman, Nick",17,10,4,7,1,2,0,5
Gold Coast,"Joyce, Jesse",16,9,5,7,0,0,0,2
Gold Coast,"Kolodjashnij, Kade",20,11,7,9,0,1,0,1
Gold Coast,"Lemmens, Sean",16,7,1,9,0,3,0,3
Gold Coast,"Lonergan, Jesse",14,6,0,8,0,0,0,3
Gold Coast,"Lyons, Jarryd",20,10,3,10,0,0,0,5
Gold Coast,"May, Steven",23,18,14,5,0,0,0,1
Gold Coast,"Miller, Touk",25,14,1,11,1,0,0,5
Gold Coast,"Powell, Wil",7,4,0,3,0,0,0,1
Gold Coast,"Rischitelli, Michael",8,6,2,2,0,0,0,2
Gold Coast,"Sexton, Alex",16,11,4,5,3,1,0,4
Gold Coast,"Thompson, Rory",4,0,0,4,0,0,0,3
Gold Coast,"Weller, Lachie",23,16,7,7,2,1,0,3
Gold Coast,"Witts, Jarrod",14,6,2,8,0,2,56,9
Gold Coast,"Wright, Peter",20,10,9,10,0,0,0,4
Gold Coast,"Young, Aaron",17,13,4,4,4,1,0,7
Gold Coast,"Bowes, Jack",20,13,2,7,1,0,0,1
Gold Coast,"Brodie, Will",27,12,0,15,0,1,0,6
Gold Coast,"Fiorini, Brayden",13,10,2,3,0,0,0,9
Gold Coast,"Harbrow, Jarrod",24,20,2,4,0,0,0,1
Gold Coast,"Heron, Jacob",4,2,0,2,0,0,0,4
Gold Coast,"Holman, Nick",9,3,1,6,0,0,0,4
Gold Coast,"Joyce, Jesse",12,8,1,4,0,0,0,1
Gold Coast,"Kolodjashnij, Kade",10,7,5,3,0,1,0,0
Gold Coast,"Lemmens, Sean",10,6,1,4,0,1,0,4
Gold Coast,"Lonergan, Jesse",22,9,1,13,0,0,0,9
Gold Coast,"Lyons, Jarryd",29,18,2,11,0,1,0,3
Gold Coast,"May, Steven",17,15,7,2,1,2,0,4
Gold Coast,"Miller, Touk",24,5,1,19,0,1,0,7
Gold Coast,"Powell, Wil",9,6,2,3,1,2,0,3
Gold Coast,"Rischitelli, Michael",10,6,3,4,0,0,0,8
Gold Coast,"Sexton, Alex",13,10,1,3,0,3,0,4
Gold Coast,"Swallow, David",9,6,0,3,0,0,0,2
Gold Coast,"Thompson, Rory",5,2,2,3,0,1,0,3
Gold Coast,"Weller, Lachie",20,8,1,12,0,0,0,7
Gold Coast,"Witts, Jarrod",13,9,3,4,0,0,60,3
Gold Coast,"Wright, Peter",9,6,3,3,2,0,8,1
Gold Coast,"Young, Aaron",12,10,0,2,0,0,0,7
Gold Coast,"Ah Chee, Callum",22,11,5,11,0,0,0,0
Gold Coast,"Bowes, Jack",14,11,6,3,0,0,0,0
Gold Coast,"Brodie, Will",23,8,2,15,0,0,0,3
Gold Coast,"Dawson, Jacob",18,4,3,14,0,0,0,2
Gold Coast,"Fiorini, Brayden",15,11,2,4,0,1,0,10
Gold Coast,"Hanley, Pearce",18,10,3,8,0,0,0,3
Gold Coast,"Harbrow, Jarrod",22,15,5,7,0,0,0,1
Gold Coast,"Heron, Jacob",12,2,2,10,0,0,0,0
Gold Coast,"Holman, Nick",6,5,2,1,1,0,0,4
Gold Coast,"Kolodjashnij, Kade",18,15,5,3,0,0,0,2
Gold Coast,"Lemmens, Sean",8,4,3,4,0,0,0,7
Gold Coast,"Leslie, Jack",10,8,4,2,0,3,8,3
Gold Coast,"Lonergan, Jesse",13,6,3,7,0,0,0,7
Gold Coast,"Miller, Touk",25,5,5,20,0,0,0,7
Gold Coast,"Powell, Wil",8,5,4,3,0,1,0,4
Gold Coast,"Rischitelli, Michael",9,6,0,3,1,0,0,1
Gold Coast,"Sexton, Alex",10,7,2,3,5,0,0,1
Gold Coast,"Spencer, Max",11,5,2,6,0,0,0,0
Gold Coast,"Weller, Lachie",16,11,5,5,0,0,0,5
Gold Coast,"Witts, Jarrod",10,6,1,4,0,0,40,6
Gold Coast,"Wright, Peter",1,1,1,0,0,0,0,1
Gold Coast,"Young, Aaron",13,6,3,7,0,0,0,4
Gold Coast,"Ah Chee, Callum",15,6,3,9,1,1,0,4
Gold Coast,"Ainsworth, Ben",17,9,2,8,0,1,0,1
Gold Coast,"Bowes, Jack",26,18,10,8,0,1,0,4
Gold Coast,"Brodie, Will",8,3,1,5,0,0,0,3
Gold Coast,"Crossley, Brayden",12,8,6,4,0,2,8,0
Gold Coast,"Fiorini, Brayden",29,14,4,15,0,0,0,6
Gold Coast,"Hanley, Pearce",23,15,8,8,0,0,0,2
Gold Coast,"Harbrow, Jarrod",24,13,6,11,0,0,0,0
Gold Coast,"Holman, Nick",14,4,2,10,1,0,0,6
Gold Coast,"Joyce, Jesse",17,7,5,10,0,0,0,2
Gold Coast,"Kolodjashnij, Kade",12,8,2,4,0,0,0,3
Gold Coast,"Leslie, Jack",4,1,1,3,1,0,0,0
Gold Coast,"Lyons, Jarryd",26,14,2,12,0,1,0,3
Gold Coast,"May, Steven",15,11,7,4,0,0,1,0
Gold Coast,"Miller, Touk",22,11,4,11,0,0,0,3
Gold Coast,"Powell, Wil",9,4,1,5,0,0,0,2
Gold Coast,"Rischitelli, Michael",14,6,5,8,0,0,0,0
Gold Coast,"Sexton, Alex",12,8,1,4,1,0,0,3
Gold Coast,"Swallow, David",26,12,5,14,1,0,0,4
Gold Coast,"Weller, Lachie",15,7,2,8,1,1,0,0
Gold Coast,"Witts, Jarrod",14,4,3,10,0,0,33,3
Gold Coast,"Young, Aaron",11,10,6,1,1,0,0,3
Gold Coast,"Ah Chee, Callum",10,9,3,1,0,0,0,1
Gold Coast,"Ainsworth, Ben",15,5,3,10,1,1,0,4
Gold Coast,"Barlow, Michael",20,10,6,10,0,0,0,0
Gold Coast,"Bowes, Jack",19,14,3,5,1,1,0,3
Gold Coast,"Crossley, Brayden",7,3,1,4,1,0,4,1
Gold Coast,"Fiorini, Brayden",32,21,4,11,1,0,0,3
Gold Coast,"Harbrow, Jarrod",23,14,5,9,0,0,0,1
Gold Coast,"Heron, Jacob",10,2,1,8,0,0,0,5
Gold Coast,"Holman, Nick",11,7,4,4,1,1,0,3
Gold Coast,"Joyce, Jesse",21,12,6,9,0,0,0,0
Gold Coast,"Lemmens, Sean",9,3,1,6,0,1,0,2
Gold Coast,"Leslie, Jack",4,3,2,1,0,0,2,0
Gold Coast,"Lyons, Jarryd",20,14,3,6,1,2,0,4
Gold Coast,"May, Steven",17,12,4,5,0,0,2,2
Gold Coast,"Miller, Touk",15,3,4,12,0,0,0,2
Gold Coast,"Rischitelli, Michael",11,7,2,4,0,0,0,1
Gold Coast,"Scheer, Brad",9,6,4,3,0,1,0,6
Gold Coast,"Sexton, Alex",19,11,4,8,4,0,0,4
Gold Coast,"Swallow, David",25,15,6,10,0,0,0,3
Gold Coast,"Weller, Lachie",22,13,4,9,0,1,0,3
Gold Coast,"Witts, Jarrod",14,6,2,8,0,0,31,4
Gold Coast,"Young, Aaron",14,4,2,10,1,0,0,3
Gold Coast,"Ah Chee, Callum",21,10,2,11,0,0,0,3
Gold Coast,"Barlow, Michael",35,18,9,17,0,2,0,5
Gold Coast,"Bowes, Jack",25,12,3,13,0,0,0,4
Gold Coast,"Crossley, Brayden",12,4,4,8,1,0,3,1
Gold Coast,"Fiorini, Brayden",23,12,4,11,0,1,0,4
Gold Coast,"Harbrow, Jarrod",26,19,6,7,0,0,0,6
Gold Coast,"Heron, Jacob",7,3,3,4,0,0,0,2
Gold Coast,"Holman, Nick",15,7,2,8,0,0,0,2
Gold Coast,"Joyce, Jesse",20,10,5,10,0,0,0,0
Gold Coast,"Lemmens, Sean",10,5,4,5,0,0,0,2
Gold Coast,"Leslie, Jack",2,0,0,2,0,0,0,0
Gold Coast,"Lyons, Jarryd",23,14,4,9,1,1,0,4
Gold Coast,"May, Steven",19,13,5,6,0,0,0,2
Gold Coast,"Miller, Touk",23,10,6,13,0,1,0,3
Gold Coast,"Rischitelli, Michael",15,7,4,8,0,0,0,2
Gold Coast,"Scheer, Brad",13,9,4,4,1,0,0,3
Gold Coast,"Schoenfeld, Josh",10,5,4,5,1,0,0,1
Gold Coast,"Sexton, Alex",17,14,6,3,1,3,0,1
Gold Coast,"Swallow, David",20,10,5,10,0,0,0,6
Gold Coast,"Weller, Lachie",22,7,4,15,0,0,0,2
Gold Coast,"Witts, Jarrod",6,4,1,2,0,0,43,5
Gold Coast,"Young, Aaron",13,7,3,6,0,1,0,2
Geelong,"Ablett, Gary",39,22,5,17,1,1,0,1
Geelong,"Bews, Jed",10,6,4,4,0,0,0,1
Geelong,"Blicavs, Mark",9,2,1,7,0,0,1,4
Geelong,"Duncan, Mitch",26,15,10,11,0,0,0,4
Geelong,"Fogarty, Lachie",20,8,4,12,1,0,0,2
Geelong,"Gregson, Cory",11,5,2,6,0,0,0,3
Geelong,"Guthrie, Cameron",20,11,3,9,1,0,0,0
Geelong,"Guthrie, Zach",22,14,6,8,0,0,0,2
Geelong,"Hawkins, Tom",14,8,6,6,0,1,1,1
Geelong,"Kelly, Tim",27,10,3,17,1,0,0,2
Geelong,"Kolodjashnij, Jake",20,10,5,10,0,1,0,1
Geelong,"Menegola, Sam",18,8,4,10,0,0,0,6
Geelong,"Menzel, Daniel",15,11,6,4,4,2,0,0
Geelong,"Murdoch, Jordan",24,13,5,11,1,1,0,5
Geelong,"Parfitt, Brandan",22,13,3,9,2,2,0,4
Geelong,"Parsons, James",17,8,8,9,1,1,0,2
Geelong,"Ratugolea, Esava",8,5,5,3,1,1,5,0
Geelong,"Selwood, Joel",39,17,4,22,0,2,0,5
Geelong,"Smith, Zac",11,3,3,8,1,0,23,2
Geelong,"Stewart, Tom",17,11,7,6,0,0,0,0
Geelong,"Taylor, Harry",4,2,2,2,0,0,0,0
Geelong,"Tuohy, Zach",25,18,7,7,0,0,0,0
Geelong,"Ablett, Gary",35,17,7,18,1,1,0,6
Geelong,"Bews, Jed",8,5,5,3,0,1,0,2
Geelong,"Blicavs, Mark",18,9,5,9,0,0,7,4
Geelong,"Cockatoo, Nakia",10,3,1,7,0,0,0,1
Geelong,"Dangerfield, Patrick",31,16,4,15,2,1,0,3
Geelong,"Fogarty, Lachie",8,5,1,3,1,0,0,3
Geelong,"Gregson, Cory",11,9,5,2,1,0,0,2
Geelong,"Guthrie, Cameron",25,11,3,14,0,0,0,1
Geelong,"Guthrie, Zach",12,9,5,3,0,0,0,1
Geelong,"Hawkins, Tom",11,9,7,2,1,1,0,3
Geelong,"Henry, Jack",5,3,2,2,0,0,0,2
Geelong,"Kelly, Tim",27,20,6,7,1,0,0,4
Geelong,"Kolodjashnij, Jake",15,8,5,7,0,0,0,0
Geelong,"Menegola, Sam",14,7,4,7,1,0,0,0
Geelong,"Menzel, Daniel",17,11,7,6,4,1,0,2
Geelong,"OConnor, Mark",12,8,7,4,0,0,0,2
Geelong,"Parfitt, Brandan",15,6,1,9,1,0,0,5
Geelong,"Parsons, James",7,6,3,1,2,0,0,1
Geelong,"Selwood, Joel",29,9,5,20,1,0,0,5
Geelong,"Stanley, Rhys",11,4,2,7,2,0,28,2
Geelong,"Stewart, Tom",24,18,7,6,0,0,0,2
Geelong,"Tuohy, Zach",27,20,10,7,0,0,0,0
Geelong,"Ablett, Gary",26,13,2,13,0,0,0,1
Geelong,"Bews, Jed",22,14,8,8,1,0,0,0
Geelong,"Blicavs, Mark",12,5,2,7,0,0,17,8
Geelong,"Cockatoo, Nakia",15,11,5,4,0,2,0,3
Geelong,"Dangerfield, Patrick",33,15,2,18,0,1,0,3
Geelong,"Fogarty, Lachie",14,12,4,2,1,4,0,1
Geelong,"Gregson, Cory",17,9,6,8,0,0,0,3
Geelong,"Guthrie, Cameron",4,2,0,2,0,0,0,0
Geelong,"Guthrie, Zach",14,10,5,4,0,0,0,2
Geelong,"Hawkins, Tom",15,10,7,5,3,3,3,2
Geelong,"Henry, Jack",16,11,6,5,0,0,0,1
Geelong,"Kelly, Tim",19,9,3,10,1,0,0,5
Geelong,"Kolodjashnij, Jake",16,12,9,4,0,0,0,1
Geelong,"Menegola, Sam",29,12,6,17,1,0,0,7
Geelong,"Menzel, Daniel",8,6,5,2,1,1,0,0
Geelong,"Parfitt, Brandan",20,11,5,9,0,0,0,4
Geelong,"Parsons, James",12,8,3,4,0,0,0,2
Geelong,"Ratugolea, Esava",14,9,8,5,2,1,7,2
Geelong,"Selwood, Joel",21,10,5,11,0,0,0,7
Geelong,"Selwood, Scott",14,5,2,9,0,0,0,6
Geelong,"Stewart, Tom",20,15,8,5,0,0,0,2
Geelong,"Tuohy, Zach",22,15,4,7,1,0,0,2
Geelong,"Bews, Jed",15,11,7,4,0,0,0,1
Geelong,"Blicavs, Mark",13,5,3,8,0,0,0,2
Geelong,"Cunico, Jordan",21,15,5,6,2,1,0,3
Geelong,"Dangerfield, Patrick",25,16,2,9,0,1,0,6
Geelong,"Duncan, Mitch",21,14,8,7,0,0,0,4
Geelong,"Fogarty, Lachie",18,10,2,8,0,1,0,3
Geelong,"Gregson, Cory",2,2,0,0,0,0,0,2
Geelong,"Guthrie, Zach",6,2,2,4,0,0,0,1
Geelong,"Hawkins, Tom",8,7,2,1,0,0,6,2
Geelong,"Henry, Jack",7,6,3,1,0,0,0,6
Geelong,"Kelly, Tim",15,9,2,6,2,0,0,3
Geelong,"Kolodjashnij, Jake",14,7,5,7,0,0,0,2
Geelong,"Menegola, Sam",22,13,9,9,2,1,0,6
Geelong,"Menzel, Daniel",16,11,2,5,5,3,0,1
Geelong,"Murdoch, Jordan",17,9,5,8,0,0,0,2
Geelong,"Parfitt, Brandan",28,15,6,13,3,0,0,7
Geelong,"Ratugolea, Esava",6,4,3,2,0,1,2,3
Geelong,"Selwood, Joel",27,13,2,14,0,0,0,7
Geelong,"Selwood, Scott",19,9,1,10,0,0,0,9
Geelong,"Stanley, Rhys",11,9,4,2,1,1,31,1
Geelong,"Stewart, Tom",20,16,8,4,0,1,0,0
Geelong,"Tuohy, Zach",29,19,6,10,0,1,0,0
Geelong,"Bews, Jed",9,5,5,4,0,0,0,1
Geelong,"Blicavs, Mark",11,4,2,7,0,0,0,3
Geelong,"Cunico, Jordan",15,11,4,4,0,0,0,1
Geelong,"Dangerfield, Patrick",28,15,3,13,1,1,0,4
Geelong,"Duncan, Mitch",22,14,5,8,1,1,0,3
Geelong,"Fogarty, Lachie",17,9,2,8,1,0,0,10
Geelong,"Henry, Jack",7,5,3,2,0,0,0,1
Geelong,"Horlin-Smith, George",26,17,5,9,2,0,0,8
Geelong,"Kelly, Tim",20,4,0,16,1,0,0,5
Geelong,"Kolodjashnij, Jake",8,5,3,3,0,1,0,1
Geelong,"Menegola, Sam",27,11,3,16,1,1,0,7
Geelong,"Menzel, Daniel",13,13,4,0,1,2,0,0
Geelong,"Murdoch, Jordan",16,10,5,6,1,1,0,4
Geelong,"Parfitt, Brandan",23,9,2,14,0,0,0,7
Geelong,"Parsons, James",9,5,2,4,2,1,0,0
Geelong,"Ratugolea, Esava",7,2,1,5,1,1,19,4
Geelong,"Selwood, Joel",29,19,3,10,0,1,0,7
Geelong,"Selwood, Scott",6,5,2,1,0,0,0,2
Geelong,"Stanley, Rhys",10,1,0,9,0,0,45,5
Geelong,"Stewart, Tom",16,13,5,3,0,0,0,2
Geelong,"Thurlow, Jackson",12,7,4,5,0,0,0,3
Geelong,"Tuohy, Zach",16,12,3,4,0,0,0,3
Geelong,"Bews, Jed",8,4,1,4,0,0,0,5
Geelong,"Blicavs, Mark",13,5,5,8,0,0,0,4
Geelong,"Cunico, Jordan",21,13,7,8,0,1,0,4
Geelong,"Dangerfield, Patrick",22,7,3,15,1,0,0,3
Geelong,"Duncan, Mitch",24,13,4,11,0,1,0,7
Geelong,"Fogarty, Lachie",11,5,0,6,0,1,0,4
Geelong,"Gregson, Cory",9,6,1,3,1,0,0,4
Geelong,"Guthrie, Zach",4,4,3,0,0,0,0,0
Geelong,"Hawkins, Tom",18,12,9,6,2,2,5,2
Geelong,"Henry, Jack",13,10,4,3,0,0,0,0
Geelong,"Horlin-Smith, George",7,2,1,5,0,0,0,1
Geelong,"Kelly, Tim",19,13,2,6,1,1,0,5
Geelong,"Kolodjashnij, Jake",11,9,5,2,0,0,0,4
Geelong,"Menegola, Sam",22,11,2,11,1,0,0,6
Geelong,"Murdoch, Jordan",14,5,3,9,0,0,0,6
Geelong,"Parsons, James",14,9,1,5,2,1,0,1
Geelong,"Ratugolea, Esava",11,5,3,6,0,1,12,2
Geelong,"Selwood, Joel",23,14,2,9,1,0,0,6
Geelong,"Stanley, Rhys",10,6,2,4,1,0,33,2
Geelong,"Stewart, Tom",15,11,1,4,0,0,0,4
Geelong,"Thurlow, Jackson",17,10,1,7,0,0,0,1
Geelong,"Tuohy, Zach",13,12,3,1,0,0,0,3
Geelong,"Bews, Jed",13,7,4,6,0,0,0,2
Geelong,"Blicavs, Mark",23,12,9,11,0,0,0,2
Geelong,"Crameri, Stewart",11,8,4,3,2,0,0,3
Geelong,"Cunico, Jordan",17,12,6,5,0,0,0,1
Geelong,"Dangerfield, Patrick",27,15,5,12,2,2,0,4
Geelong,"Duncan, Mitch",33,20,8,13,0,1,0,3
Geelong,"Fogarty, Lachie",13,9,1,4,0,1,0,8
Geelong,"Gregson, Cory",11,8,4,3,1,0,0,2
Geelong,"Guthrie, Zach",17,8,3,9,0,0,0,1
Geelong,"Hawkins, Tom",15,12,8,3,4,1,3,1
Geelong,"Henry, Jack",18,14,11,4,0,0,0,3
Geelong,"Kelly, Tim",30,16,2,14,0,0,0,3
Geelong,"Kolodjashnij, Jake",14,10,6,4,0,0,0,1
Geelong,"Menegola, Sam",18,10,3,8,0,2,0,3
Geelong,"Murdoch, Jordan",20,13,6,7,1,0,0,4
Geelong,"Ratugolea, Esava",8,6,3,2,2,0,12,3
Geelong,"Selwood, Joel",25,11,7,14,0,0,1,9
Geelong,"Selwood, Scott",18,6,3,12,0,0,0,7
Geelong,"Stanley, Rhys",17,7,6,10,0,0,29,5
Geelong,"Stewart, Tom",24,15,12,9,1,0,0,1
Geelong,"Thurlow, Jackson",22,13,7,9,1,0,0,0
Geelong,"Tuohy, Zach",22,19,9,3,0,1,0,0
Geelong,"Ablett, Gary",32,17,5,15,1,1,0,2
Geelong,"Bews, Jed",7,3,2,4,0,0,0,0
Geelong,"Blicavs, Mark",17,11,7,6,0,0,0,5
Geelong,"Crameri, Stewart",11,7,6,4,1,2,0,2
Geelong,"Cunico, Jordan",18,13,5,5,0,1,0,1
Geelong,"Dangerfield, Patrick",26,14,1,12,1,0,0,7
Geelong,"Duncan, Mitch",25,15,6,10,0,0,0,4
Geelong,"Gregson, Cory",10,5,1,5,0,0,0,5
Geelong,"Henry, Jack",6,5,3,1,0,0,0,3
Geelong,"Horlin-Smith, George",15,5,0,10,1,0,0,6
Geelong,"Kelly, Tim",22,12,1,10,0,0,0,2
Geelong,"Kolodjashnij, Jake",7,4,3,3,0,0,0,1
Geelong,"Menegola, Sam",24,15,10,9,3,1,0,2
Geelong,"Murdoch, Jordan",9,5,4,4,0,0,0,2
Geelong,"Parsons, James",17,7,3,10,0,0,0,4
Geelong,"Ratugolea, Esava",15,6,3,9,1,2,3,0
Geelong,"Selwood, Joel",25,12,5,13,0,2,0,4
Geelong,"Smith, Zac",10,3,0,7,0,0,20,2
Geelong,"Stewart, Tom",28,20,9,8,0,0,0,2
Geelong,"Taylor, Harry",20,13,6,7,0,1,0,0
Geelong,"Thurlow, Jackson",16,9,3,7,1,0,0,5
Geelong,"Tuohy, Zach",18,11,3,7,0,0,0,2
Geelong,"Ablett, Gary",17,8,1,9,0,1,0,1
Geelong,"Bews, Jed",9,6,2,3,0,0,0,2
Geelong,"Blicavs, Mark",18,7,3,11,0,1,7,2
Geelong,"Crameri, Stewart",15,6,7,9,1,0,0,2
Geelong,"Cunico, Jordan",15,10,3,5,0,0,0,2
Geelong,"Dangerfield, Patrick",27,13,3,14,2,0,0,6
Geelong,"Duncan, Mitch",26,17,8,9,0,0,0,4
Geelong,"Gregson, Cory",9,7,1,2,0,2,0,4
Geelong,"Hawkins, Tom",20,10,9,10,3,1,0,2
Geelong,"Henry, Jack",10,7,5,3,0,0,0,4
Geelong,"Horlin-Smith, George",17,10,1,7,0,0,0,0
Geelong,"Kelly, Tim",16,10,4,6,0,0,0,3
Geelong,"Kolodjashnij, Jake",15,6,4,9,0,0,0,2
Geelong,"Menegola, Sam",16,8,3,8,0,0,0,5
Geelong,"Murdoch, Jordan",8,4,1,4,0,1,0,6
Geelong,"Parsons, James",11,6,5,5,0,0,0,5
Geelong,"Selwood, Joel",30,10,6,20,1,2,0,6
Geelong,"Smith, Zac",8,3,2,5,0,0,26,4
Geelong,"Stewart, Tom",16,8,3,8,0,0,0,3
Geelong,"Taylor, Harry",7,2,3,5,0,0,0,0
Geelong,"Thurlow, Jackson",13,6,6,7,0,0,0,1
Geelong,"Tuohy, Zach",27,19,6,8,0,0,0,4
Geelong,"Ablett, Gary",25,14,8,11,1,0,0,4
Geelong,"Bews, Jed",6,4,4,2,0,0,0,0
Geelong,"Black, Aaron",18,10,8,8,0,0,0,4
Geelong,"Blicavs, Mark",17,5,4,12,0,0,1,0
Geelong,"Crameri, Stewart",9,6,3,3,1,1,0,2
Geelong,"Cunico, Jordan",16,11,3,5,1,0,0,2
Geelong,"Dangerfield, Patrick",29,23,4,6,1,2,0,3
Geelong,"Duncan, Mitch",27,20,7,7,0,0,0,0
Geelong,"Gregson, Cory",5,2,1,3,0,0,0,9
Geelong,"Hawkins, Tom",11,6,6,5,3,0,1,5
Geelong,"Henry, Jack",16,12,5,4,0,0,0,6
Geelong,"Jones, Jamaine",8,3,0,5,1,0,0,1
Geelong,"Kelly, Tim",15,7,2,8,0,0,0,4
Geelong,"Kolodjashnij, Jake",12,8,5,4,0,0,0,1
Geelong,"Menegola, Sam",23,10,4,13,2,0,0,10
Geelong,"Murdoch, Jordan",17,11,4,6,1,0,0,2
Geelong,"Parfitt, Brandan",18,9,2,9,0,1,0,2
Geelong,"Ratugolea, Esava",0,0,0,0,0,0,2,1
Geelong,"Selwood, Joel",20,12,5,8,0,0,0,6
Geelong,"Stanley, Rhys",9,7,5,2,0,2,32,4
Geelong,"Stewart, Tom",28,23,12,5,0,0,0,2
Geelong,"Tuohy, Zach",17,11,5,6,0,0,0,3
Geelong,"Ablett, Gary",37,17,6,20,3,0,0,0
Geelong,"Bews, Jed",13,2,5,11,0,0,0,0
Geelong,"Black, Aaron",16,9,7,7,0,0,0,3
Geelong,"Blicavs, Mark",18,7,6,11,0,0,0,3
Geelong,"Buzza, Wylie",7,3,4,4,0,1,4,1
Geelong,"Cunico, Jordan",24,16,6,8,0,2,0,0
Geelong,"Dangerfield, Patrick",28,12,4,16,1,0,0,5
Geelong,"Duncan, Mitch",32,16,5,16,1,0,0,1
Geelong,"Fogarty, Lachie",17,9,6,8,0,1,0,2
Geelong,"Hawkins, Tom",14,13,7,1,3,2,0,1
Geelong,"Henry, Jack",5,3,3,2,0,0,0,1
Geelong,"Jones, Jamaine",14,10,4,4,1,1,0,2
Geelong,"Kelly, Tim",24,10,5,14,2,1,0,4
Geelong,"Kolodjashnij, Jake",16,5,5,11,0,0,0,0
Geelong,"McCarthy, Lincoln",14,10,5,4,2,3,0,3
Geelong,"Menegola, Sam",30,14,6,16,2,2,0,6
Geelong,"Murdoch, Jordan",22,15,6,7,0,1,0,0
Geelong,"Parfitt, Brandan",12,5,2,7,1,1,0,7
Geelong,"Selwood, Joel",33,19,8,14,1,0,0,4
Geelong,"Stanley, Rhys",8,4,3,4,0,0,18,2
Geelong,"Stewart, Tom",28,16,10,12,0,0,0,1
Geelong,"Tuohy, Zach",24,15,4,9,0,0,0,0
Geelong,"Ablett, Gary",34,20,5,14,1,1,0,8
Geelong,"Bews, Jed",15,7,4,8,1,1,0,4
Geelong,"Black, Aaron",6,4,2,2,0,0,0,2
Geelong,"Blicavs, Mark",18,11,7,7,0,0,0,0
Geelong,"Buzza, Wylie",7,4,4,3,1,0,2,2
Geelong,"Cunico, Jordan",26,17,5,9,1,1,0,2
Geelong,"Dangerfield, Patrick",24,11,5,13,2,2,0,5
Geelong,"Duncan, Mitch",22,12,8,10,1,0,0,6
Geelong,"Fogarty, Lachie",16,5,2,11,0,0,0,2
Geelong,"Hawkins, Tom",23,11,11,12,3,1,0,2
Geelong,"Henry, Jack",15,13,8,2,0,0,0,2
Geelong,"Jones, Jamaine",6,3,3,3,1,0,0,5
Geelong,"Kelly, Tim",19,10,5,9,1,1,0,4
Geelong,"Kolodjashnij, Jake",16,9,9,7,0,0,0,2
Geelong,"Menegola, Sam",24,8,9,16,0,1,0,2
Geelong,"Murdoch, Jordan",20,13,6,7,0,0,0,5
Geelong,"Parfitt, Brandan",19,4,3,15,0,0,0,5
Geelong,"Parsons, James",16,8,4,8,1,1,0,2
Geelong,"Selwood, Joel",27,10,4,17,0,1,0,8
Geelong,"Stanley, Rhys",17,8,3,9,0,0,20,1
Geelong,"Stewart, Tom",26,17,7,9,0,0,0,3
Geelong,"Tuohy, Zach",22,16,7,6,1,0,0,1
Geelong,"Ablett, Gary",25,15,3,10,1,1,0,3
Geelong,"Bews, Jed",14,10,4,4,0,0,0,3
Geelong,"Blicavs, Mark",18,10,3,8,0,0,0,2
Geelong,"Cunico, Jordan",19,11,3,8,0,0,0,3
Geelong,"Dangerfield, Patrick",20,10,2,10,0,0,0,4
Geelong,"Duncan, Mitch",22,11,2,11,0,1,0,2
Geelong,"Fogarty, Lachie",9,8,3,1,0,1,0,2
Geelong,"Gregson, Cory",8,4,1,4,0,2,0,0
Geelong,"Guthrie, Zach",7,3,1,4,0,0,0,4
Geelong,"Hawkins, Tom",11,7,4,4,3,1,4,4
Geelong,"Henry, Jack",7,5,1,2,0,0,0,4
Geelong,"Kelly, Tim",21,5,3,16,0,0,0,6
Geelong,"Kolodjashnij, Jake",9,3,2,6,0,0,0,2
Geelong,"McCarthy, Lincoln",8,4,0,4,0,0,0,1
Geelong,"Menegola, Sam",21,13,3,8,0,1,3,9
Geelong,"Murdoch, Jordan",9,4,1,5,0,0,0,2
Geelong,"Parfitt, Brandan",13,6,3,7,1,0,0,3
Geelong,"Parsons, James",14,7,1,7,1,1,0,1
Geelong,"Selwood, Joel",29,20,5,9,2,0,0,4
Geelong,"Stanley, Rhys",16,7,2,9,1,0,34,6
Geelong,"Stewart, Tom",24,16,4,8,0,0,0,0
Geelong,"Tuohy, Zach",21,11,2,10,0,0,0,0
Geelong,"Ablett, Gary",31,18,8,13,1,0,0,2
Geelong,"Bews, Jed",8,2,0,6,0,0,0,2
Geelong,"Blicavs, Mark",14,5,5,9,0,0,0,4
Geelong,"Cunico, Jordan",8,4,1,4,0,0,0,4
Geelong,"Dangerfield, Patrick",31,11,5,20,1,1,0,1
Geelong,"Duncan, Mitch",27,16,8,11,0,0,0,4
Geelong,"Fogarty, Lachie",13,6,4,7,0,0,0,0
Geelong,"Guthrie, Cameron",22,13,7,9,0,0,0,3
Geelong,"Hawkins, Tom",14,9,9,5,3,2,2,1
Geelong,"Henry, Jack",12,6,6,6,0,0,0,6
Geelong,"Kelly, Tim",34,17,4,17,1,0,0,4
Geelong,"Kolodjashnij, Jake",7,1,0,6,0,0,0,1
Geelong,"Menegola, Sam",21,11,8,10,2,0,0,6
Geelong,"Murdoch, Jordan",11,10,2,1,1,2,0,6
Geelong,"Narkle, Quinton",14,9,4,5,2,1,0,6
Geelong,"Parfitt, Brandan",13,7,1,6,1,0,0,5
Geelong,"Parsons, James",9,3,1,6,0,1,0,3
Geelong,"Selwood, Joel",34,13,4,21,0,1,0,6
Geelong,"Stanley, Rhys",19,8,4,11,1,0,36,3
Geelong,"Stewart, Tom",21,12,2,9,0,0,0,3
Geelong,"Taylor, Harry",17,12,5,5,2,3,2,3
Geelong,"Tuohy, Zach",28,20,5,8,0,0,0,2
Geelong,"Ablett, Gary",17,11,3,6,0,0,0,2
Geelong,"Bews, Jed",7,4,2,3,0,0,0,1
Geelong,"Blicavs, Mark",8,3,1,5,0,0,0,4
Geelong,"Dangerfield, Patrick",19,11,3,8,1,2,0,4
Geelong,"Duncan, Mitch",32,19,5,13,0,1,0,1
Geelong,"Fogarty, Lachie",12,7,2,5,1,1,0,5
Geelong,"Guthrie, Cameron",17,7,1,10,0,0,0,1
Geelong,"Hawkins, Tom",16,10,6,6,2,5,5,2
Geelong,"Henry, Jack",15,9,2,6,0,0,0,1
Geelong,"Jones, Jamaine",10,4,3,6,0,1,0,11
Geelong,"Kelly, Tim",21,9,4,12,2,2,0,5
Geelong,"Kolodjashnij, Jake",16,5,4,11,0,0,0,3
Geelong,"Menegola, Sam",25,17,6,8,0,1,0,2
Geelong,"Murdoch, Jordan",8,6,3,2,0,1,0,2
Geelong,"Narkle, Quinton",12,4,0,8,1,1,0,1
Geelong,"Parfitt, Brandan",21,10,0,11,0,1,0,1
Geelong,"Selwood, Joel",28,17,5,11,0,1,0,9
Geelong,"Selwood, Scott",14,7,5,7,0,0,0,9
Geelong,"Stanley, Rhys",15,7,2,8,0,0,26,3
Geelong,"Stewart, Tom",23,10,5,13,0,0,0,2
Geelong,"Taylor, Harry",11,5,0,6,1,0,11,2
Geelong,"Tuohy, Zach",27,13,6,14,0,0,0,0
Geelong,"Ablett, Gary",32,21,2,11,0,1,0,5
Geelong,"Bews, Jed",15,10,4,5,0,0,0,2
Geelong,"Blicavs, Mark",15,7,6,8,0,1,0,3
Geelong,"Buzza, Wylie",8,3,1,5,0,1,6,4
Geelong,"Dangerfield, Patrick",33,17,5,16,3,3,0,10
Geelong,"Duncan, Mitch",23,12,3,11,1,0,0,4
Geelong,"Guthrie, Cameron",16,8,2,8,0,0,0,3
Geelong,"Hawkins, Tom",18,12,7,6,4,1,2,1
Geelong,"Henry, Jack",8,5,2,3,0,0,0,3
Geelong,"Jones, Jamaine",7,1,2,6,0,0,0,2
Geelong,"Kelly, Tim",29,16,3,13,1,0,0,3
Geelong,"Kolodjashnij, Jake",17,7,3,10,0,0,0,1
Geelong,"Menegola, Sam",22,14,4,8,1,0,0,3
Geelong,"Menzel, Daniel",6,3,0,3,1,0,0,1
Geelong,"Narkle, Quinton",15,7,3,8,1,0,0,1
Geelong,"Parfitt, Brandan",11,8,2,3,1,0,0,3
Geelong,"Selwood, Joel",29,13,3,16,0,0,1,0
Geelong,"Selwood, Scott",13,4,1,9,0,0,0,8
Geelong,"Simpson, Sam",7,3,3,4,0,0,0,2
Geelong,"Stanley, Rhys",18,11,4,7,0,0,27,3
Geelong,"Stewart, Tom",17,8,3,9,0,0,0,3
Geelong,"Tuohy, Zach",22,13,5,9,1,1,0,3
Geelong,"Ablett, Gary",31,11,3,20,0,1,0,6
Geelong,"Bews, Jed",15,11,5,4,0,0,0,1
Geelong,"Blicavs, Mark",16,7,5,9,0,0,0,3
Geelong,"Cunico, Jordan",18,10,6,8,0,0,0,1
Geelong,"Dangerfield, Patrick",29,10,1,19,2,0,0,7
Geelong,"Duncan, Mitch",31,15,11,16,1,0,0,2
Geelong,"Guthrie, Cameron",13,5,2,8,0,0,0,3
Geelong,"Hawkins, Tom",19,12,8,7,7,0,1,1
Geelong,"Henderson, Lachie",9,4,4,5,0,0,0,2
Geelong,"Henry, Jack",11,5,1,6,1,0,2,7
Geelong,"Jones, Jamaine",8,6,0,2,1,0,0,1
Geelong,"Kelly, Tim",32,18,6,14,1,2,0,2
Geelong,"Kolodjashnij, Jake",17,11,7,6,0,0,0,3
Geelong,"Menegola, Sam",30,17,5,13,0,0,0,6
Geelong,"Menzel, Daniel",9,6,4,3,0,0,0,1
Geelong,"Narkle, Quinton",7,3,2,4,0,0,0,3
Geelong,"Parfitt, Brandan",20,9,3,11,0,0,0,2
Geelong,"Selwood, Joel",16,7,2,9,1,0,0,6
Geelong,"Selwood, Scott",18,5,1,13,0,0,0,3
Geelong,"Stanley, Rhys",21,11,5,10,0,0,31,2
Geelong,"Stewart, Tom",22,14,6,8,0,0,0,2
Geelong,"Tuohy, Zach",24,18,8,6,2,0,0,1
Geelong,"Ablett, Gary",38,13,8,25,0,0,0,5
Geelong,"Bews, Jed",2,1,1,1,0,0,0,3
Geelong,"Blicavs, Mark",10,5,3,5,0,1,0,2
Geelong,"Cunico, Jordan",23,13,7,10,0,0,0,5
Geelong,"Dangerfield, Patrick",26,12,2,14,0,0,0,1
Geelong,"Duncan, Mitch",28,16,10,12,0,2,0,3
Geelong,"Fogarty, Lachie",15,10,3,5,0,2,0,4
Geelong,"Guthrie, Cameron",11,6,5,5,1,0,0,3
Geelong,"Hawkins, Tom",22,11,10,11,7,1,1,1
Geelong,"Henderson, Lachie",17,13,6,4,0,0,0,0
Geelong,"Henry, Jack",13,10,5,3,3,1,1,1
Geelong,"Kelly, Tim",16,11,2,5,0,2,0,2
Geelong,"Kolodjashnij, Jake",11,8,5,3,0,0,0,2
Geelong,"Menegola, Sam",27,16,9,11,1,0,0,0
Geelong,"Menzel, Daniel",11,10,5,1,3,0,0,2
Geelong,"Narkle, Quinton",12,4,3,8,0,0,0,1
Geelong,"Parfitt, Brandan",26,11,6,15,1,2,0,5
Geelong,"Selwood, Joel",22,9,5,13,0,1,0,1
Geelong,"Selwood, Scott",23,11,5,12,2,0,0,6
Geelong,"Stanley, Rhys",16,8,1,8,0,0,18,1
Geelong,"Stewart, Tom",4,2,0,2,0,0,0,1
Geelong,"Tuohy, Zach",26,15,4,11,0,0,0,0
Geelong,"Abbott, Ryan",10,3,3,7,2,0,27,7
Geelong,"Ablett, Gary",24,13,1,11,0,2,0,4
Geelong,"Bews, Jed",9,3,0,6,0,0,0,2
Geelong,"Blicavs, Mark",14,8,2,6,0,0,10,5
Geelong,"Cunico, Jordan",16,8,3,8,0,0,0,1
Geelong,"Dangerfield, Patrick",39,16,4,23,0,0,0,5
Geelong,"Duncan, Mitch",33,18,4,15,0,1,0,1
Geelong,"Fogarty, Lachie",11,4,2,7,0,0,0,3
Geelong,"Guthrie, Cameron",20,7,3,13,1,0,0,8
Geelong,"Hawkins, Tom",13,8,4,5,1,1,0,1
Geelong,"Henderson, Lachie",15,9,1,6,0,0,0,1
Geelong,"Henry, Jack",9,7,2,2,1,2,4,3
Geelong,"Jones, Jamaine",7,3,2,4,0,0,0,4
Geelong,"Kelly, Tim",36,19,3,17,1,1,0,3
Geelong,"Kolodjashnij, Jake",5,3,1,2,0,0,0,5
Geelong,"Menegola, Sam",29,15,4,14,2,1,0,3
Geelong,"Menzel, Daniel",11,6,5,5,3,1,0,0
Geelong,"Parfitt, Brandan",16,6,0,10,0,0,0,5
Geelong,"Selwood, Joel",37,18,5,19,0,0,0,4
Geelong,"Selwood, Scott",16,6,2,10,0,0,0,7
Geelong,"Thurlow, Jackson",11,8,4,3,0,0,0,0
Geelong,"Tuohy, Zach",23,12,3,11,1,0,0,1
Geelong,"Ablett, Gary",32,22,5,10,3,1,0,8
Geelong,"Blicavs, Mark",13,6,3,7,0,0,19,2
Geelong,"Dangerfield, Patrick",39,17,5,22,0,0,0,3
Geelong,"Duncan, Mitch",24,12,4,12,0,0,0,3
Geelong,"Fogarty, Lachie",5,2,1,3,0,0,0,3
Geelong,"Guthrie, Cameron",13,6,2,7,0,0,0,5
Geelong,"Hawkins, Tom",14,12,9,2,1,3,3,1
Geelong,"Henderson, Lachie",16,9,4,7,0,0,0,7
Geelong,"Henry, Jack",12,7,4,5,1,1,3,1
Geelong,"Kelly, Tim",17,11,2,6,1,2,0,2
Geelong,"Kolodjashnij, Jake",7,4,0,3,0,0,0,2
Geelong,"Menegola, Sam",30,18,8,12,0,0,0,6
Geelong,"Menzel, Daniel",7,5,2,2,1,1,0,1
Geelong,"Narkle, Quinton",13,4,1,9,1,0,0,2
Geelong,"OConnor, Mark",8,6,4,2,0,0,0,3
Geelong,"Parfitt, Brandan",17,7,2,10,0,0,0,3
Geelong,"Parsons, James",8,3,1,5,0,1,0,3
Geelong,"Selwood, Joel",23,11,1,12,0,1,0,6
Geelong,"Selwood, Scott",18,6,3,12,0,0,0,6
Geelong,"Stanley, Rhys",4,1,1,3,0,0,14,2
Geelong,"Stewart, Tom",11,7,1,4,0,0,0,5
Geelong,"Tuohy, Zach",13,8,2,5,0,0,0,1
Geelong,"Abbott, Ryan",19,9,4,10,0,1,31,5
Geelong,"Ablett, Gary",25,15,2,10,1,2,0,4
Geelong,"Blicavs, Mark",11,4,3,7,0,0,8,2
Geelong,"Dangerfield, Patrick",24,13,6,11,0,3,0,8
Geelong,"Duncan, Mitch",25,16,6,9,0,0,0,6
Geelong,"Guthrie, Cameron",17,7,2,10,0,0,0,3
Geelong,"Hawkins, Tom",22,13,7,9,6,1,2,0
Geelong,"Henderson, Lachie",20,15,5,5,0,0,0,3
Geelong,"Henry, Jack",11,7,3,4,2,0,0,3
Geelong,"Kelly, Tim",26,14,3,12,3,2,0,6
Geelong,"Kolodjashnij, Jake",11,7,3,4,0,0,0,3
Geelong,"Menegola, Sam",27,12,6,15,1,0,0,2
Geelong,"Menzel, Daniel",9,7,4,2,2,2,0,3
Geelong,"Murdoch, Jordan",20,12,5,8,1,1,0,5
Geelong,"OConnor, Mark",11,6,4,5,0,0,0,0
Geelong,"Parfitt, Brandan",17,10,4,7,4,0,0,6
Geelong,"Selwood, Joel",22,13,4,9,0,0,0,5
Geelong,"Selwood, Scott",14,1,1,13,0,0,0,3
Geelong,"Stewart, Tom",20,12,7,8,0,0,0,1
Geelong,"Taylor, Harry",5,3,2,2,1,0,0,0
Geelong,"Thurlow, Jackson",18,15,6,3,1,0,0,4
Geelong,"Tuohy, Zach",17,14,2,3,2,0,0,1
Geelong,"Abbott, Ryan",9,5,2,4,1,1,24,6
Geelong,"Ablett, Gary",25,13,5,12,2,1,0,4
Geelong,"Bews, Jed",10,2,4,8,0,0,0,4
Geelong,"Blicavs, Mark",16,9,4,7,1,0,5,6
Geelong,"Dangerfield, Patrick",34,20,9,14,4,3,0,3
Geelong,"Duncan, Mitch",29,12,7,17,1,0,0,9
Geelong,"Guthrie, Cameron",20,9,3,11,0,0,0,5
Geelong,"Hawkins, Tom",16,13,10,3,2,2,1,5
Geelong,"Henderson, Lachie",20,15,9,5,0,0,0,3
Geelong,"Henry, Jack",6,3,4,3,0,0,0,4
Geelong,"Kelly, Tim",23,14,8,9,3,0,0,1
Geelong,"Kolodjashnij, Jake",12,6,2,6,0,0,0,0
Geelong,"Menegola, Sam",23,14,5,9,2,0,0,4
Geelong,"Menzel, Daniel",11,7,5,4,2,1,0,1
Geelong,"Murdoch, Jordan",16,12,10,4,2,0,0,2
Geelong,"OConnor, Mark",15,11,6,4,0,0,0,1
Geelong,"Parfitt, Brandan",18,12,3,6,0,0,0,6
Geelong,"Selwood, Joel",28,10,2,18,0,1,0,2
Geelong,"Selwood, Scott",25,10,9,15,1,1,0,1
Geelong,"Stewart, Tom",22,19,13,3,0,0,0,5
Geelong,"Taylor, Harry",16,12,9,4,0,0,0,1
Geelong,"Tuohy, Zach",22,15,6,7,1,0,0,1
Geelong,"Abbott, Ryan",5,3,2,2,0,1,27,5
Geelong,"Ablett, Gary",27,16,6,11,0,1,0,6
Geelong,"Bews, Jed",15,7,1,8,0,0,0,1
Geelong,"Blicavs, Mark",13,6,2,7,0,0,4,6
Geelong,"Dangerfield, Patrick",25,11,4,14,0,1,0,7
Geelong,"Duncan, Mitch",21,12,4,9,1,0,0,3
Geelong,"Guthrie, Cameron",14,7,1,7,0,0,0,4
Geelong,"Hawkins, Tom",11,7,7,4,2,0,1,2
Geelong,"Henderson, Lachie",10,5,2,5,0,0,0,1
Geelong,"Henry, Jack",11,7,1,4,0,0,2,4
Geelong,"Kelly, Tim",18,13,4,5,1,2,0,3
Geelong,"Kolodjashnij, Jake",14,6,4,8,0,0,0,4
Geelong,"Menegola, Sam",20,9,5,11,0,1,0,2
Geelong,"Menzel, Daniel",8,4,2,4,0,1,0,2
Geelong,"Murdoch, Jordan",7,5,2,2,1,0,0,5
Geelong,"OConnor, Mark",12,6,2,6,0,0,0,3
Geelong,"Parfitt, Brandan",13,6,2,7,0,0,0,5
Geelong,"Selwood, Joel",25,11,2,14,0,0,0,7
Geelong,"Selwood, Scott",17,5,5,12,0,0,0,2
Geelong,"Stewart, Tom",16,13,2,3,0,0,0,2
Geelong,"Taylor, Harry",17,9,3,8,0,0,1,6
Geelong,"Tuohy, Zach",19,10,7,9,1,0,0,1
Greater Western Sydney,"Cameron, Jeremy",18,18,9,0,6,3,0,0
Greater Western Sydney,"Coniglio, Stephen",32,21,8,11,2,0,0,7
Greater Western Sydney,"Corr, Aidan",8,5,2,3,0,0,0,3
Greater Western Sydney,"Davis, Phil",14,10,6,4,0,0,0,1
Greater Western Sydney,"Deledio, Brett",18,5,4,13,0,0,0,1
Greater Western Sydney,"Finlayson, Jeremy",20,12,4,8,0,0,0,1
Greater Western Sydney,"Greene, Toby",25,13,10,12,4,0,0,0
Greater Western Sydney,"Haynes, Nick",21,14,5,7,0,0,0,0
Greater Western Sydney,"Himmelberg, Harry",11,8,5,3,1,0,0,0
Greater Western Sydney,"Kelly, Josh",29,12,6,17,2,0,0,5
Greater Western Sydney,"Langdon, Zac",7,4,3,3,1,0,0,6
Greater Western Sydney,"Lloyd, Daniel",13,9,4,4,0,1,0,7
Greater Western Sydney,"Lobb, Rory",10,4,2,6,0,0,41,2
Greater Western Sydney,"Patton, Jonathon",14,11,4,3,2,2,2,2
Greater Western Sydney,"Reid, Sam",14,5,1,9,0,0,0,6
Greater Western Sydney,"Shaw, Heath",22,13,7,9,0,0,0,5
Greater Western Sydney,"Shiel, Dylan",28,10,4,18,1,0,0,5
Greater Western Sydney,"Taranto, Tim",32,18,6,14,0,0,0,5
Greater Western Sydney,"Tomlinson, Adam",20,10,8,10,1,1,0,2
Greater Western Sydney,"Ward, Callan",24,13,5,11,0,2,0,2
Greater Western Sydney,"Whitfield, Lachie",34,20,9,14,0,0,0,2
Greater Western Sydney,"de Boer, Matt",23,11,7,12,0,0,0,0
Greater Western Sydney,"Cameron, Jeremy",11,10,9,1,3,1,0,0
Greater Western Sydney,"Coniglio, Stephen",27,16,7,11,3,0,0,3
Greater Western Sydney,"Corr, Aidan",7,5,3,2,0,0,0,2
Greater Western Sydney,"Davis, Phil",17,6,5,11,0,0,0,1
Greater Western Sydney,"Deledio, Brett",22,11,4,11,0,0,0,3
Greater Western Sydney,"Finlayson, Jeremy",23,21,6,2,0,0,0,2
Greater Western Sydney,"Haynes, Nick",11,9,5,2,0,0,0,2
Greater Western Sydney,"Himmelberg, Harry",6,3,1,3,1,2,0,1
Greater Western Sydney,"Kelly, Josh",19,13,2,6,1,0,0,15
Greater Western Sydney,"Langdon, Zac",13,8,3,5,2,0,0,1
Greater Western Sydney,"Lloyd, Daniel",13,4,1,9,1,0,0,3
Greater Western Sydney,"Lobb, Rory",15,11,5,4,0,0,20,2
Greater Western Sydney,"Patton, Jonathon",13,5,3,8,0,1,2,3
Greater Western Sydney,"Reid, Sam",13,5,3,8,0,0,0,3
Greater Western Sydney,"Scully, Tom",5,3,1,2,1,0,0,1
Greater Western Sydney,"Shaw, Heath",23,17,4,6,0,0,0,1
Greater Western Sydney,"Shiel, Dylan",26,15,2,11,0,0,0,3
Greater Western Sydney,"Taranto, Tim",23,10,1,13,0,0,0,8
Greater Western Sydney,"Tomlinson, Adam",23,13,9,10,1,0,0,1
Greater Western Sydney,"Ward, Callan",29,16,5,13,0,0,0,2
Greater Western Sydney,"Whitfield, Lachie",26,17,13,9,1,0,0,3
Greater Western Sydney,"de Boer, Matt",17,5,4,12,1,0,0,3
Greater Western Sydney,"Cameron, Jeremy",17,13,4,4,3,1,0,3
Greater Western Sydney,"Coniglio, Stephen",27,18,5,9,1,1,0,5
Greater Western Sydney,"Corr, Aidan",10,8,4,2,0,0,0,1
Greater Western Sydney,"Davis, Phil",11,5,7,6,0,0,0,1
Greater Western Sydney,"Deledio, Brett",13,8,6,5,0,0,2,4
Greater Western Sydney,"Finlayson, Jeremy",20,13,3,7,0,0,0,1
Greater Western Sydney,"Haynes, Nick",28,18,8,10,0,0,0,1
Greater Western Sydney,"Himmelberg, Harry",7,5,1,2,1,1,0,1
Greater Western Sydney,"Hopper, Jacob",19,9,3,10,1,0,0,4
Greater Western Sydney,"Kelly, Josh",22,18,3,4,0,3,0,4
Greater Western Sydney,"Lloyd, Daniel",12,9,6,3,2,2,0,6
Greater Western Sydney,"Lobb, Rory",5,4,4,1,1,1,9,4
Greater Western Sydney,"Patton, Jonathon",19,9,5,10,1,0,14,10
Greater Western Sydney,"Perryman, Harry",11,6,3,5,0,0,0,1
Greater Western Sydney,"Reid, Sam",7,2,1,5,0,0,0,1
Greater Western Sydney,"Shaw, Heath",23,18,4,5,0,0,0,3
Greater Western Sydney,"Shiel, Dylan",23,12,4,11,0,0,0,3
Greater Western Sydney,"Taranto, Tim",12,8,2,4,0,0,0,4
Greater Western Sydney,"Tomlinson, Adam",14,9,5,5,0,0,1,3
Greater Western Sydney,"Ward, Callan",24,12,5,12,0,0,0,8
Greater Western Sydney,"Whitfield, Lachie",15,5,4,10,0,1,0,4
Greater Western Sydney,"de Boer, Matt",21,5,4,16,2,0,0,4
Greater Western Sydney,"Cameron, Jeremy",20,17,12,3,2,0,0,2
Greater Western Sydney,"Coniglio, Stephen",27,12,7,15,1,0,0,7
Greater Western Sydney,"Corr, Aidan",6,3,2,3,0,1,0,1
Greater Western Sydney,"Davis, Phil",17,7,4,10,0,0,0,2
Greater Western Sydney,"Deledio, Brett",28,13,5,15,0,0,0,1
Greater Western Sydney,"Finlayson, Jeremy",25,17,6,8,0,0,0,1
Greater Western Sydney,"Greene, Toby",20,14,5,6,2,3,0,4
Greater Western Sydney,"Griffen, Ryan",11,8,5,3,2,2,0,2
Greater Western Sydney,"Haynes, Nick",29,18,15,11,0,0,0,0
Greater Western Sydney,"Himmelberg, Harry",12,7,5,5,0,0,0,3
Greater Western Sydney,"Hopper, Jacob",25,12,3,13,1,2,0,2
Greater Western Sydney,"Lloyd, Daniel",14,7,2,7,1,1,0,3
Greater Western Sydney,"Patton, Jonathon",11,5,5,6,0,0,1,0
Greater Western Sydney,"Reid, Sam",12,6,6,6,0,0,0,3
Greater Western Sydney,"Shaw, Heath",24,20,7,4,0,0,0,1
Greater Western Sydney,"Shiel, Dylan",23,12,2,11,0,1,0,3
Greater Western Sydney,"Simpson, Dawson",10,3,4,7,0,0,31,1
Greater Western Sydney,"Taranto, Tim",22,14,3,8,1,1,0,11
Greater Western Sydney,"Tomlinson, Adam",11,10,6,1,0,0,0,4
Greater Western Sydney,"Ward, Callan",34,15,5,19,0,1,0,4
Greater Western Sydney,"Whitfield, Lachie",23,11,3,12,0,0,0,2
Greater Western Sydney,"de Boer, Matt",21,8,3,13,1,1,0,3
Greater Western Sydney,"Cameron, Jeremy",19,13,7,6,2,3,0,1
Greater Western Sydney,"Coniglio, Stephen",29,14,1,15,0,3,0,9
Greater Western Sydney,"Corr, Aidan",5,5,2,0,0,0,0,1
Greater Western Sydney,"Davis, Phil",20,10,8,10,0,0,0,1
Greater Western Sydney,"Deledio, Brett",29,18,8,11,2,0,0,6
Greater Western Sydney,"Finlayson, Jeremy",18,14,1,4,0,0,0,2
Greater Western Sydney,"Greene, Toby",15,8,4,7,1,2,0,0
Greater Western Sydney,"Griffen, Ryan",9,5,2,4,2,0,0,1
Greater Western Sydney,"Haynes, Nick",10,3,4,7,0,0,0,1
Greater Western Sydney,"Himmelberg, Harry",7,4,3,3,0,0,0,1
Greater Western Sydney,"Hopper, Jacob",21,8,5,13,0,2,0,4
Greater Western Sydney,"Lloyd, Daniel",11,4,3,7,0,0,0,5
Greater Western Sydney,"Patton, Jonathon",9,4,4,5,1,0,6,1
Greater Western Sydney,"Reid, Sam",13,5,1,8,0,1,0,0
Greater Western Sydney,"Shaw, Heath",18,16,5,2,0,0,0,3
Greater Western Sydney,"Shiel, Dylan",23,13,4,10,1,1,0,2
Greater Western Sydney,"Simpson, Dawson",8,3,1,5,0,0,37,5
Greater Western Sydney,"Taranto, Tim",19,13,6,6,0,0,0,7
Greater Western Sydney,"Tomlinson, Adam",18,11,4,7,0,0,0,3
Greater Western Sydney,"Ward, Callan",29,15,6,14,0,1,0,6
Greater Western Sydney,"Whitfield, Lachie",22,14,3,8,0,1,0,1
Greater Western Sydney,"de Boer, Matt",22,8,2,14,0,0,0,3
Greater Western Sydney,"Cameron, Jeremy",18,11,6,7,1,1,0,0
Greater Western Sydney,"Coniglio, Stephen",28,12,4,16,0,2,0,5
Greater Western Sydney,"Corr, Aidan",15,11,5,4,0,0,0,0
Greater Western Sydney,"Davis, Phil",14,8,5,6,0,0,0,2
Greater Western Sydney,"Deledio, Brett",28,15,11,13,1,0,0,2
Greater Western Sydney,"Finlayson, Jeremy",15,10,6,5,0,1,0,2
Greater Western Sydney,"Griffen, Ryan",21,13,7,8,1,0,0,0
Greater Western Sydney,"Haynes, Nick",17,13,9,4,0,0,0,1
Greater Western Sydney,"Himmelberg, Harry",12,6,3,6,1,1,0,2
Greater Western Sydney,"Hopper, Jacob",14,5,4,9,1,1,0,3
Greater Western Sydney,"Langdon, Zac",6,4,0,2,1,0,0,3
Greater Western Sydney,"Lloyd, Daniel",20,12,7,8,1,1,0,3
Greater Western Sydney,"Patton, Jonathon",16,8,6,8,0,1,1,2
Greater Western Sydney,"Reid, Sam",10,5,4,5,0,0,0,1
Greater Western Sydney,"Shaw, Heath",23,20,8,3,0,0,0,4
Greater Western Sydney,"Shiel, Dylan",31,14,6,17,0,1,0,1
Greater Western Sydney,"Shipley, Nick",7,4,2,3,0,1,0,3
Greater Western Sydney,"Taranto, Tim",23,15,4,8,0,1,0,7
Greater Western Sydney,"Tomlinson, Adam",19,11,6,8,1,1,3,3
Greater Western Sydney,"Ward, Callan",19,10,5,9,0,0,0,2
Greater Western Sydney,"Whitfield, Lachie",33,16,8,17,1,0,0,5
Greater Western Sydney,"de Boer, Matt",35,12,4,23,1,0,0,5
Greater Western Sydney,"Buckley, Dylan",7,3,1,4,0,0,0,4
Greater Western Sydney,"Coniglio, Stephen",28,15,2,13,0,0,0,5
Greater Western Sydney,"Corr, Aidan",4,4,1,0,0,0,0,6
Greater Western Sydney,"Davis, Phil",14,7,2,7,0,0,0,2
Greater Western Sydney,"Finlayson, Jeremy",15,11,2,4,2,0,0,0
Greater Western Sydney,"Griffen, Ryan",15,8,3,7,0,0,0,1
Greater Western Sydney,"Haynes, Nick",19,11,10,8,0,0,0,5
Greater Western Sydney,"Himmelberg, Harry",13,7,3,6,0,0,0,1
Greater Western Sydney,"Hopper, Jacob",17,5,1,12,0,0,0,4
Greater Western Sydney,"Keeffe, Lachlan",16,12,3,4,0,0,18,2
Greater Western Sydney,"Langdon, Zac",6,2,0,4,0,1,0,6
Greater Western Sydney,"Lloyd, Daniel",11,5,1,6,1,1,0,4
Greater Western Sydney,"Patton, Jonathon",16,6,3,10,0,0,13,1
Greater Western Sydney,"Reid, Sam",12,5,3,7,0,2,0,2
Greater Western Sydney,"Shaw, Heath",20,18,6,2,0,0,0,5
Greater Western Sydney,"Shiel, Dylan",32,24,5,8,0,2,0,1
Greater Western Sydney,"Shipley, Nick",1,0,0,1,0,0,0,1
Greater Western Sydney,"Taranto, Tim",21,13,3,8,0,1,0,7
Greater Western Sydney,"Tomlinson, Adam",8,6,4,2,0,0,0,2
Greater Western Sydney,"Ward, Callan",19,10,1,9,1,0,0,3
Greater Western Sydney,"Whitfield, Lachie",24,13,5,11,0,0,0,6
Greater Western Sydney,"de Boer, Matt",14,6,1,8,0,0,0,6
Greater Western Sydney,"Cameron, Jeremy",14,8,1,6,2,0,0,0
Greater Western Sydney,"Coniglio, Stephen",29,20,5,9,0,0,0,6
Greater Western Sydney,"Corr, Aidan",13,7,1,6,0,0,0,1
Greater Western Sydney,"Cumming, Isaac",14,7,3,7,0,0,0,2
Greater Western Sydney,"Davis, Phil",11,5,4,6,0,0,0,3
Greater Western Sydney,"Finlayson, Jeremy",17,9,4,8,0,0,0,2
Greater Western Sydney,"Griffen, Ryan",17,9,3,8,1,0,0,4
Greater Western Sydney,"Haynes, Nick",16,12,3,4,0,0,0,3
Greater Western Sydney,"Himmelberg, Harry",13,6,2,7,0,1,0,1
Greater Western Sydney,"Hopper, Jacob",18,6,2,12,0,0,0,7
Greater Western Sydney,"Keeffe, Lachlan",11,2,1,9,0,0,27,1
Greater Western Sydney,"Langdon, Zac",10,5,2,5,1,1,0,6
Greater Western Sydney,"Lloyd, Daniel",10,4,2,6,1,0,0,4
Greater Western Sydney,"Lobb, Rory",12,5,3,7,0,0,32,3
Greater Western Sydney,"Reid, Sam",10,1,2,9,1,0,0,4
Greater Western Sydney,"Shaw, Heath",20,18,3,2,0,1,0,3
Greater Western Sydney,"Shiel, Dylan",22,8,2,14,0,1,0,6
Greater Western Sydney,"Taranto, Tim",21,15,3,6,1,0,0,8
Greater Western Sydney,"Tomlinson, Adam",14,11,4,3,0,1,0,5
Greater Western Sydney,"Ward, Callan",30,17,3,13,1,2,0,3
Greater Western Sydney,"Whitfield, Lachie",30,16,6,14,0,1,0,1
Greater Western Sydney,"de Boer, Matt",8,3,2,5,0,0,0,2
Greater Western Sydney,"Cameron, Jeremy",14,9,4,5,2,2,0,1
Greater Western Sydney,"Coniglio, Stephen",25,11,6,14,0,1,0,5
Greater Western Sydney,"Corr, Aidan",19,12,8,7,1,0,0,3
Greater Western Sydney,"Cumming, Isaac",8,2,1,6,0,0,0,1
Greater Western Sydney,"Finlayson, Jeremy",14,8,2,6,0,0,0,1
Greater Western Sydney,"Griffen, Ryan",16,8,3,8,0,0,0,3
Greater Western Sydney,"Haynes, Nick",16,9,3,7,0,0,0,4
Greater Western Sydney,"Himmelberg, Harry",15,7,0,8,1,0,0,1
Greater Western Sydney,"Hopper, Jacob",24,12,2,12,0,2,0,5
Greater Western Sydney,"Keeffe, Lachlan",8,4,0,4,1,0,21,0
Greater Western Sydney,"Langdon, Zac",6,3,2,3,1,1,0,4
Greater Western Sydney,"Lloyd, Daniel",15,6,3,9,1,2,0,4
Greater Western Sydney,"Lobb, Rory",9,5,3,4,1,0,15,1
Greater Western Sydney,"Mohr, Tim",10,8,1,2,0,0,0,3
Greater Western Sydney,"Perryman, Harry",19,4,1,15,0,0,0,4
Greater Western Sydney,"Reid, Sam",9,5,1,4,1,2,0,4
Greater Western Sydney,"Shaw, Heath",15,10,1,5,0,1,0,3
Greater Western Sydney,"Shiel, Dylan",24,10,0,14,0,0,0,12
Greater Western Sydney,"Taranto, Tim",19,12,2,7,0,1,0,4
Greater Western Sydney,"Tomlinson, Adam",18,9,7,9,0,0,0,4
Greater Western Sydney,"Ward, Callan",19,5,1,14,0,0,0,1
Greater Western Sydney,"Whitfield, Lachie",19,5,3,14,0,1,0,4
Greater Western Sydney,"Buckley, Dylan",8,6,3,2,2,0,0,0
Greater Western Sydney,"Buntine, Matt",12,7,3,5,0,0,0,1
Greater Western Sydney,"Cameron, Jeremy",13,8,7,5,2,3,0,0
Greater Western Sydney,"Coniglio, Stephen",32,14,3,18,1,0,0,7
Greater Western Sydney,"Corr, Aidan",13,8,6,5,0,0,0,3
Greater Western Sydney,"Griffen, Ryan",14,9,3,5,1,0,0,2
Greater Western Sydney,"Haynes, Nick",16,13,4,3,0,0,0,0
Greater Western Sydney,"Himmelberg, Harry",13,8,3,5,0,2,0,2
Greater Western Sydney,"Hopper, Jacob",27,14,4,13,0,0,0,7
Greater Western Sydney,"Kelly, Josh",29,17,0,12,0,2,0,4
Greater Western Sydney,"Langdon, Zac",5,4,2,1,1,0,0,3
Greater Western Sydney,"Lloyd, Daniel",11,2,0,9,0,0,0,1
Greater Western Sydney,"Lobb, Rory",10,8,3,2,0,0,38,5
Greater Western Sydney,"Mohr, Tim",9,7,5,2,0,0,0,1
Greater Western Sydney,"Patton, Jonathon",15,8,6,7,1,1,6,5
Greater Western Sydney,"Perryman, Harry",12,7,6,5,0,0,0,3
Greater Western Sydney,"Shaw, Heath",34,29,8,5,0,0,0,0
Greater Western Sydney,"Shiel, Dylan",17,5,1,12,0,1,0,3
Greater Western Sydney,"Taranto, Tim",12,4,3,8,0,1,0,3
Greater Western Sydney,"Tomlinson, Adam",10,8,6,2,0,0,0,1
Greater Western Sydney,"Ward, Callan",34,16,0,18,0,0,0,3
Greater Western Sydney,"Whitfield, Lachie",25,14,7,11,0,0,0,4
Greater Western Sydney,"Cameron, Jeremy",13,8,5,5,3,1,0,3
Greater Western Sydney,"Coniglio, Stephen",24,16,2,8,2,4,0,5
Greater Western Sydney,"Corr, Aidan",10,6,2,4,0,0,0,2
Greater Western Sydney,"Davis, Phil",13,11,5,2,0,0,0,5
Greater Western Sydney,"Griffen, Ryan",22,13,2,9,3,0,0,2
Greater Western Sydney,"Haynes, Nick",14,11,5,3,0,0,0,6
Greater Western Sydney,"Himmelberg, Harry",8,5,4,3,1,1,0,6
Greater Western Sydney,"Hopper, Jacob",21,5,0,16,0,0,0,6
Greater Western Sydney,"Kelly, Josh",31,16,3,15,0,1,0,2
Greater Western Sydney,"Langdon, Zac",13,8,2,5,3,1,0,8
Greater Western Sydney,"Lloyd, Daniel",8,5,2,3,0,2,0,9
Greater Western Sydney,"Lobb, Rory",7,6,1,1,1,1,37,2
Greater Western Sydney,"Patton, Jonathon",15,12,6,3,0,0,7,2
Greater Western Sydney,"Perryman, Harry",8,3,2,5,0,0,0,4
Greater Western Sydney,"Reid, Sam",10,7,3,3,0,0,0,3
Greater Western Sydney,"Shaw, Heath",22,21,10,1,0,0,0,1
Greater Western Sydney,"Shiel, Dylan",29,15,1,14,1,0,0,2
Greater Western Sydney,"Taranto, Tim",21,8,1,13,0,0,0,9
Greater Western Sydney,"Taylor, Sam",9,2,0,7,0,0,0,3
Greater Western Sydney,"Tomlinson, Adam",17,12,5,5,0,0,0,7
Greater Western Sydney,"Ward, Callan",22,10,2,12,0,1,0,5
Greater Western Sydney,"Whitfield, Lachie",26,21,7,5,0,0,0,4
Greater Western Sydney,"Cameron, Jeremy",26,18,9,8,6,3,0,0
Greater Western Sydney,"Corr, Aidan",12,5,4,7,0,0,0,6
Greater Western Sydney,"Davis, Phil",15,11,8,4,0,0,0,1
Greater Western Sydney,"Griffen, Ryan",21,9,4,12,0,2,0,2
Greater Western Sydney,"Haynes, Nick",23,18,4,5,0,0,0,2
Greater Western Sydney,"Himmelberg, Harry",17,9,0,8,2,1,5,8
Greater Western Sydney,"Hopper, Jacob",29,14,0,15,0,1,0,4
Greater Western Sydney,"Kelly, Josh",40,27,8,13,2,0,0,7
Greater Western Sydney,"Langdon, Zac",9,3,0,6,1,0,0,7
Greater Western Sydney,"Lloyd, Daniel",7,4,1,3,1,0,0,4
Greater Western Sydney,"Lobb, Rory",1,1,0,0,0,0,12,1
Greater Western Sydney,"Patton, Jonathon",15,8,3,7,1,0,12,5
Greater Western Sydney,"Perryman, Harry",18,8,5,10,0,0,0,2
Greater Western Sydney,"Reid, Sam",9,7,1,2,2,1,0,3
Greater Western Sydney,"Shaw, Heath",31,28,9,3,0,0,0,0
Greater Western Sydney,"Shiel, Dylan",35,20,5,15,0,1,0,3
Greater Western Sydney,"Taranto, Tim",24,12,1,12,0,1,0,8
Greater Western Sydney,"Taylor, Sam",11,4,2,7,0,0,0,2
Greater Western Sydney,"Tomlinson, Adam",27,16,6,11,0,0,0,4
Greater Western Sydney,"Ward, Callan",34,18,3,16,2,0,0,5
Greater Western Sydney,"Whitfield, Lachie",36,22,8,14,0,0,0,2
Greater Western Sydney,"de Boer, Matt",24,9,5,15,3,0,0,9
Greater Western Sydney,"Cameron, Jeremy",9,7,4,2,3,1,0,2
Greater Western Sydney,"Coniglio, Stephen",26,9,3,17,0,0,0,1
Greater Western Sydney,"Corr, Aidan",11,5,5,6,0,0,0,1
Greater Western Sydney,"Davis, Phil",15,10,6,5,0,0,0,1
Greater Western Sydney,"Finlayson, Jeremy",8,4,2,4,1,0,0,0
Greater Western Sydney,"Griffen, Ryan",13,10,2,3,2,1,0,1
Greater Western Sydney,"Haynes, Nick",14,13,9,1,0,0,0,1
Greater Western Sydney,"Himmelberg, Harry",14,8,6,6,1,2,0,2
Greater Western Sydney,"Hopper, Jacob",17,11,3,6,1,0,0,3
Greater Western Sydney,"Kelly, Josh",30,21,8,9,2,1,0,5
Greater Western Sydney,"Langdon, Zac",13,5,4,8,1,0,0,2
Greater Western Sydney,"Patton, Jonathon",10,7,8,3,3,2,5,0
Greater Western Sydney,"Reid, Sam",15,5,2,10,1,0,0,2
Greater Western Sydney,"Shaw, Heath",23,16,8,7,0,0,0,3
Greater Western Sydney,"Shiel, Dylan",26,17,3,9,0,0,0,3
Greater Western Sydney,"Simpson, Dawson",11,4,1,7,0,0,21,6
Greater Western Sydney,"Taranto, Tim",18,11,4,7,1,2,0,6
Greater Western Sydney,"Taylor, Sam",8,2,1,6,0,0,0,1
Greater Western Sydney,"Tomlinson, Adam",10,6,3,4,0,0,2,1
Greater Western Sydney,"Ward, Callan",21,9,4,12,0,0,0,2
Greater Western Sydney,"Whitfield, Lachie",26,15,5,11,0,0,0,3
Greater Western Sydney,"de Boer, Matt",24,7,6,17,0,2,0,1
Greater Western Sydney,"Coniglio, Stephen",30,21,4,9,1,1,0,6
Greater Western Sydney,"Corr, Aidan",15,11,3,4,0,0,0,1
Greater Western Sydney,"Davis, Phil",18,7,5,11,0,0,0,3
Greater Western Sydney,"Finlayson, Jeremy",14,12,5,2,0,0,0,0
Greater Western Sydney,"Griffen, Ryan",15,5,1,10,1,0,0,3
Greater Western Sydney,"Haynes, Nick",20,15,7,5,0,0,0,3
Greater Western Sydney,"Himmelberg, Harry",21,10,4,11,1,0,0,3
Greater Western Sydney,"Hopper, Jacob",20,11,1,9,1,1,0,8
Greater Western Sydney,"Kelly, Josh",29,15,1,14,0,0,0,7
Greater Western Sydney,"Langdon, Zac",7,4,1,3,0,0,0,1
Greater Western Sydney,"Lobb, Rory",9,7,3,2,3,1,1,1
Greater Western Sydney,"Patton, Jonathon",10,6,5,4,1,3,8,1
Greater Western Sydney,"Reid, Sam",16,8,3,8,0,2,0,6
Greater Western Sydney,"Shaw, Heath",11,7,1,4,0,0,0,5
Greater Western Sydney,"Shiel, Dylan",28,15,3,13,1,1,0,0
Greater Western Sydney,"Simpson, Dawson",9,2,0,7,0,1,32,1
Greater Western Sydney,"Taranto, Tim",20,9,0,11,0,1,0,4
Greater Western Sydney,"Taylor, Sam",10,5,3,5,0,0,0,1
Greater Western Sydney,"Tomlinson, Adam",18,12,3,6,0,1,0,3
Greater Western Sydney,"Ward, Callan",32,14,4,18,2,0,1,6
Greater Western Sydney,"Whitfield, Lachie",25,11,5,14,1,0,0,2
Greater Western Sydney,"de Boer, Matt",11,5,3,6,1,1,0,7
Greater Western Sydney,"Coniglio, Stephen",30,17,6,13,1,1,0,1
Greater Western Sydney,"Corr, Aidan",10,5,4,5,0,0,0,2
Greater Western Sydney,"Daniels, Brent",10,6,3,4,0,1,0,0
Greater Western Sydney,"Davis, Phil",11,7,4,4,0,0,0,3
Greater Western Sydney,"Finlayson, Jeremy",13,8,5,5,0,0,0,1
Greater Western Sydney,"Griffen, Ryan",21,12,3,9,0,2,0,4
Greater Western Sydney,"Haynes, Nick",9,5,3,4,0,0,0,1
Greater Western Sydney,"Himmelberg, Harry",14,9,7,5,2,2,1,3
Greater Western Sydney,"Kelly, Josh",26,11,3,15,0,0,0,4
Greater Western Sydney,"Langdon, Zac",11,5,1,6,0,1,0,3
Greater Western Sydney,"Lobb, Rory",11,6,6,5,0,1,2,1
Greater Western Sydney,"Perryman, Harry",14,5,1,9,1,0,0,3
Greater Western Sydney,"Reid, Sam",10,7,4,3,0,1,0,2
Greater Western Sydney,"Shaw, Heath",14,8,5,6,0,0,0,3
Greater Western Sydney,"Shiel, Dylan",25,10,1,15,0,1,0,3
Greater Western Sydney,"Simpson, Dawson",8,2,1,6,0,0,23,3
Greater Western Sydney,"Taranto, Tim",28,16,5,12,0,1,0,7
Greater Western Sydney,"Taylor, Sam",5,2,0,3,0,0,0,7
Greater Western Sydney,"Tomlinson, Adam",24,10,7,14,3,0,3,2
Greater Western Sydney,"Ward, Callan",28,11,3,17,1,1,0,4
Greater Western Sydney,"Whitfield, Lachie",28,21,5,7,1,1,0,2
Greater Western Sydney,"de Boer, Matt",22,7,2,15,1,0,0,4
Greater Western Sydney,"Coniglio, Stephen",30,17,6,13,1,0,0,2
Greater Western Sydney,"Corr, Aidan",5,4,2,1,0,0,0,1
Greater Western Sydney,"Daniels, Brent",9,2,1,7,0,0,0,2
Greater Western Sydney,"Davis, Phil",15,8,4,7,0,0,0,0
Greater Western Sydney,"Greene, Toby",15,10,3,5,2,0,0,0
Greater Western Sydney,"Griffen, Ryan",20,12,4,8,1,2,0,2
Greater Western Sydney,"Haynes, Nick",16,14,5,2,0,0,0,0
Greater Western Sydney,"Himmelberg, Harry",12,6,3,6,0,2,0,2
Greater Western Sydney,"Hopper, Jacob",17,10,0,7,0,0,0,6
Greater Western Sydney,"Kelly, Josh",20,12,3,8,2,1,0,5
Greater Western Sydney,"Kennedy, Adam",11,9,3,2,0,0,0,2
Greater Western Sydney,"Langdon, Zac",15,7,6,8,3,0,0,4
Greater Western Sydney,"Lobb, Rory",9,6,3,3,0,1,0,3
Greater Western Sydney,"Reid, Sam",10,3,2,7,0,1,0,2
Greater Western Sydney,"Shaw, Heath",30,27,9,3,0,0,0,4
Greater Western Sydney,"Shiel, Dylan",29,16,5,13,0,0,0,2
Greater Western Sydney,"Simpson, Dawson",4,2,1,2,0,0,36,4
Greater Western Sydney,"Taranto, Tim",23,14,7,9,2,1,0,1
Greater Western Sydney,"Taylor, Sam",13,8,5,5,0,0,0,5
Greater Western Sydney,"Tomlinson, Adam",14,9,4,5,0,0,3,2
Greater Western Sydney,"Ward, Callan",32,16,4,16,0,0,1,2
Greater Western Sydney,"Whitfield, Lachie",35,23,12,12,0,0,0,6
Greater Western Sydney,"Buntine, Matt",13,10,5,3,0,0,0,1
Greater Western Sydney,"Coniglio, Stephen",25,15,4,10,1,0,0,8
Greater Western Sydney,"Daniels, Brent",9,3,1,6,0,1,0,3
Greater Western Sydney,"Davis, Phil",18,9,8,9,0,0,0,0
Greater Western Sydney,"Deledio, Brett",14,9,6,5,0,1,0,4
Greater Western Sydney,"Greene, Toby",12,7,1,5,2,1,0,2
Greater Western Sydney,"Haynes, Nick",15,14,4,1,0,0,0,5
Greater Western Sydney,"Himmelberg, Harry",9,4,3,5,2,0,0,4
Greater Western Sydney,"Hopper, Jacob",28,15,5,13,2,0,0,2
Greater Western Sydney,"Keeffe, Lachlan",7,4,4,3,0,0,0,0
Greater Western Sydney,"Kelly, Josh",30,20,3,10,0,3,0,5
Greater Western Sydney,"Kennedy, Adam",15,7,6,8,0,0,0,2
Greater Western Sydney,"Langdon, Zac",6,3,0,3,1,0,0,2
Greater Western Sydney,"Lobb, Rory",9,7,5,2,0,1,8,3
Greater Western Sydney,"Reid, Sam",10,7,3,3,1,2,0,4
Greater Western Sydney,"Shaw, Heath",28,20,5,8,0,0,0,3
Greater Western Sydney,"Shiel, Dylan",23,11,1,12,0,0,0,7
Greater Western Sydney,"Simpson, Dawson",11,5,2,6,0,0,46,7
Greater Western Sydney,"Taranto, Tim",16,8,2,8,1,0,0,6
Greater Western Sydney,"Tomlinson, Adam",13,7,5,6,1,0,1,0
Greater Western Sydney,"Ward, Callan",28,18,6,10,0,2,2,4
Greater Western Sydney,"Whitfield, Lachie",31,23,8,8,0,0,0,2
Greater Western Sydney,"Buntine, Matt",13,10,3,3,0,0,0,3
Greater Western Sydney,"Coniglio, Stephen",29,22,5,7,0,2,1,0
Greater Western Sydney,"Daniels, Brent",7,4,2,3,2,0,0,6
Greater Western Sydney,"Davis, Phil",17,9,7,8,0,0,0,1
Greater Western Sydney,"Deledio, Brett",24,9,4,15,1,0,0,1
Greater Western Sydney,"Greene, Toby",15,11,7,4,2,1,0,0
Greater Western Sydney,"Haynes, Nick",20,10,8,10,0,0,0,1
Greater Western Sydney,"Himmelberg, Harry",11,6,4,5,4,0,0,0
Greater Western Sydney,"Hopper, Jacob",23,7,2,16,0,0,0,8
Greater Western Sydney,"Kelly, Josh",32,19,8,13,0,1,0,5
Greater Western Sydney,"Kennedy, Adam",21,11,5,10,0,0,0,3
Greater Western Sydney,"Langdon, Zac",6,4,4,2,2,0,0,3
Greater Western Sydney,"Lobb, Rory",12,7,2,5,2,1,14,0
Greater Western Sydney,"Reid, Sam",7,2,1,5,0,0,0,5
Greater Western Sydney,"Shaw, Heath",25,22,6,3,0,0,0,2
Greater Western Sydney,"Shiel, Dylan",22,8,1,14,0,2,0,2
Greater Western Sydney,"Simpson, Dawson",10,4,2,6,0,0,19,1
Greater Western Sydney,"Taranto, Tim",24,15,7,9,0,1,0,5
Greater Western Sydney,"Taylor, Sam",10,7,3,3,0,0,0,5
Greater Western Sydney,"Tomlinson, Adam",17,9,6,8,0,0,2,4
Greater Western Sydney,"Ward, Callan",20,12,5,8,0,0,0,1
Greater Western Sydney,"Whitfield, Lachie",32,24,11,8,0,0,0,2
Greater Western Sydney,"Bonar, Aiden",16,8,3,8,2,0,0,6
Greater Western Sydney,"Buntine, Matt",17,9,6,8,0,0,0,0
Greater Western Sydney,"Cameron, Jeremy",17,14,8,3,4,1,0,1
Greater Western Sydney,"Coniglio, Stephen",36,21,6,15,2,0,0,6
Greater Western Sydney,"Daniels, Brent",10,3,1,7,2,0,0,4
Greater Western Sydney,"Davis, Phil",17,11,8,6,0,0,0,1
Greater Western Sydney,"Deledio, Brett",6,3,1,3,0,0,0,1
Greater Western Sydney,"Greene, Toby",4,3,2,1,0,0,0,0
Greater Western Sydney,"Haynes, Nick",11,7,3,4,0,0,0,0
Greater Western Sydney,"Himmelberg, Harry",15,4,4,11,3,0,0,1
Greater Western Sydney,"Hopper, Jacob",31,14,6,17,1,1,0,5
Greater Western Sydney,"Kelly, Josh",41,29,7,12,0,1,0,5
Greater Western Sydney,"Kennedy, Adam",26,14,9,12,2,0,0,2
Greater Western Sydney,"Langdon, Zac",10,6,3,4,1,0,0,7
Greater Western Sydney,"Lobb, Rory",11,10,5,1,0,1,10,6
Greater Western Sydney,"Shaw, Heath",19,18,2,1,0,0,0,2
Greater Western Sydney,"Simpson, Dawson",8,3,1,5,0,0,23,2
Greater Western Sydney,"Taylor, Sam",5,2,2,3,0,0,0,0
Greater Western Sydney,"Tomlinson, Adam",21,17,4,4,3,0,5,4
Greater Western Sydney,"Ward, Callan",34,19,7,15,0,2,0,9
Greater Western Sydney,"Whitfield, Lachie",28,19,6,9,1,1,0,5
Greater Western Sydney,"de Boer, Matt",18,8,6,10,2,2,0,5
Greater Western Sydney,"Bonar, Aiden",9,6,5,3,2,2,0,4
Greater Western Sydney,"Buntine, Matt",4,3,2,1,0,0,0,1
Greater Western Sydney,"Cameron, Jeremy",15,11,5,4,2,1,0,0
Greater Western Sydney,"Coniglio, Stephen",19,12,1,7,2,0,0,5
Greater Western Sydney,"Daniels, Brent",11,5,2,6,0,1,0,5
Greater Western Sydney,"Davis, Phil",17,8,9,9,0,0,0,2
Greater Western Sydney,"Griffen, Ryan",10,7,2,3,1,2,0,4
Greater Western Sydney,"Haynes, Nick",22,16,8,6,0,0,0,1
Greater Western Sydney,"Himmelberg, Harry",18,10,6,8,2,2,1,5
Greater Western Sydney,"Hopper, Jacob",17,12,2,5,2,0,0,6
Greater Western Sydney,"Keeffe, Lachlan",10,4,2,6,0,0,0,1
Greater Western Sydney,"Kelly, Josh",17,10,0,7,1,0,0,4
Greater Western Sydney,"Kennedy, Adam",13,9,5,4,0,0,0,1
Greater Western Sydney,"Langdon, Zac",13,5,3,8,0,0,0,6
Greater Western Sydney,"Lobb, Rory",15,12,3,3,1,1,40,8
Greater Western Sydney,"Reid, Sam",7,5,1,2,0,1,0,1
Greater Western Sydney,"Shaw, Heath",20,15,7,5,0,0,0,2
Greater Western Sydney,"Shiel, Dylan",24,18,3,6,1,0,0,5
Greater Western Sydney,"Taranto, Tim",16,11,2,5,0,1,0,10
Greater Western Sydney,"Tomlinson, Adam",12,8,1,4,0,0,3,4
Greater Western Sydney,"Ward, Callan",27,12,1,15,0,0,0,4
Greater Western Sydney,"Whitfield, Lachie",30,23,11,7,1,1,0,3
Greater Western Sydney,"Bonar, Aiden",5,3,2,2,1,0,0,4
Greater Western Sydney,"Buntine, Matt",13,8,5,5,0,0,0,1
Greater Western Sydney,"Cameron, Jeremy",8,5,2,3,1,1,0,6
Greater Western Sydney,"Coniglio, Stephen",21,15,4,6,1,1,0,4
Greater Western Sydney,"Daniels, Brent",8,3,1,5,0,0,0,1
Greater Western Sydney,"Davis, Phil",13,8,2,5,0,1,0,1
Greater Western Sydney,"Finlayson, Jeremy",11,9,3,2,0,0,0,1
Greater Western Sydney,"Griffen, Ryan",7,3,1,4,0,0,0,1
Greater Western Sydney,"Haynes, Nick",18,14,9,4,0,0,0,1
Greater Western Sydney,"Himmelberg, Harry",11,9,5,2,2,1,0,1
Greater Western Sydney,"Hopper, Jacob",20,9,1,11,0,0,0,1
Greater Western Sydney,"Keeffe, Lachlan",8,5,1,3,0,0,0,1
Greater Western Sydney,"Kennedy, Adam",17,13,5,4,0,0,0,2
Greater Western Sydney,"Langdon, Zac",10,7,3,3,0,1,0,6
Greater Western Sydney,"Lloyd, Daniel",13,8,2,5,2,0,0,4
Greater Western Sydney,"Lobb, Rory",7,5,2,2,0,1,38,3
Greater Western Sydney,"Perryman, Harry",18,7,1,11,0,0,0,5
Greater Western Sydney,"Shiel, Dylan",33,20,4,13,1,1,0,2
Greater Western Sydney,"Taranto, Tim",30,15,8,15,0,1,0,6
Greater Western Sydney,"Tomlinson, Adam",21,15,12,6,0,0,1,2
Greater Western Sydney,"Ward, Callan",27,15,7,12,0,0,6,8
Greater Western Sydney,"Whitfield, Lachie",17,12,2,5,0,0,0,5
Greater Western Sydney,"Bonar, Aiden",12,2,2,10,0,0,0,4
Greater Western Sydney,"Buntine, Matt",8,4,2,4,0,0,0,1
Greater Western Sydney,"Cameron, Jeremy",13,10,7,3,1,4,0,0
Greater Western Sydney,"Coniglio, Stephen",32,18,9,14,2,1,0,8
Greater Western Sydney,"Davis, Phil",14,8,7,6,0,0,0,2
Greater Western Sydney,"Finlayson, Jeremy",16,13,6,3,1,0,0,0
Greater Western Sydney,"Haynes, Nick",21,14,8,7,0,0,0,1
Greater Western Sydney,"Himmelberg, Harry",13,9,8,4,1,0,1,0
Greater Western Sydney,"Hopper, Jacob",11,6,4,5,0,0,0,1
Greater Western Sydney,"Keeffe, Lachlan",8,2,3,6,0,0,1,0
Greater Western Sydney,"Kelly, Josh",19,9,2,10,0,0,0,4
Greater Western Sydney,"Kennedy, Adam",19,10,6,9,0,0,0,2
Greater Western Sydney,"Langdon, Zac",8,3,2,5,1,0,0,2
Greater Western Sydney,"Lloyd, Daniel",7,5,5,2,0,0,0,1
Greater Western Sydney,"Lobb, Rory",10,7,4,3,1,0,12,2
Greater Western Sydney,"Perryman, Harry",22,11,6,11,0,0,0,1
Greater Western Sydney,"Reid, Sam",9,4,6,5,0,1,0,5
Greater Western Sydney,"Shiel, Dylan",27,12,4,15,0,0,0,2
Greater Western Sydney,"Taranto, Tim",20,10,5,10,0,0,0,5
Greater Western Sydney,"Tomlinson, Adam",20,17,6,3,1,0,4,1
Greater Western Sydney,"Ward, Callan",29,13,4,16,0,1,0,3
Greater Western Sydney,"Whitfield, Lachie",17,9,4,8,0,0,0,1
Greater Western Sydney,"Buntine, Matt",14,8,6,6,0,0,0,1
Greater Western Sydney,"Cameron, Jeremy",14,11,3,3,2,3,0,2
Greater Western Sydney,"Coniglio, Stephen",27,19,3,8,1,0,0,5
Greater Western Sydney,"Davis, Phil",18,8,10,10,0,0,0,2
Greater Western Sydney,"Deledio, Brett",22,12,7,10,0,0,0,4
Greater Western Sydney,"Greene, Toby",27,23,9,4,3,3,0,0
Greater Western Sydney,"Haynes, Nick",20,17,8,3,0,0,0,1
Greater Western Sydney,"Himmelberg, Harry",23,11,9,12,2,2,0,4
Greater Western Sydney,"Hopper, Jacob",26,18,5,8,0,3,0,5
Greater Western Sydney,"Kelly, Josh",7,4,1,3,0,0,0,1
Greater Western Sydney,"Kennedy, Adam",16,12,5,4,0,0,0,1
Greater Western Sydney,"Langdon, Zac",8,3,2,5,0,0,0,4
Greater Western Sydney,"Lobb, Rory",8,5,2,3,0,0,37,3
Greater Western Sydney,"Perryman, Harry",13,8,3,5,0,0,0,1
Greater Western Sydney,"Reid, Sam",12,8,4,4,0,0,0,2
Greater Western Sydney,"Shiel, Dylan",23,18,3,5,0,1,0,4
Greater Western Sydney,"Taranto, Tim",18,7,3,11,0,0,0,5
Greater Western Sydney,"Tomlinson, Adam",21,15,7,6,0,0,5,1
Greater Western Sydney,"Ward, Callan",29,12,3,17,1,2,0,1
Greater Western Sydney,"Whitfield, Lachie",29,18,8,11,0,2,0,5
Greater Western Sydney,"Williams, Zac",23,20,9,3,0,0,0,4
Greater Western Sydney,"de Boer, Matt",17,5,1,12,1,0,0,3
Greater Western Sydney,"Buntine, Matt",5,4,3,1,0,0,0,2
Greater Western Sydney,"Cameron, Jeremy",15,11,9,4,1,3,0,3
Greater Western Sydney,"Coniglio, Stephen",30,19,7,11,2,0,0,6
Greater Western Sydney,"Davis, Phil",15,8,4,7,0,0,0,3
Greater Western Sydney,"Deledio, Brett",18,6,3,12,0,0,0,4
Greater Western Sydney,"Greene, Toby",9,7,1,2,0,0,0,2
Greater Western Sydney,"Griffen, Ryan",8,5,2,3,1,0,0,3
Greater Western Sydney,"Haynes, Nick",11,9,3,2,0,0,0,1
Greater Western Sydney,"Himmelberg, Harry",10,5,4,5,1,1,0,1
Greater Western Sydney,"Hopper, Jacob",16,11,2,5,0,1,0,7
Greater Western Sydney,"Keeffe, Lachlan",8,5,3,3,0,0,0,2
Greater Western Sydney,"Kennedy, Adam",12,10,5,2,0,0,0,5
Greater Western Sydney,"Langdon, Zac",9,6,3,3,1,0,0,3
Greater Western Sydney,"Lobb, Rory",12,11,4,1,1,0,28,4
Greater Western Sydney,"Reid, Sam",10,6,4,4,0,0,0,2
Greater Western Sydney,"Shiel, Dylan",22,18,2,4,0,0,0,5
Greater Western Sydney,"Taranto, Tim",17,13,5,4,0,0,0,4
Greater Western Sydney,"Tomlinson, Adam",9,4,1,5,1,0,1,0
Greater Western Sydney,"Ward, Callan",18,10,3,8,0,0,0,7
Greater Western Sydney,"Whitfield, Lachie",31,23,8,8,0,0,0,3
Greater Western Sydney,"Williams, Zac",19,13,2,6,0,0,0,3
Greater Western Sydney,"de Boer, Matt",6,3,1,3,1,0,0,6
Hawthorn,"Breust, Luke",17,6,2,11,4,0,0,4
Hawthorn,"Burgoyne, Shaun",14,13,5,1,2,1,0,2
Hawthorn,"Burton, Ryan",8,3,0,5,0,0,0,0
Hawthorn,"Duryea, Taylor",17,10,5,7,0,1,0,3
Hawthorn,"Frawley, James",15,13,5,2,0,0,0,0
Hawthorn,"Gunston, Jack",22,17,7,5,2,1,0,0
Hawthorn,"Hardwick, Blake",15,11,4,4,0,0,0,7
Hawthorn,"Henderson, Ricky",21,13,4,8,2,0,0,3
Hawthorn,"Howe, Daniel",20,13,7,7,0,0,0,7
Hawthorn,"Impey, Jarman",18,7,2,11,0,1,0,4
Hawthorn,"McEvoy, Ben",12,3,1,9,0,0,21,3
Hawthorn,"Mitchell, Tom",54,20,8,34,0,0,0,2
Hawthorn,"OBrien, Tim",15,11,2,4,0,0,0,2
Hawthorn,"OMeara, Jaeger",27,14,4,13,0,1,0,5
Hawthorn,"Puopolo, Paul",15,5,2,10,0,0,0,7
Hawthorn,"Rioli, Cyril",14,10,2,4,1,1,0,0
Hawthorn,"Roughead, Jarryd",10,4,4,6,1,1,3,1
Hawthorn,"Schoenmakers, Ryan",11,6,2,5,1,0,5,2
Hawthorn,"Shiels, Liam",15,12,3,3,1,0,0,5
Hawthorn,"Sicily, James",26,17,7,9,0,0,0,2
Hawthorn,"Smith, Isaac",24,12,7,12,1,1,0,3
Hawthorn,"Stratton, Ben",12,5,3,7,0,0,0,2
Hawthorn,"Brand, Kaiden",8,3,2,5,0,0,0,1
Hawthorn,"Breust, Luke",13,7,1,6,0,2,0,6
Hawthorn,"Burgoyne, Shaun",4,1,1,3,0,1,0,1
Hawthorn,"Burton, Ryan",17,9,4,8,0,0,0,1
Hawthorn,"Duryea, Taylor",19,11,7,8,0,0,0,0
Hawthorn,"Gunston, Jack",13,10,8,3,2,2,0,3
Hawthorn,"Hardwick, Blake",15,13,9,2,0,0,0,3
Hawthorn,"Henderson, Ricky",19,12,5,7,2,2,0,4
Hawthorn,"Howe, Daniel",16,11,5,5,1,0,0,6
Hawthorn,"Impey, Jarman",16,11,2,5,2,1,0,3
Hawthorn,"McEvoy, Ben",16,6,5,10,1,0,43,3
Hawthorn,"Mitchell, Tom",40,21,4,19,2,0,0,4
Hawthorn,"OBrien, Tim",9,8,4,1,0,1,0,0
Hawthorn,"OMeara, Jaeger",21,9,3,12,1,0,0,3
Hawthorn,"Puopolo, Paul",9,5,1,4,1,0,0,1
Hawthorn,"Rioli, Cyril",7,2,2,5,0,0,0,3
Hawthorn,"Roughead, Jarryd",14,11,5,3,2,3,7,1
Hawthorn,"Schoenmakers, Ryan",5,4,2,1,0,1,0,0
Hawthorn,"Shiels, Liam",15,11,6,4,1,0,0,13
Hawthorn,"Sicily, James",19,14,3,5,0,0,0,2
Hawthorn,"Smith, Isaac",20,16,5,4,2,1,0,3
Hawthorn,"Stratton, Ben",8,6,4,2,0,0,0,1
Hawthorn,"Brand, Kaiden",10,7,4,3,0,0,0,4
Hawthorn,"Breust, Luke",14,10,2,4,3,0,0,1
Hawthorn,"Burton, Ryan",12,6,1,6,0,0,0,2
Hawthorn,"Duryea, Taylor",22,14,8,8,0,0,0,1
Hawthorn,"Frawley, James",11,5,1,6,0,0,0,1
Hawthorn,"Gunston, Jack",22,15,4,7,0,2,0,1
Hawthorn,"Hardwick, Blake",16,11,3,5,0,1,0,3
Hawthorn,"Henderson, Ricky",20,15,9,5,0,1,0,2
Hawthorn,"Howe, Daniel",21,11,6,10,0,1,0,1
Hawthorn,"Impey, Jarman",18,11,6,7,0,0,0,2
Hawthorn,"Langford, Will",9,1,1,8,0,0,0,2
Hawthorn,"McEvoy, Ben",11,7,5,4,0,1,39,0
Hawthorn,"Mitchell, Tom",42,21,2,21,1,0,0,8
Hawthorn,"Morrison, Harry",12,8,6,4,0,1,0,2
Hawthorn,"OBrien, Tim",7,6,4,1,0,0,2,2
Hawthorn,"OMeara, Jaeger",23,13,5,10,1,0,0,3
Hawthorn,"Puopolo, Paul",17,9,1,8,3,0,0,2
Hawthorn,"Rioli, Cyril",12,8,0,4,1,1,0,4
Hawthorn,"Roughead, Jarryd",11,8,7,3,4,0,1,1
Hawthorn,"Shiels, Liam",15,8,4,7,0,0,0,5
Hawthorn,"Smith, Isaac",23,15,8,8,0,1,0,2
Hawthorn,"Stratton, Ben",15,10,4,5,0,0,0,4
Hawthorn,"Breust, Luke",19,13,3,6,4,0,0,9
Hawthorn,"Duryea, Taylor",18,12,4,6,0,0,0,2
Hawthorn,"Frawley, James",5,3,1,2,0,0,0,3
Hawthorn,"Glass, Conor",11,7,0,4,0,0,0,3
Hawthorn,"Gunston, Jack",19,15,6,4,2,0,0,8
Hawthorn,"Hardwick, Blake",12,7,1,5,0,0,0,3
Hawthorn,"Henderson, Ricky",18,9,5,9,1,1,0,8
Hawthorn,"Howe, Daniel",16,8,4,8,0,0,0,9
Hawthorn,"Impey, Jarman",23,17,5,6,0,2,0,3
Hawthorn,"McEvoy, Ben",6,0,1,6,0,0,27,3
Hawthorn,"Mirra, David",18,13,3,5,0,0,0,1
Hawthorn,"Mitchell, Tom",24,11,0,13,0,0,0,5
Hawthorn,"Morrison, Harry",18,11,3,7,0,0,0,5
Hawthorn,"OBrien, Tim",14,11,5,3,3,0,4,4
Hawthorn,"OMeara, Jaeger",26,17,3,9,2,0,0,9
Hawthorn,"Puopolo, Paul",9,3,2,6,1,0,0,8
Hawthorn,"Rioli, Cyril",6,3,0,3,0,0,0,3
Hawthorn,"Roughead, Jarryd",15,11,4,4,3,1,3,4
Hawthorn,"Shiels, Liam",31,20,0,11,0,0,0,14
Hawthorn,"Sicily, James",23,13,5,10,0,0,0,1
Hawthorn,"Smith, Isaac",22,13,1,9,2,1,0,5
Hawthorn,"Stratton, Ben",10,6,2,4,0,0,0,3
Hawthorn,"Breust, Luke",15,9,5,6,5,1,0,4
Hawthorn,"Burton, Ryan",9,7,4,2,0,0,0,3
Hawthorn,"Cousins, James",17,7,5,10,0,0,0,2
Hawthorn,"Duryea, Taylor",19,10,4,9,0,1,0,2
Hawthorn,"Frawley, James",15,10,3,5,0,0,0,2
Hawthorn,"Glass, Conor",13,9,1,4,0,0,0,3
Hawthorn,"Gunston, Jack",16,7,4,9,2,1,0,1
Hawthorn,"Hardwick, Blake",13,9,5,4,0,0,0,2
Hawthorn,"Henderson, Ricky",26,16,9,10,0,0,0,1
Hawthorn,"Howe, Daniel",18,9,6,9,0,0,0,3
Hawthorn,"Impey, Jarman",15,11,3,4,1,1,0,4
Hawthorn,"McEvoy, Ben",12,6,4,6,0,0,29,1
Hawthorn,"Mirra, David",17,12,6,5,0,0,0,0
Hawthorn,"Mitchell, Tom",19,11,4,8,0,0,0,6
Hawthorn,"Morrison, Harry",16,11,4,5,0,0,0,1
Hawthorn,"OBrien, Tim",7,2,0,5,0,0,0,1
Hawthorn,"OMeara, Jaeger",16,8,4,8,0,0,0,5
Hawthorn,"Roughead, Jarryd",16,5,3,11,0,0,5,2
Hawthorn,"Shiels, Liam",16,10,1,6,2,0,0,2
Hawthorn,"Sicily, James",28,19,11,9,0,0,0,1
Hawthorn,"Smith, Isaac",25,19,10,6,1,0,0,0
Hawthorn,"Stratton, Ben",10,4,3,6,0,0,0,1
Hawthorn,"Breust, Luke",16,10,6,6,3,2,0,5
Hawthorn,"Burgoyne, Shaun",16,7,5,9,0,2,0,2
Hawthorn,"Burton, Ryan",18,10,5,8,0,0,0,0
Hawthorn,"Cousins, James",14,8,3,6,0,0,0,2
Hawthorn,"Duryea, Taylor",21,12,7,9,0,0,0,1
Hawthorn,"Frawley, James",12,11,4,1,0,0,0,1
Hawthorn,"Gunston, Jack",16,13,5,3,3,1,0,3
Hawthorn,"Hardwick, Blake",23,15,6,8,0,0,0,2
Hawthorn,"Henderson, Ricky",29,16,6,13,0,0,0,0
Hawthorn,"Howe, Daniel",20,13,6,7,1,0,0,2
Hawthorn,"Impey, Jarman",11,5,2,6,1,0,0,8
Hawthorn,"Langford, Will",15,9,3,6,0,0,0,3
Hawthorn,"McEvoy, Ben",22,9,5,13,0,0,25,3
Hawthorn,"Mirra, David",15,11,4,4,0,0,0,1
Hawthorn,"Mitchell, Tom",45,22,7,23,0,0,0,3
Hawthorn,"Morrison, Harry",25,17,8,8,1,0,0,2
Hawthorn,"OBrien, Tim",12,8,5,4,0,2,7,2
Hawthorn,"OMeara, Jaeger",21,8,4,13,0,0,0,6
Hawthorn,"Roughead, Jarryd",18,7,1,11,0,1,1,4
Hawthorn,"Smith, Isaac",24,16,6,8,4,0,0,4
Hawthorn,"Stratton, Ben",11,3,3,8,0,0,0,2
Hawthorn,"Worpel, James",13,6,1,7,0,1,0,3
Hawthorn,"Breust, Luke",15,10,6,5,1,1,0,4
Hawthorn,"Burgoyne, Shaun",18,8,5,10,0,0,0,1
Hawthorn,"Burton, Ryan",15,7,3,8,0,0,0,3
Hawthorn,"Cousins, James",12,5,3,7,0,0,0,2
Hawthorn,"Duryea, Taylor",22,11,7,11,0,0,0,2
Hawthorn,"Frawley, James",15,8,5,7,0,0,0,2
Hawthorn,"Gunston, Jack",12,8,3,4,1,2,0,3
Hawthorn,"Hardwick, Blake",18,10,4,8,0,0,0,3
Hawthorn,"Howe, Daniel",11,7,3,4,0,0,0,2
Hawthorn,"Impey, Jarman",8,7,2,1,1,1,0,4
Hawthorn,"McEvoy, Ben",11,5,3,6,0,1,27,2
Hawthorn,"Mitchell, Tom",29,14,1,15,1,0,0,10
Hawthorn,"Morrison, Harry",15,9,5,6,0,1,0,2
Hawthorn,"OBrien, Tim",15,7,1,8,0,0,6,1
Hawthorn,"OMeara, Jaeger",22,13,4,9,1,0,0,3
Hawthorn,"Roughead, Jarryd",16,11,7,5,3,2,2,2
Hawthorn,"Shiels, Liam",16,14,2,2,1,0,0,10
Hawthorn,"Sicily, James",29,23,14,6,1,0,0,2
Hawthorn,"Smith, Isaac",20,13,6,7,2,0,0,4
Hawthorn,"Stratton, Ben",9,5,3,4,0,0,0,2
Hawthorn,"Whitecross, Brendan",12,8,5,4,1,1,0,5
Hawthorn,"Worpel, James",6,2,0,4,0,0,0,3
Hawthorn,"Breust, Luke",18,12,6,6,3,1,0,5
Hawthorn,"Burgoyne, Shaun",26,12,6,14,0,1,0,10
Hawthorn,"Burton, Ryan",17,13,5,4,0,0,0,1
Hawthorn,"Duryea, Taylor",13,8,3,5,0,0,0,1
Hawthorn,"Frawley, James",20,11,5,9,0,0,0,4
Hawthorn,"Gunston, Jack",15,13,4,2,5,3,0,3
Hawthorn,"Hardwick, Blake",15,6,5,9,0,0,0,4
Hawthorn,"Henderson, Ricky",24,12,3,12,0,0,0,4
Hawthorn,"Howe, Daniel",13,7,3,6,0,0,0,9
Hawthorn,"Impey, Jarman",14,10,2,4,0,0,0,5
Hawthorn,"Langford, Will",14,10,2,4,0,1,0,1
Hawthorn,"McEvoy, Ben",18,5,5,13,0,1,36,4
Hawthorn,"Mitchell, Tom",20,7,1,13,0,0,0,4
Hawthorn,"Morrison, Harry",15,10,4,5,1,0,0,2
Hawthorn,"OBrien, Tim",13,7,2,6,0,0,4,1
Hawthorn,"OMeara, Jaeger",13,10,3,3,0,1,0,8
Hawthorn,"Roughead, Jarryd",15,6,3,9,1,1,2,4
Hawthorn,"Shiels, Liam",23,14,2,9,0,0,0,7
Hawthorn,"Sicily, James",26,21,9,5,0,0,0,1
Hawthorn,"Smith, Isaac",16,13,7,3,0,0,0,2
Hawthorn,"Stratton, Ben",18,15,7,3,0,0,0,2
Hawthorn,"Whitecross, Brendan",14,11,6,3,0,0,0,2
Hawthorn,"Brand, Kaiden",12,8,2,4,0,0,0,2
Hawthorn,"Breust, Luke",11,3,1,8,0,1,0,5
Hawthorn,"Burgoyne, Shaun",21,6,1,15,0,0,0,2
Hawthorn,"Burton, Ryan",19,9,4,10,0,0,0,1
Hawthorn,"Cousins, James",8,4,2,4,0,0,0,5
Hawthorn,"Duryea, Taylor",14,7,2,7,0,1,0,2
Hawthorn,"Gunston, Jack",17,11,3,6,4,0,0,2
Hawthorn,"Hardwick, Blake",18,10,5,8,0,0,0,1
Hawthorn,"Henderson, Ricky",15,11,4,4,0,0,0,1
Hawthorn,"Impey, Jarman",25,19,5,6,0,0,0,1
Hawthorn,"Lewis, Mitch",10,3,1,7,0,0,3,3
Hawthorn,"McEvoy, Ben",11,6,6,5,0,0,29,4
Hawthorn,"Mirra, David",24,12,8,12,0,0,0,3
Hawthorn,"Mitchell, Tom",46,20,5,26,1,1,0,4
Hawthorn,"Morrison, Harry",15,9,7,6,0,0,0,7
Hawthorn,"Puopolo, Paul",6,3,2,3,0,0,0,6
Hawthorn,"Roughead, Jarryd",18,11,4,7,2,0,4,0
Hawthorn,"Shiels, Liam",28,20,5,8,0,1,0,7
Hawthorn,"Sicily, James",19,11,5,8,1,0,0,0
Hawthorn,"Smith, Isaac",25,13,5,12,2,1,0,3
Hawthorn,"Stratton, Ben",14,4,3,10,0,0,0,2
Hawthorn,"Worpel, James",11,3,0,8,1,0,0,3
Hawthorn,"Breust, Luke",13,7,1,6,0,0,0,5
Hawthorn,"Burgoyne, Shaun",13,6,3,7,0,0,0,4
Hawthorn,"Burton, Ryan",22,18,8,4,0,1,0,2
Hawthorn,"Ceglar, Jonathon",6,3,2,3,1,0,12,2
Hawthorn,"Duryea, Taylor",17,11,4,6,0,0,0,3
Hawthorn,"Frawley, James",14,11,8,3,0,0,0,2
Hawthorn,"Gunston, Jack",11,8,4,3,0,2,0,0
Hawthorn,"Hardwick, Blake",18,9,7,9,1,0,0,4
Hawthorn,"Henderson, Ricky",19,13,9,6,0,0,0,8
Hawthorn,"Impey, Jarman",17,12,4,5,2,0,0,6
Hawthorn,"Lewis, Mitch",6,1,1,5,0,0,0,0
Hawthorn,"McEvoy, Ben",11,5,2,6,0,0,22,3
Hawthorn,"Mirra, David",15,11,6,4,0,0,0,2
Hawthorn,"Mitchell, Tom",28,16,7,12,0,0,0,10
Hawthorn,"Morrison, Harry",13,7,4,6,0,0,0,1
Hawthorn,"OMeara, Jaeger",20,14,6,6,3,1,0,5
Hawthorn,"Puopolo, Paul",13,5,1,8,1,0,0,4
Hawthorn,"Roughead, Jarryd",22,9,4,13,0,1,0,2
Hawthorn,"Shiels, Liam",29,19,4,10,0,0,0,7
Hawthorn,"Sicily, James",21,16,3,5,0,0,0,2
Hawthorn,"Smith, Isaac",24,16,10,8,1,0,0,3
Hawthorn,"Stratton, Ben",11,7,1,4,0,0,0,1
Hawthorn,"Breust, Luke",12,8,6,4,1,1,0,2
Hawthorn,"Burgoyne, Shaun",26,12,6,14,1,1,0,3
Hawthorn,"Burton, Ryan",19,13,11,6,0,0,0,2
Hawthorn,"Ceglar, Jonathon",4,3,2,1,0,0,9,2
Hawthorn,"Duryea, Taylor",14,13,9,1,0,0,0,1
Hawthorn,"Frawley, James",13,11,8,2,0,0,0,2
Hawthorn,"Gunston, Jack",25,17,10,8,0,1,0,0
Hawthorn,"Hardwick, Blake",17,13,10,4,0,0,0,1
Hawthorn,"Henderson, Ricky",25,14,6,11,0,0,0,1
Hawthorn,"Howe, Daniel",19,11,4,8,0,0,0,7
Hawthorn,"Impey, Jarman",10,7,4,3,1,0,0,3
Hawthorn,"McEvoy, Ben",15,9,7,6,2,0,22,2
Hawthorn,"Mitchell, Tom",28,16,8,12,2,0,0,8
Hawthorn,"Morrison, Harry",6,4,3,2,0,0,0,3
Hawthorn,"OBrien, Tim",5,4,2,1,0,1,0,1
Hawthorn,"OMeara, Jaeger",21,12,5,9,0,0,0,5
Hawthorn,"Puopolo, Paul",8,5,1,3,1,0,0,2
Hawthorn,"Roughead, Jarryd",21,9,5,12,1,3,0,2
Hawthorn,"Shiels, Liam",23,17,10,6,0,0,0,3
Hawthorn,"Sicily, James",22,16,10,6,0,0,0,1
Hawthorn,"Smith, Isaac",19,12,6,7,0,0,0,2
Hawthorn,"Stratton, Ben",17,14,10,3,0,0,0,0
Hawthorn,"Brand, Kaiden",13,10,8,3,0,0,0,0
Hawthorn,"Breust, Luke",23,10,2,13,1,2,0,6
Hawthorn,"Burgoyne, Shaun",24,7,3,17,1,2,0,5
Hawthorn,"Burton, Ryan",16,11,6,5,0,0,0,2
Hawthorn,"Ceglar, Jonathon",12,6,4,6,1,1,19,1
Hawthorn,"Duryea, Taylor",10,6,2,4,0,2,0,2
Hawthorn,"Gunston, Jack",27,18,7,9,1,0,0,1
Hawthorn,"Hardwick, Blake",17,10,4,7,1,0,0,1
Hawthorn,"Henderson, Ricky",16,10,2,6,0,0,0,4
Hawthorn,"Howe, Daniel",26,10,4,16,0,0,0,5
Hawthorn,"Impey, Jarman",23,12,4,11,0,0,0,1
Hawthorn,"Langford, Will",11,8,2,3,0,0,0,3
Hawthorn,"McEvoy, Ben",10,2,2,8,0,0,30,4
Hawthorn,"Mitchell, Tom",40,16,4,24,0,1,0,3
Hawthorn,"Morrison, Harry",15,9,7,6,0,0,0,1
Hawthorn,"OMeara, Jaeger",30,13,4,17,0,2,0,8
Hawthorn,"Puopolo, Paul",11,6,0,5,1,0,0,1
Hawthorn,"Roughead, Jarryd",15,10,3,5,1,2,1,4
Hawthorn,"Shiels, Liam",20,9,3,11,1,0,0,2
Hawthorn,"Sicily, James",24,18,8,6,3,0,0,0
Hawthorn,"Smith, Isaac",22,11,4,11,1,1,0,0
Hawthorn,"Stratton, Ben",10,9,6,1,0,0,0,2
Hawthorn,"Breust, Luke",21,15,8,6,2,3,0,3
Hawthorn,"Burgoyne, Shaun",19,10,7,9,1,2,0,0
Hawthorn,"Burton, Ryan",19,11,3,8,0,1,0,2
Hawthorn,"Duryea, Taylor",15,11,5,4,0,2,0,2
Hawthorn,"Frawley, James",12,9,4,3,0,0,0,2
Hawthorn,"Gunston, Jack",13,9,5,4,3,1,0,0
Hawthorn,"Hardwick, Blake",15,6,3,9,0,0,0,3
Hawthorn,"Henderson, Ricky",18,14,7,4,0,2,0,2
Hawthorn,"Howe, Daniel",20,11,6,9,1,0,0,2
Hawthorn,"Impey, Jarman",19,15,7,4,0,0,0,7
Hawthorn,"Langford, Will",13,5,2,8,0,0,0,2
Hawthorn,"McEvoy, Ben",9,3,3,6,0,1,25,6
Hawthorn,"Mitchell, Tom",31,13,3,18,0,0,0,2
Hawthorn,"Morrison, Harry",11,8,6,3,0,1,0,0
Hawthorn,"OBrien, Tim",13,9,8,4,1,2,6,2
Hawthorn,"OMeara, Jaeger",24,15,4,9,1,0,0,10
Hawthorn,"Puopolo, Paul",14,7,3,7,1,0,0,4
Hawthorn,"Roughead, Jarryd",10,6,4,4,1,1,0,1
Hawthorn,"Shiels, Liam",33,20,10,13,1,0,0,2
Hawthorn,"Sicily, James",23,14,6,9,0,0,0,4
Hawthorn,"Smith, Isaac",19,7,5,12,1,0,0,2
Hawthorn,"Stratton, Ben",9,6,5,3,0,0,0,2
Hawthorn,"Breust, Luke",14,11,7,3,3,2,0,6
Hawthorn,"Burton, Ryan",18,13,2,5,0,1,0,3
Hawthorn,"Ceglar, Jonathon",15,4,4,11,2,0,14,1
Hawthorn,"Duryea, Taylor",8,5,3,3,0,0,0,8
Hawthorn,"Frawley, James",12,8,3,4,0,0,0,2
Hawthorn,"Glass, Conor",11,7,4,4,0,0,0,6
Hawthorn,"Hardwick, Blake",20,7,2,13,0,0,0,6
Hawthorn,"Henderson, Ricky",13,7,3,6,1,0,0,1
Hawthorn,"Howe, Daniel",14,8,3,6,0,0,0,4
Hawthorn,"Impey, Jarman",15,13,7,2,0,0,0,5
Hawthorn,"Langford, Will",5,3,2,2,0,0,0,0
Hawthorn,"McEvoy, Ben",6,2,2,4,1,0,29,6
Hawthorn,"Mitchell, Tom",50,18,9,32,0,0,0,13
Hawthorn,"Morrison, Harry",8,4,2,4,0,0,0,6
Hawthorn,"OBrien, Tim",15,11,5,4,0,0,0,0
Hawthorn,"OMeara, Jaeger",24,11,4,13,0,0,0,10
Hawthorn,"Puopolo, Paul",10,7,3,3,2,1,0,10
Hawthorn,"Roughead, Jarryd",14,8,2,6,2,0,0,4
Hawthorn,"Shiels, Liam",19,6,2,13,0,0,0,6
Hawthorn,"Sicily, James",24,15,3,9,1,1,0,3
Hawthorn,"Smith, Isaac",26,18,6,8,1,1,0,4
Hawthorn,"Stratton, Ben",17,10,3,7,0,0,0,4
Hawthorn,"Breust, Luke",24,13,8,11,6,2,0,7
Hawthorn,"Burton, Ryan",17,9,3,8,0,1,0,3
Hawthorn,"Ceglar, Jonathon",6,0,1,6,0,0,14,1
Hawthorn,"Duryea, Taylor",11,6,4,5,0,0,0,1
Hawthorn,"Frawley, James",13,6,6,7,0,0,0,2
Hawthorn,"Gunston, Jack",21,15,10,6,4,2,0,1
Hawthorn,"Hardwick, Blake",12,3,1,9,0,0,0,4
Hawthorn,"Henderson, Ricky",21,15,9,6,0,0,0,1
Hawthorn,"Howe, Daniel",25,11,8,14,1,0,0,6
Hawthorn,"Impey, Jarman",15,9,5,6,0,0,0,4
Hawthorn,"McEvoy, Ben",14,3,2,11,0,1,36,8
Hawthorn,"Miles, Teia",18,9,3,9,0,0,0,3
Hawthorn,"Mitchell, Tom",27,14,0,13,0,0,0,7
Hawthorn,"Morrison, Harry",12,10,6,2,1,0,0,3
Hawthorn,"OMeara, Jaeger",28,15,4,13,1,0,0,2
Hawthorn,"ORourke, Jonathan",13,6,5,7,0,0,0,2
Hawthorn,"Puopolo, Paul",15,5,1,10,0,0,0,3
Hawthorn,"Roughead, Jarryd",18,12,6,6,4,1,1,5
Hawthorn,"Shiels, Liam",29,20,4,9,0,0,0,6
Hawthorn,"Sicily, James",28,22,12,6,0,0,0,1
Hawthorn,"Smith, Isaac",30,17,8,13,2,1,0,2
Hawthorn,"Stratton, Ben",9,4,2,5,0,0,0,2
Hawthorn,"Breust, Luke",12,7,3,5,0,2,0,3
Hawthorn,"Burton, Ryan",18,12,5,6,0,0,0,3
Hawthorn,"Ceglar, Jonathon",9,3,3,6,0,0,30,1
Hawthorn,"Duryea, Taylor",7,5,3,2,1,0,0,1
Hawthorn,"Frawley, James",15,13,3,2,0,0,0,0
Hawthorn,"Gunston, Jack",16,9,5,7,2,0,0,2
Hawthorn,"Hardwick, Blake",21,11,6,10,0,0,0,0
Hawthorn,"Henderson, Ricky",14,8,3,6,0,1,0,5
Hawthorn,"Howe, Daniel",15,9,5,6,0,0,0,4
Hawthorn,"Impey, Jarman",15,11,2,4,0,0,0,2
Hawthorn,"Miles, Teia",16,10,6,6,0,0,0,2
Hawthorn,"Mitchell, Tom",43,15,7,28,1,1,0,7
Hawthorn,"Morrison, Harry",14,6,5,8,0,0,0,3
Hawthorn,"OBrien, Tim",7,4,0,3,0,0,2,1
Hawthorn,"OMeara, Jaeger",27,15,2,12,4,0,0,8
Hawthorn,"Puopolo, Paul",13,8,2,5,0,0,0,4
Hawthorn,"Roughead, Jarryd",13,8,4,5,0,1,0,5
Hawthorn,"Shiels, Liam",34,19,4,15,0,1,0,7
Hawthorn,"Sicily, James",23,17,9,6,0,0,0,1
Hawthorn,"Smith, Isaac",24,12,6,12,0,0,0,2
Hawthorn,"Stratton, Ben",10,5,4,5,0,0,0,3
Hawthorn,"Whitecross, Brendan",18,9,5,9,1,2,0,3
Hawthorn,"Brand, Kaiden",13,5,4,8,0,0,0,0
Hawthorn,"Breust, Luke",14,10,6,4,5,1,0,4
Hawthorn,"Burton, Ryan",17,11,6,6,0,0,0,2
Hawthorn,"Ceglar, Jonathon",16,7,3,9,0,0,37,3
Hawthorn,"Frawley, James",11,8,4,3,0,0,0,2
Hawthorn,"Gunston, Jack",16,11,3,5,2,2,0,2
Hawthorn,"Hardwick, Blake",23,10,7,13,0,0,0,2
Hawthorn,"Henderson, Ricky",20,10,8,10,1,0,0,3
Hawthorn,"Howe, Daniel",19,7,2,12,0,0,0,4
Hawthorn,"Impey, Jarman",19,11,1,8,0,0,0,0
Hawthorn,"Miles, Teia",16,10,4,6,1,0,0,1
Hawthorn,"Mitchell, Tom",46,21,9,25,2,2,0,9
Hawthorn,"Morrison, Harry",13,7,5,6,0,1,0,2
Hawthorn,"ORourke, Jonathan",19,8,2,11,0,0,0,0
Hawthorn,"Puopolo, Paul",22,14,5,8,4,2,0,2
Hawthorn,"Roughead, Jarryd",18,11,5,7,1,2,7,1
Hawthorn,"Schoenmakers, Ryan",14,10,8,4,2,1,0,2
Hawthorn,"Shiels, Liam",19,10,4,9,0,0,0,4
Hawthorn,"Smith, Isaac",18,9,4,9,0,2,0,3
Hawthorn,"Stratton, Ben",18,7,3,11,0,0,0,1
Hawthorn,"Whitecross, Brendan",17,8,2,9,0,1,0,3
Hawthorn,"Worpel, James",32,12,2,20,0,1,0,4
Hawthorn,"Brand, Kaiden",18,12,4,6,0,0,0,2
Hawthorn,"Breust, Luke",19,11,6,8,4,0,0,4
Hawthorn,"Burgoyne, Shaun",20,14,2,6,1,1,0,6
Hawthorn,"Burton, Ryan",23,11,2,12,0,0,0,0
Hawthorn,"Ceglar, Jonathon",12,7,4,5,0,0,27,3
Hawthorn,"Frawley, James",17,11,6,6,0,0,0,2
Hawthorn,"Gunston, Jack",19,12,7,7,2,0,0,0
Hawthorn,"Hardwick, Blake",22,9,5,13,1,0,0,1
Hawthorn,"Henderson, Ricky",23,14,7,9,0,0,0,2
Hawthorn,"Impey, Jarman",15,11,4,4,0,0,0,3
Hawthorn,"Miles, Teia",23,18,4,5,1,0,0,4
Hawthorn,"Mitchell, Tom",42,18,9,24,2,0,0,5
Hawthorn,"OMeara, Jaeger",33,19,8,14,1,0,0,3
Hawthorn,"ORourke, Jonathan",20,6,4,14,0,0,0,4
Hawthorn,"Puopolo, Paul",10,4,1,6,1,0,0,5
Hawthorn,"Roughead, Jarryd",20,11,6,9,1,2,4,2
Hawthorn,"Schoenmakers, Ryan",13,7,6,6,2,2,0,3
Hawthorn,"Shiels, Liam",27,14,7,13,1,0,0,6
Hawthorn,"Smith, Isaac",22,11,7,11,0,2,0,2
Hawthorn,"Stratton, Ben",20,9,5,11,0,0,0,2
Hawthorn,"Whitecross, Brendan",10,6,6,4,0,0,0,4
Hawthorn,"Worpel, James",16,8,2,8,0,1,0,3
Hawthorn,"Brand, Kaiden",15,9,8,6,0,0,0,1
Hawthorn,"Breust, Luke",14,10,6,4,3,1,0,3
Hawthorn,"Burgoyne, Shaun",22,15,2,7,0,0,0,6
Hawthorn,"Burton, Ryan",21,15,7,6,0,0,0,1
Hawthorn,"Ceglar, Jonathon",10,4,4,6,1,0,33,2
Hawthorn,"Frawley, James",15,11,7,4,0,0,0,0
Hawthorn,"Gunston, Jack",24,20,8,4,5,3,0,1
Hawthorn,"Hardwick, Blake",16,7,2,9,0,0,0,0
Hawthorn,"Henderson, Ricky",21,15,8,6,2,1,0,3
Hawthorn,"Impey, Jarman",13,12,5,1,0,1,0,0
Hawthorn,"Miles, Teia",18,10,4,8,0,0,0,1
Hawthorn,"Mitchell, Tom",43,23,6,20,0,0,0,4
Hawthorn,"Morrison, Harry",22,12,6,10,0,1,0,1
Hawthorn,"OMeara, Jaeger",30,12,1,18,0,0,0,4
Hawthorn,"Puopolo, Paul",11,8,5,3,0,0,0,2
Hawthorn,"Roughead, Jarryd",15,9,4,6,1,1,12,4
Hawthorn,"Schoenmakers, Ryan",8,5,1,3,0,2,0,4
Hawthorn,"Shiels, Liam",21,11,1,10,0,0,0,6
Hawthorn,"Smith, Isaac",21,13,6,8,2,0,0,0
Hawthorn,"Stratton, Ben",19,14,11,5,0,0,0,2
Hawthorn,"Whitecross, Brendan",9,6,3,3,1,0,0,1
Hawthorn,"Worpel, James",16,12,3,4,1,0,0,5
Hawthorn,"Brand, Kaiden",15,8,7,7,0,0,0,0
Hawthorn,"Breust, Luke",17,10,2,7,2,0,0,2
Hawthorn,"Burgoyne, Shaun",20,11,5,9,0,0,0,14
Hawthorn,"Burton, Ryan",18,12,5,6,0,0,0,0
Hawthorn,"Ceglar, Jonathon",9,6,5,3,1,0,23,3
Hawthorn,"Frawley, James",17,13,5,4,0,0,0,1
Hawthorn,"Gunston, Jack",15,10,1,5,2,2,0,4
Hawthorn,"Hardwick, Blake",19,11,5,8,0,0,0,1
Hawthorn,"Henderson, Ricky",22,13,8,9,0,0,0,4
Hawthorn,"Impey, Jarman",16,11,0,5,0,1,0,3
Hawthorn,"Miles, Teia",18,11,3,7,0,0,0,2
Hawthorn,"Mitchell, Tom",32,22,5,10,0,1,0,7
Hawthorn,"Morrison, Harry",15,7,5,8,1,0,0,6
Hawthorn,"Nash, Conor",5,2,1,3,0,0,0,5
Hawthorn,"OMeara, Jaeger",24,13,3,11,1,0,0,6
Hawthorn,"Pittonet, Marc",6,2,2,4,0,1,25,3
Hawthorn,"Puopolo, Paul",21,11,4,10,0,1,0,7
Hawthorn,"Schoenmakers, Ryan",11,5,1,6,1,0,4,3
Hawthorn,"Shiels, Liam",21,16,5,5,0,0,0,9
Hawthorn,"Smith, Isaac",21,10,8,11,2,1,0,4
Hawthorn,"Stratton, Ben",8,5,3,3,0,0,0,3
Hawthorn,"Worpel, James",23,12,5,11,0,1,0,8
Hawthorn,"Brand, Kaiden",9,7,3,2,0,0,0,2
Hawthorn,"Breust, Luke",15,7,3,8,2,1,0,2
Hawthorn,"Burgoyne, Shaun",24,14,8,10,1,0,0,4
Hawthorn,"Burton, Ryan",13,8,7,5,0,0,0,3
Hawthorn,"Frawley, James",9,5,2,4,0,0,0,0
Hawthorn,"Glass, Conor",13,8,6,5,0,0,0,1
Hawthorn,"Gunston, Jack",24,19,7,5,4,1,0,2
Hawthorn,"Hardwick, Blake",13,6,2,7,0,0,0,4
Hawthorn,"Impey, Jarman",19,11,4,8,1,1,0,3
Hawthorn,"McEvoy, Ben",11,7,5,4,2,0,32,2
Hawthorn,"Miles, Teia",18,13,5,5,0,0,0,1
Hawthorn,"Mitchell, Tom",33,11,3,22,0,1,0,6
Hawthorn,"Morrison, Harry",14,7,4,7,0,0,0,3
Hawthorn,"Nash, Conor",16,10,6,6,1,2,0,7
Hawthorn,"OMeara, Jaeger",27,15,4,12,0,0,0,4
Hawthorn,"Pittonet, Marc",3,1,1,2,0,0,25,4
Hawthorn,"Puopolo, Paul",13,5,2,8,0,0,0,2
Hawthorn,"Schoenmakers, Ryan",7,4,2,3,0,1,0,2
Hawthorn,"Shiels, Liam",23,13,0,10,0,0,0,7
Hawthorn,"Smith, Isaac",16,7,2,9,0,1,0,2
Hawthorn,"Stratton, Ben",7,4,4,3,0,0,0,2
Hawthorn,"Worpel, James",27,15,3,12,1,0,0,3
Hawthorn,"Brand, Kaiden",10,7,5,3,0,0,0,2
Hawthorn,"Breust, Luke",18,7,3,11,1,0,0,2
Hawthorn,"Burgoyne, Shaun",19,14,2,5,0,1,0,4
Hawthorn,"Burton, Ryan",18,16,5,2,0,0,0,0
Hawthorn,"Gunston, Jack",12,9,3,3,2,1,1,4
Hawthorn,"Hardwick, Blake",9,6,1,3,0,0,0,0
Hawthorn,"Henderson, Ricky",13,10,5,3,2,0,0,4
Hawthorn,"Impey, Jarman",22,17,4,5,0,1,0,1
Hawthorn,"McEvoy, Ben",15,7,4,8,0,1,52,3
Hawthorn,"Miles, Teia",8,8,4,0,0,0,0,3
Hawthorn,"Mirra, David",7,4,3,3,0,0,0,1
Hawthorn,"Mitchell, Tom",24,10,2,14,0,0,0,11
Hawthorn,"Morrison, Harry",20,16,4,4,1,2,0,5
Hawthorn,"Nash, Conor",12,4,2,8,0,2,0,4
Hawthorn,"OMeara, Jaeger",18,10,3,8,0,1,0,5
Hawthorn,"Puopolo, Paul",9,7,1,2,3,0,0,3
Hawthorn,"Roughead, Jarryd",11,6,3,5,1,0,9,2
Hawthorn,"Schoenmakers, Ryan",7,5,3,2,1,0,1,0
Hawthorn,"Shiels, Liam",26,16,2,10,0,0,0,4
Hawthorn,"Smith, Isaac",16,10,4,6,0,0,0,2
Hawthorn,"Stratton, Ben",7,5,1,2,0,0,0,0
Hawthorn,"Worpel, James",23,11,3,12,1,1,0,2
Hawthorn,"Breust, Luke",11,7,3,4,1,1,0,3
Hawthorn,"Burgoyne, Shaun",17,8,0,9,0,1,0,6
Hawthorn,"Burton, Ryan",18,10,1,8,0,0,0,4
Hawthorn,"Ceglar, Jonathon",9,5,2,4,0,0,21,1
Hawthorn,"Frawley, James",14,9,5,5,0,0,0,2
Hawthorn,"Gunston, Jack",18,13,4,5,0,0,0,2
Hawthorn,"Hardwick, Blake",16,11,4,5,0,0,0,2
Hawthorn,"Henderson, Ricky",29,18,9,11,0,0,0,3
Hawthorn,"Howe, Daniel",15,10,2,5,0,1,0,7
Hawthorn,"Impey, Jarman",12,7,1,5,1,0,0,5
Hawthorn,"McEvoy, Ben",8,3,0,5,0,0,34,1
Hawthorn,"Mitchell, Tom",38,12,4,26,1,0,0,4
Hawthorn,"Morrison, Harry",13,4,1,9,0,0,0,7
Hawthorn,"Nash, Conor",5,3,1,2,1,0,0,1
Hawthorn,"OMeara, Jaeger",29,10,1,19,0,2,0,2
Hawthorn,"Puopolo, Paul",10,6,2,4,0,1,0,7
Hawthorn,"Roughead, Jarryd",11,6,2,5,3,0,4,1
Hawthorn,"Shiels, Liam",26,21,2,5,1,1,0,11
Hawthorn,"Sicily, James",21,17,5,4,0,0,0,3
Hawthorn,"Smith, Isaac",25,14,4,11,1,0,0,4
Hawthorn,"Stratton, Ben",11,7,3,4,0,0,0,1
Hawthorn,"Worpel, James",17,8,1,9,0,0,0,4
Hawthorn,"Breust, Luke",13,8,3,5,0,0,0,4
Hawthorn,"Burgoyne, Shaun",13,7,3,6,0,0,0,2
Hawthorn,"Burton, Ryan",17,11,3,6,0,1,0,1
Hawthorn,"Duryea, Taylor",12,7,2,5,0,0,0,1
Hawthorn,"Frawley, James",16,9,6,7,0,0,0,0
Hawthorn,"Gunston, Jack",16,13,7,3,3,5,0,3
Hawthorn,"Hardwick, Blake",11,8,6,3,0,0,0,0
Hawthorn,"Henderson, Ricky",21,16,9,5,0,1,0,1
Hawthorn,"Howe, Daniel",15,9,6,6,0,0,0,4
Hawthorn,"Impey, Jarman",15,11,3,4,0,0,0,4
Hawthorn,"McEvoy, Ben",17,3,7,14,0,0,25,3
Hawthorn,"Mirra, David",19,14,10,5,0,0,0,2
Hawthorn,"Mitchell, Tom",24,17,5,7,0,0,0,10
Hawthorn,"Morrison, Harry",13,8,5,5,0,1,0,3
Hawthorn,"Nash, Conor",4,2,2,2,0,0,0,3
Hawthorn,"Puopolo, Paul",12,7,3,5,1,1,0,4
Hawthorn,"Roughead, Jarryd",15,10,2,5,2,1,1,6
Hawthorn,"Schoenmakers, Ryan",6,5,3,1,2,0,0,0
Hawthorn,"Shiels, Liam",23,12,4,11,0,0,0,6
Hawthorn,"Sicily, James",17,11,4,6,0,0,0,2
Hawthorn,"Smith, Isaac",22,14,8,8,1,0,0,3
Hawthorn,"Worpel, James",9,6,3,3,1,0,0,5
Melbourne,"Fritsch, Bayley",11,7,6,4,1,1,0,5
Melbourne,"Garlett, Jeff",8,5,2,3,1,2,0,2
Melbourne,"Gawn, Max",20,8,4,12,1,2,47,5
Melbourne,"Hannan, Mitch",9,6,2,3,1,1,0,1
Melbourne,"Harmes, James",18,13,3,5,0,2,0,4
Melbourne,"Hibberd, Michael",20,12,2,8,0,0,0,0
Melbourne,"Hogan, Jesse",16,8,3,8,3,0,0,1
Melbourne,"Hunt, Jayden",18,11,4,7,0,1,0,3
Melbourne,"Jetta, Neville",11,5,2,6,0,0,0,5
Melbourne,"Jones, Nathan",29,10,1,19,0,0,0,3
Melbourne,"Lever, Jake",10,8,3,2,0,0,0,2
Melbourne,"Lewis, Jordan",24,6,4,18,0,0,0,3
Melbourne,"Maynard, Corey",15,5,0,10,0,0,0,7
Melbourne,"McDonald, Oscar",12,8,1,4,0,0,0,0
Melbourne,"Melksham, Jake",15,9,3,6,0,1,0,0
Melbourne,"Neal-Bullen, Alex",13,11,1,2,2,0,0,2
Melbourne,"Oliver, Clayton",28,9,3,19,1,0,0,10
Melbourne,"Pedersen, Cameron",13,6,1,7,2,1,4,4
Melbourne,"Petracca, Christian",24,14,3,10,1,3,0,4
Melbourne,"Salem, Christian",12,5,0,7,0,0,0,4
Melbourne,"Vince, Bernie",17,13,2,4,0,0,0,3
Melbourne,"Wagner, Josh",15,6,2,9,0,0,0,4
Melbourne,"Bugg, Tomas",13,9,2,4,0,2,0,4
Melbourne,"Fritsch, Bayley",9,7,3,2,2,1,0,3
Melbourne,"Garlett, Jeff",17,13,5,4,4,1,0,4
Melbourne,"Gawn, Max",10,2,1,8,0,0,48,1
Melbourne,"Harmes, James",23,12,2,11,0,0,0,5
Melbourne,"Hibberd, Michael",20,10,5,10,0,0,0,1
Melbourne,"Hogan, Jesse",22,15,9,7,5,1,0,4
Melbourne,"Hunt, Jayden",6,5,2,1,0,1,0,4
Melbourne,"Jetta, Neville",12,5,2,7,0,1,0,3
Melbourne,"Jones, Nathan",28,12,3,16,2,1,0,5
Melbourne,"Lever, Jake",13,9,4,4,0,0,0,1
Melbourne,"Lewis, Jordan",23,11,2,12,0,0,0,2
Melbourne,"McDonald, Oscar",10,9,5,1,0,0,0,1
Melbourne,"Melksham, Jake",18,9,5,9,0,3,0,3
Melbourne,"Neal-Bullen, Alex",21,16,5,5,1,0,0,2
Melbourne,"Oliver, Clayton",35,11,3,24,0,1,0,8
Melbourne,"Pedersen, Cameron",6,4,2,2,0,0,6,3
Melbourne,"Petracca, Christian",24,14,4,10,0,1,0,3
Melbourne,"Salem, Christian",13,6,1,7,0,0,0,3
Melbourne,"Tyson, Dom",22,12,7,10,0,0,0,6
Melbourne,"Vince, Bernie",12,10,1,2,0,0,0,3
Melbourne,"Wagner, Josh",12,8,3,4,0,0,0,6
Melbourne,"Bugg, Tomas",16,9,3,7,4,1,0,3
Melbourne,"Fritsch, Bayley",11,7,4,4,1,0,0,0
Melbourne,"Frost, Sam",9,6,6,3,0,0,0,1
Melbourne,"Garlett, Jeff",11,6,2,5,3,1,0,3
Melbourne,"Gawn, Max",18,8,6,10,0,0,50,3
Melbourne,"Harmes, James",17,9,2,8,0,0,2,6
Melbourne,"Hibberd, Michael",18,10,6,8,0,0,0,1
Melbourne,"Hogan, Jesse",26,17,7,9,1,2,0,1
Melbourne,"Jetta, Neville",12,3,1,9,0,0,0,2
Melbourne,"Jones, Nathan",25,14,4,11,1,1,0,7
Melbourne,"Kent, Dean",20,12,5,8,3,2,0,1
Melbourne,"Lever, Jake",20,14,6,6,0,0,0,0
Melbourne,"Lewis, Jordan",27,12,4,15,1,0,0,0
Melbourne,"McDonald, Oscar",6,4,1,2,0,0,0,1
Melbourne,"Melksham, Jake",16,12,7,4,0,2,0,1
Melbourne,"Neal-Bullen, Alex",19,11,5,8,0,0,0,4
Melbourne,"Oliver, Clayton",20,7,2,13,2,0,0,6
Melbourne,"Petracca, Christian",25,14,6,11,1,1,0,2
Melbourne,"Salem, Christian",20,15,4,5,0,1,0,6
Melbourne,"Tyson, Dom",25,15,8,10,0,1,0,2
Melbourne,"Vince, Bernie",23,16,2,7,1,0,0,2
Melbourne,"Wagner, Josh",15,10,3,5,0,1,0,7
Melbourne,"Brayshaw, Angus",19,8,2,11,0,1,0,4
Melbourne,"Bugg, Tomas",19,10,4,9,0,4,0,6
Melbourne,"Fritsch, Bayley",14,5,1,9,0,1,0,3
Melbourne,"Frost, Sam",12,8,3,4,0,0,2,1
Melbourne,"Garlett, Jeff",5,2,0,3,0,1,0,4
Melbourne,"Gawn, Max",16,11,5,5,0,1,66,1
Melbourne,"Harmes, James",9,4,2,5,0,1,3,3
Melbourne,"Hibberd, Michael",18,8,2,10,0,0,0,4
Melbourne,"Hogan, Jesse",24,12,3,12,1,1,0,2
Melbourne,"Jetta, Neville",6,4,1,2,0,0,0,2
Melbourne,"Jones, Nathan",20,8,0,12,0,0,0,2
Melbourne,"Kent, Dean",17,11,3,6,3,0,0,5
Melbourne,"Lever, Jake",15,10,6,5,0,0,0,0
Melbourne,"Lewis, Jordan",14,9,3,5,0,0,0,3
Melbourne,"McDonald, Oscar",13,10,5,3,0,0,0,0
Melbourne,"Melksham, Jake",13,8,1,5,0,1,0,3
Melbourne,"Neal-Bullen, Alex",22,12,4,10,1,0,0,6
Melbourne,"Oliver, Clayton",28,10,2,18,0,0,0,11
Melbourne,"Petracca, Christian",23,16,0,7,0,0,1,3
Melbourne,"Salem, Christian",20,13,2,7,1,0,0,3
Melbourne,"Vince, Bernie",13,9,0,4,0,0,0,3
Melbourne,"Wagner, Josh",12,8,1,4,0,0,0,5
Melbourne,"Brayshaw, Angus",17,10,2,7,0,0,0,1
Melbourne,"Garlett, Jeff",6,4,2,2,1,0,0,2
Melbourne,"Gawn, Max",16,11,6,5,0,0,56,8
Melbourne,"Harmes, James",13,6,1,7,1,0,0,9
Melbourne,"Hibberd, Michael",14,10,5,4,0,0,0,3
Melbourne,"Hogan, Jesse",22,12,9,10,2,2,0,1
Melbourne,"Hunt, Jayden",12,8,3,4,0,0,0,2
Melbourne,"Jetta, Neville",14,6,2,8,0,0,0,7
Melbourne,"Jones, Nathan",30,12,1,18,0,0,0,3
Melbourne,"Kent, Dean",6,1,1,5,0,0,0,3
Melbourne,"Lever, Jake",18,13,6,5,0,0,0,5
Melbourne,"McDonald, Oscar",12,9,5,3,0,0,0,2
Melbourne,"Melksham, Jake",10,8,5,2,4,0,0,1
Melbourne,"Neal-Bullen, Alex",14,8,2,6,0,1,0,1
Melbourne,"Oliver, Clayton",31,10,6,21,0,2,0,6
Melbourne,"Petracca, Christian",19,12,2,7,0,1,0,5
Melbourne,"Salem, Christian",20,8,1,12,0,0,0,8
Melbourne,"Stretch, Billy",16,7,2,9,0,0,0,2
Melbourne,"Tyson, Dom",23,12,4,11,0,0,0,1
Melbourne,"Vince, Bernie",24,17,4,7,0,0,0,3
Melbourne,"Wagner, Josh",9,4,4,5,0,0,0,1
Melbourne,"Weideman, Sam",12,7,4,5,0,0,9,5
Melbourne,"Brayshaw, Angus",21,11,4,10,0,1,0,3
Melbourne,"Fritsch, Bayley",14,13,8,1,3,1,0,1
Melbourne,"Gawn, Max",16,8,6,8,2,2,42,5
Melbourne,"Hannan, Mitch",18,13,5,5,3,1,0,4
Melbourne,"Harmes, James",23,7,3,16,0,1,0,9
Melbourne,"Hibberd, Michael",24,19,8,5,0,0,0,4
Melbourne,"Hogan, Jesse",8,5,5,3,2,1,0,2
Melbourne,"Hunt, Jayden",11,8,4,3,0,0,0,1
Melbourne,"Jetta, Neville",16,3,5,13,0,0,0,4
Melbourne,"Jones, Nathan",24,12,0,12,0,1,0,6
Melbourne,"Lever, Jake",13,9,6,4,0,0,0,3
Melbourne,"Lewis, Jordan",19,11,6,8,0,0,0,1
Melbourne,"McDonald, Oscar",9,6,4,3,0,0,0,0
Melbourne,"McDonald, Tom",16,11,5,5,2,0,2,1
Melbourne,"Melksham, Jake",14,10,5,4,2,1,0,2
Melbourne,"Neal-Bullen, Alex",8,3,0,5,0,1,0,3
Melbourne,"Oliver, Clayton",19,8,2,11,0,0,0,7
Melbourne,"Salem, Christian",27,16,4,11,0,0,0,5
Melbourne,"Spargo, Charlie",18,4,4,14,2,0,0,3
Melbourne,"Tyson, Dom",19,7,5,12,0,1,0,1
Melbourne,"Vince, Bernie",13,9,2,4,0,0,0,3
Melbourne,"Weideman, Sam",9,3,3,6,0,0,1,1
Melbourne,"Brayshaw, Angus",32,19,5,13,1,0,0,3
Melbourne,"Fritsch, Bayley",18,8,7,10,0,0,0,6
Melbourne,"Gawn, Max",20,8,5,12,1,0,34,1
Melbourne,"Hannan, Mitch",9,6,4,3,0,2,0,0
Melbourne,"Harmes, James",21,10,4,11,1,0,0,3
Melbourne,"Hibberd, Michael",28,18,4,10,0,0,0,4
Melbourne,"Hogan, Jesse",25,13,7,12,3,1,0,1
Melbourne,"Hunt, Jayden",14,11,6,3,0,0,0,2
Melbourne,"Jetta, Neville",14,6,4,8,0,0,0,2
Melbourne,"Jones, Nathan",24,10,2,14,1,1,0,9
Melbourne,"Lever, Jake",12,9,6,3,0,0,0,1
Melbourne,"Lewis, Jordan",23,13,5,10,0,0,0,0
Melbourne,"McDonald, Oscar",18,10,4,8,0,0,0,0
Melbourne,"McDonald, Tom",12,7,7,5,2,0,0,2
Melbourne,"Melksham, Jake",11,8,2,3,0,1,0,2
Melbourne,"Neal-Bullen, Alex",15,10,4,5,1,2,0,2
Melbourne,"Oliver, Clayton",36,8,3,28,1,0,0,4
Melbourne,"Petracca, Christian",15,8,5,7,1,2,0,1
Melbourne,"Spargo, Charlie",15,6,5,9,1,0,0,3
Melbourne,"Tyson, Dom",27,13,7,14,1,0,0,1
Melbourne,"Vince, Bernie",23,15,5,8,0,0,0,3
Melbourne,"Weideman, Sam",9,3,2,6,2,0,0,2
Melbourne,"Brayshaw, Angus",24,16,2,8,1,3,0,1
Melbourne,"Fritsch, Bayley",26,13,2,13,0,0,0,4
Melbourne,"Gawn, Max",18,4,2,14,1,1,41,4
Melbourne,"Hannan, Mitch",17,10,5,7,3,3,0,3
Melbourne,"Harmes, James",33,16,9,17,0,3,0,6
Melbourne,"Hibberd, Michael",17,13,2,4,1,0,0,2
Melbourne,"Hogan, Jesse",22,12,8,10,3,0,0,3
Melbourne,"Jetta, Neville",13,5,4,8,0,0,0,1
Melbourne,"Jones, Nathan",25,15,3,10,0,0,0,7
Melbourne,"Lever, Jake",13,9,4,4,0,0,0,3
Melbourne,"Lewis, Jordan",25,15,9,10,0,0,0,2
Melbourne,"McDonald, Oscar",12,5,3,7,0,0,0,0
Melbourne,"McDonald, Tom",17,11,7,6,5,1,0,1
Melbourne,"Melksham, Jake",21,16,6,5,1,3,0,3
Melbourne,"Neal-Bullen, Alex",23,11,5,12,2,2,0,1
Melbourne,"Oliver, Clayton",29,12,2,17,0,1,0,11
Melbourne,"Petracca, Christian",19,5,4,14,0,1,0,1
Melbourne,"Salem, Christian",27,14,8,13,2,1,0,4
Melbourne,"Spargo, Charlie",9,7,2,2,2,1,0,0
Melbourne,"Tyson, Dom",16,6,1,10,0,0,0,4
Melbourne,"Vince, Bernie",14,10,2,4,0,0,0,2
Melbourne,"Weideman, Sam",6,2,1,4,0,0,6,2
Melbourne,"Brayshaw, Angus",24,11,3,13,0,0,0,11
Melbourne,"Fritsch, Bayley",17,13,6,4,2,0,0,4
Melbourne,"Gawn, Max",12,9,4,3,2,0,44,3
Melbourne,"Hannan, Mitch",14,9,2,5,2,1,0,5
Melbourne,"Harmes, James",25,10,6,15,1,0,0,4
Melbourne,"Hibberd, Michael",12,8,4,4,0,0,0,0
Melbourne,"Hogan, Jesse",15,8,6,7,1,1,0,0
Melbourne,"Jetta, Neville",9,5,2,4,0,0,0,8
Melbourne,"Jones, Nathan",31,15,4,16,1,0,0,2
Melbourne,"Lever, Jake",27,19,8,8,0,0,0,0
Melbourne,"Lewis, Jordan",22,9,3,13,0,0,0,2
Melbourne,"McDonald, Oscar",10,8,7,2,0,0,0,2
Melbourne,"McDonald, Tom",20,14,5,6,4,1,0,6
Melbourne,"Melksham, Jake",21,14,2,7,5,0,0,4
Melbourne,"Neal-Bullen, Alex",17,7,2,10,4,0,0,5
Melbourne,"Oliver, Clayton",26,8,0,18,1,0,0,4
Melbourne,"Petracca, Christian",20,10,5,10,1,0,0,2
Melbourne,"Salem, Christian",21,14,4,7,0,1,0,1
Melbourne,"Smith, Tim",18,7,5,11,0,2,9,6
Melbourne,"Spargo, Charlie",12,7,2,5,0,2,0,3
Melbourne,"Vince, Bernie",16,9,6,7,0,0,0,5
Melbourne,"Viney, Jack",12,8,3,4,1,0,0,6
Melbourne,"Brayshaw, Angus",37,22,14,15,3,0,0,2
Melbourne,"Fritsch, Bayley",24,9,6,15,0,0,0,1
Melbourne,"Gawn, Max",12,2,0,10,0,1,49,0
Melbourne,"Hannan, Mitch",15,8,4,7,1,0,0,3
Melbourne,"Harmes, James",23,15,5,8,0,0,0,1
Melbourne,"Hibberd, Michael",23,13,6,10,0,0,0,1
Melbourne,"Hogan, Jesse",20,11,11,9,5,0,0,0
Melbourne,"Jetta, Neville",19,8,5,11,0,0,0,1
Melbourne,"Jones, Nathan",28,9,1,19,1,1,0,2
Melbourne,"Lever, Jake",15,12,4,3,0,0,0,3
Melbourne,"Lewis, Jordan",21,14,11,7,0,0,0,2
Melbourne,"McDonald, Oscar",7,7,3,0,0,0,0,1
Melbourne,"McDonald, Tom",18,12,7,6,2,1,0,2
Melbourne,"Melksham, Jake",17,11,6,6,2,2,0,3
Melbourne,"Neal-Bullen, Alex",23,15,6,8,3,0,0,6
Melbourne,"Oliver, Clayton",31,8,3,23,0,0,0,10
Melbourne,"Petracca, Christian",22,12,4,10,3,0,0,3
Melbourne,"Salem, Christian",28,19,8,9,0,0,0,2
Melbourne,"Smith, Tim",19,8,6,11,2,1,5,6
Melbourne,"Spargo, Charlie",14,10,9,4,1,0,0,4
Melbourne,"Vince, Bernie",17,10,3,7,0,0,0,4
Melbourne,"Viney, Jack",35,10,3,25,0,1,0,3
Melbourne,"Brayshaw, Angus",39,21,8,18,1,0,0,1
Melbourne,"Fritsch, Bayley",26,14,14,12,1,0,0,4
Melbourne,"Gawn, Max",19,8,7,11,0,1,57,5
Melbourne,"Hannan, Mitch",13,9,5,4,1,1,0,1
Melbourne,"Harmes, James",17,11,4,6,0,0,0,4
Melbourne,"Hibberd, Michael",24,13,3,11,0,0,0,4
Melbourne,"Hogan, Jesse",19,15,10,4,5,1,0,2
Melbourne,"Jetta, Neville",24,14,9,10,0,0,0,3
Melbourne,"Jones, Nathan",26,8,2,18,1,0,0,2
Melbourne,"Lever, Jake",3,2,1,1,0,0,0,0
Melbourne,"Lewis, Jordan",28,11,2,17,0,0,0,0
Melbourne,"McDonald, Oscar",13,9,6,4,0,0,0,1
Melbourne,"McDonald, Tom",24,14,11,10,4,2,0,5
Melbourne,"Melksham, Jake",15,11,4,4,0,2,0,1
Melbourne,"Neal-Bullen, Alex",25,12,5,13,1,2,0,5
Melbourne,"Oliver, Clayton",38,10,5,28,0,1,0,3
Melbourne,"Petracca, Christian",21,10,4,11,1,0,0,3
Melbourne,"Salem, Christian",25,14,5,11,0,0,0,2
Melbourne,"Smith, Tim",7,3,2,4,0,0,2,6
Melbourne,"Spargo, Charlie",11,5,5,6,0,0,0,2
Melbourne,"Vince, Bernie",15,7,3,8,0,0,0,1
Melbourne,"Viney, Jack",22,9,4,13,0,0,0,6
Melbourne,"Brayshaw, Angus",16,11,1,5,0,1,0,0
Melbourne,"Fritsch, Bayley",19,13,9,6,1,0,0,3
Melbourne,"Gawn, Max",17,7,3,10,1,0,33,1
Melbourne,"Hannan, Mitch",8,6,2,2,2,0,0,1
Melbourne,"Harmes, James",15,5,2,10,1,1,0,5
Melbourne,"Hibberd, Michael",16,7,3,9,0,0,0,2
Melbourne,"Hogan, Jesse",17,5,3,12,0,1,0,3
Melbourne,"Jetta, Neville",10,5,0,5,0,0,0,2
Melbourne,"Jones, Nathan",26,6,3,20,0,0,0,4
Melbourne,"Lewis, Jordan",33,22,9,11,0,0,0,0
Melbourne,"McDonald, Oscar",9,6,4,3,0,0,0,1
Melbourne,"McDonald, Tom",16,9,8,7,6,0,0,3
Melbourne,"Melksham, Jake",12,8,4,4,0,1,0,2
Melbourne,"Neal-Bullen, Alex",19,7,3,12,1,1,0,6
Melbourne,"Oliver, Clayton",31,13,4,18,1,0,0,10
Melbourne,"Pedersen, Cameron",11,5,3,6,0,0,2,2
Melbourne,"Petracca, Christian",15,10,4,5,0,0,0,1
Melbourne,"Salem, Christian",16,12,3,4,0,0,0,4
Melbourne,"Smith, Joel",16,7,5,9,0,0,0,6
Melbourne,"Spargo, Charlie",12,5,4,7,0,1,0,7
Melbourne,"Vince, Bernie",14,7,3,7,0,0,0,1
Melbourne,"Viney, Jack",23,9,3,14,1,0,0,4
Melbourne,"Brayshaw, Angus",28,15,3,13,0,0,0,8
Melbourne,"Fritsch, Bayley",13,9,5,4,0,1,0,5
Melbourne,"Gawn, Max",16,11,4,5,0,1,53,2
Melbourne,"Hannan, Mitch",11,9,2,2,2,3,0,4
Melbourne,"Harmes, James",20,7,3,13,0,0,0,2
Melbourne,"Hibberd, Michael",21,14,2,7,0,0,0,0
Melbourne,"Hogan, Jesse",12,5,2,7,0,1,0,5
Melbourne,"Jetta, Neville",9,5,1,4,0,0,0,3
Melbourne,"Jones, Nathan",28,14,0,14,0,0,0,6
Melbourne,"Lewis, Jordan",21,13,2,8,0,0,0,3
Melbourne,"McDonald, Oscar",10,6,1,4,0,0,0,1
Melbourne,"McDonald, Tom",13,7,4,6,3,2,0,2
Melbourne,"Melksham, Jake",12,9,3,3,1,0,0,5
Melbourne,"Neal-Bullen, Alex",12,6,2,6,0,1,0,9
Melbourne,"Oliver, Clayton",28,10,3,18,0,0,0,6
Melbourne,"Petracca, Christian",17,9,6,8,1,0,0,4
Melbourne,"Salem, Christian",13,7,1,6,1,0,0,2
Melbourne,"Smith, Joel",6,4,2,2,0,0,0,2
Melbourne,"Smith, Tim",7,3,1,4,1,0,1,6
Melbourne,"Tyson, Dom",16,4,3,12,0,0,0,5
Melbourne,"Vince, Bernie",13,7,1,6,0,0,0,2
Melbourne,"Viney, Jack",31,14,1,17,0,0,0,7
Melbourne,"Brayshaw, Angus",27,13,6,14,2,0,0,4
Melbourne,"Fritsch, Bayley",9,9,5,0,4,1,0,2
Melbourne,"Gawn, Max",25,14,11,11,0,1,39,1
Melbourne,"Hannan, Mitch",4,2,0,2,0,0,0,4
Melbourne,"Harmes, James",24,13,4,11,3,0,0,2
Melbourne,"Hibberd, Michael",21,14,6,7,0,0,0,3
Melbourne,"Hogan, Jesse",15,8,4,7,3,2,0,5
Melbourne,"Jetta, Neville",14,5,2,9,0,0,0,1
Melbourne,"Jones, Nathan",26,15,2,11,0,0,0,5
Melbourne,"Lewis, Jordan",23,14,4,9,1,1,0,2
Melbourne,"McDonald, Oscar",14,7,3,7,0,0,0,3
Melbourne,"McDonald, Tom",8,4,2,4,1,0,2,2
Melbourne,"Melksham, Jake",10,8,4,2,1,1,0,0
Melbourne,"Neal-Bullen, Alex",14,5,3,9,1,0,0,1
Melbourne,"Oliver, Clayton",24,8,4,16,0,0,0,4
Melbourne,"Petracca, Christian",15,12,2,3,1,0,0,5
Melbourne,"Petty, Harry",11,7,4,4,0,0,0,2
Melbourne,"Salem, Christian",15,9,2,6,0,0,0,3
Melbourne,"Smith, Joel",14,5,5,9,0,0,0,2
Melbourne,"Tyson, Dom",15,8,4,7,1,0,0,2
Melbourne,"Viney, Jack",26,10,2,16,0,0,0,8
Melbourne,"Weideman, Sam",7,3,4,4,0,2,6,2
Melbourne,"Brayshaw, Angus",31,20,4,11,0,2,0,4
Melbourne,"Fritsch, Bayley",25,17,2,8,0,1,0,1
Melbourne,"Frost, Sam",9,3,1,6,0,0,0,4
Melbourne,"Garlett, Jeff",14,6,2,8,1,0,0,6
Melbourne,"Gawn, Max",20,11,6,9,1,1,42,1
Melbourne,"Harmes, James",24,12,3,12,1,0,0,5
Melbourne,"Hibberd, Michael",17,9,3,8,0,1,0,3
Melbourne,"Hogan, Jesse",19,12,7,7,2,3,4,2
Melbourne,"Jetta, Neville",13,6,5,7,0,0,0,1
Melbourne,"Jones, Nathan",22,10,4,12,1,1,0,2
Melbourne,"Lewis, Jordan",21,14,5,7,0,1,0,1
Melbourne,"McDonald, Oscar",13,11,3,2,0,0,0,1
Melbourne,"McDonald, Tom",19,11,7,8,1,2,3,0
Melbourne,"Melksham, Jake",15,9,2,6,1,1,0,0
Melbourne,"Neal-Bullen, Alex",14,9,3,5,1,2,0,4
Melbourne,"Oliver, Clayton",35,15,5,20,2,1,0,7
Melbourne,"Petracca, Christian",29,12,5,17,0,3,0,5
Melbourne,"Salem, Christian",29,19,5,10,1,1,0,1
Melbourne,"Smith, Joel",8,2,2,6,0,0,0,7
Melbourne,"Spargo, Charlie",13,8,5,5,1,0,0,3
Melbourne,"Stretch, Billy",24,15,5,9,0,2,0,4
Melbourne,"Viney, Jack",28,9,5,19,0,1,0,7
Melbourne,"Brayshaw, Angus",38,19,6,19,0,0,0,4
Melbourne,"Fritsch, Bayley",18,12,6,6,0,2,0,2
Melbourne,"Frost, Sam",10,7,4,3,0,0,0,3
Melbourne,"Garlett, Jeff",12,6,4,6,2,0,0,3
Melbourne,"Gawn, Max",17,10,7,7,0,0,41,1
Melbourne,"Hannan, Mitch",11,8,3,3,1,2,0,0
Melbourne,"Harmes, James",16,7,2,9,0,0,0,4
Melbourne,"Hibberd, Michael",16,12,4,4,0,0,0,0
Melbourne,"Hogan, Jesse",18,13,9,5,4,1,4,1
Melbourne,"Jetta, Neville",7,3,3,4,0,0,0,1
Melbourne,"Jones, Nathan",19,9,6,10,0,0,0,3
Melbourne,"Kennedy Harris, Jay",15,9,2,6,0,0,0,8
Melbourne,"Lewis, Jordan",23,11,7,12,1,0,0,3
Melbourne,"McDonald, Oscar",12,8,3,4,0,0,0,0
Melbourne,"McDonald, Tom",16,9,5,7,3,1,6,2
Melbourne,"Melksham, Jake",20,14,9,6,1,0,0,3
Melbourne,"Neal-Bullen, Alex",17,6,5,11,2,0,0,5
Melbourne,"Oliver, Clayton",34,14,4,20,1,0,0,6
Melbourne,"Petracca, Christian",19,10,4,9,1,0,0,2
Melbourne,"Salem, Christian",21,17,5,4,0,0,0,4
Melbourne,"Spargo, Charlie",14,7,2,7,2,0,0,7
Melbourne,"Vince, Bernie",14,8,2,6,0,1,0,1
Melbourne,"Brayshaw, Angus",23,13,4,10,1,0,0,4
Melbourne,"Fritsch, Bayley",21,15,7,6,0,0,0,1
Melbourne,"Frost, Sam",14,9,2,5,0,0,0,4
Melbourne,"Garlett, Jeff",13,8,1,5,2,0,0,3
Melbourne,"Gawn, Max",12,7,4,5,1,0,38,2
Melbourne,"Harmes, James",12,4,2,8,0,0,0,5
Melbourne,"Hogan, Jesse",14,7,4,7,1,1,0,2
Melbourne,"Jetta, Neville",14,10,4,4,0,0,0,2
Melbourne,"Jones, Nathan",27,9,2,18,1,0,0,2
Melbourne,"Kennedy Harris, Jay",14,5,3,9,0,2,0,4
Melbourne,"Lewis, Jordan",30,14,5,16,0,0,0,4
Melbourne,"McDonald, Oscar",10,8,2,2,0,0,0,3
Melbourne,"McDonald, Tom",16,8,5,8,4,2,6,3
Melbourne,"Melksham, Jake",12,10,4,2,2,0,0,3
Melbourne,"Neal-Bullen, Alex",18,16,3,2,0,1,0,5
Melbourne,"Oliver, Clayton",40,14,7,26,0,0,0,6
Melbourne,"Petracca, Christian",22,12,6,10,1,1,0,8
Melbourne,"Salem, Christian",19,12,4,7,0,0,0,6
Melbourne,"Smith, Joel",16,4,5,12,0,0,0,4
Melbourne,"Spargo, Charlie",11,8,2,3,1,1,0,3
Melbourne,"Tyson, Dom",21,6,2,15,0,0,0,3
Melbourne,"Vince, Bernie",21,13,5,8,0,0,0,1
Melbourne,"Brayshaw, Angus",21,15,4,6,0,0,0,7
Melbourne,"Fritsch, Bayley",8,8,3,0,2,0,0,2
Melbourne,"Frost, Sam",14,9,3,5,0,0,0,4
Melbourne,"Garlett, Jeff",15,7,1,8,1,2,0,1
Melbourne,"Gawn, Max",12,5,2,7,0,0,66,0
Melbourne,"Harmes, James",23,6,3,17,0,1,0,7
Melbourne,"Hogan, Jesse",10,6,4,4,1,0,0,4
Melbourne,"Jetta, Neville",6,4,3,2,0,0,0,7
Melbourne,"Jones, Nathan",23,9,3,14,0,1,0,7
Melbourne,"Kennedy Harris, Jay",16,8,3,8,1,1,0,2
Melbourne,"Lewis, Jordan",21,14,3,7,2,0,0,1
Melbourne,"McDonald, Oscar",6,4,2,2,0,0,0,2
Melbourne,"McDonald, Tom",13,6,5,7,3,1,8,5
Melbourne,"Melksham, Jake",17,12,4,5,2,1,0,1
Melbourne,"Neal-Bullen, Alex",22,15,2,7,1,1,0,12
Melbourne,"Oliver, Clayton",31,13,1,18,0,0,0,4
Melbourne,"Petracca, Christian",21,11,3,10,0,1,0,5
Melbourne,"Salem, Christian",15,13,1,2,0,0,0,6
Melbourne,"Smith, Joel",9,9,3,0,0,0,0,2
Melbourne,"Spargo, Charlie",9,2,3,7,0,0,0,5
Melbourne,"Tyson, Dom",20,9,0,11,0,1,0,5
Melbourne,"Vince, Bernie",13,8,0,5,0,0,0,0
Melbourne,"Brayshaw, Angus",27,17,8,10,1,0,0,10
Melbourne,"Fritsch, Bayley",21,15,9,6,0,2,0,1
Melbourne,"Frost, Sam",16,8,5,8,0,0,0,3
Melbourne,"Garlett, Jeff",21,16,6,5,2,3,0,4
Melbourne,"Gawn, Max",18,10,6,8,0,0,30,4
Melbourne,"Harmes, James",25,13,3,12,3,0,0,5
Melbourne,"Hogan, Jesse",22,15,10,7,4,1,0,1
Melbourne,"Jetta, Neville",14,12,7,2,0,0,0,2
Melbourne,"Jones, Nathan",24,15,5,9,2,0,0,3
Melbourne,"Kennedy Harris, Jay",14,5,3,9,0,0,0,4
Melbourne,"Lewis, Jordan",18,11,3,7,0,0,0,2
Melbourne,"McDonald, Oscar",13,8,5,5,0,0,0,2
Melbourne,"McDonald, Tom",17,11,11,6,0,3,7,2
Melbourne,"Neal-Bullen, Alex",22,15,4,7,2,0,0,2
Melbourne,"Oliver, Clayton",31,17,11,14,2,2,0,7
Melbourne,"Petracca, Christian",20,12,6,8,2,1,0,2
Melbourne,"Salem, Christian",26,19,2,7,1,0,0,5
Melbourne,"Smith, Joel",13,9,6,4,0,0,0,5
Melbourne,"Spargo, Charlie",12,9,5,3,2,0,0,3
Melbourne,"Tyson, Dom",27,13,6,14,0,0,0,3
Melbourne,"Vandenberg, Aaron",14,8,7,6,0,2,0,2
Melbourne,"Vince, Bernie",11,4,2,7,0,0,0,5
Melbourne,"Brayshaw, Angus",25,14,4,11,0,1,0,7
Melbourne,"Fritsch, Bayley",14,8,4,6,0,0,0,0
Melbourne,"Frost, Sam",9,6,3,3,0,0,0,2
Melbourne,"Garlett, Jeff",10,3,1,7,1,1,0,0
Melbourne,"Gawn, Max",7,4,2,3,0,0,46,1
Melbourne,"Harmes, James",26,12,4,14,0,0,0,5
Melbourne,"Hogan, Jesse",19,11,4,8,1,3,1,1
Melbourne,"Hunt, Jayden",10,6,3,4,0,0,0,2
Melbourne,"Jetta, Neville",8,3,4,5,0,0,0,4
Melbourne,"Jones, Nathan",23,14,2,9,1,0,0,3
Melbourne,"Kennedy Harris, Jay",14,5,3,9,0,0,0,5
Melbourne,"Lewis, Jordan",21,10,1,11,0,0,0,0
Melbourne,"McDonald, Oscar",11,6,3,5,0,0,0,3
Melbourne,"McDonald, Tom",17,11,10,6,2,2,9,1
Melbourne,"Neal-Bullen, Alex",14,10,2,4,0,0,0,6
Melbourne,"Oliver, Clayton",27,15,5,12,0,2,0,12
Melbourne,"Pedersen, Cameron",10,6,4,4,1,0,1,2
Melbourne,"Petracca, Christian",20,13,8,7,1,1,0,3
Melbourne,"Salem, Christian",22,12,5,10,0,0,0,4
Melbourne,"Spargo, Charlie",10,4,2,6,0,2,0,4
Melbourne,"Tyson, Dom",31,13,4,18,0,2,0,2
Melbourne,"Vandenberg, Aaron",10,7,4,3,3,0,0,2
Melbourne,"Brayshaw, Angus",26,16,8,10,1,0,0,10
Melbourne,"Fritsch, Bayley",16,10,2,6,0,1,0,1
Melbourne,"Frost, Sam",11,6,5,5,0,0,0,2
Melbourne,"Gawn, Max",20,12,5,8,0,0,41,2
Melbourne,"Hannan, Mitch",13,7,6,6,3,1,0,1
Melbourne,"Harmes, James",28,12,0,16,1,1,0,7
Melbourne,"Hibberd, Michael",17,7,2,10,0,0,0,1
Melbourne,"Jetta, Neville",10,5,3,5,0,0,0,2
Melbourne,"Jones, Nathan",27,16,5,11,1,1,0,3
Melbourne,"Kent, Dean",14,9,5,5,1,1,0,6
Melbourne,"Lewis, Jordan",23,10,7,13,0,0,0,3
Melbourne,"McDonald, Oscar",13,11,3,2,0,0,0,2
Melbourne,"McDonald, Tom",10,8,5,2,3,0,1,4
Melbourne,"Melksham, Jake",18,16,10,2,4,1,0,2
Melbourne,"Neal-Bullen, Alex",18,7,2,11,0,1,0,6
Melbourne,"Oliver, Clayton",23,8,1,15,0,0,0,5
Melbourne,"Petracca, Christian",18,7,2,11,0,0,0,0
Melbourne,"Salem, Christian",19,13,2,6,0,0,0,2
Melbourne,"Spargo, Charlie",12,7,4,5,0,0,0,1
Melbourne,"Tyson, Dom",23,8,5,15,0,0,0,5
Melbourne,"Vandenberg, Aaron",14,5,1,9,1,0,0,1
Melbourne,"Weideman, Sam",13,10,5,3,1,2,1,3
Melbourne,"Brayshaw, Angus",32,15,7,17,1,0,0,5
Melbourne,"Fritsch, Bayley",12,8,5,4,0,0,0,2
Melbourne,"Frost, Sam",16,8,3,8,0,0,0,1
Melbourne,"Gawn, Max",18,10,6,8,1,0,37,3
Melbourne,"Harmes, James",29,17,7,12,1,1,0,6
Melbourne,"Hibberd, Michael",22,14,3,8,0,0,0,0
Melbourne,"Jetta, Neville",8,4,1,4,0,0,0,5
Melbourne,"Jones, Nathan",27,14,3,13,1,1,0,2
Melbourne,"Kennedy Harris, Jay",15,10,3,5,0,1,0,5
Melbourne,"Kent, Dean",1,0,0,1,0,0,0,0
Melbourne,"Lewis, Jordan",22,10,8,12,0,0,0,1
Melbourne,"McDonald, Oscar",16,7,7,9,0,0,0,3
Melbourne,"McDonald, Tom",14,8,7,6,3,0,5,2
Melbourne,"Melksham, Jake",16,13,10,3,1,1,0,2
Melbourne,"Neal-Bullen, Alex",12,10,1,2,2,0,0,4
Melbourne,"Oliver, Clayton",30,12,5,18,0,0,0,4
Melbourne,"Petracca, Christian",20,14,4,6,3,2,2,3
Melbourne,"Salem, Christian",26,17,7,9,0,0,0,3
Melbourne,"Spargo, Charlie",16,6,2,10,0,1,0,1
Melbourne,"Tyson, Dom",13,5,4,8,0,0,0,1
Melbourne,"Vandenberg, Aaron",21,13,7,8,1,1,0,6
Melbourne,"Weideman, Sam",17,7,6,10,1,0,4,1
Melbourne,"Brayshaw, Angus",26,10,4,16,0,0,0,5
Melbourne,"Fritsch, Bayley",12,8,3,4,0,0,0,5
Melbourne,"Frost, Sam",10,4,3,6,0,0,0,1
Melbourne,"Gawn, Max",11,7,3,4,1,0,42,2
Melbourne,"Hannan, Mitch",14,10,4,4,1,0,0,1
Melbourne,"Harmes, James",26,13,4,13,1,1,0,10
Melbourne,"Hibberd, Michael",15,11,5,4,0,0,0,0
Melbourne,"Jetta, Neville",7,4,2,3,0,0,0,4
Melbourne,"Jones, Nathan",15,9,2,6,1,1,0,3
Melbourne,"Lewis, Jordan",24,14,6,10,0,0,0,0
Melbourne,"McDonald, Oscar",16,6,6,10,0,0,0,1
Melbourne,"McDonald, Tom",17,9,8,8,1,2,6,1
Melbourne,"Melksham, Jake",11,10,5,1,1,0,0,3
Melbourne,"Neal-Bullen, Alex",20,12,4,8,1,3,0,9
Melbourne,"Oliver, Clayton",30,9,1,21,0,0,0,6
Melbourne,"Petracca, Christian",15,7,3,8,0,1,0,6
Melbourne,"Salem, Christian",25,21,4,4,0,2,0,4
Melbourne,"Spargo, Charlie",9,5,3,4,0,0,0,2
Melbourne,"Tyson, Dom",17,7,1,10,0,1,0,3
Melbourne,"Vandenberg, Aaron",18,9,5,9,0,0,0,7
Melbourne,"Viney, Jack",20,4,1,16,0,0,0,11
Melbourne,"Weideman, Sam",24,12,7,12,3,0,1,4
Melbourne,"Brayshaw, Angus",12,8,3,4,2,0,0,3
Melbourne,"Fritsch, Bayley",16,8,4,8,0,0,0,3
Melbourne,"Frost, Sam",12,8,5,4,0,0,0,3
Melbourne,"Gawn, Max",15,8,5,7,1,0,41,1
Melbourne,"Hannan, Mitch",6,3,3,3,1,0,0,5
Melbourne,"Harmes, James",19,10,5,9,0,1,0,11
Melbourne,"Hibberd, Michael",20,14,7,6,0,0,0,2
Melbourne,"Jetta, Neville",17,8,3,9,0,0,0,3
Melbourne,"Jones, Nathan",19,10,6,9,0,0,0,2
Melbourne,"Lewis, Jordan",16,7,3,9,0,0,0,1
Melbourne,"McDonald, Oscar",14,11,5,3,0,0,0,1
Melbourne,"McDonald, Tom",14,10,10,4,4,0,2,1
Melbourne,"Melksham, Jake",11,10,3,1,2,1,0,0
Melbourne,"Neal-Bullen, Alex",8,5,1,3,1,1,0,6
Melbourne,"Oliver, Clayton",22,8,1,14,0,0,0,8
Melbourne,"Petracca, Christian",22,13,4,9,1,2,0,0
Melbourne,"Salem, Christian",16,12,4,4,0,1,0,1
Melbourne,"Spargo, Charlie",12,7,3,5,2,0,0,3
Melbourne,"Tyson, Dom",11,7,2,4,0,0,0,2
Melbourne,"Vandenberg, Aaron",15,8,3,7,0,2,0,1
Melbourne,"Viney, Jack",27,10,1,17,0,0,0,5
Melbourne,"Weideman, Sam",11,5,5,6,2,0,4,4
Melbourne,"Brayshaw, Angus",29,18,6,11,0,1,0,2
Melbourne,"Frost, Sam",7,6,3,1,0,0,0,1
Melbourne,"Gawn, Max",11,9,3,2,0,1,36,0
Melbourne,"Hannan, Mitch",11,6,3,5,1,1,0,0
Melbourne,"Harmes, James",24,13,4,11,1,0,0,3
Melbourne,"Hibberd, Michael",14,8,1,6,0,0,0,0
Melbourne,"Jetta, Neville",10,4,0,6,0,0,0,3
Melbourne,"Jones, Nathan",18,10,2,8,0,0,0,0
Melbourne,"Lewis, Jordan",18,10,3,8,0,0,0,1
Melbourne,"McDonald, Oscar",11,6,4,5,0,0,0,0
Melbourne,"McDonald, Tom",13,9,5,4,0,0,3,2
Melbourne,"Melksham, Jake",10,8,4,2,2,1,0,0
Melbourne,"Neal-Bullen, Alex",12,7,4,5,0,0,0,6
Melbourne,"Oliver, Clayton",27,5,4,22,1,1,0,3
Melbourne,"Petracca, Christian",21,11,1,10,0,2,1,2
Melbourne,"Salem, Christian",19,13,3,6,0,0,0,1
Melbourne,"Smith, Joel",12,6,1,6,1,2,0,3
Melbourne,"Spargo, Charlie",10,5,4,5,0,1,0,1
Melbourne,"Tyson, Dom",14,3,2,11,0,0,0,1
Melbourne,"Vandenberg, Aaron",19,11,3,8,0,1,0,3
Melbourne,"Viney, Jack",21,4,2,17,0,0,0,2
Melbourne,"Weideman, Sam",7,5,3,2,1,1,2,0
North Melbourne,"Anderson, Jed",12,11,0,1,1,0,0,7
North Melbourne,"Atley, Shaun",20,9,2,11,0,1,0,1
North Melbourne,"Brown, Ben",4,3,0,1,0,0,9,2
North Melbourne,"Clarke, Ryan",26,18,0,8,0,0,0,4
North Melbourne,"Cunnington, Ben",21,12,1,9,0,0,0,7
North Melbourne,"Davies-Uniacke, Luke",8,3,0,5,0,0,0,2
North Melbourne,"Dumont, Trent",18,11,0,7,1,0,0,9
North Melbourne,"Goldstein, Todd",14,8,3,6,0,1,35,2
North Melbourne,"Hartung, Billy",22,11,1,11,0,1,0,5
North Melbourne,"Higgins, Shaun",21,14,2,7,1,2,0,4
North Melbourne,"Hrovat, Nathan",8,5,0,3,0,0,0,2
North Melbourne,"Jacobs, Ben",6,5,0,1,0,0,0,7
North Melbourne,"Macmillan, Jamie",27,20,2,7,0,0,0,2
North Melbourne,"McDonald, Luke",13,9,1,4,0,0,0,4
North Melbourne,"Simpkin, Jy",22,13,0,9,0,0,0,2
North Melbourne,"Tarrant, Robbie",9,6,0,3,0,0,0,7
North Melbourne,"Thompson, Scott",20,8,2,12,0,0,0,3
North Melbourne,"Turner, Kayne",12,5,0,7,0,2,0,3
North Melbourne,"Vickers-Willis, Ed",16,11,2,5,0,0,0,5
North Melbourne,"Waite, Jarrad",15,10,1,5,0,1,2,2
North Melbourne,"Williams, Marley",12,10,2,2,0,0,0,5
North Melbourne,"Ziebell, Jack",21,15,2,6,2,0,0,3
North Melbourne,"Anderson, Jed",16,11,1,5,1,1,0,5
North Melbourne,"Atley, Shaun",17,8,1,9,0,3,0,3
North Melbourne,"Brown, Ben",11,8,3,3,6,1,8,1
North Melbourne,"Clarke, Ryan",7,5,2,2,0,0,0,0
North Melbourne,"Cunnington, Ben",21,11,4,10,1,0,0,1
North Melbourne,"Davies-Uniacke, Luke",16,7,3,9,0,0,0,5
North Melbourne,"Dumont, Trent",17,8,3,9,0,1,0,4
North Melbourne,"Goldstein, Todd",16,7,6,9,0,1,38,5
North Melbourne,"Hartung, Billy",24,16,9,8,1,1,0,2
North Melbourne,"Higgins, Shaun",24,18,2,6,0,2,0,5
North Melbourne,"Hrovat, Nathan",21,7,2,14,1,1,0,0
North Melbourne,"Jacobs, Ben",18,11,4,7,1,0,0,10
North Melbourne,"Macmillan, Jamie",15,10,4,5,0,0,0,1
North Melbourne,"McDonald, Luke",19,15,8,4,0,1,0,2
North Melbourne,"Simpkin, Jy",15,11,5,4,0,1,0,3
North Melbourne,"Tarrant, Robbie",18,12,6,6,0,0,0,0
North Melbourne,"Thompson, Scott",12,9,6,3,0,0,0,3
North Melbourne,"Turner, Kayne",11,5,4,6,1,0,0,2
North Melbourne,"Vickers-Willis, Ed",6,3,3,3,0,0,0,3
North Melbourne,"Waite, Jarrad",24,21,13,3,1,2,5,6
North Melbourne,"Williams, Marley",14,7,3,7,0,0,0,0
North Melbourne,"Ziebell, Jack",22,12,8,10,0,1,0,4
North Melbourne,"Anderson, Jed",8,5,2,3,0,0,0,4
North Melbourne,"Atley, Shaun",16,11,4,5,0,1,0,2
North Melbourne,"Brown, Ben",11,10,5,1,4,1,3,1
North Melbourne,"Clarke, Ryan",20,9,2,11,0,0,0,3
North Melbourne,"Cunnington, Ben",25,14,6,11,2,0,0,3
North Melbourne,"Davies-Uniacke, Luke",7,5,2,2,0,0,0,1
North Melbourne,"Daw, Majak",7,6,6,1,0,0,3,7
North Melbourne,"Dumont, Trent",23,13,4,10,0,0,0,4
North Melbourne,"Goldstein, Todd",13,8,2,5,1,0,15,1
North Melbourne,"Hartung, Billy",18,7,2,11,1,0,0,1
North Melbourne,"Higgins, Shaun",23,12,3,11,0,1,0,3
North Melbourne,"Hrovat, Nathan",8,2,2,6,0,1,0,1
North Melbourne,"Jacobs, Ben",15,4,6,11,0,0,0,10
North Melbourne,"Macmillan, Jamie",15,6,1,9,0,0,0,5
North Melbourne,"McDonald, Luke",21,13,8,8,0,0,0,1
North Melbourne,"Simpkin, Jy",11,5,1,6,1,0,0,1
North Melbourne,"Thompson, Scott",13,8,6,5,0,0,0,2
North Melbourne,"Turner, Kayne",6,2,1,4,0,0,0,2
North Melbourne,"Vickers-Willis, Ed",12,7,1,5,0,0,0,1
North Melbourne,"Waite, Jarrad",10,8,3,2,3,1,3,3
North Melbourne,"Williams, Marley",10,4,1,6,0,0,0,3
North Melbourne,"Ziebell, Jack",22,17,6,5,1,2,0,3
North Melbourne,"Anderson, Jed",23,12,3,11,1,0,0,5
North Melbourne,"Atley, Shaun",22,11,2,11,3,0,0,4
North Melbourne,"Brown, Ben",17,13,8,4,5,1,0,2
North Melbourne,"Clarke, Ryan",16,9,6,7,0,0,0,1
North Melbourne,"Cunnington, Ben",22,11,3,11,0,0,0,8
North Melbourne,"Davies-Uniacke, Luke",9,6,3,3,0,0,0,1
North Melbourne,"Daw, Majak",12,9,3,3,0,0,10,1
North Melbourne,"Dumont, Trent",23,16,2,7,0,0,0,5
North Melbourne,"Goldstein, Todd",10,5,1,5,0,0,31,2
North Melbourne,"Hartung, Billy",24,15,6,9,1,1,0,3
North Melbourne,"Higgins, Shaun",35,15,5,20,1,1,0,3
North Melbourne,"Jacobs, Ben",11,6,0,5,0,0,0,7
North Melbourne,"Macmillan, Jamie",17,11,6,6,0,1,0,2
North Melbourne,"McDonald, Luke",21,16,5,5,0,1,0,3
North Melbourne,"Simpkin, Jy",10,5,2,5,1,0,0,1
North Melbourne,"Tarrant, Robbie",16,14,9,2,0,0,0,1
North Melbourne,"Thompson, Scott",25,17,15,8,0,0,0,0
North Melbourne,"Turner, Kayne",7,3,0,4,0,1,0,6
North Melbourne,"Vickers-Willis, Ed",15,10,5,5,0,0,0,5
North Melbourne,"Waite, Jarrad",17,11,4,6,3,1,0,2
North Melbourne,"Williams, Marley",15,10,3,5,0,0,0,2
North Melbourne,"Ziebell, Jack",18,13,6,5,3,0,0,2
North Melbourne,"Anderson, Jed",15,6,0,9,0,0,0,9
North Melbourne,"Atley, Shaun",20,6,1,14,1,1,0,1
North Melbourne,"Brown, Ben",10,8,7,2,4,1,0,2
North Melbourne,"Clarke, Ryan",26,17,10,9,0,0,0,2
North Melbourne,"Cunnington, Ben",30,15,3,15,0,0,0,6
North Melbourne,"Daw, Majak",13,9,4,4,0,0,4,1
North Melbourne,"Dumont, Trent",23,13,0,10,1,0,0,2
North Melbourne,"Goldstein, Todd",12,5,3,7,0,0,31,2
North Melbourne,"Hartung, Billy",18,10,4,8,1,1,0,3
North Melbourne,"Higgins, Shaun",13,9,5,4,0,1,0,1
North Melbourne,"Jacobs, Ben",19,5,0,14,0,0,0,5
North Melbourne,"Macmillan, Jamie",20,15,6,5,0,1,0,3
North Melbourne,"McDonald, Luke",18,10,4,8,0,0,0,3
North Melbourne,"Simpkin, Jy",11,4,0,7,0,0,0,2
North Melbourne,"Tarrant, Robbie",20,18,16,2,0,0,0,4
North Melbourne,"Thompson, Scott",20,15,11,5,0,0,0,2
North Melbourne,"Turner, Kayne",15,9,4,6,0,0,0,4
North Melbourne,"Vickers-Willis, Ed",8,7,3,1,0,0,0,2
North Melbourne,"Waite, Jarrad",16,13,8,3,3,5,0,2
North Melbourne,"Williams, Marley",13,8,5,5,0,0,0,1
North Melbourne,"Ziebell, Jack",18,16,5,2,2,2,0,7
North Melbourne,"Zurhaar, Cameron",15,11,2,4,2,1,0,2
North Melbourne,"Anderson, Jed",21,9,0,12,1,0,0,3
North Melbourne,"Atley, Shaun",11,7,5,4,0,1,0,2
North Melbourne,"Brown, Ben",8,7,4,1,4,1,0,0
North Melbourne,"Clarke, Ryan",23,11,5,12,0,0,0,3
North Melbourne,"Cunnington, Ben",27,15,3,12,0,0,0,4
North Melbourne,"Davies-Uniacke, Luke",9,4,0,5,1,1,0,0
North Melbourne,"Daw, Majak",14,8,5,6,0,0,6,4
North Melbourne,"Dumont, Trent",11,10,4,1,0,0,0,3
North Melbourne,"Goldstein, Todd",15,6,4,9,0,0,38,3
North Melbourne,"Hartung, Billy",17,11,1,6,0,0,0,3
North Melbourne,"Jacobs, Ben",23,11,1,12,0,0,0,4
North Melbourne,"Macmillan, Jamie",14,11,3,3,0,1,0,2
North Melbourne,"McDonald, Luke",19,8,4,11,0,0,0,3
North Melbourne,"Simpkin, Jy",22,9,2,13,1,0,0,5
North Melbourne,"Tarrant, Robbie",14,6,4,8,0,0,0,3
North Melbourne,"Thompson, Scott",15,6,2,9,0,0,0,2
North Melbourne,"Turner, Kayne",15,4,2,11,0,0,0,5
North Melbourne,"Vickers-Willis, Ed",16,6,3,10,0,0,0,4
North Melbourne,"Waite, Jarrad",12,8,4,4,3,1,0,2
North Melbourne,"Williams, Marley",18,6,3,12,0,0,0,0
North Melbourne,"Ziebell, Jack",11,4,1,7,0,1,0,5
North Melbourne,"Zurhaar, Cameron",10,5,1,5,0,2,0,3
North Melbourne,"Anderson, Jed",24,9,5,15,0,1,0,4
North Melbourne,"Atley, Shaun",16,7,2,9,0,1,0,1
North Melbourne,"Brown, Ben",12,12,6,0,1,2,8,0
North Melbourne,"Clarke, Ryan",22,16,4,6,0,1,0,1
North Melbourne,"Cunnington, Ben",24,12,6,12,1,0,0,4
North Melbourne,"Dumont, Trent",22,15,7,7,0,1,0,4
North Melbourne,"Goldstein, Todd",8,6,2,2,0,0,40,1
North Melbourne,"Hartung, Billy",19,11,7,8,1,0,0,0
North Melbourne,"Higgins, Shaun",31,16,4,15,1,0,0,2
North Melbourne,"Jacobs, Ben",29,10,6,19,0,0,0,9
North Melbourne,"Macmillan, Jamie",15,8,4,7,0,0,0,2
North Melbourne,"McDonald, Luke",15,9,0,6,0,0,0,4
North Melbourne,"Simpkin, Jy",13,8,4,5,1,0,0,2
North Melbourne,"Tarrant, Robbie",13,7,6,6,0,0,0,1
North Melbourne,"Thompson, Scott",13,10,6,3,0,0,0,2
North Melbourne,"Turner, Kayne",9,3,3,6,0,1,0,3
North Melbourne,"Vickers-Willis, Ed",11,6,4,5,0,0,0,3
North Melbourne,"Williams, Marley",12,8,1,4,0,0,0,0
North Melbourne,"Wood, Mason",17,12,9,5,4,0,0,2
North Melbourne,"Wright, Sam",19,12,7,7,0,0,0,0
North Melbourne,"Ziebell, Jack",19,15,6,4,0,4,0,1
North Melbourne,"Zurhaar, Cameron",8,6,2,2,0,1,0,2
North Melbourne,"Anderson, Jed",28,12,3,16,0,1,0,5
North Melbourne,"Atley, Shaun",12,5,2,7,2,1,0,4
North Melbourne,"Brown, Ben",11,10,3,1,2,2,0,0
North Melbourne,"Clarke, Ryan",19,10,5,9,0,0,0,2
North Melbourne,"Cunnington, Ben",38,20,6,18,0,0,0,7
North Melbourne,"Daw, Majak",11,6,4,5,0,0,7,4
North Melbourne,"Dumont, Trent",17,14,5,3,0,0,0,4
North Melbourne,"Goldstein, Todd",8,3,2,5,0,0,36,4
North Melbourne,"Hartung, Billy",15,8,3,7,0,0,0,2
North Melbourne,"Higgins, Shaun",22,10,2,12,1,0,0,5
North Melbourne,"Jacobs, Ben",15,4,1,11,0,0,0,6
North Melbourne,"Macmillan, Jamie",20,13,6,7,1,0,0,4
North Melbourne,"McDonald, Luke",24,16,6,8,0,0,0,3
North Melbourne,"Simpkin, Jy",18,7,1,11,1,0,0,5
North Melbourne,"Tarrant, Robbie",16,9,5,7,0,0,0,0
North Melbourne,"Thompson, Scott",15,12,6,3,0,0,0,1
North Melbourne,"Turner, Kayne",6,3,3,3,0,0,0,3
North Melbourne,"Waite, Jarrad",10,5,3,5,2,0,0,0
North Melbourne,"Williams, Marley",7,3,2,4,0,0,0,0
North Melbourne,"Wood, Mason",9,7,3,2,2,0,0,2
North Melbourne,"Wright, Sam",10,4,3,6,0,0,0,3
North Melbourne,"Ziebell, Jack",20,13,5,7,0,2,0,5
North Melbourne,"Anderson, Jed",26,10,4,16,1,0,0,3
North Melbourne,"Atley, Shaun",12,2,1,10,0,0,0,3
North Melbourne,"Brown, Ben",13,10,6,3,5,1,0,1
North Melbourne,"Clarke, Ryan",19,14,5,5,0,1,0,3
North Melbourne,"Cunnington, Ben",19,9,4,10,0,0,0,8
North Melbourne,"Daw, Majak",9,4,2,5,0,0,6,2
North Melbourne,"Dumont, Trent",21,14,4,7,1,2,0,5
North Melbourne,"Goldstein, Todd",17,4,1,13,1,0,39,6
North Melbourne,"Hartung, Billy",15,4,3,11,0,0,0,5
North Melbourne,"Higgins, Shaun",28,16,3,12,0,0,0,1
North Melbourne,"Jacobs, Ben",14,6,4,8,0,0,0,10
North Melbourne,"Macmillan, Jamie",11,8,1,3,0,0,0,2
North Melbourne,"McDonald, Luke",25,15,5,10,0,1,0,1
North Melbourne,"Simpkin, Jy",17,5,1,12,1,1,0,6
North Melbourne,"Tarrant, Robbie",13,9,6,4,0,0,0,0
North Melbourne,"Thompson, Scott",11,9,4,2,0,0,0,4
North Melbourne,"Turner, Kayne",13,1,0,12,0,0,0,6
North Melbourne,"Waite, Jarrad",22,17,7,5,4,0,0,2
North Melbourne,"Williams, Marley",13,7,1,6,0,0,0,2
North Melbourne,"Wood, Mason",6,3,1,3,2,0,0,2
North Melbourne,"Wright, Sam",13,7,3,6,0,0,0,3
North Melbourne,"Ziebell, Jack",15,14,7,1,2,2,0,4
North Melbourne,"Anderson, Jed",19,8,1,11,0,2,0,8
North Melbourne,"Atley, Shaun",19,11,2,8,1,2,0,4
North Melbourne,"Brown, Ben",10,7,3,3,2,1,0,2
North Melbourne,"Clarke, Ryan",13,5,2,8,0,0,0,1
North Melbourne,"Cunnington, Ben",20,8,1,12,0,0,0,8
North Melbourne,"Dumont, Trent",15,7,3,8,0,1,0,4
North Melbourne,"Durdin, Sam",6,5,1,1,0,0,4,1
North Melbourne,"Goldstein, Todd",8,4,0,4,1,1,42,2
North Melbourne,"Hartung, Billy",19,7,7,12,0,0,0,4
North Melbourne,"Higgins, Shaun",25,18,5,7,0,2,0,3
North Melbourne,"Jacobs, Ben",29,11,4,18,1,0,0,9
North Melbourne,"Macmillan, Jamie",21,16,7,5,0,0,0,4
North Melbourne,"McDonald, Luke",18,13,5,5,0,0,0,3
North Melbourne,"Simpkin, Jy",17,6,1,11,1,0,0,4
North Melbourne,"Tarrant, Robbie",13,10,2,3,0,0,0,2
North Melbourne,"Thompson, Scott",15,14,5,1,0,0,0,0
North Melbourne,"Turner, Kayne",23,12,4,11,1,2,0,6
North Melbourne,"Waite, Jarrad",19,15,5,4,3,0,0,4
North Melbourne,"Williams, Marley",12,8,3,4,0,0,0,2
North Melbourne,"Wood, Mason",10,6,1,4,2,0,0,4
North Melbourne,"Wright, Sam",7,5,3,2,0,0,0,1
North Melbourne,"Ziebell, Jack",11,6,2,5,0,2,0,3
North Melbourne,"Ahern, Paul",29,13,4,16,0,0,0,3
North Melbourne,"Anderson, Jed",1,1,0,0,0,1,0,0
North Melbourne,"Atley, Shaun",16,9,4,7,2,0,0,1
North Melbourne,"Brown, Ben",14,8,5,6,2,0,0,0
North Melbourne,"Cunnington, Ben",28,6,4,22,1,0,0,1
North Melbourne,"Daw, Majak",10,6,5,4,0,0,7,1
North Melbourne,"Dumont, Trent",20,6,3,14,0,0,0,0
North Melbourne,"Goldstein, Todd",14,4,2,10,1,0,36,3
North Melbourne,"Hartung, Billy",18,5,5,13,1,0,0,1
North Melbourne,"Higgins, Shaun",38,15,3,23,1,0,0,4
North Melbourne,"Jacobs, Ben",22,7,2,15,2,0,0,4
North Melbourne,"Macmillan, Jamie",22,11,4,11,0,0,0,2
North Melbourne,"McDonald, Luke",34,18,6,16,2,1,0,4
North Melbourne,"Murphy, Tom",14,8,2,6,0,0,0,3
North Melbourne,"Simpkin, Jy",21,11,5,10,1,3,0,6
North Melbourne,"Tarrant, Robbie",21,13,5,8,1,0,0,1
North Melbourne,"Thompson, Scott",11,8,4,3,0,0,0,2
North Melbourne,"Turner, Kayne",14,4,3,10,0,0,0,3
North Melbourne,"Williams, Marley",13,8,2,5,1,0,0,3
North Melbourne,"Wood, Mason",20,10,5,10,1,1,0,2
North Melbourne,"Wright, Sam",18,7,4,11,2,0,0,1
North Melbourne,"Ziebell, Jack",19,15,6,4,3,2,0,5
North Melbourne,"Ahern, Paul",13,6,3,7,0,0,0,3
North Melbourne,"Atley, Shaun",15,2,0,13,0,0,0,4
North Melbourne,"Brown, Ben",11,7,2,4,0,0,0,0
North Melbourne,"Cunnington, Ben",22,10,1,12,1,1,0,6
North Melbourne,"Daw, Majak",10,6,4,4,0,0,4,0
North Melbourne,"Dumont, Trent",16,9,1,7,1,1,0,2
North Melbourne,"Goldstein, Todd",13,5,3,8,1,0,36,2
North Melbourne,"Hartung, Billy",10,2,0,8,0,0,0,5
North Melbourne,"Higgins, Shaun",30,17,6,13,2,2,0,3
North Melbourne,"Jacobs, Ben",21,8,1,13,0,0,0,3
North Melbourne,"Macmillan, Jamie",17,11,3,6,0,0,0,1
North Melbourne,"McDonald, Luke",19,11,2,8,0,1,0,1
North Melbourne,"Murphy, Tom",12,7,3,5,0,0,0,1
North Melbourne,"Simpkin, Jy",12,6,1,6,0,0,0,8
North Melbourne,"Tarrant, Robbie",19,14,7,5,0,0,0,0
North Melbourne,"Thompson, Scott",13,8,3,5,0,0,0,2
North Melbourne,"Turner, Kayne",10,4,3,6,1,1,0,1
North Melbourne,"Williams, Marley",18,8,6,10,0,0,0,2
North Melbourne,"Wood, Mason",18,12,5,6,1,3,0,2
North Melbourne,"Wright, Sam",19,12,6,7,0,0,0,0
North Melbourne,"Ziebell, Jack",12,8,1,4,1,1,0,8
North Melbourne,"Zurhaar, Cameron",10,6,0,4,0,0,0,4
North Melbourne,"Ahern, Paul",16,5,1,11,0,0,0,0
North Melbourne,"Anderson, Jed",21,9,3,12,1,0,0,6
North Melbourne,"Atley, Shaun",17,7,3,10,1,0,0,4
North Melbourne,"Brown, Ben",11,8,6,3,5,1,1,0
North Melbourne,"Cunnington, Ben",30,10,4,20,0,0,0,3
North Melbourne,"Daw, Majak",12,5,3,7,0,0,0,1
North Melbourne,"Dumont, Trent",24,16,7,8,0,0,0,2
North Melbourne,"Goldstein, Todd",20,11,7,9,0,0,42,3
North Melbourne,"Hartung, Billy",7,2,0,5,0,0,0,1
North Melbourne,"Higgins, Shaun",32,13,1,19,2,1,0,2
North Melbourne,"Hrovat, Nathan",9,4,1,5,0,0,0,4
North Melbourne,"Macmillan, Jamie",18,13,5,5,0,0,0,1
North Melbourne,"McDonald, Luke",14,10,6,4,0,0,0,1
North Melbourne,"Murphy, Tom",10,6,3,4,0,0,0,3
North Melbourne,"Simpkin, Jy",12,5,2,7,0,0,0,5
North Melbourne,"Tarrant, Robbie",16,12,8,4,0,0,0,2
North Melbourne,"Thompson, Scott",15,9,3,6,0,0,0,6
North Melbourne,"Turner, Kayne",9,2,0,7,0,0,0,2
North Melbourne,"Williams, Marley",16,10,5,6,0,0,0,2
North Melbourne,"Wood, Mason",13,9,5,4,0,2,0,1
North Melbourne,"Wright, Sam",18,13,4,5,0,0,0,0
North Melbourne,"Ziebell, Jack",12,10,4,2,3,1,0,4
North Melbourne,"Ahern, Paul",22,11,3,11,1,0,0,3
North Melbourne,"Anderson, Jed",20,9,4,11,0,0,0,5
North Melbourne,"Atley, Shaun",14,8,4,6,1,0,0,2
North Melbourne,"Brown, Ben",14,13,9,1,2,3,0,3
North Melbourne,"Clarke, Ryan",14,8,2,6,1,0,0,2
North Melbourne,"Cunnington, Ben",23,11,8,12,2,0,0,4
North Melbourne,"Daw, Majak",8,6,4,2,0,0,5,3
North Melbourne,"Dumont, Trent",16,9,5,7,1,1,0,5
North Melbourne,"Goldstein, Todd",14,6,4,8,0,1,44,2
North Melbourne,"Higgins, Shaun",31,18,6,13,0,1,0,2
North Melbourne,"Hrovat, Nathan",13,8,3,5,1,1,0,0
North Melbourne,"Macmillan, Jamie",24,15,5,9,0,0,0,1
North Melbourne,"McDonald, Luke",20,12,7,8,2,0,0,1
North Melbourne,"Murphy, Tom",7,1,1,6,0,0,0,1
North Melbourne,"Simpkin, Jy",14,4,2,10,0,1,0,4
North Melbourne,"Tarrant, Robbie",13,8,3,5,0,0,0,3
North Melbourne,"Thompson, Scott",17,11,10,6,0,0,0,3
North Melbourne,"Turner, Kayne",11,4,2,7,1,0,0,2
North Melbourne,"Williams, Marley",9,5,3,4,0,0,0,1
North Melbourne,"Wood, Mason",16,13,5,3,3,3,0,3
North Melbourne,"Wright, Sam",21,18,11,3,0,0,0,2
North Melbourne,"Ziebell, Jack",19,14,4,5,1,0,0,3
North Melbourne,"Ahern, Paul",22,13,4,9,2,0,0,3
North Melbourne,"Anderson, Jed",20,7,3,13,0,0,0,8
North Melbourne,"Atley, Shaun",13,6,1,7,0,2,0,4
North Melbourne,"Brown, Ben",12,8,4,4,4,2,0,1
North Melbourne,"Clarke, Ryan",27,15,6,12,1,0,0,0
North Melbourne,"Cunnington, Ben",30,10,6,20,0,0,0,6
North Melbourne,"Daw, Majak",13,6,5,7,2,0,1,1
North Melbourne,"Dumont, Trent",23,10,8,13,0,0,0,7
North Melbourne,"Goldstein, Todd",20,13,4,7,1,0,36,6
North Melbourne,"Higgins, Shaun",26,7,0,19,1,0,0,2
North Melbourne,"Hrovat, Nathan",12,3,1,9,0,0,0,1
North Melbourne,"Jacobs, Ben",26,11,3,15,1,1,0,4
North Melbourne,"Macmillan, Jamie",19,15,8,4,0,0,0,5
North Melbourne,"McDonald, Luke",26,14,7,12,0,1,0,4
North Melbourne,"Simpkin, Jy",13,4,3,9,0,0,0,0
North Melbourne,"Tarrant, Robbie",26,14,10,12,0,0,0,1
North Melbourne,"Thompson, Scott",31,18,9,13,0,0,0,3
North Melbourne,"Turner, Kayne",14,8,4,6,1,0,0,3
North Melbourne,"Williams, Marley",18,10,3,8,0,0,0,7
North Melbourne,"Wright, Sam",22,10,8,12,0,0,0,1
North Melbourne,"Ziebell, Jack",18,10,4,8,1,2,0,4
North Melbourne,"Zurhaar, Cameron",9,2,0,7,0,1,1,3
North Melbourne,"Ahern, Paul",21,9,1,12,0,0,0,6
North Melbourne,"Anderson, Jed",27,10,3,17,0,0,0,4
North Melbourne,"Atley, Shaun",20,9,5,11,0,0,0,0
North Melbourne,"Brown, Ben",17,13,8,4,4,2,0,1
North Melbourne,"Clarke, Ryan",10,5,0,5,0,0,0,1
North Melbourne,"Cunnington, Ben",21,6,1,15,0,0,0,6
North Melbourne,"Davies-Uniacke, Luke",16,8,3,8,0,0,0,5
North Melbourne,"Daw, Majak",10,8,6,2,4,2,4,3
North Melbourne,"Dumont, Trent",13,6,3,7,0,0,0,0
North Melbourne,"Goldstein, Todd",18,5,5,13,0,0,52,4
North Melbourne,"Higgins, Shaun",33,17,2,16,0,0,0,3
North Melbourne,"Hrovat, Nathan",10,5,3,5,1,0,0,6
North Melbourne,"Macmillan, Jamie",18,12,6,6,1,0,0,2
North Melbourne,"McDonald, Luke",20,12,3,8,0,0,0,0
North Melbourne,"Morgan, Alex",18,8,9,10,0,0,0,2
North Melbourne,"Simpkin, Jy",18,7,5,11,0,0,0,1
North Melbourne,"Tarrant, Robbie",15,9,5,6,0,0,0,1
North Melbourne,"Thompson, Scott",13,8,3,5,0,0,0,3
North Melbourne,"Turner, Kayne",0,0,0,0,0,0,0,0
North Melbourne,"Williams, Marley",13,11,4,2,0,0,0,1
North Melbourne,"Wright, Sam",22,10,6,12,0,0,0,0
North Melbourne,"Ziebell, Jack",22,15,9,7,5,1,0,2
North Melbourne,"Ahern, Paul",24,10,0,14,0,0,0,0
North Melbourne,"Anderson, Jed",22,9,2,13,0,1,0,5
North Melbourne,"Atley, Shaun",13,3,2,10,0,0,0,3
North Melbourne,"Brown, Ben",10,8,5,2,2,1,0,0
North Melbourne,"Clarke, Ryan",27,15,12,12,0,1,0,2
North Melbourne,"Cunnington, Ben",30,10,4,20,0,1,0,7
North Melbourne,"Davies-Uniacke, Luke",8,4,2,4,0,0,0,3
North Melbourne,"Daw, Majak",10,8,6,2,3,2,4,4
North Melbourne,"Dumont, Trent",20,9,3,11,0,0,0,3
North Melbourne,"Goldstein, Todd",16,4,3,12,1,1,26,2
North Melbourne,"Higgins, Shaun",33,14,2,19,0,0,0,1
North Melbourne,"Hrovat, Nathan",18,8,2,10,1,0,0,2
North Melbourne,"Macmillan, Jamie",21,13,8,8,0,0,0,0
North Melbourne,"McDonald, Luke",13,7,3,6,0,1,0,3
North Melbourne,"Morgan, Alex",6,2,2,4,0,0,0,0
North Melbourne,"Simpkin, Jy",9,2,0,7,0,0,0,2
North Melbourne,"Tarrant, Robbie",21,11,4,10,0,0,0,0
North Melbourne,"Thompson, Scott",11,4,2,7,0,0,0,1
North Melbourne,"Turner, Kayne",9,2,1,7,0,0,0,3
North Melbourne,"Williams, Marley",11,4,2,7,0,0,0,3
North Melbourne,"Wright, Sam",15,8,3,7,0,0,0,1
North Melbourne,"Ziebell, Jack",10,9,3,1,2,0,0,2
North Melbourne,"Ahern, Paul",37,23,3,14,0,0,0,3
North Melbourne,"Anderson, Jed",23,11,1,12,1,0,0,6
North Melbourne,"Atley, Shaun",20,6,4,14,0,0,0,2
North Melbourne,"Brown, Ben",9,3,2,6,1,1,0,0
North Melbourne,"Clarke, Ryan",28,15,7,13,0,0,0,3
North Melbourne,"Cunnington, Ben",39,14,4,25,1,0,0,10
North Melbourne,"Daw, Majak",17,9,7,8,0,0,5,3
North Melbourne,"Dumont, Trent",24,15,3,9,0,0,0,3
North Melbourne,"Goldstein, Todd",22,7,4,15,1,0,44,4
North Melbourne,"Higgins, Shaun",21,10,2,11,2,0,0,4
North Melbourne,"Hrovat, Nathan",12,6,1,6,1,0,0,2
North Melbourne,"Macmillan, Jamie",19,14,7,5,0,0,0,1
North Melbourne,"McDonald, Luke",18,9,4,9,0,0,0,3
North Melbourne,"Simpkin, Jy",18,9,4,9,1,0,0,8
North Melbourne,"Tarrant, Robbie",13,8,5,5,0,0,0,2
North Melbourne,"Thompson, Scott",10,6,5,4,0,0,0,3
North Melbourne,"Turner, Kayne",16,6,2,10,0,0,0,4
North Melbourne,"Walker, Will",11,6,4,5,0,1,0,4
North Melbourne,"Williams, Marley",17,12,1,5,0,0,0,3
North Melbourne,"Wood, Mason",15,9,4,6,2,2,0,2
North Melbourne,"Wright, Sam",17,7,2,10,0,0,0,0
North Melbourne,"Ziebell, Jack",12,9,5,3,2,3,0,3
North Melbourne,"Ahern, Paul",16,8,0,8,0,0,0,2
North Melbourne,"Anderson, Jed",25,15,4,10,0,0,0,5
North Melbourne,"Atley, Shaun",14,5,2,9,2,0,0,2
North Melbourne,"Brown, Ben",12,9,2,3,1,0,0,2
North Melbourne,"Clarke, Ryan",21,9,3,12,0,0,0,1
North Melbourne,"Cunnington, Ben",22,8,2,14,1,0,0,1
North Melbourne,"Daw, Majak",15,10,6,5,0,0,3,2
North Melbourne,"Dumont, Trent",29,14,3,15,0,1,0,5
North Melbourne,"Goldstein, Todd",8,3,2,5,0,0,32,2
North Melbourne,"Hrovat, Nathan",15,8,3,7,1,0,0,3
North Melbourne,"Macmillan, Jamie",17,12,5,5,0,0,0,1
North Melbourne,"McDonald, Luke",7,6,2,1,0,0,0,3
North Melbourne,"Simpkin, Jy",20,8,3,12,1,0,0,4
North Melbourne,"Tarrant, Robbie",12,10,7,2,0,1,0,0
North Melbourne,"Thompson, Scott",6,2,1,4,0,0,0,2
North Melbourne,"Turner, Kayne",17,8,2,9,2,1,0,4
North Melbourne,"Waite, Jarrad",9,4,3,5,2,1,0,0
North Melbourne,"Walker, Will",11,7,4,4,2,2,0,1
North Melbourne,"Williams, Marley",13,7,2,6,0,0,0,5
North Melbourne,"Wood, Mason",9,4,2,5,1,1,0,3
North Melbourne,"Wright, Sam",19,11,5,8,0,0,0,2
North Melbourne,"Ziebell, Jack",26,20,7,6,3,2,0,2
North Melbourne,"Ahern, Paul",10,6,1,4,0,2,0,2
North Melbourne,"Anderson, Jed",20,7,1,13,0,0,0,8
North Melbourne,"Atley, Shaun",12,6,2,6,1,1,0,6
North Melbourne,"Brown, Ben",12,8,4,4,4,0,0,1
North Melbourne,"Clarke, Ryan",12,5,2,7,0,0,0,2
North Melbourne,"Cunnington, Ben",26,14,5,12,0,0,0,3
North Melbourne,"Daw, Majak",15,10,9,5,0,0,4,1
North Melbourne,"Dumont, Trent",18,11,4,7,0,0,0,5
North Melbourne,"Goldstein, Todd",20,8,8,12,0,0,34,2
North Melbourne,"Higgins, Shaun",24,14,3,10,1,0,0,2
North Melbourne,"Macmillan, Jamie",19,11,5,8,0,0,0,3
North Melbourne,"McDonald, Luke",10,4,3,6,0,0,0,0
North Melbourne,"Simpkin, Jy",11,6,1,5,0,1,0,2
North Melbourne,"Tarrant, Robbie",16,11,6,5,0,0,0,4
North Melbourne,"Thompson, Scott",18,12,9,6,0,0,1,1
North Melbourne,"Turner, Kayne",6,2,2,4,1,0,0,4
North Melbourne,"Waite, Jarrad",19,13,12,6,2,2,0,1
North Melbourne,"Walker, Will",8,8,2,0,1,0,0,2
North Melbourne,"Williams, Marley",18,10,5,8,0,0,0,3
North Melbourne,"Wood, Mason",18,13,4,5,2,3,0,5
North Melbourne,"Wright, Sam",14,7,5,7,0,0,0,2
North Melbourne,"Ziebell, Jack",17,9,3,8,0,0,0,3
North Melbourne,"Anderson, Jed",21,11,3,10,0,0,0,4
North Melbourne,"Atley, Shaun",23,11,2,12,2,0,0,0
North Melbourne,"Brown, Ben",4,4,3,0,0,1,0,5
North Melbourne,"Clarke, Ryan",17,7,6,10,0,0,0,0
North Melbourne,"Cunnington, Ben",16,10,2,6,0,0,0,7
North Melbourne,"Daw, Majak",17,11,10,6,0,0,9,4
North Melbourne,"Dumont, Trent",33,15,4,18,0,1,0,6
North Melbourne,"Goldstein, Todd",14,6,1,8,2,0,29,2
North Melbourne,"Higgins, Shaun",29,12,5,17,0,0,0,7
North Melbourne,"Hrovat, Nathan",11,6,0,5,0,0,0,1
North Melbourne,"Macmillan, Jamie",18,11,8,7,0,0,0,2
North Melbourne,"McDonald, Luke",20,7,4,13,0,0,0,1
North Melbourne,"Simpkin, Jy",11,6,5,5,1,0,0,5
North Melbourne,"Tarrant, Robbie",19,16,10,3,0,0,0,2
North Melbourne,"Thompson, Scott",18,12,8,6,0,0,0,4
North Melbourne,"Turner, Kayne",12,7,2,5,0,3,0,6
North Melbourne,"Waite, Jarrad",15,12,10,3,3,1,0,3
North Melbourne,"Walker, Will",9,6,2,3,1,2,0,2
North Melbourne,"Williams, Marley",19,11,4,8,0,1,0,2
North Melbourne,"Wood, Mason",11,7,4,4,1,1,0,0
North Melbourne,"Wright, Sam",18,10,4,8,0,0,0,3
North Melbourne,"Ziebell, Jack",17,11,4,6,1,0,0,2
North Melbourne,"Ahern, Paul",23,12,3,11,0,1,0,1
North Melbourne,"Anderson, Jed",21,6,3,15,0,1,0,5
North Melbourne,"Atley, Shaun",20,8,2,12,0,0,0,3
North Melbourne,"Brown, Ben",13,9,5,4,3,2,0,0
North Melbourne,"Clarke, Ryan",28,14,3,14,0,0,0,1
North Melbourne,"Cunnington, Ben",29,10,4,19,0,0,0,3
North Melbourne,"Daw, Majak",13,8,6,5,1,0,5,2
North Melbourne,"Dumont, Trent",38,17,7,21,1,1,0,5
North Melbourne,"Goldstein, Todd",20,11,7,9,2,0,27,3
North Melbourne,"Higgins, Shaun",29,16,5,13,1,3,0,1
North Melbourne,"Hrovat, Nathan",20,16,7,4,1,0,0,7
North Melbourne,"Macmillan, Jamie",24,9,7,15,0,0,0,1
North Melbourne,"McDonald, Luke",14,8,2,6,0,1,0,2
North Melbourne,"Simpkin, Jy",12,3,3,9,1,0,0,4
North Melbourne,"Tarrant, Robbie",17,8,6,9,0,0,0,1
North Melbourne,"Thompson, Scott",10,5,4,5,0,0,0,0
North Melbourne,"Turner, Kayne",13,7,3,6,0,0,0,3
North Melbourne,"Waite, Jarrad",16,14,8,2,3,3,0,0
North Melbourne,"Williams, Marley",18,12,4,6,0,0,0,2
North Melbourne,"Wood, Mason",3,3,3,0,1,0,0,0
North Melbourne,"Wright, Sam",29,16,8,13,0,0,0,2
North Melbourne,"Ziebell, Jack",15,12,6,3,3,1,0,2
Port Adelaide,"Barry, Dom",22,12,5,10,0,0,0,1
Port Adelaide,"Boak, Travis",26,12,5,14,1,1,0,3
Port Adelaide,"Bonner, Riley",31,21,6,10,0,0,0,1
Port Adelaide,"Byrne-Jones, Darcy",28,13,3,15,0,0,0,3
Port Adelaide,"Clurey, Tom",16,13,8,3,0,0,0,1
Port Adelaide,"Dixon, Charlie",20,12,7,8,1,3,4,3
Port Adelaide,"Ebert, Brad",28,13,5,15,0,1,0,7
Port Adelaide,"Gray, Sam",11,8,3,3,1,0,0,4
Port Adelaide,"Hartlett, Hamish",23,19,7,4,0,0,0,2
Port Adelaide,"Houston, Dan",17,12,7,5,0,0,0,2
Port Adelaide,"Howard, Dougal",10,8,4,2,0,0,0,3
Port Adelaide,"Jonas, Tom",16,11,6,5,0,0,0,3
Port Adelaide,"Marshall, Todd",10,6,2,4,4,0,0,2
Port Adelaide,"Motlop, Steven",19,11,3,8,2,0,0,3
Port Adelaide,"Polec, Jared",29,15,4,14,0,0,0,2
Port Adelaide,"Powell-Pepper, Sam",19,11,5,8,0,4,0,3
Port Adelaide,"Rockliff, Tom",12,6,4,6,1,0,0,1
Port Adelaide,"Ryder, Paddy",6,4,2,2,1,0,16,1
Port Adelaide,"Watts, Jack",20,12,7,8,3,3,0,4
Port Adelaide,"Westhoff, Justin",25,15,9,10,0,0,5,9
Port Adelaide,"Wines, Ollie",28,13,3,15,0,0,1,5
Port Adelaide,"Wingard, Chad",23,13,7,10,2,1,0,0
Port Adelaide,"Barry, Dom",15,6,2,9,0,0,0,7
Port Adelaide,"Boak, Travis",22,11,1,11,2,0,0,2
Port Adelaide,"Bonner, Riley",18,11,5,7,1,1,0,1
Port Adelaide,"Byrne-Jones, Darcy",20,11,3,9,0,0,0,0
Port Adelaide,"Clurey, Tom",11,10,4,1,0,0,0,0
Port Adelaide,"Dixon, Charlie",17,9,2,8,0,0,32,5
Port Adelaide,"Ebert, Brad",13,6,4,7,0,0,0,9
Port Adelaide,"Gray, Robbie",26,12,3,14,1,0,0,10
Port Adelaide,"Gray, Sam",17,11,5,6,0,1,0,6
Port Adelaide,"Hartlett, Hamish",13,12,10,1,0,1,0,2
Port Adelaide,"Houston, Dan",14,10,2,4,0,0,0,4
Port Adelaide,"Howard, Dougal",7,4,1,3,0,0,0,0
Port Adelaide,"Jonas, Tom",19,15,11,4,0,0,0,2
Port Adelaide,"Marshall, Todd",12,7,3,5,3,1,0,0
Port Adelaide,"Motlop, Steven",20,11,2,9,1,2,0,2
Port Adelaide,"Polec, Jared",21,17,4,4,2,1,0,2
Port Adelaide,"Powell-Pepper, Sam",9,5,0,4,1,0,0,9
Port Adelaide,"Rockliff, Tom",9,7,0,2,0,0,0,2
Port Adelaide,"Watts, Jack",10,4,0,6,0,0,0,5
Port Adelaide,"Westhoff, Justin",27,19,1,8,0,0,11,6
Port Adelaide,"Wines, Ollie",35,18,3,17,1,0,1,6
Port Adelaide,"Wingard, Chad",12,10,3,2,2,2,0,0
Port Adelaide,"Barry, Dom",12,6,4,6,0,1,0,0
Port Adelaide,"Boak, Travis",18,12,6,6,1,1,0,2
Port Adelaide,"Bonner, Riley",22,18,10,4,0,0,0,0
Port Adelaide,"Byrne-Jones, Darcy",11,6,5,5,0,0,0,2
Port Adelaide,"Clurey, Tom",7,7,4,0,0,0,0,1
Port Adelaide,"Dixon, Charlie",14,7,2,7,1,2,6,4
Port Adelaide,"Ebert, Brad",23,8,3,15,1,0,0,3
Port Adelaide,"Gray, Robbie",22,9,3,13,1,1,0,3
Port Adelaide,"Gray, Sam",21,13,9,8,3,1,0,2
Port Adelaide,"Hartlett, Hamish",26,17,9,9,0,0,0,0
Port Adelaide,"Houston, Dan",18,13,6,5,0,0,0,2
Port Adelaide,"Howard, Dougal",12,10,6,2,0,0,1,1
Port Adelaide,"Jonas, Tom",16,12,7,4,0,0,0,2
Port Adelaide,"Marshall, Todd",8,8,3,0,1,1,0,3
Port Adelaide,"Motlop, Steven",17,7,2,10,2,1,0,1
Port Adelaide,"Polec, Jared",29,24,12,5,0,1,0,3
Port Adelaide,"Powell-Pepper, Sam",19,10,1,9,0,1,0,4
Port Adelaide,"Rockliff, Tom",19,13,6,6,1,0,0,1
Port Adelaide,"Watts, Jack",13,9,6,4,1,1,0,0
Port Adelaide,"Westhoff, Justin",12,4,3,8,1,0,15,5
Port Adelaide,"Wines, Ollie",25,10,1,15,0,0,0,4
Port Adelaide,"Wingard, Chad",20,12,3,8,1,1,0,2
Port Adelaide,"Amon, Karl",18,5,2,13,1,0,0,1
Port Adelaide,"Boak, Travis",21,12,1,9,1,0,0,1
Port Adelaide,"Bonner, Riley",14,10,1,4,1,0,0,2
Port Adelaide,"Byrne-Jones, Darcy",12,6,2,6,1,0,0,2
Port Adelaide,"Clurey, Tom",6,5,1,1,0,0,0,1
Port Adelaide,"Dixon, Charlie",12,4,4,8,1,1,13,1
Port Adelaide,"Ebert, Brad",20,7,2,13,0,0,0,7
Port Adelaide,"Gray, Robbie",39,12,5,27,0,1,0,4
Port Adelaide,"Gray, Sam",18,9,3,9,1,1,0,4
Port Adelaide,"Hartlett, Hamish",13,6,4,7,0,0,0,5
Port Adelaide,"Houston, Dan",17,13,3,4,0,0,0,3
Port Adelaide,"Howard, Dougal",13,5,3,8,0,0,21,4
Port Adelaide,"Jonas, Tom",17,12,9,5,0,0,0,4
Port Adelaide,"Marshall, Todd",8,6,1,2,1,2,0,1
Port Adelaide,"McKenzie, Trent",11,7,3,4,0,0,0,2
Port Adelaide,"Motlop, Steven",15,8,2,7,0,0,0,3
Port Adelaide,"Polec, Jared",28,13,5,15,0,1,0,2
Port Adelaide,"Rockliff, Tom",8,5,1,3,1,0,0,4
Port Adelaide,"Watts, Jack",13,7,4,6,3,0,0,5
Port Adelaide,"Westhoff, Justin",19,12,6,7,1,1,5,2
Port Adelaide,"Wines, Ollie",27,12,5,15,0,1,0,2
Port Adelaide,"Wingard, Chad",16,8,2,8,0,2,0,1
Port Adelaide,"Amon, Karl",10,7,3,3,1,0,0,0
Port Adelaide,"Boak, Travis",23,11,4,12,0,2,0,8
Port Adelaide,"Bonner, Riley",22,15,6,7,0,0,0,1
Port Adelaide,"Byrne-Jones, Darcy",17,14,7,3,0,0,0,8
Port Adelaide,"Clurey, Tom",13,12,8,1,0,0,0,1
Port Adelaide,"Dixon, Charlie",11,8,6,3,0,1,1,2
Port Adelaide,"Ebert, Brad",24,8,4,16,0,0,0,14
Port Adelaide,"Gray, Robbie",32,13,5,19,1,1,0,7
Port Adelaide,"Gray, Sam",15,8,2,7,1,0,0,2
Port Adelaide,"Hartlett, Hamish",23,17,9,6,0,0,0,3
Port Adelaide,"Hombsch, Jack",15,12,7,3,0,0,0,1
Port Adelaide,"Houston, Dan",16,16,8,0,0,0,0,4
Port Adelaide,"Howard, Dougal",10,6,2,4,0,0,15,3
Port Adelaide,"Jonas, Tom",21,18,15,3,0,0,0,2
Port Adelaide,"Motlop, Steven",11,5,2,6,0,0,0,2
Port Adelaide,"Neade, Jake",9,5,2,4,2,0,0,4
Port Adelaide,"Polec, Jared",25,16,4,9,0,0,0,3
Port Adelaide,"Thomas, Lindsay",8,5,2,3,1,1,0,3
Port Adelaide,"Watts, Jack",18,9,5,9,0,1,0,3
Port Adelaide,"Westhoff, Justin",23,14,6,9,0,0,26,3
Port Adelaide,"Wines, Ollie",29,11,2,18,1,0,0,5
Port Adelaide,"Wingard, Chad",14,10,2,4,0,2,0,0
Port Adelaide,"Amon, Karl",15,10,1,5,0,0,0,2
Port Adelaide,"Barry, Dom",11,4,2,7,0,2,0,1
Port Adelaide,"Boak, Travis",29,7,5,22,0,0,0,4
Port Adelaide,"Bonner, Riley",18,13,4,5,0,0,0,1
Port Adelaide,"Byrne-Jones, Darcy",22,14,5,8,0,0,0,4
Port Adelaide,"Clurey, Tom",14,10,6,4,0,0,0,3
Port Adelaide,"Dixon, Charlie",16,9,2,7,1,1,25,4
Port Adelaide,"Ebert, Brad",33,14,6,19,0,0,0,11
Port Adelaide,"Gray, Robbie",23,7,7,16,1,0,0,5
Port Adelaide,"Gray, Sam",19,11,9,8,4,1,0,3
Port Adelaide,"Hombsch, Jack",7,4,3,3,0,0,0,2
Port Adelaide,"Houston, Dan",16,11,4,5,1,0,0,4
Port Adelaide,"Howard, Dougal",15,12,1,3,0,0,0,2
Port Adelaide,"Johnson, Aidyn",9,2,1,7,1,1,0,5
Port Adelaide,"Jonas, Tom",19,15,7,4,0,0,0,0
Port Adelaide,"Motlop, Steven",20,8,3,12,0,0,0,1
Port Adelaide,"Neade, Jake",15,7,3,8,2,1,0,4
Port Adelaide,"Polec, Jared",34,18,5,16,1,0,0,12
Port Adelaide,"Watts, Jack",10,4,3,6,1,1,0,3
Port Adelaide,"Westhoff, Justin",25,14,8,11,1,1,4,5
Port Adelaide,"Wines, Ollie",20,12,1,8,0,0,0,2
Port Adelaide,"Wingard, Chad",13,11,3,2,2,2,0,3
Port Adelaide,"Amon, Karl",16,8,5,8,0,0,0,2
Port Adelaide,"Barry, Dom",14,5,3,9,0,0,0,1
Port Adelaide,"Boak, Travis",28,14,7,14,0,1,0,3
Port Adelaide,"Bonner, Riley",20,11,3,9,1,0,0,3
Port Adelaide,"Byrne-Jones, Darcy",26,12,7,14,0,0,0,1
Port Adelaide,"Dixon, Charlie",14,9,7,5,1,3,0,1
Port Adelaide,"Ebert, Brad",20,11,6,9,0,0,0,8
Port Adelaide,"Gray, Robbie",28,8,3,20,0,0,0,6
Port Adelaide,"Gray, Sam",6,3,2,3,2,0,0,2
Port Adelaide,"Hombsch, Jack",14,7,3,7,0,0,0,0
Port Adelaide,"Houston, Dan",24,15,7,9,0,0,0,5
Port Adelaide,"Howard, Dougal",13,7,3,6,0,0,0,5
Port Adelaide,"Johnson, Aidyn",9,4,3,5,2,0,0,3
Port Adelaide,"Jonas, Tom",17,7,5,10,0,0,0,2
Port Adelaide,"Motlop, Steven",22,13,4,9,1,0,0,3
Port Adelaide,"Neade, Jake",5,0,1,5,0,0,0,2
Port Adelaide,"Pittard, Jasper",13,8,0,5,0,0,0,1
Port Adelaide,"Polec, Jared",21,14,1,7,1,0,0,5
Port Adelaide,"Ryder, Paddy",9,6,3,3,0,0,19,2
Port Adelaide,"Watts, Jack",20,9,7,11,1,0,0,1
Port Adelaide,"Westhoff, Justin",19,8,6,11,0,0,7,5
Port Adelaide,"Wines, Ollie",22,8,1,14,0,0,0,5
Port Adelaide,"Boak, Travis",24,9,2,15,1,0,0,5
Port Adelaide,"Bonner, Riley",17,10,8,7,0,0,0,1
Port Adelaide,"Byrne-Jones, Darcy",23,17,7,6,0,0,0,5
Port Adelaide,"Clurey, Tom",8,7,3,1,0,0,0,0
Port Adelaide,"Dixon, Charlie",11,8,6,3,0,0,7,3
Port Adelaide,"Ebert, Brad",24,10,5,14,0,1,0,6
Port Adelaide,"Gray, Robbie",20,11,5,9,6,0,0,0
Port Adelaide,"Gray, Sam",21,12,3,9,1,2,0,1
Port Adelaide,"Hombsch, Jack",9,6,5,3,0,0,0,3
Port Adelaide,"Houston, Dan",20,14,8,6,0,0,0,1
Port Adelaide,"Howard, Dougal",12,8,4,4,0,0,0,1
Port Adelaide,"Jonas, Tom",21,14,10,7,0,0,0,3
Port Adelaide,"Motlop, Steven",20,14,4,6,1,2,0,4
Port Adelaide,"Neade, Jake",11,5,1,6,0,1,0,7
Port Adelaide,"Polec, Jared",23,14,5,9,0,0,0,4
Port Adelaide,"Powell-Pepper, Sam",21,8,4,13,1,1,0,6
Port Adelaide,"Rockliff, Tom",31,14,4,17,0,0,0,9
Port Adelaide,"Ryder, Paddy",11,6,3,5,2,0,39,5
Port Adelaide,"Watts, Jack",13,8,5,5,0,0,0,2
Port Adelaide,"Westhoff, Justin",26,16,6,10,0,1,2,6
Port Adelaide,"Wines, Ollie",26,12,2,14,0,1,0,7
Port Adelaide,"Wingard, Chad",19,10,1,9,2,2,0,2
Port Adelaide,"Boak, Travis",29,15,5,14,1,1,0,6
Port Adelaide,"Bonner, Riley",17,11,4,6,0,0,0,0
Port Adelaide,"Byrne-Jones, Darcy",26,22,5,4,0,0,0,4
Port Adelaide,"Clurey, Tom",17,14,7,3,0,0,0,3
Port Adelaide,"Dixon, Charlie",18,8,2,10,1,2,3,3
Port Adelaide,"Ebert, Brad",12,10,4,2,0,0,0,9
Port Adelaide,"Gray, Robbie",15,11,1,4,0,3,0,4
Port Adelaide,"Gray, Sam",17,12,2,5,2,2,0,3
Port Adelaide,"Hombsch, Jack",7,3,1,4,0,0,0,0
Port Adelaide,"Houston, Dan",14,7,3,7,0,0,0,3
Port Adelaide,"Howard, Dougal",8,6,3,2,0,0,0,0
Port Adelaide,"Jonas, Tom",16,14,10,2,0,0,0,3
Port Adelaide,"Motlop, Steven",5,3,0,2,0,0,0,2
Port Adelaide,"Neade, Jake",13,6,0,7,0,2,0,4
Port Adelaide,"Polec, Jared",20,14,0,6,0,0,0,5
Port Adelaide,"Powell-Pepper, Sam",26,16,3,10,2,1,0,10
Port Adelaide,"Rockliff, Tom",26,16,2,10,1,1,0,7
Port Adelaide,"Ryder, Paddy",6,4,3,2,0,0,42,3
Port Adelaide,"Watts, Jack",12,4,2,8,1,0,0,5
Port Adelaide,"Westhoff, Justin",16,10,2,6,0,1,7,5
Port Adelaide,"Wines, Ollie",26,15,5,11,1,0,0,3
Port Adelaide,"Wingard, Chad",16,10,3,6,2,3,0,0
Port Adelaide,"Boak, Travis",16,10,1,6,0,0,0,4
Port Adelaide,"Bonner, Riley",17,13,4,4,0,0,0,3
Port Adelaide,"Byrne-Jones, Darcy",18,13,5,5,0,0,0,3
Port Adelaide,"Clurey, Tom",13,11,5,2,0,0,0,1
Port Adelaide,"Dixon, Charlie",13,9,6,4,1,0,2,1
Port Adelaide,"Ebert, Brad",18,10,6,8,0,0,0,3
Port Adelaide,"Gray, Robbie",13,7,2,6,4,0,0,2
Port Adelaide,"Gray, Sam",12,2,2,10,0,0,0,1
Port Adelaide,"Hombsch, Jack",14,8,7,6,0,0,0,2
Port Adelaide,"Houston, Dan",11,10,3,1,0,0,0,1
Port Adelaide,"Howard, Dougal",13,9,7,4,0,0,0,0
Port Adelaide,"Jonas, Tom",15,14,9,1,0,0,0,2
Port Adelaide,"Motlop, Steven",21,12,3,9,0,0,0,5
Port Adelaide,"Neade, Jake",9,3,3,6,0,0,0,7
Port Adelaide,"Polec, Jared",21,14,6,7,0,0,0,1
Port Adelaide,"Powell-Pepper, Sam",21,10,4,11,0,1,0,4
Port Adelaide,"Rockliff, Tom",10,6,0,4,0,0,0,7
Port Adelaide,"Ryder, Paddy",13,7,4,6,0,0,35,0
Port Adelaide,"Watts, Jack",10,8,4,2,3,0,0,1
Port Adelaide,"Westhoff, Justin",20,14,7,6,1,0,3,2
Port Adelaide,"Wines, Ollie",22,7,4,15,0,1,0,2
Port Adelaide,"Wingard, Chad",13,9,4,4,0,0,0,1
Port Adelaide,"Boak, Travis",18,9,4,9,0,0,0,6
Port Adelaide,"Bonner, Riley",15,11,4,4,0,0,0,0
Port Adelaide,"Byrne-Jones, Darcy",21,19,7,2,0,0,0,6
Port Adelaide,"Clurey, Tom",12,7,2,5,0,0,0,1
Port Adelaide,"Dixon, Charlie",13,8,4,5,1,1,5,2
Port Adelaide,"Ebert, Brad",17,13,6,4,0,0,0,5
Port Adelaide,"Gray, Robbie",16,6,2,10,2,1,0,2
Port Adelaide,"Gray, Sam",20,12,5,8,2,3,0,4
Port Adelaide,"Houston, Dan",11,9,5,2,0,0,0,2
Port Adelaide,"Howard, Dougal",11,9,7,2,0,0,0,1
Port Adelaide,"Jonas, Tom",12,11,4,1,0,0,0,2
Port Adelaide,"Motlop, Steven",12,8,1,4,1,0,0,3
Port Adelaide,"Neade, Jake",9,3,2,6,0,0,0,2
Port Adelaide,"Pittard, Jasper",18,11,5,7,0,0,0,3
Port Adelaide,"Polec, Jared",28,13,5,15,1,0,0,1
Port Adelaide,"Powell-Pepper, Sam",28,9,1,19,0,0,0,6
Port Adelaide,"Rockliff, Tom",25,16,5,9,0,1,0,4
Port Adelaide,"Ryder, Paddy",15,6,1,9,0,2,41,3
Port Adelaide,"Watts, Jack",12,3,2,9,0,0,0,1
Port Adelaide,"Westhoff, Justin",23,17,3,6,3,1,10,3
Port Adelaide,"Wines, Ollie",29,18,4,11,0,1,0,12
Port Adelaide,"Wingard, Chad",31,14,5,17,0,0,0,8
Port Adelaide,"Boak, Travis",19,11,6,8,1,1,0,3
Port Adelaide,"Bonner, Riley",14,10,6,4,0,0,0,3
Port Adelaide,"Byrne-Jones, Darcy",10,9,0,1,0,0,0,5
Port Adelaide,"Clurey, Tom",8,4,2,4,0,0,0,2
Port Adelaide,"Dixon, Charlie",11,6,2,5,3,2,4,0
Port Adelaide,"Ebert, Brad",22,7,5,15,0,0,0,4
Port Adelaide,"Gray, Robbie",28,11,4,17,3,1,0,2
Port Adelaide,"Gray, Sam",17,6,3,11,1,1,0,2
Port Adelaide,"Hombsch, Jack",5,4,4,1,0,0,0,2
Port Adelaide,"Houston, Dan",20,15,7,5,1,0,0,0
Port Adelaide,"Howard, Dougal",10,7,6,3,0,0,0,1
Port Adelaide,"Marshall, Todd",8,6,2,2,0,2,0,0
Port Adelaide,"Motlop, Steven",23,12,4,11,1,0,0,7
Port Adelaide,"Pittard, Jasper",11,7,3,4,0,0,0,2
Port Adelaide,"Polec, Jared",19,14,6,5,2,0,0,1
Port Adelaide,"Powell-Pepper, Sam",24,8,1,16,0,0,0,4
Port Adelaide,"Rockliff, Tom",25,17,5,8,3,1,0,6
Port Adelaide,"Ryder, Paddy",14,4,3,10,1,0,41,4
Port Adelaide,"Thomas, Lindsay",14,9,4,5,1,1,0,4
Port Adelaide,"Westhoff, Justin",19,13,7,6,2,1,11,5
Port Adelaide,"Wines, Ollie",35,17,6,18,1,0,0,7
Port Adelaide,"Wingard, Chad",30,24,3,6,0,1,0,8
Port Adelaide,"Boak, Travis",17,7,5,10,1,0,0,8
Port Adelaide,"Bonner, Riley",16,10,4,6,0,0,0,1
Port Adelaide,"Byrne-Jones, Darcy",10,8,4,2,0,0,0,1
Port Adelaide,"Clurey, Tom",10,6,4,4,0,0,0,8
Port Adelaide,"Dixon, Charlie",9,5,3,4,1,1,8,5
Port Adelaide,"Ebert, Brad",18,13,5,5,2,0,0,3
Port Adelaide,"Gray, Robbie",15,5,3,10,2,1,0,3
Port Adelaide,"Gray, Sam",12,4,1,8,1,0,0,2
Port Adelaide,"Houston, Dan",15,12,4,3,0,0,0,6
Port Adelaide,"Howard, Dougal",11,9,5,2,0,0,0,3
Port Adelaide,"Jonas, Tom",20,15,11,5,0,0,0,3
Port Adelaide,"Marshall, Todd",9,5,3,4,0,1,0,3
Port Adelaide,"Motlop, Steven",15,10,5,5,0,0,0,5
Port Adelaide,"Pittard, Jasper",20,13,0,7,0,0,0,2
Port Adelaide,"Polec, Jared",23,15,4,8,0,0,0,5
Port Adelaide,"Powell-Pepper, Sam",15,4,2,11,0,0,0,17
Port Adelaide,"Rockliff, Tom",20,14,4,6,0,0,0,2
Port Adelaide,"Ryder, Paddy",10,6,4,4,0,0,40,2
Port Adelaide,"Thomas, Lindsay",11,7,2,4,1,1,0,5
Port Adelaide,"Westhoff, Justin",12,10,5,2,2,2,9,6
Port Adelaide,"Wines, Ollie",29,16,4,13,0,2,0,5
Port Adelaide,"Wingard, Chad",19,9,1,10,1,0,0,4
Port Adelaide,"Boak, Travis",16,8,4,8,1,1,0,7
Port Adelaide,"Bonner, Riley",18,15,5,3,0,0,0,0
Port Adelaide,"Clurey, Tom",16,11,8,5,0,0,0,2
Port Adelaide,"Dixon, Charlie",11,9,4,2,1,1,7,2
Port Adelaide,"Ebert, Brad",20,15,8,5,0,0,0,2
Port Adelaide,"Gray, Robbie",13,5,2,8,3,0,0,2
Port Adelaide,"Gray, Sam",10,7,2,3,0,2,0,6
Port Adelaide,"Hombsch, Jack",8,3,2,5,0,0,0,2
Port Adelaide,"Houston, Dan",22,17,9,5,0,0,0,2
Port Adelaide,"Howard, Dougal",9,6,5,3,0,0,0,2
Port Adelaide,"Marshall, Todd",5,2,2,3,2,0,0,3
Port Adelaide,"Motlop, Steven",14,10,5,4,1,1,0,4
Port Adelaide,"Pittard, Jasper",11,8,5,3,0,0,0,2
Port Adelaide,"Polec, Jared",20,14,4,6,0,0,0,2
Port Adelaide,"Powell-Pepper, Sam",22,9,2,13,0,1,0,6
Port Adelaide,"Rockliff, Tom",29,16,4,13,0,1,0,3
Port Adelaide,"Ryder, Paddy",14,5,5,9,0,1,28,2
Port Adelaide,"Thomas, Lindsay",16,11,5,5,1,0,0,5
Port Adelaide,"Trengove, Jack",21,13,8,8,0,0,0,4
Port Adelaide,"Westhoff, Justin",19,16,6,3,2,1,7,4
Port Adelaide,"Wines, Ollie",21,11,3,10,0,0,0,7
Port Adelaide,"Wingard, Chad",24,12,1,12,2,1,0,6
Port Adelaide,"Boak, Travis",18,11,5,7,2,1,0,4
Port Adelaide,"Bonner, Riley",16,10,4,6,0,0,0,2
Port Adelaide,"Byrne-Jones, Darcy",26,17,6,9,0,0,0,2
Port Adelaide,"Clurey, Tom",20,13,6,7,0,0,0,0
Port Adelaide,"Dixon, Charlie",16,10,6,6,4,1,3,3
Port Adelaide,"Ebert, Brad",20,15,11,5,0,0,0,1
Port Adelaide,"Gray, Robbie",21,8,5,13,1,4,0,3
Port Adelaide,"Houston, Dan",22,16,8,6,0,0,0,1
Port Adelaide,"Howard, Dougal",8,6,3,2,0,0,0,1
Port Adelaide,"Johnson, Aidyn",8,3,0,5,0,0,0,2
Port Adelaide,"Jonas, Tom",12,7,5,5,0,0,0,1
Port Adelaide,"Motlop, Steven",28,17,7,11,0,0,0,6
Port Adelaide,"Polec, Jared",26,18,8,8,0,1,0,3
Port Adelaide,"Powell-Pepper, Sam",24,11,2,13,0,1,0,7
Port Adelaide,"Rockliff, Tom",30,17,8,13,0,0,0,3
Port Adelaide,"Ryder, Paddy",7,5,1,2,1,0,25,2
Port Adelaide,"Thomas, Lindsay",12,8,0,4,0,1,0,7
Port Adelaide,"Trengove, Jack",16,10,8,6,0,0,0,4
Port Adelaide,"Watts, Jack",17,9,8,8,2,0,1,3
Port Adelaide,"Westhoff, Justin",19,11,7,8,2,2,7,5
Port Adelaide,"Wines, Ollie",18,5,3,13,0,1,0,4
Port Adelaide,"Wingard, Chad",32,14,2,18,0,0,0,5
Port Adelaide,"Amon, Karl",22,9,1,13,0,0,0,4
Port Adelaide,"Boak, Travis",22,12,3,10,1,0,0,4
Port Adelaide,"Bonner, Riley",12,6,0,6,0,0,0,2
Port Adelaide,"Byrne-Jones, Darcy",17,13,6,4,0,0,0,4
Port Adelaide,"Clurey, Tom",12,9,4,3,0,0,0,1
Port Adelaide,"Dixon, Charlie",16,8,3,8,0,0,18,3
Port Adelaide,"Ebert, Brad",16,9,2,7,0,0,0,4
Port Adelaide,"Gray, Robbie",9,2,0,7,0,0,0,1
Port Adelaide,"Gray, Sam",16,7,4,9,1,1,0,2
Port Adelaide,"Hombsch, Jack",11,8,6,3,0,0,0,2
Port Adelaide,"Houston, Dan",19,10,4,9,0,0,0,2
Port Adelaide,"Howard, Dougal",11,8,4,3,0,0,0,0
Port Adelaide,"Motlop, Steven",18,9,0,9,0,0,0,1
Port Adelaide,"Polec, Jared",26,18,7,8,0,1,0,1
Port Adelaide,"Powell-Pepper, Sam",28,12,3,16,1,0,0,2
Port Adelaide,"Rockliff, Tom",25,14,3,11,0,1,0,3
Port Adelaide,"Ryder, Paddy",3,0,1,3,0,0,18,6
Port Adelaide,"Thomas, Lindsay",13,10,3,3,0,0,0,3
Port Adelaide,"Watts, Jack",17,6,7,11,1,1,0,5
Port Adelaide,"Westhoff, Justin",18,11,6,7,1,1,5,4
Port Adelaide,"Wines, Ollie",30,15,4,15,0,1,0,7
Port Adelaide,"Wingard, Chad",24,14,0,10,2,0,0,6
Port Adelaide,"Amon, Karl",11,7,2,4,0,0,0,1
Port Adelaide,"Boak, Travis",24,13,6,11,1,1,0,2
Port Adelaide,"Byrne-Jones, Darcy",19,12,6,7,0,0,0,4
Port Adelaide,"Clurey, Tom",16,11,9,5,0,0,0,3
Port Adelaide,"Dixon, Charlie",11,7,4,4,3,2,10,2
Port Adelaide,"Ebert, Brad",17,9,4,8,1,1,2,4
Port Adelaide,"Gray, Robbie",24,14,4,10,2,0,0,6
Port Adelaide,"Gray, Sam",13,4,2,9,0,0,0,2
Port Adelaide,"Hombsch, Jack",8,7,6,1,0,0,0,4
Port Adelaide,"Houston, Dan",17,12,6,5,0,0,0,6
Port Adelaide,"Howard, Dougal",5,5,3,0,0,0,4,0
Port Adelaide,"Lienert, Jarrod",20,15,5,5,0,0,0,2
Port Adelaide,"Pittard, Jasper",23,17,9,6,0,0,0,3
Port Adelaide,"Polec, Jared",29,22,4,7,0,0,0,3
Port Adelaide,"Powell-Pepper, Sam",11,5,1,6,0,0,0,4
Port Adelaide,"Rockliff, Tom",20,10,6,10,0,0,0,11
Port Adelaide,"Thomas, Lindsay",8,3,2,5,0,2,0,1
Port Adelaide,"Trengove, Jack",10,8,5,2,0,0,0,1
Port Adelaide,"Watts, Jack",10,6,3,4,0,1,0,4
Port Adelaide,"Westhoff, Justin",19,8,4,11,1,0,12,3
Port Adelaide,"Wines, Ollie",29,13,6,16,0,0,2,4
Port Adelaide,"Wingard, Chad",22,12,5,10,0,1,0,2
Port Adelaide,"Boak, Travis",21,16,2,5,0,1,0,7
Port Adelaide,"Bonner, Riley",14,5,1,9,0,0,0,1
Port Adelaide,"Byrne-Jones, Darcy",10,9,3,1,0,1,0,3
Port Adelaide,"Clurey, Tom",8,7,3,1,0,0,0,2
Port Adelaide,"Dixon, Charlie",14,10,5,4,5,2,3,2
Port Adelaide,"Ebert, Brad",20,11,6,9,0,0,0,11
Port Adelaide,"Farrell, Kane",10,5,2,5,1,1,0,3
Port Adelaide,"Gray, Robbie",19,14,2,5,1,1,0,4
Port Adelaide,"Hombsch, Jack",7,3,3,4,0,0,0,1
Port Adelaide,"Houston, Dan",12,10,2,2,0,0,0,1
Port Adelaide,"Jonas, Tom",11,8,3,3,0,0,0,1
Port Adelaide,"Lienert, Jarrod",17,14,5,3,0,0,0,2
Port Adelaide,"Motlop, Steven",12,10,1,2,1,0,0,1
Port Adelaide,"Pittard, Jasper",14,11,6,3,0,0,0,5
Port Adelaide,"Polec, Jared",32,22,1,10,0,1,0,2
Port Adelaide,"Powell-Pepper, Sam",14,5,2,9,0,1,0,6
Port Adelaide,"Rockliff, Tom",21,16,1,5,0,0,0,10
Port Adelaide,"Ryder, Paddy",5,1,1,4,0,0,33,4
Port Adelaide,"Watts, Jack",15,5,3,10,1,0,0,3
Port Adelaide,"Westhoff, Justin",17,11,4,6,1,1,11,4
Port Adelaide,"Wines, Ollie",26,13,3,13,0,0,0,7
Port Adelaide,"Wingard, Chad",25,16,2,9,1,2,0,6
Port Adelaide,"Boak, Travis",20,8,3,12,2,0,0,2
Port Adelaide,"Bonner, Riley",15,10,3,5,0,0,0,2
Port Adelaide,"Byrne-Jones, Darcy",7,5,0,2,1,1,0,3
Port Adelaide,"Clurey, Tom",12,11,6,1,0,0,0,3
Port Adelaide,"Dixon, Charlie",10,6,4,4,0,1,5,1
Port Adelaide,"Ebert, Brad",20,5,3,15,0,1,0,4
Port Adelaide,"Farrell, Kane",13,11,2,2,3,0,0,3
Port Adelaide,"Gray, Robbie",20,13,5,7,4,0,0,0
Port Adelaide,"Hombsch, Jack",8,5,3,3,0,0,0,1
Port Adelaide,"Houston, Dan",21,11,8,10,0,0,0,3
Port Adelaide,"Jonas, Tom",11,7,5,4,0,0,0,1
Port Adelaide,"Lienert, Jarrod",18,13,8,5,0,0,0,1
Port Adelaide,"Motlop, Steven",14,8,2,6,0,0,0,3
Port Adelaide,"Pittard, Jasper",15,12,4,3,0,0,0,5
Port Adelaide,"Polec, Jared",24,20,3,4,0,0,0,1
Port Adelaide,"Powell-Pepper, Sam",11,7,3,4,0,2,0,4
Port Adelaide,"Rockliff, Tom",20,14,2,6,0,0,0,3
Port Adelaide,"Ryder, Paddy",7,4,3,3,0,0,40,1
Port Adelaide,"Watts, Jack",10,3,3,7,0,0,0,0
Port Adelaide,"Westhoff, Justin",18,13,6,5,0,1,6,4
Port Adelaide,"Wines, Ollie",17,11,2,6,0,0,1,4
Port Adelaide,"Wingard, Chad",16,11,3,5,4,0,0,3
Port Adelaide,"Boak, Travis",18,11,5,7,0,0,0,5
Port Adelaide,"Byrne-Jones, Darcy",23,12,5,11,0,0,0,2
Port Adelaide,"Clurey, Tom",17,13,7,4,0,0,0,3
Port Adelaide,"Dixon, Charlie",8,6,3,2,1,0,3,4
Port Adelaide,"Ebert, Brad",25,8,4,17,0,1,0,6
Port Adelaide,"Farrell, Kane",8,6,4,2,1,0,0,2
Port Adelaide,"Gray, Robbie",18,10,8,8,2,3,0,3
Port Adelaide,"Gray, Sam",14,8,7,6,0,0,0,2
Port Adelaide,"Houston, Dan",11,9,2,2,0,0,0,1
Port Adelaide,"Howard, Dougal",16,14,6,2,0,0,0,1
Port Adelaide,"Johnson, Aidyn",7,3,0,4,3,0,0,1
Port Adelaide,"Jonas, Tom",30,19,13,11,0,0,0,0
Port Adelaide,"Lienert, Jarrod",18,10,7,8,0,0,0,2
Port Adelaide,"Motlop, Steven",17,12,5,5,0,0,0,2
Port Adelaide,"Pittard, Jasper",25,18,12,7,0,0,0,1
Port Adelaide,"Polec, Jared",24,16,4,8,0,0,0,1
Port Adelaide,"Rockliff, Tom",23,9,6,14,0,0,0,3
Port Adelaide,"Ryder, Paddy",9,5,3,4,1,0,10,1
Port Adelaide,"Watts, Jack",16,8,8,8,0,0,0,4
Port Adelaide,"Westhoff, Justin",20,12,3,8,0,0,6,9
Port Adelaide,"Wines, Ollie",27,15,7,12,0,0,0,4
Port Adelaide,"Wingard, Chad",18,11,4,7,1,0,0,5
Port Adelaide,"Boak, Travis",27,8,5,19,2,0,0,4
Port Adelaide,"Bonner, Riley",11,9,6,2,0,0,0,0
Port Adelaide,"Byrne-Jones, Darcy",8,7,1,1,0,0,0,1
Port Adelaide,"Ebert, Brad",21,12,6,9,0,0,0,7
Port Adelaide,"Farrell, Kane",6,5,1,1,0,1,0,2
Port Adelaide,"Gray, Robbie",19,7,3,12,1,1,0,0
Port Adelaide,"Gray, Sam",17,7,2,10,1,0,0,3
Port Adelaide,"Hombsch, Jack",10,8,5,2,0,0,0,1
Port Adelaide,"Houston, Dan",19,13,7,6,0,0,0,4
Port Adelaide,"Howard, Dougal",14,13,10,1,0,0,0,0
Port Adelaide,"Johnson, Aidyn",4,2,1,2,0,0,0,4
Port Adelaide,"Jonas, Tom",12,7,4,5,0,0,0,3
Port Adelaide,"Lienert, Jarrod",17,12,9,5,0,0,0,3
Port Adelaide,"Motlop, Steven",28,16,2,12,0,0,0,4
Port Adelaide,"Pittard, Jasper",13,11,5,2,0,0,0,3
Port Adelaide,"Polec, Jared",21,12,3,9,1,0,0,1
Port Adelaide,"Rockliff, Tom",17,8,4,9,0,0,0,5
Port Adelaide,"Ryder, Paddy",10,6,4,4,3,0,16,2
Port Adelaide,"Watts, Jack",13,6,6,7,1,0,0,1
Port Adelaide,"Westhoff, Justin",22,14,4,8,1,0,9,10
Port Adelaide,"Wines, Ollie",29,9,3,20,0,0,0,5
Port Adelaide,"Wingard, Chad",18,10,2,8,0,1,0,5
Port Adelaide,"Boak, Travis",25,11,1,14,1,2,0,4
Port Adelaide,"Byrne-Jones, Darcy",11,7,2,4,0,0,0,3
Port Adelaide,"Ebert, Brad",18,8,4,10,2,0,0,6
Port Adelaide,"Farrell, Kane",11,8,6,3,1,0,0,0
Port Adelaide,"Frampton, Billy",7,6,5,1,1,2,15,0
Port Adelaide,"Gray, Robbie",19,8,2,11,1,0,0,0
Port Adelaide,"Gray, Sam",17,4,2,13,0,1,0,2
Port Adelaide,"Hombsch, Jack",4,4,2,0,0,0,0,2
Port Adelaide,"Houston, Dan",14,7,4,7,0,0,0,2
Port Adelaide,"Howard, Dougal",10,6,4,4,0,0,0,1
Port Adelaide,"Jonas, Tom",16,9,7,7,0,0,0,1
Port Adelaide,"Lienert, Jarrod",14,11,4,3,0,0,0,2
Port Adelaide,"Motlop, Steven",19,10,2,9,0,0,0,3
Port Adelaide,"Neade, Jake",8,5,1,3,0,2,0,1
Port Adelaide,"Pittard, Jasper",20,14,5,6,0,0,0,4
Port Adelaide,"Polec, Jared",30,18,4,12,1,2,0,4
Port Adelaide,"Powell-Pepper, Sam",13,7,2,6,0,0,0,5
Port Adelaide,"Ryder, Paddy",16,12,8,4,1,1,46,0
Port Adelaide,"Watts, Jack",17,7,2,10,0,0,0,1
Port Adelaide,"Westhoff, Justin",20,13,8,7,5,0,5,2
Port Adelaide,"Wines, Ollie",24,8,0,16,0,1,0,4
Port Adelaide,"Wingard, Chad",32,12,2,20,0,0,0,3
Richmond,"Astbury, David",16,9,7,7,0,0,0,2
Richmond,"Bolton, Shai",6,3,2,3,0,0,1,0
Richmond,"Butler, Dan",13,10,2,3,3,0,0,7
Richmond,"Caddy, Josh",19,13,5,6,3,2,0,2
Richmond,"Castagna, Jason",15,7,4,8,2,1,0,4
Richmond,"Conca, Reece",16,9,0,7,0,0,0,7
Richmond,"Cotchin, Trent",24,14,2,10,0,0,0,4
Richmond,"Edwards, Shane",16,5,3,11,0,0,0,4
Richmond,"Ellis, Brandon",18,11,3,7,0,1,0,3
Richmond,"Ellis, Corey",12,6,2,6,0,0,0,4
Richmond,"Graham, Jack",13,7,0,6,0,1,0,13
Richmond,"Grigg, Shaun",17,7,4,10,0,1,0,2
Richmond,"Grimes, Dylan",6,4,1,2,0,0,0,2
Richmond,"Lambert, Kane",14,7,1,7,0,0,0,2
Richmond,"Martin, Dustin",32,20,5,12,1,3,0,1
Richmond,"McIntosh, Kamdyn",19,19,5,0,0,1,0,1
Richmond,"Nankervis, Toby",14,7,2,7,0,0,33,5
Richmond,"Rance, Alex",15,9,3,6,0,0,0,1
Richmond,"Riewoldt, Jack",18,12,7,6,4,2,0,1
Richmond,"Short, Jayden",16,12,2,4,0,1,0,1
Richmond,"Townsend, Jacob",9,6,5,3,4,2,0,1
Richmond,"Vlastuin, Nick",12,10,3,2,0,0,0,3
Richmond,"Astbury, David",16,11,6,5,0,0,0,0
Richmond,"Bolton, Shai",10,6,2,4,1,1,0,3
Richmond,"Butler, Dan",11,9,2,2,0,1,0,5
Richmond,"Caddy, Josh",17,11,3,6,3,0,0,4
Richmond,"Castagna, Jason",7,4,3,3,0,1,0,1
Richmond,"Conca, Reece",14,8,1,6,0,1,0,2
Richmond,"Cotchin, Trent",17,9,1,8,0,0,0,9
Richmond,"Edwards, Shane",19,8,0,11,1,1,0,6
Richmond,"Ellis, Brandon",16,13,0,3,0,0,0,1
Richmond,"Ellis, Corey",11,3,2,8,0,0,0,1
Richmond,"Graham, Jack",9,8,1,1,0,0,0,6
Richmond,"Grigg, Shaun",15,10,4,5,0,0,0,1
Richmond,"Grimes, Dylan",9,3,0,6,0,0,0,3
Richmond,"Houli, Bachar",17,9,2,8,0,0,0,0
Richmond,"Lambert, Kane",15,4,3,11,1,1,0,3
Richmond,"Martin, Dustin",25,19,3,6,5,0,0,5
Richmond,"McIntosh, Kamdyn",9,7,0,2,0,0,0,2
Richmond,"Nankervis, Toby",18,7,3,11,0,0,25,8
Richmond,"Rance, Alex",19,8,7,11,0,0,0,2
Richmond,"Riewoldt, Jack",13,10,5,3,0,1,1,2
Richmond,"Short, Jayden",17,13,3,4,0,1,0,4
Richmond,"Townsend, Jacob",5,3,1,2,1,0,0,3
Richmond,"Astbury, David",15,10,8,5,0,0,0,1
Richmond,"Butler, Dan",12,8,5,4,1,3,0,2
Richmond,"Castagna, Jason",12,7,4,5,3,0,0,6
Richmond,"Conca, Reece",24,12,1,12,0,0,0,4
Richmond,"Cotchin, Trent",31,13,1,18,0,0,0,6
Richmond,"Edwards, Shane",20,7,4,13,1,0,0,1
Richmond,"Ellis, Brandon",21,11,6,10,0,0,0,1
Richmond,"Graham, Jack",13,7,4,6,0,0,0,4
Richmond,"Grigg, Shaun",21,9,3,12,1,0,2,2
Richmond,"Grimes, Dylan",13,8,2,5,0,0,0,5
Richmond,"Higgins, Jack",12,4,2,8,2,1,0,1
Richmond,"Houli, Bachar",26,16,11,10,0,0,0,1
Richmond,"Lambert, Kane",20,7,3,13,0,0,0,3
Richmond,"Lloyd, Sam",17,8,1,9,1,0,0,1
Richmond,"Martin, Dustin",21,11,3,10,0,1,0,1
Richmond,"McIntosh, Kamdyn",15,14,7,1,1,0,0,1
Richmond,"Nankervis, Toby",15,10,6,5,1,0,27,1
Richmond,"Rance, Alex",19,9,10,10,0,0,0,3
Richmond,"Riewoldt, Jack",13,9,5,4,4,0,1,3
Richmond,"Short, Jayden",21,14,6,7,0,0,0,1
Richmond,"Townsend, Jacob",9,4,0,5,0,2,0,0
Richmond,"Vlastuin, Nick",21,17,10,4,0,0,0,2
Richmond,"Astbury, David",20,13,6,7,0,0,0,1
Richmond,"Butler, Dan",13,5,1,8,0,0,0,0
Richmond,"Caddy, Josh",16,6,2,10,1,0,0,2
Richmond,"Castagna, Jason",15,10,5,5,3,2,0,6
Richmond,"Conca, Reece",26,12,3,14,0,1,0,6
Richmond,"Cotchin, Trent",26,11,7,15,0,0,0,4
Richmond,"Edwards, Shane",15,2,0,13,0,0,0,1
Richmond,"Ellis, Brandon",18,9,6,9,0,1,0,1
Richmond,"Graham, Jack",17,10,1,7,0,0,0,2
Richmond,"Grigg, Shaun",26,10,4,16,0,0,0,3
Richmond,"Grimes, Dylan",9,6,1,3,0,0,0,5
Richmond,"Houli, Bachar",22,8,2,14,0,0,0,4
Richmond,"Lambert, Kane",24,9,4,15,2,1,0,3
Richmond,"Martin, Dustin",17,14,6,3,6,0,0,1
Richmond,"McIntosh, Kamdyn",16,11,4,5,0,0,0,2
Richmond,"Nankervis, Toby",19,8,3,11,0,0,17,2
Richmond,"Prestia, Dion",23,12,0,11,0,0,0,4
Richmond,"Rance, Alex",14,5,3,9,0,0,0,0
Richmond,"Riewoldt, Jack",13,11,6,2,1,2,0,4
Richmond,"Short, Jayden",22,14,6,8,0,0,0,2
Richmond,"Townsend, Jacob",11,6,5,5,3,0,0,2
Richmond,"Vlastuin, Nick",15,9,5,6,0,0,0,2
Richmond,"Astbury, David",20,14,7,6,0,0,0,1
Richmond,"Broad, Nathan",9,6,5,3,0,0,0,4
Richmond,"Butler, Dan",12,8,2,4,0,0,0,3
Richmond,"Castagna, Jason",16,9,6,7,2,2,0,2
Richmond,"Conca, Reece",21,12,1,9,0,0,0,9
Richmond,"Cotchin, Trent",15,5,2,10,1,0,1,7
Richmond,"Edwards, Shane",26,15,1,11,0,0,0,2
Richmond,"Ellis, Brandon",16,5,4,11,0,0,0,4
Richmond,"Grigg, Shaun",22,12,3,10,0,0,3,4
Richmond,"Grimes, Dylan",10,5,0,5,0,0,0,1
Richmond,"Higgins, Jack",14,7,2,7,3,1,0,6
Richmond,"Houli, Bachar",26,18,5,8,0,1,0,2
Richmond,"Lambert, Kane",29,11,2,18,2,1,0,8
Richmond,"Lloyd, Sam",13,10,1,3,2,0,0,1
Richmond,"Martin, Dustin",26,12,2,14,0,1,0,1
Richmond,"McIntosh, Kamdyn",10,8,2,2,2,1,0,2
Richmond,"Nankervis, Toby",14,7,0,7,0,0,19,3
Richmond,"Prestia, Dion",17,10,1,7,1,0,0,6
Richmond,"Rance, Alex",19,10,8,9,0,0,0,1
Richmond,"Riewoldt, Jack",12,8,4,4,2,2,0,5
Richmond,"Short, Jayden",20,15,1,5,0,0,0,1
Richmond,"Townsend, Jacob",7,5,2,2,0,1,0,5
Richmond,"Astbury, David",9,5,4,4,0,0,0,0
Richmond,"Broad, Nathan",15,5,3,10,0,0,0,2
Richmond,"Butler, Dan",15,10,2,5,3,1,0,3
Richmond,"Caddy, Josh",21,11,2,10,4,2,0,5
Richmond,"Castagna, Jason",10,6,3,4,2,1,0,1
Richmond,"Conca, Reece",11,3,1,8,0,0,0,4
Richmond,"Cotchin, Trent",29,12,2,17,0,1,0,1
Richmond,"Edwards, Shane",17,7,1,10,0,0,0,3
Richmond,"Graham, Jack",11,3,0,8,0,1,0,5
Richmond,"Grigg, Shaun",17,10,5,7,0,0,0,5
Richmond,"Grimes, Dylan",9,6,2,3,0,0,0,0
Richmond,"Higgins, Jack",13,6,1,7,2,0,0,2
Richmond,"Houli, Bachar",21,10,5,11,0,2,0,3
Richmond,"Lambert, Kane",24,9,6,15,0,1,0,1
Richmond,"Martin, Dustin",28,18,3,10,1,0,0,2
Richmond,"McIntosh, Kamdyn",6,3,1,3,0,0,0,2
Richmond,"Nankervis, Toby",29,19,10,10,0,1,17,2
Richmond,"Prestia, Dion",25,11,5,14,0,0,0,0
Richmond,"Rance, Alex",15,6,5,9,0,0,0,0
Richmond,"Riewoldt, Jack",20,14,7,6,3,3,0,3
Richmond,"Short, Jayden",20,17,4,3,1,0,0,1
Richmond,"Vlastuin, Nick",15,11,3,4,0,0,0,2
Richmond,"Astbury, David",20,14,14,6,0,0,0,0
Richmond,"Broad, Nathan",12,10,2,2,0,0,0,0
Richmond,"Butler, Dan",11,5,2,6,0,0,0,2
Richmond,"Caddy, Josh",22,12,8,10,1,1,2,1
Richmond,"Castagna, Jason",13,6,5,7,1,2,0,2
Richmond,"Conca, Reece",20,9,1,11,1,0,0,7
Richmond,"Edwards, Shane",20,7,3,13,0,0,0,6
Richmond,"Graham, Jack",24,13,5,11,1,0,0,7
Richmond,"Grimes, Dylan",15,13,6,2,0,0,0,2
Richmond,"Higgins, Jack",13,6,2,7,1,2,0,3
Richmond,"Houli, Bachar",22,12,5,10,1,1,0,3
Richmond,"Lambert, Kane",25,12,6,13,2,0,0,3
Richmond,"Lloyd, Sam",18,15,1,3,1,1,0,4
Richmond,"Martin, Dustin",26,11,6,15,0,4,0,4
Richmond,"McIntosh, Kamdyn",21,13,4,8,1,0,0,5
Richmond,"Nankervis, Toby",21,12,5,9,0,0,14,3
Richmond,"Prestia, Dion",19,12,5,7,0,0,0,1
Richmond,"Rance, Alex",20,6,8,14,0,0,0,3
Richmond,"Riewoldt, Jack",13,8,6,5,3,1,0,6
Richmond,"Short, Jayden",16,11,1,5,0,1,0,2
Richmond,"Townsend, Jacob",15,7,7,8,2,1,0,4
Richmond,"Vlastuin, Nick",17,8,4,9,0,0,0,1
Richmond,"Astbury, David",15,10,5,5,0,0,0,2
Richmond,"Broad, Nathan",9,6,2,3,0,0,0,3
Richmond,"Butler, Dan",10,5,4,5,1,0,0,3
Richmond,"Caddy, Josh",21,11,5,10,4,0,3,2
Richmond,"Castagna, Jason",6,2,1,4,1,0,0,4
Richmond,"Conca, Reece",21,14,4,7,0,0,0,6
Richmond,"Cotchin, Trent",37,14,3,23,1,1,1,3
Richmond,"Edwards, Shane",17,9,1,8,0,1,0,1
Richmond,"Graham, Jack",18,14,5,4,0,0,0,6
Richmond,"Grimes, Dylan",7,5,2,2,0,0,0,6
Richmond,"Higgins, Jack",14,8,4,6,0,2,0,3
Richmond,"Houli, Bachar",27,15,8,12,0,1,0,3
Richmond,"Lambert, Kane",21,7,2,14,3,1,0,3
Richmond,"Lloyd, Sam",24,14,6,10,0,0,0,4
Richmond,"Martin, Dustin",16,11,2,5,0,0,0,1
Richmond,"McIntosh, Kamdyn",14,9,7,5,0,0,0,2
Richmond,"Nankervis, Toby",18,10,6,8,0,0,26,7
Richmond,"Rance, Alex",20,13,7,7,0,0,0,0
Richmond,"Riewoldt, Jack",14,10,5,4,2,0,0,6
Richmond,"Short, Jayden",16,10,3,6,0,1,0,1
Richmond,"Townsend, Jacob",11,7,2,4,0,0,0,7
Richmond,"Vlastuin, Nick",26,16,12,10,0,0,0,8
Richmond,"Astbury, David",7,4,3,3,0,0,0,0
Richmond,"Broad, Nathan",5,3,1,2,0,0,1,1
Richmond,"Butler, Dan",10,7,0,3,0,0,0,3
Richmond,"Caddy, Josh",16,13,4,3,1,0,0,6
Richmond,"Castagna, Jason",8,5,2,3,1,1,0,3
Richmond,"Conca, Reece",15,11,3,4,1,0,0,2
Richmond,"Cotchin, Trent",14,6,1,8,0,1,0,7
Richmond,"Edwards, Shane",18,6,1,12,1,0,0,0
Richmond,"Graham, Jack",12,5,1,7,0,0,0,2
Richmond,"Grigg, Shaun",17,11,4,6,0,2,0,3
Richmond,"Grimes, Dylan",7,4,3,3,0,0,0,1
Richmond,"Houli, Bachar",17,10,4,7,1,0,0,0
Richmond,"Lambert, Kane",19,7,2,12,0,0,0,1
Richmond,"Lloyd, Sam",17,9,5,8,0,0,0,0
Richmond,"Martin, Dustin",26,14,4,12,0,1,0,0
Richmond,"McIntosh, Kamdyn",10,7,3,3,0,0,0,0
Richmond,"Nankervis, Toby",15,7,5,8,0,0,21,2
Richmond,"Rance, Alex",17,10,4,7,0,0,0,0
Richmond,"Riewoldt, Jack",13,11,7,2,5,2,1,3
Richmond,"Short, Jayden",14,10,3,4,2,0,0,2
Richmond,"Townsend, Jacob",8,6,0,2,0,1,0,3
Richmond,"Vlastuin, Nick",11,4,4,7,0,0,0,3
Richmond,"Astbury, David",16,9,7,7,0,0,0,0
Richmond,"Broad, Nathan",13,11,6,2,0,0,0,1
Richmond,"Butler, Dan",17,13,7,4,3,2,0,3
Richmond,"Caddy, Josh",24,11,6,13,6,1,0,7
Richmond,"Conca, Reece",21,12,2,9,0,0,0,3
Richmond,"Cotchin, Trent",32,20,2,12,1,2,0,2
Richmond,"Edwards, Shane",16,5,2,11,0,0,0,6
Richmond,"Ellis, Brandon",20,16,6,4,0,1,0,2
Richmond,"Graham, Jack",7,4,2,3,0,0,0,4
Richmond,"Grigg, Shaun",22,10,4,12,0,1,0,4
Richmond,"Higgins, Jack",15,9,5,6,0,2,0,2
Richmond,"Houli, Bachar",4,2,0,2,0,0,0,0
Richmond,"Lambert, Kane",19,6,5,13,0,0,0,1
Richmond,"Martin, Dustin",26,14,0,12,2,1,0,1
Richmond,"McIntosh, Kamdyn",19,11,4,8,0,0,0,1
Richmond,"Menadue, Connor",10,6,3,4,0,0,0,1
Richmond,"Moore, Callum",14,7,6,7,0,3,0,1
Richmond,"Nankervis, Toby",19,13,7,6,0,0,25,3
Richmond,"Rance, Alex",14,9,8,5,0,0,0,0
Richmond,"Riewoldt, Jack",0,0,0,0,0,0,0,0
Richmond,"Short, Jayden",21,17,9,4,0,0,0,1
Richmond,"Vlastuin, Nick",16,12,9,4,3,0,0,0
Richmond,"Astbury, David",12,8,4,4,0,0,0,0
Richmond,"Broad, Nathan",8,4,2,4,0,0,0,6
Richmond,"Butler, Dan",11,7,1,4,2,0,0,6
Richmond,"Caddy, Josh",15,9,4,6,4,0,0,3
Richmond,"Conca, Reece",26,14,5,12,0,1,0,7
Richmond,"Cotchin, Trent",17,13,5,4,0,2,0,6
Richmond,"Edwards, Shane",31,18,5,13,2,0,0,1
Richmond,"Ellis, Brandon",25,14,5,11,1,0,0,1
Richmond,"Graham, Jack",13,9,1,4,1,0,0,7
Richmond,"Grigg, Shaun",24,12,9,12,0,0,1,1
Richmond,"Grimes, Dylan",15,8,3,7,0,0,0,4
Richmond,"Higgins, Jack",14,5,2,9,0,1,0,1
Richmond,"Lambert, Kane",8,4,1,4,0,1,0,2
Richmond,"Martin, Dustin",28,17,5,11,1,1,0,0
Richmond,"McIntosh, Kamdyn",8,3,1,5,0,0,0,0
Richmond,"Menadue, Connor",14,10,4,4,1,1,0,2
Richmond,"Moore, Callum",11,9,6,2,2,3,0,2
Richmond,"Nankervis, Toby",13,9,4,4,2,0,17,5
Richmond,"Rance, Alex",18,10,9,8,0,0,0,1
Richmond,"Riewoldt, Jack",10,7,2,3,1,0,0,1
Richmond,"Short, Jayden",28,22,6,6,0,0,0,2
Richmond,"Vlastuin, Nick",17,11,8,6,0,0,0,2
Richmond,"Astbury, David",14,10,5,4,0,0,0,0
Richmond,"Broad, Nathan",8,5,3,3,0,0,0,3
Richmond,"Butler, Dan",9,5,0,4,0,1,0,5
Richmond,"Caddy, Josh",11,8,0,3,0,2,3,4
Richmond,"Castagna, Jason",8,6,2,2,2,2,0,5
Richmond,"Conca, Reece",22,14,5,8,0,0,0,9
Richmond,"Cotchin, Trent",20,11,0,9,0,1,0,4
Richmond,"Edwards, Shane",15,5,1,10,2,0,0,1
Richmond,"Ellis, Brandon",17,10,3,7,0,0,0,5
Richmond,"Grigg, Shaun",24,13,4,11,0,0,0,1
Richmond,"Grimes, Dylan",13,6,2,7,0,0,0,6
Richmond,"Higgins, Jack",16,8,2,8,0,0,0,4
Richmond,"Lambert, Kane",26,10,3,16,0,0,0,4
Richmond,"McIntosh, Kamdyn",9,7,3,2,0,1,0,2
Richmond,"Menadue, Connor",8,5,4,3,0,0,0,2
Richmond,"Miles, Anthony",20,13,3,7,1,0,0,3
Richmond,"Moore, Callum",8,2,1,6,0,0,3,2
Richmond,"Nankervis, Toby",11,5,1,6,0,1,27,1
Richmond,"Rance, Alex",17,10,6,7,0,0,0,2
Richmond,"Riewoldt, Jack",11,8,5,3,3,0,1,4
Richmond,"Short, Jayden",25,22,3,3,0,1,0,4
Richmond,"Vlastuin, Nick",17,10,6,7,0,0,0,3
Richmond,"Broad, Nathan",16,13,3,3,0,0,0,3
Richmond,"Butler, Dan",14,9,2,5,2,1,0,3
Richmond,"Caddy, Josh",14,7,2,7,1,0,0,3
Richmond,"Castagna, Jason",8,4,3,4,2,1,0,4
Richmond,"Conca, Reece",22,14,4,8,0,0,0,6
Richmond,"Cotchin, Trent",18,13,4,5,0,0,1,5
Richmond,"Edwards, Shane",21,7,1,14,0,2,0,3
Richmond,"Ellis, Brandon",17,13,8,4,0,0,0,0
Richmond,"Garthwaite, Ryan",9,6,3,3,0,0,0,4
Richmond,"Graham, Jack",11,3,0,8,0,0,0,13
Richmond,"Grigg, Shaun",20,16,2,4,1,0,4,0
Richmond,"Grimes, Dylan",15,8,4,7,0,0,0,4
Richmond,"Higgins, Jack",16,6,5,10,0,0,0,1
Richmond,"Lambert, Kane",24,13,4,11,1,0,0,3
Richmond,"Martin, Dustin",22,14,1,8,1,1,0,5
Richmond,"McIntosh, Kamdyn",9,3,1,6,0,0,0,3
Richmond,"Nankervis, Toby",11,5,1,6,1,0,29,2
Richmond,"Rance, Alex",17,11,9,6,0,0,0,4
Richmond,"Riewoldt, Jack",13,9,3,4,2,1,1,3
Richmond,"Rioli, Daniel",12,9,2,3,1,2,0,8
Richmond,"Short, Jayden",17,14,6,3,0,0,0,2
Richmond,"Vlastuin, Nick",21,17,11,4,0,1,0,3
Richmond,"Astbury, David",20,9,5,11,0,0,0,2
Richmond,"Broad, Nathan",11,5,4,6,0,0,0,2
Richmond,"Butler, Dan",7,6,3,1,2,0,0,2
Richmond,"Caddy, Josh",15,8,2,7,1,1,0,3
Richmond,"Castagna, Jason",6,3,2,3,0,0,0,1
Richmond,"Conca, Reece",1,1,0,0,0,0,0,1
Richmond,"Cotchin, Trent",27,14,3,13,0,2,0,2
Richmond,"Edwards, Shane",24,8,5,16,1,0,0,2
Richmond,"Ellis, Brandon",15,10,5,5,0,0,0,0
Richmond,"Graham, Jack",16,14,3,2,0,0,0,5
Richmond,"Grigg, Shaun",24,17,7,7,0,0,3,3
Richmond,"Grimes, Dylan",13,9,4,4,0,0,0,8
Richmond,"Higgins, Jack",20,10,7,10,0,0,0,2
Richmond,"Lambert, Kane",27,16,7,11,3,0,0,1
Richmond,"Martin, Dustin",21,17,6,4,0,1,0,4
Richmond,"Nankervis, Toby",18,6,4,12,0,0,41,10
Richmond,"Prestia, Dion",24,13,6,11,0,0,0,4
Richmond,"Rance, Alex",13,7,5,6,0,0,0,1
Richmond,"Riewoldt, Jack",23,15,16,8,3,2,1,1
Richmond,"Rioli, Daniel",8,4,0,4,1,0,0,6
Richmond,"Short, Jayden",20,15,5,5,2,0,0,3
Richmond,"Vlastuin, Nick",21,14,10,7,1,0,0,6
Richmond,"Astbury, David",18,7,6,11,0,0,0,2
Richmond,"Broad, Nathan",19,11,4,8,0,0,0,2
Richmond,"Butler, Dan",7,4,1,3,1,1,0,3
Richmond,"Caddy, Josh",19,10,3,9,2,0,0,0
Richmond,"Castagna, Jason",15,5,2,10,0,2,0,1
Richmond,"Cotchin, Trent",27,18,5,9,0,1,0,3
Richmond,"Edwards, Shane",28,15,2,13,2,0,0,0
Richmond,"Ellis, Brandon",27,15,5,12,0,0,0,4
Richmond,"Ellis, Corey",13,3,3,10,0,0,0,1
Richmond,"Graham, Jack",17,7,1,10,0,0,0,7
Richmond,"Grigg, Shaun",28,11,7,17,0,0,1,5
Richmond,"Grimes, Dylan",16,6,5,10,0,0,0,5
Richmond,"Higgins, Jack",25,10,5,15,0,0,0,2
Richmond,"Lambert, Kane",33,17,5,16,0,2,0,1
Richmond,"Martin, Dustin",30,16,6,14,2,2,0,3
Richmond,"Moore, Callum",13,8,5,5,2,2,0,4
Richmond,"Nankervis, Toby",16,7,4,9,0,0,31,3
Richmond,"Prestia, Dion",28,14,0,14,1,0,0,5
Richmond,"Rance, Alex",15,7,3,8,0,0,0,1
Richmond,"Riewoldt, Jack",18,13,7,5,2,1,0,3
Richmond,"Rioli, Daniel",12,11,5,1,2,0,0,4
Richmond,"Short, Jayden",25,20,9,5,1,0,0,2
Richmond,"Astbury, David",18,8,5,10,0,0,0,3
Richmond,"Bolton, Shai",9,2,2,7,0,0,0,1
Richmond,"Caddy, Josh",10,8,4,2,1,0,0,3
Richmond,"Castagna, Jason",14,9,3,5,0,5,0,2
Richmond,"Cotchin, Trent",18,10,1,8,0,1,0,1
Richmond,"Edwards, Shane",17,9,4,8,0,1,0,2
Richmond,"Ellis, Brandon",30,14,7,16,0,0,0,2
Richmond,"Ellis, Corey",10,3,2,7,0,1,0,5
Richmond,"Grigg, Shaun",17,10,5,7,0,0,0,3
Richmond,"Grimes, Dylan",15,11,8,4,0,0,0,3
Richmond,"Higgins, Jack",14,8,1,6,0,0,0,2
Richmond,"Houli, Bachar",21,8,2,13,0,0,0,5
Richmond,"Lambert, Kane",28,7,1,21,0,0,0,4
Richmond,"Martin, Dustin",29,22,2,7,1,0,0,0
Richmond,"Moore, Callum",5,5,2,0,0,1,0,3
Richmond,"Nankervis, Toby",9,6,2,3,1,0,25,3
Richmond,"Prestia, Dion",29,15,2,14,1,1,0,1
Richmond,"Rance, Alex",17,6,6,11,0,0,0,1
Richmond,"Riewoldt, Jack",15,12,8,3,2,2,1,2
Richmond,"Rioli, Daniel",18,10,2,8,3,1,1,2
Richmond,"Short, Jayden",23,17,5,6,1,0,0,0
Richmond,"Vlastuin, Nick",18,10,7,8,0,0,0,2
Richmond,"Astbury, David",14,8,9,6,0,0,0,1
Richmond,"Broad, Nathan",14,11,6,3,0,0,0,2
Richmond,"Caddy, Josh",16,11,3,5,2,0,0,2
Richmond,"Castagna, Jason",8,4,1,4,0,1,0,1
Richmond,"Cotchin, Trent",17,5,2,12,1,0,0,4
Richmond,"Edwards, Shane",19,7,1,12,1,0,0,3
Richmond,"Ellis, Brandon",16,10,6,6,0,1,0,2
Richmond,"Grigg, Shaun",21,6,6,15,1,0,0,2
Richmond,"Grimes, Dylan",11,5,4,6,0,0,0,6
Richmond,"Higgins, Jack",18,7,4,11,1,1,0,4
Richmond,"Lambert, Kane",23,11,6,12,1,1,0,3
Richmond,"Martin, Dustin",30,20,2,10,1,0,0,1
Richmond,"McIntosh, Kamdyn",14,7,5,7,0,0,0,1
Richmond,"Menadue, Connor",10,7,4,3,0,2,0,2
Richmond,"Moore, Callum",10,4,2,6,0,0,0,2
Richmond,"Nankervis, Toby",18,9,3,9,0,0,27,4
Richmond,"Prestia, Dion",26,14,5,12,3,1,0,2
Richmond,"Rance, Alex",10,4,3,6,0,0,0,5
Richmond,"Riewoldt, Jack",13,11,7,2,4,1,0,0
Richmond,"Rioli, Daniel",12,7,5,5,1,1,0,3
Richmond,"Short, Jayden",26,19,6,7,0,1,0,2
Richmond,"Vlastuin, Nick",15,9,6,6,0,1,0,2
Richmond,"Astbury, David",21,7,7,14,0,0,0,1
Richmond,"Baker, Liam",12,3,1,9,0,2,0,1
Richmond,"Broad, Nathan",18,10,6,8,0,0,0,3
Richmond,"Caddy, Josh",13,7,2,6,1,0,0,4
Richmond,"Castagna, Jason",12,7,5,5,2,0,0,3
Richmond,"Cotchin, Trent",17,8,2,9,0,0,0,4
Richmond,"Edwards, Shane",22,10,4,12,1,0,0,5
Richmond,"Ellis, Brandon",22,12,6,10,0,0,0,0
Richmond,"Grigg, Shaun",17,8,3,9,0,0,0,3
Richmond,"Grimes, Dylan",13,6,5,7,0,0,0,1
Richmond,"Higgins, Jack",20,7,1,13,2,0,0,1
Richmond,"Lambert, Kane",16,7,3,9,0,0,0,6
Richmond,"Martin, Dustin",19,13,4,6,3,1,0,0
Richmond,"McIntosh, Kamdyn",20,15,2,5,0,0,0,4
Richmond,"Nankervis, Toby",19,11,5,8,0,0,24,2
Richmond,"Prestia, Dion",21,12,1,9,0,0,0,7
Richmond,"Rance, Alex",15,8,4,7,0,0,0,1
Richmond,"Riewoldt, Jack",16,9,7,7,3,2,1,0
Richmond,"Rioli, Daniel",14,4,3,10,1,0,0,0
Richmond,"Short, Jayden",19,13,4,6,2,0,0,1
Richmond,"Townsend, Jacob",11,5,4,6,1,0,0,1
Richmond,"Vlastuin, Nick",17,11,7,6,0,0,0,0
Richmond,"Astbury, David",13,8,3,5,0,0,0,2
Richmond,"Baker, Liam",14,7,3,7,0,2,0,2
Richmond,"Caddy, Josh",15,11,5,4,0,2,1,9
Richmond,"Castagna, Jason",8,7,1,1,2,0,1,5
Richmond,"Cotchin, Trent",19,16,3,3,1,0,0,9
Richmond,"Edwards, Shane",15,8,3,7,0,0,0,5
Richmond,"Ellis, Brandon",18,10,3,8,0,0,0,4
Richmond,"Grigg, Shaun",15,11,4,4,0,0,6,4
Richmond,"Grimes, Dylan",9,6,6,3,0,0,0,5
Richmond,"Higgins, Jack",18,11,2,7,1,2,0,2
Richmond,"Lambert, Kane",31,14,6,17,0,1,0,7
Richmond,"Lloyd, Sam",17,8,2,9,1,0,0,7
Richmond,"Martin, Dustin",26,23,4,3,0,2,0,6
Richmond,"McIntosh, Kamdyn",13,10,2,3,1,0,0,5
Richmond,"Menadue, Connor",18,11,2,7,0,0,0,2
Richmond,"Nankervis, Toby",18,15,3,3,1,1,33,3
Richmond,"Rance, Alex",13,6,2,7,0,0,0,2
Richmond,"Riewoldt, Jack",10,9,4,1,4,1,0,2
Richmond,"Rioli, Daniel",12,5,2,7,0,0,0,4
Richmond,"Short, Jayden",14,12,1,2,0,0,0,1
Richmond,"Townsend, Jacob",7,4,1,3,1,0,1,4
Richmond,"Vlastuin, Nick",14,11,4,3,0,0,0,2
Richmond,"Astbury, David",10,4,2,6,0,0,0,2
Richmond,"Broad, Nathan",12,5,4,7,0,0,0,2
Richmond,"Caddy, Josh",22,13,6,9,4,2,0,0
Richmond,"Castagna, Jason",6,4,3,2,0,1,0,0
Richmond,"Cotchin, Trent",12,7,0,5,0,0,0,7
Richmond,"Edwards, Shane",21,4,0,17,1,0,0,4
Richmond,"Ellis, Brandon",17,10,5,7,2,0,0,2
Richmond,"Graham, Jack",19,6,2,13,0,0,0,3
Richmond,"Grigg, Shaun",26,11,2,15,0,0,1,5
Richmond,"Grimes, Dylan",9,3,1,6,0,0,0,5
Richmond,"Higgins, Jack",16,6,5,10,0,1,0,1
Richmond,"Houli, Bachar",26,14,7,12,0,0,0,0
Richmond,"Lambert, Kane",25,7,5,18,0,0,0,2
Richmond,"Martin, Dustin",28,13,1,15,1,0,0,2
Richmond,"McIntosh, Kamdyn",16,9,5,7,0,0,0,1
Richmond,"Prestia, Dion",23,15,3,8,0,0,0,4
Richmond,"Rance, Alex",16,11,4,5,0,0,0,1
Richmond,"Riewoldt, Jack",26,23,14,3,10,6,1,2
Richmond,"Rioli, Daniel",25,13,5,12,0,1,0,2
Richmond,"Short, Jayden",23,15,4,8,0,0,0,1
Richmond,"Soldo, Ivan",11,2,0,9,0,0,34,3
Richmond,"Vlastuin, Nick",22,8,6,14,1,0,0,2
Richmond,"Baker, Liam",8,5,0,3,1,0,0,1
Richmond,"Broad, Nathan",4,2,0,2,0,0,0,2
Richmond,"Caddy, Josh",17,9,5,8,4,0,0,2
Richmond,"Castagna, Jason",9,4,1,5,1,0,0,1
Richmond,"Conca, Reece",21,11,2,10,0,1,0,5
Richmond,"Edwards, Shane",20,7,7,13,0,1,0,4
Richmond,"Ellis, Brandon",22,11,5,11,0,0,0,4
Richmond,"Garthwaite, Ryan",11,4,4,7,0,0,0,4
Richmond,"Graham, Jack",15,10,0,5,0,1,0,6
Richmond,"Grigg, Shaun",23,11,4,12,0,0,1,3
Richmond,"Grimes, Dylan",13,9,6,4,0,0,0,2
Richmond,"Higgins, Jack",14,4,0,10,0,0,0,2
Richmond,"Houli, Bachar",20,12,7,8,0,1,0,1
Richmond,"Lloyd, Sam",16,9,5,7,0,0,0,2
Richmond,"Martin, Dustin",26,14,10,12,4,0,0,1
Richmond,"McIntosh, Kamdyn",20,13,4,7,0,0,0,3
Richmond,"Nankervis, Toby",16,8,2,8,0,0,21,4
Richmond,"Rance, Alex",17,9,4,8,0,0,0,2
Richmond,"Riewoldt, Jack",14,12,5,2,2,2,3,3
Richmond,"Rioli, Daniel",17,7,6,10,0,2,0,7
Richmond,"Short, Jayden",25,19,7,6,0,0,0,0
Richmond,"Vlastuin, Nick",13,9,5,4,0,0,0,3
Richmond,"Astbury, David",10,6,5,4,0,0,0,0
Richmond,"Broad, Nathan",4,3,0,1,0,0,1,1
Richmond,"Caddy, Josh",12,6,2,6,1,0,0,1
Richmond,"Castagna, Jason",17,10,6,7,2,2,0,2
Richmond,"Conca, Reece",18,12,5,6,0,0,0,3
Richmond,"Cotchin, Trent",17,7,1,10,0,0,0,3
Richmond,"Edwards, Shane",16,6,1,10,0,0,0,2
Richmond,"Ellis, Brandon",21,8,4,13,0,0,0,2
Richmond,"Graham, Jack",20,12,4,8,3,0,0,8
Richmond,"Grigg, Shaun",19,8,6,11,0,1,1,1
Richmond,"Grimes, Dylan",11,4,4,7,0,0,0,3
Richmond,"Higgins, Jack",18,7,0,11,0,0,0,5
Richmond,"Houli, Bachar",21,13,6,8,0,0,0,0
Richmond,"Martin, Dustin",33,25,4,8,1,0,0,4
Richmond,"McIntosh, Kamdyn",17,12,2,5,1,0,0,3
Richmond,"Nankervis, Toby",21,11,7,10,1,0,25,2
Richmond,"Prestia, Dion",28,14,6,14,0,0,0,0
Richmond,"Rance, Alex",12,5,4,7,0,0,0,1
Richmond,"Riewoldt, Jack",14,11,7,3,5,2,1,1
Richmond,"Rioli, Daniel",10,3,3,7,1,1,0,2
Richmond,"Short, Jayden",13,9,2,4,0,1,0,0
Richmond,"Vlastuin, Nick",12,8,6,4,0,0,0,4
Richmond,"Astbury, David",6,6,4,0,0,0,1,3
Richmond,"Broad, Nathan",3,2,2,1,0,0,0,1
Richmond,"Caddy, Josh",17,15,6,2,2,2,0,3
Richmond,"Castagna, Jason",8,4,1,4,0,0,0,7
Richmond,"Conca, Reece",17,8,3,9,0,0,0,6
Richmond,"Cotchin, Trent",26,17,1,9,0,1,0,5
Richmond,"Edwards, Shane",15,9,1,6,1,2,0,2
Richmond,"Graham, Jack",7,5,1,2,1,0,0,7
Richmond,"Grigg, Shaun",25,18,6,7,0,0,0,4
Richmond,"Grimes, Dylan",12,6,3,6,0,0,0,2
Richmond,"Higgins, Jack",20,14,4,6,1,1,0,3
Richmond,"Houli, Bachar",24,12,3,12,0,0,0,4
Richmond,"Lambert, Kane",26,10,2,16,0,0,0,4
Richmond,"Martin, Dustin",29,18,4,11,1,2,0,4
Richmond,"McIntosh, Kamdyn",12,9,3,3,3,0,0,3
Richmond,"Nankervis, Toby",14,8,3,6,0,0,27,2
Richmond,"Prestia, Dion",26,21,3,5,1,0,0,2
Richmond,"Rance, Alex",13,11,5,2,0,0,0,1
Richmond,"Riewoldt, Jack",15,10,3,5,0,2,2,3
Richmond,"Rioli, Daniel",16,7,0,9,3,0,0,3
Richmond,"Short, Jayden",21,16,4,5,0,1,0,4
Richmond,"Vlastuin, Nick",12,7,4,5,0,0,0,2
Richmond,"Astbury, David",12,4,3,8,0,0,0,0
Richmond,"Broad, Nathan",10,5,2,5,0,0,0,2
Richmond,"Caddy, Josh",11,6,1,5,0,0,0,3
Richmond,"Castagna, Jason",6,5,2,1,0,0,0,3
Richmond,"Conca, Reece",18,8,2,10,0,0,0,5
Richmond,"Cotchin, Trent",25,12,1,13,0,0,0,7
Richmond,"Edwards, Shane",14,6,0,8,0,0,0,4
Richmond,"Graham, Jack",8,6,0,2,0,0,0,2
Richmond,"Grigg, Shaun",15,7,1,8,0,0,2,5
Richmond,"Grimes, Dylan",14,5,1,9,0,0,0,3
Richmond,"Higgins, Jack",14,7,2,7,2,0,0,2
Richmond,"Houli, Bachar",22,16,4,6,1,0,0,0
Richmond,"Lambert, Kane",19,10,3,9,0,2,0,1
Richmond,"Martin, Dustin",19,6,3,13,0,0,0,1
Richmond,"McIntosh, Kamdyn",15,8,1,7,0,0,0,0
Richmond,"Nankervis, Toby",16,9,3,7,0,0,24,4
Richmond,"Prestia, Dion",24,12,4,12,0,0,0,5
Richmond,"Rance, Alex",20,8,6,12,0,0,0,2
Richmond,"Riewoldt, Jack",14,11,9,3,5,1,0,2
Richmond,"Rioli, Daniel",14,7,2,7,0,1,0,5
Richmond,"Short, Jayden",18,14,2,4,0,0,0,1
Richmond,"Vlastuin, Nick",17,10,6,7,0,1,0,4
St Kilda,"Acres, Blake",30,14,9,16,1,0,0,4
St Kilda,"Armitage, David",24,8,7,16,0,0,0,2
St Kilda,"Billings, Jack",26,18,9,8,2,3,0,3
St Kilda,"Brown, Nathan",7,5,5,2,0,0,0,2
St Kilda,"Bruce, Josh",12,5,6,7,3,0,3,0
St Kilda,"Carlisle, Jake",13,8,8,5,0,0,0,1
St Kilda,"Clark, Hunter",12,8,3,4,1,0,0,1
St Kilda,"Geary, Jarryn",27,15,8,12,0,0,0,1
St Kilda,"Gresham, Jade",16,11,3,5,3,1,0,3
St Kilda,"Long, Ben",15,7,6,8,1,0,0,3
St Kilda,"Longer, Billy",7,1,1,6,0,0,22,0
St Kilda,"McCartin, Paddy",7,6,3,1,1,0,0,0
St Kilda,"Membrey, Tim",16,13,9,3,2,3,0,3
St Kilda,"Newnes, Jack",25,15,6,10,0,0,0,2
St Kilda,"Roberton, Dylan",24,19,10,5,0,0,0,2
St Kilda,"Ross, Sebastian",32,20,6,12,0,0,0,7
St Kilda,"Savage, Shane",24,18,7,6,0,0,0,1
St Kilda,"Sinclair, Jack",12,1,3,11,0,0,0,2
St Kilda,"Steele, Jack",18,6,3,12,0,0,0,3
St Kilda,"Steven, Jack",34,21,10,13,2,0,0,2
St Kilda,"Stevens, Koby",23,9,5,14,0,1,0,4
St Kilda,"Webster, Jimmy",18,14,8,4,0,0,0,2
St Kilda,"Acres, Blake",21,11,4,10,1,0,2,7
St Kilda,"Armitage, David",27,11,5,16,0,1,0,2
St Kilda,"Billings, Jack",23,10,3,13,0,0,0,2
St Kilda,"Brown, Nathan",6,3,2,3,0,0,0,3
St Kilda,"Bruce, Josh",13,5,1,8,0,0,1,5
St Kilda,"Carlisle, Jake",17,12,11,5,1,0,0,2
St Kilda,"Clark, Hunter",7,3,1,4,0,1,0,4
St Kilda,"Geary, Jarryn",25,8,6,17,0,0,0,4
St Kilda,"Gresham, Jade",19,8,4,11,1,0,0,3
St Kilda,"Long, Ben",8,5,2,3,0,2,0,1
St Kilda,"Longer, Billy",1,1,0,0,0,0,16,2
St Kilda,"McCartin, Paddy",10,8,4,2,0,2,0,2
St Kilda,"Membrey, Tim",8,5,4,3,0,1,0,0
St Kilda,"Newnes, Jack",20,12,4,8,0,0,0,0
St Kilda,"Roberton, Dylan",19,12,4,7,0,0,0,2
St Kilda,"Ross, Sebastian",23,12,4,11,0,0,0,6
St Kilda,"Savage, Shane",26,15,7,11,0,0,0,1
St Kilda,"Sinclair, Jack",10,3,2,7,0,0,0,8
St Kilda,"Steele, Jack",14,4,2,10,1,0,0,7
St Kilda,"Steven, Jack",26,17,5,9,1,0,0,5
St Kilda,"Stevens, Koby",19,9,7,10,0,1,0,8
St Kilda,"Webster, Jimmy",30,18,5,12,0,0,0,1
St Kilda,"Acres, Blake",19,10,2,9,1,3,1,4
St Kilda,"Armitage, David",13,10,4,3,1,0,0,1
St Kilda,"Billings, Jack",17,4,4,13,0,0,0,2
St Kilda,"Brown, Nathan",8,0,2,8,0,0,0,4
St Kilda,"Bruce, Josh",10,3,5,7,1,0,3,2
St Kilda,"Carlisle, Jake",14,8,9,6,0,0,0,1
St Kilda,"Coffield, Nick",18,12,6,6,1,0,0,0
St Kilda,"Dunstan, Luke",30,15,5,15,0,0,0,3
St Kilda,"Geary, Jarryn",13,6,2,7,1,0,0,2
St Kilda,"Gresham, Jade",10,6,5,4,1,0,0,0
St Kilda,"Long, Ben",11,6,0,5,0,0,0,2
St Kilda,"Marshall, Rowan",14,9,6,5,0,1,18,4
St Kilda,"McCartin, Paddy",10,6,6,4,0,1,0,1
St Kilda,"Newnes, Jack",25,17,8,8,0,2,0,1
St Kilda,"Roberton, Dylan",16,10,8,6,0,0,0,0
St Kilda,"Ross, Sebastian",32,20,8,12,0,0,0,6
St Kilda,"Savage, Shane",29,21,6,8,0,2,0,4
St Kilda,"Sinclair, Jack",23,13,5,10,1,0,0,4
St Kilda,"Steven, Jack",28,15,5,13,0,0,0,4
St Kilda,"Webster, Jimmy",20,15,1,5,0,0,0,3
St Kilda,"White, Brandon",12,11,3,1,0,0,0,0
St Kilda,"Wright, Nathan",5,3,1,2,0,1,0,3
St Kilda,"Acres, Blake",22,12,2,10,1,1,2,3
St Kilda,"Billings, Jack",23,10,5,13,0,2,0,2
St Kilda,"Brown, Nathan",6,3,0,3,0,0,0,1
St Kilda,"Carlisle, Jake",18,11,5,7,0,1,1,1
St Kilda,"Coffield, Nick",17,7,4,10,0,0,0,4
St Kilda,"Dunstan, Luke",26,16,6,10,2,0,0,7
St Kilda,"Geary, Jarryn",26,17,4,9,0,1,0,3
St Kilda,"Gilbert, Sam",15,10,3,5,0,0,0,5
St Kilda,"Gresham, Jade",19,7,2,12,0,0,0,2
St Kilda,"Hickey, Tom",14,7,5,7,0,0,22,3
St Kilda,"Long, Ben",18,10,4,8,1,1,0,2
St Kilda,"Lonie, Jack",11,6,2,5,0,0,0,4
St Kilda,"Marshall, Rowan",9,5,2,4,1,1,6,3
St Kilda,"McCartin, Paddy",12,9,6,3,1,2,0,1
St Kilda,"Newnes, Jack",16,13,1,3,0,3,0,0
St Kilda,"Roberton, Dylan",2,2,0,0,1,0,0,2
St Kilda,"Ross, Sebastian",20,10,2,10,0,0,0,4
St Kilda,"Savage, Shane",24,19,7,5,0,0,0,4
St Kilda,"Sinclair, Jack",21,16,3,5,0,1,0,1
St Kilda,"Steele, Jack",24,13,4,11,0,1,0,4
St Kilda,"Steven, Jack",26,9,0,17,0,0,0,2
St Kilda,"White, Brandon",13,7,1,6,0,0,0,3
St Kilda,"Acres, Blake",29,17,5,12,0,2,2,2
St Kilda,"Billings, Jack",20,12,4,8,1,3,0,3
St Kilda,"Brown, Nathan",4,0,1,4,0,0,0,1
St Kilda,"Carlisle, Jake",16,12,8,4,0,1,0,0
St Kilda,"Clark, Hunter",10,7,1,3,1,0,0,4
St Kilda,"Coffield, Nick",18,12,11,6,0,0,0,1
St Kilda,"Dunstan, Luke",19,11,2,8,1,0,0,5
St Kilda,"Geary, Jarryn",14,8,3,6,0,0,0,2
St Kilda,"Gilbert, Sam",15,6,1,9,0,0,0,4
St Kilda,"Gresham, Jade",13,4,1,9,1,1,0,4
St Kilda,"Hickey, Tom",18,7,2,11,0,0,29,5
St Kilda,"Long, Ben",15,6,4,9,1,0,0,8
St Kilda,"McCartin, Paddy",10,6,4,4,3,1,0,1
St Kilda,"Membrey, Tim",6,6,5,0,0,2,0,0
St Kilda,"Newnes, Jack",3,3,1,0,0,0,0,0
St Kilda,"Ross, Sebastian",31,21,7,10,0,1,0,4
St Kilda,"Savage, Shane",14,10,2,4,0,0,0,2
St Kilda,"Sinclair, Jack",23,13,3,10,0,0,0,11
St Kilda,"Steele, Jack",24,9,2,15,0,0,0,7
St Kilda,"Steven, Jack",29,13,3,16,1,0,0,5
St Kilda,"Weller, Maverick",25,13,6,12,1,1,0,3
St Kilda,"White, Brandon",14,11,6,3,0,0,0,7
St Kilda,"Acres, Blake",19,8,4,11,0,0,1,3
St Kilda,"Billings, Jack",15,9,3,6,1,3,0,3
St Kilda,"Brown, Nathan",13,3,2,10,0,0,0,2
St Kilda,"Carlisle, Jake",20,12,7,8,0,0,0,2
St Kilda,"Coffield, Nick",7,4,2,3,0,0,0,0
St Kilda,"Dunstan, Luke",19,13,3,6,0,1,0,4
St Kilda,"Geary, Jarryn",21,11,1,10,0,0,0,3
St Kilda,"Gilbert, Sam",19,9,4,10,0,1,0,4
St Kilda,"Gresham, Jade",12,8,3,4,0,2,0,1
St Kilda,"Hickey, Tom",10,5,3,5,1,0,21,4
St Kilda,"Long, Ben",12,5,3,7,1,0,0,0
St Kilda,"McCartin, Paddy",11,7,7,4,1,0,0,1
St Kilda,"Membrey, Tim",9,8,5,1,1,1,0,2
St Kilda,"Newnes, Jack",18,12,6,6,0,0,0,1
St Kilda,"Ross, Sebastian",21,13,3,8,0,2,0,3
St Kilda,"Savage, Shane",23,16,6,7,0,0,0,3
St Kilda,"Sinclair, Jack",12,7,1,5,1,1,0,2
St Kilda,"Steele, Jack",18,7,2,11,1,0,0,11
St Kilda,"Steven, Jack",29,13,3,16,0,0,0,4
St Kilda,"Webster, Jimmy",25,15,9,10,0,0,0,2
St Kilda,"Weller, Maverick",12,6,4,6,0,0,0,5
St Kilda,"White, Brandon",14,8,4,6,0,0,0,4
St Kilda,"Armitage, David",21,9,3,12,2,1,0,2
St Kilda,"Billings, Jack",20,9,3,11,0,0,0,2
St Kilda,"Brown, Nathan",11,2,3,9,0,0,0,2
St Kilda,"Carlisle, Jake",15,5,6,10,0,0,0,1
St Kilda,"Clark, Hunter",20,9,2,11,0,1,0,1
St Kilda,"Coffield, Nick",21,10,4,11,0,0,0,3
St Kilda,"Dunstan, Luke",22,10,3,12,1,0,0,7
St Kilda,"Geary, Jarryn",18,8,1,10,0,0,0,2
St Kilda,"Gilbert, Sam",18,8,4,10,0,0,0,8
St Kilda,"Gresham, Jade",24,9,3,15,1,3,0,3
St Kilda,"Hickey, Tom",17,5,4,12,1,0,26,3
St Kilda,"Long, Ben",14,5,3,9,2,0,0,5
St Kilda,"Marshall, Rowan",8,5,3,3,0,3,4,2
St Kilda,"McCartin, Paddy",8,5,3,3,0,2,0,1
St Kilda,"Membrey, Tim",13,8,7,5,2,0,0,0
St Kilda,"Newnes, Jack",25,13,6,12,0,0,0,0
St Kilda,"Ross, Sebastian",35,18,7,17,0,2,0,2
St Kilda,"Savage, Shane",20,6,5,14,0,0,0,1
St Kilda,"Steele, Jack",25,11,3,14,0,0,0,7
St Kilda,"Steven, Jack",29,14,3,15,0,0,0,3
St Kilda,"Webster, Jimmy",24,14,7,10,0,0,0,3
St Kilda,"Weller, Maverick",23,8,5,15,0,0,0,5
St Kilda,"Acres, Blake",23,13,3,10,0,0,0,3
St Kilda,"Armitage, David",8,3,2,5,0,0,0,3
St Kilda,"Billings, Jack",15,9,3,6,0,1,0,2
St Kilda,"Brown, Nathan",9,2,2,7,0,0,0,2
St Kilda,"Carlisle, Jake",7,3,5,4,0,0,0,1
St Kilda,"Clark, Hunter",17,6,4,11,0,0,0,0
St Kilda,"Coffield, Nick",16,10,2,6,0,0,0,3
St Kilda,"Dunstan, Luke",26,14,5,12,0,0,0,9
St Kilda,"Geary, Jarryn",10,5,1,5,1,0,0,1
St Kilda,"Gilbert, Sam",14,7,2,7,1,0,0,4
St Kilda,"Gresham, Jade",16,12,2,4,2,1,0,1
St Kilda,"Hickey, Tom",16,5,3,11,1,0,18,4
St Kilda,"Marshall, Rowan",8,5,5,3,0,1,6,3
St Kilda,"Membrey, Tim",13,9,8,4,1,5,0,3
St Kilda,"Newnes, Jack",14,10,6,4,1,1,0,2
St Kilda,"Phillips, Ed",24,8,3,16,0,0,0,5
St Kilda,"Ross, Sebastian",23,13,5,10,0,0,0,2
St Kilda,"Savage, Shane",18,8,6,10,0,0,0,3
St Kilda,"Steele, Jack",23,9,3,14,0,1,0,2
St Kilda,"Steven, Jack",23,16,2,7,1,0,0,4
St Kilda,"Webster, Jimmy",31,15,4,16,0,0,0,2
St Kilda,"Weller, Maverick",19,7,8,12,0,0,0,4
St Kilda,"Armitage, David",8,4,4,4,0,2,0,2
St Kilda,"Billings, Jack",21,7,2,14,1,0,0,2
St Kilda,"Brown, Nathan",9,3,2,6,0,0,0,1
St Kilda,"Clark, Hunter",21,8,2,13,0,0,0,3
St Kilda,"Coffield, Nick",12,7,4,5,0,0,0,1
St Kilda,"Dunstan, Luke",32,11,2,21,0,0,0,5
St Kilda,"Geary, Jarryn",23,8,3,15,0,0,0,3
St Kilda,"Gresham, Jade",15,12,3,3,2,0,0,1
St Kilda,"Hickey, Tom",13,6,3,7,0,0,18,1
St Kilda,"Lonie, Jack",15,8,4,7,2,0,0,1
St Kilda,"Marshall, Rowan",11,6,5,5,0,1,1,1
St Kilda,"Membrey, Tim",12,5,7,7,0,3,1,0
St Kilda,"Newnes, Jack",15,8,8,7,4,2,0,2
St Kilda,"Phillips, Ed",19,10,2,9,0,0,0,1
St Kilda,"Rice, Bailey",17,12,4,5,0,0,0,1
St Kilda,"Ross, Sebastian",29,11,4,18,0,0,0,2
St Kilda,"Savage, Shane",24,15,5,9,1,0,0,1
St Kilda,"Sinclair, Jack",27,10,4,17,0,1,0,6
St Kilda,"Steele, Jack",23,13,2,10,0,0,0,9
St Kilda,"Steven, Jack",29,12,5,17,0,1,0,5
St Kilda,"Webster, Jimmy",24,14,2,10,0,0,0,1
St Kilda,"Weller, Maverick",9,6,3,3,0,0,0,1
St Kilda,"Austin, Logan",23,12,8,11,0,0,0,3
St Kilda,"Billings, Jack",18,13,7,5,1,0,0,3
St Kilda,"Carlisle, Jake",27,13,10,14,0,0,7,2
St Kilda,"Clark, Hunter",17,12,5,5,0,1,0,1
St Kilda,"Dunstan, Luke",10,6,3,4,0,0,0,0
St Kilda,"Geary, Jarryn",32,14,10,18,0,0,0,5
St Kilda,"Gresham, Jade",15,8,3,7,6,0,0,4
St Kilda,"Hickey, Tom",12,7,2,5,0,0,29,5
St Kilda,"Lonie, Jack",16,8,4,8,1,1,0,0
St Kilda,"McCartin, Paddy",11,7,6,4,0,1,0,0
St Kilda,"McKenzie, Daniel",13,6,4,7,0,0,0,3
St Kilda,"Membrey, Tim",14,8,5,6,2,0,0,2
St Kilda,"Newnes, Jack",8,6,5,2,1,1,0,1
St Kilda,"Phillips, Ed",21,14,3,7,0,0,0,2
St Kilda,"Rice, Bailey",19,12,6,7,0,0,0,2
St Kilda,"Ross, Sebastian",37,16,9,21,0,0,0,4
St Kilda,"Savage, Shane",31,15,4,16,0,0,0,0
St Kilda,"Sinclair, Jack",21,12,6,9,0,0,0,4
St Kilda,"Steele, Jack",22,9,5,13,0,0,0,7
St Kilda,"Steven, Jack",36,15,9,21,1,1,0,3
St Kilda,"Webster, Jimmy",36,25,5,11,0,0,0,1
St Kilda,"White, Brandon",1,1,0,0,0,0,0,0
St Kilda,"Austin, Logan",26,13,14,13,0,0,0,2
St Kilda,"Billings, Jack",15,7,3,8,0,0,0,2
St Kilda,"Clark, Hunter",17,10,0,7,0,0,0,6
St Kilda,"Geary, Jarryn",10,4,2,6,0,0,0,2
St Kilda,"Gresham, Jade",14,6,4,8,2,0,0,3
St Kilda,"Hickey, Tom",18,5,3,13,0,0,28,0
St Kilda,"Lonie, Jack",11,9,2,2,1,0,0,1
St Kilda,"Marshall, Rowan",22,5,4,17,0,0,4,2
St Kilda,"McCartin, Paddy",9,7,6,2,1,0,0,1
St Kilda,"McKenzie, Daniel",16,3,2,13,0,0,0,3
St Kilda,"Membrey, Tim",20,12,9,8,6,0,0,1
St Kilda,"Newnes, Jack",21,14,8,7,2,0,0,6
St Kilda,"Phillips, Ed",17,9,3,8,0,0,0,7
St Kilda,"Rice, Bailey",16,13,5,3,0,0,0,1
St Kilda,"Ross, Sebastian",32,16,4,16,0,0,0,3
St Kilda,"Savage, Shane",24,17,5,7,0,1,0,4
St Kilda,"Sinclair, Jack",29,12,5,17,1,0,0,8
St Kilda,"Steele, Jack",16,8,3,8,0,0,0,7
St Kilda,"Steven, Jack",24,8,1,16,0,0,0,5
St Kilda,"Webster, Jimmy",21,11,6,10,0,0,0,2
St Kilda,"Weller, Maverick",20,7,4,13,1,1,0,1
St Kilda,"White, Brandon",20,12,5,8,0,0,0,1
St Kilda,"Austin, Logan",21,14,9,7,0,1,0,0
St Kilda,"Battle, Josh",14,8,4,6,2,1,0,2
St Kilda,"Brown, Nathan",4,4,1,0,0,0,0,1
St Kilda,"Clark, Hunter",13,8,3,5,0,0,0,5
St Kilda,"Coffield, Nick",15,8,5,7,0,0,0,1
St Kilda,"Dunstan, Luke",22,14,1,8,0,0,0,6
St Kilda,"Gresham, Jade",13,7,3,6,1,1,0,1
St Kilda,"Hickey, Tom",11,8,1,3,0,1,30,8
St Kilda,"Lonie, Jack",14,7,5,7,0,2,0,0
St Kilda,"McCartin, Paddy",10,8,5,2,1,3,0,1
St Kilda,"McKenzie, Daniel",7,3,4,4,0,0,0,4
St Kilda,"Membrey, Tim",15,8,6,7,1,0,0,0
St Kilda,"Newnes, Jack",19,12,6,7,0,3,0,2
St Kilda,"Phillips, Ed",20,14,5,6,0,0,0,3
St Kilda,"Rice, Bailey",20,16,9,4,0,0,0,1
St Kilda,"Ross, Sebastian",25,13,4,12,0,0,0,5
St Kilda,"Savage, Shane",17,16,8,1,0,0,0,2
St Kilda,"Sinclair, Jack",17,8,4,9,1,0,0,6
St Kilda,"Steele, Jack",21,5,6,16,0,0,3,2
St Kilda,"Steven, Jack",13,7,0,6,0,0,0,4
St Kilda,"Webster, Jimmy",24,17,5,7,0,0,0,3
St Kilda,"Weller, Maverick",9,1,2,8,1,0,0,3
St Kilda,"Armitage, David",25,15,6,10,0,2,0,4
St Kilda,"Austin, Logan",11,5,3,6,0,0,0,0
St Kilda,"Battle, Josh",12,7,2,5,3,0,0,3
St Kilda,"Billings, Jack",27,15,6,12,0,0,0,4
St Kilda,"Brown, Nathan",5,2,1,3,0,0,0,1
St Kilda,"Carlisle, Jake",23,14,11,9,0,0,0,3
St Kilda,"Clark, Hunter",17,9,6,8,0,0,0,6
St Kilda,"Dunstan, Luke",15,8,2,7,0,2,0,5
St Kilda,"Gresham, Jade",23,11,6,12,2,1,0,3
St Kilda,"Longer, Billy",7,3,1,4,0,0,33,3
St Kilda,"McCartin, Paddy",10,9,4,1,2,0,0,2
St Kilda,"McKenzie, Daniel",13,5,3,8,1,0,0,7
St Kilda,"Membrey, Tim",10,10,9,0,2,0,0,3
St Kilda,"Newnes, Jack",15,14,7,1,1,2,0,5
St Kilda,"Rice, Bailey",8,6,3,2,0,0,0,1
St Kilda,"Ross, Sebastian",33,15,10,18,0,0,0,7
St Kilda,"Savage, Shane",15,8,3,7,0,0,0,2
St Kilda,"Sinclair, Jack",25,13,5,12,0,0,0,2
St Kilda,"Steele, Jack",21,15,4,6,0,0,0,6
St Kilda,"Steven, Jack",28,21,5,7,0,1,0,3
St Kilda,"Webster, Jimmy",3,2,1,1,0,0,0,0
St Kilda,"Weller, Maverick",15,11,7,4,0,2,0,5
St Kilda,"Armitage, David",26,16,6,10,1,0,0,7
St Kilda,"Battle, Josh",16,9,7,7,1,2,4,3
St Kilda,"Billings, Jack",24,13,9,11,1,0,0,1
St Kilda,"Brown, Nathan",5,1,0,4,0,0,0,1
St Kilda,"Carlisle, Jake",22,12,9,10,0,0,0,2
St Kilda,"Clark, Hunter",14,9,2,5,1,0,0,2
St Kilda,"Dunstan, Luke",16,9,3,7,0,0,0,4
St Kilda,"Geary, Jarryn",25,11,3,14,0,0,0,1
St Kilda,"Gresham, Jade",19,10,3,9,4,0,0,1
St Kilda,"Joyce, Darragh",10,4,3,6,0,1,0,1
St Kilda,"Longer, Billy",8,3,2,5,0,0,26,1
St Kilda,"McCartin, Paddy",12,8,4,4,2,3,1,0
St Kilda,"McKenzie, Daniel",19,7,5,12,0,0,0,0
St Kilda,"Membrey, Tim",15,12,7,3,4,2,0,1
St Kilda,"Newnes, Jack",10,6,2,4,1,0,0,3
St Kilda,"Rice, Bailey",9,7,1,2,0,0,0,1
St Kilda,"Ross, Sebastian",23,14,4,9,0,0,0,1
St Kilda,"Savage, Shane",22,14,5,8,1,0,0,1
St Kilda,"Sinclair, Jack",30,14,5,16,0,1,0,0
St Kilda,"Steele, Jack",20,8,3,12,1,0,0,11
St Kilda,"Steven, Jack",27,16,1,11,1,1,0,3
St Kilda,"Weller, Maverick",15,4,2,11,0,0,0,3
St Kilda,"Armitage, David",30,14,4,16,3,0,0,2
St Kilda,"Austin, Logan",18,11,4,7,0,0,0,3
St Kilda,"Billings, Jack",22,13,3,9,0,0,0,4
St Kilda,"Clark, Hunter",13,6,0,7,0,0,0,3
St Kilda,"Dunstan, Luke",23,8,5,15,1,0,0,5
St Kilda,"Geary, Jarryn",18,9,4,9,0,0,0,1
St Kilda,"Gilbert, Sam",11,4,1,7,0,0,0,0
St Kilda,"Gresham, Jade",17,11,3,6,2,0,0,4
St Kilda,"Joyce, Darragh",3,3,1,0,0,0,0,0
St Kilda,"Longer, Billy",9,6,1,3,0,1,24,2
St Kilda,"McCartin, Paddy",6,5,4,1,0,2,0,1
St Kilda,"McKenzie, Daniel",21,7,5,14,0,0,0,2
St Kilda,"Membrey, Tim",8,6,6,2,1,1,0,1
St Kilda,"Newnes, Jack",11,8,5,3,0,1,0,3
St Kilda,"Ross, Sebastian",22,12,1,10,0,0,0,4
St Kilda,"Savage, Shane",22,17,3,5,0,1,0,1
St Kilda,"Sinclair, Jack",20,9,1,11,0,0,0,3
St Kilda,"Steele, Jack",26,8,5,18,0,0,0,7
St Kilda,"Steven, Jack",20,9,0,11,0,0,0,4
St Kilda,"Webster, Jimmy",20,11,7,9,0,0,0,3
St Kilda,"Weller, Maverick",18,7,3,11,0,1,0,5
St Kilda,"Wright, Nathan",9,1,2,8,0,0,0,0
St Kilda,"Armitage, David",27,14,5,13,0,2,0,6
St Kilda,"Billings, Jack",30,17,7,13,2,1,0,2
St Kilda,"Carlisle, Jake",10,9,7,1,0,0,0,0
St Kilda,"Clark, Hunter",13,6,3,7,0,1,0,5
St Kilda,"Dunstan, Luke",28,13,4,15,0,1,0,5
St Kilda,"Geary, Jarryn",19,9,4,10,0,0,0,3
St Kilda,"Gilbert, Sam",9,3,2,6,0,0,0,2
St Kilda,"Gresham, Jade",13,10,2,3,0,2,0,2
St Kilda,"Hickey, Tom",14,5,5,9,0,1,29,1
St Kilda,"Lonie, Jack",13,9,5,4,1,2,0,9
St Kilda,"Marshall, Rowan",16,9,8,7,2,2,23,3
St Kilda,"McKenzie, Daniel",13,7,6,6,0,0,0,2
St Kilda,"Membrey, Tim",11,7,6,4,3,2,0,2
St Kilda,"Newnes, Jack",16,8,4,8,3,0,0,5
St Kilda,"Phillips, Ed",21,11,8,10,0,0,0,1
St Kilda,"Rice, Bailey",18,9,2,9,0,1,0,4
St Kilda,"Savage, Shane",25,19,4,6,0,0,0,3
St Kilda,"Sinclair, Jack",25,12,1,13,1,2,0,1
St Kilda,"Steele, Jack",33,12,4,21,1,0,0,10
St Kilda,"Steven, Jack",33,16,8,17,2,0,0,4
St Kilda,"Webster, Jimmy",18,10,4,8,0,0,0,2
St Kilda,"Weller, Maverick",15,8,4,7,1,1,0,7
St Kilda,"Armitage, David",20,9,2,11,1,0,0,1
St Kilda,"Battle, Josh",7,4,2,3,0,1,0,2
St Kilda,"Billings, Jack",20,8,4,12,0,1,0,6
St Kilda,"Carlisle, Jake",19,9,8,10,0,0,0,0
St Kilda,"Clark, Hunter",20,12,6,8,0,0,0,1
St Kilda,"Dunstan, Luke",21,10,6,11,0,1,0,2
St Kilda,"Geary, Jarryn",21,11,5,10,0,0,0,5
St Kilda,"Gilbert, Sam",11,6,4,5,0,0,0,3
St Kilda,"Gresham, Jade",24,16,2,8,2,0,0,5
St Kilda,"Hickey, Tom",17,4,6,13,0,1,24,0
St Kilda,"Marshall, Rowan",15,11,7,4,1,0,14,2
St Kilda,"McKenzie, Daniel",13,7,4,6,0,0,0,1
St Kilda,"Membrey, Tim",10,7,5,3,2,1,0,0
St Kilda,"Newnes, Jack",14,8,1,6,0,0,0,3
St Kilda,"Phillips, Ed",14,4,6,10,0,0,0,1
St Kilda,"Rice, Bailey",11,4,4,7,0,0,0,3
St Kilda,"Ross, Sebastian",33,16,6,17,0,0,0,6
St Kilda,"Savage, Shane",19,8,5,11,0,0,0,1
St Kilda,"Sinclair, Jack",17,6,5,11,0,0,0,2
St Kilda,"Steele, Jack",25,13,5,12,0,0,0,4
St Kilda,"Steven, Jack",23,12,2,11,1,0,0,1
St Kilda,"Weller, Maverick",11,7,5,4,1,1,0,4
St Kilda,"Acres, Blake",18,13,6,5,0,1,1,6
St Kilda,"Battle, Josh",7,4,2,3,1,0,0,3
St Kilda,"Billings, Jack",22,7,1,15,0,1,0,5
St Kilda,"Brown, Nathan",9,4,5,5,0,0,0,2
St Kilda,"Carlisle, Jake",20,10,9,10,0,1,0,1
St Kilda,"Coffield, Nick",14,9,5,5,0,0,0,1
St Kilda,"Dunstan, Luke",16,6,2,10,0,0,0,1
St Kilda,"Geary, Jarryn",30,20,2,10,0,0,0,2
St Kilda,"Gilbert, Sam",10,5,2,5,0,0,0,6
St Kilda,"Gresham, Jade",25,16,5,9,2,0,0,2
St Kilda,"Hickey, Tom",15,4,0,11,0,0,29,2
St Kilda,"Lonie, Jack",21,11,3,10,2,4,0,1
St Kilda,"Marshall, Rowan",9,4,5,5,0,1,7,4
St Kilda,"McKenzie, Daniel",11,5,2,6,0,0,0,6
St Kilda,"Membrey, Tim",15,10,10,5,2,3,0,1
St Kilda,"Newnes, Jack",20,10,2,10,0,0,0,1
St Kilda,"Ross, Sebastian",30,17,5,13,0,0,0,3
St Kilda,"Savage, Shane",21,14,7,7,0,1,0,0
St Kilda,"Sinclair, Jack",20,5,4,15,0,0,0,2
St Kilda,"Steele, Jack",24,10,2,14,0,0,0,5
St Kilda,"Steven, Jack",27,16,2,11,1,1,0,5
St Kilda,"Weller, Maverick",9,3,1,6,0,0,0,3
St Kilda,"Acres, Blake",22,7,4,15,0,0,1,3
St Kilda,"Armitage, David",19,10,4,9,0,0,0,1
St Kilda,"Battle, Josh",1,1,0,0,0,0,0,0
St Kilda,"Billings, Jack",27,13,8,14,1,3,0,5
St Kilda,"Brown, Nathan",11,5,6,6,0,0,0,4
St Kilda,"Carlisle, Jake",21,13,10,8,0,0,6,0
St Kilda,"Clark, Hunter",20,8,5,12,0,0,0,0
St Kilda,"Coffield, Nick",10,7,3,3,0,0,0,0
St Kilda,"Dunstan, Luke",22,14,4,8,0,0,0,2
St Kilda,"Freeman, Nathan",19,7,1,12,0,0,0,3
St Kilda,"Geary, Jarryn",24,9,8,15,0,0,0,3
St Kilda,"Gresham, Jade",26,13,3,13,0,3,0,6
St Kilda,"Hickey, Tom",14,6,3,8,0,2,13,1
St Kilda,"Lonie, Jack",21,17,11,4,2,0,0,1
St Kilda,"McKenzie, Daniel",15,8,6,7,0,0,0,2
St Kilda,"Membrey, Tim",15,9,5,6,1,0,0,3
St Kilda,"Newnes, Jack",9,4,3,5,2,0,0,5
St Kilda,"Ross, Sebastian",40,22,9,18,3,1,0,3
St Kilda,"Sinclair, Jack",15,8,3,7,0,0,0,3
St Kilda,"Steele, Jack",21,10,6,11,0,0,0,8
St Kilda,"Steven, Jack",27,14,7,13,0,1,0,2
St Kilda,"Webster, Jimmy",23,16,5,7,0,0,0,1
St Kilda,"Acres, Blake",21,6,3,15,0,0,0,3
St Kilda,"Armitage, David",25,12,8,13,0,1,0,3
St Kilda,"Billings, Jack",25,14,7,11,2,1,0,1
St Kilda,"Brown, Nathan",4,4,0,0,0,0,0,0
St Kilda,"Carlisle, Jake",8,7,4,1,0,0,0,2
St Kilda,"Freeman, Nathan",14,9,5,5,1,1,0,2
St Kilda,"Geary, Jarryn",16,9,5,7,0,0,0,1
St Kilda,"Gresham, Jade",11,6,3,5,2,2,0,2
St Kilda,"Long, Ben",10,6,1,4,1,0,0,2
St Kilda,"Lonie, Jack",11,7,4,4,2,0,0,3
St Kilda,"Marshall, Rowan",14,9,7,5,1,1,13,0
St Kilda,"McKenzie, Daniel",11,7,5,4,0,0,0,1
St Kilda,"Membrey, Tim",13,8,7,5,0,2,0,0
St Kilda,"Newnes, Jack",11,4,2,7,1,1,0,4
St Kilda,"Paton, Ben",9,6,2,3,1,1,0,0
St Kilda,"Pierce, Lewis",18,5,5,13,0,0,27,2
St Kilda,"Rice, Bailey",5,3,0,2,0,0,0,1
St Kilda,"Ross, Sebastian",43,22,7,21,0,0,0,4
St Kilda,"Sinclair, Jack",20,9,3,11,0,1,0,2
St Kilda,"Steele, Jack",31,11,7,20,0,0,0,8
St Kilda,"Steven, Jack",23,11,4,12,0,1,0,3
St Kilda,"Webster, Jimmy",13,11,4,2,0,0,0,2
St Kilda,"Acres, Blake",19,9,3,10,0,0,0,3
St Kilda,"Armitage, David",15,11,5,4,0,2,0,5
St Kilda,"Austin, Logan",21,14,7,7,0,0,0,3
St Kilda,"Billings, Jack",27,14,6,13,1,0,0,1
St Kilda,"Geary, Jarryn",11,6,1,5,0,0,0,2
St Kilda,"Gilbert, Sam",15,13,4,2,0,0,0,2
St Kilda,"Goddard, Hugh",6,1,1,5,0,0,0,3
St Kilda,"Gresham, Jade",26,16,3,10,1,1,0,3
St Kilda,"Long, Ben",9,6,2,3,0,1,0,3
St Kilda,"Lonie, Jack",18,11,4,7,4,0,0,2
St Kilda,"Marshall, Rowan",18,6,6,12,0,1,8,2
St Kilda,"McKenzie, Daniel",10,6,3,4,0,0,0,3
St Kilda,"Membrey, Tim",14,8,6,6,2,1,0,1
St Kilda,"Newnes, Jack",16,7,3,9,1,0,0,0
St Kilda,"Paton, Ben",11,4,1,7,1,1,0,3
St Kilda,"Pierce, Lewis",7,1,0,6,0,0,17,4
St Kilda,"Rice, Bailey",16,13,4,3,0,0,0,0
St Kilda,"Ross, Sebastian",34,17,3,17,0,1,0,3
St Kilda,"Sinclair, Jack",15,8,5,7,0,1,0,2
St Kilda,"Steele, Jack",29,14,6,15,1,0,0,6
St Kilda,"Steven, Jack",25,11,5,14,0,0,0,3
St Kilda,"Webster, Jimmy",20,13,3,7,0,0,0,4
St Kilda,"Acres, Blake",15,9,2,6,0,0,0,2
St Kilda,"Armitage, David",11,6,5,5,0,0,0,2
St Kilda,"Austin, Logan",18,15,8,3,0,0,0,1
St Kilda,"Billings, Jack",22,7,4,15,1,0,0,4
St Kilda,"Carlisle, Jake",13,9,6,4,0,0,0,1
St Kilda,"Geary, Jarryn",18,5,5,13,1,0,0,2
St Kilda,"Gilbert, Sam",21,14,6,7,1,0,0,6
St Kilda,"Gresham, Jade",17,13,6,4,0,2,0,1
St Kilda,"Long, Ben",8,2,3,6,0,0,0,1
St Kilda,"Lonie, Jack",9,6,1,3,1,1,0,1
St Kilda,"Marshall, Rowan",16,11,9,5,1,1,9,2
St Kilda,"McKenzie, Daniel",14,8,5,6,0,0,0,2
St Kilda,"Membrey, Tim",10,6,6,4,2,1,0,0
St Kilda,"Newnes, Jack",14,9,7,5,1,1,0,1
St Kilda,"Paton, Ben",16,9,3,7,1,0,0,2
St Kilda,"Pierce, Lewis",9,3,2,6,0,0,14,1
St Kilda,"Rice, Bailey",12,10,4,2,0,0,0,2
St Kilda,"Ross, Sebastian",34,19,6,15,0,1,0,4
St Kilda,"Sinclair, Jack",13,6,2,7,1,1,0,2
St Kilda,"Steele, Jack",35,12,6,23,2,0,0,9
St Kilda,"Steven, Jack",34,19,8,15,2,0,0,4
St Kilda,"Webster, Jimmy",24,12,8,12,0,0,0,0
Sydney,"Cunningham, Harry",10,4,2,6,0,0,0,6
Sydney,"Florent, Oliver",6,2,0,4,0,0,0,2
Sydney,"Fox, Robbie",10,6,0,4,0,0,0,2
Sydney,"Franklin, Lance",21,17,9,4,8,1,0,4
Sydney,"Grundy, Heath",7,4,1,3,0,0,0,0
Sydney,"Hayward, Will",21,11,5,10,2,1,0,0
Sydney,"Heeney, Isaac",26,13,4,13,1,1,0,4
Sydney,"Hewett, George",19,9,6,10,1,1,0,2
Sydney,"Jack, Kieren",19,14,4,5,1,0,0,2
Sydney,"Jones, Zak",20,10,3,10,1,0,0,2
Sydney,"Kennedy, Josh",24,10,3,14,1,1,0,3
Sydney,"Lloyd, Jake",29,19,8,10,1,0,0,2
Sydney,"McVeigh, Jarrad",14,7,1,7,0,0,0,1
Sydney,"Melican, Lewis",14,7,2,7,0,0,0,2
Sydney,"Mills, Callum",20,13,5,7,0,0,0,5
Sydney,"Newman, Nic",19,10,4,9,0,0,0,2
Sydney,"Papley, Tom",17,8,5,9,0,1,0,3
Sydney,"Parker, Luke",32,17,3,15,1,0,0,9
Sydney,"Rampe, Dane",13,9,6,4,0,0,0,2
Sydney,"Sinclair, Callum",21,13,3,8,0,0,16,1
Sydney,"Smith, Nick",19,10,7,9,0,0,0,3
Sydney,"Towers, Dean",12,6,1,6,1,1,1,5
Sydney,"Cunningham, Harry",21,14,2,7,1,1,0,2
Sydney,"Florent, Oliver",20,15,4,5,0,1,0,4
Sydney,"Fox, Robbie",12,7,1,5,0,0,0,1
Sydney,"Franklin, Lance",15,15,5,0,4,2,0,2
Sydney,"Grundy, Heath",16,7,4,9,0,0,0,2
Sydney,"Hannebery, Dan",18,9,3,9,0,0,0,6
Sydney,"Hayward, Will",8,3,0,5,1,0,0,2
Sydney,"Heeney, Isaac",22,13,2,9,1,0,0,5
Sydney,"Hewett, George",20,7,1,13,0,0,0,4
Sydney,"Jack, Kieren",16,12,2,4,0,1,0,4
Sydney,"Kennedy, Josh",33,16,3,17,0,1,0,4
Sydney,"Lloyd, Jake",20,11,5,9,0,0,0,2
Sydney,"McVeigh, Jarrad",28,18,6,10,0,0,0,2
Sydney,"Melican, Lewis",11,8,3,3,0,0,0,3
Sydney,"Mills, Callum",14,8,4,6,0,0,0,2
Sydney,"Papley, Tom",16,10,4,6,1,2,0,2
Sydney,"Parker, Luke",27,11,1,16,1,0,1,6
Sydney,"Rampe, Dane",8,5,2,3,0,0,0,1
Sydney,"Rohan, Gary",7,5,3,2,0,1,0,5
Sydney,"Sinclair, Callum",11,6,1,5,0,1,44,4
Sydney,"Smith, Nick",21,11,4,10,0,0,0,5
Sydney,"Towers, Dean",16,6,5,10,1,0,6,3
Sydney,"Cunningham, Harry",16,12,7,4,0,0,0,0
Sydney,"Florent, Oliver",10,7,1,3,0,1,0,3
Sydney,"Franklin, Lance",22,19,10,3,2,0,0,0
Sydney,"Grundy, Heath",13,6,4,7,0,0,0,2
Sydney,"Hannebery, Dan",23,11,4,12,0,0,0,3
Sydney,"Hayward, Will",18,10,9,8,2,1,0,1
Sydney,"Heeney, Isaac",23,9,6,14,1,0,0,5
Sydney,"Hewett, George",9,3,1,6,0,0,0,0
Sydney,"Jack, Kieren",18,14,1,4,0,0,0,3
Sydney,"Kennedy, Josh",25,13,3,12,1,0,0,5
Sydney,"Lloyd, Jake",22,13,7,9,0,0,0,2
Sydney,"McVeigh, Jarrad",18,11,4,7,0,0,0,3
Sydney,"Melican, Lewis",15,11,4,4,0,0,0,0
Sydney,"Mills, Callum",26,15,6,11,0,0,0,2
Sydney,"Papley, Tom",11,9,2,2,2,2,0,4
Sydney,"Parker, Luke",18,8,4,10,1,0,0,3
Sydney,"Rampe, Dane",16,14,5,2,0,0,0,3
Sydney,"Reid, Sam",12,11,6,1,2,2,0,3
Sydney,"Rohan, Gary",6,6,3,0,2,0,0,1
Sydney,"Sinclair, Callum",14,10,3,4,3,0,45,3
Sydney,"Smith, Nick",14,6,6,8,0,0,0,2
Sydney,"Towers, Dean",13,5,2,8,0,0,5,3
Sydney,"Aliir, Aliir",5,4,2,1,0,1,1,2
Sydney,"Cunningham, Harry",13,6,3,7,1,0,0,2
Sydney,"Florent, Oliver",12,7,2,5,1,0,0,4
Sydney,"Franklin, Lance",16,13,10,3,3,4,0,1
Sydney,"Grundy, Heath",17,8,6,9,0,0,0,0
Sydney,"Hannebery, Dan",21,9,5,12,0,0,0,1
Sydney,"Hayward, Will",5,2,2,3,0,1,0,4
Sydney,"Heeney, Isaac",20,11,4,9,2,0,0,3
Sydney,"Hewett, George",10,3,0,7,0,0,0,2
Sydney,"Jack, Kieren",12,6,2,6,0,0,0,7
Sydney,"Jones, Zak",17,7,3,10,0,1,0,1
Sydney,"Kennedy, Josh",16,4,2,12,0,0,0,2
Sydney,"Lloyd, Jake",23,15,3,8,0,0,0,0
Sydney,"McVeigh, Jarrad",21,12,4,9,0,0,0,0
Sydney,"Mills, Callum",19,13,4,6,0,0,0,1
Sydney,"Newman, Nic",16,10,4,6,0,0,0,1
Sydney,"Papley, Tom",15,10,3,5,2,0,0,1
Sydney,"Parker, Luke",21,9,2,12,3,0,0,10
Sydney,"Rampe, Dane",23,9,8,14,0,1,0,1
Sydney,"Sinclair, Callum",15,11,7,4,0,0,36,1
Sydney,"Smith, Nick",13,6,4,7,0,0,0,1
Sydney,"Towers, Dean",15,7,5,8,1,0,6,2
Sydney,"Cunningham, Harry",21,12,3,9,1,0,0,3
Sydney,"Florent, Oliver",15,11,3,4,1,1,0,0
Sydney,"Franklin, Lance",11,9,6,2,1,3,0,0
Sydney,"Grundy, Heath",18,5,6,13,0,0,0,2
Sydney,"Hannebery, Dan",18,7,2,11,0,0,0,1
Sydney,"Hayward, Will",7,5,3,2,0,0,0,7
Sydney,"Heeney, Isaac",19,10,8,9,1,2,0,8
Sydney,"Hewett, George",13,6,2,7,1,0,0,5
Sydney,"Jack, Kieren",11,9,1,2,1,0,0,2
Sydney,"Jones, Zak",27,17,5,10,1,1,0,2
Sydney,"Kennedy, Josh",13,7,1,6,0,0,0,8
Sydney,"Lloyd, Jake",28,16,6,12,0,0,0,0
Sydney,"Marsh, Harrison",24,15,4,9,0,0,0,0
Sydney,"McVeigh, Jarrad",26,14,5,12,0,0,0,2
Sydney,"Mills, Callum",19,12,6,7,0,1,0,2
Sydney,"Papley, Tom",11,8,2,3,0,2,0,7
Sydney,"Parker, Luke",17,7,4,10,0,1,0,6
Sydney,"Rampe, Dane",22,15,8,7,0,0,0,3
Sydney,"Rohan, Gary",9,9,4,0,2,1,0,2
Sydney,"Sinclair, Callum",11,9,3,2,0,1,32,2
Sydney,"Smith, Nick",18,10,5,8,0,0,0,2
Sydney,"Towers, Dean",17,8,4,9,1,0,5,0
Sydney,"Cunningham, Harry",16,7,5,9,0,1,0,5
Sydney,"Florent, Oliver",14,10,6,4,2,0,0,1
Sydney,"Fox, Robbie",9,7,3,2,2,0,3,1
Sydney,"Grundy, Heath",23,13,12,10,0,0,0,1
Sydney,"Hayward, Will",11,9,4,2,3,0,0,4
Sydney,"Heeney, Isaac",21,11,4,10,0,2,0,7
Sydney,"Hewett, George",16,7,1,9,0,0,0,6
Sydney,"Jack, Kieren",16,12,1,4,0,1,0,9
Sydney,"Jones, Zak",19,10,2,9,1,0,0,4
Sydney,"Kennedy, Josh",33,16,4,17,0,0,0,4
Sydney,"Lloyd, Jake",29,24,10,5,0,0,0,2
Sydney,"Marsh, Harrison",6,3,2,3,0,0,0,3
Sydney,"McVeigh, Jarrad",21,13,5,8,0,0,0,3
Sydney,"Mills, Callum",19,11,3,8,0,0,0,5
Sydney,"Papley, Tom",13,9,6,4,0,2,0,4
Sydney,"Parker, Luke",19,10,5,9,1,2,0,6
Sydney,"Rampe, Dane",15,8,8,7,0,0,0,1
Sydney,"Robinson, Dan",8,3,1,5,0,0,0,2
Sydney,"Rohan, Gary",11,7,2,4,1,1,0,4
Sydney,"Ronke, Ben",15,9,0,6,2,1,0,7
Sydney,"Sinclair, Callum",18,10,6,8,0,0,39,2
Sydney,"Smith, Nick",17,10,6,7,0,1,0,4
Sydney,"Cunningham, Harry",9,4,2,5,0,0,0,3
Sydney,"Florent, Oliver",9,5,1,4,0,1,0,4
Sydney,"Fox, Robbie",10,4,1,6,1,0,0,2
Sydney,"Grundy, Heath",22,13,11,9,0,0,0,1
Sydney,"Hayward, Will",12,8,5,4,3,2,0,3
Sydney,"Heeney, Isaac",18,11,6,7,0,1,0,3
Sydney,"Hewett, George",18,11,3,7,0,0,0,2
Sydney,"Jack, Kieren",24,17,2,7,0,3,0,1
Sydney,"Jones, Zak",18,11,4,7,1,0,0,2
Sydney,"Kennedy, Josh",31,17,2,14,0,0,0,9
Sydney,"Lloyd, Jake",17,11,4,6,1,0,0,1
Sydney,"Marsh, Harrison",16,10,4,6,0,0,0,1
Sydney,"McVeigh, Jarrad",21,8,6,13,0,0,0,3
Sydney,"Mills, Callum",20,11,7,9,0,0,0,3
Sydney,"Papley, Tom",11,7,3,4,0,2,0,1
Sydney,"Parker, Luke",21,8,3,13,1,0,0,2
Sydney,"Rampe, Dane",11,6,2,5,0,0,0,5
Sydney,"Rohan, Gary",10,9,4,1,0,0,0,2
Sydney,"Ronke, Ben",13,10,2,3,0,2,0,3
Sydney,"Sinclair, Callum",20,12,7,8,1,0,27,2
Sydney,"Smith, Nick",8,6,2,2,0,0,0,2
Sydney,"Towers, Dean",10,4,3,6,1,1,0,4
Sydney,"Cunningham, Harry",27,16,7,11,0,0,0,1
Sydney,"Florent, Oliver",25,12,3,13,0,0,0,1
Sydney,"Grundy, Heath",24,15,8,9,0,0,0,2
Sydney,"Hayward, Will",15,10,5,5,3,0,0,2
Sydney,"Heeney, Isaac",28,14,3,14,0,1,0,7
Sydney,"Hewett, George",23,8,3,15,0,0,0,6
Sydney,"Jack, Kieren",18,11,1,7,0,1,0,2
Sydney,"Jones, Zak",18,10,5,8,0,0,0,0
Sydney,"Kennedy, Josh",19,6,0,13,0,0,0,5
Sydney,"Lloyd, Jake",36,24,4,12,0,1,0,2
Sydney,"McCartin, Tom",8,5,4,3,0,0,0,3
Sydney,"McVeigh, Jarrad",26,11,4,15,0,0,0,1
Sydney,"Mills, Callum",18,8,3,10,0,0,0,2
Sydney,"Papley, Tom",13,8,1,5,0,1,0,6
Sydney,"Parker, Luke",28,9,4,19,2,1,0,4
Sydney,"Rampe, Dane",23,14,8,9,0,0,0,3
Sydney,"Robinson, Dan",20,3,2,17,0,0,0,5
Sydney,"Rohan, Gary",9,7,3,2,0,0,0,5
Sydney,"Ronke, Ben",11,9,2,2,7,0,0,10
Sydney,"Sinclair, Callum",14,9,3,5,0,1,41,2
Sydney,"Smith, Nick",21,8,4,13,0,0,0,3
Sydney,"Towers, Dean",8,1,0,7,0,0,0,2
Sydney,"Cunningham, Harry",21,14,9,7,0,1,0,3
Sydney,"Florent, Oliver",22,14,6,8,0,0,0,0
Sydney,"Franklin, Lance",19,17,9,2,3,1,0,2
Sydney,"Grundy, Heath",20,11,7,9,0,0,0,0
Sydney,"Hannebery, Dan",22,10,6,12,0,0,0,0
Sydney,"Hayward, Will",16,11,9,5,1,1,0,0
Sydney,"Heeney, Isaac",22,15,8,7,1,0,0,4
Sydney,"Hewett, George",20,11,5,9,1,1,0,3
Sydney,"Jack, Kieren",16,8,2,8,0,0,0,3
Sydney,"Jones, Zak",12,7,3,5,0,0,0,2
Sydney,"Kennedy, Josh",20,10,6,10,3,0,0,1
Sydney,"Lloyd, Jake",41,26,15,15,1,0,0,1
Sydney,"McCartin, Tom",9,5,2,4,2,1,0,0
Sydney,"McVeigh, Jarrad",31,20,6,11,0,0,0,0
Sydney,"Mills, Callum",18,10,6,8,0,0,0,1
Sydney,"Papley, Tom",18,8,3,10,2,1,0,1
Sydney,"Parker, Luke",23,17,4,6,1,0,0,5
Sydney,"Rampe, Dane",22,12,5,10,0,0,0,1
Sydney,"Rohan, Gary",7,4,2,3,0,0,1,4
Sydney,"Ronke, Ben",14,10,6,4,1,0,0,3
Sydney,"Sinclair, Callum",13,8,4,5,1,0,13,0
Sydney,"Smith, Nick",21,6,6,15,0,0,0,0
Sydney,"Cunningham, Harry",18,14,2,4,0,1,0,2
Sydney,"Florent, Oliver",20,13,2,7,0,1,0,1
Sydney,"Franklin, Lance",13,11,1,2,1,2,1,2
Sydney,"Grundy, Heath",18,9,5,9,0,0,0,0
Sydney,"Hannebery, Dan",17,7,0,10,0,0,0,1
Sydney,"Hayward, Will",13,7,4,6,2,0,0,3
Sydney,"Heeney, Isaac",20,13,6,7,2,0,0,5
Sydney,"Hewett, George",28,13,1,15,0,0,0,5
Sydney,"Jack, Kieren",15,7,0,8,1,0,0,2
Sydney,"Jones, Zak",25,14,4,11,0,0,0,3
Sydney,"Kennedy, Josh",34,15,1,19,0,0,0,7
Sydney,"Lloyd, Jake",26,15,6,11,0,0,0,1
Sydney,"Marsh, Harrison",11,1,1,10,0,0,0,4
Sydney,"McCartin, Tom",4,3,0,1,0,0,0,3
Sydney,"McVeigh, Jarrad",22,13,3,9,0,0,0,3
Sydney,"Papley, Tom",12,7,1,5,1,1,0,2
Sydney,"Parker, Luke",22,6,3,16,0,0,0,5
Sydney,"Rampe, Dane",16,8,3,8,0,0,0,1
Sydney,"Ronke, Ben",13,11,2,2,2,1,0,3
Sydney,"Sinclair, Callum",12,6,1,6,0,0,21,3
Sydney,"Smith, Nick",15,8,3,7,0,0,0,1
Sydney,"Stoddart, Ryley",9,6,2,3,1,0,0,2
Sydney,"Cunningham, Harry",13,8,4,5,0,0,0,2
Sydney,"Florent, Oliver",20,8,3,12,0,0,0,2
Sydney,"Franklin, Lance",15,14,5,1,3,2,0,4
Sydney,"Grundy, Heath",13,10,8,3,0,0,0,0
Sydney,"Hannebery, Dan",12,4,1,8,0,0,0,4
Sydney,"Hayward, Will",10,6,3,4,2,2,0,6
Sydney,"Heeney, Isaac",22,13,6,9,2,3,0,4
Sydney,"Hewett, George",21,8,2,13,0,0,0,3
Sydney,"Jack, Kieren",14,9,2,5,1,0,0,4
Sydney,"Jones, Zak",20,13,5,7,0,0,0,0
Sydney,"Kennedy, Josh",26,11,4,15,0,1,0,2
Sydney,"Lloyd, Jake",24,16,5,8,0,0,0,2
Sydney,"Marsh, Harrison",16,5,2,11,0,0,0,1
Sydney,"McVeigh, Jarrad",18,11,6,7,1,0,0,2
Sydney,"Newman, Nic",11,8,1,3,0,0,0,3
Sydney,"Parker, Luke",21,10,5,11,2,0,0,6
Sydney,"Rampe, Dane",9,6,2,3,0,0,0,3
Sydney,"Rohan, Gary",9,6,3,3,0,1,4,4
Sydney,"Ronke, Ben",13,8,5,5,0,0,0,2
Sydney,"Sinclair, Callum",22,12,7,10,2,0,26,4
Sydney,"Smith, Nick",19,6,9,13,0,0,0,1
Sydney,"Stoddart, Ryley",6,4,1,2,0,0,0,2
Sydney,"Cunningham, Harry",20,14,6,6,0,0,0,4
Sydney,"Florent, Oliver",27,15,5,12,0,0,0,2
Sydney,"Franklin, Lance",18,18,12,0,4,4,0,0
Sydney,"Grundy, Heath",18,9,9,9,0,0,0,1
Sydney,"Hannebery, Dan",16,3,3,13,0,0,0,2
Sydney,"Hayward, Will",10,5,3,5,2,0,0,4
Sydney,"Heeney, Isaac",27,14,8,13,1,1,0,5
Sydney,"Hewett, George",19,4,0,15,0,0,0,1
Sydney,"Jones, Zak",23,16,5,7,1,0,0,1
Sydney,"Kennedy, Josh",31,13,5,18,1,0,0,5
Sydney,"Lloyd, Jake",29,17,5,12,0,1,0,1
Sydney,"Marsh, Harrison",15,5,4,10,0,0,0,3
Sydney,"McCartin, Tom",8,5,4,3,1,0,0,1
Sydney,"McVeigh, Jarrad",25,13,5,12,0,0,0,3
Sydney,"Papley, Tom",14,9,5,5,2,1,0,2
Sydney,"Parker, Luke",25,14,8,11,2,1,0,4
Sydney,"Rampe, Dane",16,11,6,5,0,0,0,4
Sydney,"Robinson, Dan",10,1,3,9,0,0,1,3
Sydney,"Rohan, Gary",9,5,1,4,2,0,5,2
Sydney,"Ronke, Ben",13,8,2,5,0,1,0,6
Sydney,"Sinclair, Callum",14,11,4,3,3,0,29,3
Sydney,"Smith, Nick",13,2,3,11,0,0,0,1
Sydney,"Aliir, Aliir",18,13,10,5,0,0,0,0
Sydney,"Cunningham, Harry",17,7,4,10,1,0,0,6
Sydney,"Florent, Oliver",29,14,6,15,0,0,0,2
Sydney,"Franklin, Lance",18,14,7,4,2,5,0,3
Sydney,"Grundy, Heath",23,14,7,9,0,0,0,2
Sydney,"Hannebery, Dan",24,3,0,21,0,0,0,2
Sydney,"Hayward, Will",13,11,4,2,1,2,0,1
Sydney,"Heeney, Isaac",22,11,6,11,0,0,0,8
Sydney,"Hewett, George",24,6,3,18,0,0,0,0
Sydney,"Jack, Kieren",17,7,1,10,1,0,0,2
Sydney,"Jones, Zak",20,9,3,11,0,0,0,5
Sydney,"Kennedy, Josh",28,12,2,16,1,2,0,3
Sydney,"Lloyd, Jake",28,20,8,8,0,0,0,1
Sydney,"Marsh, Harrison",17,12,4,5,0,0,0,1
Sydney,"McCartin, Tom",16,7,4,9,0,0,0,3
Sydney,"Papley, Tom",9,6,2,3,2,0,0,2
Sydney,"Parker, Luke",19,12,4,7,0,0,0,5
Sydney,"Rampe, Dane",11,7,2,4,0,0,0,2
Sydney,"Rohan, Gary",10,8,2,2,0,0,1,1
Sydney,"Ronke, Ben",13,9,5,4,2,0,0,4
Sydney,"Sinclair, Callum",14,5,2,9,0,1,16,5
Sydney,"Smith, Nick",20,12,6,8,0,0,0,3
Sydney,"Aliir, Aliir",15,9,5,6,0,0,0,2
Sydney,"Cunningham, Harry",17,10,5,7,0,0,0,3
Sydney,"Florent, Oliver",14,7,1,7,2,0,0,2
Sydney,"Franklin, Lance",9,6,3,3,4,0,0,2
Sydney,"Grundy, Heath",13,5,6,8,0,0,0,5
Sydney,"Hannebery, Dan",20,9,2,11,0,0,0,5
Sydney,"Hayward, Will",12,10,6,2,1,0,0,2
Sydney,"Heeney, Isaac",5,3,0,2,0,0,0,1
Sydney,"Hewett, George",20,7,2,13,0,0,0,7
Sydney,"Jack, Kieren",8,1,0,7,0,0,0,6
Sydney,"Jones, Zak",19,9,4,10,0,0,0,3
Sydney,"Kennedy, Josh",36,11,0,25,0,0,0,9
Sydney,"Lloyd, Jake",34,21,8,13,0,0,0,3
Sydney,"McCartin, Tom",11,7,5,4,0,1,0,3
Sydney,"McVeigh, Jarrad",19,13,5,6,0,0,0,5
Sydney,"Parker, Luke",23,12,2,11,2,0,0,7
Sydney,"Rampe, Dane",13,8,5,5,0,0,0,3
Sydney,"Rohan, Gary",6,5,0,1,0,0,1,0
Sydney,"Ronke, Ben",14,8,3,6,2,0,0,3
Sydney,"Rose, James",7,2,0,5,0,0,0,6
Sydney,"Sinclair, Callum",10,8,1,2,0,0,39,5
Sydney,"Smith, Nick",11,5,3,6,0,0,0,2
Sydney,"Aliir, Aliir",19,7,8,12,0,0,0,2
Sydney,"Cunningham, Harry",19,11,3,8,0,0,0,3
Sydney,"Florent, Oliver",14,7,2,7,1,0,0,2
Sydney,"Fox, Robbie",20,11,4,9,0,1,0,5
Sydney,"Franklin, Lance",10,8,5,2,4,0,0,1
Sydney,"Grundy, Heath",15,8,3,7,0,0,0,0
Sydney,"Hannebery, Dan",12,7,2,5,0,0,0,0
Sydney,"Hayward, Will",11,4,3,7,0,0,0,6
Sydney,"Hewett, George",12,3,1,9,0,0,0,4
Sydney,"Jack, Kieren",2,1,0,1,0,0,0,4
Sydney,"Jones, Zak",21,12,4,9,0,0,0,2
Sydney,"Kennedy, Josh",26,7,0,19,0,0,0,7
Sydney,"Lloyd, Jake",33,23,4,10,0,0,0,3
Sydney,"McCartin, Tom",11,5,4,6,1,1,0,2
Sydney,"McVeigh, Jarrad",16,10,5,6,0,0,0,3
Sydney,"Parker, Luke",23,17,4,6,2,1,0,7
Sydney,"Rampe, Dane",15,8,6,7,0,0,0,3
Sydney,"Robinson, Dan",14,7,1,7,1,0,0,3
Sydney,"Ronke, Ben",12,7,4,5,0,1,0,2
Sydney,"Sinclair, Callum",19,14,4,5,0,0,35,4
Sydney,"Smith, Nick",11,7,2,4,0,0,0,6
Sydney,"Towers, Dean",8,2,0,6,0,0,2,4
Sydney,"Aliir, Aliir",23,12,10,11,1,0,0,0
Sydney,"Cunningham, Harry",20,12,4,8,1,0,0,1
Sydney,"Florent, Oliver",20,9,3,11,0,0,0,1
Sydney,"Fox, Robbie",13,5,3,8,1,0,0,5
Sydney,"Franklin, Lance",19,14,9,5,3,1,0,1
Sydney,"Hayward, Will",16,14,6,2,2,2,0,2
Sydney,"Heeney, Isaac",28,13,3,15,2,0,0,4
Sydney,"Hewett, George",19,7,4,12,0,0,0,5
Sydney,"Jones, Zak",23,6,5,17,0,0,0,1
Sydney,"Kennedy, Josh",10,3,0,7,0,0,0,1
Sydney,"Lloyd, Jake",30,19,3,11,0,0,0,3
Sydney,"Marsh, Harrison",10,6,2,4,0,0,0,1
Sydney,"McCartin, Tom",10,5,8,5,0,1,0,1
Sydney,"Newman, Nic",16,12,4,4,0,0,0,2
Sydney,"ORiordan, Colin",19,9,8,10,0,0,0,5
Sydney,"Papley, Tom",14,10,4,4,1,2,0,4
Sydney,"Parker, Luke",20,11,2,9,0,0,0,1
Sydney,"Rampe, Dane",28,20,10,8,0,0,0,0
Sydney,"Robinson, Dan",11,5,6,6,0,0,0,1
Sydney,"Ronke, Ben",16,13,3,3,5,1,0,0
Sydney,"Sinclair, Callum",15,10,3,5,0,1,25,8
Sydney,"Smith, Nick",11,4,5,7,0,0,0,5
Sydney,"Aliir, Aliir",24,15,7,9,0,0,0,2
Sydney,"Cameron, Darcy",3,1,2,2,0,0,9,2
Sydney,"Cunningham, Harry",24,11,5,13,0,0,0,5
Sydney,"Florent, Oliver",18,10,1,8,1,0,0,4
Sydney,"Fox, Robbie",9,2,4,7,0,0,0,5
Sydney,"Franklin, Lance",15,10,6,5,0,3,0,3
Sydney,"Hayward, Will",12,9,3,3,1,1,0,3
Sydney,"Heeney, Isaac",20,12,2,8,0,1,0,2
Sydney,"Hewett, George",19,6,3,13,0,1,0,6
Sydney,"Jones, Zak",20,8,4,12,1,0,0,2
Sydney,"Kennedy, Josh",33,16,5,17,0,2,0,8
Sydney,"Lloyd, Jake",25,16,2,9,0,0,0,1
Sydney,"Marsh, Harrison",15,12,7,3,0,0,0,2
Sydney,"McCartin, Tom",11,3,2,8,0,0,0,2
Sydney,"Newman, Nic",20,12,6,8,0,0,0,6
Sydney,"ORiordan, Colin",20,9,7,11,0,1,0,1
Sydney,"Papley, Tom",12,7,1,5,3,1,0,4
Sydney,"Parker, Luke",29,15,2,14,2,0,0,7
Sydney,"Rampe, Dane",22,10,2,12,0,0,0,4
Sydney,"Ronke, Ben",12,8,2,4,0,2,0,6
Sydney,"Sinclair, Callum",11,7,4,4,0,2,24,3
Sydney,"Smith, Nick",6,2,3,4,0,0,0,5
Sydney,"Aliir, Aliir",12,10,9,2,0,0,0,0
Sydney,"Cunningham, Harry",20,13,6,7,0,0,0,1
Sydney,"Dawson, Jordan",12,7,5,5,1,1,2,1
Sydney,"Florent, Oliver",19,13,3,6,0,0,0,3
Sydney,"Fox, Robbie",12,6,6,6,0,1,0,3
Sydney,"Franklin, Lance",7,5,2,2,2,1,0,1
Sydney,"Grundy, Heath",8,5,4,3,1,0,0,1
Sydney,"Hayward, Will",8,4,1,4,0,1,0,4
Sydney,"Heeney, Isaac",21,15,3,6,1,0,0,5
Sydney,"Hewett, George",13,5,3,8,0,0,0,2
Sydney,"Jones, Zak",17,10,7,7,0,0,0,2
Sydney,"Kennedy, Josh",23,10,1,13,0,1,0,6
Sydney,"Lloyd, Jake",29,19,3,10,0,0,0,2
Sydney,"McCartin, Tom",8,5,5,3,0,1,0,0
Sydney,"Newman, Nic",14,9,4,5,1,0,0,3
Sydney,"ORiordan, Colin",10,6,2,4,0,0,0,1
Sydney,"Papley, Tom",17,9,8,8,1,0,0,2
Sydney,"Parker, Luke",21,13,7,8,1,0,0,3
Sydney,"Rampe, Dane",17,10,5,7,0,0,0,0
Sydney,"Ronke, Ben",12,8,2,4,1,0,0,3
Sydney,"Sinclair, Callum",14,9,4,5,1,0,35,2
Sydney,"Smith, Nick",12,6,5,6,0,0,0,2
Sydney,"Aliir, Aliir",24,15,12,9,0,0,0,2
Sydney,"Cunningham, Harry",18,9,4,9,0,0,0,7
Sydney,"Dawson, Jordan",13,6,4,7,2,0,0,6
Sydney,"Florent, Oliver",12,5,0,7,0,0,0,3
Sydney,"Franklin, Lance",17,15,9,2,6,4,0,6
Sydney,"Hayward, Will",6,1,0,5,0,0,0,3
Sydney,"Heeney, Isaac",14,9,4,5,0,0,0,4
Sydney,"Hewett, George",25,10,3,15,0,0,0,5
Sydney,"Jack, Kieren",9,7,2,2,0,0,0,5
Sydney,"Johnson, Alex",15,11,11,4,0,0,0,4
Sydney,"Kennedy, Josh",21,8,1,13,1,0,0,2
Sydney,"Lloyd, Jake",27,19,6,8,0,0,0,0
Sydney,"McCartin, Tom",6,3,1,3,1,0,0,1
Sydney,"McVeigh, Jarrad",26,16,7,10,0,0,0,0
Sydney,"Newman, Nic",24,15,12,9,0,0,0,2
Sydney,"Papley, Tom",12,7,3,5,0,0,0,4
Sydney,"Parker, Luke",24,11,1,13,0,1,0,7
Sydney,"Rampe, Dane",28,18,11,10,0,0,0,3
Sydney,"Robinson, Dan",14,8,6,6,0,0,0,1
Sydney,"Ronke, Ben",10,7,2,3,1,0,0,6
Sydney,"Sinclair, Callum",19,10,7,9,0,0,16,3
Sydney,"Smith, Nick",16,10,7,6,0,0,0,3
Sydney,"Aliir, Aliir",15,12,10,3,0,0,3,1
Sydney,"Cunningham, Harry",20,13,9,7,1,0,0,2
Sydney,"Dawson, Jordan",15,13,9,2,1,1,2,3
Sydney,"Florent, Oliver",18,10,5,8,0,0,0,3
Sydney,"Franklin, Lance",19,16,9,3,2,5,0,3
Sydney,"Hannebery, Dan",26,12,4,14,1,0,0,3
Sydney,"Hayward, Will",14,10,7,4,1,1,0,3
Sydney,"Heeney, Isaac",19,11,6,8,2,0,0,5
Sydney,"Hewett, George",24,14,3,10,0,0,0,8
Sydney,"Jack, Kieren",16,9,3,7,0,0,0,2
Sydney,"Johnson, Alex",4,1,1,3,0,0,0,1
Sydney,"Kennedy, Josh",28,12,4,16,1,0,0,7
Sydney,"Lloyd, Jake",31,21,10,10,0,0,0,1
Sydney,"McCartin, Tom",10,6,6,4,1,0,0,3
Sydney,"McVeigh, Jarrad",15,8,6,7,0,0,0,3
Sydney,"Newman, Nic",22,18,12,4,0,0,0,5
Sydney,"Papley, Tom",16,10,3,6,3,2,0,4
Sydney,"Parker, Luke",19,8,7,11,0,0,1,6
Sydney,"Rampe, Dane",12,4,3,8,0,0,0,3
Sydney,"Ronke, Ben",13,7,1,6,0,0,0,4
Sydney,"Sinclair, Callum",13,9,2,4,0,0,13,6
Sydney,"Smith, Nick",2,0,0,2,0,0,0,1
Sydney,"Aliir, Aliir",15,11,7,4,0,0,0,1
Sydney,"Cunningham, Harry",19,11,4,8,0,0,0,6
Sydney,"Florent, Oliver",15,6,4,9,0,0,0,5
Sydney,"Fox, Robbie",4,2,0,2,0,0,3,3
Sydney,"Franklin, Lance",16,15,8,1,5,4,0,3
Sydney,"Hannebery, Dan",15,11,4,4,0,0,0,3
Sydney,"Hayward, Will",14,11,3,3,1,1,0,5
Sydney,"Heeney, Isaac",13,5,3,8,0,1,0,10
Sydney,"Hewett, George",16,4,1,12,0,0,0,3
Sydney,"Jack, Kieren",22,15,3,7,2,1,0,1
Sydney,"Jones, Zak",23,11,3,12,0,1,0,1
Sydney,"Kennedy, Josh",27,14,4,13,0,2,0,3
Sydney,"Lloyd, Jake",30,17,9,13,0,1,0,3
Sydney,"McCartin, Tom",10,3,1,7,1,0,0,4
Sydney,"McVeigh, Jarrad",22,13,4,9,0,0,0,3
Sydney,"Newman, Nic",20,9,3,11,0,0,0,2
Sydney,"Papley, Tom",9,6,1,3,0,0,0,3
Sydney,"Parker, Luke",33,21,7,12,2,2,0,5
Sydney,"Rampe, Dane",11,7,2,4,0,0,0,5
Sydney,"Robinson, Dan",10,5,2,5,0,0,0,2
Sydney,"Ronke, Ben",14,5,1,9,0,0,0,2
Sydney,"Sinclair, Callum",13,8,4,5,0,0,34,3
Sydney,"Aliir, Aliir",10,6,3,4,0,0,2,1
Sydney,"Cunningham, Harry",18,14,3,4,1,1,0,6
Sydney,"Dawson, Jordan",9,7,4,2,0,1,1,2
Sydney,"Florent, Oliver",14,8,2,6,1,2,0,6
Sydney,"Fox, Robbie",7,4,3,3,0,0,0,0
Sydney,"Grundy, Heath",22,10,6,12,0,0,0,0
Sydney,"Hannebery, Dan",12,6,2,6,0,0,0,3
Sydney,"Hayward, Will",14,7,2,7,0,2,0,3
Sydney,"Heeney, Isaac",18,9,3,9,2,0,0,9
Sydney,"Hewett, George",24,11,0,13,0,0,0,6
Sydney,"Jack, Kieren",13,13,2,0,1,2,0,4
Sydney,"Jones, Zak",11,6,4,5,0,0,0,1
Sydney,"Kennedy, Josh",20,10,1,10,1,2,0,9
Sydney,"Lloyd, Jake",31,23,9,8,0,0,0,4
Sydney,"McCartin, Tom",9,4,2,5,1,1,0,4
Sydney,"McVeigh, Jarrad",18,13,5,5,0,0,0,3
Sydney,"Newman, Nic",16,12,6,4,0,0,0,6
Sydney,"Papley, Tom",16,9,3,7,2,1,0,1
Sydney,"Rampe, Dane",18,12,8,6,0,0,0,2
Sydney,"Robinson, Dan",9,2,1,7,0,0,0,4
Sydney,"Ronke, Ben",10,8,1,2,0,0,0,6
Sydney,"Sinclair, Callum",15,13,6,2,1,1,28,1
Sydney,"Aliir, Aliir",15,7,8,8,0,0,0,0
Sydney,"Cunningham, Harry",25,15,7,10,0,0,0,5
Sydney,"Florent, Oliver",11,8,3,3,0,0,0,1
Sydney,"Franklin, Lance",8,5,2,3,0,1,0,0
Sydney,"Grundy, Heath",15,11,7,4,0,0,0,0
Sydney,"Hannebery, Dan",24,17,8,7,0,1,0,3
Sydney,"Hayward, Will",8,5,4,3,0,0,0,3
Sydney,"Heeney, Isaac",20,13,4,7,0,1,2,3
Sydney,"Hewett, George",17,7,3,10,0,0,0,5
Sydney,"Jack, Kieren",15,11,2,4,0,0,0,6
Sydney,"Jones, Zak",17,8,3,9,0,0,0,1
Sydney,"Kennedy, Josh",27,9,3,18,0,0,0,3
Sydney,"Lloyd, Jake",17,15,9,2,0,0,0,0
Sydney,"McCartin, Tom",3,3,2,0,0,0,0,2
Sydney,"McVeigh, Jarrad",14,11,5,3,0,0,0,2
Sydney,"Newman, Nic",15,12,4,3,0,0,0,1
Sydney,"Papley, Tom",17,12,5,5,2,2,0,1
Sydney,"Parker, Luke",21,15,6,6,1,0,0,9
Sydney,"Rampe, Dane",17,10,6,7,0,0,0,2
Sydney,"Robinson, Dan",14,10,8,4,0,0,0,2
Sydney,"Ronke, Ben",10,5,2,5,1,0,0,1
Sydney,"Sinclair, Callum",8,6,0,2,0,0,33,3
West Coast,"Barrass, Tom",20,15,8,5,0,0,0,1
West Coast,"Cripps, Jamie",16,11,1,5,0,0,0,1
West Coast,"Darling, Jack",12,7,5,5,3,0,1,4
West Coast,"Duggan, Liam",10,8,1,2,1,0,0,2
West Coast,"Gaff, Andrew",24,15,5,9,0,0,0,4
West Coast,"Hurn, Shannon",23,20,10,3,1,1,0,3
West Coast,"Jetta, Lewis",16,13,4,3,0,0,0,1
West Coast,"LeCras, Mark",16,13,4,3,3,2,0,9
West Coast,"Lycett, Scott",10,6,2,4,0,0,32,1
West Coast,"Masten, Chris",15,10,4,5,1,0,0,0
West Coast,"McGovern, Jeremy",18,11,9,7,0,0,0,2
West Coast,"Naitanui, Nic",12,9,3,3,1,1,33,3
West Coast,"Nelson, Jackson",5,4,0,1,0,1,0,2
West Coast,"Redden, Jack",18,7,3,11,0,0,0,6
West Coast,"Ryan, Liam",12,9,3,3,1,1,0,1
West Coast,"Schofield, Will",8,5,4,3,0,0,0,1
West Coast,"Sheed, Dom",23,15,2,8,0,0,0,1
West Coast,"Sheppard, Brad",15,6,4,9,0,0,0,5
West Coast,"Shuey, Luke",25,16,4,9,0,1,0,6
West Coast,"Venables, Daniel",7,4,1,3,0,0,0,4
West Coast,"Waterman, Jake",8,4,2,4,1,0,0,3
West Coast,"Yeo, Elliot",26,18,5,8,1,0,0,4
West Coast,"Barrass, Tom",14,11,6,3,0,0,0,2
West Coast,"Cripps, Jamie",16,10,6,6,1,0,0,3
West Coast,"Darling, Jack",16,10,11,6,4,0,0,1
West Coast,"Duggan, Liam",17,14,6,3,0,1,0,1
West Coast,"Gaff, Andrew",27,16,5,11,1,0,0,1
West Coast,"Hurn, Shannon",29,22,10,7,0,0,0,2
West Coast,"Jetta, Lewis",23,15,8,8,0,0,0,0
West Coast,"LeCras, Mark",16,11,4,5,2,0,0,5
West Coast,"Lycett, Scott",15,12,5,3,2,1,21,6
West Coast,"Masten, Chris",20,11,4,9,0,0,0,1
West Coast,"McGovern, Jeremy",14,11,8,3,0,1,0,0
West Coast,"Naitanui, Nic",8,5,1,3,0,0,33,3
West Coast,"Nelson, Jackson",11,10,7,1,0,0,0,2
West Coast,"Redden, Jack",17,8,5,9,0,0,0,4
West Coast,"Rioli, Willie",8,5,2,3,0,1,0,2
West Coast,"Ryan, Liam",14,11,6,3,3,3,0,3
West Coast,"Sheed, Dom",18,11,2,7,0,0,0,2
West Coast,"Sheppard, Brad",14,10,6,4,0,0,0,1
West Coast,"Shuey, Luke",18,10,4,8,0,0,0,3
West Coast,"Venables, Daniel",12,9,7,3,3,1,0,0
West Coast,"Waterman, Jake",13,7,4,6,2,0,0,0
West Coast,"Yeo, Elliot",20,16,7,4,0,0,0,7
West Coast,"Barrass, Tom",8,6,3,2,0,0,0,0
West Coast,"Cripps, Jamie",13,9,6,4,0,1,0,5
West Coast,"Darling, Jack",12,5,4,7,2,1,1,1
West Coast,"Gaff, Andrew",29,19,8,10,1,0,0,3
West Coast,"Hurn, Shannon",21,17,8,4,0,0,0,1
West Coast,"Hutchings, Mark",21,12,6,9,0,1,0,4
West Coast,"Jetta, Lewis",12,8,3,4,0,0,0,1
West Coast,"LeCras, Mark",12,9,6,3,3,2,0,2
West Coast,"Lycett, Scott",10,6,2,4,0,0,16,4
West Coast,"Masten, Chris",18,8,7,10,0,1,0,4
West Coast,"McGovern, Jeremy",11,6,2,5,0,0,0,0
West Coast,"Naitanui, Nic",9,4,0,5,1,0,39,6
West Coast,"Nelson, Jackson",7,5,4,2,0,0,0,0
West Coast,"Redden, Jack",19,13,2,6,1,0,0,4
West Coast,"Rioli, Willie",12,8,2,4,0,0,0,2
West Coast,"Ryan, Liam",12,11,4,1,3,0,0,3
West Coast,"Sheed, Dom",30,20,6,10,2,2,0,1
West Coast,"Sheppard, Brad",17,13,7,4,0,0,0,2
West Coast,"Shuey, Luke",28,18,1,10,1,0,0,4
West Coast,"Venables, Daniel",9,5,2,4,0,1,0,0
West Coast,"Waterman, Jake",20,16,9,4,0,1,0,2
West Coast,"Yeo, Elliot",12,9,3,3,0,0,0,4
West Coast,"Barrass, Tom",20,18,8,2,0,0,0,0
West Coast,"Cripps, Jamie",17,10,4,7,4,0,0,4
West Coast,"Darling, Jack",19,10,9,9,3,1,0,2
West Coast,"Duggan, Liam",18,10,3,8,0,0,0,3
West Coast,"Gaff, Andrew",32,17,9,15,0,1,0,3
West Coast,"Hurn, Shannon",22,17,14,5,0,0,0,1
West Coast,"Jetta, Lewis",17,13,4,4,0,0,0,4
West Coast,"Kennedy, Josh",13,12,2,1,5,3,0,0
West Coast,"LeCras, Mark",14,10,3,4,2,1,0,3
West Coast,"Lycett, Scott",14,4,4,10,1,0,12,0
West Coast,"Masten, Chris",30,20,12,10,2,1,0,2
West Coast,"McGovern, Jeremy",22,19,13,3,0,0,0,0
West Coast,"Naitanui, Nic",14,7,4,7,0,0,33,1
West Coast,"Nelson, Jackson",12,8,3,4,0,0,0,2
West Coast,"Redden, Jack",10,6,1,4,0,0,0,5
West Coast,"Rioli, Willie",10,8,6,2,2,0,0,1
West Coast,"Sheed, Dom",29,12,5,17,0,0,0,1
West Coast,"Sheppard, Brad",15,8,3,7,0,0,0,3
West Coast,"Shuey, Luke",22,14,4,8,0,0,0,2
West Coast,"Venables, Daniel",11,2,2,9,1,1,0,4
West Coast,"Waterman, Jake",10,6,3,4,1,1,0,1
West Coast,"Yeo, Elliot",33,25,11,8,0,1,0,5
West Coast,"Barrass, Tom",3,3,2,0,0,0,0,0
West Coast,"Cole, Tom",19,10,6,9,0,1,0,2
West Coast,"Cripps, Jamie",20,13,9,7,0,0,0,3
West Coast,"Darling, Jack",8,7,4,1,0,1,0,2
West Coast,"Duggan, Liam",13,8,5,5,0,0,0,0
West Coast,"Gaff, Andrew",31,17,1,14,2,0,0,1
West Coast,"Hurn, Shannon",12,11,6,1,0,0,0,3
West Coast,"Hutchings, Mark",16,9,6,7,0,2,0,2
West Coast,"Kennedy, Josh",5,4,2,1,1,1,0,2
West Coast,"LeCras, Mark",13,12,4,1,3,2,0,0
West Coast,"Lycett, Scott",13,7,4,6,1,1,23,6
West Coast,"Masten, Chris",27,15,6,12,1,0,0,1
West Coast,"McGovern, Jeremy",13,10,5,3,0,0,0,1
West Coast,"Naitanui, Nic",8,5,2,3,0,1,26,6
West Coast,"Nelson, Jackson",9,6,3,3,0,0,0,0
West Coast,"Redden, Jack",17,11,4,6,0,0,0,8
West Coast,"Rioli, Willie",16,10,2,6,1,3,0,2
West Coast,"Sheed, Dom",18,13,3,5,0,1,0,2
West Coast,"Sheppard, Brad",13,8,3,5,0,0,0,3
West Coast,"Shuey, Luke",24,12,3,12,1,0,0,6
West Coast,"Waterman, Jake",10,5,5,5,0,1,0,2
West Coast,"Yeo, Elliot",26,12,3,14,0,1,0,11
West Coast,"Barrass, Tom",7,6,3,1,0,0,0,1
West Coast,"Cole, Tom",12,8,1,4,0,0,0,10
West Coast,"Cripps, Jamie",15,7,5,8,0,1,0,4
West Coast,"Darling, Jack",18,13,7,5,3,1,0,3
West Coast,"Duggan, Liam",18,12,6,6,0,0,0,0
West Coast,"Gaff, Andrew",32,20,8,12,0,0,0,3
West Coast,"Hurn, Shannon",31,24,11,7,0,0,0,1
West Coast,"Jetta, Lewis",12,9,5,3,0,0,0,0
West Coast,"Kennedy, Josh",7,5,4,2,3,1,0,0
West Coast,"LeCras, Mark",16,15,2,1,1,2,0,4
West Coast,"Lycett, Scott",18,6,4,12,0,0,20,3
West Coast,"Masten, Chris",17,10,7,7,0,0,0,5
West Coast,"McGovern, Jeremy",19,14,10,5,0,0,0,0
West Coast,"Naitanui, Nic",8,4,1,4,0,1,32,2
West Coast,"Petruccelle, Jack",4,1,1,3,0,0,0,1
West Coast,"Redden, Jack",34,16,6,18,1,1,0,4
West Coast,"Rioli, Willie",9,6,3,3,0,2,0,2
West Coast,"Sheed, Dom",23,16,2,7,1,0,0,3
West Coast,"Sheppard, Brad",11,10,7,1,0,0,0,0
West Coast,"Shuey, Luke",27,13,4,14,1,0,0,6
West Coast,"Waterman, Jake",14,8,5,6,2,1,0,4
West Coast,"Yeo, Elliot",19,12,3,7,1,0,0,7
West Coast,"Barrass, Tom",6,3,3,3,0,0,0,0
West Coast,"Cole, Tom",21,6,4,15,0,0,0,0
West Coast,"Cripps, Jamie",15,10,4,5,1,2,0,7
West Coast,"Darling, Jack",18,13,10,5,3,2,0,4
West Coast,"Duggan, Liam",19,13,1,6,0,0,0,2
West Coast,"Gaff, Andrew",35,18,3,17,0,0,0,3
West Coast,"Hurn, Shannon",22,20,6,2,0,0,0,0
West Coast,"Hutchings, Mark",27,15,2,12,1,0,0,10
West Coast,"Kennedy, Josh",9,8,3,1,4,1,0,1
West Coast,"LeCras, Mark",17,12,3,5,1,0,0,2
West Coast,"Lycett, Scott",16,8,3,8,0,0,25,3
West Coast,"Masten, Chris",19,13,6,6,0,0,0,3
West Coast,"McGovern, Jeremy",13,8,4,5,0,0,0,1
West Coast,"Naitanui, Nic",11,5,2,6,0,0,31,4
West Coast,"Nelson, Jackson",14,8,4,6,0,0,0,0
West Coast,"Petruccelle, Jack",7,4,1,3,2,0,0,1
West Coast,"Redden, Jack",32,21,7,11,1,0,0,6
West Coast,"Rioli, Willie",16,12,5,4,2,0,0,2
West Coast,"Sheppard, Brad",18,15,6,3,0,0,0,0
West Coast,"Shuey, Luke",3,0,1,3,0,0,0,0
West Coast,"Waterman, Jake",11,6,3,5,1,0,0,1
West Coast,"Yeo, Elliot",26,12,4,14,0,0,0,4
West Coast,"Ah Chee, Brendon",21,10,7,11,0,1,0,5
West Coast,"Ainsworth, Brayden",15,7,3,8,0,0,0,8
West Coast,"Barrass, Tom",15,14,11,1,0,0,0,0
West Coast,"Cole, Tom",9,7,2,2,0,0,0,5
West Coast,"Cripps, Jamie",17,12,4,5,1,5,0,4
West Coast,"Darling, Jack",19,14,9,5,4,3,0,6
West Coast,"Duggan, Liam",19,12,4,7,1,0,0,5
West Coast,"Gaff, Andrew",32,12,3,20,0,0,0,1
West Coast,"Hurn, Shannon",24,21,5,3,0,1,0,1
West Coast,"Hutchings, Mark",19,13,3,6,0,1,0,9
West Coast,"Kennedy, Josh",7,4,3,3,2,1,0,1
West Coast,"LeCras, Mark",13,9,0,4,0,0,0,3
West Coast,"Lycett, Scott",13,8,2,5,0,0,30,3
West Coast,"Masten, Chris",19,9,5,10,0,0,0,1
West Coast,"McInnes, Fraser",11,3,3,8,0,0,6,2
West Coast,"Nelson, Jackson",11,10,4,1,0,0,0,1
West Coast,"Redden, Jack",29,20,2,9,0,0,0,4
West Coast,"Rioli, Willie",9,6,4,3,1,0,0,4
West Coast,"Schofield, Will",7,5,2,2,0,0,0,0
West Coast,"Sheppard, Brad",23,12,8,11,0,0,0,2
West Coast,"Waterman, Jake",12,7,4,5,3,0,0,1
West Coast,"Yeo, Elliot",28,13,3,15,0,0,0,8
West Coast,"Ah Chee, Brendon",9,4,3,5,0,0,0,2
West Coast,"Barrass, Tom",9,8,3,1,0,0,0,2
West Coast,"Cole, Tom",14,8,5,6,0,0,0,3
West Coast,"Cripps, Jamie",7,5,5,2,2,0,0,0
West Coast,"Darling, Jack",21,20,15,1,6,2,0,2
West Coast,"Duggan, Liam",18,12,4,6,0,0,0,4
West Coast,"Gaff, Andrew",24,14,8,10,1,0,0,3
West Coast,"Hurn, Shannon",20,16,8,4,0,0,0,1
West Coast,"Hutchings, Mark",20,11,2,9,0,0,0,2
West Coast,"Jetta, Lewis",14,7,0,7,0,0,0,4
West Coast,"Kennedy, Josh",13,9,5,4,3,2,0,0
West Coast,"LeCras, Mark",17,11,5,6,3,0,0,4
West Coast,"Lycett, Scott",13,7,4,6,0,1,20,2
West Coast,"Masten, Chris",16,10,6,6,0,1,0,2
West Coast,"McGovern, Jeremy",14,11,9,3,1,0,0,3
West Coast,"Naitanui, Nic",12,4,1,8,0,0,30,7
West Coast,"Redden, Jack",23,13,6,10,2,0,0,1
West Coast,"Rioli, Willie",12,10,3,2,1,0,0,0
West Coast,"Sheed, Dom",17,10,4,7,0,0,0,1
West Coast,"Sheppard, Brad",18,11,8,7,0,0,0,4
West Coast,"Waterman, Jake",11,9,5,2,0,1,0,0
West Coast,"Yeo, Elliot",29,18,2,11,1,1,0,6
West Coast,"Ah Chee, Brendon",14,7,2,7,0,0,0,3
West Coast,"Barrass, Tom",12,10,9,2,0,0,0,2
West Coast,"Cole, Tom",10,8,3,2,0,0,0,1
West Coast,"Cripps, Jamie",8,6,3,2,1,0,0,2
West Coast,"Darling, Jack",15,5,4,10,0,0,0,3
West Coast,"Duggan, Liam",15,9,6,6,0,0,0,4
West Coast,"Gaff, Andrew",35,24,12,11,1,0,0,5
West Coast,"Hurn, Shannon",17,12,4,5,0,0,0,2
West Coast,"Hutchings, Mark",18,14,0,4,0,0,0,5
West Coast,"Jetta, Lewis",12,7,4,5,0,0,0,2
West Coast,"Kennedy, Josh",15,10,5,5,3,0,0,1
West Coast,"LeCras, Mark",18,12,6,6,1,1,0,3
West Coast,"Lycett, Scott",17,12,4,5,0,0,18,1
West Coast,"Masten, Chris",11,4,4,7,1,0,0,0
West Coast,"McGovern, Jeremy",11,8,6,3,0,0,0,2
West Coast,"Naitanui, Nic",12,5,2,7,1,0,34,6
West Coast,"Redden, Jack",25,14,5,11,0,0,0,4
West Coast,"Rioli, Willie",13,11,5,2,2,1,0,3
West Coast,"Sheed, Dom",22,10,5,12,0,1,0,5
West Coast,"Sheppard, Brad",20,10,7,10,0,0,0,3
West Coast,"Waterman, Jake",9,7,7,2,1,1,0,1
West Coast,"Yeo, Elliot",28,15,3,13,0,0,0,5
West Coast,"Ah Chee, Brendon",14,9,5,5,0,1,0,3
West Coast,"Barrass, Tom",16,13,11,3,0,0,0,1
West Coast,"Cole, Tom",21,11,5,10,0,0,0,0
West Coast,"Cripps, Jamie",14,8,3,6,2,0,0,6
West Coast,"Darling, Jack",2,1,0,1,0,0,0,0
West Coast,"Duggan, Liam",18,15,6,3,0,0,0,1
West Coast,"Gaff, Andrew",29,16,7,13,1,0,0,1
West Coast,"Hurn, Shannon",23,21,12,2,0,0,0,1
West Coast,"Hutchings, Mark",17,9,4,8,0,0,0,4
West Coast,"Jetta, Lewis",18,13,6,5,0,0,0,2
West Coast,"Kennedy, Josh",15,9,7,6,6,1,0,3
West Coast,"LeCras, Mark",6,3,3,3,2,0,0,6
West Coast,"Lycett, Scott",14,9,4,5,0,1,20,3
West Coast,"McGovern, Jeremy",21,15,12,6,0,0,0,2
West Coast,"Naitanui, Nic",17,5,2,12,2,0,18,6
West Coast,"Nelson, Jackson",9,9,6,0,0,0,0,0
West Coast,"Redden, Jack",22,10,7,12,0,0,0,2
West Coast,"Rioli, Willie",9,7,2,2,1,1,0,2
West Coast,"Sheed, Dom",26,15,3,11,1,0,0,2
West Coast,"Sheppard, Brad",15,11,8,4,0,0,0,1
West Coast,"Waterman, Jake",10,10,7,0,1,0,0,2
West Coast,"Yeo, Elliot",20,11,5,9,0,1,0,5
West Coast,"Brander, Jarrod",5,5,3,0,0,1,0,1
West Coast,"Cole, Tom",12,9,2,3,0,0,0,2
West Coast,"Cripps, Jamie",14,11,5,3,0,0,0,5
West Coast,"Duggan, Liam",19,14,3,5,0,0,0,0
West Coast,"Gaff, Andrew",24,11,1,13,0,1,0,4
West Coast,"Hurn, Shannon",14,10,9,4,0,0,0,1
West Coast,"Jetta, Lewis",13,9,3,4,0,0,0,1
West Coast,"Kennedy, Josh",8,7,4,1,2,1,0,2
West Coast,"LeCras, Mark",19,9,6,10,0,1,0,2
West Coast,"Lycett, Scott",13,9,3,4,1,0,16,3
West Coast,"Masten, Chris",23,13,9,10,0,1,0,5
West Coast,"McGovern, Jeremy",13,10,6,3,0,0,0,2
West Coast,"Naitanui, Nic",15,8,2,7,0,1,32,1
West Coast,"Nelson, Jackson",16,13,2,3,0,0,0,0
West Coast,"Redden, Jack",28,10,5,18,0,0,0,2
West Coast,"Rioli, Willie",7,3,0,4,0,0,0,5
West Coast,"Ryan, Liam",12,8,3,4,1,2,0,2
West Coast,"Sheed, Dom",11,2,1,9,0,1,0,4
West Coast,"Sheppard, Brad",14,11,3,3,0,0,0,2
West Coast,"Shuey, Luke",14,8,1,6,0,1,0,4
West Coast,"Waterman, Jake",10,4,4,6,1,0,0,1
West Coast,"Yeo, Elliot",29,23,5,6,2,1,0,8
West Coast,"Cole, Tom",13,7,1,6,0,0,0,3
West Coast,"Cripps, Jamie",16,9,5,7,2,1,0,5
West Coast,"Duggan, Liam",17,14,6,3,0,0,0,3
West Coast,"Gaff, Andrew",32,20,4,12,0,0,0,4
West Coast,"Hurn, Shannon",24,15,9,9,0,0,0,1
West Coast,"Hutchings, Mark",10,7,2,3,0,0,0,4
West Coast,"Jetta, Lewis",19,11,5,8,0,0,0,1
West Coast,"LeCras, Mark",11,7,4,4,1,2,0,1
West Coast,"Lycett, Scott",14,5,2,9,0,2,15,1
West Coast,"Masten, Chris",17,10,5,7,0,0,0,3
West Coast,"McGovern, Jeremy",12,9,6,3,0,0,0,1
West Coast,"McInnes, Fraser",8,8,4,0,0,3,0,1
West Coast,"Naitanui, Nic",9,5,0,4,1,1,34,3
West Coast,"Nelson, Jackson",6,6,3,0,0,1,0,1
West Coast,"Redden, Jack",26,13,6,13,0,0,0,4
West Coast,"Rioli, Willie",9,5,2,4,1,0,0,3
West Coast,"Ryan, Liam",7,6,3,1,0,1,0,0
West Coast,"Schofield, Will",7,5,4,2,0,0,0,2
West Coast,"Sheppard, Brad",16,12,6,4,0,0,0,6
West Coast,"Shuey, Luke",18,12,2,6,1,0,0,5
West Coast,"Waterman, Jake",6,4,3,2,0,1,0,1
West Coast,"Yeo, Elliot",22,13,5,9,0,1,0,12
West Coast,"Ah Chee, Brendon",13,6,5,7,1,0,0,2
West Coast,"Ainsworth, Brayden",12,7,2,5,0,0,0,2
West Coast,"Cole, Tom",10,5,2,5,0,0,0,3
West Coast,"Cripps, Jamie",18,9,6,9,2,0,0,7
West Coast,"Duggan, Liam",13,11,3,2,0,0,0,2
West Coast,"Gaff, Andrew",37,25,6,12,1,0,0,7
West Coast,"Hurn, Shannon",24,17,6,7,0,0,0,4
West Coast,"Hutchings, Mark",25,22,6,3,0,0,0,6
West Coast,"Jetta, Lewis",13,6,3,7,0,0,0,0
West Coast,"Lycett, Scott",9,5,0,4,2,1,13,2
West Coast,"Masten, Chris",22,16,8,6,0,0,0,0
West Coast,"McGovern, Jeremy",9,8,5,1,2,1,0,1
West Coast,"McInnes, Fraser",6,4,2,2,1,0,0,5
West Coast,"Naitanui, Nic",7,5,1,2,0,0,34,6
West Coast,"Redden, Jack",21,8,5,13,0,0,0,10
West Coast,"Rioli, Willie",10,5,5,5,0,0,0,3
West Coast,"Ryan, Liam",5,3,1,2,1,1,0,1
West Coast,"Schofield, Will",6,5,2,1,0,0,0,2
West Coast,"Sheppard, Brad",19,15,9,4,0,0,0,4
West Coast,"Shuey, Luke",26,13,1,13,1,0,0,10
West Coast,"Waterman, Jake",11,9,5,2,0,0,0,1
West Coast,"Yeo, Elliot",19,12,6,7,1,0,0,3
West Coast,"Ah Chee, Brendon",8,7,4,1,0,2,0,1
West Coast,"Ainsworth, Brayden",14,13,5,1,1,0,0,3
West Coast,"Allen, Oscar",7,4,2,3,0,0,0,3
West Coast,"Cole, Tom",8,5,3,3,0,0,0,3
West Coast,"Cripps, Jamie",17,12,9,5,2,0,0,3
West Coast,"Duggan, Liam",15,13,8,2,0,0,0,0
West Coast,"Gaff, Andrew",41,22,6,19,2,0,0,3
West Coast,"Hurn, Shannon",24,20,7,4,0,0,0,1
West Coast,"Hutchings, Mark",16,8,4,8,2,0,0,1
West Coast,"Jetta, Lewis",12,11,6,1,0,0,0,0
West Coast,"Lycett, Scott",8,6,6,2,1,0,0,4
West Coast,"Masten, Chris",17,12,10,5,0,0,0,0
West Coast,"McGovern, Jeremy",6,3,2,3,2,0,0,3
West Coast,"Naitanui, Nic",15,9,3,6,0,0,41,8
West Coast,"Redden, Jack",32,18,9,14,1,1,0,6
West Coast,"Rioli, Willie",8,5,3,3,2,0,0,2
West Coast,"Schofield, Will",10,8,5,2,0,0,0,2
West Coast,"Sheppard, Brad",9,6,3,3,0,0,0,3
West Coast,"Shuey, Luke",32,16,4,16,0,1,0,3
West Coast,"Vardy, Nathan",5,2,0,3,0,0,17,1
West Coast,"Venables, Daniel",4,1,1,3,0,0,0,6
West Coast,"Yeo, Elliot",32,19,6,13,0,2,0,4
West Coast,"Cole, Tom",12,5,2,7,0,0,0,2
West Coast,"Cripps, Jamie",9,4,2,5,0,0,0,2
West Coast,"Darling, Jack",12,11,2,1,3,3,0,3
West Coast,"Duggan, Liam",14,11,5,3,0,1,0,4
West Coast,"Gaff, Andrew",30,24,5,6,1,0,0,2
West Coast,"Hurn, Shannon",25,22,11,3,0,0,0,1
West Coast,"Hutchings, Mark",15,10,5,5,1,0,0,4
West Coast,"Jetta, Lewis",17,13,10,4,0,0,0,1
West Coast,"Kennedy, Josh",10,8,5,2,3,1,0,3
West Coast,"LeCras, Mark",18,10,4,8,2,1,0,3
West Coast,"Lycett, Scott",9,5,1,4,0,1,17,4
West Coast,"Masten, Chris",16,11,4,5,0,0,0,3
West Coast,"McGovern, Jeremy",22,18,12,4,0,0,0,2
West Coast,"Naitanui, Nic",6,2,1,4,0,0,9,2
West Coast,"Redden, Jack",30,18,8,12,1,0,0,7
West Coast,"Rioli, Willie",12,10,4,2,3,0,0,2
West Coast,"Schofield, Will",7,7,4,0,0,0,0,2
West Coast,"Sheppard, Brad",17,13,12,4,0,0,0,1
West Coast,"Shuey, Luke",30,15,5,15,0,0,0,6
West Coast,"Venables, Daniel",12,4,5,8,0,1,0,2
West Coast,"Waterman, Jake",15,9,7,6,0,3,0,2
West Coast,"Yeo, Elliot",17,12,3,5,1,0,0,5
West Coast,"Cole, Tom",15,8,6,7,0,0,0,3
West Coast,"Cripps, Jamie",17,10,7,7,3,0,0,4
West Coast,"Darling, Jack",18,13,11,5,3,3,0,2
West Coast,"Duggan, Liam",25,16,8,9,0,0,0,3
West Coast,"Gaff, Andrew",35,18,3,17,0,1,0,1
West Coast,"Hurn, Shannon",19,17,7,2,0,0,0,4
West Coast,"Hutchings, Mark",16,7,4,9,0,0,0,5
West Coast,"Jetta, Lewis",28,21,7,7,0,0,0,2
West Coast,"Kennedy, Josh",10,8,4,2,2,2,0,4
West Coast,"LeCras, Mark",17,10,5,7,2,1,0,0
West Coast,"Lycett, Scott",10,5,4,5,0,0,23,6
West Coast,"Masten, Chris",28,14,7,14,0,0,0,3
West Coast,"McGovern, Jeremy",20,12,6,8,0,0,0,2
West Coast,"Redden, Jack",26,13,9,13,0,1,0,5
West Coast,"Rioli, Willie",11,10,6,1,1,1,0,2
West Coast,"Schofield, Will",10,2,2,8,0,0,0,0
West Coast,"Sheed, Dom",10,6,1,4,0,1,0,1
West Coast,"Sheppard, Brad",18,13,8,5,0,0,0,3
West Coast,"Shuey, Luke",28,15,9,13,0,0,0,4
West Coast,"Vardy, Nathan",12,4,5,8,1,0,16,4
West Coast,"Venables, Daniel",13,8,6,5,1,0,0,1
West Coast,"Yeo, Elliot",28,21,6,7,1,2,0,8
West Coast,"Barrass, Tom",14,8,7,6,0,0,0,0
West Coast,"Cole, Tom",18,10,6,8,0,0,0,0
West Coast,"Cripps, Jamie",19,15,6,4,1,1,0,7
West Coast,"Darling, Jack",8,5,2,3,0,0,0,5
West Coast,"Duggan, Liam",17,8,4,9,0,0,0,2
West Coast,"Gaff, Andrew",21,14,3,7,0,0,0,4
West Coast,"Hurn, Shannon",21,19,8,2,0,0,0,2
West Coast,"Hutchings, Mark",18,11,3,7,0,0,0,6
West Coast,"LeCras, Mark",9,8,4,1,1,0,0,2
West Coast,"Lycett, Scott",12,7,3,5,0,0,34,5
West Coast,"Masten, Chris",16,12,4,4,0,0,0,0
West Coast,"McGovern, Jeremy",18,13,7,5,0,0,0,2
West Coast,"Petruccelle, Jack",5,2,1,3,0,0,0,1
West Coast,"Redden, Jack",26,13,2,13,0,0,0,5
West Coast,"Rioli, Willie",12,7,1,5,2,0,0,5
West Coast,"Schofield, Will",13,10,5,3,0,0,0,0
West Coast,"Sheed, Dom",17,12,3,5,0,0,0,4
West Coast,"Sheppard, Brad",17,14,6,3,0,0,0,1
West Coast,"Vardy, Nathan",4,1,1,3,1,0,7,3
West Coast,"Venables, Daniel",8,6,2,2,0,2,0,3
West Coast,"Waterman, Jake",8,7,2,1,0,2,0,1
West Coast,"Yeo, Elliot",28,13,6,15,1,0,0,11
West Coast,"Barrass, Tom",13,11,9,2,0,0,0,0
West Coast,"Cole, Tom",10,6,4,4,0,0,0,0
West Coast,"Cripps, Jamie",17,10,6,7,4,3,0,3
West Coast,"Darling, Jack",13,9,5,4,4,2,0,4
West Coast,"Duggan, Liam",14,12,1,2,0,0,0,0
West Coast,"Gaff, Andrew",33,17,3,16,1,1,0,3
West Coast,"Hurn, Shannon",19,11,5,8,0,0,0,1
West Coast,"Hutchings, Mark",21,13,6,8,0,0,0,7
West Coast,"Jetta, Lewis",18,13,8,5,0,0,0,3
West Coast,"LeCras, Mark",12,12,4,0,0,0,0,3
West Coast,"Lycett, Scott",20,7,2,13,2,0,21,4
West Coast,"Masten, Chris",20,11,8,9,0,0,0,1
West Coast,"McGovern, Jeremy",15,8,5,7,0,0,0,0
West Coast,"Redden, Jack",33,17,10,16,1,0,0,5
West Coast,"Rioli, Willie",14,10,5,4,2,0,0,2
West Coast,"Ryan, Liam",15,12,2,3,3,2,0,2
West Coast,"Schofield, Will",2,2,1,0,0,0,0,1
West Coast,"Sheppard, Brad",26,16,12,10,0,1,0,2
West Coast,"Shuey, Luke",26,10,4,16,0,0,0,4
West Coast,"Vardy, Nathan",8,6,2,2,2,2,18,3
West Coast,"Venables, Daniel",12,8,2,4,0,1,0,1
West Coast,"Yeo, Elliot",26,16,6,10,2,3,0,5
West Coast,"Ah Chee, Brendon",15,6,1,9,0,1,0,5
West Coast,"Barrass, Tom",21,16,10,5,0,0,2,0
West Coast,"Cole, Tom",19,10,5,9,0,0,0,1
West Coast,"Cripps, Jamie",12,6,3,6,3,0,0,2
West Coast,"Darling, Jack",8,4,4,4,0,1,0,2
West Coast,"Duggan, Liam",18,15,5,3,0,0,0,2
West Coast,"Hurn, Shannon",15,12,6,3,0,0,0,1
West Coast,"Hutchings, Mark",12,6,0,6,0,0,0,4
West Coast,"Jetta, Lewis",18,15,3,3,0,0,0,2
West Coast,"LeCras, Mark",24,16,6,8,1,0,0,5
West Coast,"Lycett, Scott",19,13,5,6,0,0,40,3
West Coast,"Masten, Chris",21,12,6,9,1,0,0,2
West Coast,"McGovern, Jeremy",9,7,6,2,1,0,0,1
West Coast,"Redden, Jack",24,14,1,10,0,0,0,4
West Coast,"Rioli, Willie",10,6,3,4,0,0,0,1
West Coast,"Ryan, Liam",10,9,2,1,1,2,0,2
West Coast,"Sheed, Dom",22,12,4,10,1,1,0,1
West Coast,"Sheppard, Brad",18,13,9,5,0,0,0,1
West Coast,"Shuey, Luke",31,8,1,23,0,0,0,5
West Coast,"Vardy, Nathan",9,5,7,4,0,1,17,3
West Coast,"Venables, Daniel",5,4,3,1,0,0,0,1
West Coast,"Yeo, Elliot",25,21,7,4,1,0,0,6
West Coast,"Ah Chee, Brendon",15,5,3,10,1,0,0,4
West Coast,"Barrass, Tom",14,9,5,5,0,0,2,2
West Coast,"Cole, Tom",13,5,2,8,0,0,0,3
West Coast,"Cripps, Jamie",22,12,5,10,1,1,0,7
West Coast,"Darling, Jack",0,0,1,0,0,0,0,0
West Coast,"Duggan, Liam",24,15,6,9,0,0,0,1
West Coast,"Hurn, Shannon",18,15,5,3,0,0,0,4
West Coast,"Hutchings, Mark",14,11,5,3,2,0,0,3
West Coast,"Jetta, Lewis",19,10,2,9,0,0,0,2
West Coast,"LeCras, Mark",11,6,4,5,1,0,0,1
West Coast,"Lycett, Scott",11,5,0,6,0,0,21,7
West Coast,"Masten, Chris",27,17,5,10,1,0,0,0
West Coast,"McGovern, Jeremy",13,10,6,3,0,0,0,2
West Coast,"Redden, Jack",25,15,2,10,0,1,0,5
West Coast,"Rioli, Willie",10,6,2,4,3,2,0,2
West Coast,"Ryan, Liam",8,3,0,5,1,0,0,1
West Coast,"Sheed, Dom",31,18,8,13,1,0,0,3
West Coast,"Sheppard, Brad",23,14,8,9,0,0,0,2
West Coast,"Shuey, Luke",21,8,2,13,0,0,0,10
West Coast,"Vardy, Nathan",8,5,5,3,1,1,14,2
West Coast,"Venables, Daniel",10,6,5,4,1,0,0,3
West Coast,"Yeo, Elliot",23,15,9,8,1,1,0,10
West Coast,"Allen, Oscar",14,9,6,5,0,1,0,2
West Coast,"Barrass, Tom",12,9,6,3,0,0,0,2
West Coast,"Cole, Tom",11,6,4,5,0,0,0,3
West Coast,"Cripps, Jamie",23,15,8,8,3,1,0,2
West Coast,"Darling, Jack",15,10,7,5,4,3,0,1
West Coast,"Duggan, Liam",16,9,3,7,0,0,0,0
West Coast,"Hurn, Shannon",22,19,6,3,0,0,0,1
West Coast,"Hutchings, Mark",15,9,2,6,1,0,0,3
West Coast,"LeCras, Mark",15,11,5,4,0,2,0,2
West Coast,"Lycett, Scott",8,5,2,3,0,1,16,2
West Coast,"Masten, Chris",23,14,3,9,0,0,0,1
West Coast,"McGovern, Jeremy",14,10,8,4,0,0,0,0
West Coast,"Redden, Jack",27,16,4,11,0,0,0,2
West Coast,"Rioli, Willie",15,7,4,8,1,0,0,3
West Coast,"Ryan, Liam",12,9,4,3,3,0,0,4
West Coast,"Schofield, Will",5,4,2,1,0,0,0,4
West Coast,"Sheed, Dom",30,12,5,18,0,0,0,0
West Coast,"Sheppard, Brad",15,10,5,5,0,0,0,4
West Coast,"Shuey, Luke",29,17,2,12,0,3,0,5
West Coast,"Vardy, Nathan",5,2,0,3,0,0,23,3
West Coast,"Venables, Daniel",13,6,3,7,2,0,0,2
West Coast,"Yeo, Elliot",21,14,6,7,0,0,0,9
West Coast,"Barrass, Tom",8,6,3,2,0,0,0,0
West Coast,"Cole, Tom",5,3,0,2,0,0,0,1
West Coast,"Cripps, Jamie",16,11,4,5,1,0,0,1
West Coast,"Darling, Jack",13,9,5,4,2,1,0,1
West Coast,"Duggan, Liam",15,15,6,0,0,0,0,4
West Coast,"Hurn, Shannon",17,15,9,2,0,0,0,0
West Coast,"Hutchings, Mark",15,8,3,7,0,0,0,0
West Coast,"Jetta, Lewis",20,14,4,6,1,0,0,4
West Coast,"Kennedy, Josh",12,9,6,3,2,4,0,3
West Coast,"LeCras, Mark",15,11,1,4,0,2,0,2
West Coast,"Lycett, Scott",10,3,1,7,0,0,14,3
West Coast,"Masten, Chris",11,6,0,5,0,0,0,3
West Coast,"McGovern, Jeremy",18,13,9,5,0,0,0,3
West Coast,"Redden, Jack",32,23,12,9,1,0,0,3
West Coast,"Rioli, Willie",14,10,1,4,1,0,0,6
West Coast,"Ryan, Liam",15,12,2,3,2,0,0,0
West Coast,"Sheed, Dom",27,17,5,10,1,0,0,1
West Coast,"Sheppard, Brad",2,2,0,0,0,0,0,0
West Coast,"Shuey, Luke",19,13,5,6,0,0,0,5
West Coast,"Vardy, Nathan",11,3,1,8,1,0,14,2
West Coast,"Venables, Daniel",7,3,1,4,0,1,0,7
West Coast,"Yeo, Elliot",36,23,6,13,0,1,0,9
West Coast,"Barrass, Tom",13,12,7,1,0,0,2,2
West Coast,"Cole, Tom",10,6,4,4,0,0,0,4
West Coast,"Cripps, Jamie",24,14,3,10,3,1,0,6
West Coast,"Darling, Jack",17,14,7,3,3,3,0,1
West Coast,"Duggan, Liam",19,15,8,4,0,0,0,3
West Coast,"Hurn, Shannon",24,21,8,3,0,0,0,3
West Coast,"Hutchings, Mark",12,6,2,6,1,0,0,6
West Coast,"Jetta, Lewis",14,10,4,4,0,0,0,0
West Coast,"Kennedy, Josh",13,10,7,3,4,0,0,4
West Coast,"LeCras, Mark",12,8,3,4,3,2,0,3
West Coast,"Lycett, Scott",7,3,1,4,0,0,20,3
West Coast,"Masten, Chris",17,8,6,9,0,0,0,1
West Coast,"McGovern, Jeremy",17,13,4,4,0,0,0,0
West Coast,"Redden, Jack",31,19,13,12,1,0,0,9
West Coast,"Rioli, Willie",14,10,6,4,1,2,0,0
West Coast,"Ryan, Liam",18,14,4,4,1,1,0,2
West Coast,"Schofield, Will",8,4,4,4,0,0,1,0
West Coast,"Sheed, Dom",27,13,7,14,0,0,0,1
West Coast,"Shuey, Luke",21,18,3,3,0,0,0,1
West Coast,"Vardy, Nathan",5,2,1,3,0,0,8,2
West Coast,"Venables, Daniel",17,8,2,9,1,1,0,2
West Coast,"Yeo, Elliot",23,15,6,8,0,0,0,6
West Coast,"Barrass, Tom",17,15,10,2,0,0,0,0
West Coast,"Cole, Tom",13,8,6,5,0,0,0,2
West Coast,"Cripps, Jamie",16,10,3,6,1,1,0,4
West Coast,"Darling, Jack",12,8,7,4,1,0,0,3
West Coast,"Duggan, Liam",16,10,7,6,0,0,0,3
West Coast,"Hurn, Shannon",21,16,6,5,0,0,0,4
West Coast,"Hutchings, Mark",15,11,4,4,1,1,0,2
West Coast,"Jetta, Lewis",13,9,2,4,0,1,0,2
West Coast,"Kennedy, Josh",18,14,11,4,3,2,0,4
West Coast,"LeCras, Mark",10,5,3,5,0,0,0,5
West Coast,"Lycett, Scott",9,4,1,5,0,1,15,4
West Coast,"Masten, Chris",14,8,4,6,0,1,0,1
West Coast,"McGovern, Jeremy",14,12,9,2,0,0,0,1
West Coast,"Redden, Jack",21,15,6,6,0,0,0,3
West Coast,"Rioli, Willie",12,5,1,7,1,1,0,7
West Coast,"Ryan, Liam",10,6,3,4,0,2,0,4
West Coast,"Schofield, Will",9,7,5,2,0,0,0,2
West Coast,"Sheed, Dom",32,17,6,15,1,0,0,0
West Coast,"Shuey, Luke",34,21,3,13,1,1,0,8
West Coast,"Vardy, Nathan",14,7,4,7,1,0,14,6
West Coast,"Venables, Daniel",4,1,0,3,0,0,0,2
West Coast,"Yeo, Elliot",19,12,3,7,1,0,0,5
Western Bulldogs,"Biggs, Shane",15,13,6,2,0,0,0,1
Western Bulldogs,"Bontempelli, Marcus",18,9,1,9,0,1,0,5
Western Bulldogs,"Cordy, Zaine",14,8,3,6,0,0,0,3
Western Bulldogs,"Crozier, Hayden",8,6,2,2,0,0,0,3
Western Bulldogs,"Dahlhaus, Luke",29,10,4,19,0,1,0,4
Western Bulldogs,"Dale, Bailey",20,13,6,7,1,1,0,1
Western Bulldogs,"Dunkley, Josh",16,9,3,7,1,0,0,8
Western Bulldogs,"English, Tim",13,8,6,5,0,0,12,3
Western Bulldogs,"Gowers, Billy",10,5,3,5,1,0,0,3
Western Bulldogs,"Honeychurch, Mitch",15,10,1,5,1,0,0,4
Western Bulldogs,"Hunter, Lachie",32,14,6,18,0,1,0,3
Western Bulldogs,"Johannisen, Jason",19,10,3,9,0,1,0,0
Western Bulldogs,"Liberatore, Tom",3,2,0,1,0,0,0,0
Western Bulldogs,"Macrae, Jack",31,16,5,15,0,1,0,6
Western Bulldogs,"McLean, Toby",20,8,1,12,0,0,0,4
Western Bulldogs,"Naughton, Aaron",11,9,2,2,0,0,0,1
Western Bulldogs,"Roberts, Fletcher",14,12,4,2,0,0,0,1
Western Bulldogs,"Roughead, Jordan",12,8,3,4,2,1,20,1
Western Bulldogs,"Suckling, Matt",24,13,4,11,1,0,0,0
Western Bulldogs,"Trengove, Jackson",4,0,0,4,0,0,14,3
Western Bulldogs,"Williams, Bailey",12,8,2,4,0,1,0,3
Western Bulldogs,"Wood, Easton",7,5,3,2,0,0,0,0
Western Bulldogs,"Bontempelli, Marcus",23,11,2,12,1,0,0,3
Western Bulldogs,"Cordy, Zaine",18,13,9,5,0,0,0,1
Western Bulldogs,"Dahlhaus, Luke",15,6,4,9,0,0,0,3
Western Bulldogs,"Dale, Bailey",13,6,3,7,0,1,0,0
Western Bulldogs,"Daniel, Caleb",13,9,7,4,0,0,0,1
Western Bulldogs,"Dunkley, Josh",13,9,7,4,2,2,0,3
Western Bulldogs,"English, Tim",7,4,2,3,0,1,6,2
Western Bulldogs,"Gowers, Billy",13,11,8,2,1,3,0,0
Western Bulldogs,"Honeychurch, Mitch",19,13,6,6,0,0,0,0
Western Bulldogs,"Hunter, Lachie",26,19,9,7,2,0,0,2
Western Bulldogs,"Johannisen, Jason",23,15,2,8,0,0,0,1
Western Bulldogs,"Jong, Lin",9,5,3,4,0,1,0,4
Western Bulldogs,"Macrae, Jack",31,19,6,12,3,0,0,4
Western Bulldogs,"McLean, Toby",30,14,3,16,0,1,0,5
Western Bulldogs,"Naughton, Aaron",13,9,7,4,0,0,0,2
Western Bulldogs,"Richards, Ed",11,5,6,6,0,0,0,1
Western Bulldogs,"Roughead, Jordan",5,4,1,1,0,0,3,2
Western Bulldogs,"Suckling, Matt",19,13,6,6,0,1,0,1
Western Bulldogs,"Trengove, Jackson",13,6,5,7,0,1,4,1
Western Bulldogs,"Webb, Lukas",10,5,2,5,0,0,0,4
Western Bulldogs,"Williams, Bailey",17,15,8,2,0,1,0,2
Western Bulldogs,"Wood, Easton",12,8,9,4,0,0,0,0
Western Bulldogs,"Bontempelli, Marcus",16,12,4,4,3,3,2,1
Western Bulldogs,"Cordy, Zaine",14,10,9,4,0,0,0,3
Western Bulldogs,"Dahlhaus, Luke",31,7,6,24,0,1,0,5
Western Bulldogs,"Dale, Bailey",14,9,7,5,2,2,0,0
Western Bulldogs,"Daniel, Caleb",27,12,8,15,0,1,0,2
Western Bulldogs,"Dickson, Tory",11,6,3,5,0,0,0,3
Western Bulldogs,"Dunkley, Josh",17,12,11,5,2,0,1,0
Western Bulldogs,"English, Tim",17,11,6,6,0,0,19,0
Western Bulldogs,"Gowers, Billy",10,7,4,3,1,3,0,1
Western Bulldogs,"Honeychurch, Mitch",17,9,5,8,0,0,0,5
Western Bulldogs,"Hunter, Lachie",35,25,13,10,1,2,0,1
Western Bulldogs,"Johannisen, Jason",16,12,8,4,1,0,0,1
Western Bulldogs,"Jong, Lin",14,9,6,5,0,1,0,3
Western Bulldogs,"Macrae, Jack",30,19,7,11,0,1,0,5
Western Bulldogs,"McLean, Toby",25,14,7,11,2,1,0,2
Western Bulldogs,"Naughton, Aaron",15,9,3,6,0,0,0,1
Western Bulldogs,"Redpath, Jack",10,7,6,3,0,0,0,0
Western Bulldogs,"Richards, Ed",17,13,7,4,0,0,0,5
Western Bulldogs,"Suckling, Matt",24,14,8,10,0,1,0,1
Western Bulldogs,"Wallis, Mitch",22,11,6,11,1,1,0,3
Western Bulldogs,"Williams, Bailey",26,20,12,6,1,0,0,0
Western Bulldogs,"Wood, Easton",9,6,6,3,0,0,0,2
Western Bulldogs,"Biggs, Shane",14,12,6,2,0,0,0,0
Western Bulldogs,"Bontempelli, Marcus",21,13,4,8,2,0,1,2
Western Bulldogs,"Dahlhaus, Luke",20,14,5,6,1,0,0,5
Western Bulldogs,"Dale, Bailey",18,12,4,6,1,0,0,0
Western Bulldogs,"Daniel, Caleb",18,11,3,7,1,1,0,1
Western Bulldogs,"Dickson, Tory",13,7,5,6,2,0,0,2
Western Bulldogs,"Dunkley, Josh",22,11,9,11,0,4,3,7
Western Bulldogs,"English, Tim",16,9,7,7,0,0,24,1
Western Bulldogs,"Gowers, Billy",8,6,2,2,1,0,0,4
Western Bulldogs,"Honeychurch, Mitch",14,8,6,6,0,0,0,2
Western Bulldogs,"Hunter, Lachie",17,6,0,11,0,0,0,2
Western Bulldogs,"Johannisen, Jason",15,10,2,5,0,0,0,4
Western Bulldogs,"Jong, Lin",17,7,4,10,1,1,0,5
Western Bulldogs,"Macrae, Jack",34,20,7,14,0,0,0,4
Western Bulldogs,"McLean, Toby",24,8,3,16,0,1,0,5
Western Bulldogs,"Naughton, Aaron",15,10,7,5,0,0,0,1
Western Bulldogs,"Redpath, Jack",9,8,7,1,1,0,0,0
Western Bulldogs,"Richards, Ed",13,9,3,4,0,0,0,5
Western Bulldogs,"Suckling, Matt",28,21,11,7,0,3,0,0
Western Bulldogs,"Wallis, Mitch",23,9,7,14,1,0,0,2
Western Bulldogs,"Williams, Bailey",20,12,4,8,0,0,0,1
Western Bulldogs,"Wood, Easton",18,12,7,6,0,0,0,3
Western Bulldogs,"Bontempelli, Marcus",22,14,4,8,0,0,0,2
Western Bulldogs,"Boyd, Tom",7,6,4,1,2,0,3,1
Western Bulldogs,"Cordy, Zaine",14,10,6,4,0,0,0,1
Western Bulldogs,"Dahlhaus, Luke",19,8,7,11,0,0,0,4
Western Bulldogs,"Dale, Bailey",12,10,6,2,0,1,0,1
Western Bulldogs,"Daniel, Caleb",22,14,5,8,0,0,0,7
Western Bulldogs,"Dickson, Tory",7,3,2,4,0,0,0,3
Western Bulldogs,"Dunkley, Josh",9,5,3,4,0,0,1,2
Western Bulldogs,"English, Tim",19,12,9,7,0,1,13,3
Western Bulldogs,"Gowers, Billy",9,5,3,4,2,0,1,1
Western Bulldogs,"Honeychurch, Mitch",20,14,9,6,0,0,0,7
Western Bulldogs,"Johannisen, Jason",25,19,4,6,0,1,0,0
Western Bulldogs,"Jong, Lin",23,10,6,13,1,0,0,3
Western Bulldogs,"Lipinski, Patrick",11,7,2,4,1,0,0,3
Western Bulldogs,"Macrae, Jack",26,14,6,12,0,0,0,4
Western Bulldogs,"McLean, Toby",25,10,7,15,1,1,0,6
Western Bulldogs,"Naughton, Aaron",11,8,5,3,0,0,0,1
Western Bulldogs,"Richards, Ed",15,9,4,6,0,0,0,1
Western Bulldogs,"Suckling, Matt",27,17,6,10,0,0,0,2
Western Bulldogs,"Wallis, Mitch",17,5,2,12,1,0,0,7
Western Bulldogs,"Webb, Lukas",15,8,5,7,0,1,0,4
Western Bulldogs,"Wood, Easton",12,7,3,5,0,0,0,0
Western Bulldogs,"Bontempelli, Marcus",30,15,5,15,0,2,0,7
Western Bulldogs,"Boyd, Tom",13,7,6,6,1,3,7,1
Western Bulldogs,"Cordy, Zaine",9,5,4,4,0,0,0,1
Western Bulldogs,"Crozier, Hayden",14,7,3,7,0,0,0,3
Western Bulldogs,"Dahlhaus, Luke",21,2,2,19,0,0,0,4
Western Bulldogs,"Dale, Bailey",14,5,1,9,1,2,0,3
Western Bulldogs,"Daniel, Caleb",20,11,6,9,1,1,0,3
Western Bulldogs,"Dunkley, Josh",15,7,3,8,0,1,0,6
Western Bulldogs,"English, Tim",10,1,0,9,0,0,15,2
Western Bulldogs,"Gowers, Billy",9,8,7,1,2,0,0,2
Western Bulldogs,"Hunter, Lachie",29,15,7,14,0,1,0,2
Western Bulldogs,"Johannisen, Jason",20,9,4,11,0,0,0,3
Western Bulldogs,"Jong, Lin",13,5,4,8,0,1,0,6
Western Bulldogs,"Lipinski, Patrick",15,6,3,9,3,0,0,1
Western Bulldogs,"Macrae, Jack",32,15,7,17,1,1,0,9
Western Bulldogs,"McLean, Toby",21,8,2,13,1,2,0,6
Western Bulldogs,"Naughton, Aaron",13,9,4,4,0,0,0,4
Western Bulldogs,"Richards, Ed",17,13,4,4,0,0,0,1
Western Bulldogs,"Suckling, Matt",25,9,6,16,0,0,0,1
Western Bulldogs,"Wallis, Mitch",21,10,4,11,1,0,0,6
Western Bulldogs,"Williams, Bailey",20,13,4,7,0,0,0,2
Western Bulldogs,"Wood, Easton",14,7,4,7,0,0,0,1
Western Bulldogs,"Boyd, Tom",15,10,4,5,0,0,11,3
Western Bulldogs,"Cordy, Zaine",10,5,3,5,0,0,0,1
Western Bulldogs,"Crozier, Hayden",10,6,3,4,0,0,0,6
Western Bulldogs,"Dahlhaus, Luke",29,13,3,16,0,1,0,5
Western Bulldogs,"Dale, Bailey",18,9,4,9,0,0,0,1
Western Bulldogs,"Daniel, Caleb",24,8,2,16,0,1,0,2
Western Bulldogs,"Dunkley, Josh",19,11,4,8,1,0,0,9
Western Bulldogs,"English, Tim",9,4,3,5,1,0,8,0
Western Bulldogs,"Gowers, Billy",16,7,3,9,2,1,0,1
Western Bulldogs,"Honeychurch, Mitch",11,6,3,5,1,1,0,3
Western Bulldogs,"Hunter, Lachie",34,20,9,14,0,2,0,3
Western Bulldogs,"Johannisen, Jason",18,12,5,6,1,2,0,3
Western Bulldogs,"Jong, Lin",11,6,2,5,1,0,0,3
Western Bulldogs,"Lipinski, Patrick",17,8,2,9,2,0,0,1
Western Bulldogs,"Macrae, Jack",40,19,5,21,1,1,0,8
Western Bulldogs,"McLean, Toby",33,11,5,22,0,1,0,13
Western Bulldogs,"Naughton, Aaron",12,7,5,5,0,0,0,4
Western Bulldogs,"Richards, Ed",11,6,0,5,0,1,0,1
Western Bulldogs,"Suckling, Matt",24,13,1,11,0,2,0,1
Western Bulldogs,"Wallis, Mitch",21,7,0,14,0,0,0,6
Western Bulldogs,"Williams, Bailey",21,17,6,4,1,0,0,1
Western Bulldogs,"Young, Lewis",10,7,3,3,0,0,0,5
Western Bulldogs,"Bontempelli, Marcus",24,13,6,11,4,1,0,4
Western Bulldogs,"Boyd, Tom",15,9,3,6,1,0,17,3
Western Bulldogs,"Cordy, Zaine",12,9,3,3,0,0,0,1
Western Bulldogs,"Crozier, Hayden",12,9,4,3,0,0,0,3
Western Bulldogs,"Dahlhaus, Luke",16,3,1,13,0,0,0,4
Western Bulldogs,"Dale, Bailey",24,13,6,11,1,3,0,1
Western Bulldogs,"Daniel, Caleb",27,11,3,16,1,0,0,3
Western Bulldogs,"Dunkley, Josh",19,10,2,9,1,1,3,7
Western Bulldogs,"Gowers, Billy",15,11,6,4,2,1,0,2
Western Bulldogs,"Honeychurch, Mitch",23,6,1,17,0,0,0,2
Western Bulldogs,"Hunter, Lachie",33,14,3,19,0,0,0,4
Western Bulldogs,"Johannisen, Jason",19,12,6,7,0,0,0,2
Western Bulldogs,"Lipinski, Patrick",15,6,1,9,2,0,0,6
Western Bulldogs,"Macrae, Jack",47,18,4,29,0,0,0,8
Western Bulldogs,"McLean, Toby",26,13,5,13,2,1,0,5
Western Bulldogs,"Naughton, Aaron",1,1,0,0,0,0,0,0
Western Bulldogs,"Richards, Ed",16,7,2,9,0,1,0,4
Western Bulldogs,"Suckling, Matt",30,13,7,17,1,1,0,1
Western Bulldogs,"Wallis, Mitch",24,6,4,18,1,1,0,1
Western Bulldogs,"Webb, Lukas",9,3,2,6,0,0,0,2
Western Bulldogs,"Williams, Bailey",23,14,4,9,0,0,0,1
Western Bulldogs,"Young, Lewis",9,7,1,2,0,0,0,3
Western Bulldogs,"Bontempelli, Marcus",28,12,0,16,0,0,0,7
Western Bulldogs,"Boyd, Tom",9,3,1,6,0,0,23,4
Western Bulldogs,"Cordy, Zaine",18,12,3,6,0,0,0,2
Western Bulldogs,"Crozier, Hayden",18,8,1,10,0,0,0,4
Western Bulldogs,"Dahlhaus, Luke",25,9,1,16,0,0,0,7
Western Bulldogs,"Dale, Bailey",9,5,1,4,0,0,0,0
Western Bulldogs,"Daniel, Caleb",17,9,1,8,0,0,0,6
Western Bulldogs,"Dunkley, Josh",12,6,3,6,0,1,0,5
Western Bulldogs,"Gowers, Billy",9,7,2,2,0,1,0,4
Western Bulldogs,"Hunter, Lachie",23,14,2,9,0,1,0,5
Western Bulldogs,"Johannisen, Jason",18,11,2,7,0,3,0,3
Western Bulldogs,"Lipinski, Patrick",14,8,0,6,0,1,0,7
Western Bulldogs,"Macrae, Jack",36,12,2,24,0,0,0,13
Western Bulldogs,"McLean, Toby",22,10,3,12,0,0,0,10
Western Bulldogs,"Richards, Ed",12,10,1,2,0,1,0,7
Western Bulldogs,"Roughead, Jordan",12,6,0,6,0,0,17,4
Western Bulldogs,"Suckling, Matt",19,14,2,5,1,1,0,6
Western Bulldogs,"Trengove, Jackson",21,12,3,9,0,0,0,5
Western Bulldogs,"Wallis, Mitch",20,7,0,13,0,0,0,10
Western Bulldogs,"Webb, Lukas",14,6,0,8,1,1,0,3
Western Bulldogs,"Williams, Bailey",24,17,4,7,0,0,0,3
Western Bulldogs,"Wood, Easton",18,14,2,4,0,0,0,3
Western Bulldogs,"Bontempelli, Marcus",17,7,3,10,0,1,0,3
Western Bulldogs,"Boyd, Tom",10,5,4,5,1,1,9,3
Western Bulldogs,"Cordy, Zaine",7,4,4,3,0,0,0,0
Western Bulldogs,"Crozier, Hayden",10,5,4,5,0,0,0,1
Western Bulldogs,"Dahlhaus, Luke",24,12,9,12,0,1,0,5
Western Bulldogs,"Dale, Bailey",13,7,1,6,0,0,0,3
Western Bulldogs,"Daniel, Caleb",20,9,4,11,0,0,0,6
Western Bulldogs,"Dickson, Tory",10,6,3,4,2,0,0,1
Western Bulldogs,"Gowers, Billy",13,6,5,7,1,0,0,0
Western Bulldogs,"Hunter, Lachie",25,15,6,10,0,1,0,3
Western Bulldogs,"Johannisen, Jason",14,9,5,5,0,0,0,2
Western Bulldogs,"Lipinski, Patrick",11,6,2,5,0,0,0,1
Western Bulldogs,"Macrae, Jack",30,15,7,15,0,0,0,4
Western Bulldogs,"McLean, Toby",33,23,9,10,0,0,0,10
Western Bulldogs,"Richards, Ed",23,12,4,11,0,0,0,4
Western Bulldogs,"Roughead, Jordan",11,7,4,4,2,0,9,2
Western Bulldogs,"Schache, Josh",9,6,2,3,1,0,0,0
Western Bulldogs,"Smith, Roarke",13,6,5,7,0,0,0,4
Western Bulldogs,"Suckling, Matt",23,18,7,5,1,0,0,1
Western Bulldogs,"Trengove, Jackson",21,12,9,9,0,0,4,2
Western Bulldogs,"Williams, Bailey",22,15,4,7,0,1,0,3
Western Bulldogs,"Wood, Easton",15,11,10,4,0,0,0,0
Western Bulldogs,"Bontempelli, Marcus",24,12,4,12,2,0,1,3
Western Bulldogs,"Boyd, Tom",4,1,1,3,0,0,13,2
Western Bulldogs,"Crozier, Hayden",17,11,3,6,0,0,0,2
Western Bulldogs,"Dahlhaus, Luke",15,6,4,9,0,0,0,4
Western Bulldogs,"Daniel, Caleb",16,7,3,9,0,0,0,3
Western Bulldogs,"Dickson, Tory",2,2,1,0,0,0,0,2
Western Bulldogs,"Gowers, Billy",16,7,1,9,1,1,0,3
Western Bulldogs,"Honeychurch, Mitch",14,7,6,7,1,1,0,4
Western Bulldogs,"Hunter, Lachie",32,20,4,12,0,0,0,3
Western Bulldogs,"Johannisen, Jason",24,9,4,15,0,1,0,1
Western Bulldogs,"Lipinski, Patrick",17,8,2,9,0,1,0,2
Western Bulldogs,"Macrae, Jack",31,14,3,17,0,1,0,5
Western Bulldogs,"McLean, Toby",24,11,2,13,0,1,0,6
Western Bulldogs,"Morris, Dale",12,2,3,10,0,0,0,2
Western Bulldogs,"Richards, Ed",16,11,2,5,0,0,0,1
Western Bulldogs,"Roughead, Jordan",12,4,5,8,1,0,12,4
Western Bulldogs,"Schache, Josh",10,8,2,2,1,1,0,3
Western Bulldogs,"Smith, Roarke",13,5,0,8,0,0,0,2
Western Bulldogs,"Suckling, Matt",26,15,3,11,1,0,0,1
Western Bulldogs,"Trengove, Jackson",17,10,6,7,0,0,0,2
Western Bulldogs,"Williams, Bailey",23,15,4,8,0,0,0,4
Western Bulldogs,"Wood, Easton",21,10,3,11,0,0,0,2
Western Bulldogs,"Biggs, Shane",10,6,3,4,0,0,0,3
Western Bulldogs,"Bontempelli, Marcus",23,16,0,7,2,1,0,5
Western Bulldogs,"Boyd, Tom",9,4,1,5,0,0,31,1
Western Bulldogs,"Cordy, Zaine",14,8,6,6,0,0,0,2
Western Bulldogs,"Crozier, Hayden",21,16,8,5,0,0,0,3
Western Bulldogs,"Dahlhaus, Luke",24,6,2,18,0,0,0,1
Western Bulldogs,"Daniel, Caleb",5,3,1,2,0,0,0,0
Western Bulldogs,"Gowers, Billy",11,7,4,4,1,2,1,2
Western Bulldogs,"Honeychurch, Mitch",11,8,5,3,0,1,0,8
Western Bulldogs,"Hunter, Lachie",18,12,3,6,0,0,0,3
Western Bulldogs,"Johannisen, Jason",13,9,3,4,0,0,0,2
Western Bulldogs,"Lipinski, Patrick",9,5,2,4,1,0,0,0
Western Bulldogs,"Macrae, Jack",12,6,4,6,0,0,0,1
Western Bulldogs,"McLean, Toby",15,9,2,6,1,0,0,2
Western Bulldogs,"Richards, Ed",15,7,0,8,3,0,0,2
Western Bulldogs,"Schache, Josh",15,12,1,3,1,2,1,1
Western Bulldogs,"Smith, Roarke",13,7,2,6,0,0,0,0
Western Bulldogs,"Trengove, Jackson",14,9,7,5,0,0,0,2
Western Bulldogs,"Wallis, Mitch",13,5,3,8,2,0,0,6
Western Bulldogs,"Webb, Lukas",10,7,1,3,0,0,0,3
Western Bulldogs,"Williams, Bailey",21,15,6,6,0,1,0,2
Western Bulldogs,"Wood, Easton",9,4,3,5,0,0,0,2
Western Bulldogs,"Adams, Marcus",20,13,12,7,0,0,0,0
Western Bulldogs,"Bontempelli, Marcus",20,13,3,7,0,0,0,1
Western Bulldogs,"Boyd, Tom",14,5,2,9,1,0,22,2
Western Bulldogs,"Cordy, Zaine",13,9,4,4,1,1,0,3
Western Bulldogs,"Crozier, Hayden",30,25,5,5,0,0,0,1
Western Bulldogs,"Dahlhaus, Luke",15,4,4,11,0,0,0,3
Western Bulldogs,"Daniel, Caleb",17,9,3,8,0,1,0,5
Western Bulldogs,"Dunkley, Josh",15,7,5,8,0,0,0,6
Western Bulldogs,"Gowers, Billy",22,16,12,6,3,1,0,3
Western Bulldogs,"Honeychurch, Mitch",14,7,4,7,0,0,0,4
Western Bulldogs,"Hunter, Lachie",30,16,2,14,0,1,0,4
Western Bulldogs,"Johannisen, Jason",20,13,2,7,0,0,0,2
Western Bulldogs,"Lipinski, Patrick",16,6,3,10,0,1,0,1
Western Bulldogs,"McLean, Toby",26,9,4,17,0,0,0,1
Western Bulldogs,"Morris, Dale",12,5,7,7,0,0,0,1
Western Bulldogs,"Naughton, Aaron",10,5,4,5,2,1,0,3
Western Bulldogs,"Richards, Ed",13,8,2,5,1,1,0,2
Western Bulldogs,"Schache, Josh",17,8,4,9,0,1,0,3
Western Bulldogs,"Smith, Roarke",10,4,1,6,0,0,0,1
Western Bulldogs,"Trengove, Jackson",10,7,6,3,0,0,0,1
Western Bulldogs,"Wallis, Mitch",25,10,4,15,1,0,0,2
Western Bulldogs,"Williams, Bailey",16,8,3,8,2,1,0,4
Western Bulldogs,"Adams, Marcus",14,9,6,5,0,0,1,0
Western Bulldogs,"Bontempelli, Marcus",23,12,3,11,2,3,0,7
Western Bulldogs,"Boyd, Tom",17,5,1,12,0,0,31,3
Western Bulldogs,"Cordy, Zaine",14,10,3,4,1,0,1,4
Western Bulldogs,"Crozier, Hayden",16,12,6,4,0,0,0,4
Western Bulldogs,"Dahlhaus, Luke",29,12,8,17,0,0,0,5
Western Bulldogs,"Dunkley, Josh",27,12,3,15,2,0,0,7
Western Bulldogs,"Gowers, Billy",19,15,4,4,2,1,0,1
Western Bulldogs,"Hunter, Lachie",24,13,5,11,0,0,0,3
Western Bulldogs,"Johannisen, Jason",23,16,3,7,0,0,0,1
Western Bulldogs,"Jong, Lin",2,1,1,1,0,0,0,0
Western Bulldogs,"Lipinski, Patrick",25,8,6,17,0,1,0,1
Western Bulldogs,"Lynch, Brad",18,10,3,8,0,0,0,2
Western Bulldogs,"McLean, Toby",25,13,2,12,1,0,0,11
Western Bulldogs,"Morris, Dale",12,4,2,8,0,0,0,2
Western Bulldogs,"Naughton, Aaron",7,3,2,4,0,0,0,2
Western Bulldogs,"Richards, Ed",13,8,2,5,3,0,0,5
Western Bulldogs,"Schache, Josh",15,7,5,8,2,0,0,1
Western Bulldogs,"Smith, Roarke",15,6,4,9,0,0,0,1
Western Bulldogs,"Trengove, Jackson",15,7,4,8,0,0,2,1
Western Bulldogs,"Wallis, Mitch",24,8,4,16,1,0,0,4
Western Bulldogs,"Williams, Bailey",18,10,3,8,2,0,0,4
Western Bulldogs,"Adams, Marcus",18,10,6,8,0,0,2,4
Western Bulldogs,"Biggs, Shane",11,8,2,3,1,1,0,5
Western Bulldogs,"Bontempelli, Marcus",23,9,5,14,0,0,0,4
Western Bulldogs,"Boyd, Tom",9,3,0,6,0,0,24,4
Western Bulldogs,"Cordy, Zaine",7,3,0,4,0,0,6,1
Western Bulldogs,"Crozier, Hayden",23,18,10,5,0,0,0,3
Western Bulldogs,"Dahlhaus, Luke",18,2,3,16,0,0,0,5
Western Bulldogs,"Daniel, Caleb",20,11,5,9,1,0,0,3
Western Bulldogs,"Dunkley, Josh",23,11,6,12,0,0,0,10
Western Bulldogs,"Gowers, Billy",7,6,2,1,1,1,0,0
Western Bulldogs,"Hunter, Lachie",26,14,6,12,2,0,0,4
Western Bulldogs,"Johannisen, Jason",32,23,8,9,0,0,0,2
Western Bulldogs,"Lipinski, Patrick",12,4,2,8,0,0,0,0
Western Bulldogs,"Lynch, Brad",23,15,5,8,0,0,0,1
Western Bulldogs,"McLean, Toby",25,12,4,13,0,0,0,3
Western Bulldogs,"Morris, Dale",16,7,7,9,0,0,0,4
Western Bulldogs,"Naughton, Aaron",9,6,3,3,0,0,0,1
Western Bulldogs,"Richards, Ed",15,8,4,7,0,0,0,1
Western Bulldogs,"Schache, Josh",11,8,5,3,1,2,0,1
Western Bulldogs,"Smith, Roarke",9,5,2,4,0,0,0,1
Western Bulldogs,"Trengove, Jackson",22,11,11,11,0,0,4,1
Western Bulldogs,"Wallis, Mitch",16,9,2,7,3,0,0,1
Western Bulldogs,"Adams, Marcus",16,9,6,7,0,0,0,2
Western Bulldogs,"Biggs, Shane",15,8,1,7,0,0,0,5
Western Bulldogs,"Cordy, Zaine",11,5,2,6,0,0,0,4
Western Bulldogs,"Dahlhaus, Luke",23,8,2,15,0,0,0,6
Western Bulldogs,"Daniel, Caleb",16,7,4,9,0,1,0,5
Western Bulldogs,"Dunkley, Josh",30,9,4,21,0,1,0,4
Western Bulldogs,"Gowers, Billy",16,13,1,3,0,1,0,2
Western Bulldogs,"Honeychurch, Mitch",16,10,2,6,0,0,0,4
Western Bulldogs,"Hunter, Lachie",35,24,5,11,1,0,0,1
Western Bulldogs,"Johannisen, Jason",21,11,0,10,2,0,0,4
Western Bulldogs,"Lipinski, Patrick",9,3,0,6,1,0,0,1
Western Bulldogs,"Lynch, Brad",16,7,1,9,0,0,0,2
Western Bulldogs,"Macrae, Jack",33,12,7,21,0,0,0,8
Western Bulldogs,"McLean, Toby",22,6,1,16,1,0,0,6
Western Bulldogs,"Morris, Dale",13,8,5,5,0,1,0,3
Western Bulldogs,"Naughton, Aaron",18,10,4,8,0,0,0,1
Western Bulldogs,"Richards, Ed",16,9,2,7,0,0,1,0
Western Bulldogs,"Roughead, Jordan",20,9,6,11,0,1,19,5
Western Bulldogs,"Schache, Josh",15,9,8,6,2,2,0,0
Western Bulldogs,"Smith, Roarke",14,6,0,8,0,0,0,2
Western Bulldogs,"Trengove, Jackson",19,11,7,8,0,0,4,1
Western Bulldogs,"Wallis, Mitch",29,8,2,21,3,0,0,2
Western Bulldogs,"Adams, Marcus",13,7,7,6,0,0,0,0
Western Bulldogs,"Boyd, Tom",11,6,0,5,0,0,13,2
Western Bulldogs,"Cordy, Zaine",14,10,5,4,0,0,0,0
Western Bulldogs,"Crozier, Hayden",29,20,5,9,0,0,0,1
Western Bulldogs,"Dahlhaus, Luke",12,5,2,7,1,0,0,2
Western Bulldogs,"Daniel, Caleb",23,12,5,11,0,1,0,6
Western Bulldogs,"Dunkley, Josh",29,10,4,19,0,1,0,6
Western Bulldogs,"Gowers, Billy",18,6,2,12,0,1,0,3
Western Bulldogs,"Honeychurch, Mitch",10,3,4,7,0,1,0,5
Western Bulldogs,"Hunter, Lachie",28,17,5,11,0,0,0,4
Western Bulldogs,"Johannisen, Jason",21,7,6,14,1,1,0,4
Western Bulldogs,"Lynch, Brad",12,7,3,5,0,0,0,0
Western Bulldogs,"Macrae, Jack",22,7,2,15,1,0,0,3
Western Bulldogs,"McLean, Toby",24,14,6,10,0,0,0,7
Western Bulldogs,"Morris, Dale",12,4,3,8,0,0,0,2
Western Bulldogs,"Naughton, Aaron",3,0,1,3,0,0,0,2
Western Bulldogs,"Richards, Ed",7,3,0,4,0,0,0,5
Western Bulldogs,"Roughead, Jordan",7,5,3,2,1,1,17,7
Western Bulldogs,"Schache, Josh",11,7,6,4,1,1,0,0
Western Bulldogs,"Smith, Roarke",16,5,3,11,0,1,0,1
Western Bulldogs,"Trengove, Jackson",7,5,1,2,0,0,0,1
Western Bulldogs,"Wallis, Mitch",22,8,2,14,1,0,0,4
Western Bulldogs,"Adams, Marcus",9,7,0,2,0,0,0,6
Western Bulldogs,"Bontempelli, Marcus",22,16,1,6,0,0,0,1
Western Bulldogs,"Cordy, Zaine",7,7,4,0,0,0,0,5
Western Bulldogs,"Crozier, Hayden",22,14,4,8,0,1,0,3
Western Bulldogs,"Daniel, Caleb",14,5,2,9,0,0,0,2
Western Bulldogs,"Dunkley, Josh",27,13,1,14,0,0,0,12
Western Bulldogs,"Greene, Fergus",5,2,2,3,1,0,0,5
Western Bulldogs,"Honeychurch, Mitch",9,7,0,2,0,1,0,4
Western Bulldogs,"Hunter, Lachie",35,19,1,16,0,0,0,4
Western Bulldogs,"Johannisen, Jason",9,5,1,4,0,0,0,5
Western Bulldogs,"Lipinski, Patrick",14,5,1,9,0,0,0,3
Western Bulldogs,"Lynch, Brad",6,5,1,1,0,0,0,1
Western Bulldogs,"Macrae, Jack",36,18,2,18,0,0,0,4
Western Bulldogs,"McLean, Toby",21,7,3,14,0,1,0,7
Western Bulldogs,"Morris, Dale",10,7,1,3,0,0,0,3
Western Bulldogs,"Naughton, Aaron",20,13,4,7,0,0,0,4
Western Bulldogs,"Richards, Ed",5,5,1,0,0,0,0,3
Western Bulldogs,"Roberts, Fletcher",8,6,3,2,0,0,0,0
Western Bulldogs,"Roughead, Jordan",9,5,4,4,0,0,15,1
Western Bulldogs,"Schache, Josh",9,4,1,5,1,0,0,1
Western Bulldogs,"Trengove, Jackson",22,16,1,6,2,1,28,5
Western Bulldogs,"Wallis, Mitch",19,5,2,14,1,0,0,4
Western Bulldogs,"Bontempelli, Marcus",22,14,4,8,4,1,0,3
Western Bulldogs,"Cordy, Zaine",14,11,2,3,0,0,0,2
Western Bulldogs,"Crozier, Hayden",19,11,6,8,1,0,0,1
Western Bulldogs,"Daniel, Caleb",29,13,10,16,0,0,0,1
Western Bulldogs,"Dickson, Tory",12,6,4,6,1,0,0,2
Western Bulldogs,"Dunkley, Josh",33,12,6,21,0,1,0,7
Western Bulldogs,"Greene, Fergus",14,8,6,6,1,1,0,4
Western Bulldogs,"Hunter, Lachie",32,7,7,25,1,0,0,1
Western Bulldogs,"Johannisen, Jason",42,21,4,21,0,1,0,2
Western Bulldogs,"Jong, Lin",18,4,4,14,1,0,0,1
Western Bulldogs,"Lipinski, Patrick",22,11,10,11,1,0,0,6
Western Bulldogs,"Lynch, Brad",10,8,3,2,0,1,0,1
Western Bulldogs,"Macrae, Jack",36,21,8,15,1,0,0,2
Western Bulldogs,"McLean, Toby",22,8,2,14,0,1,0,4
Western Bulldogs,"Morris, Dale",10,4,2,6,0,0,0,0
Western Bulldogs,"Naughton, Aaron",13,7,7,6,0,0,2,2
Western Bulldogs,"Richards, Ed",8,6,2,2,0,1,0,0
Western Bulldogs,"Roughead, Jordan",19,10,9,9,0,2,10,3
Western Bulldogs,"Schache, Josh",11,5,2,6,3,1,0,0
Western Bulldogs,"Smith, Roarke",2,0,0,2,0,0,0,0
Western Bulldogs,"Trengove, Jackson",15,1,3,14,0,0,17,4
Western Bulldogs,"Wallis, Mitch",21,10,5,11,1,1,0,5
Western Bulldogs,"Bontempelli, Marcus",35,19,4,16,2,1,0,2
Western Bulldogs,"Cordy, Zaine",4,3,3,1,0,0,0,1
Western Bulldogs,"Crozier, Hayden",24,11,8,13,0,0,0,1
Western Bulldogs,"Daniel, Caleb",40,24,4,16,0,0,0,2
Western Bulldogs,"Dickson, Tory",14,7,4,7,3,1,0,0
Western Bulldogs,"Dunkley, Josh",26,12,5,14,0,0,0,4
Western Bulldogs,"Gowers, Billy",11,6,2,5,1,1,1,3
Western Bulldogs,"Greene, Fergus",11,9,6,2,1,4,0,1
Western Bulldogs,"Hunter, Lachie",44,24,8,20,0,1,0,2
Western Bulldogs,"Johannisen, Jason",24,14,5,10,1,0,0,3
Western Bulldogs,"Jong, Lin",15,7,3,8,1,0,0,1
Western Bulldogs,"Lipinski, Patrick",18,8,4,10,1,1,0,2
Western Bulldogs,"Lynch, Brad",8,5,1,3,0,1,0,0
Western Bulldogs,"Macrae, Jack",40,15,6,25,0,0,0,2
Western Bulldogs,"McLean, Toby",26,10,4,16,1,1,0,4
Western Bulldogs,"Morris, Dale",8,3,5,5,0,0,0,4
Western Bulldogs,"Naughton, Aaron",10,6,4,4,0,0,0,1
Western Bulldogs,"Richards, Ed",17,3,2,14,0,0,0,0
Western Bulldogs,"Roughead, Jordan",12,6,3,6,0,0,9,4
Western Bulldogs,"Schache, Josh",14,10,5,4,2,1,0,1
Western Bulldogs,"Trengove, Jackson",21,7,6,14,0,0,20,0
Western Bulldogs,"Wallis, Mitch",22,7,3,15,0,0,0,1
Western Bulldogs,"Bontempelli, Marcus",37,22,3,15,0,0,0,3
Western Bulldogs,"Crozier, Hayden",18,14,6,4,0,0,0,5
Western Bulldogs,"Daniel, Caleb",23,13,2,10,0,0,0,4
Western Bulldogs,"Dickson, Tory",7,5,2,2,0,0,0,2
Western Bulldogs,"Dunkley, Josh",36,13,7,23,0,3,0,6
Western Bulldogs,"Gowers, Billy",9,7,5,2,1,1,0,3
Western Bulldogs,"Greene, Fergus",6,4,2,2,1,1,0,4
Western Bulldogs,"Hunter, Lachie",33,17,4,16,1,0,0,2
Western Bulldogs,"Johannisen, Jason",24,15,6,9,1,0,0,1
Western Bulldogs,"Jong, Lin",13,9,5,4,2,0,0,1
Western Bulldogs,"Lipinski, Patrick",19,10,5,9,0,0,0,5
Western Bulldogs,"Lynch, Brad",7,4,4,3,0,0,0,0
Western Bulldogs,"Macrae, Jack",33,15,8,18,0,0,0,5
Western Bulldogs,"McLean, Toby",19,8,3,11,1,1,0,4
Western Bulldogs,"Morris, Dale",5,3,4,2,0,0,0,1
Western Bulldogs,"Naughton, Aaron",9,6,6,3,0,0,0,7
Western Bulldogs,"Richards, Ed",15,11,4,4,0,0,0,2
Western Bulldogs,"Roughead, Jordan",10,7,6,3,0,0,10,1
Western Bulldogs,"Schache, Josh",12,10,8,2,1,0,0,2
Western Bulldogs,"Trengove, Jackson",17,8,5,9,1,0,24,4
Western Bulldogs,"Wallis, Mitch",23,8,7,15,1,0,0,5
Western Bulldogs,"Wood, Easton",13,7,6,6,0,0,0,3
Western Bulldogs,"Bontempelli, Marcus",29,19,7,10,0,2,0,8
Western Bulldogs,"Crozier, Hayden",23,17,5,6,0,0,0,3
Western Bulldogs,"Daniel, Caleb",29,16,6,13,0,0,0,1
Western Bulldogs,"Dunkley, Josh",28,14,7,14,2,0,0,4
Western Bulldogs,"Gowers, Billy",13,9,8,4,3,1,0,2
Western Bulldogs,"Greene, Fergus",8,4,2,4,1,0,0,1
Western Bulldogs,"Hunter, Lachie",35,18,12,17,0,0,0,2
Western Bulldogs,"Johannisen, Jason",24,15,6,9,0,0,0,1
Western Bulldogs,"Lipinski, Patrick",6,4,3,2,0,0,0,1
Western Bulldogs,"Lynch, Brad",10,9,7,1,2,1,0,3
Western Bulldogs,"Macrae, Jack",43,24,14,19,1,0,0,7
Western Bulldogs,"McLean, Toby",17,7,7,10,0,0,0,5
Western Bulldogs,"Morris, Dale",9,2,0,7,0,0,0,1
Western Bulldogs,"Naughton, Aaron",18,12,9,6,0,0,0,1
Western Bulldogs,"Richards, Ed",10,3,4,7,1,0,0,1
Western Bulldogs,"Roughead, Jordan",12,7,6,5,0,1,5,1
Western Bulldogs,"Schache, Josh",10,4,4,6,1,0,0,1
Western Bulldogs,"Smith, Roarke",15,6,3,9,0,0,0,2
Western Bulldogs,"Trengove, Jackson",16,11,6,5,1,0,15,7
Western Bulldogs,"Wallis, Mitch",23,10,2,13,1,0,0,2
Western Bulldogs,"Williams, Bailey",18,12,6,6,1,1,0,1
Western Bulldogs,"Wood, Easton",17,10,7,7,0,0,0,1
Adelaide,"Atkins, Rory",19,14,5,5,3,0,0,7
Adelaide,"Betts, Eddie",18,14,4,4,4,2,0,1
Adelaide,"Brown, Luke",18,9,4,9,0,0,0,3
Adelaide,"Cameron, Charlie",23,17,4,6,2,3,0,6
Adelaide,"Crouch, Matt",29,9,3,20,0,0,0,5
Adelaide,"Douglas, Richard",27,16,6,11,2,0,0,1
Adelaide,"Hampton, Curtly",11,7,4,4,0,1,0,6
Adelaide,"Hartigan, Kyle",14,8,8,6,0,0,0,3
Adelaide,"Jacobs, Sam",13,3,2,10,0,0,28,3
Adelaide,"Jenkins, Josh",20,16,7,4,3,3,3,0
Adelaide,"Kelly, Jake",17,7,4,10,0,0,0,0
Adelaide,"Knight, Riley",18,6,5,12,2,0,0,1
Adelaide,"Laird, Rory",40,23,6,17,0,0,0,4
Adelaide,"Lynch, Tom",17,10,4,7,0,0,0,1
Adelaide,"Mackay, David",20,11,4,9,1,0,0,5
Adelaide,"McGovern, Mitch",15,9,5,6,2,2,0,0
Adelaide,"Menzel, Troy",14,11,3,3,1,0,0,3
Adelaide,"Milera, Wayne",23,13,5,10,1,0,0,3
Adelaide,"Otten, Andy",10,6,3,4,0,0,0,2
Adelaide,"Sloane, Rory",24,9,0,15,0,0,0,4
Adelaide,"Smith, Brodie",19,10,4,9,1,2,0,1
Adelaide,"Talia, Daniel",6,2,1,4,0,0,0,1
Adelaide,"Atkins, Rory",19,11,5,8,1,0,0,2
Adelaide,"Betts, Eddie",13,6,2,7,3,0,0,4
Adelaide,"Brown, Luke",12,8,3,4,1,0,0,1
Adelaide,"Cameron, Charlie",17,11,3,6,1,2,0,9
Adelaide,"Crouch, Matt",28,6,1,22,0,1,0,4
Adelaide,"Douglas, Richard",13,8,1,5,0,0,0,3
Adelaide,"Hampton, Curtly",12,7,1,5,0,0,0,10
Adelaide,"Hartigan, Kyle",13,8,6,5,0,0,0,4
Adelaide,"Jacobs, Sam",15,11,6,4,1,1,43,0
Adelaide,"Jenkins, Josh",1,0,0,1,0,0,0,0
Adelaide,"Kelly, Jake",7,5,1,2,0,0,0,1
Adelaide,"Knight, Riley",16,9,3,7,0,1,0,4
Adelaide,"Laird, Rory",21,11,5,10,0,0,0,5
Adelaide,"Lynch, Tom",31,14,14,17,1,2,0,4
Adelaide,"Mackay, David",13,9,3,4,3,0,0,2
Adelaide,"McGovern, Mitch",14,11,6,3,1,3,0,4
Adelaide,"Milera, Wayne",16,8,3,8,0,0,0,3
Adelaide,"Otten, Andy",17,6,4,11,1,0,2,5
Adelaide,"Sloane, Rory",25,16,6,9,1,1,0,15
Adelaide,"Smith, Brodie",24,10,1,14,0,0,0,2
Adelaide,"Talia, Daniel",20,7,8,13,0,0,0,1
Adelaide,"Walker, Taylor",21,12,8,9,2,2,0,0
Adelaide,"Atkins, Rory",19,9,3,10,0,0,0,0
Adelaide,"Betts, Eddie",16,12,5,4,3,1,0,4
Adelaide,"Brown, Luke",13,7,4,6,0,0,0,1
Adelaide,"Cameron, Charlie",16,9,3,7,0,1,0,6
Adelaide,"Crouch, Matt",32,21,5,11,0,0,0,5
Adelaide,"Douglas, Richard",29,18,3,11,0,2,0,7
Adelaide,"Hampton, Curtly",18,12,3,6,0,0,0,9
Adelaide,"Hartigan, Kyle",16,6,2,10,0,0,0,1
Adelaide,"Jacobs, Sam",9,5,4,4,0,0,42,5
Adelaide,"Kelly, Jake",16,6,2,10,0,0,0,4
Adelaide,"Knight, Riley",14,7,5,7,2,0,0,4
Adelaide,"Laird, Rory",25,14,4,11,0,0,0,4
Adelaide,"Lever, Jake",9,5,3,4,0,0,0,1
Adelaide,"Lynch, Tom",22,14,7,8,2,0,0,3
Adelaide,"Mackay, David",11,7,2,4,1,0,0,4
Adelaide,"McGovern, Mitch",10,5,3,5,0,1,0,2
Adelaide,"Milera, Wayne",12,6,2,6,0,0,0,2
Adelaide,"Otten, Andy",16,8,3,8,2,0,4,3
Adelaide,"Sloane, Rory",31,15,5,16,1,1,0,9
Adelaide,"Smith, Brodie",23,15,2,8,0,2,0,1
Adelaide,"Talia, Daniel",13,7,2,6,0,0,0,1
Adelaide,"Walker, Taylor",17,15,10,2,4,1,0,3
Adelaide,"Atkins, Rory",23,8,2,15,2,0,0,3
Adelaide,"Betts, Eddie",22,9,5,13,6,2,0,3
Adelaide,"Brown, Luke",9,6,2,3,0,0,0,1
Adelaide,"Cameron, Charlie",16,13,3,3,1,1,0,3
Adelaide,"Crouch, Matt",31,10,2,21,0,0,0,4
Adelaide,"Douglas, Richard",20,11,1,9,1,1,0,5
Adelaide,"Hampton, Curtly",15,5,1,10,0,0,0,3
Adelaide,"Hartigan, Kyle",12,7,3,5,0,0,0,2
Adelaide,"Jacobs, Sam",17,5,2,12,0,0,33,7
Adelaide,"Kelly, Jake",5,2,1,3,0,0,0,1
Adelaide,"Knight, Riley",20,8,7,12,0,0,0,1
Adelaide,"Laird, Rory",36,16,2,20,1,0,0,2
Adelaide,"Lever, Jake",13,8,5,5,0,0,0,0
Adelaide,"Lynch, Tom",14,9,9,5,2,1,0,2
Adelaide,"Mackay, David",21,12,2,9,0,0,0,3
Adelaide,"Menzel, Troy",9,6,3,3,1,2,0,5
Adelaide,"Milera, Wayne",19,10,2,9,0,0,0,0
Adelaide,"Otten, Andy",13,6,1,7,2,1,6,0
Adelaide,"Sloane, Rory",34,20,3,14,2,0,0,9
Adelaide,"Smith, Brodie",33,16,6,17,1,0,0,1
Adelaide,"Talia, Daniel",12,4,3,8,0,0,0,3
Adelaide,"Walker, Taylor",19,15,10,4,5,0,0,2
Adelaide,"Atkins, Rory",29,11,3,18,1,0,0,1
Adelaide,"Betts, Eddie",12,10,3,2,3,1,0,3
Adelaide,"Brown, Luke",15,8,3,7,1,0,0,1
Adelaide,"Cameron, Charlie",13,8,2,5,2,1,0,4
Adelaide,"Crouch, Brad",33,13,1,20,0,2,0,8
Adelaide,"Crouch, Matt",35,17,4,18,1,0,0,3
Adelaide,"Douglas, Richard",18,8,3,10,0,0,0,2
Adelaide,"Hampton, Curtly",21,7,6,14,2,0,0,10
Adelaide,"Hartigan, Kyle",10,5,2,5,0,0,0,1
Adelaide,"Jacobs, Sam",14,3,4,11,0,0,34,2
Adelaide,"Knight, Riley",19,9,3,10,2,0,0,1
Adelaide,"Laird, Rory",33,13,7,20,0,1,0,3
Adelaide,"Lever, Jake",14,8,6,6,0,0,0,0
Adelaide,"Lynch, Tom",20,15,10,5,3,3,0,0
Adelaide,"Mackay, David",23,9,4,14,0,0,0,2
Adelaide,"Menzel, Troy",4,2,0,2,2,0,0,2
Adelaide,"Milera, Wayne",17,9,2,8,0,0,0,2
Adelaide,"Otten, Andy",21,13,9,8,2,1,0,3
Adelaide,"Sloane, Rory",30,13,1,17,1,0,0,13
Adelaide,"Smith, Brodie",22,12,5,10,1,0,0,1
Adelaide,"Talia, Daniel",1,1,0,0,0,0,0,0
Adelaide,"Walker, Taylor",18,11,2,7,2,1,0,1
Adelaide,"Atkins, Rory",23,18,8,5,0,1,0,4
Adelaide,"Betts, Eddie",16,13,5,3,1,1,0,3
Adelaide,"Brown, Luke",17,9,4,8,0,0,0,5
Adelaide,"Cameron, Charlie",13,10,7,3,2,1,0,6
Adelaide,"Crouch, Brad",26,10,0,16,0,0,0,6
Adelaide,"Crouch, Matt",38,15,4,23,1,0,0,3
Adelaide,"Douglas, Richard",25,14,0,11,1,0,0,5
Adelaide,"Hampton, Curtly",14,8,2,6,0,1,0,2
Adelaide,"Hartigan, Kyle",10,7,5,3,0,0,0,2
Adelaide,"Jacobs, Sam",26,15,9,11,1,1,50,2
Adelaide,"Jenkins, Josh",11,5,4,6,1,0,1,2
Adelaide,"Kelly, Jake",28,12,10,16,0,0,0,1
Adelaide,"Laird, Rory",34,16,5,18,0,0,0,4
Adelaide,"Lever, Jake",20,9,8,11,0,0,1,1
Adelaide,"Lynch, Tom",22,13,9,9,3,2,0,1
Adelaide,"Mackay, David",21,13,4,8,0,0,0,3
Adelaide,"Milera, Wayne",16,9,4,7,1,0,0,3
Adelaide,"Otten, Andy",14,10,6,4,1,1,11,3
Adelaide,"Sloane, Rory",33,15,8,18,3,0,0,8
Adelaide,"Smith, Brodie",22,9,8,13,1,0,0,3
Adelaide,"Talia, Daniel",17,9,8,8,0,0,0,3
Adelaide,"Walker, Taylor",15,11,7,4,5,2,0,0
Adelaide,"Atkins, Rory",20,10,3,10,1,1,0,2
Adelaide,"Betts, Eddie",13,9,1,4,3,0,0,2
Adelaide,"Brown, Luke",13,9,2,4,0,0,0,2
Adelaide,"Cameron, Charlie",14,9,1,5,2,0,0,1
Adelaide,"Crouch, Brad",24,12,0,12,0,0,0,5
Adelaide,"Crouch, Matt",38,12,5,26,0,0,0,4
Adelaide,"Douglas, Richard",30,17,4,13,2,0,0,4
Adelaide,"Hampton, Curtly",14,5,0,9,0,0,0,3
Adelaide,"Hartigan, Kyle",18,9,5,9,0,0,0,1
Adelaide,"Jacobs, Sam",19,9,4,10,1,0,35,1
Adelaide,"Jenkins, Josh",13,10,6,3,2,2,2,2
Adelaide,"Kelly, Jake",12,6,2,6,0,0,0,0
Adelaide,"Knight, Riley",8,3,0,5,0,0,0,2
Adelaide,"Laird, Rory",37,11,3,26,0,0,0,2
Adelaide,"Lever, Jake",13,9,5,4,1,1,0,4
Adelaide,"Lynch, Tom",10,7,2,3,0,0,0,1
Adelaide,"Mackay, David",16,8,2,8,0,0,0,1
Adelaide,"Otten, Andy",16,7,6,9,0,0,1,5
Adelaide,"Sloane, Rory",18,9,3,9,0,0,0,4
Adelaide,"Smith, Brodie",12,9,2,3,0,0,0,1
Adelaide,"Talia, Daniel",24,11,9,13,0,0,0,2
Adelaide,"Walker, Taylor",7,4,4,3,1,1,0,1
Adelaide,"Atkins, Rory",21,15,4,6,1,0,0,2
Adelaide,"Betts, Eddie",9,7,1,2,2,0,0,2
Adelaide,"Brown, Luke",20,7,3,13,0,0,0,0
Adelaide,"Cameron, Charlie",10,5,1,5,0,0,0,5
Adelaide,"Crouch, Brad",26,8,2,18,0,0,0,3
Adelaide,"Crouch, Matt",29,15,2,14,0,1,0,3
Adelaide,"Douglas, Richard",22,11,2,11,0,2,0,9
Adelaide,"Hampton, Curtly",15,6,1,9,0,0,0,4
Adelaide,"Hartigan, Kyle",11,3,3,8,0,0,0,0
Adelaide,"Jacobs, Sam",13,8,5,5,0,1,74,4
Adelaide,"Jenkins, Josh",10,7,6,3,2,1,2,2
Adelaide,"Kelly, Jake",16,6,3,10,0,0,0,3
Adelaide,"Laird, Rory",37,11,4,26,1,0,0,2
Adelaide,"Lynch, Tom",16,7,5,9,0,0,0,3
Adelaide,"Mackay, David",12,8,4,4,0,0,0,3
Adelaide,"Menzel, Troy",11,7,4,4,0,1,0,3
Adelaide,"Milera, Wayne",20,9,5,11,0,0,0,1
Adelaide,"Otten, Andy",15,6,3,9,0,2,0,2
Adelaide,"Sloane, Rory",11,6,0,5,0,1,0,12
Adelaide,"Smith, Brodie",26,16,5,10,1,0,0,1
Adelaide,"Talia, Daniel",14,6,3,8,0,0,0,5
Adelaide,"Walker, Taylor",15,10,3,5,2,2,0,2
Adelaide,"Atkins, Rory",28,17,9,11,0,1,0,3
Adelaide,"Betts, Eddie",16,13,4,3,3,2,0,4
Adelaide,"Brown, Luke",25,18,7,7,0,0,0,2
Adelaide,"Cameron, Charlie",18,15,7,3,4,2,0,2
Adelaide,"Crouch, Brad",29,10,4,19,1,0,0,4
Adelaide,"Crouch, Matt",32,12,2,20,0,0,0,3
Adelaide,"Douglas, Richard",24,15,2,9,0,0,0,3
Adelaide,"Gallucci, Jordan",11,7,2,4,1,0,0,3
Adelaide,"Greenwood, Hugh",15,9,2,6,3,0,0,9
Adelaide,"Hampton, Curtly",9,6,2,3,0,0,0,4
Adelaide,"Hartigan, Kyle",9,6,5,3,0,0,0,1
Adelaide,"Jacobs, Sam",14,7,2,7,0,0,35,2
Adelaide,"Kelly, Jake",21,11,4,10,0,0,0,3
Adelaide,"Laird, Rory",37,19,6,18,0,0,0,1
Adelaide,"Lever, Jake",20,13,7,7,0,0,0,1
Adelaide,"Lynch, Tom",23,16,8,7,3,2,0,3
Adelaide,"Milera, Wayne",14,9,2,5,1,1,0,1
Adelaide,"Otten, Andy",14,8,1,6,2,1,5,3
Adelaide,"Sloane, Rory",31,17,4,14,0,0,0,4
Adelaide,"Smith, Brodie",13,8,2,5,0,0,0,1
Adelaide,"Talia, Daniel",20,7,7,13,0,0,0,1
Adelaide,"Walker, Taylor",19,14,10,5,3,3,0,2
Adelaide,"Atkins, Rory",37,24,6,13,0,1,0,4
Adelaide,"Betts, Eddie",14,9,3,5,3,2,0,4
Adelaide,"Brown, Luke",16,10,5,6,0,0,0,2
Adelaide,"Cameron, Charlie",13,9,2,4,3,0,0,4
Adelaide,"Crouch, Brad",30,12,2,18,0,1,0,6
Adelaide,"Crouch, Matt",35,18,3,17,0,0,0,6
Adelaide,"Douglas, Richard",19,8,2,11,0,0,0,5
Adelaide,"Greenwood, Hugh",11,4,1,7,0,1,0,6
Adelaide,"Hartigan, Kyle",14,9,4,5,0,0,0,0
Adelaide,"Jacobs, Sam",13,7,5,6,1,1,40,3
Adelaide,"Jenkins, Josh",14,11,7,3,3,1,9,6
Adelaide,"Kelly, Jake",17,9,3,8,0,0,0,8
Adelaide,"Laird, Rory",27,15,3,12,0,0,0,0
Adelaide,"Lever, Jake",29,20,11,9,0,0,0,0
Adelaide,"Lynch, Tom",21,12,4,9,0,1,0,1
Adelaide,"Mackay, David",17,13,2,4,0,2,0,3
Adelaide,"Milera, Wayne",16,11,5,5,3,1,0,4
Adelaide,"Otten, Andy",17,11,8,6,4,0,0,4
Adelaide,"Sloane, Rory",30,17,5,13,2,1,0,13
Adelaide,"Smith, Brodie",20,13,4,7,0,1,0,1
Adelaide,"Talia, Daniel",18,11,5,7,0,0,0,1
Adelaide,"Walker, Taylor",7,7,3,0,1,2,0,2
Adelaide,"Atkins, Rory",14,7,3,7,0,0,0,4
Adelaide,"Betts, Eddie",12,8,1,4,1,1,0,5
Adelaide,"Brown, Luke",12,6,2,6,0,0,0,5
Adelaide,"Cameron, Charlie",8,6,1,2,1,1,0,4
Adelaide,"Crouch, Brad",28,11,5,17,0,0,0,7
Adelaide,"Crouch, Matt",27,14,2,13,0,0,0,5
Adelaide,"Douglas, Richard",18,11,2,7,0,0,0,6
Adelaide,"Greenwood, Hugh",18,12,1,6,0,0,0,11
Adelaide,"Hartigan, Kyle",7,6,2,1,0,0,0,1
Adelaide,"Jacobs, Sam",15,5,3,10,0,0,45,1
Adelaide,"Jenkins, Josh",14,7,2,7,2,0,5,1
Adelaide,"Kelly, Jake",10,5,2,5,0,0,0,2
Adelaide,"Laird, Rory",20,13,1,7,0,0,0,2
Adelaide,"Lever, Jake",14,8,6,6,0,0,0,1
Adelaide,"Lynch, Tom",20,11,6,9,2,2,0,2
Adelaide,"Mackay, David",13,9,2,4,0,0,0,5
Adelaide,"Milera, Wayne",14,8,5,6,0,0,0,2
Adelaide,"Otten, Andy",9,6,2,3,1,1,0,2
Adelaide,"Sloane, Rory",23,13,2,10,0,0,0,7
Adelaide,"Smith, Brodie",11,8,2,3,0,0,0,5
Adelaide,"Talia, Daniel",2,1,0,1,0,0,0,1
Adelaide,"Walker, Taylor",12,11,8,1,3,3,0,3
Adelaide,"Atkins, Rory",25,11,6,14,0,0,0,5
Adelaide,"Beech, Jonathon",15,7,4,8,1,0,0,4
Adelaide,"Betts, Eddie",11,7,4,4,2,1,0,3
Adelaide,"Cameron, Charlie",13,6,2,7,0,2,0,3
Adelaide,"Crouch, Brad",24,9,1,15,0,1,0,8
Adelaide,"Crouch, Matt",29,10,2,19,0,1,0,2
Adelaide,"Douglas, Richard",28,12,3,16,0,0,0,4
Adelaide,"Greenwood, Hugh",17,6,1,11,0,0,0,3
Adelaide,"Hartigan, Kyle",16,9,6,7,0,0,0,2
Adelaide,"Jacobs, Sam",25,11,5,14,0,0,37,3
Adelaide,"Jenkins, Josh",14,12,8,2,3,3,5,2
Adelaide,"Kelly, Jake",18,9,4,9,0,0,0,0
Adelaide,"Knight, Riley",12,3,3,9,0,0,0,3
Adelaide,"Laird, Rory",34,15,4,19,0,0,0,5
Adelaide,"Lever, Jake",20,15,6,5,0,0,0,2
Adelaide,"Lynch, Tom",22,17,8,5,3,1,0,2
Adelaide,"Milera, Wayne",14,9,3,5,1,0,0,4
Adelaide,"Otten, Andy",9,7,4,2,1,1,0,1
Adelaide,"Sloane, Rory",14,7,1,7,1,0,0,4
Adelaide,"Smith, Brodie",26,13,6,13,1,0,0,0
Adelaide,"Talia, Daniel",14,5,4,9,0,0,0,3
Adelaide,"Walker, Taylor",18,13,7,5,3,2,0,0
Adelaide,"Atkins, Rory",28,21,5,7,0,0,0,0
Adelaide,"Beech, Jonathon",12,5,2,7,0,0,0,3
Adelaide,"Betts, Eddie",14,7,4,7,1,3,0,2
Adelaide,"Brown, Luke",10,7,3,3,0,0,0,2
Adelaide,"Cameron, Charlie",15,9,3,6,1,1,0,6
Adelaide,"Crouch, Brad",29,10,0,19,1,0,0,11
Adelaide,"Crouch, Matt",35,13,5,22,0,0,0,8
Adelaide,"Douglas, Richard",18,9,4,9,0,0,0,2
Adelaide,"Greenwood, Hugh",21,12,6,9,2,0,0,9
Adelaide,"Hartigan, Kyle",12,7,6,5,0,0,0,0
Adelaide,"Jacobs, Sam",12,6,5,6,0,0,39,2
Adelaide,"Jenkins, Josh",18,12,4,6,3,1,9,2
Adelaide,"Kelly, Jake",20,10,5,10,0,0,0,4
Adelaide,"Laird, Rory",28,12,2,16,0,0,0,2
Adelaide,"Lever, Jake",15,8,7,7,0,0,0,2
Adelaide,"Lynch, Tom",24,13,7,11,1,1,0,2
Adelaide,"Milera, Wayne",14,5,3,9,0,0,0,2
Adelaide,"Otten, Andy",6,3,1,3,1,0,0,2
Adelaide,"Sloane, Rory",23,12,0,11,0,0,0,7
Adelaide,"Smith, Brodie",20,16,4,4,0,1,0,2
Adelaide,"Talia, Daniel",20,9,7,11,0,0,0,3
Adelaide,"Walker, Taylor",12,10,6,2,2,0,0,2
Adelaide,"Atkins, Rory",15,5,4,10,0,1,0,1
Adelaide,"Beech, Jonathon",11,3,4,8,0,0,0,2
Adelaide,"Betts, Eddie",11,9,3,2,2,2,0,6
Adelaide,"Brown, Luke",15,10,6,5,0,0,0,2
Adelaide,"Crouch, Brad",30,14,5,16,0,1,0,10
Adelaide,"Crouch, Matt",29,12,1,17,1,0,0,5
Adelaide,"Douglas, Richard",25,18,2,7,0,0,0,3
Adelaide,"Greenwood, Hugh",12,3,1,9,0,0,0,9
Adelaide,"Hartigan, Kyle",1,1,0,0,0,0,0,1
Adelaide,"Jacobs, Sam",10,3,2,7,1,0,31,3
Adelaide,"Jenkins, Josh",13,10,5,3,3,1,9,13
Adelaide,"Kelly, Jake",11,5,1,6,0,0,0,3
Adelaide,"Knight, Riley",18,5,4,13,2,1,0,5
Adelaide,"Laird, Rory",25,12,5,13,0,0,0,1
Adelaide,"Lever, Jake",14,8,3,6,0,0,0,6
Adelaide,"Mackay, David",21,15,3,6,0,0,0,3
Adelaide,"McGovern, Mitch",9,6,6,3,1,0,0,3
Adelaide,"Milera, Wayne",12,7,2,5,0,0,0,1
Adelaide,"Sloane, Rory",19,11,4,8,1,0,0,6
Adelaide,"Smith, Brodie",30,18,6,12,1,1,0,0
Adelaide,"Talia, Daniel",9,5,2,4,0,0,0,1
Adelaide,"Walker, Taylor",13,5,4,8,1,2,0,3
Adelaide,"Atkins, Rory",23,15,7,8,1,0,0,3
Adelaide,"Betts, Eddie",13,11,4,2,2,0,0,1
Adelaide,"Brown, Luke",14,9,6,5,0,0,0,3
Adelaide,"Cameron, Charlie",10,5,1,5,1,0,0,2
Adelaide,"Crouch, Brad",24,15,4,9,1,0,0,7
Adelaide,"Crouch, Matt",32,16,5,16,1,1,0,2
Adelaide,"Douglas, Richard",14,13,3,1,1,0,0,3
Adelaide,"Jacobs, Sam",11,6,2,5,0,0,36,3
Adelaide,"Jenkins, Josh",15,12,11,3,4,1,5,2
Adelaide,"Kelly, Jake",17,9,8,8,0,0,0,9
Adelaide,"Knight, Riley",15,6,7,9,1,0,0,6
Adelaide,"Laird, Rory",32,23,12,9,0,0,0,3
Adelaide,"Lever, Jake",22,16,11,6,0,0,0,3
Adelaide,"Mackay, David",20,13,3,7,0,1,0,5
Adelaide,"McGovern, Mitch",18,10,6,8,0,0,0,3
Adelaide,"Milera, Wayne",11,7,2,4,0,1,0,4
Adelaide,"Otten, Andy",21,12,10,9,0,0,0,1
Adelaide,"Sloane, Rory",24,12,4,12,1,0,0,8
Adelaide,"Smith, Brodie",18,12,6,6,0,1,0,4
Adelaide,"Talia, Daniel",14,10,7,4,0,0,0,3
Adelaide,"Thompson, Scott",10,5,1,5,0,0,0,5
Adelaide,"Walker, Taylor",18,11,7,7,3,1,0,4
Adelaide,"Atkins, Rory",18,9,1,9,0,0,0,0
Adelaide,"Betts, Eddie",16,11,5,5,2,2,0,1
Adelaide,"Brown, Luke",17,12,4,5,0,0,0,4
Adelaide,"Cameron, Charlie",20,12,2,8,0,0,0,2
Adelaide,"Crouch, Brad",27,9,3,18,1,0,0,7
Adelaide,"Crouch, Matt",31,13,4,18,0,0,0,3
Adelaide,"Douglas, Richard",23,15,4,8,0,0,0,2
Adelaide,"Greenwood, Hugh",16,6,3,10,0,0,0,7
Adelaide,"Jacobs, Sam",9,8,3,1,1,0,42,4
Adelaide,"Jenkins, Josh",13,8,6,5,1,1,8,2
Adelaide,"Kelly, Jake",11,5,3,6,0,0,0,4
Adelaide,"Knight, Riley",13,7,1,6,1,1,0,6
Adelaide,"Laird, Rory",34,17,5,17,0,0,0,3
Adelaide,"Lever, Jake",10,8,6,2,0,0,0,2
Adelaide,"Lynch, Tom",27,19,11,8,3,2,0,1
Adelaide,"Mackay, David",21,11,3,10,2,0,0,3
Adelaide,"McGovern, Mitch",11,9,7,2,2,2,0,1
Adelaide,"Otten, Andy",10,4,4,6,0,0,0,2
Adelaide,"Sloane, Rory",8,4,0,4,0,0,0,5
Adelaide,"Smith, Brodie",19,12,4,7,0,1,0,4
Adelaide,"Talia, Daniel",19,10,7,9,0,0,0,1
Adelaide,"Walker, Taylor",21,15,8,6,4,4,0,3
Adelaide,"Atkins, Rory",19,11,5,8,0,1,0,5
Adelaide,"Betts, Eddie",8,3,4,5,0,0,0,6
Adelaide,"Brown, Luke",11,10,7,1,1,0,0,0
Adelaide,"Cameron, Charlie",6,5,1,1,1,0,0,2
Adelaide,"Crouch, Brad",29,14,3,15,0,0,0,7
Adelaide,"Crouch, Matt",32,14,4,18,0,1,0,5
Adelaide,"Douglas, Richard",20,11,1,9,4,0,0,5
Adelaide,"Greenwood, Hugh",23,13,2,10,1,2,0,4
Adelaide,"Jacobs, Sam",17,11,7,6,0,0,32,1
Adelaide,"Jenkins, Josh",13,10,6,3,1,0,7,0
Adelaide,"Keath, Alex",6,6,3,0,0,0,0,3
Adelaide,"Kelly, Jake",12,8,7,4,0,0,0,2
Adelaide,"Knight, Riley",9,5,1,4,0,0,0,6
Adelaide,"Laird, Rory",22,11,6,11,0,0,0,1
Adelaide,"Lynch, Tom",19,12,7,7,1,1,0,3
Adelaide,"Mackay, David",14,12,1,2,0,1,0,2
Adelaide,"McGovern, Mitch",9,6,3,3,0,2,0,3
Adelaide,"Otten, Andy",11,7,4,4,0,0,0,0
Adelaide,"Sloane, Rory",28,18,3,10,3,2,0,7
Adelaide,"Smith, Brodie",17,16,7,1,0,0,0,3
Adelaide,"Talia, Daniel",9,4,4,5,0,0,0,3
Adelaide,"Walker, Taylor",12,7,5,5,1,2,0,2
Adelaide,"Atkins, Rory",16,12,3,4,0,0,0,3
Adelaide,"Brown, Luke",10,7,1,3,0,0,0,2
Adelaide,"Cameron, Charlie",9,6,1,3,1,3,0,8
Adelaide,"Crouch, Matt",36,13,0,23,0,0,0,10
Adelaide,"Douglas, Richard",28,16,4,12,0,0,0,2
Adelaide,"Greenwood, Hugh",15,7,2,8,0,0,0,3
Adelaide,"Jacobs, Sam",14,7,3,7,0,0,39,5
Adelaide,"Jenkins, Josh",13,7,4,6,3,0,7,3
Adelaide,"Keath, Alex",10,7,4,3,0,0,0,2
Adelaide,"Kelly, Jake",17,9,5,8,0,0,0,4
Adelaide,"Knight, Riley",17,5,5,12,1,0,0,8
Adelaide,"Laird, Rory",25,12,5,13,0,0,0,0
Adelaide,"Lynch, Tom",19,12,7,7,1,0,0,1
Adelaide,"Mackay, David",22,11,6,11,1,1,0,2
Adelaide,"McGovern, Mitch",10,9,8,1,4,2,0,1
Adelaide,"Milera, Wayne",15,9,3,6,0,0,0,2
Adelaide,"Otten, Andy",16,7,4,9,2,0,0,0
Adelaide,"Seedsman, Paul",16,13,5,3,1,0,0,4
Adelaide,"Sloane, Rory",16,5,1,11,0,0,0,3
Adelaide,"Smith, Brodie",26,15,8,11,1,0,0,3
Adelaide,"Talia, Daniel",12,3,6,9,0,0,0,0
Adelaide,"Walker, Taylor",14,5,4,9,1,0,0,2
Adelaide,"Atkins, Rory",16,9,3,7,0,1,0,2
Adelaide,"Betts, Eddie",16,11,6,5,4,4,0,4
Adelaide,"Brown, Luke",20,12,6,8,0,0,0,1
Adelaide,"Cameron, Charlie",17,14,3,3,0,2,0,4
Adelaide,"Crouch, Brad",29,15,5,14,1,0,0,8
Adelaide,"Crouch, Matt",34,13,2,21,0,1,0,8
Adelaide,"Douglas, Richard",24,15,3,9,0,1,0,3
Adelaide,"Greenwood, Hugh",15,6,2,9,1,0,0,13
Adelaide,"Jacobs, Sam",12,10,3,2,2,1,42,6
Adelaide,"Jenkins, Josh",13,10,3,3,4,2,2,4
Adelaide,"Keath, Alex",11,5,3,6,0,0,0,1
Adelaide,"Kelly, Jake",15,7,2,8,0,0,0,0
Adelaide,"Knight, Riley",14,7,4,7,0,0,0,4
Adelaide,"Laird, Rory",28,18,8,10,1,0,0,2
Adelaide,"Lever, Jake",18,12,8,6,0,0,0,2
Adelaide,"Lynch, Tom",29,19,4,10,1,2,0,1
Adelaide,"Mackay, David",0,0,0,0,0,0,0,1
Adelaide,"McGovern, Mitch",10,9,3,1,0,3,0,3
Adelaide,"Sloane, Rory",30,21,5,9,1,0,0,7
Adelaide,"Smith, Brodie",20,14,5,6,0,0,0,4
Adelaide,"Talia, Daniel",13,9,4,4,0,0,0,1
Adelaide,"Walker, Taylor",23,14,8,9,3,2,0,4
Adelaide,"Atkins, Rory",27,16,7,11,1,0,0,1
Adelaide,"Betts, Eddie",7,6,0,1,0,1,0,4
Adelaide,"Brown, Luke",17,13,4,4,0,0,0,2
Adelaide,"Cameron, Charlie",13,12,6,1,0,1,0,6
Adelaide,"Crouch, Brad",20,8,1,12,1,0,0,4
Adelaide,"Crouch, Matt",35,13,1,22,0,0,0,4
Adelaide,"Douglas, Richard",23,14,6,9,2,0,0,2
Adelaide,"Greenwood, Hugh",16,6,7,10,1,1,0,1
Adelaide,"Jacobs, Sam",11,8,1,3,0,0,26,2
Adelaide,"Jenkins, Josh",21,12,11,9,3,2,9,3
Adelaide,"Keath, Alex",18,8,11,10,0,0,0,2
Adelaide,"Kelly, Jake",14,8,9,6,0,0,0,3
Adelaide,"Knight, Riley",13,7,4,6,1,1,0,0
Adelaide,"Laird, Rory",27,13,10,14,0,0,0,0
Adelaide,"Lever, Jake",14,10,3,4,0,0,0,4
Adelaide,"Lynch, Tom",17,13,8,4,1,1,0,3
Adelaide,"Mackay, David",19,13,5,6,1,1,0,7
Adelaide,"McGovern, Mitch",10,8,5,2,3,1,0,3
Adelaide,"Sloane, Rory",21,13,2,8,0,0,0,9
Adelaide,"Smith, Brodie",23,15,9,8,2,0,0,5
Adelaide,"Talia, Daniel",9,4,2,5,0,0,0,1
Adelaide,"Walker, Taylor",12,11,7,1,2,2,0,2
Adelaide,"Atkins, Rory",21,11,3,10,0,0,0,2
Adelaide,"Betts, Eddie",16,9,3,7,2,3,0,5
Adelaide,"Brown, Luke",17,10,3,7,0,0,0,2
Adelaide,"Cameron, Charlie",10,7,3,3,0,2,0,4
Adelaide,"Crouch, Brad",26,12,2,14,0,2,0,6
Adelaide,"Crouch, Matt",34,10,4,24,1,0,0,3
Adelaide,"Douglas, Richard",13,6,3,7,0,1,0,1
Adelaide,"Greenwood, Hugh",21,7,3,14,0,0,0,11
Adelaide,"Jacobs, Sam",14,11,3,3,0,0,48,3
Adelaide,"Jenkins, Josh",19,12,3,7,1,2,5,4
Adelaide,"Keath, Alex",12,5,2,7,0,0,0,5
Adelaide,"Kelly, Jake",9,3,1,6,0,0,0,2
Adelaide,"Knight, Riley",22,10,5,12,0,1,0,4
Adelaide,"Laird, Rory",34,17,10,17,0,0,0,0
Adelaide,"Lever, Jake",13,10,5,3,0,0,0,1
Adelaide,"Lynch, Tom",24,15,7,9,1,0,0,5
Adelaide,"Mackay, David",18,14,2,4,0,0,0,6
Adelaide,"McGovern, Mitch",14,12,7,2,4,1,0,4
Adelaide,"Sloane, Rory",29,19,3,10,1,0,0,14
Adelaide,"Smith, Brodie",20,17,7,3,0,0,0,1
Adelaide,"Talia, Daniel",11,6,1,5,0,0,0,2
Adelaide,"Walker, Taylor",13,9,5,4,1,0,0,2
Adelaide,"Atkins, Rory",21,6,5,15,0,0,0,1
Adelaide,"Betts, Eddie",12,8,4,4,2,2,0,4
Adelaide,"Brown, Luke",9,5,3,4,0,0,0,0
Adelaide,"Cameron, Charlie",10,5,1,5,1,0,0,4
Adelaide,"Crouch, Brad",42,13,5,29,0,0,0,6
Adelaide,"Crouch, Matt",45,19,2,26,1,1,0,7
Adelaide,"Douglas, Richard",22,8,3,14,0,1,0,2
Adelaide,"Hartigan, Kyle",12,7,5,5,0,0,0,1
Adelaide,"Jacobs, Sam",17,10,3,7,0,0,51,2
Adelaide,"Jenkins, Josh",11,4,4,7,1,0,3,1
Adelaide,"Keath, Alex",7,5,4,2,0,0,0,0
Adelaide,"Kelly, Jake",16,10,5,6,0,0,0,3
Adelaide,"Knight, Riley",11,4,4,7,0,1,0,4
Adelaide,"Laird, Rory",26,13,4,13,0,0,0,4
Adelaide,"Lever, Jake",17,8,7,9,0,0,0,1
Adelaide,"Lynch, Tom",12,8,4,4,0,1,0,1
Adelaide,"Mackay, David",17,8,1,9,0,1,0,2
Adelaide,"McGovern, Mitch",6,5,5,1,2,0,0,4
Adelaide,"Milera, Wayne",16,12,5,4,1,0,0,2
Adelaide,"Seedsman, Paul",25,12,3,13,1,2,0,3
Adelaide,"Sloane, Rory",38,18,6,20,0,0,0,9
Adelaide,"Smith, Brodie",23,14,4,9,1,0,0,1
Adelaide,"Atkins, Rory",16,11,5,5,0,1,0,2
Adelaide,"Betts, Eddie",13,8,1,5,3,2,0,6
Adelaide,"Brown, Luke",20,12,0,8,0,0,0,3
Adelaide,"Cameron, Charlie",15,10,2,5,0,1,0,4
Adelaide,"Crouch, Brad",27,16,4,11,1,1,0,8
Adelaide,"Crouch, Matt",31,15,3,16,0,0,0,7
Adelaide,"Douglas, Richard",20,15,2,5,2,0,0,5
Adelaide,"Greenwood, Hugh",19,13,3,6,0,0,0,7
Adelaide,"Hartigan, Kyle",10,8,4,2,0,0,0,3
Adelaide,"Jacobs, Sam",9,8,2,1,0,1,30,4
Adelaide,"Jenkins, Josh",7,6,1,1,1,1,8,2
Adelaide,"Kelly, Jake",16,11,10,5,0,0,0,3
Adelaide,"Knight, Riley",17,10,4,7,0,0,0,10
Adelaide,"Laird, Rory",15,11,2,4,0,0,0,4
Adelaide,"Lever, Jake",15,9,4,6,0,0,0,1
Adelaide,"Lynch, Tom",25,15,10,10,1,0,0,4
Adelaide,"Mackay, David",19,13,5,6,0,0,0,4
Adelaide,"McGovern, Mitch",11,6,2,5,1,0,0,3
Adelaide,"Seedsman, Paul",12,5,2,7,1,1,0,4
Adelaide,"Smith, Brodie",2,1,0,1,1,0,0,0
Adelaide,"Talia, Daniel",11,7,4,4,0,0,0,2
Adelaide,"Walker, Taylor",10,7,7,3,1,3,0,2
Adelaide,"Atkins, Rory",22,18,9,4,0,0,0,1
Adelaide,"Betts, Eddie",13,6,4,7,2,0,0,1
Adelaide,"Brown, Luke",10,8,5,2,0,0,0,1
Adelaide,"Cameron, Charlie",19,14,6,5,5,1,0,3
Adelaide,"Crouch, Brad",29,17,5,12,0,2,0,10
Adelaide,"Crouch, Matt",31,15,7,16,1,0,0,5
Adelaide,"Douglas, Richard",19,14,5,5,0,1,0,4
Adelaide,"Greenwood, Hugh",6,1,2,5,0,0,0,2
Adelaide,"Hartigan, Kyle",13,11,6,2,0,0,0,5
Adelaide,"Jacobs, Sam",16,13,5,3,1,0,35,1
Adelaide,"Jenkins, Josh",17,15,7,2,4,0,4,0
Adelaide,"Kelly, Jake",11,10,6,1,0,0,0,4
Adelaide,"Knight, Riley",14,7,6,7,1,0,0,4
Adelaide,"Laird, Rory",32,20,15,12,0,0,0,0
Adelaide,"Lever, Jake",15,12,6,3,0,0,0,1
Adelaide,"Lynch, Tom",20,14,7,6,2,0,0,2
Adelaide,"Mackay, David",18,10,6,8,0,0,0,5
Adelaide,"Otten, Andy",13,7,4,6,1,0,0,4
Adelaide,"Seedsman, Paul",19,13,7,6,2,1,0,3
Adelaide,"Sloane, Rory",20,13,5,7,0,1,0,4
Adelaide,"Talia, Daniel",9,5,5,4,0,0,0,3
Adelaide,"Walker, Taylor",16,11,7,5,2,0,0,1
Adelaide,"Atkins, Rory",17,8,4,9,0,0,0,3
Adelaide,"Betts, Eddie",7,4,2,3,1,2,0,2
Adelaide,"Brown, Luke",13,9,4,4,0,0,0,1
Adelaide,"Cameron, Charlie",16,10,2,6,1,0,0,5
Adelaide,"Crouch, Brad",29,9,4,20,1,0,0,6
Adelaide,"Crouch, Matt",37,20,3,17,0,0,0,5
Adelaide,"Douglas, Richard",20,14,2,6,0,0,0,8
Adelaide,"Greenwood, Hugh",13,9,1,4,1,0,0,4
Adelaide,"Hartigan, Kyle",15,11,6,4,0,0,0,2
Adelaide,"Jacobs, Sam",15,8,3,7,0,1,49,0
Adelaide,"Jenkins, Josh",7,3,5,4,0,1,6,1
Adelaide,"Kelly, Jake",20,9,6,11,0,0,0,2
Adelaide,"Knight, Riley",9,5,5,4,0,1,0,3
Adelaide,"Laird, Rory",27,11,9,16,0,0,0,1
Adelaide,"Lever, Jake",15,12,8,3,0,0,0,2
Adelaide,"Lynch, Tom",18,12,5,6,0,1,0,4
Adelaide,"Mackay, David",15,8,2,7,0,1,0,5
Adelaide,"Otten, Andy",5,4,4,1,0,0,0,2
Adelaide,"Seedsman, Paul",15,8,5,7,0,0,0,4
Adelaide,"Sloane, Rory",21,11,4,10,2,0,0,6
Adelaide,"Talia, Daniel",3,3,2,0,0,0,0,3
Adelaide,"Walker, Taylor",10,9,6,1,2,0,0,1
Brisbane Lions,"Andrews, Harris",7,3,4,4,0,0,0,2
Brisbane Lions,"Barrett, Jake",11,7,3,4,0,1,0,5
Brisbane Lions,"Bastinac, Ryan",14,8,4,6,3,0,0,5
Brisbane Lions,"Beams, Dayne",28,14,2,14,0,1,0,6
Brisbane Lions,"Bell, Tom",10,5,1,5,1,0,0,1
Brisbane Lions,"Bewick, Rohan",20,9,4,11,1,1,0,2
Brisbane Lions,"Close, Michael",6,4,0,2,1,0,2,5
Brisbane Lions,"Cutler, Tom",24,19,2,5,0,0,0,0
Brisbane Lions,"Gardiner, Darcy",12,6,3,6,0,0,0,4
Brisbane Lions,"Harwood, Ryan",8,2,1,6,0,0,0,1
Brisbane Lions,"Hipwood, Eric",12,8,5,4,2,0,0,1
Brisbane Lions,"Keays, Ben",14,7,5,7,0,1,0,3
Brisbane Lions,"Lester, Ryan",11,9,3,2,1,0,0,4
Brisbane Lions,"Martin, Stefan",23,10,4,13,0,0,33,1
Brisbane Lions,"Mayes, Sam",21,13,2,8,0,0,0,2
Brisbane Lions,"McStay, Daniel",10,4,3,6,0,0,0,3
Brisbane Lions,"Rich, Daniel",12,8,2,4,1,1,0,3
Brisbane Lions,"Robertson, Nick",11,8,2,3,0,0,0,3
Brisbane Lions,"Robinson, Mitch",14,6,1,8,2,0,0,3
Brisbane Lions,"Rockliff, Tom",37,22,5,15,0,0,0,4
Brisbane Lions,"Taylor, Lewis",14,7,3,7,1,1,0,6
Brisbane Lions,"Zorko, Dayne",23,13,2,10,2,0,0,10
Brisbane Lions,"Andrews, Harris",15,9,7,6,1,0,1,2
Brisbane Lions,"Barrett, Jake",11,5,3,6,0,0,0,7
Brisbane Lions,"Bastinac, Ryan",16,6,2,10,0,0,0,0
Brisbane Lions,"Beams, Dayne",33,19,2,14,2,1,0,2
Brisbane Lions,"Bell, Tom",15,12,6,3,0,1,0,1
Brisbane Lions,"Bewick, Rohan",15,5,3,10,0,0,0,0
Brisbane Lions,"Close, Michael",8,5,1,3,2,0,0,3
Brisbane Lions,"Cutler, Tom",20,13,3,7,0,0,0,4
Brisbane Lions,"Frost, Jack",6,2,1,4,0,0,0,1
Brisbane Lions,"Gardiner, Darcy",14,5,4,9,0,0,0,0
Brisbane Lions,"Harwood, Ryan",7,2,2,5,0,0,0,2
Brisbane Lions,"Hipwood, Eric",8,7,5,1,2,2,0,1
Brisbane Lions,"Lester, Ryan",20,14,3,6,1,0,0,3
Brisbane Lions,"Martin, Stefan",23,12,5,11,0,0,42,2
Brisbane Lions,"Mayes, Sam",21,10,4,11,0,0,0,1
Brisbane Lions,"McStay, Daniel",7,4,2,3,0,0,0,1
Brisbane Lions,"Rich, Daniel",14,6,1,8,1,0,0,1
Brisbane Lions,"Robertson, Nick",15,6,3,9,0,0,0,3
Brisbane Lions,"Robinson, Mitch",26,16,5,10,1,1,0,2
Brisbane Lions,"Rockliff, Tom",28,13,5,15,0,0,1,11
Brisbane Lions,"Taylor, Lewis",20,15,6,5,1,3,0,2
Brisbane Lions,"Zorko, Dayne",29,20,3,9,1,2,0,4
Brisbane Lions,"Andrews, Harris",12,8,4,4,0,0,0,0
Brisbane Lions,"Barrett, Jake",16,5,5,11,0,1,0,10
Brisbane Lions,"Beams, Dayne",30,17,5,13,1,1,0,8
Brisbane Lions,"Bell, Tom",15,8,3,7,1,1,0,4
Brisbane Lions,"Berry, Jarrod",8,3,2,5,1,0,0,2
Brisbane Lions,"Bewick, Rohan",14,9,5,5,1,0,0,5
Brisbane Lions,"Cutler, Tom",25,16,4,9,0,0,0,0
Brisbane Lions,"Frost, Jack",4,0,0,4,0,0,0,1
Brisbane Lions,"Gardiner, Darcy",5,2,2,3,0,0,0,1
Brisbane Lions,"Hipwood, Eric",2,1,0,1,0,0,1,1
Brisbane Lions,"Lester, Ryan",12,6,6,6,0,0,0,4
Brisbane Lions,"Martin, Stefan",21,11,7,10,0,0,44,1
Brisbane Lions,"Mayes, Sam",23,11,7,12,0,0,0,1
Brisbane Lions,"McCluggage, Hugh",13,9,4,4,0,1,0,2
Brisbane Lions,"McStay, Daniel",10,2,5,8,0,0,0,4
Brisbane Lions,"Rich, Daniel",32,21,4,11,1,2,0,1
Brisbane Lions,"Robertson, Nick",18,8,8,10,0,0,0,1
Brisbane Lions,"Robinson, Mitch",15,7,3,8,2,0,0,5
Brisbane Lions,"Rockliff, Tom",28,16,5,12,0,0,1,6
Brisbane Lions,"Schache, Josh",9,3,2,6,2,0,1,2
Brisbane Lions,"Taylor, Lewis",19,8,4,11,1,0,0,4
Brisbane Lions,"Zorko, Dayne",26,15,2,11,1,2,0,9
Brisbane Lions,"Andrews, Harris",14,11,8,3,0,0,0,2
Brisbane Lions,"Beams, Claye",17,13,8,4,0,0,0,2
Brisbane Lions,"Beams, Dayne",25,13,4,12,2,1,0,1
Brisbane Lions,"Bell, Tom",12,5,3,7,1,0,0,5
Brisbane Lions,"Berry, Jarrod",10,7,2,3,0,0,0,3
Brisbane Lions,"Bewick, Rohan",18,11,7,7,0,0,0,4
Brisbane Lions,"Cox, Cedric",10,6,4,4,0,0,0,2
Brisbane Lions,"Cutler, Tom",1,1,0,0,0,0,0,0
Brisbane Lions,"Gardiner, Darcy",13,9,5,4,0,0,0,2
Brisbane Lions,"Hipwood, Eric",4,4,2,0,2,0,0,0
Brisbane Lions,"Lester, Ryan",16,9,7,7,0,1,0,2
Brisbane Lions,"Martin, Stefan",18,9,3,9,0,0,52,2
Brisbane Lions,"Mayes, Sam",24,19,7,5,0,0,0,1
Brisbane Lions,"McCluggage, Hugh",16,8,7,8,0,0,0,3
Brisbane Lions,"McStay, Daniel",11,8,4,3,0,0,0,1
Brisbane Lions,"Rich, Daniel",21,15,7,6,0,0,0,3
Brisbane Lions,"Robertson, Nick",11,5,4,6,0,0,0,5
Brisbane Lions,"Robinson, Mitch",29,14,11,15,1,1,0,4
Brisbane Lions,"Rockliff, Tom",33,19,8,14,0,0,0,11
Brisbane Lions,"Schache, Josh",13,5,6,8,1,2,1,0
Brisbane Lions,"Taylor, Lewis",18,14,4,4,1,0,0,1
Brisbane Lions,"Zorko, Dayne",26,23,6,3,2,2,0,8
Brisbane Lions,"Andrews, Harris",15,10,6,5,0,0,0,0
Brisbane Lions,"Bastinac, Ryan",16,7,3,9,0,0,0,7
Brisbane Lions,"Beams, Claye",15,11,6,4,1,0,0,3
Brisbane Lions,"Beams, Dayne",36,21,5,15,0,0,0,5
Brisbane Lions,"Berry, Jarrod",6,2,2,4,0,0,0,2
Brisbane Lions,"Cox, Cedric",9,4,2,5,0,0,0,2
Brisbane Lions,"Dawson, Liam",8,7,2,1,0,0,0,1
Brisbane Lions,"Harwood, Ryan",13,6,3,7,0,0,0,7
Brisbane Lions,"Hipwood, Eric",12,8,5,4,3,2,0,4
Brisbane Lions,"Keays, Ben",12,6,1,6,2,0,0,5
Brisbane Lions,"Lester, Ryan",12,9,5,3,2,0,0,2
Brisbane Lions,"Martin, Stefan",18,5,6,13,0,0,49,4
Brisbane Lions,"Mayes, Sam",23,13,7,10,0,0,0,6
Brisbane Lions,"McCluggage, Hugh",15,7,2,8,1,1,0,2
Brisbane Lions,"McStay, Daniel",12,5,5,7,0,0,0,4
Brisbane Lions,"Rich, Daniel",20,19,4,1,0,0,0,0
Brisbane Lions,"Robertson, Nick",7,6,1,1,0,0,0,4
Brisbane Lions,"Robinson, Mitch",21,7,3,14,1,0,0,8
Brisbane Lions,"Rockliff, Tom",30,15,10,15,1,0,0,4
Brisbane Lions,"Schache, Josh",6,5,4,1,0,0,1,0
Brisbane Lions,"Taylor, Lewis",22,11,6,11,1,0,0,3
Brisbane Lions,"Zorko, Dayne",32,26,6,6,2,2,0,8
Brisbane Lions,"Andrews, Harris",17,10,6,7,0,0,0,0
Brisbane Lions,"Beams, Claye",22,10,6,12,1,0,0,1
Brisbane Lions,"Beams, Dayne",21,13,3,8,0,0,0,1
Brisbane Lions,"Berry, Jarrod",16,5,1,11,0,0,0,7
Brisbane Lions,"Close, Michael",9,8,4,1,1,1,4,2
Brisbane Lions,"Cutler, Tom",28,14,7,14,1,0,0,1
Brisbane Lions,"Gardiner, Darcy",18,10,8,8,0,1,0,0
Brisbane Lions,"Harwood, Ryan",20,6,6,14,0,0,0,0
Brisbane Lions,"Hipwood, Eric",4,3,2,1,2,0,0,1
Brisbane Lions,"Keays, Ben",25,11,3,14,0,0,0,3
Brisbane Lions,"Lester, Ryan",16,7,5,9,0,1,0,3
Brisbane Lions,"Martin, Stefan",21,9,3,12,0,0,25,1
Brisbane Lions,"Mayes, Sam",19,12,5,7,0,0,1,2
Brisbane Lions,"McCluggage, Hugh",7,4,3,3,0,1,0,0
Brisbane Lions,"McStay, Daniel",11,9,5,2,0,0,0,0
Brisbane Lions,"Rich, Daniel",25,11,1,14,0,0,0,1
Brisbane Lions,"Robertson, Nick",24,9,7,15,0,0,0,2
Brisbane Lions,"Robinson, Mitch",25,13,2,12,2,0,0,6
Brisbane Lions,"Rockliff, Tom",23,14,6,9,0,0,0,6
Brisbane Lions,"Schache, Josh",4,1,0,3,1,0,1,0
Brisbane Lions,"Taylor, Lewis",26,14,9,12,1,1,0,2
Brisbane Lions,"Zorko, Dayne",19,13,3,6,1,1,0,3
Brisbane Lions,"Andrews, Harris",15,7,7,8,0,0,0,1
Brisbane Lions,"Barrett, Jake",13,7,2,6,1,0,0,6
Brisbane Lions,"Beams, Claye",13,5,4,8,0,0,0,0
Brisbane Lions,"Berry, Jarrod",11,5,2,6,1,0,0,4
Brisbane Lions,"Close, Michael",13,7,6,6,1,0,3,3
Brisbane Lions,"Gardiner, Darcy",12,10,4,2,0,0,0,1
Brisbane Lions,"Harwood, Ryan",17,9,8,8,0,0,0,2
Brisbane Lions,"Hipwood, Eric",7,4,0,3,0,0,0,0
Brisbane Lions,"Keays, Ben",18,9,4,9,1,0,0,2
Brisbane Lions,"Lester, Ryan",18,12,7,6,2,1,0,3
Brisbane Lions,"Martin, Stefan",21,10,4,11,0,0,40,2
Brisbane Lions,"Mayes, Sam",15,10,6,5,0,1,0,2
Brisbane Lions,"McCluggage, Hugh",15,11,5,4,0,0,0,2
Brisbane Lions,"McStay, Daniel",10,5,3,5,0,0,0,1
Brisbane Lions,"Paparone, Marco",28,19,9,9,0,0,0,1
Brisbane Lions,"Rich, Daniel",15,10,4,5,0,0,0,2
Brisbane Lions,"Robertson, Nick",12,7,3,5,1,0,0,2
Brisbane Lions,"Robinson, Mitch",7,5,2,2,0,0,0,1
Brisbane Lions,"Rockliff, Tom",32,21,7,11,2,1,0,11
Brisbane Lions,"Schache, Josh",11,8,4,3,2,2,0,0
Brisbane Lions,"Taylor, Lewis",17,10,1,7,0,1,0,3
Brisbane Lions,"Zorko, Dayne",21,11,5,10,1,1,0,6
Brisbane Lions,"Andrews, Harris",11,8,5,3,0,0,0,1
Brisbane Lions,"Barrett, Jake",13,5,1,8,2,0,0,2
Brisbane Lions,"Beams, Claye",9,5,1,4,0,0,0,2
Brisbane Lions,"Bell, Tom",19,8,3,11,1,0,0,3
Brisbane Lions,"Berry, Jarrod",13,7,5,6,1,0,0,4
Brisbane Lions,"Bewick, Rohan",13,8,4,5,1,0,0,3
Brisbane Lions,"Close, Michael",6,3,1,3,0,0,0,4
Brisbane Lions,"Gardiner, Darcy",11,5,3,6,0,0,0,0
Brisbane Lions,"Harwood, Ryan",16,8,5,8,0,0,0,5
Brisbane Lions,"Hipwood, Eric",10,9,4,1,2,2,0,1
Brisbane Lions,"Keays, Ben",13,6,2,7,0,0,0,12
Brisbane Lions,"Lester, Ryan",20,10,6,10,1,1,0,8
Brisbane Lions,"Martin, Stefan",13,6,1,7,0,0,63,10
Brisbane Lions,"Mayes, Sam",12,6,2,6,0,0,0,0
Brisbane Lions,"Paparone, Marco",9,8,1,1,0,1,0,2
Brisbane Lions,"Rich, Daniel",22,17,3,5,0,0,0,3
Brisbane Lions,"Robertson, Nick",8,3,0,5,0,0,0,2
Brisbane Lions,"Rockliff, Tom",30,14,1,16,1,0,0,13
Brisbane Lions,"Schache, Josh",8,6,3,2,0,0,0,1
Brisbane Lions,"Taylor, Lewis",9,3,3,6,0,1,0,2
Brisbane Lions,"Walker, Josh",10,5,6,5,2,0,0,4
Brisbane Lions,"Zorko, Dayne",31,22,1,9,0,1,0,11
Brisbane Lions,"Andrews, Harris",14,11,6,3,0,0,0,1
Brisbane Lions,"Barrett, Jake",13,7,2,6,2,2,0,8
Brisbane Lions,"Beams, Claye",4,2,1,2,0,0,0,1
Brisbane Lions,"Beams, Dayne",40,17,7,23,0,1,0,6
Brisbane Lions,"Bell, Tom",16,7,0,9,0,1,0,5
Brisbane Lions,"Berry, Jarrod",16,6,3,10,0,1,0,2
Brisbane Lions,"Close, Michael",10,8,5,2,0,1,3,3
Brisbane Lions,"Gardiner, Darcy",12,7,3,5,0,0,0,2
Brisbane Lions,"Hammelmann, Matthew",8,6,2,2,1,1,0,1
Brisbane Lions,"Harwood, Ryan",13,9,5,4,0,0,0,2
Brisbane Lions,"Hipwood, Eric",9,5,1,4,0,0,0,6
Brisbane Lions,"Keays, Ben",16,7,4,9,0,1,0,4
Brisbane Lions,"Lester, Ryan",23,13,4,10,0,0,0,4
Brisbane Lions,"Martin, Stefan",16,9,7,7,0,0,33,3
Brisbane Lions,"Mayes, Sam",20,13,4,7,0,0,0,0
Brisbane Lions,"McCluggage, Hugh",15,6,0,9,1,1,0,0
Brisbane Lions,"Paparone, Marco",13,8,1,5,0,0,0,2
Brisbane Lions,"Rich, Daniel",29,21,2,8,0,0,0,1
Brisbane Lions,"Robertson, Nick",11,8,3,3,0,1,0,6
Brisbane Lions,"Taylor, Lewis",24,13,3,11,0,3,0,3
Brisbane Lions,"Walker, Josh",11,7,3,4,1,1,0,2
Brisbane Lions,"Zorko, Dayne",26,21,6,5,2,3,0,4
Brisbane Lions,"Andrews, Harris",9,4,6,5,0,0,0,0
Brisbane Lions,"Barrett, Jake",18,6,3,12,1,1,0,7
Brisbane Lions,"Bastinac, Ryan",12,4,1,8,0,0,0,7
Brisbane Lions,"Beams, Dayne",28,15,3,13,3,1,0,5
Brisbane Lions,"Berry, Jarrod",6,3,1,3,1,0,0,5
Brisbane Lions,"Cutler, Tom",20,14,6,6,1,0,0,1
Brisbane Lions,"Gardiner, Darcy",9,6,5,3,0,0,0,6
Brisbane Lions,"Hammelmann, Matthew",8,3,1,5,1,0,0,1
Brisbane Lions,"Hipwood, Eric",6,4,2,2,1,0,0,0
Brisbane Lions,"Keays, Ben",11,4,1,7,0,0,0,2
Brisbane Lions,"Lester, Ryan",8,4,3,4,0,0,0,3
Brisbane Lions,"Martin, Stefan",17,11,0,6,0,0,20,1
Brisbane Lions,"Mathieson, Rhys",14,10,2,4,1,0,0,4
Brisbane Lions,"Mayes, Sam",20,16,4,4,0,0,0,2
Brisbane Lions,"McCluggage, Hugh",19,12,5,7,0,1,0,0
Brisbane Lions,"McStay, Daniel",10,7,5,3,0,0,0,2
Brisbane Lions,"Paparone, Marco",14,9,5,5,0,0,0,1
Brisbane Lions,"Rich, Daniel",14,9,2,5,1,0,0,1
Brisbane Lions,"Robertson, Nick",17,10,4,7,0,0,0,3
Brisbane Lions,"Smith, Archie",9,3,3,6,1,0,7,2
Brisbane Lions,"Taylor, Lewis",13,7,2,6,0,0,0,3
Brisbane Lions,"Zorko, Dayne",28,15,5,13,2,1,0,7
Brisbane Lions,"Andrews, Harris",19,10,11,9,0,0,0,1
Brisbane Lions,"Barrett, Jake",24,12,5,12,2,2,0,3
Brisbane Lions,"Bastinac, Ryan",16,6,5,10,1,0,0,1
Brisbane Lions,"Beams, Dayne",36,21,5,15,1,1,0,8
Brisbane Lions,"Berry, Jarrod",15,8,4,7,1,0,0,5
Brisbane Lions,"Cutler, Tom",19,14,10,5,3,0,0,3
Brisbane Lions,"Gardiner, Darcy",17,11,9,6,0,0,0,5
Brisbane Lions,"Harwood, Ryan",11,5,3,6,0,0,0,4
Brisbane Lions,"Hipwood, Eric",8,5,2,3,1,2,0,3
Brisbane Lions,"Lester, Ryan",21,11,9,10,0,1,0,3
Brisbane Lions,"Martin, Stefan",22,11,7,11,0,0,26,4
Brisbane Lions,"Mathieson, Rhys",20,9,3,11,1,1,0,2
Brisbane Lions,"Mayes, Sam",29,19,9,10,0,0,0,2
Brisbane Lions,"McCluggage, Hugh",16,9,1,7,1,0,0,2
Brisbane Lions,"McStay, Daniel",14,8,3,6,0,0,0,2
Brisbane Lions,"Paparone, Marco",19,16,10,3,0,0,0,0
Brisbane Lions,"Rich, Daniel",25,17,4,8,0,0,0,2
Brisbane Lions,"Robertson, Nick",22,16,6,6,0,1,0,4
Brisbane Lions,"Rockliff, Tom",27,14,6,13,1,0,0,3
Brisbane Lions,"Smith, Archie",13,4,0,9,0,0,12,2
Brisbane Lions,"Taylor, Lewis",20,12,5,8,4,1,0,1
Brisbane Lions,"Zorko, Dayne",30,20,6,10,2,1,0,5
Brisbane Lions,"Andrews, Harris",11,8,4,3,1,0,0,1
Brisbane Lions,"Barrett, Jake",17,9,1,8,1,1,0,6
Brisbane Lions,"Bastinac, Ryan",21,11,4,10,3,0,0,6
Brisbane Lions,"Beams, Dayne",20,8,3,12,0,0,0,2
Brisbane Lions,"Berry, Jarrod",16,6,2,10,0,0,0,0
Brisbane Lions,"Cutler, Tom",14,10,6,4,0,0,0,1
Brisbane Lions,"Gardiner, Darcy",19,12,6,7,0,0,0,2
Brisbane Lions,"Harwood, Ryan",7,1,1,6,0,0,0,2
Brisbane Lions,"Hipwood, Eric",10,10,4,0,2,2,0,1
Brisbane Lions,"Lester, Ryan",22,11,6,11,1,1,0,6
Brisbane Lions,"Martin, Stefan",16,8,4,8,0,0,15,1
Brisbane Lions,"Mathieson, Rhys",19,11,6,8,0,0,0,2
Brisbane Lions,"Mayes, Sam",25,15,10,10,0,0,0,3
Brisbane Lions,"McCluggage, Hugh",13,7,1,6,0,0,0,3
Brisbane Lions,"McStay, Daniel",12,7,4,5,0,0,0,3
Brisbane Lions,"Paparone, Marco",18,14,7,4,0,0,0,2
Brisbane Lions,"Rich, Daniel",23,13,5,10,0,0,0,1
Brisbane Lions,"Robertson, Nick",18,9,6,9,0,0,0,4
Brisbane Lions,"Rockliff, Tom",15,9,8,6,1,0,0,2
Brisbane Lions,"Smith, Archie",13,1,1,12,0,0,11,3
Brisbane Lions,"Taylor, Lewis",19,7,3,12,1,0,0,3
Brisbane Lions,"Zorko, Dayne",32,24,4,8,2,2,0,12
Brisbane Lions,"Andrews, Harris",9,5,4,4,0,0,0,3
Brisbane Lions,"Barrett, Jake",13,3,4,10,0,0,0,1
Brisbane Lions,"Bastinac, Ryan",21,12,6,9,2,2,0,2
Brisbane Lions,"Beams, Dayne",2,1,0,1,0,0,0,0
Brisbane Lions,"Berry, Jarrod",18,4,3,14,1,1,0,2
Brisbane Lions,"Bewick, Rohan",13,8,3,5,0,1,0,1
Brisbane Lions,"Cutler, Tom",20,14,7,6,1,1,0,2
Brisbane Lions,"Gardiner, Darcy",13,7,6,6,0,0,0,2
Brisbane Lions,"Hipwood, Eric",9,8,3,1,1,2,0,0
Brisbane Lions,"Lester, Ryan",14,9,3,5,2,1,0,1
Brisbane Lions,"Martin, Stefan",17,10,4,7,1,0,27,4
Brisbane Lions,"Mathieson, Rhys",32,13,4,19,0,0,0,6
Brisbane Lions,"Mayes, Sam",21,10,4,11,0,0,0,1
Brisbane Lions,"McCluggage, Hugh",19,13,8,6,0,2,0,2
Brisbane Lions,"McStay, Daniel",10,6,3,4,1,0,0,1
Brisbane Lions,"Rich, Daniel",10,6,0,4,0,0,0,0
Brisbane Lions,"Robertson, Nick",23,11,7,12,0,0,0,5
Brisbane Lions,"Rockliff, Tom",27,15,5,12,0,1,0,4
Brisbane Lions,"Smith, Archie",9,5,2,4,2,0,7,0
Brisbane Lions,"Taylor, Lewis",20,9,1,11,1,1,0,3
Brisbane Lions,"Witherden, Alex",20,12,7,8,0,0,0,1
Brisbane Lions,"Zorko, Dayne",5,2,1,3,0,0,0,9
Brisbane Lions,"Andrews, Harris",20,9,9,11,0,0,0,1
Brisbane Lions,"Barrett, Jake",6,2,1,4,0,1,0,3
Brisbane Lions,"Bastinac, Ryan",20,11,3,9,1,1,0,9
Brisbane Lions,"Berry, Jarrod",15,7,3,8,0,0,0,3
Brisbane Lions,"Bewick, Rohan",15,11,6,4,3,1,0,1
Brisbane Lions,"Cutler, Tom",28,15,9,13,1,1,0,1
Brisbane Lions,"Gardiner, Darcy",3,1,0,2,0,0,0,0
Brisbane Lions,"Hipwood, Eric",12,9,3,3,4,0,0,2
Brisbane Lions,"Lester, Ryan",17,9,5,8,1,1,0,1
Brisbane Lions,"Martin, Stefan",11,5,3,6,0,1,28,2
Brisbane Lions,"Mathieson, Rhys",18,6,2,12,0,0,0,7
Brisbane Lions,"Mayes, Sam",27,16,10,11,0,0,0,2
Brisbane Lions,"McCluggage, Hugh",20,9,5,11,0,2,0,2
Brisbane Lions,"McStay, Daniel",19,8,11,11,0,0,0,0
Brisbane Lions,"Rich, Daniel",23,17,4,6,0,1,0,3
Brisbane Lions,"Robertson, Nick",24,15,5,9,0,0,0,1
Brisbane Lions,"Rockliff, Tom",27,11,3,16,0,0,0,6
Brisbane Lions,"Smith, Archie",10,3,1,7,0,0,12,1
Brisbane Lions,"Taylor, Lewis",24,13,5,11,0,1,0,3
Brisbane Lions,"Walker, Josh",16,7,5,9,1,0,0,1
Brisbane Lions,"Witherden, Alex",29,16,8,13,0,0,0,1
Brisbane Lions,"Zorko, Dayne",30,15,3,15,2,1,0,8
Brisbane Lions,"Andrews, Harris",5,3,2,2,0,0,0,0
Brisbane Lions,"Bastinac, Ryan",16,7,3,9,3,0,0,1
Brisbane Lions,"Beams, Dayne",18,7,2,11,0,0,0,6
Brisbane Lions,"Berry, Jarrod",18,7,6,11,0,0,0,6
Brisbane Lions,"Bewick, Rohan",9,3,3,6,0,2,0,2
Brisbane Lions,"Cutler, Tom",18,10,6,8,0,3,0,1
Brisbane Lions,"Hammelmann, Matthew",7,3,1,4,0,0,0,1
Brisbane Lions,"Hipwood, Eric",8,5,4,3,2,0,0,0
Brisbane Lions,"Lester, Ryan",9,5,4,4,0,0,0,1
Brisbane Lions,"Martin, Stefan",16,12,2,4,0,1,31,2
Brisbane Lions,"Mathieson, Rhys",15,7,2,8,1,0,0,7
Brisbane Lions,"Mayes, Sam",22,17,8,5,0,0,0,2
Brisbane Lions,"McCluggage, Hugh",12,6,3,6,1,2,0,5
Brisbane Lions,"McStay, Daniel",9,5,3,4,0,0,0,1
Brisbane Lions,"Rich, Daniel",21,19,5,2,0,1,0,1
Brisbane Lions,"Robertson, Nick",16,5,3,11,0,0,0,6
Brisbane Lions,"Rockliff, Tom",22,15,6,7,0,0,0,4
Brisbane Lions,"Smith, Archie",8,2,2,6,0,1,11,1
Brisbane Lions,"Taylor, Lewis",13,6,5,7,0,0,0,2
Brisbane Lions,"Walker, Josh",0,0,0,0,0,0,0,0
Brisbane Lions,"Witherden, Alex",21,13,6,8,0,0,0,3
Brisbane Lions,"Zorko, Dayne",36,22,4,14,4,0,0,12
Brisbane Lions,"Andrews, Harris",16,8,8,8,0,0,0,0
Brisbane Lions,"Bastinac, Ryan",17,9,5,8,1,0,0,4
Brisbane Lions,"Beams, Dayne",21,11,7,10,0,0,0,5
Brisbane Lions,"Berry, Jarrod",12,8,7,4,0,0,0,7
Brisbane Lions,"Cox, Cedric",12,7,3,5,0,0,0,1
Brisbane Lions,"Cutler, Tom",14,8,6,6,1,1,0,2
Brisbane Lions,"Hipwood, Eric",8,7,2,1,2,2,0,0
Brisbane Lions,"Keays, Ben",12,8,4,4,2,0,0,4
Brisbane Lions,"Lester, Ryan",8,4,2,4,0,0,0,3
Brisbane Lions,"Martin, Stefan",12,5,2,7,0,0,28,4
Brisbane Lions,"Mathieson, Rhys",16,6,2,10,1,0,0,4
Brisbane Lions,"Mayes, Sam",19,11,6,8,0,0,0,0
Brisbane Lions,"McCluggage, Hugh",14,8,4,6,1,1,0,2
Brisbane Lions,"McStay, Daniel",14,10,10,4,0,0,0,1
Brisbane Lions,"Rich, Daniel",19,12,5,7,0,0,0,2
Brisbane Lions,"Robertson, Nick",16,11,7,5,0,0,0,4
Brisbane Lions,"Rockliff, Tom",14,11,6,3,0,0,0,4
Brisbane Lions,"Schache, Josh",14,7,5,7,2,0,0,1
Brisbane Lions,"Taylor, Lewis",24,15,4,9,0,0,0,4
Brisbane Lions,"Walker, Josh",11,8,7,3,1,0,5,0
Brisbane Lions,"Witherden, Alex",28,18,1,10,0,0,0,4
Brisbane Lions,"Zorko, Dayne",11,6,0,5,1,1,0,4
Brisbane Lions,"Andrews, Harris",18,11,10,7,0,0,0,1
Brisbane Lions,"Barrett, Jake",16,7,3,9,1,0,0,3
Brisbane Lions,"Bastinac, Ryan",16,10,5,6,0,1,0,0
Brisbane Lions,"Beams, Dayne",30,21,10,9,3,1,0,3
Brisbane Lions,"Berry, Jarrod",21,6,7,15,0,1,0,3
Brisbane Lions,"Cox, Cedric",18,7,4,11,1,0,0,5
Brisbane Lions,"Gardiner, Darcy",13,7,8,6,0,0,0,1
Brisbane Lions,"Hipwood, Eric",7,5,4,2,2,1,0,0
Brisbane Lions,"Keays, Ben",8,4,5,4,0,1,0,2
Brisbane Lions,"Lester, Ryan",26,13,9,13,1,0,0,1
Brisbane Lions,"Martin, Stefan",19,12,6,7,0,1,24,1
Brisbane Lions,"Mathieson, Rhys",13,7,4,6,1,0,0,2
Brisbane Lions,"Mayes, Sam",23,17,12,6,0,0,0,3
Brisbane Lions,"McCluggage, Hugh",17,10,4,7,1,0,0,2
Brisbane Lions,"McStay, Daniel",18,11,10,7,0,0,0,0
Brisbane Lions,"Rich, Daniel",17,14,7,3,1,1,0,3
Brisbane Lions,"Rockliff, Tom",10,3,1,7,0,0,0,5
Brisbane Lions,"Schache, Josh",6,5,4,1,0,0,0,1
Brisbane Lions,"Taylor, Lewis",20,15,7,5,1,1,0,1
Brisbane Lions,"Walker, Josh",17,9,6,8,1,1,9,3
Brisbane Lions,"Witherden, Alex",22,18,7,4,1,0,0,2
Brisbane Lions,"Zorko, Dayne",26,19,4,7,3,1,0,5
Brisbane Lions,"Allison, Jacob",20,6,5,14,0,1,0,1
Brisbane Lions,"Andrews, Harris",12,7,6,5,0,0,0,3
Brisbane Lions,"Barrett, Jake",18,6,3,12,0,1,0,5
Brisbane Lions,"Bastinac, Ryan",28,13,6,15,1,0,0,7
Brisbane Lions,"Beams, Dayne",41,23,5,18,0,0,0,6
Brisbane Lions,"Close, Michael",12,8,3,4,0,0,5,3
Brisbane Lions,"Cox, Cedric",16,10,5,6,0,0,0,6
Brisbane Lions,"Gardiner, Darcy",13,5,2,8,0,0,0,3
Brisbane Lions,"Jansen, Jarrad",11,7,5,4,0,0,0,1
Brisbane Lions,"Keays, Ben",22,8,1,14,1,0,0,4
Brisbane Lions,"Lester, Ryan",23,11,8,12,0,0,0,1
Brisbane Lions,"Martin, Stefan",13,9,3,4,0,0,50,4
Brisbane Lions,"Mathieson, Rhys",17,5,3,12,0,0,0,0
Brisbane Lions,"Mayes, Sam",21,8,3,13,0,0,0,2
Brisbane Lions,"Rich, Daniel",32,20,4,12,0,0,0,2
Brisbane Lions,"Robertson, Nick",22,10,6,12,0,0,0,3
Brisbane Lions,"Rockliff, Tom",18,9,2,9,1,0,0,9
Brisbane Lions,"Schache, Josh",14,10,7,4,1,1,0,2
Brisbane Lions,"Skinner, Sam",9,4,1,5,2,1,0,3
Brisbane Lions,"Taylor, Lewis",26,13,5,13,0,0,0,7
Brisbane Lions,"Walker, Josh",12,6,6,6,0,0,0,3
Brisbane Lions,"Witherden, Alex",28,18,5,10,0,0,0,4
Brisbane Lions,"Allison, Jacob",17,14,7,3,0,0,0,2
Brisbane Lions,"Andrews, Harris",14,8,5,6,0,0,0,0
Brisbane Lions,"Barrett, Jake",11,1,0,10,1,0,0,5
Brisbane Lions,"Bastinac, Ryan",18,12,6,6,2,1,0,1
Brisbane Lions,"Beams, Dayne",22,9,5,13,0,0,0,3
Brisbane Lions,"Berry, Jarrod",18,8,6,10,1,0,0,6
Brisbane Lions,"Cox, Cedric",2,2,2,0,0,0,0,1
Brisbane Lions,"Gardiner, Darcy",11,4,5,7,0,0,0,2
Brisbane Lions,"Hipwood, Eric",17,11,3,6,0,0,0,2
Brisbane Lions,"Lester, Ryan",16,9,9,7,0,0,0,4
Brisbane Lions,"Martin, Stefan",13,5,3,8,0,0,43,2
Brisbane Lions,"Mathieson, Rhys",13,8,4,5,1,0,0,2
Brisbane Lions,"McCluggage, Hugh",13,6,4,7,0,2,0,1
Brisbane Lions,"McStay, Daniel",10,5,6,5,0,1,0,3
Brisbane Lions,"Rich, Daniel",24,19,7,5,2,1,0,0
Brisbane Lions,"Robertson, Nick",12,8,2,4,0,0,0,2
Brisbane Lions,"Rockliff, Tom",22,12,4,10,2,0,0,4
Brisbane Lions,"Schache, Josh",6,5,4,1,0,1,0,3
Brisbane Lions,"Taylor, Lewis",18,12,2,6,2,0,0,0
Brisbane Lions,"Walker, Josh",15,8,6,7,0,1,2,3
Brisbane Lions,"Witherden, Alex",19,15,3,4,0,0,0,2
Brisbane Lions,"Zorko, Dayne",21,13,3,8,2,4,0,4
Brisbane Lions,"Allison, Jacob",19,12,7,7,0,2,0,2
Brisbane Lions,"Andrews, Harris",13,10,8,3,0,0,0,0
Brisbane Lions,"Barrett, Jake",14,8,2,6,3,0,0,6
Brisbane Lions,"Bastinac, Ryan",21,14,6,7,1,0,0,2
Brisbane Lions,"Beams, Claye",15,7,5,8,1,1,0,1
Brisbane Lions,"Beams, Dayne",32,19,7,13,4,1,0,4
Brisbane Lions,"Close, Michael",6,4,4,2,1,0,0,2
Brisbane Lions,"Cox, Cedric",13,7,4,6,0,0,0,0
Brisbane Lions,"Gardiner, Darcy",15,7,2,8,0,0,0,4
Brisbane Lions,"Hipwood, Eric",9,6,3,3,1,1,0,2
Brisbane Lions,"Lester, Ryan",18,8,5,10,2,0,0,2
Brisbane Lions,"Martin, Stefan",23,10,6,13,0,0,34,2
Brisbane Lions,"Mathieson, Rhys",17,7,4,10,1,0,0,6
Brisbane Lions,"Mayes, Sam",21,15,9,6,0,0,0,1
Brisbane Lions,"McCluggage, Hugh",14,8,1,6,0,0,0,2
Brisbane Lions,"McStay, Daniel",10,4,2,6,0,0,0,3
Brisbane Lions,"Rich, Daniel",22,15,3,7,0,0,0,1
Brisbane Lions,"Robertson, Nick",18,10,7,8,0,0,0,0
Brisbane Lions,"Rockliff, Tom",24,18,7,6,3,1,0,4
Brisbane Lions,"Taylor, Lewis",25,13,4,12,2,0,0,1
Brisbane Lions,"Walker, Josh",11,8,5,3,2,0,5,3
Brisbane Lions,"Zorko, Dayne",22,9,4,13,1,1,0,4
Brisbane Lions,"Allison, Jacob",16,7,4,9,1,0,0,3
Brisbane Lions,"Andrews, Harris",11,7,7,4,0,0,0,0
Brisbane Lions,"Barrett, Jake",13,6,3,7,1,0,0,2
Brisbane Lions,"Bastinac, Ryan",22,12,6,10,1,0,0,3
Brisbane Lions,"Beams, Claye",14,6,4,8,0,0,0,4
Brisbane Lions,"Beams, Dayne",33,16,7,17,3,1,0,4
Brisbane Lions,"Close, Michael",8,6,4,2,1,0,0,2
Brisbane Lions,"Gardiner, Darcy",14,10,8,4,1,0,0,4
Brisbane Lions,"Hipwood, Eric",10,5,5,5,1,0,0,0
Brisbane Lions,"Lester, Ryan",18,9,5,9,0,0,0,4
Brisbane Lions,"Martin, Stefan",15,6,5,9,0,0,27,1
Brisbane Lions,"Mathieson, Rhys",19,6,1,13,0,0,1,3
Brisbane Lions,"Mayes, Sam",19,14,6,5,0,0,0,0
Brisbane Lions,"McCluggage, Hugh",17,8,5,9,1,0,0,4
Brisbane Lions,"McStay, Daniel",13,6,5,7,0,0,0,2
Brisbane Lions,"Rich, Daniel",25,16,2,9,0,1,0,0
Brisbane Lions,"Robertson, Nick",16,7,3,9,0,0,0,6
Brisbane Lions,"Rockliff, Tom",16,9,6,7,2,0,0,3
Brisbane Lions,"Taylor, Lewis",22,16,3,6,0,1,0,2
Brisbane Lions,"Walker, Josh",14,9,8,5,1,1,6,1
Brisbane Lions,"Witherden, Alex",18,13,6,5,0,0,0,5
Brisbane Lions,"Zorko, Dayne",26,16,7,10,1,0,0,8
Brisbane Lions,"Allison, Jacob",16,8,4,8,0,0,0,2
Brisbane Lions,"Andrews, Harris",9,3,5,6,0,0,0,3
Brisbane Lions,"Barrett, Jake",15,5,7,10,0,1,0,3
Brisbane Lions,"Bastinac, Ryan",14,9,3,5,0,0,0,0
Brisbane Lions,"Beams, Claye",17,11,7,6,1,1,0,0
Brisbane Lions,"Beams, Dayne",18,11,4,7,1,1,0,4
Brisbane Lions,"Close, Michael",11,11,7,0,1,1,0,0
Brisbane Lions,"Cox, Cedric",11,3,1,8,0,0,0,2
Brisbane Lions,"Gardiner, Darcy",20,10,6,10,0,0,0,5
Brisbane Lions,"Lester, Ryan",9,6,3,3,0,0,0,0
Brisbane Lions,"Martin, Stefan",15,5,3,10,0,0,36,3
Brisbane Lions,"Mathieson, Rhys",23,11,7,12,1,0,0,2
Brisbane Lions,"Mayes, Sam",15,5,2,10,0,0,0,5
Brisbane Lions,"McCluggage, Hugh",17,11,8,6,1,1,0,2
Brisbane Lions,"McStay, Daniel",12,5,6,7,0,0,0,1
Brisbane Lions,"Rich, Daniel",24,17,5,7,1,3,0,4
Brisbane Lions,"Robertson, Nick",16,8,5,8,0,0,0,1
Brisbane Lions,"Rockliff, Tom",17,8,5,9,2,2,0,3
Brisbane Lions,"Taylor, Lewis",15,10,2,5,0,0,0,3
Brisbane Lions,"Walker, Josh",15,5,6,10,0,0,6,2
Brisbane Lions,"Witherden, Alex",27,20,5,7,1,0,0,1
Brisbane Lions,"Zorko, Dayne",26,16,4,10,2,1,0,6
Carlton,"Armfield, Dennis",6,1,2,5,1,0,0,1
Carlton,"Casboult, Levi",10,5,4,5,1,1,11,2
Carlton,"Cripps, Patrick",19,10,3,9,0,0,0,5
Carlton,"Curnow, Charlie",8,7,4,1,0,0,0,5
Carlton,"Curnow, Ed",19,13,5,6,0,0,0,4
Carlton,"Docherty, Sam",24,18,6,6,0,0,0,1
Carlton,"Gibbs, Bryce",26,14,4,12,1,1,0,6
Carlton,"Kreuzer, Matthew",15,11,4,4,2,0,39,4
Carlton,"Macreadie, Harrison",7,3,1,4,0,0,0,4
Carlton,"Marchbank, Caleb",19,15,8,4,0,0,0,2
Carlton,"Murphy, Marc",35,21,6,14,0,0,0,7
Carlton,"Petrevski-Seton, Sam",11,7,2,4,0,0,0,7
Carlton,"Pickett, Jarrod",5,2,2,3,0,0,0,3
Carlton,"Plowman, Lachie",20,12,10,8,0,0,0,1
Carlton,"Rowe, Sam",12,6,1,6,0,0,0,1
Carlton,"Silvagni, Jack",11,8,5,3,2,2,0,1
Carlton,"Simpson, Kade",33,22,7,11,0,0,0,3
Carlton,"Smedts, Billie",17,8,5,9,0,0,0,1
Carlton,"Thomas, Dale",17,12,6,5,1,0,0,1
Carlton,"Weitering, Jacob",10,6,7,4,3,0,0,0
Carlton,"White, Simon",10,7,3,3,0,0,0,3
Carlton,"Wright, Matthew",14,7,4,7,3,0,0,5
Carlton,"Armfield, Dennis",11,11,8,0,1,1,0,2
Carlton,"Casboult, Levi",12,8,8,4,1,0,5,0
Carlton,"Cripps, Patrick",29,16,4,13,0,1,0,4
Carlton,"Curnow, Charlie",7,3,2,4,0,0,0,1
Carlton,"Curnow, Ed",23,11,5,12,1,0,0,3
Carlton,"Docherty, Sam",29,22,10,7,0,0,0,0
Carlton,"Gibbs, Bryce",25,18,9,7,0,0,0,1
Carlton,"Kreuzer, Matthew",11,4,3,7,0,0,21,3
Carlton,"Macreadie, Harrison",10,6,4,4,0,0,0,3
Carlton,"Marchbank, Caleb",16,11,6,5,0,0,0,4
Carlton,"Murphy, Marc",31,18,7,13,1,1,0,4
Carlton,"Petrevski-Seton, Sam",13,11,4,2,1,1,0,2
Carlton,"Pickett, Jarrod",9,6,2,3,1,0,0,4
Carlton,"Plowman, Lachie",18,12,5,6,0,0,0,1
Carlton,"Rowe, Sam",6,1,2,5,0,0,0,0
Carlton,"Silvagni, Jack",13,6,6,7,0,2,0,2
Carlton,"Simpson, Kade",14,8,4,6,0,0,0,2
Carlton,"Smedts, Billie",16,9,1,7,0,1,0,3
Carlton,"Thomas, Dale",19,11,8,8,0,1,0,1
Carlton,"Weitering, Jacob",14,10,6,4,0,1,0,0
Carlton,"White, Simon",11,9,6,2,0,0,0,3
Carlton,"Wright, Matthew",21,12,7,9,3,0,0,2
Carlton,"Casboult, Levi",5,3,2,2,0,0,11,3
Carlton,"Cripps, Patrick",24,14,5,10,1,0,0,4
Carlton,"Curnow, Ed",24,12,2,12,1,2,0,7
Carlton,"Docherty, Sam",20,20,9,0,0,0,0,2
Carlton,"Gibbs, Bryce",35,21,3,14,0,2,0,9
Carlton,"Kerridge, Sam",8,5,1,3,1,0,0,2
Carlton,"Kreuzer, Matthew",14,14,1,0,1,0,30,11
Carlton,"Macreadie, Harrison",5,2,1,3,0,0,0,6
Carlton,"Marchbank, Caleb",10,9,5,1,0,0,0,7
Carlton,"Murphy, Marc",32,23,2,9,2,0,0,10
Carlton,"Palmer, Rhys",12,6,4,6,0,0,0,2
Carlton,"Petrevski-Seton, Sam",17,12,3,5,1,0,0,8
Carlton,"Pickett, Jarrod",11,7,2,4,0,2,0,3
Carlton,"Plowman, Lachie",18,12,6,6,0,0,0,4
Carlton,"Rowe, Sam",15,12,4,3,0,0,0,3
Carlton,"Silvagni, Jack",11,10,4,1,0,2,0,8
Carlton,"Simpson, Kade",21,17,3,4,0,0,0,6
Carlton,"Thomas, Dale",16,13,6,3,0,0,0,3
Carlton,"Weitering, Jacob",10,8,4,2,0,1,0,3
Carlton,"White, Simon",17,15,8,2,0,0,0,1
Carlton,"Williamson, Tom",15,9,2,6,0,1,0,5
Carlton,"Wright, Matthew",11,5,1,6,0,0,0,3
Carlton,"Casboult, Levi",13,9,10,4,3,0,2,2
Carlton,"Cripps, Patrick",17,10,2,7,0,0,0,9
Carlton,"Curnow, Charlie",13,10,6,3,0,2,0,5
Carlton,"Curnow, Ed",17,12,5,5,1,0,0,10
Carlton,"Docherty, Sam",26,24,13,2,0,1,0,4
Carlton,"Fisher, Zac",12,7,3,5,1,0,0,5
Carlton,"Gibbs, Bryce",22,15,3,7,0,0,0,7
Carlton,"Kreuzer, Matthew",10,8,1,2,0,1,23,5
Carlton,"Macreadie, Harrison",9,6,5,3,0,0,0,1
Carlton,"Marchbank, Caleb",20,11,8,9,0,1,0,1
Carlton,"Murphy, Marc",28,19,7,9,0,1,0,7
Carlton,"Petrevski-Seton, Sam",10,9,1,1,0,0,0,3
Carlton,"Pickett, Jarrod",9,7,2,2,1,1,0,0
Carlton,"Plowman, Lachie",9,6,3,3,0,0,0,1
Carlton,"Rowe, Sam",8,6,4,2,1,0,0,2
Carlton,"Silvagni, Jack",14,11,10,3,3,0,0,4
Carlton,"Simpson, Kade",19,13,9,6,1,0,0,3
Carlton,"Thomas, Dale",18,11,6,7,0,0,0,1
Carlton,"Weitering, Jacob",9,5,4,4,1,0,0,3
Carlton,"White, Simon",8,5,3,3,0,0,0,3
Carlton,"Williamson, Tom",13,8,1,5,0,0,0,3
Carlton,"Wright, Matthew",17,11,3,6,0,2,0,3
Carlton,"Casboult, Levi",12,9,5,3,4,1,5,1
Carlton,"Cripps, Patrick",37,14,3,23,0,1,0,5
Carlton,"Curnow, Charlie",19,16,8,3,0,0,0,3
Carlton,"Curnow, Ed",17,8,2,9,0,0,0,5
Carlton,"Docherty, Sam",29,24,7,5,0,0,0,1
Carlton,"Fisher, Zac",17,8,0,9,0,0,0,1
Carlton,"Gibbs, Bryce",24,13,3,11,1,1,0,6
Carlton,"Macreadie, Harrison",8,4,2,4,0,0,0,1
Carlton,"Marchbank, Caleb",13,10,7,3,0,0,0,4
Carlton,"Murphy, Marc",25,16,11,9,0,1,0,0
Carlton,"Petrevski-Seton, Sam",16,11,4,5,0,1,0,5
Carlton,"Phillips, Andrew",5,3,1,2,0,0,29,3
Carlton,"Pickett, Jarrod",7,3,3,4,0,0,0,1
Carlton,"Plowman, Lachie",17,14,7,3,0,1,0,2
Carlton,"Polson, Cameron",11,3,0,8,0,1,0,2
Carlton,"Rowe, Sam",4,1,0,3,0,0,0,2
Carlton,"Silvagni, Jack",18,10,7,8,1,1,0,0
Carlton,"Simpson, Kade",21,13,9,8,0,0,0,5
Carlton,"Weitering, Jacob",9,5,3,4,0,0,0,0
Carlton,"White, Simon",19,10,7,9,0,0,0,1
Carlton,"Williamson, Tom",18,11,5,7,0,1,0,1
Carlton,"Wright, Matthew",18,8,5,10,0,0,0,0
Carlton,"Casboult, Levi",10,8,5,2,2,2,9,1
Carlton,"Cripps, Patrick",27,11,7,16,1,0,0,7
Carlton,"Curnow, Charlie",14,11,6,3,1,0,0,2
Carlton,"Curnow, Ed",22,15,5,7,1,0,0,8
Carlton,"Docherty, Sam",39,28,12,11,0,0,0,4
Carlton,"Fisher, Zac",11,7,1,4,0,0,0,2
Carlton,"Gibbs, Bryce",23,18,6,5,0,0,0,5
Carlton,"Graham, Nick",17,10,7,7,0,0,0,6
Carlton,"Kreuzer, Matthew",12,8,4,4,2,0,32,5
Carlton,"Marchbank, Caleb",21,16,10,5,0,0,0,1
Carlton,"Murphy, Marc",31,16,3,15,0,0,0,4
Carlton,"Petrevski-Seton, Sam",20,9,6,11,1,0,0,1
Carlton,"Plowman, Lachie",10,7,5,3,0,0,0,3
Carlton,"Rowe, Sam",12,5,3,7,0,0,0,3
Carlton,"Silvagni, Alex",8,5,5,3,0,0,0,5
Carlton,"Silvagni, Jack",2,2,1,0,0,1,0,0
Carlton,"Simpson, Kade",31,25,12,6,1,0,0,8
Carlton,"Smedts, Billie",14,7,2,7,1,2,0,3
Carlton,"Weitering, Jacob",17,12,8,5,1,0,0,1
Carlton,"White, Simon",16,11,8,5,0,0,0,2
Carlton,"Williamson, Tom",18,11,4,7,0,0,0,3
Carlton,"Wright, Matthew",15,9,2,6,4,0,0,5
Carlton,"Casboult, Levi",8,5,4,3,2,0,11,1
Carlton,"Cripps, Patrick",25,12,5,13,0,0,0,8
Carlton,"Curnow, Charlie",14,10,5,4,1,0,0,0
Carlton,"Curnow, Ed",25,15,4,10,0,0,0,9
Carlton,"Docherty, Sam",22,16,9,6,0,0,0,4
Carlton,"Gibbs, Bryce",17,14,7,3,1,1,0,6
Carlton,"Graham, Nick",19,11,10,8,1,1,0,5
Carlton,"Kerridge, Sam",9,5,3,4,0,0,0,9
Carlton,"Kreuzer, Matthew",15,9,1,6,0,1,29,7
Carlton,"Marchbank, Caleb",21,15,9,6,0,0,0,0
Carlton,"Murphy, Marc",30,13,4,17,0,0,0,5
Carlton,"Petrevski-Seton, Sam",21,16,4,5,2,1,0,3
Carlton,"Plowman, Lachie",10,6,4,4,0,0,0,5
Carlton,"Rowe, Sam",7,4,2,3,0,0,0,0
Carlton,"Silvagni, Alex",13,8,5,5,0,0,0,7
Carlton,"Simpson, Kade",26,21,9,5,1,0,0,1
Carlton,"Smedts, Billie",7,2,2,5,0,0,0,1
Carlton,"Thomas, Dale",20,10,9,10,1,0,0,0
Carlton,"Weitering, Jacob",10,6,2,4,1,0,0,1
Carlton,"White, Simon",13,7,3,6,0,0,0,1
Carlton,"Williamson, Tom",11,6,4,5,0,0,0,2
Carlton,"Wright, Matthew",16,11,3,5,2,1,0,2
Carlton,"Casboult, Levi",8,6,4,2,0,0,12,4
Carlton,"Cripps, Patrick",30,17,11,13,2,0,0,5
Carlton,"Curnow, Charlie",8,5,5,3,1,0,0,3
Carlton,"Curnow, Ed",18,12,4,6,0,1,0,1
Carlton,"Docherty, Sam",26,18,11,8,0,0,0,6
Carlton,"Fisher, Zac",8,5,1,3,0,0,0,5
Carlton,"Gibbs, Bryce",22,14,6,8,1,0,0,5
Carlton,"Graham, Nick",18,10,6,8,0,0,0,3
Carlton,"Kreuzer, Matthew",19,12,5,7,0,1,14,3
Carlton,"Marchbank, Caleb",20,15,10,5,0,0,0,0
Carlton,"Murphy, Marc",28,18,6,10,2,0,0,5
Carlton,"Petrevski-Seton, Sam",12,8,5,4,0,1,0,3
Carlton,"Plowman, Lachie",13,8,4,5,0,0,0,3
Carlton,"Rowe, Sam",14,8,7,6,0,0,0,2
Carlton,"Silvagni, Alex",13,9,5,4,0,0,0,3
Carlton,"Silvagni, Jack",8,6,6,2,2,0,0,2
Carlton,"Simpson, Kade",27,21,7,6,0,0,0,2
Carlton,"Thomas, Dale",18,13,9,5,0,0,0,2
Carlton,"Weitering, Jacob",9,4,4,5,1,0,0,1
Carlton,"White, Simon",11,9,6,2,0,0,0,1
Carlton,"Williamson, Tom",9,8,3,1,1,0,0,1
Carlton,"Wright, Matthew",12,9,5,3,0,0,0,6
Carlton,"Casboult, Levi",9,5,4,4,2,0,10,3
Carlton,"Cripps, Patrick",21,10,3,11,0,0,0,8
Carlton,"Cuningham, David",13,6,1,7,0,0,0,5
Carlton,"Curnow, Charlie",9,7,4,2,0,0,0,1
Carlton,"Curnow, Ed",31,17,4,14,0,0,0,6
Carlton,"Docherty, Sam",27,23,11,4,1,0,0,1
Carlton,"Fisher, Zac",13,7,1,6,1,0,0,2
Carlton,"Gibbs, Bryce",34,19,5,15,1,0,0,6
Carlton,"Graham, Nick",17,14,1,3,0,0,0,8
Carlton,"Kreuzer, Matthew",22,11,5,11,0,2,26,6
Carlton,"Marchbank, Caleb",17,13,6,4,0,0,0,3
Carlton,"Murphy, Marc",32,21,3,11,1,1,0,2
Carlton,"Petrevski-Seton, Sam",8,5,3,3,0,0,0,10
Carlton,"Plowman, Lachie",18,12,7,6,0,0,0,1
Carlton,"Rowe, Sam",2,1,1,1,0,0,0,0
Carlton,"Silvagni, Alex",15,6,8,9,0,0,0,4
Carlton,"Silvagni, Jack",12,9,7,3,0,2,0,1
Carlton,"Simpson, Kade",19,15,6,4,0,1,0,2
Carlton,"Thomas, Dale",8,5,2,3,1,0,0,0
Carlton,"Weitering, Jacob",17,14,8,3,0,0,0,0
Carlton,"Williamson, Tom",17,14,8,3,0,0,0,1
Carlton,"Wright, Matthew",17,13,2,4,0,1,0,2
Carlton,"Casboult, Levi",11,7,5,4,2,0,6,1
Carlton,"Cripps, Patrick",32,11,5,21,1,0,0,5
Carlton,"Cuningham, David",15,11,5,4,2,0,0,7
Carlton,"Curnow, Charlie",17,10,5,7,2,0,0,5
Carlton,"Curnow, Ed",32,13,6,19,0,0,0,6
Carlton,"Docherty, Sam",31,23,7,8,2,1,0,4
Carlton,"Fisher, Zac",9,4,0,5,0,1,0,4
Carlton,"Gibbs, Bryce",38,15,6,23,3,0,0,6
Carlton,"Graham, Nick",20,7,1,13,0,0,0,5
Carlton,"Kreuzer, Matthew",18,10,2,8,0,1,46,9
Carlton,"Macreadie, Harrison",10,6,3,4,0,0,0,0
Carlton,"Marchbank, Caleb",14,11,9,3,0,0,0,5
Carlton,"Murphy, Marc",30,10,4,20,1,0,0,2
Carlton,"Petrevski-Seton, Sam",7,4,1,3,0,0,0,5
Carlton,"Plowman, Lachie",16,9,3,7,0,0,0,2
Carlton,"Silvagni, Alex",17,13,3,4,0,0,0,7
Carlton,"Silvagni, Jack",8,5,4,3,0,1,0,4
Carlton,"Simpson, Kade",27,17,6,10,0,0,0,2
Carlton,"Sumner, Liam",8,4,3,4,1,0,0,3
Carlton,"Weitering, Jacob",14,11,2,3,0,0,0,4
Carlton,"Williamson, Tom",8,6,2,2,0,1,0,6
Carlton,"Wright, Matthew",24,13,7,11,1,0,0,3
Carlton,"Casboult, Levi",12,6,5,6,1,2,6,1
Carlton,"Cripps, Patrick",21,6,1,15,0,0,0,5
Carlton,"Cuningham, David",19,8,5,11,2,0,0,1
Carlton,"Curnow, Charlie",9,4,3,5,0,1,0,4
Carlton,"Curnow, Ed",18,10,5,8,1,0,0,3
Carlton,"Docherty, Sam",35,25,12,10,0,0,0,5
Carlton,"Fisher, Zac",12,5,2,7,0,1,0,1
Carlton,"Gibbs, Bryce",27,15,6,12,1,1,0,4
Carlton,"Jones, Liam",14,11,8,3,0,0,0,3
Carlton,"Kreuzer, Matthew",21,15,6,6,1,1,33,8
Carlton,"Lamb, Jed",15,10,4,5,1,0,0,0
Carlton,"Marchbank, Caleb",18,13,7,5,0,0,0,4
Carlton,"Murphy, Marc",30,16,9,14,0,0,0,1
Carlton,"Plowman, Lachie",10,5,7,5,0,0,0,1
Carlton,"Silvagni, Alex",0,0,0,0,0,0,0,1
Carlton,"Silvagni, Jack",10,8,2,2,1,0,0,3
Carlton,"Simpson, Kade",20,9,4,11,0,1,0,2
Carlton,"Sumner, Liam",9,6,0,3,0,0,0,1
Carlton,"Thomas, Dale",19,12,8,7,0,1,0,2
Carlton,"Weitering, Jacob",14,11,6,3,0,0,0,2
Carlton,"Williamson, Tom",10,5,2,5,0,0,0,1
Carlton,"Wright, Matthew",16,14,5,2,2,0,0,2
Carlton,"Boekhorst, Blaine",18,13,4,5,1,0,0,3
Carlton,"Casboult, Levi",13,10,8,3,0,3,8,1
Carlton,"Cripps, Patrick",27,10,4,17,0,0,0,7
Carlton,"Cuningham, David",10,7,3,3,0,0,0,7
Carlton,"Curnow, Charlie",15,9,3,6,1,2,0,3
Carlton,"Curnow, Ed",21,11,1,10,1,0,0,2
Carlton,"Docherty, Sam",30,22,9,8,0,0,0,9
Carlton,"Fisher, Zac",11,3,0,8,0,0,0,5
Carlton,"Gibbs, Bryce",43,31,8,12,2,0,0,10
Carlton,"Jones, Liam",12,11,6,1,0,0,0,2
Carlton,"Kreuzer, Matthew",18,11,3,7,0,0,30,6
Carlton,"Lamb, Jed",17,11,4,6,1,1,0,5
Carlton,"Marchbank, Caleb",15,12,6,3,0,0,0,2
Carlton,"Murphy, Marc",31,12,6,19,0,0,0,3
Carlton,"Petrevski-Seton, Sam",15,7,4,8,1,0,0,2
Carlton,"Plowman, Lachie",15,7,4,8,0,0,0,2
Carlton,"Silvagni, Jack",13,12,6,1,2,2,0,2
Carlton,"Simpson, Kade",33,26,15,7,0,0,0,0
Carlton,"Thomas, Dale",17,9,5,8,2,1,0,3
Carlton,"Weitering, Jacob",11,7,2,4,0,0,0,0
Carlton,"Williamson, Tom",7,3,2,4,0,0,0,2
Carlton,"Wright, Matthew",15,11,1,4,1,1,0,4
Carlton,"Boekhorst, Blaine",10,4,2,6,0,0,0,3
Carlton,"Casboult, Levi",9,6,7,3,2,1,6,0
Carlton,"Cripps, Patrick",27,13,5,14,1,1,0,8
Carlton,"Curnow, Charlie",16,10,9,6,1,0,0,1
Carlton,"Curnow, Ed",15,7,3,8,0,0,0,2
Carlton,"Docherty, Sam",28,21,11,7,0,0,0,4
Carlton,"Gibbs, Bryce",30,15,5,15,0,2,0,3
Carlton,"Graham, Nick",20,13,6,7,0,0,0,4
Carlton,"Jones, Liam",8,7,3,1,0,0,0,3
Carlton,"Kreuzer, Matthew",14,11,4,3,2,2,37,1
Carlton,"Lamb, Jed",0,0,0,0,0,0,0,0
Carlton,"Marchbank, Caleb",11,10,5,1,0,0,0,3
Carlton,"Murphy, Marc",26,11,7,15,0,0,0,2
Carlton,"Petrevski-Seton, Sam",4,3,3,1,0,0,0,3
Carlton,"Pickett, Jarrod",6,2,2,4,0,0,0,2
Carlton,"Plowman, Lachie",11,2,1,9,0,0,0,1
Carlton,"Silvagni, Jack",9,7,1,2,0,1,0,1
Carlton,"Simpson, Kade",22,15,6,7,0,1,0,2
Carlton,"Smedts, Billie",8,4,2,4,0,0,0,2
Carlton,"Thomas, Dale",21,13,7,8,1,0,0,1
Carlton,"Weitering, Jacob",17,8,6,9,0,0,0,1
Carlton,"Wright, Matthew",16,12,8,4,1,1,0,1
Carlton,"Casboult, Levi",12,9,7,3,2,1,8,3
Carlton,"Cripps, Patrick",29,8,6,21,1,1,0,6
Carlton,"Cuningham, David",10,7,3,3,1,0,0,4
Carlton,"Curnow, Charlie",22,18,11,4,1,0,1,0
Carlton,"Docherty, Sam",30,23,11,7,0,0,0,4
Carlton,"Fisher, Zac",9,4,0,5,0,0,0,4
Carlton,"Gibbs, Bryce",30,16,5,14,2,0,0,15
Carlton,"Graham, Nick",24,14,8,10,0,1,0,2
Carlton,"Jones, Liam",19,12,9,7,0,0,0,3
Carlton,"Kerridge, Sam",27,14,5,13,1,0,0,5
Carlton,"Kreuzer, Matthew",14,10,8,4,0,0,42,5
Carlton,"Marchbank, Caleb",14,11,3,3,0,0,0,0
Carlton,"Murphy, Marc",29,16,6,13,0,0,0,9
Carlton,"Plowman, Lachie",12,5,4,7,0,0,0,0
Carlton,"Sheehan, Ciaran",10,6,2,4,0,0,0,1
Carlton,"Silvagni, Jack",5,3,2,2,1,0,0,6
Carlton,"Simpson, Kade",26,16,7,10,0,0,0,3
Carlton,"Sumner, Liam",4,3,3,1,1,1,0,2
Carlton,"Thomas, Dale",18,11,7,7,1,0,0,1
Carlton,"Weitering, Jacob",22,13,4,9,0,0,0,0
Carlton,"White, Simon",18,12,6,6,0,0,0,3
Carlton,"Wright, Matthew",10,9,0,1,1,0,0,7
Carlton,"Casboult, Levi",12,8,9,4,1,2,6,1
Carlton,"Cripps, Patrick",9,6,1,3,0,0,0,4
Carlton,"Cuningham, David",17,13,6,4,0,0,0,5
Carlton,"Curnow, Charlie",19,12,10,7,2,1,0,4
Carlton,"Docherty, Sam",34,23,10,11,0,1,0,7
Carlton,"Fisher, Zac",10,4,0,6,0,0,0,5
Carlton,"Gibbs, Bryce",31,20,6,11,0,2,0,5
Carlton,"Jones, Liam",11,6,4,5,0,0,0,3
Carlton,"Kerridge, Sam",35,18,7,17,0,0,0,2
Carlton,"Kreuzer, Matthew",18,7,3,11,1,1,28,7
Carlton,"Lamb, Jed",17,14,7,3,0,0,0,3
Carlton,"Macreadie, Harrison",6,3,0,3,0,0,0,4
Carlton,"Murphy, Marc",35,17,5,18,2,0,0,4
Carlton,"Petrevski-Seton, Sam",16,8,2,8,1,0,0,9
Carlton,"Plowman, Lachie",24,12,7,12,0,0,0,3
Carlton,"Sheehan, Ciaran",9,5,3,4,0,0,0,1
Carlton,"Silvagni, Jack",8,7,3,1,3,0,0,4
Carlton,"Simpson, Kade",35,28,10,7,0,0,0,1
Carlton,"Thomas, Dale",19,11,6,8,0,1,0,1
Carlton,"Weitering, Jacob",17,9,8,8,0,0,0,2
Carlton,"White, Simon",8,5,2,3,0,0,0,1
Carlton,"Wright, Matthew",16,10,7,6,2,1,0,2
Carlton,"Boekhorst, Blaine",15,11,2,4,1,0,0,3
Carlton,"Buckley, Dylan",8,5,0,3,0,0,0,1
Carlton,"Byrne, Ciaran",12,7,6,5,0,0,0,0
Carlton,"Casboult, Levi",12,5,4,7,1,1,4,1
Carlton,"Curnow, Charlie",14,9,8,5,2,1,0,1
Carlton,"Docherty, Sam",29,19,9,10,0,0,0,4
Carlton,"Fisher, Zac",13,6,2,7,0,1,0,4
Carlton,"Gibbs, Bryce",32,20,3,12,1,0,0,4
Carlton,"Graham, Nick",23,14,5,9,1,0,0,4
Carlton,"Jones, Liam",9,8,6,1,0,0,0,3
Carlton,"Kerridge, Sam",30,12,5,18,0,1,0,2
Carlton,"Kreuzer, Matthew",12,5,4,7,0,0,50,1
Carlton,"Lamb, Jed",22,16,7,6,0,0,0,3
Carlton,"Murphy, Marc",27,19,7,8,0,0,0,4
Carlton,"Petrevski-Seton, Sam",13,8,4,5,0,0,0,5
Carlton,"Plowman, Lachie",14,7,6,7,0,0,0,2
Carlton,"Silvagni, Alex",7,4,5,3,0,0,0,6
Carlton,"Silvagni, Jack",14,11,9,3,0,1,0,3
Carlton,"Simpson, Kade",23,17,7,6,0,0,0,5
Carlton,"Sumner, Liam",6,4,1,2,0,0,0,0
Carlton,"Weitering, Jacob",10,7,5,3,0,1,0,2
Carlton,"Wright, Matthew",15,10,8,5,3,0,0,0
Carlton,"Casboult, Levi",10,8,5,2,1,2,7,1
Carlton,"Cuningham, David",12,5,2,7,1,1,0,3
Carlton,"Curnow, Charlie",15,10,7,5,2,1,1,6
Carlton,"Docherty, Sam",24,16,4,8,0,0,0,4
Carlton,"Fisher, Zac",11,8,0,3,0,0,0,1
Carlton,"Gibbs, Bryce",8,5,1,3,0,0,0,4
Carlton,"Graham, Nick",13,9,3,4,1,1,0,6
Carlton,"Jones, Liam",7,5,1,2,0,0,0,0
Carlton,"Kerridge, Sam",23,15,8,8,0,0,0,1
Carlton,"Kreuzer, Matthew",17,12,4,5,0,0,22,3
Carlton,"Lamb, Jed",12,10,2,2,0,2,0,4
Carlton,"Macreadie, Harrison",6,5,1,1,0,0,0,0
Carlton,"McKay, Harry",11,8,6,3,1,2,0,1
Carlton,"Murphy, Marc",25,17,6,8,0,1,0,2
Carlton,"Petrevski-Seton, Sam",14,9,4,5,2,1,0,4
Carlton,"Plowman, Lachie",12,6,6,6,0,0,0,2
Carlton,"Silvagni, Jack",6,3,2,3,0,0,0,0
Carlton,"Simpson, Kade",22,17,3,5,1,0,0,1
Carlton,"Thomas, Dale",11,7,2,4,0,1,0,0
Carlton,"Weitering, Jacob",5,4,3,1,0,0,0,1
Carlton,"Williamson, Tom",10,8,3,2,0,0,0,2
Carlton,"Wright, Matthew",18,12,6,6,2,1,0,2
Carlton,"Casboult, Levi",11,8,5,3,3,0,8,5
Carlton,"Cuningham, David",7,6,2,1,0,0,0,2
Carlton,"Curnow, Charlie",14,10,4,4,1,0,4,7
Carlton,"Docherty, Sam",29,19,8,10,0,0,0,4
Carlton,"Fisher, Zac",9,5,1,4,0,1,0,2
Carlton,"Gibbs, Bryce",24,18,8,6,0,0,0,4
Carlton,"Jones, Liam",11,9,2,2,0,0,0,5
Carlton,"Kerridge, Sam",23,10,4,13,0,1,0,6
Carlton,"Kreuzer, Matthew",8,4,0,4,0,0,26,3
Carlton,"Lamb, Jed",8,6,5,2,0,2,0,2
Carlton,"Marchbank, Caleb",6,4,0,2,0,0,0,4
Carlton,"McKay, Harry",4,3,1,1,2,0,0,0
Carlton,"Murphy, Marc",24,13,2,11,0,2,0,6
Carlton,"Petrevski-Seton, Sam",20,11,3,9,0,1,0,10
Carlton,"Plowman, Lachie",7,4,1,3,0,0,0,6
Carlton,"Silvagni, Jack",11,7,6,4,1,0,0,2
Carlton,"Simpson, Kade",14,9,6,5,0,0,0,2
Carlton,"Thomas, Dale",13,8,2,5,0,0,0,3
Carlton,"Weitering, Jacob",3,3,2,0,0,0,0,2
Carlton,"White, Simon",11,7,4,4,0,0,0,2
Carlton,"Williamson, Tom",8,5,2,3,0,0,0,3
Carlton,"Wright, Matthew",13,12,4,1,1,1,0,5
Carlton,"Armfield, Dennis",14,9,6,5,0,0,0,4
Carlton,"Boekhorst, Blaine",14,9,3,5,1,1,0,5
Carlton,"Casboult, Levi",9,6,6,3,1,2,2,2
Carlton,"Curnow, Charlie",12,9,4,3,1,2,0,2
Carlton,"Docherty, Sam",27,21,6,6,0,0,0,1
Carlton,"Fisher, Zac",8,3,0,5,0,0,0,1
Carlton,"Gibbs, Bryce",29,18,6,11,1,1,0,8
Carlton,"Jones, Liam",14,9,8,5,0,0,0,2
Carlton,"Kerridge, Sam",19,15,6,4,0,0,0,2
Carlton,"Kreuzer, Matthew",15,11,3,4,1,0,38,7
Carlton,"Lamb, Jed",11,9,3,2,1,0,0,1
Carlton,"Marchbank, Caleb",13,8,3,5,0,0,0,0
Carlton,"Murphy, Marc",32,12,4,20,0,0,0,4
Carlton,"Petrevski-Seton, Sam",22,9,3,13,1,1,0,2
Carlton,"Pickett, Jarrod",9,6,0,3,0,0,0,2
Carlton,"Plowman, Lachie",12,10,7,2,0,0,0,0
Carlton,"Silvagni, Jack",10,7,5,3,1,1,0,3
Carlton,"Simpson, Kade",20,16,8,4,0,0,0,4
Carlton,"Smedts, Billie",5,2,0,3,0,0,0,6
Carlton,"Thomas, Dale",22,14,7,8,0,0,0,5
Carlton,"Weitering, Jacob",20,12,7,8,0,0,0,2
Carlton,"Wright, Matthew",16,14,7,2,3,1,0,4
Carlton,"Armfield, Dennis",9,5,3,4,0,0,0,3
Carlton,"Boekhorst, Blaine",14,10,4,4,1,0,0,2
Carlton,"Casboult, Levi",7,3,6,4,2,0,5,3
Carlton,"Curnow, Charlie",19,15,8,4,1,1,0,5
Carlton,"Docherty, Sam",23,14,6,9,0,0,0,0
Carlton,"Fisher, Zac",15,3,4,12,1,0,0,2
Carlton,"Gibbs, Bryce",26,13,5,13,1,1,0,3
Carlton,"Jones, Liam",13,9,2,4,0,0,0,4
Carlton,"Kerridge, Sam",24,9,7,15,0,0,0,6
Carlton,"Kreuzer, Matthew",17,9,3,8,0,1,33,7
Carlton,"Lamb, Jed",14,12,6,2,1,2,0,5
Carlton,"Murphy, Marc",29,21,5,8,2,2,0,3
Carlton,"Petrevski-Seton, Sam",19,10,3,9,0,0,0,6
Carlton,"Pickett, Jarrod",10,6,1,4,1,0,0,1
Carlton,"Plowman, Lachie",15,10,6,5,0,0,0,1
Carlton,"Silvagni, Jack",13,9,3,4,2,1,0,2
Carlton,"Simpson, Kade",22,15,7,7,0,0,0,1
Carlton,"Smedts, Billie",11,7,5,4,0,0,0,4
Carlton,"Thomas, Dale",24,15,3,9,0,1,0,2
Carlton,"Weitering, Jacob",16,9,7,7,0,0,0,1
Carlton,"Williamson, Tom",12,9,4,3,0,0,0,2
Carlton,"Wright, Matthew",17,10,1,7,0,0,0,2
Carlton,"Boekhorst, Blaine",26,16,8,10,0,0,0,4
Carlton,"Byrne, Ciaran",23,12,5,11,0,0,0,0
Carlton,"Casboult, Levi",7,5,3,2,2,0,9,2
Carlton,"Curnow, Charlie",22,12,5,10,1,0,0,3
Carlton,"Docherty, Sam",31,26,15,5,0,0,0,3
Carlton,"Fisher, Zac",16,8,4,8,1,0,0,3
Carlton,"Gibbs, Bryce",20,14,3,6,1,1,0,8
Carlton,"Jones, Liam",9,3,3,6,0,0,0,3
Carlton,"Kerridge, Sam",24,12,6,12,0,0,0,7
Carlton,"Kreuzer, Matthew",15,12,2,3,1,1,29,2
Carlton,"Lamb, Jed",15,14,7,1,2,2,0,4
Carlton,"Murphy, Marc",34,13,7,21,0,0,0,1
Carlton,"Petrevski-Seton, Sam",12,6,4,6,0,0,0,4
Carlton,"Pickett, Jarrod",16,11,3,5,2,1,0,2
Carlton,"Plowman, Lachie",20,12,8,8,0,0,0,1
Carlton,"Silvagni, Jack",5,3,1,2,0,0,0,3
Carlton,"Simpson, Kade",25,17,8,8,0,0,0,1
Carlton,"Smedts, Billie",5,1,1,4,0,0,0,8
Carlton,"Thomas, Dale",17,11,4,6,1,0,0,2
Carlton,"Weitering, Jacob",23,15,10,8,0,0,0,1
Carlton,"Williamson, Tom",13,4,4,9,0,0,0,2
Carlton,"Wright, Matthew",17,11,3,6,1,0,0,1
Carlton,"Armfield, Dennis",15,11,6,4,0,0,0,1
Carlton,"Boekhorst, Blaine",19,14,8,5,3,0,0,1
Carlton,"Byrne, Ciaran",4,2,2,2,0,0,0,2
Carlton,"Casboult, Levi",8,5,4,3,1,0,6,1
Carlton,"Curnow, Charlie",11,10,2,1,2,1,0,0
Carlton,"Docherty, Sam",20,15,3,5,0,0,0,1
Carlton,"Fisher, Zac",13,6,3,7,0,0,0,3
Carlton,"Gibbs, Bryce",24,16,6,8,0,0,0,4
Carlton,"Graham, Nick",16,10,3,6,0,1,0,4
Carlton,"Jones, Liam",8,5,4,3,0,0,0,3
Carlton,"Kerridge, Sam",16,5,3,11,0,0,0,6
Carlton,"Kreuzer, Matthew",16,12,3,4,1,0,37,4
Carlton,"Lamb, Jed",10,8,6,2,0,1,0,1
Carlton,"Murphy, Marc",32,18,10,14,0,0,0,1
Carlton,"Petrevski-Seton, Sam",10,5,2,5,0,0,0,3
Carlton,"Pickett, Jarrod",9,6,3,3,1,1,0,3
Carlton,"Simpson, Kade",29,20,9,9,0,0,0,3
Carlton,"Smedts, Billie",8,4,2,4,0,0,0,4
Carlton,"Thomas, Dale",18,10,6,8,0,1,0,3
Carlton,"Weitering, Jacob",24,19,14,5,0,0,0,1
Carlton,"Williamson, Tom",13,9,5,4,0,0,0,1
Carlton,"Wright, Matthew",23,13,7,10,0,2,0,3
Collingwood,"Adams, Taylor",33,20,6,13,0,0,0,12
Collingwood,"Blair, Jarryd",15,6,3,9,0,2,0,4
Collingwood,"Cox, Mason",8,3,1,5,0,1,21,0
Collingwood,"Crisp, Jack",17,11,6,6,0,0,0,3
Collingwood,"Fasolo, Alex",22,13,8,9,3,3,0,3
Collingwood,"Goldsack, Tyson",8,5,1,3,1,0,0,2
Collingwood,"Grundy, Brodie",12,7,7,5,0,0,29,4
Collingwood,"Hoskin-Elliott, Will",22,15,8,7,1,0,0,1
Collingwood,"Howe, Jeremy",26,16,11,10,0,0,0,3
Collingwood,"Maynard, Brayden",16,11,7,5,0,0,0,4
Collingwood,"Mayne, Chris",13,9,4,4,1,1,0,5
Collingwood,"Moore, Darcy",10,7,4,3,0,1,0,1
Collingwood,"Pendlebury, Scott",35,16,3,19,2,0,0,6
Collingwood,"Phillips, Tom",26,12,2,14,0,0,0,4
Collingwood,"Ramsay, Jackson",25,12,5,13,0,1,0,3
Collingwood,"Reid, Ben",12,7,7,5,0,0,0,1
Collingwood,"Schade, Henry",10,4,4,6,0,0,0,0
Collingwood,"Sidebottom, Steele",35,17,4,18,2,0,0,3
Collingwood,"Smith, Josh",20,14,6,6,0,0,0,1
Collingwood,"Treloar, Adam",33,20,8,13,1,0,0,3
Collingwood,"Varcoe, Travis",15,8,5,7,0,1,0,2
Collingwood,"White, Jesse",18,13,8,5,1,1,0,2
Collingwood,"Adams, Taylor",25,12,3,13,0,0,0,7
Collingwood,"Aish, James",16,6,2,10,0,1,0,5
Collingwood,"Blair, Jarryd",9,1,1,8,0,0,0,4
Collingwood,"Broomhead, Tim",12,6,1,6,1,0,0,2
Collingwood,"Crisp, Jack",15,9,2,6,0,1,0,1
Collingwood,"Fasolo, Alex",11,8,6,3,0,3,0,1
Collingwood,"Goldsack, Tyson",14,5,3,9,0,0,0,3
Collingwood,"Grundy, Brodie",23,10,4,13,1,1,45,2
Collingwood,"Hoskin-Elliott, Will",21,15,12,6,3,0,0,3
Collingwood,"Howe, Jeremy",15,10,6,5,0,0,0,3
Collingwood,"Maynard, Brayden",14,7,0,7,0,0,0,2
Collingwood,"Mayne, Chris",12,5,3,7,1,1,0,4
Collingwood,"Moore, Darcy",8,8,7,0,1,1,0,0
Collingwood,"Pendlebury, Scott",32,18,6,14,0,0,0,4
Collingwood,"Phillips, Tom",18,8,3,10,0,0,0,2
Collingwood,"Ramsay, Jackson",11,3,1,8,0,0,0,6
Collingwood,"Reid, Ben",14,12,5,2,0,0,0,1
Collingwood,"Schade, Henry",15,7,6,8,0,0,0,1
Collingwood,"Sidebottom, Steele",21,8,3,13,0,1,0,1
Collingwood,"Smith, Josh",19,16,7,3,0,0,0,1
Collingwood,"Treloar, Adam",35,20,6,15,2,1,0,2
Collingwood,"White, Jesse",11,8,1,3,2,1,4,0
Collingwood,"Adams, Taylor",31,14,6,17,0,1,0,11
Collingwood,"Broomhead, Tim",26,11,6,15,0,2,0,4
Collingwood,"Crisp, Jack",26,13,4,13,1,1,0,4
Collingwood,"Fasolo, Alex",18,10,6,8,4,1,0,2
Collingwood,"Goldsack, Tyson",13,11,5,2,0,0,0,3
Collingwood,"Greenwood, Levi",19,13,6,6,1,3,0,3
Collingwood,"Grundy, Brodie",23,12,2,11,0,0,43,7
Collingwood,"Hoskin-Elliott, Will",17,12,10,5,1,0,0,3
Collingwood,"Howe, Jeremy",22,12,5,10,0,0,0,1
Collingwood,"Maynard, Brayden",17,10,2,7,0,0,0,7
Collingwood,"Mayne, Chris",11,5,2,6,0,0,0,5
Collingwood,"Moore, Darcy",10,5,4,5,0,0,0,2
Collingwood,"Pendlebury, Scott",26,13,3,13,0,0,0,10
Collingwood,"Phillips, Tom",27,15,4,12,0,1,0,5
Collingwood,"Ramsay, Jackson",16,5,3,11,0,0,0,4
Collingwood,"Reid, Ben",16,13,10,3,0,0,0,1
Collingwood,"Schade, Henry",16,10,3,6,0,0,0,6
Collingwood,"Sidebottom, Steele",25,12,5,13,0,1,0,12
Collingwood,"Smith, Josh",19,14,6,5,0,0,0,2
Collingwood,"Treloar, Adam",28,12,0,16,1,1,0,15
Collingwood,"Varcoe, Travis",15,5,1,10,2,0,0,4
Collingwood,"White, Jesse",15,10,8,5,1,2,5,4
Collingwood,"Adams, Taylor",39,12,2,27,0,0,0,3
Collingwood,"Blair, Jarryd",16,6,2,10,1,0,0,3
Collingwood,"Broomhead, Tim",17,3,0,14,0,2,0,2
Collingwood,"Crisp, Jack",19,12,6,7,1,0,0,3
Collingwood,"Elliott, Jamie",6,5,4,1,0,1,0,1
Collingwood,"Fasolo, Alex",9,5,4,4,1,3,0,2
Collingwood,"Goldsack, Tyson",15,4,2,11,0,0,0,1
Collingwood,"Greenwood, Levi",17,8,2,9,0,1,0,1
Collingwood,"Grundy, Brodie",21,11,7,10,0,0,37,3
Collingwood,"Hoskin-Elliott, Will",14,8,5,6,2,1,0,2
Collingwood,"Howe, Jeremy",21,14,10,7,0,0,0,5
Collingwood,"Maynard, Brayden",18,11,3,7,0,0,0,3
Collingwood,"Moore, Darcy",6,5,4,1,0,1,0,1
Collingwood,"Pendlebury, Scott",25,6,2,19,0,1,0,5
Collingwood,"Ramsay, Jackson",19,10,5,9,0,0,0,3
Collingwood,"Reid, Ben",20,17,11,3,0,0,0,1
Collingwood,"Schade, Henry",14,10,4,4,1,0,0,0
Collingwood,"Sidebottom, Steele",31,22,7,9,0,0,0,2
Collingwood,"Smith, Josh",17,13,7,4,0,0,0,5
Collingwood,"Treloar, Adam",28,12,2,16,0,1,0,6
Collingwood,"Varcoe, Travis",13,7,3,6,0,0,0,4
Collingwood,"White, Jesse",6,3,2,3,1,1,2,0
Collingwood,"Adams, Taylor",20,11,5,9,0,2,0,5
Collingwood,"Broomhead, Tim",14,5,2,9,0,1,0,6
Collingwood,"Cox, Mason",7,4,2,3,0,1,11,2
Collingwood,"Crisp, Jack",27,15,3,12,1,1,0,7
Collingwood,"Elliott, Jamie",14,11,6,3,3,2,0,2
Collingwood,"Fasolo, Alex",12,9,6,3,1,3,0,1
Collingwood,"Goldsack, Tyson",17,7,4,10,0,0,0,2
Collingwood,"Greenwood, Levi",11,6,5,5,0,0,0,4
Collingwood,"Grundy, Brodie",12,8,2,4,0,1,35,3
Collingwood,"Hoskin-Elliott, Will",12,9,2,3,0,0,0,4
Collingwood,"Howe, Jeremy",30,21,8,9,0,0,0,1
Collingwood,"Maynard, Brayden",21,14,8,7,0,0,0,2
Collingwood,"Moore, Darcy",8,5,5,3,2,0,0,1
Collingwood,"Pendlebury, Scott",20,10,1,10,0,0,0,4
Collingwood,"Phillips, Tom",15,12,5,3,0,1,0,1
Collingwood,"Ramsay, Jackson",20,8,1,12,0,0,0,2
Collingwood,"Reid, Ben",13,7,4,6,0,0,0,1
Collingwood,"Schade, Henry",11,6,6,5,0,0,0,1
Collingwood,"Sidebottom, Steele",25,14,4,11,1,0,0,3
Collingwood,"Treloar, Adam",39,13,2,26,1,0,0,11
Collingwood,"Varcoe, Travis",13,6,5,7,0,0,0,4
Collingwood,"Wells, Daniel",24,15,4,9,2,1,0,2
Collingwood,"Adams, Taylor",36,21,8,15,0,0,0,8
Collingwood,"Broomhead, Tim",14,5,5,9,1,0,0,2
Collingwood,"Cox, Mason",12,3,3,9,1,1,9,2
Collingwood,"Crisp, Jack",25,13,7,12,1,1,0,4
Collingwood,"Dunn, Lynden",13,12,3,1,0,1,0,2
Collingwood,"Elliott, Jamie",13,5,2,8,1,1,0,2
Collingwood,"Fasolo, Alex",13,6,4,7,2,1,0,0
Collingwood,"Goldsack, Tyson",12,6,5,6,0,0,0,0
Collingwood,"Greenwood, Levi",16,6,2,10,0,0,0,3
Collingwood,"Grundy, Brodie",16,9,4,7,0,1,33,2
Collingwood,"Hoskin-Elliott, Will",26,13,9,13,1,1,0,1
Collingwood,"Howe, Jeremy",18,12,9,6,0,0,0,1
Collingwood,"Maynard, Brayden",11,9,2,2,1,1,0,2
Collingwood,"Moore, Darcy",17,10,9,7,2,2,0,1
Collingwood,"Pendlebury, Scott",33,15,6,18,1,1,0,9
Collingwood,"Phillips, Tom",18,12,4,6,1,1,0,1
Collingwood,"Schade, Henry",13,8,8,5,0,0,0,1
Collingwood,"Sidebottom, Steele",23,16,6,7,1,1,0,5
Collingwood,"Smith, Josh",26,24,9,2,0,0,0,2
Collingwood,"Treloar, Adam",25,8,2,17,1,0,0,5
Collingwood,"Varcoe, Travis",14,7,4,7,0,0,0,1
Collingwood,"Wells, Daniel",22,11,6,11,1,0,0,3
Collingwood,"Adams, Taylor",27,13,5,14,0,0,0,9
Collingwood,"Broomhead, Tim",11,1,1,10,0,1,0,2
Collingwood,"Cox, Mason",4,3,2,1,1,0,5,5
Collingwood,"Crisp, Jack",19,7,1,12,0,2,0,7
Collingwood,"Dunn, Lynden",10,7,8,3,0,0,0,0
Collingwood,"Elliott, Jamie",14,9,6,5,3,0,0,4
Collingwood,"Fasolo, Alex",8,7,5,1,1,1,0,1
Collingwood,"Goldsack, Tyson",11,4,5,7,0,0,0,3
Collingwood,"Greenwood, Levi",20,10,3,10,0,0,0,4
Collingwood,"Grundy, Brodie",17,10,1,7,0,0,30,3
Collingwood,"Hoskin-Elliott, Will",11,7,5,4,0,0,0,3
Collingwood,"Howe, Jeremy",14,9,8,5,0,0,0,0
Collingwood,"Maynard, Brayden",11,8,4,3,0,0,0,3
Collingwood,"Moore, Darcy",6,4,4,2,1,0,0,0
Collingwood,"Pendlebury, Scott",29,8,2,21,0,0,0,9
Collingwood,"Phillips, Tom",12,6,2,6,0,1,0,3
Collingwood,"Ramsay, Jackson",19,9,1,10,0,0,0,3
Collingwood,"Reid, Ben",25,20,12,5,0,0,0,1
Collingwood,"Sidebottom, Steele",20,10,1,10,0,1,0,3
Collingwood,"Smith, Josh",21,16,5,5,0,0,0,1
Collingwood,"Treloar, Adam",21,7,0,14,0,1,0,8
Collingwood,"de Goey, Jordan",15,11,2,4,2,0,0,1
Collingwood,"Adams, Taylor",30,14,3,16,0,0,0,8
Collingwood,"Aish, James",15,7,3,8,0,0,0,0
Collingwood,"Blair, Jarryd",10,4,3,6,2,1,0,4
Collingwood,"Crisp, Jack",15,7,5,8,1,0,0,1
Collingwood,"Dunn, Lynden",12,10,5,2,0,0,0,0
Collingwood,"Elliott, Jamie",15,11,8,4,3,1,0,1
Collingwood,"Fasolo, Alex",15,12,8,3,0,1,0,2
Collingwood,"Goldsack, Tyson",16,7,5,9,0,0,0,3
Collingwood,"Greenwood, Levi",18,9,3,9,0,1,0,4
Collingwood,"Grundy, Brodie",21,8,3,13,1,0,41,1
Collingwood,"Hoskin-Elliott, Will",18,8,7,10,1,0,0,3
Collingwood,"Howe, Jeremy",26,14,7,12,0,0,0,1
Collingwood,"Maynard, Brayden",16,7,0,9,2,0,0,3
Collingwood,"Moore, Darcy",13,10,9,3,0,2,5,2
Collingwood,"Pendlebury, Scott",22,13,5,9,0,0,0,4
Collingwood,"Phillips, Tom",20,12,5,8,0,1,0,3
Collingwood,"Reid, Ben",11,7,5,4,1,1,0,2
Collingwood,"Schade, Henry",16,5,4,11,0,0,0,0
Collingwood,"Sidebottom, Steele",24,15,5,9,3,0,0,2
Collingwood,"Smith, Josh",15,8,1,7,0,0,0,2
Collingwood,"Wells, Daniel",24,16,5,8,0,1,0,1
Collingwood,"de Goey, Jordan",16,5,2,11,1,0,0,4
Collingwood,"Adams, Taylor",33,18,8,15,0,0,0,3
Collingwood,"Aish, James",11,4,2,7,0,0,0,1
Collingwood,"Blair, Jarryd",14,4,0,10,0,1,0,5
Collingwood,"Crisp, Jack",19,10,7,9,1,0,0,6
Collingwood,"Dunn, Lynden",19,8,5,11,0,0,0,3
Collingwood,"Elliott, Jamie",14,8,6,6,3,0,0,2
Collingwood,"Fasolo, Alex",8,4,2,4,0,0,0,3
Collingwood,"Goldsack, Tyson",16,9,7,7,0,1,1,1
Collingwood,"Greenwood, Levi",15,8,6,7,1,1,0,7
Collingwood,"Grundy, Brodie",17,10,3,7,0,0,44,6
Collingwood,"Hoskin-Elliott, Will",18,15,3,3,0,0,0,6
Collingwood,"Howe, Jeremy",25,18,13,7,1,0,0,3
Collingwood,"Maynard, Brayden",22,16,7,6,1,0,0,1
Collingwood,"Moore, Darcy",11,4,5,7,2,1,4,3
Collingwood,"Pendlebury, Scott",36,20,2,16,1,0,0,9
Collingwood,"Phillips, Tom",24,14,5,10,0,0,0,3
Collingwood,"Schade, Henry",12,5,5,7,0,0,0,2
Collingwood,"Sidebottom, Steele",27,14,6,13,1,0,0,5
Collingwood,"Smith, Josh",22,17,11,5,1,0,0,3
Collingwood,"Treloar, Adam",34,13,3,21,1,1,0,7
Collingwood,"Wells, Daniel",16,5,3,11,0,1,0,7
Collingwood,"de Goey, Jordan",10,6,4,4,0,0,0,6
Collingwood,"Adams, Taylor",33,17,3,16,1,1,0,3
Collingwood,"Blair, Jarryd",14,2,1,12,0,0,0,2
Collingwood,"Broomhead, Tim",17,10,3,7,1,1,0,3
Collingwood,"Crisp, Jack",22,12,8,10,0,0,0,1
Collingwood,"Dunn, Lynden",15,14,6,1,1,0,0,1
Collingwood,"Elliott, Jamie",14,13,8,1,4,4,0,4
Collingwood,"Fasolo, Alex",17,12,6,5,2,4,0,2
Collingwood,"Goldsack, Tyson",14,3,1,11,0,0,0,4
Collingwood,"Greenwood, Levi",16,11,6,5,0,2,0,3
Collingwood,"Grundy, Brodie",19,5,1,14,0,0,38,6
Collingwood,"Hoskin-Elliott, Will",17,7,4,10,0,0,0,3
Collingwood,"Howe, Jeremy",17,10,7,7,0,0,0,1
Collingwood,"Maynard, Brayden",25,17,3,8,1,0,0,3
Collingwood,"Moore, Darcy",13,11,10,2,3,2,5,2
Collingwood,"Pendlebury, Scott",31,20,3,11,0,0,0,8
Collingwood,"Phillips, Tom",20,9,4,11,0,1,0,1
Collingwood,"Scharenberg, Matt",16,10,7,6,0,0,0,1
Collingwood,"Sidebottom, Steele",34,20,8,14,1,1,0,7
Collingwood,"Smith, Josh",25,16,7,9,1,0,0,3
Collingwood,"Treloar, Adam",30,16,3,14,1,1,0,5
Collingwood,"Wells, Daniel",20,11,8,9,2,1,0,0
Collingwood,"de Goey, Jordan",15,7,7,8,0,0,0,4
Collingwood,"Adams, Taylor",28,12,7,16,0,2,0,11
Collingwood,"Broomhead, Tim",19,10,4,9,0,1,0,1
Collingwood,"Crisp, Jack",26,15,6,11,0,0,0,1
Collingwood,"Crocker, Ben",9,6,4,3,1,1,0,0
Collingwood,"Dunn, Lynden",18,12,8,6,0,0,0,1
Collingwood,"Elliott, Jamie",12,9,7,3,3,0,0,6
Collingwood,"Goldsack, Tyson",10,6,4,4,0,1,0,1
Collingwood,"Greenwood, Levi",23,16,14,7,1,1,0,0
Collingwood,"Grundy, Brodie",21,8,4,13,0,0,39,2
Collingwood,"Hoskin-Elliott, Will",18,14,8,4,2,1,0,1
Collingwood,"Howe, Jeremy",20,13,8,7,1,0,0,0
Collingwood,"Maynard, Brayden",17,13,8,4,0,0,0,5
Collingwood,"Moore, Darcy",12,11,9,1,2,2,3,3
Collingwood,"Pendlebury, Scott",30,12,6,18,1,3,0,3
Collingwood,"Phillips, Tom",22,12,9,10,1,0,0,2
Collingwood,"Ramsay, Jackson",11,3,1,8,0,0,0,2
Collingwood,"Scharenberg, Matt",12,8,5,4,0,0,0,1
Collingwood,"Sidebottom, Steele",32,21,9,11,0,1,0,4
Collingwood,"Smith, Josh",32,24,14,8,0,0,0,1
Collingwood,"Treloar, Adam",35,17,3,18,1,0,0,6
Collingwood,"Wells, Daniel",6,5,3,1,0,0,0,0
Collingwood,"de Goey, Jordan",23,10,8,13,2,2,0,4
Collingwood,"Adams, Taylor",26,13,2,13,0,0,0,2
Collingwood,"Aish, James",22,12,8,10,1,0,0,4
Collingwood,"Broomhead, Tim",23,9,2,14,0,1,0,5
Collingwood,"Brown, Callum",16,3,1,13,0,0,0,2
Collingwood,"Crisp, Jack",16,5,4,11,0,0,0,2
Collingwood,"Crocker, Ben",12,8,7,4,1,0,0,6
Collingwood,"Dunn, Lynden",21,12,6,9,0,0,0,2
Collingwood,"Fasolo, Alex",10,6,5,4,2,0,0,5
Collingwood,"Greenwood, Levi",12,6,5,6,2,2,0,3
Collingwood,"Grundy, Brodie",19,10,4,9,0,0,53,11
Collingwood,"Hoskin-Elliott, Will",18,12,6,6,0,0,0,2
Collingwood,"Howe, Jeremy",22,12,10,10,0,0,0,3
Collingwood,"Langdon, Tom",10,4,3,6,0,0,0,3
Collingwood,"Maynard, Brayden",23,17,10,6,0,0,0,0
Collingwood,"Moore, Darcy",7,4,4,3,2,0,9,4
Collingwood,"Pendlebury, Scott",22,13,4,9,0,1,3,13
Collingwood,"Phillips, Tom",18,9,3,9,2,0,0,3
Collingwood,"Scharenberg, Matt",19,13,6,6,0,0,0,0
Collingwood,"Sidebottom, Steele",32,20,8,12,2,0,0,4
Collingwood,"Smith, Josh",12,7,2,5,0,0,0,1
Collingwood,"Treloar, Adam",28,17,4,11,1,1,0,6
Collingwood,"de Goey, Jordan",18,13,8,5,2,0,0,1
Collingwood,"Adams, Taylor",29,14,9,15,0,0,0,4
Collingwood,"Aish, James",12,10,6,2,0,1,0,3
Collingwood,"Broomhead, Tim",14,5,6,9,0,1,0,1
Collingwood,"Brown, Callum",9,1,1,8,1,0,0,0
Collingwood,"Crisp, Jack",27,12,10,15,0,0,0,0
Collingwood,"Crocker, Ben",8,4,3,4,1,1,0,2
Collingwood,"Dunn, Lynden",12,6,3,6,0,0,0,0
Collingwood,"Fasolo, Alex",11,9,6,2,2,2,0,2
Collingwood,"Goldsack, Tyson",19,6,3,13,0,0,0,2
Collingwood,"Greenwood, Levi",18,14,7,4,0,1,0,3
Collingwood,"Grundy, Brodie",19,9,8,10,0,0,27,3
Collingwood,"Hoskin-Elliott, Will",23,12,4,11,0,0,0,2
Collingwood,"Howe, Jeremy",27,20,11,7,0,1,0,3
Collingwood,"Langdon, Tom",24,9,6,15,0,0,0,3
Collingwood,"Maynard, Brayden",17,12,5,5,0,0,0,3
Collingwood,"Moore, Darcy",9,6,3,3,3,0,4,3
Collingwood,"Pendlebury, Scott",32,18,4,14,0,0,0,7
Collingwood,"Phillips, Tom",19,7,5,12,0,0,0,6
Collingwood,"Reid, Ben",20,15,8,5,1,1,0,0
Collingwood,"Sidebottom, Steele",36,21,8,15,0,0,0,3
Collingwood,"Treloar, Adam",35,13,5,22,0,0,0,6
Collingwood,"de Goey, Jordan",21,12,3,9,1,0,0,1
Collingwood,"Adams, Taylor",29,16,6,13,0,0,0,3
Collingwood,"Broomhead, Tim",20,10,4,10,1,1,0,2
Collingwood,"Cox, Mason",7,6,4,1,3,0,3,3
Collingwood,"Crisp, Jack",18,10,8,8,0,0,0,9
Collingwood,"Dunn, Lynden",10,6,3,4,0,0,0,3
Collingwood,"Elliott, Jamie",10,5,5,5,1,1,0,2
Collingwood,"Fasolo, Alex",17,13,8,4,3,1,0,3
Collingwood,"Goldsack, Tyson",9,6,3,3,0,0,0,3
Collingwood,"Greenwood, Levi",15,10,6,5,1,0,0,2
Collingwood,"Grundy, Brodie",21,5,2,16,0,0,29,4
Collingwood,"Hoskin-Elliott, Will",19,11,7,8,0,0,0,5
Collingwood,"Howe, Jeremy",23,12,10,11,0,0,0,1
Collingwood,"Langdon, Tom",16,5,5,11,0,0,0,3
Collingwood,"Maynard, Brayden",17,15,11,2,0,1,0,3
Collingwood,"Moore, Darcy",8,6,4,2,1,1,6,3
Collingwood,"Pendlebury, Scott",21,11,8,10,0,1,0,3
Collingwood,"Phillips, Tom",29,16,6,13,1,0,0,2
Collingwood,"Ramsay, Jackson",9,4,2,5,0,0,0,2
Collingwood,"Sidebottom, Steele",25,18,5,7,1,1,0,2
Collingwood,"Thomas, Josh",21,11,4,10,1,0,0,2
Collingwood,"Treloar, Adam",29,10,1,19,1,0,0,6
Collingwood,"de Goey, Jordan",32,14,3,18,0,1,0,6
Collingwood,"Adams, Taylor",24,16,4,8,1,0,0,1
Collingwood,"Broomhead, Tim",12,6,3,6,1,0,0,1
Collingwood,"Cox, Mason",8,5,3,3,1,0,16,1
Collingwood,"Crisp, Jack",22,13,3,9,0,0,0,6
Collingwood,"Dunn, Lynden",12,9,6,3,0,0,0,2
Collingwood,"Elliott, Jamie",17,14,10,3,3,1,0,1
Collingwood,"Fasolo, Alex",13,11,8,2,4,0,0,2
Collingwood,"Goldsack, Tyson",14,6,1,8,0,0,0,4
Collingwood,"Greenwood, Levi",13,9,4,4,0,1,0,1
Collingwood,"Grundy, Brodie",13,3,2,10,0,0,24,3
Collingwood,"Hoskin-Elliott, Will",22,10,4,12,0,0,0,6
Collingwood,"Langdon, Tom",24,9,10,15,0,0,0,0
Collingwood,"Maynard, Brayden",16,14,2,2,0,0,0,5
Collingwood,"Pendlebury, Scott",29,11,3,18,0,0,0,4
Collingwood,"Reid, Ben",11,7,5,4,1,2,0,3
Collingwood,"Scharenberg, Matt",20,12,7,8,0,0,0,0
Collingwood,"Sidebottom, Steele",26,15,7,11,0,1,0,6
Collingwood,"Smith, Josh",12,6,4,6,0,0,0,2
Collingwood,"Thomas, Josh",19,7,5,12,0,1,0,1
Collingwood,"Treloar, Adam",21,7,1,14,0,0,0,1
Collingwood,"Varcoe, Travis",13,9,2,4,0,0,0,1
Collingwood,"de Goey, Jordan",14,5,2,9,1,0,0,0
Collingwood,"Adams, Taylor",31,17,4,14,0,0,0,4
Collingwood,"Blair, Jarryd",13,7,5,6,1,1,0,3
Collingwood,"Crisp, Jack",18,10,5,8,0,0,0,7
Collingwood,"Dunn, Lynden",13,9,6,4,0,0,0,2
Collingwood,"Elliott, Jamie",14,7,3,7,1,1,0,2
Collingwood,"Fasolo, Alex",19,9,8,10,2,2,0,2
Collingwood,"Goldsack, Tyson",13,7,4,6,0,0,0,3
Collingwood,"Grundy, Brodie",16,5,2,11,0,0,42,2
Collingwood,"Hoskin-Elliott, Will",18,15,3,3,0,1,0,6
Collingwood,"Howe, Jeremy",14,8,4,6,0,0,0,4
Collingwood,"Langdon, Tom",10,7,1,3,0,1,0,6
Collingwood,"Maynard, Brayden",17,10,0,7,1,1,0,4
Collingwood,"Moore, Darcy",9,6,4,3,2,0,5,5
Collingwood,"Pendlebury, Scott",27,13,0,14,0,0,0,5
Collingwood,"Reid, Ben",16,10,5,6,3,1,0,0
Collingwood,"Scharenberg, Matt",21,12,9,9,0,0,0,1
Collingwood,"Sidebottom, Steele",32,16,4,16,1,0,0,3
Collingwood,"Thomas, Josh",15,10,2,5,2,1,0,4
Collingwood,"Treloar, Adam",32,11,1,21,0,1,0,5
Collingwood,"Varcoe, Travis",15,2,0,13,0,0,0,0
Collingwood,"Wells, Daniel",18,11,2,7,2,0,0,3
Collingwood,"de Goey, Jordan",27,14,5,13,0,1,0,4
Collingwood,"Adams, Taylor",26,14,4,12,1,0,0,6
Collingwood,"Blair, Jarryd",8,1,0,7,0,0,0,7
Collingwood,"Crisp, Jack",33,13,6,20,0,0,0,6
Collingwood,"Dunn, Lynden",12,11,2,1,0,0,0,0
Collingwood,"Elliott, Jamie",10,7,4,3,3,0,0,3
Collingwood,"Fasolo, Alex",14,11,4,3,1,2,0,2
Collingwood,"Goldsack, Tyson",13,4,3,9,0,0,0,4
Collingwood,"Greenwood, Levi",16,10,1,6,1,1,0,1
Collingwood,"Grundy, Brodie",19,10,3,9,0,0,42,7
Collingwood,"Hoskin-Elliott, Will",24,7,3,17,1,1,0,4
Collingwood,"Howe, Jeremy",26,21,9,5,0,1,0,0
Collingwood,"Langdon, Tom",18,13,6,5,0,0,0,0
Collingwood,"Maynard, Brayden",13,9,2,4,0,0,0,3
Collingwood,"Moore, Darcy",3,2,2,1,0,0,0,0
Collingwood,"Reid, Ben",12,9,5,3,2,2,4,0
Collingwood,"Sidebottom, Steele",20,8,2,12,0,0,0,5
Collingwood,"Thomas, Josh",12,7,4,5,0,1,0,1
Collingwood,"Treloar, Adam",35,18,2,17,0,1,0,6
Collingwood,"Varcoe, Travis",11,5,5,6,0,0,0,3
Collingwood,"Wells, Daniel",16,7,7,9,0,0,0,2
Collingwood,"Wills, Rupert",15,7,2,8,0,1,0,5
Collingwood,"de Goey, Jordan",20,12,2,8,4,2,0,3
Collingwood,"Adams, Taylor",34,22,7,12,3,0,0,6
Collingwood,"Blair, Jarryd",12,4,1,8,2,1,0,5
Collingwood,"Crisp, Jack",18,10,3,8,0,1,0,2
Collingwood,"Dunn, Lynden",13,7,4,6,0,0,0,0
Collingwood,"Elliott, Jamie",15,11,5,4,1,1,0,0
Collingwood,"Fasolo, Alex",16,11,5,5,0,0,0,5
Collingwood,"Goldsack, Tyson",16,8,4,8,0,1,0,0
Collingwood,"Greenwood, Levi",12,2,1,10,0,1,0,10
Collingwood,"Grundy, Brodie",21,5,2,16,0,0,40,6
Collingwood,"Hoskin-Elliott, Will",16,12,6,4,1,1,0,1
Collingwood,"Howe, Jeremy",31,18,8,13,0,0,0,2
Collingwood,"Langdon, Tom",21,11,5,10,0,0,0,2
Collingwood,"Maynard, Brayden",20,13,2,7,0,0,0,2
Collingwood,"Moore, Darcy",14,14,8,0,1,2,7,3
Collingwood,"Phillips, Tom",16,4,2,12,0,0,0,3
Collingwood,"Reid, Ben",6,5,1,1,2,1,0,6
Collingwood,"Scharenberg, Matt",24,12,11,12,0,0,0,1
Collingwood,"Sidebottom, Steele",33,21,5,12,0,1,0,3
Collingwood,"Thomas, Josh",13,6,1,7,1,0,0,2
Collingwood,"Treloar, Adam",27,11,2,16,1,0,0,12
Collingwood,"Wells, Daniel",34,17,9,17,3,1,0,3
Collingwood,"de Goey, Jordan",18,9,0,9,0,1,0,6
Collingwood,"Adams, Taylor",30,13,3,17,2,2,0,9
Collingwood,"Blair, Jarryd",16,9,4,7,3,1,0,5
Collingwood,"Crisp, Jack",27,14,10,13,0,0,0,2
Collingwood,"Dunn, Lynden",16,12,8,4,0,0,0,1
Collingwood,"Elliott, Jamie",19,12,7,7,1,2,0,2
Collingwood,"Fasolo, Alex",13,8,4,5,1,1,0,0
Collingwood,"Goldsack, Tyson",10,4,4,6,0,0,0,3
Collingwood,"Greenwood, Levi",9,5,2,4,0,3,0,2
Collingwood,"Grundy, Brodie",18,8,4,10,1,0,31,2
Collingwood,"Hoskin-Elliott, Will",19,10,10,9,0,0,0,5
Collingwood,"Howe, Jeremy",24,15,9,9,1,0,0,0
Collingwood,"Langdon, Tom",29,12,8,17,0,0,0,2
Collingwood,"Maynard, Brayden",27,17,6,10,0,0,0,3
Collingwood,"Moore, Darcy",15,10,8,5,1,3,1,1
Collingwood,"Phillips, Tom",27,18,10,9,1,0,0,2
Collingwood,"Reid, Ben",11,8,7,3,0,2,0,0
Collingwood,"Scharenberg, Matt",27,17,8,10,0,0,0,1
Collingwood,"Sidebottom, Steele",26,14,6,12,0,0,0,2
Collingwood,"Thomas, Josh",18,8,5,10,2,0,0,3
Collingwood,"Treloar, Adam",34,17,3,17,1,0,0,2
Collingwood,"Wells, Daniel",5,3,0,2,1,0,0,1
Collingwood,"de Goey, Jordan",27,14,10,13,1,0,1,2
Collingwood,"Adams, Taylor",31,11,6,20,0,0,0,9
Collingwood,"Aish, James",14,8,1,6,0,0,0,1
Collingwood,"Blair, Jarryd",6,4,0,2,1,0,0,4
Collingwood,"Brown, Callum",11,5,5,6,0,0,0,2
Collingwood,"Cox, Mason",5,4,3,1,0,0,25,1
Collingwood,"Crisp, Jack",27,17,8,10,0,0,0,7
Collingwood,"Dunn, Lynden",11,8,7,3,0,0,0,2
Collingwood,"Elliott, Jamie",13,7,6,6,1,0,0,3
Collingwood,"Fasolo, Alex",10,5,2,5,0,1,0,0
Collingwood,"Goldsack, Tyson",15,8,4,7,0,0,0,3
Collingwood,"Hoskin-Elliott, Will",15,7,11,8,1,0,0,2
Collingwood,"Howe, Jeremy",23,16,9,7,0,0,0,0
Collingwood,"Langdon, Tom",23,9,7,14,0,0,0,3
Collingwood,"Maynard, Brayden",10,6,2,4,0,0,0,3
Collingwood,"Moore, Darcy",9,5,4,4,1,0,9,0
Collingwood,"Phillips, Tom",20,11,5,9,1,0,0,3
Collingwood,"Reid, Ben",12,11,8,1,4,2,1,0
Collingwood,"Scharenberg, Matt",24,16,11,8,0,0,0,1
Collingwood,"Sidebottom, Steele",27,14,5,13,1,0,0,7
Collingwood,"Thomas, Josh",21,10,3,11,0,1,0,3
Collingwood,"Treloar, Adam",31,15,2,16,0,2,0,5
Collingwood,"de Goey, Jordan",9,7,4,2,0,1,0,5
Collingwood,"Adams, Taylor",26,18,6,8,0,0,0,12
Collingwood,"Aish, James",16,10,2,6,0,0,0,7
Collingwood,"Blair, Jarryd",11,2,1,9,1,0,0,3
Collingwood,"Broomhead, Tim",11,6,4,5,2,0,0,2
Collingwood,"Brown, Callum",13,4,3,9,0,0,0,6
Collingwood,"Cox, Mason",9,4,6,5,2,1,43,8
Collingwood,"Crisp, Jack",19,9,3,10,0,0,0,4
Collingwood,"Daicos, Josh",10,4,2,6,0,0,0,10
Collingwood,"Dunn, Lynden",11,10,5,1,0,0,0,3
Collingwood,"Elliott, Jamie",19,12,6,7,0,0,0,2
Collingwood,"Hoskin-Elliott, Will",17,9,4,8,2,0,0,4
Collingwood,"Howe, Jeremy",14,11,8,3,0,0,0,1
Collingwood,"Langdon, Tom",18,10,5,8,0,0,0,2
Collingwood,"Maynard, Brayden",11,6,2,5,0,0,0,6
Collingwood,"Moore, Darcy",17,10,8,7,1,1,6,3
Collingwood,"Phillips, Tom",26,18,7,8,0,0,0,4
Collingwood,"Reid, Ben",9,7,1,2,0,1,0,1
Collingwood,"Scharenberg, Matt",23,15,8,8,0,0,0,2
Collingwood,"Sidebottom, Steele",23,15,3,8,1,0,0,5
Collingwood,"Smith, Josh",15,10,7,5,0,0,0,6
Collingwood,"Thomas, Josh",15,5,4,10,0,1,0,3
Collingwood,"Treloar, Adam",25,10,2,15,0,0,1,9
Collingwood,"Adams, Taylor",28,10,4,18,1,0,0,4
Collingwood,"Aish, James",19,12,5,7,0,0,0,3
Collingwood,"Broomhead, Tim",19,13,6,6,1,0,0,2
Collingwood,"Brown, Callum",19,5,1,14,0,1,0,1
Collingwood,"Cox, Mason",10,6,5,4,2,1,12,1
Collingwood,"Crisp, Jack",18,12,7,6,0,0,0,6
Collingwood,"Daicos, Josh",12,6,2,6,1,1,0,2
Collingwood,"Dunn, Lynden",12,9,3,3,0,0,0,1
Collingwood,"Elliott, Jamie",20,17,10,3,3,1,0,1
Collingwood,"Goldsack, Tyson",10,8,4,2,0,1,0,4
Collingwood,"Grundy, Brodie",20,13,8,7,1,2,12,1
Collingwood,"Hoskin-Elliott, Will",20,18,12,2,2,0,0,3
Collingwood,"Howe, Jeremy",20,12,11,8,0,0,0,0
Collingwood,"Kirby, Kayle",4,3,2,1,0,1,0,5
Collingwood,"Langdon, Tom",17,10,6,7,0,0,0,4
Collingwood,"Maynard, Brayden",23,14,5,9,0,1,0,5
Collingwood,"Moore, Darcy",15,9,10,6,0,0,0,2
Collingwood,"Phillips, Tom",23,18,7,5,2,1,0,4
Collingwood,"Scharenberg, Matt",16,10,3,6,0,0,0,1
Collingwood,"Sidebottom, Steele",23,13,4,10,1,0,0,6
Collingwood,"Thomas, Josh",14,5,1,9,0,0,0,6
Collingwood,"Treloar, Adam",23,8,2,15,0,0,0,8
Essendon,"Ambrose, Patrick",16,5,4,11,0,0,0,2
Essendon,"Baguley, Mark",17,8,8,9,0,0,0,3
Essendon,"Colyer, Travis",15,10,6,5,0,0,0,1
Essendon,"Daniher, Joe",17,12,7,5,3,3,4,1
Essendon,"Fantasia, Orazio",16,8,4,8,4,1,0,1
Essendon,"Gleeson, Martin",15,14,6,1,0,0,0,1
Essendon,"Goddard, Brendon",29,17,10,12,0,1,0,5
Essendon,"Green, Josh",11,8,4,3,0,0,0,1
Essendon,"Hartley, Michael",13,6,4,7,0,0,0,3
Essendon,"Heppell, Dyson",34,18,8,16,3,0,0,7
Essendon,"Hooker, Cale",10,7,2,3,3,1,0,1
Essendon,"Hurley, Michael",21,17,7,4,0,0,0,0
Essendon,"Kelly, James",21,11,8,10,0,0,0,1
Essendon,"Langford, Kyle",11,6,5,5,0,2,0,4
Essendon,"McDonald-Tipungwuti, Anthony",17,10,5,7,0,1,0,3
Essendon,"McGrath, Andrew",22,12,6,10,0,0,0,5
Essendon,"McKernan, Shaun",17,8,5,9,1,0,27,3
Essendon,"Merrett, Zach",37,23,7,14,0,1,0,3
Essendon,"Parish, Darcy",25,17,7,8,0,1,0,6
Essendon,"Stanton, Brent",19,15,10,4,2,0,0,1
Essendon,"Watson, Jobe",27,13,7,14,0,1,0,8
Essendon,"Zaharakis, David",18,11,5,7,1,0,0,5
Essendon,"Ambrose, Patrick",12,8,4,4,0,0,0,3
Essendon,"Baguley, Mark",16,13,9,3,0,0,0,2
Essendon,"Colyer, Travis",27,11,7,16,1,0,0,0
Essendon,"Daniher, Joe",13,7,8,6,3,0,0,0
Essendon,"Fantasia, Orazio",13,8,5,5,5,0,0,4
Essendon,"Gleeson, Martin",13,7,1,6,0,0,0,1
Essendon,"Goddard, Brendon",21,11,8,10,1,0,0,3
Essendon,"Hartley, Michael",9,6,5,3,0,0,0,4
Essendon,"Heppell, Dyson",23,15,7,8,0,2,0,3
Essendon,"Hooker, Cale",12,9,8,3,2,2,2,1
Essendon,"Howlett, Ben",15,6,4,9,0,1,0,2
Essendon,"Hurley, Michael",20,15,6,5,0,0,0,1
Essendon,"Kelly, James",18,12,4,6,0,0,0,3
Essendon,"Langford, Kyle",15,11,7,4,1,1,0,2
Essendon,"McDonald-Tipungwuti, Anthony",16,12,5,4,1,2,0,2
Essendon,"McGrath, Andrew",16,9,5,7,0,0,0,2
Essendon,"McKernan, Shaun",13,6,3,7,0,0,22,3
Essendon,"Merrett, Zach",32,24,9,8,1,0,0,5
Essendon,"Parish, Darcy",17,12,5,5,0,0,0,3
Essendon,"Stanton, Brent",17,11,5,6,0,0,0,2
Essendon,"Watson, Jobe",33,16,8,17,0,0,0,1
Essendon,"Zaharakis, David",20,10,4,10,2,0,0,3
Essendon,"Ambrose, Patrick",13,5,2,8,0,0,0,3
Essendon,"Baguley, Mark",8,5,3,3,0,0,0,7
Essendon,"Brown, Mitch",12,12,5,0,0,0,0,3
Essendon,"Colyer, Travis",16,12,0,4,0,0,0,6
Essendon,"Daniher, Joe",12,5,3,7,1,1,6,0
Essendon,"Fantasia, Orazio",9,7,0,2,0,2,0,3
Essendon,"Gleeson, Martin",14,10,2,4,0,0,0,6
Essendon,"Goddard, Brendon",30,18,4,12,1,0,0,8
Essendon,"Heppell, Dyson",30,19,5,11,0,1,0,8
Essendon,"Hocking, Heath",10,7,1,3,0,0,0,3
Essendon,"Hooker, Cale",10,4,2,6,1,0,0,1
Essendon,"Hurley, Michael",19,13,3,6,0,0,0,1
Essendon,"Kelly, James",20,18,3,2,0,0,0,4
Essendon,"Langford, Kyle",6,2,1,4,1,0,0,2
Essendon,"Leuenberger, Matthew",13,7,2,6,0,0,46,6
Essendon,"McDonald-Tipungwuti, Anthony",8,3,0,5,1,1,0,3
Essendon,"McGrath, Andrew",12,6,1,6,0,0,0,7
Essendon,"Merrett, Zach",29,21,1,8,0,0,0,4
Essendon,"Parish, Darcy",22,9,3,13,1,0,0,4
Essendon,"Stanton, Brent",15,10,5,5,0,0,0,5
Essendon,"Watson, Jobe",28,16,3,12,0,0,0,10
Essendon,"Zaharakis, David",13,7,3,6,0,0,0,5
Essendon,"Ambrose, Patrick",10,4,4,6,0,0,0,0
Essendon,"Baguley, Mark",15,12,6,3,0,0,0,1
Essendon,"Brown, Mitch",29,13,5,16,0,0,0,1
Essendon,"Colyer, Travis",24,15,7,9,3,1,0,5
Essendon,"Daniher, Joe",19,11,10,8,2,2,7,0
Essendon,"Fantasia, Orazio",18,7,1,11,1,1,0,4
Essendon,"Goddard, Brendon",34,15,6,19,0,0,0,2
Essendon,"Green, Josh",12,8,2,4,0,2,0,2
Essendon,"Heppell, Dyson",22,11,2,11,0,0,0,1
Essendon,"Hooker, Cale",8,4,6,4,0,0,0,3
Essendon,"Hurley, Michael",23,15,8,8,0,0,0,0
Essendon,"Kelly, James",25,9,4,16,0,0,0,2
Essendon,"Langford, Kyle",15,8,5,7,2,0,0,3
Essendon,"Leuenberger, Matthew",14,7,1,7,0,0,38,1
Essendon,"McDonald-Tipungwuti, Anthony",16,8,5,8,4,0,0,2
Essendon,"McGrath, Andrew",28,8,4,20,0,0,0,4
Essendon,"McKenna, Conor",18,10,5,8,0,0,0,3
Essendon,"Merrett, Zach",35,19,5,16,0,0,0,7
Essendon,"Parish, Darcy",24,11,4,13,0,0,0,1
Essendon,"Stanton, Brent",22,13,8,9,0,0,0,1
Essendon,"Watson, Jobe",16,6,3,10,0,0,0,2
Essendon,"Zaharakis, David",30,15,8,15,1,0,0,3
Essendon,"Ambrose, Patrick",8,5,3,3,0,0,0,3
Essendon,"Baguley, Mark",18,10,6,8,0,0,0,0
Essendon,"Brown, Mitch",18,10,4,8,0,0,0,1
Essendon,"Colyer, Travis",13,9,6,4,0,1,0,2
Essendon,"Daniher, Joe",16,14,8,2,3,4,3,2
Essendon,"Fantasia, Orazio",18,12,6,6,4,1,0,2
Essendon,"Francis, Aaron",9,4,3,5,1,0,0,0
Essendon,"Goddard, Brendon",22,10,6,12,0,0,0,5
Essendon,"Green, Josh",10,8,1,2,3,0,0,5
Essendon,"Heppell, Dyson",26,11,2,15,1,0,0,5
Essendon,"Hooker, Cale",15,11,7,4,3,0,0,1
Essendon,"Hurley, Michael",25,19,5,6,0,0,0,2
Essendon,"Kelly, James",24,12,4,12,0,0,0,2
Essendon,"Leuenberger, Matthew",11,2,2,9,0,0,32,6
Essendon,"McDonald-Tipungwuti, Anthony",14,11,1,3,0,1,0,7
Essendon,"McGrath, Andrew",19,7,1,12,0,0,0,3
Essendon,"McNiece, Ben",11,4,2,7,0,0,0,3
Essendon,"Merrett, Zach",33,20,10,13,0,1,0,5
Essendon,"Parish, Darcy",25,10,2,15,0,0,0,3
Essendon,"Stanton, Brent",11,7,3,4,0,0,0,2
Essendon,"Watson, Jobe",28,14,3,14,0,0,0,4
Essendon,"Zaharakis, David",17,12,6,5,0,0,0,2
Essendon,"Baguley, Mark",14,12,9,2,0,0,0,0
Essendon,"Bellchambers, Tom",9,7,7,2,1,0,33,2
Essendon,"Brown, Mitch",10,5,6,5,0,0,0,0
Essendon,"Colyer, Travis",20,14,9,6,1,1,0,1
Essendon,"Daniher, Joe",17,12,13,5,1,6,9,2
Essendon,"Dea, Matt",17,11,7,6,0,0,0,3
Essendon,"Fantasia, Orazio",9,5,4,4,2,0,0,1
Essendon,"Gleeson, Martin",18,14,6,4,0,0,0,1
Essendon,"Goddard, Brendon",31,17,5,14,0,0,0,3
Essendon,"Green, Josh",13,7,3,6,0,0,0,2
Essendon,"Heppell, Dyson",22,15,8,7,0,0,0,3
Essendon,"Hooker, Cale",11,4,5,7,2,1,3,4
Essendon,"Howlett, Ben",14,9,4,5,0,1,0,3
Essendon,"Hurley, Michael",23,19,13,4,0,0,0,1
Essendon,"McDonald-Tipungwuti, Anthony",13,8,4,5,1,2,0,5
Essendon,"McGrath, Andrew",23,16,6,7,1,0,0,3
Essendon,"McKenna, Conor",21,14,9,7,0,0,0,1
Essendon,"McNiece, Ben",14,6,2,8,0,0,0,2
Essendon,"Merrett, Zach",32,23,3,9,0,0,0,3
Essendon,"Parish, Darcy",11,5,2,6,1,0,0,2
Essendon,"Watson, Jobe",13,8,4,5,0,0,0,1
Essendon,"Zaharakis, David",17,17,9,0,0,1,0,3
Essendon,"Baguley, Mark",11,5,3,6,0,0,0,3
Essendon,"Colyer, Travis",15,7,1,8,0,1,0,2
Essendon,"Daniher, Joe",20,8,7,12,3,0,2,0
Essendon,"Dea, Matt",8,5,1,3,0,0,0,1
Essendon,"Fantasia, Orazio",13,6,5,7,0,2,0,3
Essendon,"Francis, Aaron",13,6,4,7,0,3,0,3
Essendon,"Gleeson, Martin",9,6,2,3,1,0,0,1
Essendon,"Goddard, Brendon",25,10,6,15,0,0,0,5
Essendon,"Green, Josh",10,9,3,1,1,2,0,4
Essendon,"Hartley, Michael",9,3,5,6,0,0,0,2
Essendon,"Heppell, Dyson",23,11,6,12,1,0,0,5
Essendon,"Hooker, Cale",19,13,10,6,2,2,0,1
Essendon,"Hurley, Michael",24,17,9,7,1,0,0,1
Essendon,"Kelly, James",13,5,2,8,0,0,0,4
Essendon,"Leuenberger, Matthew",11,3,0,8,0,0,16,7
Essendon,"McDonald-Tipungwuti, Anthony",9,7,4,2,1,1,0,4
Essendon,"McKenna, Conor",8,6,5,2,0,0,0,4
Essendon,"Merrett, Zach",28,20,6,8,1,0,0,7
Essendon,"Myers, David",13,9,4,4,0,0,0,0
Essendon,"Parish, Darcy",18,7,3,11,0,0,0,3
Essendon,"Stanton, Brent",17,9,3,8,0,1,0,2
Essendon,"Zaharakis, David",14,9,3,5,0,0,0,4
Essendon,"Baguley, Mark",5,3,2,2,0,0,0,2
Essendon,"Colyer, Travis",11,4,1,7,0,0,0,3
Essendon,"Daniher, Joe",16,13,6,3,5,2,7,1
Essendon,"Dea, Matt",17,9,5,8,0,0,0,1
Essendon,"Fantasia, Orazio",18,13,5,5,3,0,0,2
Essendon,"Goddard, Brendon",29,15,6,14,0,0,0,6
Essendon,"Green, Josh",9,7,2,2,2,0,0,3
Essendon,"Hartley, Michael",6,4,3,2,0,0,0,5
Essendon,"Heppell, Dyson",30,9,4,21,0,0,0,5
Essendon,"Hooker, Cale",12,6,6,6,1,0,0,4
Essendon,"Hurley, Michael",27,17,8,10,0,0,0,1
Essendon,"Kelly, James",23,16,10,7,0,0,0,3
Essendon,"Leuenberger, Matthew",10,2,1,8,0,0,32,3
Essendon,"McDonald-Tipungwuti, Anthony",17,9,3,8,3,1,0,4
Essendon,"McGrath, Andrew",12,8,3,4,0,1,0,3
Essendon,"McKenna, Conor",13,8,3,5,0,0,0,1
Essendon,"Merrett, Zach",33,19,5,14,0,0,0,12
Essendon,"Myers, David",18,9,5,9,0,0,0,1
Essendon,"Parish, Darcy",23,12,5,11,0,2,0,6
Essendon,"Stewart, James",10,8,3,2,3,0,0,4
Essendon,"Watson, Jobe",21,11,8,10,0,0,0,6
Essendon,"Zaharakis, David",31,16,7,15,0,0,0,5
Essendon,"Baguley, Mark",26,18,14,8,0,0,0,2
Essendon,"Colyer, Travis",20,16,7,4,1,1,0,6
Essendon,"Daniher, Joe",18,13,3,5,5,0,5,2
Essendon,"Dea, Matt",15,9,7,6,1,0,0,3
Essendon,"Fantasia, Orazio",12,10,3,2,3,2,0,2
Essendon,"Goddard, Brendon",28,14,10,14,0,0,0,4
Essendon,"Green, Josh",10,9,2,1,2,2,0,5
Essendon,"Hartley, Michael",21,13,13,8,0,0,0,3
Essendon,"Heppell, Dyson",25,13,6,12,0,0,0,2
Essendon,"Hooker, Cale",18,8,8,10,2,3,0,0
Essendon,"Hurley, Michael",26,17,9,9,0,0,0,1
Essendon,"Kelly, James",23,13,10,10,0,0,0,5
Essendon,"Leuenberger, Matthew",11,6,3,5,1,0,39,6
Essendon,"McDonald-Tipungwuti, Anthony",18,9,5,9,2,1,0,2
Essendon,"McGrath, Andrew",21,13,5,8,0,0,0,1
Essendon,"McKenna, Conor",17,12,4,5,0,0,0,2
Essendon,"Merrett, Zach",37,21,8,16,0,0,0,1
Essendon,"Myers, David",20,11,8,9,0,0,0,2
Essendon,"Parish, Darcy",17,9,8,8,1,0,0,1
Essendon,"Stewart, James",9,5,2,4,1,0,0,6
Essendon,"Watson, Jobe",30,11,9,19,0,1,0,5
Essendon,"Zaharakis, David",31,22,8,9,0,1,0,7
Essendon,"Baguley, Mark",18,8,9,10,0,0,0,3
Essendon,"Bellchambers, Tom",9,3,2,6,0,0,40,4
Essendon,"Colyer, Travis",17,10,4,7,0,0,0,3
Essendon,"Daniher, Joe",17,9,6,8,3,0,2,1
Essendon,"Dea, Matt",13,10,5,3,0,0,0,2
Essendon,"Fantasia, Orazio",14,7,3,7,1,0,0,3
Essendon,"Goddard, Brendon",28,10,4,18,2,0,0,3
Essendon,"Green, Josh",7,3,0,4,1,0,0,4
Essendon,"Hartley, Michael",13,6,4,7,0,0,0,4
Essendon,"Heppell, Dyson",27,18,7,9,1,0,0,6
Essendon,"Hooker, Cale",11,5,4,6,0,1,2,2
Essendon,"Hurley, Michael",27,18,5,9,0,0,0,2
Essendon,"Kelly, James",19,9,4,10,0,0,0,5
Essendon,"McDonald-Tipungwuti, Anthony",10,5,1,5,0,2,0,3
Essendon,"McGrath, Andrew",26,12,4,14,0,0,0,2
Essendon,"McKenna, Conor",18,5,1,13,0,0,0,0
Essendon,"Merrett, Zach",25,15,2,10,0,2,0,7
Essendon,"Myers, David",15,7,1,8,0,0,0,4
Essendon,"Parish, Darcy",24,7,5,17,0,0,0,4
Essendon,"Stewart, James",14,9,2,5,1,0,3,2
Essendon,"Watson, Jobe",28,8,4,20,0,0,0,2
Essendon,"Zaharakis, David",35,19,5,16,1,0,0,6
Essendon,"Baguley, Mark",16,10,4,6,0,0,0,1
Essendon,"Bellchambers, Tom",15,9,5,6,2,0,40,3
Essendon,"Colyer, Travis",12,7,3,5,1,0,0,5
Essendon,"Daniher, Joe",13,11,7,2,1,0,3,2
Essendon,"Fantasia, Orazio",14,9,5,5,2,0,0,4
Essendon,"Gleeson, Martin",23,12,7,11,0,0,0,0
Essendon,"Goddard, Brendon",21,7,4,14,0,0,0,1
Essendon,"Green, Josh",9,8,4,1,3,2,0,0
Essendon,"Hartley, Michael",10,7,4,3,0,0,0,1
Essendon,"Heppell, Dyson",23,14,4,9,0,1,0,1
Essendon,"Hooker, Cale",13,8,8,5,2,1,0,0
Essendon,"Howlett, Ben",13,3,1,10,0,0,0,4
Essendon,"Hurley, Michael",21,12,9,9,0,0,0,1
Essendon,"McDonald-Tipungwuti, Anthony",9,4,5,5,2,0,0,0
Essendon,"McGrath, Andrew",15,7,5,8,0,0,0,4
Essendon,"McKenna, Conor",18,8,2,10,1,0,0,3
Essendon,"Merrett, Zach",29,16,3,13,0,0,0,5
Essendon,"Myers, David",17,8,0,9,1,0,0,1
Essendon,"Stanton, Brent",12,10,4,2,0,0,0,7
Essendon,"Stewart, James",9,7,5,2,0,2,0,1
Essendon,"Watson, Jobe",28,12,8,16,0,1,0,7
Essendon,"Zaharakis, David",21,10,4,11,0,1,0,1
Essendon,"Baguley, Mark",8,4,1,4,0,0,0,2
Essendon,"Bellchambers, Tom",16,7,3,9,0,0,23,5
Essendon,"Colyer, Travis",22,9,2,13,0,1,0,2
Essendon,"Daniher, Joe",16,13,9,3,4,0,0,1
Essendon,"Fantasia, Orazio",16,6,4,10,0,0,0,1
Essendon,"Gleeson, Martin",11,7,4,4,0,0,0,3
Essendon,"Goddard, Brendon",31,12,3,19,1,0,0,1
Essendon,"Green, Josh",11,8,2,3,0,3,0,3
Essendon,"Hartley, Michael",14,10,8,4,0,0,0,5
Essendon,"Heppell, Dyson",34,17,7,17,1,0,0,4
Essendon,"Hooker, Cale",17,11,9,6,5,3,0,2
Essendon,"Howlett, Ben",16,9,2,7,0,0,0,2
Essendon,"Hurley, Michael",25,14,6,11,0,0,0,1
Essendon,"Kelly, James",20,13,6,7,0,0,0,3
Essendon,"McDonald-Tipungwuti, Anthony",19,14,4,5,4,1,0,6
Essendon,"McGrath, Andrew",21,9,6,12,0,0,0,1
Essendon,"McKenna, Conor",22,19,6,3,0,1,0,3
Essendon,"Merrett, Zach",38,20,6,18,1,1,0,7
Essendon,"Myers, David",14,4,1,10,0,0,0,1
Essendon,"Stewart, James",21,10,6,11,2,1,0,2
Essendon,"Watson, Jobe",30,11,7,19,1,1,0,4
Essendon,"Zaharakis, David",26,10,2,16,0,1,0,11
Essendon,"Baguley, Mark",14,8,4,6,0,0,0,3
Essendon,"Bellchambers, Tom",9,6,4,3,1,0,25,1
Essendon,"Colyer, Travis",18,8,2,10,1,1,0,3
Essendon,"Daniher, Joe",16,12,7,4,1,2,0,2
Essendon,"Fantasia, Orazio",16,11,6,5,1,4,0,2
Essendon,"Gleeson, Martin",16,7,9,9,0,0,0,1
Essendon,"Goddard, Brendon",23,9,6,14,0,0,0,4
Essendon,"Green, Josh",13,10,3,3,0,3,0,4
Essendon,"Hartley, Michael",4,2,2,2,0,0,0,4
Essendon,"Heppell, Dyson",18,8,3,10,0,0,0,2
Essendon,"Howlett, Ben",16,5,1,11,0,0,0,6
Essendon,"Hurley, Michael",30,21,8,9,1,0,0,0
Essendon,"Kelly, James",15,9,5,6,0,0,0,2
Essendon,"Langford, Kyle",16,8,5,8,0,1,0,1
Essendon,"McDonald-Tipungwuti, Anthony",13,5,2,8,1,1,0,3
Essendon,"McGrath, Andrew",13,6,2,7,0,0,0,0
Essendon,"McKenna, Conor",15,11,2,4,1,0,0,1
Essendon,"McKernan, Shaun",7,4,4,3,2,0,2,1
Essendon,"Merrett, Zach",33,16,4,17,0,0,0,6
Essendon,"Stewart, James",9,5,3,4,2,0,0,1
Essendon,"Watson, Jobe",18,11,7,7,0,0,0,6
Essendon,"Zaharakis, David",28,16,6,12,1,0,0,2
Essendon,"Baguley, Mark",14,3,3,11,0,0,0,2
Essendon,"Bellchambers, Tom",9,6,3,3,0,0,26,0
Essendon,"Colyer, Travis",13,2,1,11,0,0,0,2
Essendon,"Daniher, Joe",11,9,4,2,3,4,1,2
Essendon,"Fantasia, Orazio",17,11,2,6,1,2,0,1
Essendon,"Gleeson, Martin",18,12,9,6,0,0,0,3
Essendon,"Goddard, Brendon",31,12,6,19,0,1,0,2
Essendon,"Green, Josh",9,6,3,3,1,1,0,2
Essendon,"Hartley, Michael",10,1,1,9,0,0,0,2
Essendon,"Heppell, Dyson",24,13,2,11,0,1,0,4
Essendon,"Hooker, Cale",15,9,9,6,2,0,0,2
Essendon,"Hurley, Michael",31,18,3,13,0,1,0,1
Essendon,"Kelly, James",14,4,0,10,0,0,0,3
Essendon,"Langford, Kyle",19,12,3,7,0,0,0,7
Essendon,"McDonald-Tipungwuti, Anthony",6,6,1,0,2,0,0,7
Essendon,"McGrath, Andrew",25,4,3,21,0,0,0,4
Essendon,"McKenna, Conor",22,9,0,13,0,0,0,0
Essendon,"Merrett, Zach",19,8,2,11,0,0,0,7
Essendon,"Parish, Darcy",21,7,3,14,1,0,0,2
Essendon,"Stewart, James",10,3,2,7,1,1,0,6
Essendon,"Watson, Jobe",27,10,8,17,0,1,0,9
Essendon,"Zaharakis, David",17,12,4,5,0,2,0,3
Essendon,"Baguley, Mark",14,9,7,5,0,0,0,3
Essendon,"Bellchambers, Tom",8,6,2,2,2,1,29,4
Essendon,"Colyer, Travis",18,11,7,7,1,0,0,0
Essendon,"Daniher, Joe",18,11,9,7,3,2,0,2
Essendon,"Fantasia, Orazio",11,10,2,1,5,1,0,5
Essendon,"Gleeson, Martin",17,8,7,9,0,0,0,0
Essendon,"Goddard, Brendon",23,14,14,9,0,0,0,1
Essendon,"Green, Josh",11,3,4,8,0,0,0,1
Essendon,"Hartley, Michael",10,4,2,6,0,0,0,2
Essendon,"Heppell, Dyson",32,10,4,22,0,0,0,3
Essendon,"Hooker, Cale",7,3,3,4,1,0,0,1
Essendon,"Hurley, Michael",30,19,11,11,0,0,0,3
Essendon,"Kelly, James",32,11,6,21,0,0,0,7
Essendon,"McDonald-Tipungwuti, Anthony",14,8,6,6,1,0,0,2
Essendon,"McGrath, Andrew",21,8,3,13,0,0,0,3
Essendon,"McKenna, Conor",13,9,3,4,0,0,0,1
Essendon,"Merrett, Zach",25,16,1,9,2,0,0,6
Essendon,"Myers, David",31,17,2,14,0,2,0,4
Essendon,"Parish, Darcy",28,18,10,10,0,1,0,3
Essendon,"Stewart, James",14,6,5,8,2,0,0,2
Essendon,"Watson, Jobe",23,8,3,15,0,0,0,3
Essendon,"Zaharakis, David",38,18,2,20,1,1,0,3
Essendon,"Baguley, Mark",17,10,9,7,0,0,0,2
Essendon,"Bellchambers, Tom",14,8,4,6,2,0,26,5
Essendon,"Bird, Craig",18,7,2,11,0,0,0,4
Essendon,"Colyer, Travis",20,12,5,8,1,2,0,4
Essendon,"Daniher, Joe",14,12,9,2,4,0,5,2
Essendon,"Fantasia, Orazio",12,6,3,6,0,3,0,2
Essendon,"Gleeson, Martin",19,16,10,3,0,0,0,3
Essendon,"Goddard, Brendon",25,18,10,7,0,0,0,1
Essendon,"Green, Josh",12,5,0,7,2,0,0,3
Essendon,"Hartley, Michael",18,16,9,2,0,0,0,1
Essendon,"Heppell, Dyson",26,14,7,12,0,1,0,1
Essendon,"Hooker, Cale",14,7,8,7,1,1,1,3
Essendon,"Hurley, Michael",27,16,9,11,1,0,0,2
Essendon,"Kelly, James",28,17,13,11,0,0,0,7
Essendon,"McDonald-Tipungwuti, Anthony",12,8,7,4,2,1,0,5
Essendon,"McGrath, Andrew",23,6,5,17,0,0,0,2
Essendon,"McKenna, Conor",20,18,8,2,1,0,0,0
Essendon,"Merrett, Zach",37,18,5,19,0,0,0,10
Essendon,"Myers, David",20,8,3,12,1,1,0,3
Essendon,"Parish, Darcy",13,7,2,6,0,1,0,2
Essendon,"Stewart, James",21,12,7,9,0,4,0,1
Essendon,"Zaharakis, David",32,15,3,17,2,0,0,5
Essendon,"Baguley, Mark",10,4,1,6,0,0,0,6
Essendon,"Bellchambers, Tom",10,7,3,3,0,1,34,2
Essendon,"Colyer, Travis",14,6,0,8,0,0,0,3
Essendon,"Daniher, Joe",13,10,3,3,2,1,9,3
Essendon,"Fantasia, Orazio",12,8,4,4,4,1,0,4
Essendon,"Gleeson, Martin",15,11,5,4,0,0,0,2
Essendon,"Goddard, Brendon",25,12,7,13,0,1,0,2
Essendon,"Hartley, Michael",14,10,7,4,0,0,0,3
Essendon,"Heppell, Dyson",26,15,2,11,2,0,0,5
Essendon,"Hooker, Cale",18,13,9,5,5,2,1,1
Essendon,"Hurley, Michael",21,14,4,7,0,0,0,0
Essendon,"Kelly, James",12,1,1,11,0,0,0,5
Essendon,"Laverde, Jayden",11,3,3,8,0,1,0,2
Essendon,"McDonald-Tipungwuti, Anthony",11,7,2,4,3,0,0,2
Essendon,"McGrath, Andrew",12,6,2,6,0,0,0,5
Essendon,"McKenna, Conor",10,7,1,3,0,0,0,1
Essendon,"Merrett, Zach",33,11,2,22,0,0,0,3
Essendon,"Myers, David",21,6,1,15,0,0,0,2
Essendon,"Parish, Darcy",23,11,0,12,1,0,0,2
Essendon,"Stewart, James",9,6,4,3,2,2,0,2
Essendon,"Watson, Jobe",27,7,2,20,0,0,0,4
Essendon,"Zaharakis, David",27,16,2,11,1,2,0,4
Essendon,"Baguley, Mark",16,10,8,6,0,0,0,4
Essendon,"Bellchambers, Tom",5,3,3,2,0,0,37,1
Essendon,"Colyer, Travis",15,8,3,7,1,1,0,3
Essendon,"Daniher, Joe",18,15,11,3,6,4,3,1
Essendon,"Fantasia, Orazio",18,9,6,9,2,1,0,4
Essendon,"Gleeson, Martin",10,6,3,4,0,0,0,0
Essendon,"Goddard, Brendon",25,13,7,12,0,0,0,5
Essendon,"Hartley, Michael",10,5,3,5,0,0,0,0
Essendon,"Heppell, Dyson",29,12,4,17,0,1,0,5
Essendon,"Hooker, Cale",13,5,7,8,1,2,0,1
Essendon,"Hurley, Michael",30,21,13,9,0,0,0,0
Essendon,"Kelly, James",15,8,7,7,0,0,0,2
Essendon,"Laverde, Jayden",7,1,1,6,0,1,0,2
Essendon,"McDonald-Tipungwuti, Anthony",13,9,4,4,1,0,0,3
Essendon,"McGrath, Andrew",13,2,1,11,0,0,0,2
Essendon,"McKenna, Conor",19,11,2,8,0,0,0,4
Essendon,"Merrett, Zach",23,12,3,11,0,1,0,4
Essendon,"Myers, David",19,7,0,12,0,0,0,3
Essendon,"Parish, Darcy",29,13,5,16,1,1,0,2
Essendon,"Stewart, James",18,11,8,7,0,0,0,1
Essendon,"Watson, Jobe",20,6,5,14,0,0,0,4
Essendon,"Zaharakis, David",32,15,5,17,1,1,0,4
Essendon,"Ambrose, Patrick",9,4,2,5,0,0,0,1
Essendon,"Baguley, Mark",12,5,3,7,0,0,0,3
Essendon,"Bellchambers, Tom",8,1,2,7,0,0,31,3
Essendon,"Colyer, Travis",14,9,2,5,0,1,0,1
Essendon,"Daniher, Joe",15,10,4,5,3,2,2,2
Essendon,"Fantasia, Orazio",2,1,1,1,0,0,0,0
Essendon,"Gleeson, Martin",15,8,5,7,0,0,0,1
Essendon,"Goddard, Brendon",23,16,4,7,0,0,0,1
Essendon,"Green, Josh",17,11,2,6,1,4,0,3
Essendon,"Hartley, Michael",10,4,4,6,0,0,0,0
Essendon,"Heppell, Dyson",34,14,10,20,1,0,0,6
Essendon,"Hooker, Cale",15,12,9,3,2,5,0,2
Essendon,"Howlett, Ben",12,4,2,8,1,0,0,6
Essendon,"Hurley, Michael",23,17,7,6,0,0,0,2
Essendon,"McDonald-Tipungwuti, Anthony",16,10,4,6,3,1,0,5
Essendon,"McKenna, Conor",16,12,2,4,0,0,0,1
Essendon,"Merrett, Zach",26,15,2,11,0,1,0,5
Essendon,"Myers, David",22,10,3,12,0,0,0,6
Essendon,"Parish, Darcy",24,9,4,15,0,0,0,4
Essendon,"Stewart, James",10,4,2,6,0,1,0,1
Essendon,"Watson, Jobe",11,2,1,9,0,1,0,2
Essendon,"Zaharakis, David",33,12,3,21,0,1,0,2
Essendon,"Ambrose, Patrick",16,6,5,10,0,0,0,0
Essendon,"Colyer, Travis",7,3,1,4,1,0,0,3
Essendon,"Daniher, Joe",14,12,4,2,3,1,4,1
Essendon,"Dea, Matt",18,11,5,7,0,0,0,4
Essendon,"Gleeson, Martin",19,13,8,6,0,0,0,2
Essendon,"Goddard, Brendon",27,14,7,13,0,0,0,5
Essendon,"Green, Josh",10,4,1,6,0,0,0,6
Essendon,"Heppell, Dyson",20,11,3,9,0,0,0,5
Essendon,"Hooker, Cale",13,8,10,5,4,0,0,1
Essendon,"Howlett, Ben",9,4,4,5,0,0,0,7
Essendon,"Hurley, Michael",34,20,8,14,0,0,0,1
Essendon,"Kelly, James",21,13,9,8,0,0,0,1
Essendon,"Laverde, Jayden",14,6,3,8,0,0,0,1
Essendon,"Leuenberger, Matthew",11,4,4,7,0,0,29,3
Essendon,"McDonald-Tipungwuti, Anthony",8,4,2,4,0,1,0,3
Essendon,"McGrath, Andrew",25,14,8,11,0,0,0,0
Essendon,"McKenna, Conor",20,15,4,5,1,0,0,1
Essendon,"Myers, David",18,8,1,10,0,1,0,3
Essendon,"Parish, Darcy",19,9,1,10,0,0,0,3
Essendon,"Stewart, James",12,8,6,4,2,3,0,2
Essendon,"Watson, Jobe",16,6,2,10,1,0,0,1
Essendon,"Zaharakis, David",26,14,3,12,0,1,0,8
Essendon,"Ambrose, Patrick",13,7,4,6,0,0,0,3
Essendon,"Baguley, Mark",25,14,9,11,0,0,0,1
Essendon,"Begley, Josh",13,10,7,3,2,1,0,2
Essendon,"Bellchambers, Tom",20,16,6,4,0,2,34,2
Essendon,"Bird, Craig",23,12,2,11,0,0,0,4
Essendon,"Daniher, Joe",10,6,4,4,1,0,3,1
Essendon,"Gleeson, Martin",16,12,6,4,0,0,0,4
Essendon,"Goddard, Brendon",25,13,14,12,0,0,0,2
Essendon,"Green, Josh",12,9,1,3,1,2,0,4
Essendon,"Hartley, Michael",18,12,6,6,0,0,0,4
Essendon,"Heppell, Dyson",24,15,8,9,1,0,0,4
Essendon,"Hooker, Cale",19,8,9,11,2,2,0,2
Essendon,"Kelly, James",22,11,9,11,0,0,0,5
Essendon,"Laverde, Jayden",16,10,5,6,0,3,0,6
Essendon,"McDonald-Tipungwuti, Anthony",15,8,5,7,1,0,0,4
Essendon,"McGrath, Andrew",25,13,6,12,0,0,0,2
Essendon,"McKenna, Conor",14,7,3,7,1,0,0,0
Essendon,"Merrett, Zach",23,12,3,11,0,0,0,5
Essendon,"Myers, David",17,11,6,6,0,1,0,5
Essendon,"Parish, Darcy",21,8,4,13,1,0,0,2
Essendon,"Stewart, James",9,6,5,3,2,1,1,1
Essendon,"Zaharakis, David",38,23,5,15,0,0,0,4
Essendon,"Ambrose, Patrick",15,11,8,4,0,0,0,2
Essendon,"Baguley, Mark",25,17,9,8,0,0,0,4
Essendon,"Begley, Josh",6,5,5,1,1,1,0,1
Essendon,"Bellchambers, Tom",16,6,10,10,1,0,38,1
Essendon,"Colyer, Travis",17,11,6,6,0,0,0,2
Essendon,"Daniher, Joe",12,10,5,2,2,3,2,2
Essendon,"Gleeson, Martin",23,17,9,6,0,0,0,1
Essendon,"Goddard, Brendon",32,21,15,11,0,0,0,1
Essendon,"Hartley, Michael",12,7,4,5,0,0,0,1
Essendon,"Heppell, Dyson",30,16,7,14,0,1,0,5
Essendon,"Hocking, Heath",9,6,4,3,2,0,0,1
Essendon,"Kelly, James",23,10,6,13,0,0,0,5
Essendon,"Laverde, Jayden",8,6,4,2,1,0,0,3
Essendon,"McDonald-Tipungwuti, Anthony",15,9,2,6,1,0,0,4
Essendon,"McGrath, Andrew",21,6,3,15,0,0,0,0
Essendon,"McKenna, Conor",21,14,3,7,0,0,0,2
Essendon,"Merrett, Zach",31,21,6,10,4,1,0,4
Essendon,"Myers, David",19,8,4,11,0,1,0,2
Essendon,"Parish, Darcy",16,7,3,9,0,0,0,7
Essendon,"Stewart, James",13,9,4,4,4,0,0,0
Essendon,"Watson, Jobe",26,11,2,15,0,1,0,3
Essendon,"Zaharakis, David",25,14,6,11,0,0,0,6
Essendon,"Ambrose, Patrick",10,5,4,5,0,0,0,1
Essendon,"Baguley, Mark",14,8,7,6,0,0,0,2
Essendon,"Begley, Josh",8,4,3,4,2,0,0,3
Essendon,"Bellchambers, Tom",3,1,1,2,0,0,44,5
Essendon,"Colyer, Travis",20,14,6,6,0,2,0,6
Essendon,"Daniher, Joe",17,14,6,3,3,2,1,1
Essendon,"Fantasia, Orazio",17,7,5,10,1,1,0,5
Essendon,"Gleeson, Martin",25,16,7,9,0,0,0,2
Essendon,"Goddard, Brendon",25,11,6,14,0,0,0,3
Essendon,"Hartley, Michael",11,6,3,5,0,0,0,1
Essendon,"Heppell, Dyson",24,15,2,9,1,0,0,6
Essendon,"Hurley, Michael",30,16,10,14,0,0,0,1
Essendon,"Kelly, James",17,7,4,10,0,0,0,5
Essendon,"McDonald-Tipungwuti, Anthony",11,5,1,6,0,0,0,5
Essendon,"McGrath, Andrew",22,9,4,13,0,0,0,6
Essendon,"McKenna, Conor",17,12,6,5,0,0,0,1
Essendon,"Merrett, Zach",21,12,2,9,0,0,0,6
Essendon,"Myers, David",12,6,2,6,1,0,0,2
Essendon,"Parish, Darcy",21,7,3,14,0,0,0,5
Essendon,"Stewart, James",8,5,5,3,0,1,1,2
Essendon,"Watson, Jobe",20,7,3,13,0,0,0,3
Essendon,"Zaharakis, David",21,10,4,11,0,2,0,11
Fremantle,"Blakely, Connor",23,9,5,14,1,1,0,3
Fremantle,"Dawson, Zac",5,2,0,3,0,0,0,3
Fremantle,"Fyfe, Nat",28,12,6,16,1,0,0,5
Fremantle,"Griffin, Jonathon",10,6,5,4,0,2,15,6
Fremantle,"Hamling, Joel",8,4,4,4,0,0,0,1
Fremantle,"Hill, Bradley",17,11,4,6,1,0,0,0
Fremantle,"Hill, Stephen",25,19,4,6,1,0,0,4
Fremantle,"Ibbotson, Garrick",20,10,5,10,0,0,0,0
Fremantle,"Johnson, Michael",14,7,4,7,0,0,0,2
Fremantle,"Kersten, Shane",7,5,3,2,0,0,0,1
Fremantle,"Langdon, Ed",20,14,5,6,1,1,0,2
Fremantle,"McCarthy, Cam",12,9,2,3,1,5,0,1
Fremantle,"Mundy, David",31,17,2,14,0,2,0,0
Fremantle,"Neale, Lachie",23,7,5,16,1,0,0,5
Fremantle,"Pearce, Danyle",21,9,4,12,1,0,0,2
Fremantle,"Sandilands, Aaron",15,4,1,11,0,0,48,0
Fremantle,"Spurr, Lee",26,14,9,12,0,0,0,4
Fremantle,"Suban, Nick",10,7,4,3,1,0,0,4
Fremantle,"Sutcliffe, Cam",21,15,6,6,0,0,0,0
Fremantle,"Tucker, Darcy",15,5,3,10,0,0,0,0
Fremantle,"Walters, Michael",8,5,2,3,1,0,0,1
Fremantle,"Weller, Lachie",23,15,5,8,0,0,0,1
Fremantle,"Blakely, Connor",5,3,1,2,0,0,0,1
Fremantle,"Dawson, Zac",3,1,2,2,0,0,0,2
Fremantle,"Fyfe, Nat",30,16,5,14,1,2,0,4
Fremantle,"Griffin, Jonathon",8,6,3,2,1,0,12,4
Fremantle,"Hamling, Joel",10,3,5,7,0,0,0,1
Fremantle,"Hill, Bradley",31,18,7,13,1,0,0,1
Fremantle,"Hill, Stephen",24,11,2,13,0,1,0,3
Fremantle,"Ibbotson, Garrick",13,7,3,6,0,0,0,1
Fremantle,"Johnson, Michael",15,5,6,10,0,0,0,0
Fremantle,"Kersten, Shane",11,7,5,4,1,1,0,2
Fremantle,"Langdon, Ed",15,7,5,8,0,0,0,2
Fremantle,"McCarthy, Cam",10,7,2,3,0,1,0,2
Fremantle,"Mundy, David",15,6,5,9,1,0,0,9
Fremantle,"Neale, Lachie",34,15,2,19,1,0,0,2
Fremantle,"Pearce, Danyle",18,13,3,5,1,0,0,2
Fremantle,"Sandilands, Aaron",12,2,1,10,0,0,36,2
Fremantle,"Spurr, Lee",23,14,7,9,0,0,0,2
Fremantle,"Suban, Nick",14,8,4,6,0,0,0,2
Fremantle,"Sutcliffe, Cam",20,11,3,9,0,0,0,2
Fremantle,"Tucker, Darcy",17,9,6,8,0,0,0,0
Fremantle,"Walters, Michael",16,11,5,5,0,3,0,1
Fremantle,"Weller, Lachie",16,11,5,5,1,0,0,2
Fremantle,"Balic, Harley",8,3,1,5,0,0,0,3
Fremantle,"Blakely, Connor",18,9,6,9,0,0,0,4
Fremantle,"Crozier, Hayden",20,13,6,7,2,2,0,1
Fremantle,"Fyfe, Nat",33,11,5,22,0,0,0,6
Fremantle,"Grey, Brady",19,13,6,6,1,0,0,5
Fremantle,"Hamling, Joel",12,4,6,8,0,0,0,2
Fremantle,"Hill, Bradley",25,15,8,10,0,1,0,1
Fremantle,"Hill, Stephen",33,21,4,12,0,0,0,4
Fremantle,"Hughes, Ethan",11,6,5,5,0,0,0,1
Fremantle,"Ibbotson, Garrick",16,13,4,3,0,0,0,2
Fremantle,"Johnson, Michael",17,9,4,8,0,0,1,0
Fremantle,"Kersten, Shane",14,8,6,6,2,1,0,1
Fremantle,"Langdon, Ed",20,10,6,10,0,0,0,4
Fremantle,"Logue, Griffin",10,5,3,5,0,0,0,2
Fremantle,"McCarthy, Cam",14,8,4,6,2,0,0,2
Fremantle,"Mundy, David",30,19,7,11,2,1,0,7
Fremantle,"Neale, Lachie",30,8,4,22,0,2,0,1
Fremantle,"Sandilands, Aaron",15,3,3,12,0,0,42,2
Fremantle,"Sheridan, Tom",16,11,4,5,0,0,0,1
Fremantle,"Spurr, Lee",14,7,4,7,0,0,0,3
Fremantle,"Walters, Michael",12,9,3,3,3,1,0,1
Fremantle,"Weller, Lachie",19,7,1,12,1,0,0,1
Fremantle,"Balic, Harley",15,8,4,7,1,0,0,5
Fremantle,"Blakely, Connor",23,9,3,14,0,0,0,2
Fremantle,"Crozier, Hayden",9,7,2,2,1,0,0,6
Fremantle,"Fyfe, Nat",25,11,6,14,1,1,0,4
Fremantle,"Grey, Brady",6,5,1,1,1,0,0,7
Fremantle,"Hamling, Joel",8,2,3,6,0,0,0,1
Fremantle,"Hill, Bradley",19,12,7,7,0,2,0,3
Fremantle,"Hill, Stephen",18,10,2,8,1,0,0,3
Fremantle,"Hughes, Ethan",17,14,5,3,0,0,0,3
Fremantle,"Ibbotson, Garrick",8,2,3,6,0,0,0,3
Fremantle,"Johnson, Michael",18,9,5,9,0,0,5,3
Fremantle,"Kersten, Shane",14,8,5,6,1,0,0,2
Fremantle,"Langdon, Ed",14,10,4,4,0,0,0,1
Fremantle,"Logue, Griffin",6,4,1,2,0,0,0,1
Fremantle,"McCarthy, Cam",20,15,6,5,2,3,0,2
Fremantle,"Mundy, David",23,9,3,14,3,0,0,7
Fremantle,"Neale, Lachie",22,11,4,11,4,1,0,6
Fremantle,"Sandilands, Aaron",14,2,5,12,0,0,53,2
Fremantle,"Sheridan, Tom",11,6,5,5,0,0,0,4
Fremantle,"Spurr, Lee",18,12,2,6,0,0,0,3
Fremantle,"Walters, Michael",20,13,5,7,1,0,0,3
Fremantle,"Weller, Lachie",27,14,4,13,0,1,0,2
Fremantle,"Blakely, Connor",24,7,2,17,0,0,0,3
Fremantle,"Crozier, Hayden",9,8,1,1,1,2,0,6
Fremantle,"Fyfe, Nat",26,11,3,15,0,1,0,4
Fremantle,"Grey, Brady",10,6,3,4,1,1,0,6
Fremantle,"Hamling, Joel",11,4,3,7,0,0,0,5
Fremantle,"Hill, Bradley",23,17,8,6,1,0,0,2
Fremantle,"Hill, Stephen",25,13,1,12,0,0,0,7
Fremantle,"Hughes, Ethan",12,7,2,5,0,0,0,2
Fremantle,"Ibbotson, Garrick",17,10,3,7,0,0,0,1
Fremantle,"Johnson, Michael",26,11,7,15,1,0,1,0
Fremantle,"Kersten, Shane",10,8,5,2,1,1,0,4
Fremantle,"Langdon, Ed",16,10,4,6,2,0,0,0
Fremantle,"Logue, Griffin",9,5,4,4,1,3,0,0
Fremantle,"McCarthy, Cam",16,11,5,5,1,1,0,1
Fremantle,"Mundy, David",30,11,2,19,0,0,0,1
Fremantle,"Neale, Lachie",22,13,3,9,0,0,0,7
Fremantle,"Sandilands, Aaron",10,4,3,6,0,0,55,3
Fremantle,"Sheridan, Tom",19,8,3,11,0,0,0,1
Fremantle,"Spurr, Lee",24,14,7,10,0,0,0,2
Fremantle,"Tucker, Darcy",17,10,4,7,0,0,0,1
Fremantle,"Walters, Michael",9,5,5,4,0,0,0,0
Fremantle,"Weller, Lachie",26,14,3,12,0,0,0,3
Fremantle,"Balic, Harley",19,11,6,8,1,0,0,4
Fremantle,"Blakely, Connor",29,9,3,20,0,0,0,3
Fremantle,"Crozier, Hayden",14,8,6,6,0,2,0,5
Fremantle,"Fyfe, Nat",19,7,2,12,0,1,0,5
Fremantle,"Grey, Brady",10,6,3,4,1,0,0,3
Fremantle,"Hamling, Joel",10,5,7,5,0,0,0,4
Fremantle,"Hill, Bradley",20,11,6,9,0,0,0,3
Fremantle,"Hughes, Ethan",14,6,3,8,0,0,0,1
Fremantle,"Ibbotson, Garrick",17,9,3,8,0,1,0,3
Fremantle,"Johnson, Michael",18,15,5,3,1,0,2,0
Fremantle,"Kersten, Shane",11,9,3,2,2,1,0,0
Fremantle,"Langdon, Ed",32,18,7,14,0,1,0,2
Fremantle,"Logue, Griffin",5,2,1,3,0,0,0,1
Fremantle,"McCarthy, Cam",11,7,3,4,3,0,0,1
Fremantle,"Mundy, David",17,9,2,8,0,0,0,4
Fremantle,"Neale, Lachie",29,12,2,17,1,0,0,8
Fremantle,"Sandilands, Aaron",9,1,4,8,0,0,52,1
Fremantle,"Sheridan, Tom",18,13,4,5,0,1,0,1
Fremantle,"Spurr, Lee",15,12,5,3,0,0,0,2
Fremantle,"Tucker, Darcy",11,5,1,6,0,0,0,4
Fremantle,"Walters, Michael",13,5,3,8,0,0,0,0
Fremantle,"Weller, Lachie",17,14,5,3,0,0,0,5
Fremantle,"Balic, Harley",10,4,2,6,1,1,0,1
Fremantle,"Blakely, Connor",29,13,9,16,0,0,0,3
Fremantle,"Crozier, Hayden",11,5,5,6,1,1,0,2
Fremantle,"Fyfe, Nat",26,12,3,14,2,0,0,2
Fremantle,"Grey, Brady",9,5,3,4,2,0,0,5
Fremantle,"Hamling, Joel",15,9,11,6,0,0,0,1
Fremantle,"Hill, Bradley",37,30,16,7,1,1,0,0
Fremantle,"Hughes, Ethan",16,12,3,4,0,0,0,1
Fremantle,"Ibbotson, Garrick",14,13,7,1,0,0,0,1
Fremantle,"Johnson, Michael",17,12,5,5,0,0,0,3
Fremantle,"Kersten, Shane",16,13,9,3,2,3,0,0
Fremantle,"Langdon, Ed",19,8,2,11,0,0,0,1
Fremantle,"McCarthy, Cam",12,9,7,3,2,1,0,3
Fremantle,"Mundy, David",20,11,5,9,1,1,1,0
Fremantle,"Neale, Lachie",40,17,4,23,1,1,0,5
Fremantle,"Sandilands, Aaron",9,0,1,9,0,0,51,1
Fremantle,"Spurr, Lee",19,13,11,6,0,0,0,2
Fremantle,"Sutcliffe, Cam",17,11,7,6,0,0,0,0
Fremantle,"Taberner, Matthew",18,13,9,5,4,1,7,1
Fremantle,"Tucker, Darcy",17,9,6,8,0,1,0,0
Fremantle,"Walters, Michael",26,9,4,17,0,0,0,5
Fremantle,"Weller, Lachie",18,11,5,7,0,0,0,2
Fremantle,"Blakely, Connor",25,8,5,17,0,0,0,6
Fremantle,"Crozier, Hayden",13,6,8,7,0,2,0,5
Fremantle,"Fyfe, Nat",20,5,5,15,1,0,0,3
Fremantle,"Grey, Brady",10,7,3,3,0,2,0,6
Fremantle,"Hamling, Joel",16,5,6,11,0,0,0,0
Fremantle,"Hill, Bradley",28,25,11,3,1,1,0,1
Fremantle,"Hughes, Ethan",20,10,4,10,0,0,0,1
Fremantle,"Ibbotson, Garrick",10,8,4,2,0,0,0,3
Fremantle,"Johnson, Michael",22,12,8,10,0,0,0,1
Fremantle,"Kersten, Shane",17,14,11,3,2,1,0,1
Fremantle,"Langdon, Ed",22,13,5,9,0,1,0,3
Fremantle,"McCarthy, Cam",15,9,5,6,1,1,0,1
Fremantle,"Mundy, David",18,11,7,7,2,0,0,3
Fremantle,"Neale, Lachie",23,12,5,11,0,0,0,7
Fremantle,"Pearce, Danyle",22,9,4,13,1,0,0,4
Fremantle,"Sandilands, Aaron",13,4,3,9,0,0,35,3
Fremantle,"Spurr, Lee",18,11,6,7,0,0,0,1
Fremantle,"Sutcliffe, Cam",13,5,1,8,0,0,0,7
Fremantle,"Taberner, Matthew",11,8,6,3,2,0,12,4
Fremantle,"Tucker, Darcy",13,8,5,5,0,0,0,2
Fremantle,"Walters, Michael",38,19,7,19,0,3,0,4
Fremantle,"Weller, Lachie",15,9,1,6,0,0,0,3
Fremantle,"Blakely, Connor",33,19,7,14,0,0,0,9
Fremantle,"Crozier, Hayden",12,9,1,3,3,0,0,4
Fremantle,"Fyfe, Nat",30,14,5,16,0,2,0,0
Fremantle,"Grey, Brady",7,3,3,4,0,0,0,4
Fremantle,"Hamling, Joel",14,7,4,7,0,0,0,4
Fremantle,"Hill, Bradley",18,12,3,6,2,0,0,5
Fremantle,"Hill, Stephen",17,12,1,5,0,0,0,5
Fremantle,"Hughes, Ethan",14,7,4,7,0,0,0,2
Fremantle,"Ibbotson, Garrick",12,7,4,5,0,0,0,0
Fremantle,"Johnson, Michael",15,13,6,2,0,0,0,3
Fremantle,"Kersten, Shane",13,9,3,4,2,1,0,1
Fremantle,"Langdon, Ed",12,4,2,8,0,0,0,4
Fremantle,"McCarthy, Cam",8,5,2,3,1,0,0,6
Fremantle,"Mundy, David",28,11,2,17,0,0,0,7
Fremantle,"Neale, Lachie",37,14,4,23,1,1,0,1
Fremantle,"Pearce, Danyle",19,13,2,6,0,0,0,5
Fremantle,"Sandilands, Aaron",11,5,0,6,0,0,39,3
Fremantle,"Spurr, Lee",10,8,4,2,0,0,0,3
Fremantle,"Sutcliffe, Cam",11,7,3,4,0,0,0,3
Fremantle,"Taberner, Matthew",5,5,1,0,1,0,4,4
Fremantle,"Walters, Michael",27,17,3,10,3,2,0,4
Fremantle,"Weller, Lachie",26,17,5,9,0,0,0,2
Fremantle,"Blakely, Connor",29,16,3,13,0,2,0,8
Fremantle,"Crozier, Hayden",13,9,2,4,0,0,0,6
Fremantle,"Fyfe, Nat",25,12,2,13,1,0,0,6
Fremantle,"Grey, Brady",12,8,1,4,0,0,0,5
Fremantle,"Griffin, Jonathon",6,5,0,1,0,0,31,3
Fremantle,"Hamling, Joel",17,10,7,7,0,0,0,3
Fremantle,"Hill, Bradley",13,8,5,5,0,0,0,1
Fremantle,"Hill, Stephen",17,13,1,4,0,0,0,1
Fremantle,"Hughes, Ethan",15,8,4,7,0,0,0,3
Fremantle,"Ibbotson, Garrick",17,11,4,6,0,0,0,1
Fremantle,"Johnson, Michael",14,8,2,6,0,0,0,1
Fremantle,"Kersten, Shane",10,6,2,4,0,1,0,1
Fremantle,"McCarthy, Cam",10,7,1,3,1,1,0,1
Fremantle,"Mundy, David",7,4,1,3,0,1,0,6
Fremantle,"Neale, Lachie",17,5,1,12,0,0,0,5
Fremantle,"Pearce, Danyle",13,9,0,4,0,0,0,6
Fremantle,"Spurr, Lee",15,13,4,2,0,0,0,1
Fremantle,"Sutcliffe, Cam",15,9,2,6,0,1,0,5
Fremantle,"Taberner, Matthew",7,5,1,2,0,0,3,4
Fremantle,"Tucker, Darcy",20,13,4,7,2,0,0,1
Fremantle,"Walters, Michael",11,5,1,6,0,0,0,4
Fremantle,"Weller, Lachie",30,19,4,11,2,0,0,1
Fremantle,"Blakely, Connor",26,20,4,6,0,0,0,2
Fremantle,"Crozier, Hayden",8,5,1,3,1,1,0,3
Fremantle,"Fyfe, Nat",24,7,3,17,1,1,0,7
Fremantle,"Grey, Brady",7,6,0,1,2,2,0,6
Fremantle,"Griffin, Jonathon",13,8,5,5,0,0,26,5
Fremantle,"Hamling, Joel",10,7,4,3,0,0,0,1
Fremantle,"Hill, Bradley",22,14,4,8,1,2,0,0
Fremantle,"Hill, Stephen",17,9,5,8,0,0,0,5
Fremantle,"Hughes, Ethan",17,11,6,6,0,0,0,2
Fremantle,"Johnson, Michael",15,12,3,3,0,0,0,1
Fremantle,"Kersten, Shane",8,3,4,5,1,0,0,0
Fremantle,"Langdon, Ed",9,4,2,5,2,0,0,0
Fremantle,"McCarthy, Cam",9,5,3,4,1,1,0,5
Fremantle,"Mundy, David",17,8,4,9,1,0,0,5
Fremantle,"Neale, Lachie",22,11,6,11,1,1,0,5
Fremantle,"Ryan, Luke",7,3,2,4,0,0,0,4
Fremantle,"Spurr, Lee",13,9,3,4,0,0,0,0
Fremantle,"Sutcliffe, Cam",13,9,2,4,0,1,0,4
Fremantle,"Taberner, Matthew",8,5,3,3,1,0,2,2
Fremantle,"Tucker, Darcy",12,5,2,7,0,0,0,1
Fremantle,"Walters, Michael",22,11,3,11,0,0,0,1
Fremantle,"Weller, Lachie",22,11,6,11,0,1,0,2
Fremantle,"Blakely, Connor",19,7,1,12,0,0,0,7
Fremantle,"Collins, Sam",11,4,4,7,0,0,1,6
Fremantle,"Cox, Brennan",7,3,2,4,0,1,1,1
Fremantle,"Crozier, Hayden",12,8,5,4,0,1,0,1
Fremantle,"Fyfe, Nat",18,11,5,7,2,1,0,3
Fremantle,"Grey, Brady",1,0,0,1,0,0,0,0
Fremantle,"Griffin, Jonathon",9,5,2,4,0,0,36,3
Fremantle,"Hamling, Joel",12,5,6,7,0,0,0,2
Fremantle,"Hill, Bradley",24,21,7,3,2,0,0,3
Fremantle,"Hill, Stephen",14,9,1,5,1,0,0,5
Fremantle,"Johnson, Michael",17,12,8,5,0,0,0,1
Fremantle,"Kersten, Shane",4,1,0,3,0,0,0,1
Fremantle,"McCarthy, Cam",5,5,2,0,1,0,0,2
Fremantle,"Mundy, David",26,13,5,13,0,1,0,2
Fremantle,"Neale, Lachie",32,15,6,17,1,0,0,2
Fremantle,"Ryan, Luke",13,9,4,4,0,0,0,6
Fremantle,"Sheridan, Tom",12,5,0,7,0,0,0,1
Fremantle,"Spurr, Lee",21,13,5,8,0,0,0,1
Fremantle,"Sutcliffe, Cam",14,9,2,5,0,1,0,4
Fremantle,"Tucker, Darcy",18,7,3,11,0,0,0,0
Fremantle,"Walters, Michael",21,18,10,3,1,1,0,4
Fremantle,"Weller, Lachie",11,8,4,3,1,0,0,4
Fremantle,"Ballantyne, Hayden",14,8,5,6,2,0,0,5
Fremantle,"Blakely, Connor",27,19,7,8,0,0,0,3
Fremantle,"Cox, Brennan",15,7,6,8,0,0,8,3
Fremantle,"Crozier, Hayden",9,6,2,3,0,0,0,3
Fremantle,"Darcy, Sean",14,6,0,8,0,0,40,2
Fremantle,"Deluca, Josh",13,9,1,4,0,1,0,2
Fremantle,"Hamling, Joel",14,7,7,7,0,0,0,6
Fremantle,"Hill, Bradley",27,17,6,10,1,0,0,4
Fremantle,"Hill, Stephen",17,9,2,8,0,0,0,5
Fremantle,"Johnson, Michael",22,16,3,6,0,0,0,1
Fremantle,"Kersten, Shane",4,4,1,0,0,2,0,3
Fremantle,"Logue, Griffin",10,6,6,4,0,0,0,2
Fremantle,"McCarthy, Cam",7,4,0,3,1,0,0,4
Fremantle,"Mundy, David",19,8,5,11,0,0,0,6
Fremantle,"Neale, Lachie",29,8,1,21,1,0,0,6
Fremantle,"Ryan, Luke",10,7,3,3,0,0,0,3
Fremantle,"Sheridan, Tom",11,4,1,7,0,0,0,3
Fremantle,"Spurr, Lee",22,11,4,11,0,0,0,4
Fremantle,"Suban, Nick",18,7,1,11,1,0,0,5
Fremantle,"Tucker, Darcy",18,14,5,4,3,0,0,4
Fremantle,"Walters, Michael",28,16,7,12,2,1,0,4
Fremantle,"Weller, Lachie",23,15,2,8,0,1,0,6
Fremantle,"Ballantyne, Hayden",14,9,3,5,2,1,0,0
Fremantle,"Cox, Brennan",13,9,6,4,1,3,2,2
Fremantle,"Crozier, Hayden",14,7,6,7,0,1,0,4
Fremantle,"Darcy, Sean",16,8,2,8,1,0,33,7
Fremantle,"Fyfe, Nat",23,8,4,15,0,0,0,7
Fremantle,"Grey, Brady",11,6,2,5,0,0,0,5
Fremantle,"Hamling, Joel",22,9,7,13,0,0,0,2
Fremantle,"Hill, Bradley",29,21,8,8,1,0,0,3
Fremantle,"Hughes, Ethan",30,15,14,15,0,0,0,5
Fremantle,"Johnson, Michael",26,16,9,10,0,0,0,0
Fremantle,"Logue, Griffin",9,4,3,5,0,0,0,0
Fremantle,"McCarthy, Cam",9,7,3,2,0,0,0,5
Fremantle,"Mundy, David",28,15,5,13,0,0,0,7
Fremantle,"Neale, Lachie",29,11,7,18,1,0,0,6
Fremantle,"Ryan, Luke",15,8,7,7,0,0,0,5
Fremantle,"Sandilands, Aaron",2,2,1,0,0,1,0,1
Fremantle,"Sheridan, Tom",16,9,4,7,0,0,0,3
Fremantle,"Spurr, Lee",23,15,9,8,0,0,0,6
Fremantle,"Suban, Nick",27,13,5,14,0,0,0,4
Fremantle,"Tucker, Darcy",15,5,3,10,0,0,0,1
Fremantle,"Walters, Michael",32,21,6,11,6,2,0,2
Fremantle,"Weller, Lachie",16,6,3,10,0,0,0,1
Fremantle,"Ballantyne, Hayden",4,3,2,1,0,0,0,3
Fremantle,"Blakely, Connor",32,19,12,13,0,0,0,4
Fremantle,"Cox, Brennan",10,4,4,6,1,0,3,2
Fremantle,"Crozier, Hayden",13,8,7,5,0,0,0,2
Fremantle,"Darcy, Sean",10,3,2,7,0,0,34,7
Fremantle,"Fyfe, Nat",33,11,6,22,1,1,0,4
Fremantle,"Grey, Brady",12,8,3,4,0,2,0,4
Fremantle,"Hamling, Joel",8,2,2,6,0,0,0,2
Fremantle,"Hill, Bradley",25,18,6,7,0,1,0,2
Fremantle,"Hill, Stephen",20,11,4,9,0,0,0,2
Fremantle,"Hughes, Ethan",18,9,6,9,0,0,0,3
Fremantle,"Johnson, Michael",12,9,3,3,0,0,0,6
Fremantle,"Kersten, Shane",8,5,2,3,2,1,0,1
Fremantle,"Logue, Griffin",13,6,3,7,0,0,0,1
Fremantle,"Neale, Lachie",27,14,7,13,0,0,0,4
Fremantle,"Nyhuis, Ryan",9,8,5,1,4,1,0,1
Fremantle,"Ryan, Luke",19,15,6,4,0,0,0,4
Fremantle,"Sheridan, Tom",9,5,2,4,0,0,0,1
Fremantle,"Suban, Nick",10,6,1,4,0,0,0,10
Fremantle,"Tucker, Darcy",15,9,5,6,2,1,0,5
Fremantle,"Walters, Michael",20,15,7,5,3,0,0,5
Fremantle,"Weller, Lachie",17,9,4,8,0,0,0,3
Fremantle,"Ballantyne, Hayden",8,7,3,1,1,0,0,4
Fremantle,"Blakely, Connor",33,23,11,10,0,1,0,6
Fremantle,"Cox, Brennan",13,5,3,8,0,2,3,0
Fremantle,"Crozier, Hayden",16,8,9,8,0,1,0,6
Fremantle,"Darcy, Sean",11,5,2,6,0,0,32,4
Fremantle,"Fyfe, Nat",30,13,4,17,0,1,0,6
Fremantle,"Hamling, Joel",7,3,1,4,0,0,0,1
Fremantle,"Hill, Bradley",28,21,4,7,0,3,0,4
Fremantle,"Hill, Stephen",19,12,3,7,0,2,0,3
Fremantle,"Hughes, Ethan",11,7,3,4,0,0,0,0
Fremantle,"Johnson, Michael",11,7,6,4,0,0,0,0
Fremantle,"Kersten, Shane",8,2,1,6,1,0,0,2
Fremantle,"Logue, Griffin",9,3,2,6,0,0,0,3
Fremantle,"Mundy, David",24,10,3,14,0,1,0,3
Fremantle,"Neale, Lachie",34,13,5,21,0,0,0,4
Fremantle,"Nyhuis, Ryan",10,5,3,5,0,0,0,3
Fremantle,"Ryan, Luke",20,10,7,10,0,0,0,1
Fremantle,"Spurr, Lee",13,9,3,4,0,0,0,2
Fremantle,"Suban, Nick",17,13,3,4,1,0,0,3
Fremantle,"Tucker, Darcy",16,7,6,9,0,0,0,4
Fremantle,"Walters, Michael",14,10,1,4,2,1,0,4
Fremantle,"Weller, Lachie",20,11,4,9,0,1,0,2
Fremantle,"Ballantyne, Hayden",9,7,2,2,1,0,0,4
Fremantle,"Blakely, Connor",29,20,9,9,0,0,0,2
Fremantle,"Crozier, Hayden",14,8,7,6,0,1,0,3
Fremantle,"Darcy, Sean",11,3,3,8,0,1,31,6
Fremantle,"Deluca, Josh",11,3,0,8,0,1,0,3
Fremantle,"Fyfe, Nat",23,12,2,11,1,0,0,5
Fremantle,"Hamling, Joel",21,10,6,11,0,0,0,1
Fremantle,"Hill, Bradley",25,14,5,11,0,0,0,0
Fremantle,"Hill, Stephen",21,15,3,6,0,0,0,2
Fremantle,"Hughes, Ethan",14,8,8,6,0,0,0,3
Fremantle,"Johnson, Michael",11,6,4,5,0,0,4,3
Fremantle,"Kersten, Shane",18,12,7,6,2,2,0,1
Fremantle,"Logue, Griffin",15,9,8,6,0,0,0,2
Fremantle,"McCarthy, Cam",11,10,4,1,2,0,0,4
Fremantle,"Mundy, David",21,14,1,7,0,0,0,2
Fremantle,"Neale, Lachie",27,14,6,13,0,0,0,3
Fremantle,"Nyhuis, Ryan",11,6,3,5,1,0,0,4
Fremantle,"Spurr, Lee",11,7,3,4,0,0,0,1
Fremantle,"Suban, Nick",13,5,2,8,0,0,0,4
Fremantle,"Tucker, Darcy",8,3,1,5,0,0,0,3
Fremantle,"Walters, Michael",10,8,2,2,0,0,0,2
Fremantle,"Weller, Lachie",22,11,8,11,0,0,0,0
Fremantle,"Ballantyne, Hayden",9,5,2,4,1,1,0,3
Fremantle,"Blakely, Connor",2,0,0,2,0,0,0,1
Fremantle,"Cox, Brennan",11,7,6,4,0,0,1,3
Fremantle,"Crozier, Hayden",16,9,8,7,0,1,0,2
Fremantle,"Darcy, Sean",9,2,2,7,0,1,30,5
Fremantle,"Fyfe, Nat",31,10,6,21,2,0,0,5
Fremantle,"Grey, Brady",10,6,1,4,2,0,0,0
Fremantle,"Hamling, Joel",8,5,4,3,0,0,0,1
Fremantle,"Hill, Bradley",21,17,6,4,1,0,0,3
Fremantle,"Hill, Stephen",26,18,3,8,0,0,0,4
Fremantle,"Hughes, Ethan",15,8,6,7,1,0,0,0
Fremantle,"Johnson, Michael",19,15,12,4,0,0,0,2
Fremantle,"Kersten, Shane",12,6,6,6,3,0,0,2
Fremantle,"Logue, Griffin",9,9,7,0,0,0,0,5
Fremantle,"McCarthy, Cam",11,6,2,5,0,1,0,1
Fremantle,"Mundy, David",12,6,3,6,1,1,0,3
Fremantle,"Neale, Lachie",30,15,6,15,0,0,0,3
Fremantle,"Ryan, Luke",25,19,14,6,0,0,0,6
Fremantle,"Suban, Nick",11,8,5,3,1,0,0,4
Fremantle,"Sutcliffe, Cam",21,16,8,5,0,0,0,5
Fremantle,"Tucker, Darcy",23,16,11,7,1,1,0,1
Fremantle,"Weller, Lachie",22,13,8,9,0,0,0,4
Fremantle,"Ballantyne, Hayden",8,7,4,1,1,3,0,5
Fremantle,"Cox, Brennan",12,4,5,8,0,3,2,2
Fremantle,"Crozier, Hayden",13,10,4,3,1,0,0,5
Fremantle,"Fyfe, Nat",29,16,10,13,0,1,0,6
Fremantle,"Grey, Brady",4,3,1,1,0,0,0,0
Fremantle,"Griffin, Jonathon",11,5,4,6,1,0,34,5
Fremantle,"Hamling, Joel",14,8,4,6,0,0,0,2
Fremantle,"Hill, Bradley",33,22,7,11,0,2,0,2
Fremantle,"Hill, Stephen",27,19,4,8,1,0,0,4
Fremantle,"Hughes, Ethan",21,9,6,12,0,0,0,1
Fremantle,"Johnson, Michael",16,12,11,4,0,0,0,1
Fremantle,"Kersten, Shane",11,7,5,4,2,1,0,0
Fremantle,"Logue, Griffin",11,7,6,4,0,0,0,2
Fremantle,"McCarthy, Cam",18,14,8,4,4,2,0,1
Fremantle,"Mundy, David",18,8,5,10,1,1,0,2
Fremantle,"Neale, Lachie",32,16,9,16,1,0,0,10
Fremantle,"Pearce, Danyle",14,12,2,2,0,0,0,2
Fremantle,"Ryan, Luke",28,21,16,7,0,0,0,1
Fremantle,"Suban, Nick",14,6,3,8,0,0,0,10
Fremantle,"Sutcliffe, Cam",7,5,0,2,0,0,0,8
Fremantle,"Tucker, Darcy",13,7,3,6,0,1,0,3
Fremantle,"Weller, Lachie",20,15,9,5,0,0,0,4
Fremantle,"Ballantyne, Hayden",8,5,3,3,0,1,0,1
Fremantle,"Cox, Brennan",10,4,2,6,0,1,4,1
Fremantle,"Darcy, Sean",15,6,1,9,0,0,27,3
Fremantle,"Deluca, Josh",17,7,3,10,1,0,0,3
Fremantle,"Fyfe, Nat",28,14,5,14,0,1,0,6
Fremantle,"Hamling, Joel",9,4,5,5,0,0,0,2
Fremantle,"Hill, Bradley",8,8,2,0,0,0,0,1
Fremantle,"Hill, Stephen",21,16,3,5,0,0,0,7
Fremantle,"Hughes, Ethan",14,8,8,6,0,0,0,2
Fremantle,"Johnson, Michael",7,5,3,2,0,0,0,0
Fremantle,"Kersten, Shane",7,4,2,3,0,0,0,2
Fremantle,"Logue, Griffin",12,10,7,2,0,0,0,3
Fremantle,"McCarthy, Cam",12,10,5,2,2,1,0,2
Fremantle,"Mundy, David",12,8,4,4,1,0,0,1
Fremantle,"Neale, Lachie",9,4,2,5,0,0,0,1
Fremantle,"Pearce, Danyle",16,12,1,4,0,0,0,2
Fremantle,"Ryan, Luke",10,7,2,3,0,0,0,2
Fremantle,"Suban, Nick",11,6,2,5,0,0,0,3
Fremantle,"Sutcliffe, Cam",16,6,4,10,0,0,0,0
Fremantle,"Taberner, Matthew",18,13,9,5,1,2,1,3
Fremantle,"Tucker, Darcy",18,7,1,11,0,0,0,0
Fremantle,"Weller, Lachie",14,8,1,6,0,0,0,3
Fremantle,"Ballantyne, Hayden",16,10,4,6,1,0,0,6
Fremantle,"Bennell, Harley",6,4,1,2,2,0,0,3
Fremantle,"Cox, Brennan",10,7,7,3,0,1,6,1
Fremantle,"Crozier, Hayden",13,8,4,5,2,1,0,8
Fremantle,"Darcy, Sean",12,3,0,9,0,0,45,2
Fremantle,"Deluca, Josh",12,5,0,7,1,0,0,2
Fremantle,"Fyfe, Nat",30,14,6,16,1,0,0,2
Fremantle,"Hamling, Joel",9,5,3,4,0,0,0,0
Fremantle,"Hill, Bradley",26,16,4,10,0,1,0,3
Fremantle,"Hill, Stephen",24,15,1,9,0,0,0,2
Fremantle,"Hughes, Ethan",12,6,2,6,0,0,0,1
Fremantle,"Johnson, Michael",13,8,5,5,0,1,0,3
Fremantle,"Logue, Griffin",4,1,2,3,0,0,0,1
Fremantle,"McCarthy, Cam",5,2,1,3,0,1,0,1
Fremantle,"Mundy, David",27,8,5,19,0,0,0,2
Fremantle,"Nyhuis, Ryan",9,6,2,3,0,0,0,4
Fremantle,"Ryan, Luke",11,9,3,2,0,0,0,7
Fremantle,"Suban, Nick",12,7,2,5,0,0,0,8
Fremantle,"Sutcliffe, Cam",12,5,0,7,0,0,0,4
Fremantle,"Taberner, Matthew",11,7,5,4,0,2,1,2
Fremantle,"Tucker, Darcy",12,9,3,3,0,0,0,11
Fremantle,"Weller, Lachie",21,11,1,10,0,0,0,0
Fremantle,"Ballantyne, Hayden",14,10,4,4,2,1,0,3
Fremantle,"Bennell, Harley",13,10,4,3,1,1,0,0
Fremantle,"Collins, Sam",10,3,2,7,0,0,2,2
Fremantle,"Cox, Brennan",11,6,6,5,2,0,6,1
Fremantle,"Crozier, Hayden",11,6,2,5,1,1,0,2
Fremantle,"Fyfe, Nat",24,9,2,15,2,0,0,6
Fremantle,"Griffin, Jonathon",8,5,1,3,2,0,32,4
Fremantle,"Hamling, Joel",13,8,5,5,0,0,0,0
Fremantle,"Hill, Bradley",19,14,5,5,0,0,0,3
Fremantle,"Hill, Stephen",19,13,4,6,0,0,0,1
Fremantle,"Hughes, Ethan",16,6,4,10,0,0,0,0
Fremantle,"Johnson, Michael",14,10,4,4,0,0,0,3
Fremantle,"Kersten, Shane",8,5,2,3,0,0,0,3
Fremantle,"Mundy, David",25,9,4,16,0,0,0,10
Fremantle,"Neale, Lachie",24,10,5,14,0,0,0,3
Fremantle,"Ryan, Luke",17,12,5,5,0,0,0,5
Fremantle,"Sheridan, Tom",11,7,1,4,2,0,0,1
Fremantle,"Suban, Nick",12,4,4,8,0,0,0,8
Fremantle,"Sutcliffe, Cam",15,9,4,6,0,0,0,3
Fremantle,"Taberner, Matthew",14,9,9,5,2,1,0,0
Fremantle,"Tucker, Darcy",11,6,3,5,0,0,0,4
Fremantle,"Weller, Lachie",16,8,1,8,0,0,0,2
Gold Coast,"Ablett, Gary",28,16,1,12,0,0,0,8
Gold Coast,"Ah Chee, Callum",12,6,3,6,1,0,0,3
Gold Coast,"Ainsworth, Ben",14,8,4,6,2,1,0,6
Gold Coast,"Barlow, Michael",24,9,2,15,1,0,0,7
Gold Coast,"Bowes, Jack",11,6,3,5,0,0,0,3
Gold Coast,"Hall, Aaron",25,16,5,9,2,0,0,4
Gold Coast,"Hanley, Pearce",17,11,4,6,0,0,0,2
Gold Coast,"Joyce, Jesse",18,10,7,8,0,0,0,2
Gold Coast,"Kolodjashnij, Kade",21,10,6,11,0,0,0,2
Gold Coast,"Lemmens, Sean",16,8,1,8,1,0,0,3
Gold Coast,"Lynch, Tom",12,8,5,4,3,2,0,1
Gold Coast,"Lyons, Jarryd",20,12,2,8,0,0,0,5
Gold Coast,"Martin, Jack",18,8,4,10,0,0,0,1
Gold Coast,"May, Steven",16,10,6,6,0,0,0,1
Gold Coast,"Miller, Touk",27,12,4,15,1,2,0,5
Gold Coast,"Rosa, Matt",19,5,3,14,0,1,0,1
Gold Coast,"Saad, Adam",15,11,2,4,0,1,0,2
Gold Coast,"Schoenfeld, Josh",10,4,3,6,1,0,0,4
Gold Coast,"Sexton, Alex",10,7,2,3,1,0,0,2
Gold Coast,"Thompson, Rory",10,6,5,4,0,0,0,3
Gold Coast,"Witts, Jarrod",10,6,2,4,0,0,37,9
Gold Coast,"Wright, Peter",14,9,4,5,1,3,3,4
Gold Coast,"Ablett, Gary",16,9,0,7,1,1,0,5
Gold Coast,"Ah Chee, Callum",12,3,2,9,0,0,0,3
Gold Coast,"Ainsworth, Ben",10,7,5,3,0,0,0,3
Gold Coast,"Barlow, Michael",20,9,6,11,1,0,0,5
Gold Coast,"Bowes, Jack",7,2,2,5,0,1,0,4
Gold Coast,"Hall, Aaron",19,15,4,4,0,2,0,2
Gold Coast,"Joyce, Jesse",16,4,2,12,0,0,0,0
Gold Coast,"Kolodjashnij, Kade",27,17,11,10,1,0,0,1
Gold Coast,"Lemmens, Sean",6,3,2,3,0,0,0,3
Gold Coast,"Leslie, Jack",14,9,6,5,0,0,0,0
Gold Coast,"Lynch, Tom",14,7,4,7,0,2,1,2
Gold Coast,"Lyons, Jarryd",24,14,10,10,0,0,0,3
Gold Coast,"Martin, Jack",13,10,7,3,3,1,0,2
Gold Coast,"May, Steven",22,15,8,7,0,0,0,0
Gold Coast,"Miller, Touk",27,8,5,19,0,0,0,2
Gold Coast,"Rosa, Matt",23,9,4,14,0,1,0,1
Gold Coast,"Saad, Adam",17,5,5,12,0,0,0,2
Gold Coast,"Sexton, Alex",12,6,2,6,0,0,0,3
Gold Coast,"Swallow, David",21,14,4,7,0,1,0,5
Gold Coast,"Thompson, Rory",16,9,6,7,0,0,0,1
Gold Coast,"Witts, Jarrod",17,6,4,11,1,0,27,2
Gold Coast,"Wright, Peter",12,6,5,6,1,0,2,0
Gold Coast,"Ablett, Gary",36,27,3,9,2,1,0,4
Gold Coast,"Barlow, Michael",34,14,4,20,0,1,0,1
Gold Coast,"Bowes, Jack",11,8,4,3,0,0,0,4
Gold Coast,"Fiorini, Brayden",18,8,3,10,2,0,0,3
Gold Coast,"Hall, Aaron",29,20,6,9,2,1,0,3
Gold Coast,"Harbrow, Jarrod",26,12,7,14,1,0,0,4
Gold Coast,"Joyce, Jesse",19,9,2,10,0,1,0,2
Gold Coast,"Kolodjashnij, Kade",26,11,7,15,0,0,0,1
Gold Coast,"Lemmens, Sean",11,5,2,6,1,0,0,2
Gold Coast,"Lynch, Tom",18,11,7,7,2,3,0,2
Gold Coast,"Lyons, Jarryd",30,10,2,20,0,0,0,4
Gold Coast,"Martin, Jack",23,12,5,11,3,0,0,5
Gold Coast,"Matera, Brandon",19,12,4,7,6,0,0,2
Gold Coast,"May, Steven",23,15,8,8,0,0,0,2
Gold Coast,"Miller, Touk",28,7,5,21,2,0,0,4
Gold Coast,"Rosa, Matt",25,12,4,13,0,0,0,1
Gold Coast,"Saad, Adam",23,13,4,10,0,0,0,2
Gold Coast,"Sexton, Alex",25,16,7,9,0,1,0,0
Gold Coast,"Swallow, David",34,15,4,19,0,1,0,6
Gold Coast,"Thompson, Rory",12,7,4,5,0,0,0,2
Gold Coast,"Witts, Jarrod",13,5,1,8,0,0,40,2
Gold Coast,"Wright, Peter",15,7,5,8,0,1,8,1
Gold Coast,"Ablett, Gary",34,18,5,16,1,1,0,4
Gold Coast,"Barlow, Michael",14,5,1,9,0,0,0,2
Gold Coast,"Bowes, Jack",14,7,3,7,1,0,0,1
Gold Coast,"Fiorini, Brayden",31,13,6,18,0,0,0,4
Gold Coast,"Hall, Aaron",29,15,5,14,0,0,0,4
Gold Coast,"Harbrow, Jarrod",23,14,5,9,0,0,0,2
Gold Coast,"Joyce, Jesse",15,6,5,9,0,0,0,1
Gold Coast,"Kolodjashnij, Kade",21,14,8,7,0,0,0,0
Gold Coast,"Lemmens, Sean",16,11,7,5,1,0,0,3
Gold Coast,"Leslie, Jack",10,5,8,5,0,0,0,0
Gold Coast,"Lynch, Tom",19,13,12,6,7,0,0,1
Gold Coast,"Lyons, Jarryd",24,16,4,8,1,2,0,4
Gold Coast,"Martin, Jack",30,15,12,15,0,0,0,1
Gold Coast,"Matera, Brandon",29,22,9,7,3,1,0,3
Gold Coast,"May, Steven",17,7,5,10,0,1,0,0
Gold Coast,"Miller, Touk",24,9,2,15,0,0,0,1
Gold Coast,"Rosa, Matt",21,7,5,14,0,0,0,4
Gold Coast,"Saad, Adam",15,6,3,9,0,0,0,3
Gold Coast,"Sexton, Alex",18,7,3,11,0,0,0,0
Gold Coast,"Swallow, David",13,7,3,6,0,0,0,2
Gold Coast,"Witts, Jarrod",14,6,2,8,0,0,36,2
Gold Coast,"Wright, Peter",10,6,5,4,3,1,4,2
Gold Coast,"Ablett, Gary",33,15,5,18,0,1,0,5
Gold Coast,"Ah Chee, Callum",11,7,4,4,5,0,0,1
Gold Coast,"Barlow, Michael",36,13,9,23,0,1,0,4
Gold Coast,"Bowes, Jack",15,9,2,6,0,0,0,0
Gold Coast,"Fiorini, Brayden",8,4,3,4,0,0,0,1
Gold Coast,"Hall, Aaron",24,19,6,5,2,0,0,1
Gold Coast,"Harbrow, Jarrod",25,15,2,10,0,0,0,1
Gold Coast,"Joyce, Jesse",18,9,8,9,0,0,0,4
Gold Coast,"Kolodjashnij, Kade",15,8,7,7,0,0,0,1
Gold Coast,"Lemmens, Sean",19,11,2,8,0,0,0,3
Gold Coast,"Leslie, Jack",16,5,6,11,0,0,0,1
Gold Coast,"Lynch, Tom",15,11,9,4,2,1,0,1
Gold Coast,"Lyons, Jarryd",26,14,4,12,0,1,0,5
Gold Coast,"Martin, Jack",18,14,7,4,0,0,0,3
Gold Coast,"Matera, Brandon",11,8,4,3,2,0,0,1
Gold Coast,"Miller, Touk",18,6,3,12,0,0,0,3
Gold Coast,"Rosa, Matt",16,8,4,8,0,0,0,2
Gold Coast,"Saad, Adam",24,15,1,9,0,0,0,3
Gold Coast,"Sexton, Alex",17,11,8,6,1,1,0,1
Gold Coast,"Swallow, David",11,11,2,0,1,1,0,5
Gold Coast,"Witts, Jarrod",13,4,2,9,0,0,25,1
Gold Coast,"Wright, Peter",14,6,6,8,0,0,9,2
Gold Coast,"Ablett, Gary",45,26,3,19,1,1,0,9
Gold Coast,"Ah Chee, Callum",11,5,3,6,2,0,0,4
Gold Coast,"Barlow, Michael",24,11,4,13,2,0,0,2
Gold Coast,"Bowes, Jack",21,7,5,14,1,0,0,0
Gold Coast,"Fiorini, Brayden",21,8,4,13,0,0,0,4
Gold Coast,"Hall, Aaron",18,9,0,9,0,0,0,3
Gold Coast,"Harbrow, Jarrod",24,17,7,7,0,1,0,4
Gold Coast,"Joyce, Jesse",12,7,3,5,0,0,0,2
Gold Coast,"Lemmens, Sean",13,8,4,5,0,0,0,3
Gold Coast,"Leslie, Jack",12,8,7,4,0,0,0,0
Gold Coast,"Lonergan, Jesse",13,6,3,7,0,0,0,1
Gold Coast,"Lynch, Tom",11,8,7,3,3,1,0,2
Gold Coast,"Lyons, Jarryd",25,11,4,14,0,1,0,5
Gold Coast,"Martin, Jack",21,12,5,9,0,2,0,3
Gold Coast,"Matera, Brandon",14,8,6,6,2,1,0,2
Gold Coast,"Miller, Touk",25,10,3,15,0,1,0,4
Gold Coast,"Rosa, Matt",8,2,2,6,0,0,0,0
Gold Coast,"Saad, Adam",15,7,2,8,0,0,0,4
Gold Coast,"Sexton, Alex",26,15,7,11,1,0,0,1
Gold Coast,"Shaw, Matt",9,7,3,2,0,0,0,2
Gold Coast,"Witts, Jarrod",8,1,1,7,0,0,34,4
Gold Coast,"Wright, Peter",14,10,8,4,2,0,6,0
Gold Coast,"Ablett, Gary",32,17,5,15,1,0,0,5
Gold Coast,"Ah Chee, Callum",15,9,4,6,3,1,0,5
Gold Coast,"Barlow, Michael",29,15,6,14,1,0,0,6
Gold Coast,"Hall, Aaron",32,22,10,10,1,2,0,8
Gold Coast,"Harbrow, Jarrod",30,12,6,18,0,0,0,2
Gold Coast,"Joyce, Jesse",13,7,3,6,0,0,0,2
Gold Coast,"Kolodjashnij, Kade",20,10,7,10,0,0,0,1
Gold Coast,"Lemmens, Sean",19,8,2,11,0,0,0,5
Gold Coast,"Leslie, Jack",8,2,0,6,0,0,0,1
Gold Coast,"Lynch, Tom",22,12,8,10,3,5,1,1
Gold Coast,"Lyons, Jarryd",28,14,1,14,1,0,0,4
Gold Coast,"Martin, Jack",18,6,1,12,1,0,0,2
Gold Coast,"Matera, Brandon",10,7,6,3,2,0,0,1
Gold Coast,"May, Steven",26,17,7,9,0,0,0,0
Gold Coast,"Miller, Touk",18,4,2,14,1,1,0,7
Gold Coast,"Rosa, Matt",26,10,11,16,0,1,0,6
Gold Coast,"Saad, Adam",11,7,4,4,0,0,0,2
Gold Coast,"Scheer, Brad",8,4,1,4,0,0,0,5
Gold Coast,"Sexton, Alex",22,15,8,7,2,0,0,3
Gold Coast,"Swallow, David",23,11,4,12,1,0,0,4
Gold Coast,"Witts, Jarrod",18,10,5,8,0,0,43,4
Gold Coast,"Wright, Peter",17,12,6,5,1,4,8,1
Gold Coast,"Ablett, Gary",29,20,4,9,0,2,0,4
Gold Coast,"Barlow, Michael",29,9,1,20,1,0,0,3
Gold Coast,"Bowes, Jack",18,9,3,9,0,0,0,3
Gold Coast,"Brooksby, Keegan",19,7,8,12,0,0,0,4
Gold Coast,"Fiorini, Brayden",24,14,10,10,0,0,0,3
Gold Coast,"Hall, Aaron",37,15,4,22,0,1,0,8
Gold Coast,"Harbrow, Jarrod",35,20,7,15,0,1,0,0
Gold Coast,"Joyce, Jesse",19,10,2,9,1,0,0,2
Gold Coast,"Kolodjashnij, Kade",26,12,9,14,1,0,0,7
Gold Coast,"Lemmens, Sean",16,8,2,8,0,1,0,1
Gold Coast,"Leslie, Jack",18,11,7,7,0,0,0,3
Gold Coast,"Lynch, Tom",9,4,4,5,0,1,0,0
Gold Coast,"Lyons, Jarryd",26,9,4,17,1,0,0,5
Gold Coast,"Martin, Jack",15,10,3,5,0,1,0,5
Gold Coast,"Matera, Brandon",20,10,3,10,0,1,0,3
Gold Coast,"May, Steven",22,16,7,6,0,0,0,0
Gold Coast,"Miller, Touk",21,7,2,14,0,1,0,4
Gold Coast,"Saad, Adam",20,9,4,11,0,1,0,4
Gold Coast,"Scheer, Brad",10,1,2,9,0,0,0,1
Gold Coast,"Sexton, Alex",11,6,1,5,0,0,0,1
Gold Coast,"Witts, Jarrod",19,6,1,13,0,1,34,4
Gold Coast,"Wright, Peter",16,8,5,8,0,1,3,2
Gold Coast,"Barlow, Michael",24,10,3,14,2,0,0,3
Gold Coast,"Brodie, Will",9,3,1,6,0,0,0,5
Gold Coast,"Fiorini, Brayden",17,4,2,13,0,0,0,3
Gold Coast,"Hall, Aaron",29,19,7,10,1,1,0,3
Gold Coast,"Hanley, Pearce",8,4,2,4,0,0,0,1
Gold Coast,"Harbrow, Jarrod",23,13,2,10,0,0,0,3
Gold Coast,"Joyce, Jesse",14,6,4,8,0,0,0,2
Gold Coast,"Kolodjashnij, Kade",18,12,6,6,1,0,0,1
Gold Coast,"Lemmens, Sean",12,3,1,9,1,0,0,4
Gold Coast,"Leslie, Jack",15,7,8,8,0,0,0,2
Gold Coast,"Lynch, Tom",16,6,3,10,2,0,0,3
Gold Coast,"Lyons, Jarryd",21,11,1,10,0,0,0,2
Gold Coast,"Martin, Jack",18,8,4,10,0,1,0,3
Gold Coast,"Matera, Brandon",20,18,7,2,3,4,0,1
Gold Coast,"May, Steven",20,15,5,5,0,0,0,2
Gold Coast,"Miller, Touk",19,2,2,17,0,0,0,2
Gold Coast,"Saad, Adam",20,10,4,10,0,0,0,3
Gold Coast,"Scheer, Brad",10,4,3,6,0,1,0,3
Gold Coast,"Sexton, Alex",16,7,4,9,1,0,0,1
Gold Coast,"Swallow, David",21,11,2,10,0,0,0,5
Gold Coast,"Witts, Jarrod",13,5,3,8,0,0,51,2
Gold Coast,"Wright, Peter",9,7,6,2,2,1,3,1
Gold Coast,"Ablett, Gary",36,20,5,16,0,0,0,3
Gold Coast,"Barlow, Michael",30,15,7,15,0,2,0,3
Gold Coast,"Brodie, Will",9,5,3,4,0,1,0,7
Gold Coast,"Hall, Aaron",23,18,5,5,1,0,0,5
Gold Coast,"Hanley, Pearce",31,20,12,11,0,0,0,2
Gold Coast,"Harbrow, Jarrod",18,10,4,8,1,0,0,0
Gold Coast,"Joyce, Jesse",6,3,3,3,0,0,0,3
Gold Coast,"Kolodjashnij, Kade",20,15,11,5,0,0,0,7
Gold Coast,"Lemmens, Sean",13,5,1,8,1,2,0,1
Gold Coast,"Leslie, Jack",9,8,7,1,0,0,0,1
Gold Coast,"Lynch, Tom",16,14,8,2,3,1,0,1
Gold Coast,"Lyons, Jarryd",29,14,7,15,1,0,0,8
Gold Coast,"Martin, Jack",23,18,10,5,0,0,0,0
Gold Coast,"Matera, Brandon",22,13,5,9,1,1,0,1
Gold Coast,"May, Steven",23,12,8,11,0,0,0,3
Gold Coast,"Miller, Touk",19,2,3,17,0,0,0,8
Gold Coast,"Rosa, Matt",17,7,3,10,0,0,0,4
Gold Coast,"Saad, Adam",14,5,4,9,0,1,0,1
Gold Coast,"Sexton, Alex",22,15,8,7,1,2,0,0
Gold Coast,"Swallow, David",19,11,1,8,0,0,0,8
Gold Coast,"Witts, Jarrod",14,4,3,10,0,0,34,4
Gold Coast,"Wright, Peter",12,9,8,3,2,2,6,4
Gold Coast,"Ablett, Gary",37,21,2,16,2,1,0,10
Gold Coast,"Ainsworth, Ben",18,8,2,10,1,1,0,4
Gold Coast,"Barlow, Michael",24,11,7,13,1,2,0,7
Gold Coast,"Hall, Aaron",23,10,3,13,0,1,0,2
Gold Coast,"Hanley, Pearce",19,13,9,6,0,0,0,0
Gold Coast,"Joyce, Jesse",17,7,4,10,0,0,0,1
Gold Coast,"Kolodjashnij, Kade",20,15,6,5,0,0,0,2
Gold Coast,"Lemmens, Sean",12,5,5,7,1,0,0,4
Gold Coast,"Leslie, Jack",12,5,8,7,0,0,0,1
Gold Coast,"Lonergan, Jesse",22,6,3,16,0,0,0,6
Gold Coast,"Lynch, Tom",18,13,10,5,2,1,0,2
Gold Coast,"Lyons, Jarryd",28,13,4,15,1,3,0,7
Gold Coast,"Martin, Jack",15,9,4,6,1,0,0,1
Gold Coast,"Matera, Brandon",16,11,2,5,2,4,0,4
Gold Coast,"May, Steven",24,18,13,6,0,0,0,3
Gold Coast,"Rosa, Matt",20,7,4,13,0,0,0,3
Gold Coast,"Saad, Adam",17,9,3,8,0,2,0,2
Gold Coast,"Sexton, Alex",12,6,2,6,0,0,0,1
Gold Coast,"Swallow, David",27,11,1,16,0,0,0,6
Gold Coast,"Willis, Mackenzie",12,7,4,5,0,0,0,3
Gold Coast,"Witts, Jarrod",17,9,5,8,0,0,46,4
Gold Coast,"Wright, Peter",14,7,10,7,2,0,6,0
Gold Coast,"Ablett, Gary",25,13,0,12,0,0,0,9
Gold Coast,"Ainsworth, Ben",9,6,5,3,0,0,0,2
Gold Coast,"Barlow, Michael",17,10,3,7,1,2,0,5
Gold Coast,"Hall, Aaron",21,12,1,9,0,1,0,4
Gold Coast,"Hanley, Pearce",15,7,5,8,0,0,0,1
Gold Coast,"Joyce, Jesse",6,2,0,4,0,0,0,5
Gold Coast,"Kolodjashnij, Kade",18,14,5,4,0,0,0,1
Gold Coast,"Lemmens, Sean",8,4,2,4,1,2,0,3
Gold Coast,"Leslie, Jack",12,8,3,4,0,0,0,6
Gold Coast,"Lonergan, Jesse",17,7,1,10,0,0,0,3
Gold Coast,"Lynch, Tom",10,6,1,4,0,1,0,2
Gold Coast,"Lyons, Jarryd",24,16,3,8,2,0,0,5
Gold Coast,"Martin, Jack",13,7,2,6,3,0,0,0
Gold Coast,"Matera, Brandon",8,7,0,1,1,0,0,4
Gold Coast,"May, Steven",14,11,4,3,0,0,0,3
Gold Coast,"Rosa, Matt",21,13,5,8,0,0,0,4
Gold Coast,"Saad, Adam",17,6,1,11,0,1,0,2
Gold Coast,"Sexton, Alex",12,8,2,4,1,0,0,2
Gold Coast,"Swallow, David",18,11,3,7,1,0,0,7
Gold Coast,"Willis, Mackenzie",9,4,1,5,0,0,0,0
Gold Coast,"Witts, Jarrod",9,3,2,6,0,0,39,5
Gold Coast,"Wright, Peter",9,3,1,6,1,0,3,4
Gold Coast,"Ah Chee, Callum",20,13,6,7,0,1,0,5
Gold Coast,"Ainsworth, Ben",17,5,3,12,0,2,0,2
Gold Coast,"Fiorini, Brayden",26,16,11,10,1,0,0,1
Gold Coast,"Hanley, Pearce",18,13,7,5,0,0,0,2
Gold Coast,"Harbrow, Jarrod",29,19,11,10,0,0,0,2
Gold Coast,"Joyce, Jesse",18,10,7,8,0,0,0,2
Gold Coast,"Lemmens, Sean",15,7,7,8,1,2,0,3
Gold Coast,"Leslie, Jack",13,10,10,3,0,0,0,1
Gold Coast,"Lonergan, Jesse",23,6,3,17,0,0,0,5
Gold Coast,"Lynch, Tom",15,8,8,7,0,1,0,2
Gold Coast,"Lyons, Jarryd",26,14,1,12,1,0,0,3
Gold Coast,"Macpherson, Darcy",11,7,3,4,1,0,0,2
Gold Coast,"Martin, Jack",22,11,8,11,0,0,0,4
Gold Coast,"May, Steven",20,11,8,9,0,0,0,1
Gold Coast,"Miller, Touk",25,10,5,15,0,0,0,3
Gold Coast,"Saad, Adam",21,12,7,9,1,0,0,1
Gold Coast,"Sexton, Alex",14,7,3,7,0,1,0,1
Gold Coast,"Shaw, Matt",18,13,4,5,1,1,0,0
Gold Coast,"Swallow, David",15,7,0,8,1,1,0,5
Gold Coast,"Thompson, Rory",10,5,4,5,0,0,0,4
Gold Coast,"Witts, Jarrod",12,9,4,3,1,1,31,6
Gold Coast,"Wright, Peter",16,9,6,7,2,2,5,0
Gold Coast,"Ablett, Gary",37,22,5,15,0,2,0,4
Gold Coast,"Ah Chee, Callum",7,2,0,5,0,0,0,2
Gold Coast,"Ainsworth, Ben",14,8,3,6,4,0,0,3
Gold Coast,"Davis, Ryan",10,7,5,3,0,0,0,4
Gold Coast,"Fiorini, Brayden",24,11,7,13,1,0,0,6
Gold Coast,"Hanley, Pearce",8,5,0,3,0,0,0,1
Gold Coast,"Harbrow, Jarrod",22,17,7,5,0,0,0,1
Gold Coast,"Lemmens, Sean",17,7,1,10,0,4,0,0
Gold Coast,"Leslie, Jack",7,4,4,3,0,0,0,0
Gold Coast,"Lonergan, Jesse",26,7,6,19,0,0,0,3
Gold Coast,"Lynch, Tom",20,15,8,5,5,1,0,2
Gold Coast,"Lyons, Jarryd",39,19,5,20,0,0,0,6
Gold Coast,"Martin, Jack",22,13,8,9,2,0,0,6
Gold Coast,"May, Steven",21,20,8,1,0,0,0,2
Gold Coast,"Miller, Touk",13,5,3,8,1,0,0,6
Gold Coast,"Rosa, Matt",26,9,4,17,0,0,0,2
Gold Coast,"Saad, Adam",19,10,2,9,0,0,0,2
Gold Coast,"Sexton, Alex",20,13,4,7,2,0,0,3
Gold Coast,"Swallow, David",27,16,3,11,2,1,0,4
Gold Coast,"Thompson, Rory",5,3,2,2,0,0,1,4
Gold Coast,"Witts, Jarrod",14,8,2,6,0,0,45,2
Gold Coast,"Wright, Peter",13,5,1,8,1,1,4,1
Gold Coast,"Ah Chee, Callum",12,7,3,5,1,0,0,5
Gold Coast,"Ainsworth, Ben",6,3,2,3,0,1,0,2
Gold Coast,"Bowes, Jack",16,13,4,3,0,1,0,4
Gold Coast,"Davis, Ryan",14,10,4,4,0,0,0,2
Gold Coast,"Fiorini, Brayden",21,11,5,10,0,0,0,0
Gold Coast,"Harbrow, Jarrod",17,12,5,5,0,0,0,1
Gold Coast,"Lemmens, Sean",8,3,0,5,0,1,0,3
Gold Coast,"Lonergan, Jesse",18,10,4,8,0,0,0,2
Gold Coast,"Lynch, Tom",11,9,4,2,3,1,0,4
Gold Coast,"Lyons, Jarryd",27,13,6,14,0,0,0,7
Gold Coast,"Macpherson, Darcy",8,5,3,3,0,0,0,6
Gold Coast,"Martin, Jack",18,13,9,5,1,1,0,5
Gold Coast,"May, Steven",16,13,8,3,0,0,0,0
Gold Coast,"McKenzie, Trent",17,12,6,5,0,0,0,2
Gold Coast,"Miller, Touk",24,7,5,17,0,0,0,10
Gold Coast,"Rosa, Matt",21,9,4,12,0,1,0,3
Gold Coast,"Saad, Adam",17,12,6,5,0,1,0,0
Gold Coast,"Sexton, Alex",24,22,13,2,0,0,0,1
Gold Coast,"Swallow, David",29,16,2,13,1,0,0,5
Gold Coast,"Thompson, Rory",12,8,5,4,0,0,0,3
Gold Coast,"Witts, Jarrod",12,9,4,3,0,1,44,5
Gold Coast,"Wright, Peter",8,5,4,3,1,0,6,3
Gold Coast,"Ablett, Gary",41,27,8,14,0,1,0,6
Gold Coast,"Ah Chee, Callum",12,7,1,5,0,0,0,5
Gold Coast,"Ainsworth, Ben",12,6,1,6,2,0,0,4
Gold Coast,"Bowes, Jack",9,6,2,3,0,0,0,3
Gold Coast,"Hall, Aaron",21,6,3,15,1,0,0,2
Gold Coast,"Hanley, Pearce",18,10,4,8,0,1,0,3
Gold Coast,"Harbrow, Jarrod",21,13,4,8,0,0,0,2
Gold Coast,"Lemmens, Sean",9,6,3,3,0,1,0,5
Gold Coast,"Lynch, Tom",12,7,1,5,2,2,0,3
Gold Coast,"Lyons, Jarryd",11,8,5,3,1,1,0,1
Gold Coast,"Martin, Jack",18,12,9,6,2,0,0,2
Gold Coast,"May, Steven",3,2,0,1,0,0,0,0
Gold Coast,"McKenzie, Trent",13,11,5,2,0,0,0,4
Gold Coast,"Miller, Touk",20,9,2,11,0,0,0,7
Gold Coast,"Rischitelli, Michael",13,6,4,7,1,0,0,7
Gold Coast,"Rosa, Matt",22,8,3,14,0,0,0,3
Gold Coast,"Saad, Adam",14,12,5,2,0,0,0,1
Gold Coast,"Sexton, Alex",4,3,1,1,0,0,0,0
Gold Coast,"Swallow, David",25,18,5,7,1,2,0,7
Gold Coast,"Thompson, Rory",7,3,3,4,0,0,0,3
Gold Coast,"Witts, Jarrod",16,8,3,8,0,1,42,4
Gold Coast,"Wright, Peter",11,8,6,3,3,0,1,2
Gold Coast,"Ah Chee, Callum",12,7,0,5,0,0,0,3
Gold Coast,"Ainsworth, Ben",12,10,6,2,2,2,0,4
Gold Coast,"Bowes, Jack",8,4,2,4,0,0,0,1
Gold Coast,"Fiorini, Brayden",29,13,7,16,0,0,0,4
Gold Coast,"Hall, Aaron",23,15,4,8,1,1,0,3
Gold Coast,"Hanley, Pearce",21,10,7,11,0,0,0,1
Gold Coast,"Harbrow, Jarrod",16,11,5,5,0,0,0,1
Gold Coast,"Lemmens, Sean",7,3,1,4,0,0,0,3
Gold Coast,"Lonergan, Jesse",14,5,2,9,0,0,0,3
Gold Coast,"Lynch, Tom",19,10,8,9,1,0,0,1
Gold Coast,"Macpherson, Darcy",16,9,5,7,0,2,0,4
Gold Coast,"Martin, Jack",22,17,11,5,2,1,0,1
Gold Coast,"McKenzie, Trent",12,9,2,3,0,1,0,1
Gold Coast,"Miller, Touk",20,8,6,12,0,0,0,5
Gold Coast,"Rischitelli, Michael",12,6,2,6,0,0,0,6
Gold Coast,"Rosa, Matt",22,8,4,14,0,0,0,5
Gold Coast,"Saad, Adam",13,8,4,5,0,0,0,4
Gold Coast,"Scrimshaw, Jack",11,7,5,4,0,0,0,1
Gold Coast,"Sexton, Alex",11,8,4,3,0,0,0,1
Gold Coast,"Swallow, David",19,13,3,6,1,0,0,5
Gold Coast,"Witts, Jarrod",10,6,1,4,0,0,39,2
Gold Coast,"Wright, Peter",10,3,5,7,1,0,5,1
Gold Coast,"Ah Chee, Callum",2,1,1,1,0,0,0,2
Gold Coast,"Ainsworth, Ben",5,4,1,1,0,1,0,2
Gold Coast,"Fiorini, Brayden",21,15,5,6,1,0,0,1
Gold Coast,"Hall, Aaron",40,22,8,18,0,1,0,6
Gold Coast,"Hanley, Pearce",31,19,5,12,0,0,0,1
Gold Coast,"Harbrow, Jarrod",21,17,10,4,0,0,0,0
Gold Coast,"Joyce, Jesse",12,4,6,8,0,0,0,3
Gold Coast,"Lemmens, Sean",15,10,4,5,0,0,0,3
Gold Coast,"Lonergan, Jesse",16,10,5,6,1,0,0,5
Gold Coast,"Lynch, Tom",15,7,5,8,3,0,0,5
Gold Coast,"Macpherson, Darcy",8,6,2,2,0,0,0,5
Gold Coast,"Martin, Jack",20,14,5,6,1,0,0,3
Gold Coast,"Miller, Touk",15,8,5,7,1,0,0,2
Gold Coast,"Rischitelli, Michael",12,8,2,4,0,0,0,1
Gold Coast,"Rosa, Matt",21,12,3,9,1,0,0,3
Gold Coast,"Saad, Adam",19,9,4,10,1,0,0,3
Gold Coast,"Scrimshaw, Jack",12,6,4,6,0,0,0,1
Gold Coast,"Sexton, Alex",3,2,2,1,0,0,0,5
Gold Coast,"Spencer, Max",12,6,6,6,0,0,0,0
Gold Coast,"Swallow, David",19,8,3,11,0,0,0,4
Gold Coast,"Witts, Jarrod",11,7,1,4,0,0,35,2
Gold Coast,"Wright, Peter",11,8,7,3,1,1,3,2
Gold Coast,"Ablett, Gary",33,15,3,18,0,0,0,1
Gold Coast,"Currie, Daniel",13,3,1,10,0,0,37,0
Gold Coast,"Grant, Jarrad",16,4,3,12,0,1,0,4
Gold Coast,"Hall, Aaron",14,12,1,2,0,0,0,0
Gold Coast,"Hallahan, Mitch",25,12,4,13,0,1,0,4
Gold Coast,"Hanley, Pearce",24,15,1,9,1,1,0,5
Gold Coast,"Harbrow, Jarrod",15,10,2,5,0,0,0,1
Gold Coast,"Joyce, Jesse",14,8,5,6,0,0,0,0
Gold Coast,"Lemmens, Sean",8,5,1,3,0,0,0,5
Gold Coast,"Lynch, Tom",17,14,8,3,3,1,0,1
Gold Coast,"Macpherson, Darcy",19,8,3,11,1,1,0,1
Gold Coast,"Martin, Jack",20,15,6,5,0,0,0,2
Gold Coast,"May, Steven",19,15,7,4,0,0,0,1
Gold Coast,"McKenzie, Trent",13,10,3,3,0,0,0,3
Gold Coast,"Miller, Touk",20,4,4,16,0,0,0,2
Gold Coast,"Rosa, Matt",22,11,8,11,0,0,0,5
Gold Coast,"Saad, Adam",19,10,3,9,0,0,0,1
Gold Coast,"Schoenfeld, Josh",18,6,4,12,0,1,0,3
Gold Coast,"Scrimshaw, Jack",11,9,5,2,0,0,0,0
Gold Coast,"Sexton, Alex",19,14,9,5,2,0,0,1
Gold Coast,"Spencer, Max",17,8,6,9,0,0,0,0
Gold Coast,"Wright, Peter",16,9,7,7,3,0,9,2
Gold Coast,"Ah Chee, Callum",6,4,0,2,0,1,0,2
Gold Coast,"Ainsworth, Ben",12,8,4,4,0,0,0,3
Gold Coast,"Bowes, Jack",7,5,2,2,0,0,0,2
Gold Coast,"Currie, Daniel",11,5,3,6,1,0,34,2
Gold Coast,"Hall, Aaron",26,19,2,7,1,0,0,4
Gold Coast,"Harbrow, Jarrod",20,16,7,4,0,0,0,5
Gold Coast,"Joyce, Jesse",15,10,5,5,0,0,0,3
Gold Coast,"Lemmens, Sean",6,4,0,2,1,0,0,3
Gold Coast,"Lyons, Jarryd",12,5,1,7,0,0,0,8
Gold Coast,"Macpherson, Darcy",15,8,7,7,0,0,0,2
Gold Coast,"Martin, Jack",15,14,9,1,4,3,0,6
Gold Coast,"May, Steven",15,7,6,8,1,0,0,3
Gold Coast,"McKenzie, Trent",15,12,4,3,0,1,0,1
Gold Coast,"Miller, Touk",29,9,4,20,1,1,0,4
Gold Coast,"Rosa, Matt",26,14,4,12,0,0,0,2
Gold Coast,"Saad, Adam",17,9,5,8,0,0,0,2
Gold Coast,"Schoenfeld, Josh",13,4,2,9,1,0,0,2
Gold Coast,"Scrimshaw, Jack",6,3,2,3,0,0,0,1
Gold Coast,"Sexton, Alex",16,10,3,6,0,2,0,1
Gold Coast,"Spencer, Max",16,12,9,4,0,0,0,1
Gold Coast,"Swallow, David",30,12,3,18,1,0,0,4
Gold Coast,"Wright, Peter",8,5,4,3,1,1,3,1
Gold Coast,"Ah Chee, Callum",14,9,4,5,0,0,0,3
Gold Coast,"Ainsworth, Ben",10,7,6,3,3,0,0,1
Gold Coast,"Brooksby, Keegan",12,6,2,6,0,0,19,4
Gold Coast,"Fiorini, Brayden",18,10,6,8,0,0,0,3
Gold Coast,"Hall, Aaron",31,17,8,14,0,0,0,3
Gold Coast,"Hallahan, Mitch",23,13,5,10,1,0,0,4
Gold Coast,"Hanley, Pearce",23,15,5,8,0,0,0,6
Gold Coast,"Harbrow, Jarrod",12,7,3,5,0,0,0,3
Gold Coast,"Joyce, Jesse",16,7,5,9,0,0,0,1
Gold Coast,"Leslie, Jack",12,6,4,6,0,0,0,0
Gold Coast,"Lonergan, Jesse",12,2,1,10,0,0,0,0
Gold Coast,"Macpherson, Darcy",5,2,2,3,1,0,0,3
Gold Coast,"Martin, Jack",18,17,7,1,1,1,0,1
Gold Coast,"May, Steven",25,15,8,10,0,1,0,3
Gold Coast,"McKenzie, Trent",24,21,9,3,0,0,0,3
Gold Coast,"Miller, Touk",16,6,1,10,0,0,0,4
Gold Coast,"Rosa, Matt",21,9,5,12,0,0,0,2
Gold Coast,"Saad, Adam",9,5,1,4,0,0,0,3
Gold Coast,"Schoenfeld, Josh",6,3,2,3,1,0,0,0
Gold Coast,"Spencer, Max",11,7,3,4,0,0,0,1
Gold Coast,"Swallow, David",20,13,3,7,1,1,0,4
Gold Coast,"Wright, Peter",8,5,5,3,1,0,8,0
Gold Coast,"Ah Chee, Callum",13,5,3,8,0,0,0,0
Gold Coast,"Ainsworth, Ben",13,8,3,5,0,1,0,6
Gold Coast,"Brodie, Will",23,12,3,11,0,0,0,6
Gold Coast,"Brooksby, Keegan",15,5,2,10,0,0,17,2
Gold Coast,"Fiorini, Brayden",16,9,6,7,0,0,0,3
Gold Coast,"Hall, Aaron",23,9,6,14,0,0,0,3
Gold Coast,"Hallahan, Mitch",17,7,4,10,0,0,0,3
Gold Coast,"Hanley, Pearce",22,13,5,9,0,0,0,3
Gold Coast,"Harbrow, Jarrod",24,19,8,5,0,0,0,2
Gold Coast,"Lyons, Jarryd",23,13,3,10,1,0,0,1
Gold Coast,"Macpherson, Darcy",12,2,2,10,0,0,0,2
Gold Coast,"Martin, Jack",10,7,3,3,0,0,0,3
Gold Coast,"May, Steven",21,15,11,6,0,0,0,0
Gold Coast,"McKenzie, Trent",14,10,5,4,0,0,0,2
Gold Coast,"Miller, Touk",9,2,1,7,0,0,0,7
Gold Coast,"Rischitelli, Michael",13,6,3,7,0,0,0,1
Gold Coast,"Rosa, Matt",24,15,9,9,0,0,0,0
Gold Coast,"Saad, Adam",9,4,4,5,0,0,0,3
Gold Coast,"Scheer, Brad",5,2,2,3,0,0,0,3
Gold Coast,"Spencer, Max",20,7,6,13,0,0,0,1
Gold Coast,"Swallow, David",19,8,3,11,0,0,0,5
Gold Coast,"Wright, Peter",19,12,7,7,2,1,8,2
Geelong,"Blicavs, Mark",14,7,4,7,0,0,4,0
Geelong,"Cockatoo, Nakia",9,5,1,4,1,1,0,4
Geelong,"Cowan, Josh",14,6,2,8,0,0,0,4
Geelong,"Dangerfield, Patrick",24,9,4,15,3,0,0,9
Geelong,"Duncan, Mitch",30,15,9,15,1,1,0,6
Geelong,"Hawkins, Tom",13,8,5,5,3,1,0,3
Geelong,"Henderson, Lachie",19,14,11,5,0,0,0,1
Geelong,"Horlin-Smith, George",16,8,1,8,0,1,0,5
Geelong,"Lonergan, Tom",9,5,4,4,0,0,0,0
Geelong,"Mackie, Andrew",18,11,6,7,0,0,0,3
Geelong,"McCarthy, Lincoln",11,6,1,5,3,0,0,7
Geelong,"Menzel, Daniel",16,11,4,5,2,2,0,1
Geelong,"Motlop, Steven",18,8,1,10,3,0,0,2
Geelong,"Murdoch, Jordan",19,9,3,10,1,0,0,3
Geelong,"Parfitt, Brandan",9,2,2,7,0,0,0,3
Geelong,"Ruggles, Tom",21,12,3,9,0,0,0,3
Geelong,"Selwood, Joel",28,15,3,13,0,0,0,6
Geelong,"Stanley, Rhys",14,8,5,6,0,1,14,6
Geelong,"Stewart, Tom",10,7,2,3,0,0,0,2
Geelong,"Taylor, Harry",17,5,4,12,0,0,0,0
Geelong,"Thurlow, Jackson",10,7,2,3,0,0,0,1
Geelong,"Tuohy, Zach",24,16,6,8,1,0,0,3
Geelong,"Blicavs, Mark",17,9,7,8,1,0,7,3
Geelong,"Cowan, Josh",10,7,2,3,0,0,0,2
Geelong,"Dangerfield, Patrick",37,15,7,22,1,1,0,6
Geelong,"Duncan, Mitch",24,10,7,14,1,0,0,5
Geelong,"Hawkins, Tom",11,9,5,2,4,2,0,3
Geelong,"Henderson, Lachie",12,7,5,5,1,0,0,0
Geelong,"Horlin-Smith, George",18,8,1,10,2,0,0,1
Geelong,"Lang, Darcy",14,6,2,8,1,0,0,3
Geelong,"Lonergan, Tom",12,6,2,6,0,0,0,0
Geelong,"Mackie, Andrew",24,14,2,10,0,0,0,0
Geelong,"McCarthy, Lincoln",13,8,2,5,0,0,0,0
Geelong,"Menzel, Daniel",14,10,8,4,4,0,0,1
Geelong,"Motlop, Steven",16,12,5,4,0,0,0,4
Geelong,"Murdoch, Jordan",13,6,2,7,0,0,0,3
Geelong,"Parfitt, Brandan",11,7,5,4,1,0,0,1
Geelong,"Ruggles, Tom",13,5,0,8,0,0,0,3
Geelong,"Selwood, Joel",26,17,4,9,0,2,0,8
Geelong,"Stanley, Rhys",13,7,3,6,0,1,14,1
Geelong,"Stewart, Tom",14,7,2,7,0,0,0,1
Geelong,"Taylor, Harry",11,3,5,8,0,1,0,1
Geelong,"Thurlow, Jackson",8,7,2,1,1,0,0,2
Geelong,"Tuohy, Zach",25,9,0,16,0,1,0,2
Geelong,"Blicavs, Mark",22,9,4,13,2,0,18,5
Geelong,"Dangerfield, Patrick",36,12,4,24,3,0,0,2
Geelong,"Duncan, Mitch",28,14,3,14,0,0,0,4
Geelong,"Guthrie, Cameron",10,2,2,8,0,0,0,1
Geelong,"Hawkins, Tom",17,8,5,9,5,0,0,6
Geelong,"Henderson, Lachie",10,3,2,7,0,1,0,1
Geelong,"Lonergan, Tom",13,4,2,9,0,0,0,2
Geelong,"Mackie, Andrew",20,10,4,10,0,0,0,1
Geelong,"McCarthy, Lincoln",16,10,3,6,1,1,0,1
Geelong,"Menegola, Sam",24,9,3,15,0,0,0,9
Geelong,"Menzel, Daniel",15,8,5,7,4,1,0,1
Geelong,"Motlop, Steven",16,10,5,6,2,0,0,2
Geelong,"Murdoch, Jordan",18,6,1,12,0,1,0,4
Geelong,"Parfitt, Brandan",23,8,2,15,1,0,0,5
Geelong,"Parsons, James",18,9,3,9,0,0,0,2
Geelong,"Ruggles, Tom",17,11,4,6,0,0,0,1
Geelong,"Selwood, Joel",37,14,6,23,1,0,0,7
Geelong,"Smith, Zac",17,9,3,8,1,0,38,2
Geelong,"Stewart, Tom",10,3,2,7,0,0,0,3
Geelong,"Taylor, Harry",6,3,2,3,0,0,0,1
Geelong,"Thurlow, Jackson",9,5,2,4,0,0,0,3
Geelong,"Tuohy, Zach",21,13,2,8,0,0,0,2
Geelong,"Blicavs, Mark",15,1,0,14,0,0,10,1
Geelong,"Cockatoo, Nakia",13,11,2,2,1,1,0,2
Geelong,"Dangerfield, Patrick",27,9,3,18,0,1,0,6
Geelong,"Duncan, Mitch",32,13,6,19,2,0,0,3
Geelong,"Guthrie, Cameron",27,10,2,17,0,0,0,5
Geelong,"Hawkins, Tom",17,11,6,6,4,2,0,4
Geelong,"Henderson, Lachie",19,8,6,11,1,0,0,2
Geelong,"Lonergan, Tom",16,6,3,10,0,0,0,2
Geelong,"Mackie, Andrew",21,12,7,9,0,0,0,2
Geelong,"Menegola, Sam",31,13,5,18,1,0,0,10
Geelong,"Menzel, Daniel",14,10,4,4,3,2,0,0
Geelong,"Motlop, Steven",33,17,2,16,3,1,0,4
Geelong,"Murdoch, Jordan",15,6,0,9,1,2,0,4
Geelong,"Parfitt, Brandan",14,6,4,8,0,1,0,7
Geelong,"Parsons, James",21,8,4,13,2,1,0,1
Geelong,"Ruggles, Tom",9,4,2,5,0,0,0,1
Geelong,"Selwood, Joel",26,10,0,16,0,0,0,11
Geelong,"Smith, Zac",8,5,2,3,0,0,41,1
Geelong,"Stewart, Tom",8,3,1,5,1,0,0,1
Geelong,"Taylor, Harry",20,11,5,9,0,3,0,2
Geelong,"Thurlow, Jackson",15,7,3,8,1,0,0,1
Geelong,"Tuohy, Zach",22,16,6,6,0,0,0,4
Geelong,"Black, Aaron",21,10,7,11,2,1,0,5
Geelong,"Blicavs, Mark",21,8,6,13,0,1,12,8
Geelong,"Cockatoo, Nakia",10,6,2,4,2,1,0,6
Geelong,"Dangerfield, Patrick",31,12,6,19,2,0,0,4
Geelong,"Duncan, Mitch",32,16,9,16,1,1,0,7
Geelong,"Guthrie, Cameron",17,4,2,13,1,0,0,2
Geelong,"Hawkins, Tom",10,6,2,4,2,1,0,3
Geelong,"Henderson, Lachie",17,10,7,7,0,1,0,3
Geelong,"Horlin-Smith, George",27,10,1,17,1,0,0,1
Geelong,"Lang, Darcy",25,14,3,11,2,1,0,4
Geelong,"Lonergan, Tom",12,4,4,8,0,0,0,3
Geelong,"Mackie, Andrew",23,17,6,6,1,0,0,3
Geelong,"Menzel, Daniel",12,9,4,3,2,1,0,1
Geelong,"Motlop, Steven",20,7,1,13,0,0,0,2
Geelong,"Murdoch, Jordan",18,12,6,6,1,0,0,2
Geelong,"Parfitt, Brandan",17,9,1,8,0,1,0,4
Geelong,"Selwood, Joel",43,21,8,22,1,0,0,9
Geelong,"Smith, Zac",15,8,1,7,0,0,31,4
Geelong,"Stewart, Tom",18,10,5,8,0,0,0,2
Geelong,"Taylor, Harry",15,9,7,6,1,1,0,2
Geelong,"Thurlow, Jackson",13,7,4,6,0,0,0,2
Geelong,"Tuohy, Zach",32,18,9,14,0,0,0,5
Geelong,"Bews, Jed",16,8,7,8,1,0,0,2
Geelong,"Black, Aaron",12,8,5,4,0,1,0,2
Geelong,"Blicavs, Mark",12,4,4,8,1,0,7,2
Geelong,"Cockatoo, Nakia",10,8,3,2,2,2,0,2
Geelong,"Dangerfield, Patrick",21,8,3,13,1,1,0,2
Geelong,"Duncan, Mitch",27,19,9,8,1,0,0,4
Geelong,"Guthrie, Cameron",22,7,3,15,0,0,0,3
Geelong,"Hawkins, Tom",8,5,3,3,1,1,0,3
Geelong,"Henderson, Lachie",14,6,4,8,0,0,0,2
Geelong,"Horlin-Smith, George",19,13,4,6,0,1,0,9
Geelong,"Lang, Darcy",14,7,5,7,1,2,0,4
Geelong,"Lonergan, Tom",21,13,8,8,0,0,0,1
Geelong,"Mackie, Andrew",29,20,8,9,0,0,0,1
Geelong,"Menegola, Sam",22,9,3,13,0,1,0,7
Geelong,"Motlop, Steven",27,13,4,14,1,0,0,1
Geelong,"Murdoch, Jordan",17,5,4,12,0,0,0,2
Geelong,"Parfitt, Brandan",14,7,1,7,1,0,0,0
Geelong,"Selwood, Joel",17,6,1,11,0,0,0,4
Geelong,"Smith, Zac",7,5,1,2,0,0,23,3
Geelong,"Stewart, Tom",16,8,5,8,0,0,0,0
Geelong,"Taylor, Harry",17,10,8,7,1,0,0,6
Geelong,"Tuohy, Zach",36,17,8,19,0,0,0,1
Geelong,"Bews, Jed",18,8,3,10,0,0,0,2
Geelong,"Black, Aaron",15,8,5,7,2,0,0,2
Geelong,"Blicavs, Mark",9,4,1,5,0,0,7,2
Geelong,"Cockatoo, Nakia",14,10,4,4,0,1,0,3
Geelong,"Dangerfield, Patrick",29,13,4,16,0,2,0,9
Geelong,"Duncan, Mitch",33,18,10,15,1,0,0,2
Geelong,"Guthrie, Cameron",18,7,2,11,0,0,0,4
Geelong,"Hawkins, Tom",11,8,5,3,3,0,0,2
Geelong,"Horlin-Smith, George",16,7,2,9,0,0,0,4
Geelong,"Lang, Darcy",17,6,2,11,1,0,0,6
Geelong,"Lonergan, Tom",13,3,3,10,0,0,0,1
Geelong,"Mackie, Andrew",20,12,6,8,1,0,0,5
Geelong,"Menegola, Sam",22,14,4,8,3,3,0,5
Geelong,"Menzel, Daniel",14,10,4,4,2,1,0,0
Geelong,"Motlop, Steven",15,8,3,7,1,0,0,2
Geelong,"Murdoch, Jordan",17,8,1,9,0,1,0,5
Geelong,"Parsons, James",9,3,2,6,0,0,0,0
Geelong,"Selwood, Joel",24,8,3,16,1,0,0,5
Geelong,"Stanley, Rhys",11,6,3,5,0,0,27,1
Geelong,"Taylor, Harry",13,7,5,6,0,0,0,4
Geelong,"Thurlow, Jackson",11,7,3,4,0,0,0,1
Geelong,"Tuohy, Zach",29,19,6,10,0,0,0,1
Geelong,"Bews, Jed",11,6,3,5,0,0,0,4
Geelong,"Blicavs, Mark",11,4,2,7,0,1,0,0
Geelong,"Cockatoo, Nakia",11,7,1,4,0,1,0,6
Geelong,"Dangerfield, Patrick",30,14,2,16,2,1,0,1
Geelong,"Duncan, Mitch",20,12,11,8,0,1,0,1
Geelong,"Guthrie, Cameron",22,9,5,13,0,1,0,1
Geelong,"Hawkins, Tom",12,10,4,2,4,3,0,2
Geelong,"Horlin-Smith, George",15,9,2,6,1,1,0,3
Geelong,"Kolodjashnij, Jake",10,6,3,4,0,0,0,0
Geelong,"Lonergan, Tom",13,6,4,7,0,0,0,1
Geelong,"Mackie, Andrew",14,11,4,3,0,0,0,1
Geelong,"Menegola, Sam",25,11,4,14,0,0,0,5
Geelong,"Menzel, Daniel",9,7,4,2,2,2,0,1
Geelong,"Motlop, Steven",20,11,1,9,1,1,0,4
Geelong,"OConnor, Mark",9,1,0,8,0,0,0,2
Geelong,"Parsons, James",10,6,2,4,1,1,0,2
Geelong,"Selwood, Joel",24,9,4,15,0,0,0,1
Geelong,"Smith, Zac",13,8,1,5,1,0,30,4
Geelong,"Stanley, Rhys",10,6,5,4,0,1,15,1
Geelong,"Stewart, Tom",14,8,4,6,1,0,0,0
Geelong,"Taylor, Harry",15,6,4,9,0,0,0,0
Geelong,"Tuohy, Zach",20,14,6,6,0,0,0,0
Geelong,"Bews, Jed",6,3,2,3,0,0,0,6
Geelong,"Blicavs, Mark",18,7,2,11,1,0,12,4
Geelong,"Cockatoo, Nakia",3,2,0,1,0,0,0,2
Geelong,"Dangerfield, Patrick",36,13,1,23,4,0,0,12
Geelong,"Duncan, Mitch",31,13,7,18,0,2,0,18
Geelong,"Hawkins, Tom",15,8,3,7,1,0,0,4
Geelong,"Henderson, Lachie",11,6,5,5,0,0,0,1
Geelong,"Kolodjashnij, Jake",14,10,5,4,0,1,0,4
Geelong,"Lonergan, Tom",10,6,2,4,0,0,0,5
Geelong,"Mackie, Andrew",25,14,3,11,0,0,0,2
Geelong,"Menegola, Sam",21,9,5,12,0,1,0,7
Geelong,"Menzel, Daniel",6,3,1,3,2,0,0,3
Geelong,"Motlop, Steven",18,10,7,8,0,1,0,3
Geelong,"Murdoch, Jordan",17,10,5,7,0,0,0,8
Geelong,"OConnor, Mark",12,3,4,9,0,0,0,3
Geelong,"Parsons, James",14,4,1,10,0,0,0,5
Geelong,"Selwood, Joel",29,14,4,15,1,0,0,8
Geelong,"Selwood, Scott",17,8,1,9,1,0,0,17
Geelong,"Smith, Zac",25,9,1,16,0,0,48,10
Geelong,"Stewart, Tom",12,8,4,4,0,0,0,4
Geelong,"Taylor, Harry",13,9,5,4,5,1,0,5
Geelong,"Tuohy, Zach",28,17,1,11,1,0,0,3
Geelong,"Bews, Jed",9,5,2,4,0,0,0,1
Geelong,"Blicavs, Mark",19,9,4,10,1,1,3,4
Geelong,"Cunico, Jordan",12,8,3,4,0,0,0,1
Geelong,"Dangerfield, Patrick",24,14,4,10,3,1,0,8
Geelong,"Duncan, Mitch",31,15,6,16,0,1,0,4
Geelong,"Guthrie, Cameron",17,7,4,10,0,1,0,6
Geelong,"Hawkins, Tom",14,12,6,2,1,3,0,4
Geelong,"Henderson, Lachie",19,11,7,8,0,0,0,2
Geelong,"Kolodjashnij, Jake",14,5,4,9,0,0,0,4
Geelong,"Lang, Darcy",17,7,4,10,0,1,0,11
Geelong,"Mackie, Andrew",19,11,4,8,0,0,0,3
Geelong,"Menegola, Sam",20,12,10,8,1,3,0,2
Geelong,"Menzel, Daniel",14,11,1,3,1,0,0,0
Geelong,"Motlop, Steven",18,10,4,8,1,1,0,2
Geelong,"Murdoch, Jordan",15,8,3,7,0,0,0,7
Geelong,"Parsons, James",9,2,0,7,1,0,0,1
Geelong,"Selwood, Joel",33,19,7,14,0,0,0,4
Geelong,"Selwood, Scott",15,9,3,6,1,0,0,17
Geelong,"Smith, Zac",13,3,2,10,0,1,35,4
Geelong,"Stewart, Tom",19,11,4,8,0,0,0,4
Geelong,"Taylor, Harry",7,2,3,5,0,1,0,1
Geelong,"Tuohy, Zach",27,17,5,10,1,0,0,0
Geelong,"Blicavs, Mark",18,7,6,11,0,0,8,3
Geelong,"Cockatoo, Nakia",10,8,1,2,0,2,0,7
Geelong,"Dangerfield, Patrick",31,16,2,15,3,3,0,7
Geelong,"Duncan, Mitch",24,10,6,14,0,0,0,5
Geelong,"Guthrie, Cameron",20,10,4,10,0,0,0,1
Geelong,"Hawkins, Tom",10,7,2,3,2,2,0,4
Geelong,"Henderson, Lachie",17,11,4,6,0,0,0,2
Geelong,"Kolodjashnij, Jake",15,6,1,9,0,0,0,3
Geelong,"Lang, Darcy",15,7,2,8,0,1,0,3
Geelong,"Lonergan, Tom",13,7,5,6,0,1,0,2
Geelong,"Mackie, Andrew",27,18,9,9,0,0,0,3
Geelong,"Menegola, Sam",24,9,5,15,0,1,0,4
Geelong,"Menzel, Daniel",8,6,2,2,3,0,0,0
Geelong,"Motlop, Steven",24,15,5,9,1,1,0,1
Geelong,"Murdoch, Jordan",22,11,3,11,0,1,0,3
Geelong,"Parsons, James",14,5,4,9,1,0,0,3
Geelong,"Selwood, Joel",35,10,4,25,1,0,0,4
Geelong,"Selwood, Scott",25,12,7,13,0,0,0,10
Geelong,"Smith, Zac",15,6,1,9,0,1,33,3
Geelong,"Stewart, Tom",19,16,3,3,0,0,0,3
Geelong,"Taylor, Harry",16,10,8,6,2,1,0,5
Geelong,"Tuohy, Zach",27,18,8,9,0,1,0,1
Geelong,"Bews, Jed",6,2,0,4,0,0,0,3
Geelong,"Cockatoo, Nakia",2,1,1,1,1,0,0,1
Geelong,"Dangerfield, Patrick",34,12,4,22,1,1,0,4
Geelong,"Duncan, Mitch",32,13,2,19,0,0,0,4
Geelong,"Guthrie, Cameron",25,8,3,17,0,0,0,11
Geelong,"Henderson, Lachie",12,8,4,4,0,0,0,3
Geelong,"Kolodjashnij, Jake",12,8,3,4,0,0,0,1
Geelong,"Lang, Darcy",14,4,1,10,0,0,0,5
Geelong,"Lonergan, Tom",13,7,5,6,0,0,0,0
Geelong,"Mackie, Andrew",19,9,1,10,0,0,0,1
Geelong,"Menegola, Sam",13,5,3,8,0,1,0,6
Geelong,"Menzel, Daniel",15,11,8,4,2,0,0,1
Geelong,"Motlop, Steven",16,9,2,7,1,0,0,4
Geelong,"Murdoch, Jordan",15,6,4,9,0,1,0,6
Geelong,"Parsons, James",7,5,4,2,0,1,0,3
Geelong,"Selwood, Joel",19,11,0,8,0,0,0,2
Geelong,"Selwood, Scott",10,4,3,6,0,0,0,8
Geelong,"Smith, Zac",14,3,2,11,0,1,33,4
Geelong,"Stanley, Rhys",13,6,4,7,3,0,19,1
Geelong,"Stewart, Tom",17,9,6,8,0,0,0,4
Geelong,"Taylor, Harry",12,6,4,6,2,2,0,2
Geelong,"Tuohy, Zach",25,14,3,11,0,2,0,0
Geelong,"Bews, Jed",14,5,1,9,0,0,0,5
Geelong,"Blicavs, Mark",21,14,5,7,0,0,22,9
Geelong,"Dangerfield, Patrick",31,19,3,12,0,3,0,9
Geelong,"Duncan, Mitch",30,14,4,16,0,1,0,5
Geelong,"Guthrie, Cameron",18,9,5,9,0,0,0,7
Geelong,"Hawkins, Tom",14,10,7,4,1,2,0,3
Geelong,"Horlin-Smith, George",22,10,2,12,0,0,0,7
Geelong,"Kolodjashnij, Jake",15,6,4,9,0,0,0,0
Geelong,"Lang, Darcy",8,1,1,7,0,0,0,4
Geelong,"Lonergan, Tom",18,10,6,8,0,0,0,3
Geelong,"Mackie, Andrew",25,16,5,9,0,1,0,2
Geelong,"Menegola, Sam",22,12,8,10,1,1,0,9
Geelong,"Menzel, Daniel",14,7,3,7,3,1,0,5
Geelong,"Motlop, Steven",20,11,2,9,1,0,0,3
Geelong,"Murdoch, Jordan",16,4,2,12,0,0,0,11
Geelong,"Parsons, James",14,6,2,8,2,0,0,4
Geelong,"Selwood, Joel",1,0,0,1,0,0,0,0
Geelong,"Selwood, Scott",19,8,2,11,0,2,0,7
Geelong,"Stanley, Rhys",9,5,3,4,0,2,24,5
Geelong,"Stewart, Tom",10,6,5,4,0,0,0,2
Geelong,"Taylor, Harry",18,9,7,9,0,0,0,4
Geelong,"Tuohy, Zach",28,20,8,8,2,0,0,2
Geelong,"Bews, Jed",12,6,4,6,0,0,0,3
Geelong,"Black, Aaron",15,9,4,6,1,0,0,2
Geelong,"Blicavs, Mark",17,11,4,6,1,1,0,6
Geelong,"Buzza, Wylie",6,4,3,2,2,0,0,7
Geelong,"Dangerfield, Patrick",45,16,4,29,1,0,0,4
Geelong,"Duncan, Mitch",26,11,2,15,0,1,0,6
Geelong,"Guthrie, Cameron",21,10,1,11,0,1,0,5
Geelong,"Guthrie, Zach",13,5,2,8,0,0,0,0
Geelong,"Hawkins, Tom",10,6,4,4,1,1,0,3
Geelong,"Henderson, Lachie",13,8,6,5,0,0,0,2
Geelong,"Kolodjashnij, Jake",12,5,2,7,0,0,0,1
Geelong,"Lonergan, Tom",15,9,4,6,0,0,0,1
Geelong,"Mackie, Andrew",18,13,4,5,0,0,0,4
Geelong,"Menegola, Sam",33,11,3,22,1,0,0,5
Geelong,"Motlop, Steven",16,9,1,7,0,0,0,2
Geelong,"Murdoch, Jordan",17,11,1,6,1,1,0,5
Geelong,"Parsons, James",13,8,2,5,1,0,0,1
Geelong,"Simpson, Sam",13,7,4,6,0,0,0,2
Geelong,"Smith, Zac",13,3,1,10,0,0,35,1
Geelong,"Stanley, Rhys",11,2,3,9,1,0,21,4
Geelong,"Taylor, Harry",22,8,6,14,0,0,0,6
Geelong,"Tuohy, Zach",22,14,1,8,0,0,0,1
Geelong,"Bews, Jed",12,7,5,5,1,0,0,4
Geelong,"Blicavs, Mark",20,11,7,9,3,0,1,8
Geelong,"Buzza, Wylie",9,6,3,3,0,1,0,0
Geelong,"Dangerfield, Patrick",38,19,9,19,3,2,0,3
Geelong,"Duncan, Mitch",38,17,9,21,2,0,0,0
Geelong,"Guthrie, Cameron",11,2,2,9,1,0,0,1
Geelong,"Guthrie, Zach",7,5,4,2,0,0,0,2
Geelong,"Hawkins, Tom",14,11,6,3,4,1,0,2
Geelong,"Henderson, Lachie",27,18,11,9,0,0,0,0
Geelong,"Kolodjashnij, Jake",16,9,6,7,0,0,0,2
Geelong,"Lonergan, Tom",16,7,7,9,0,0,0,0
Geelong,"Mackie, Andrew",18,14,3,4,0,0,0,1
Geelong,"Menegola, Sam",22,12,4,10,0,0,0,4
Geelong,"Motlop, Steven",23,17,2,6,2,0,0,0
Geelong,"Murdoch, Jordan",20,11,2,9,2,2,0,3
Geelong,"Parfitt, Brandan",11,6,3,5,2,0,0,5
Geelong,"Parsons, James",12,7,4,5,3,1,0,4
Geelong,"Selwood, Joel",24,13,4,11,0,1,0,9
Geelong,"Smith, Zac",18,7,2,11,1,0,18,3
Geelong,"Stanley, Rhys",16,13,9,3,1,0,15,3
Geelong,"Taylor, Harry",16,7,8,9,0,0,0,0
Geelong,"Tuohy, Zach",20,16,2,4,0,2,0,1
Geelong,"Bews, Jed",12,6,4,6,0,0,0,3
Geelong,"Blicavs, Mark",16,9,7,7,0,0,0,7
Geelong,"Dangerfield, Patrick",20,15,12,5,5,6,0,3
Geelong,"Duncan, Mitch",27,13,3,14,0,0,0,7
Geelong,"Guthrie, Cameron",16,7,1,9,0,0,0,3
Geelong,"Guthrie, Zach",14,3,2,11,0,0,0,1
Geelong,"Hawkins, Tom",13,11,7,2,0,1,0,0
Geelong,"Henderson, Lachie",23,10,10,13,0,0,0,5
Geelong,"Kolodjashnij, Jake",15,7,6,8,0,0,0,5
Geelong,"Lonergan, Tom",11,9,8,2,0,0,0,3
Geelong,"Menegola, Sam",22,14,3,8,0,0,0,4
Geelong,"Menzel, Daniel",16,12,8,4,3,0,0,1
Geelong,"Motlop, Steven",16,7,1,9,0,0,0,1
Geelong,"Murdoch, Jordan",18,12,5,6,0,0,0,3
Geelong,"Parfitt, Brandan",11,7,0,4,1,0,0,3
Geelong,"Parsons, James",8,2,0,6,0,0,0,2
Geelong,"Selwood, Joel",30,15,4,15,1,0,0,1
Geelong,"Simpson, Sam",12,5,2,7,1,0,0,1
Geelong,"Smith, Zac",11,5,0,6,0,0,22,2
Geelong,"Stanley, Rhys",10,4,2,6,1,1,10,2
Geelong,"Taylor, Harry",20,10,4,10,0,0,0,2
Geelong,"Tuohy, Zach",19,11,5,8,1,0,0,2
Geelong,"Bews, Jed",18,12,6,6,0,0,0,1
Geelong,"Blicavs, Mark",14,9,4,5,1,0,0,10
Geelong,"Dangerfield, Patrick",25,8,3,17,1,0,0,10
Geelong,"Duncan, Mitch",24,13,4,11,1,1,0,7
Geelong,"Guthrie, Cameron",16,5,0,11,0,0,0,6
Geelong,"Guthrie, Zach",7,0,1,7,0,0,0,3
Geelong,"Hawkins, Tom",14,8,3,6,1,3,0,2
Geelong,"Henderson, Lachie",12,6,3,6,0,0,0,6
Geelong,"Kolodjashnij, Jake",15,7,4,8,0,0,0,1
Geelong,"Lonergan, Tom",16,3,1,13,0,0,0,2
Geelong,"Menegola, Sam",22,10,3,12,0,0,0,6
Geelong,"Menzel, Daniel",4,3,2,1,1,0,0,1
Geelong,"Motlop, Steven",12,8,2,4,0,0,0,1
Geelong,"Murdoch, Jordan",17,12,3,5,0,1,0,3
Geelong,"Parsons, James",6,2,2,4,0,0,0,3
Geelong,"Selwood, Joel",26,12,3,14,0,0,0,9
Geelong,"Selwood, Scott",9,3,2,6,0,0,0,10
Geelong,"Smith, Zac",14,4,0,10,0,0,15,1
Geelong,"Stanley, Rhys",10,4,4,6,0,0,22,0
Geelong,"Stewart, Tom",14,9,4,5,0,0,0,3
Geelong,"Taylor, Harry",10,9,3,1,5,0,0,2
Geelong,"Tuohy, Zach",23,16,6,7,0,1,0,2
Geelong,"Bews, Jed",13,8,5,5,0,0,0,2
Geelong,"Buzza, Wylie",10,4,2,6,1,0,2,5
Geelong,"Cockatoo, Nakia",12,9,4,3,3,2,0,4
Geelong,"Dangerfield, Patrick",23,12,4,11,2,0,0,3
Geelong,"Duncan, Mitch",28,14,7,14,1,0,0,5
Geelong,"Guthrie, Cameron",14,4,2,10,0,0,0,3
Geelong,"Hawkins, Tom",27,17,12,10,6,1,3,3
Geelong,"Henderson, Lachie",19,8,7,11,0,0,0,0
Geelong,"Kolodjashnij, Jake",16,5,4,11,0,1,0,3
Geelong,"Lonergan, Tom",15,10,6,5,0,0,0,4
Geelong,"Mackie, Andrew",29,21,9,8,0,1,0,0
Geelong,"Menegola, Sam",30,12,7,18,0,1,0,3
Geelong,"Murdoch, Jordan",22,15,12,7,3,2,0,4
Geelong,"Parfitt, Brandan",17,8,2,9,0,0,0,7
Geelong,"Parsons, James",14,6,6,8,0,2,0,2
Geelong,"Selwood, Joel",23,12,4,11,0,0,0,0
Geelong,"Selwood, Scott",26,9,4,17,0,0,0,9
Geelong,"Smith, Zac",23,7,4,16,2,0,33,2
Geelong,"Stewart, Tom",24,14,8,10,0,1,0,4
Geelong,"Taylor, Harry",13,8,6,5,0,0,0,4
Geelong,"Thurlow, Jackson",17,6,2,11,0,0,0,1
Geelong,"Tuohy, Zach",20,13,4,7,0,0,0,1
Geelong,"Bews, Jed",7,3,1,4,0,0,0,2
Geelong,"Buzza, Wylie",7,4,1,3,0,0,7,3
Geelong,"Duncan, Mitch",32,13,9,19,0,1,0,6
Geelong,"Guthrie, Cameron",14,8,4,6,1,2,0,5
Geelong,"Guthrie, Zach",11,6,1,5,0,0,0,2
Geelong,"Hawkins, Tom",13,9,9,4,3,0,0,4
Geelong,"Henderson, Lachie",23,15,11,8,0,0,0,2
Geelong,"Kolodjashnij, Jake",19,10,7,9,0,0,0,2
Geelong,"Lonergan, Tom",13,7,5,6,0,0,0,3
Geelong,"Mackie, Andrew",23,17,8,6,0,0,0,2
Geelong,"Menegola, Sam",25,14,6,11,2,3,0,7
Geelong,"Murdoch, Jordan",18,12,5,6,0,1,0,3
Geelong,"Parfitt, Brandan",9,4,1,5,0,0,0,4
Geelong,"Parsons, James",10,3,0,7,1,0,0,2
Geelong,"Selwood, Joel",20,11,2,9,0,0,0,2
Geelong,"Selwood, Scott",26,12,5,14,0,1,0,13
Geelong,"Simpson, Sam",13,8,3,5,0,1,0,1
Geelong,"Smith, Zac",16,8,1,8,1,1,32,3
Geelong,"Stewart, Tom",14,10,4,4,0,0,0,6
Geelong,"Taylor, Harry",13,6,6,7,0,0,0,2
Geelong,"Thurlow, Jackson",23,15,6,8,0,0,0,3
Geelong,"Tuohy, Zach",26,10,4,16,0,0,0,6
Geelong,"Bews, Jed",13,7,5,6,0,0,0,4
Geelong,"Dangerfield, Patrick",30,15,5,15,0,1,0,10
Geelong,"Guthrie, Cameron",25,12,3,13,1,0,0,6
Geelong,"Guthrie, Zach",7,3,3,4,0,0,0,1
Geelong,"Henderson, Lachie",19,10,8,9,0,0,0,1
Geelong,"Kolodjashnij, Jake",20,10,5,10,0,0,0,4
Geelong,"Lonergan, Tom",20,8,3,12,0,0,0,3
Geelong,"Mackie, Andrew",21,16,2,5,1,0,0,1
Geelong,"Menegola, Sam",23,12,3,11,0,1,0,10
Geelong,"Menzel, Daniel",9,7,2,2,2,1,0,1
Geelong,"Motlop, Steven",19,13,2,6,1,1,0,1
Geelong,"Murdoch, Jordan",13,6,3,7,0,0,0,4
Geelong,"Parfitt, Brandan",9,4,2,5,0,1,0,3
Geelong,"Parsons, James",9,2,1,7,0,1,0,3
Geelong,"Selwood, Scott",18,6,1,12,0,0,0,13
Geelong,"Simpson, Sam",7,3,1,4,1,0,0,0
Geelong,"Smith, Zac",13,8,1,5,0,0,33,2
Geelong,"Stanley, Rhys",15,6,3,9,1,1,12,1
Geelong,"Stewart, Tom",14,9,4,5,0,0,0,1
Geelong,"Taylor, Harry",11,8,6,3,4,2,0,1
Geelong,"Thurlow, Jackson",21,13,10,8,0,1,0,1
Geelong,"Tuohy, Zach",24,11,3,13,0,0,0,1
Geelong,"Bews, Jed",12,8,3,4,1,0,0,6
Geelong,"Buzza, Wylie",14,7,5,7,1,1,5,3
Geelong,"Dangerfield, Patrick",32,13,6,19,2,2,0,5
Geelong,"Duncan, Mitch",32,16,6,16,0,0,0,5
Geelong,"Guthrie, Cameron",22,7,2,15,0,0,0,8
Geelong,"Guthrie, Zach",11,4,4,7,0,0,0,4
Geelong,"Henderson, Lachie",20,12,6,8,0,0,0,1
Geelong,"Kolodjashnij, Jake",14,8,8,6,0,0,0,3
Geelong,"Lonergan, Tom",13,7,5,6,0,0,0,3
Geelong,"Mackie, Andrew",18,11,6,7,0,0,0,4
Geelong,"Menegola, Sam",28,14,11,14,2,1,0,4
Geelong,"Menzel, Daniel",14,9,6,5,0,2,0,1
Geelong,"Motlop, Steven",14,7,3,7,0,0,0,4
Geelong,"Murdoch, Jordan",18,11,4,7,2,0,0,1
Geelong,"Parsons, James",14,8,2,6,1,1,0,4
Geelong,"Selwood, Scott",18,7,1,11,0,0,0,12
Geelong,"Simpson, Sam",11,3,2,8,0,0,0,1
Geelong,"Smith, Zac",17,7,0,10,0,0,35,3
Geelong,"Stewart, Tom",21,14,6,7,0,0,0,3
Geelong,"Taylor, Harry",9,5,6,4,1,2,0,1
Geelong,"Thurlow, Jackson",16,9,6,7,0,0,0,2
Geelong,"Tuohy, Zach",27,16,6,11,0,0,0,0
Geelong,"Bews, Jed",13,9,0,4,0,1,0,1
Geelong,"Blicavs, Mark",17,8,5,9,0,0,0,4
Geelong,"Buzza, Wylie",5,5,3,0,1,2,1,4
Geelong,"Dangerfield, Patrick",33,13,3,20,1,0,0,6
Geelong,"Duncan, Mitch",27,12,5,15,1,0,0,4
Geelong,"Guthrie, Cameron",20,9,6,11,0,0,0,5
Geelong,"Hawkins, Tom",20,14,10,6,2,2,0,1
Geelong,"Henderson, Lachie",15,10,6,5,1,0,0,1
Geelong,"Kolodjashnij, Jake",12,5,2,7,0,0,0,3
Geelong,"Lonergan, Tom",15,8,7,7,0,0,0,1
Geelong,"Mackie, Andrew",18,12,5,6,0,0,0,2
Geelong,"Menegola, Sam",34,16,5,18,3,1,0,4
Geelong,"Menzel, Daniel",14,12,6,2,2,1,0,4
Geelong,"Motlop, Steven",16,9,3,7,1,1,0,1
Geelong,"Murdoch, Jordan",18,10,5,8,2,0,0,5
Geelong,"Parfitt, Brandan",12,7,3,5,0,1,0,2
Geelong,"Parsons, James",3,1,2,2,0,0,0,0
Geelong,"Selwood, Scott",22,6,3,16,1,0,0,12
Geelong,"Smith, Zac",14,8,3,6,0,2,28,6
Geelong,"Stewart, Tom",18,13,8,5,0,1,0,2
Geelong,"Taylor, Harry",15,9,7,6,0,0,0,1
Geelong,"Tuohy, Zach",16,12,2,4,0,0,0,2
Geelong,"Bews, Jed",11,4,4,7,0,0,0,8
Geelong,"Blicavs, Mark",12,8,4,4,0,1,10,4
Geelong,"Dangerfield, Patrick",31,16,5,15,1,1,0,5
Geelong,"Duncan, Mitch",29,15,4,14,0,1,0,11
Geelong,"Guthrie, Cameron",9,3,2,6,0,0,0,2
Geelong,"Guthrie, Zach",13,5,5,8,0,1,0,3
Geelong,"Hawkins, Tom",15,9,6,6,1,0,2,2
Geelong,"Henderson, Lachie",8,5,3,3,0,0,0,7
Geelong,"Kolodjashnij, Jake",10,6,2,4,0,0,0,1
Geelong,"Lonergan, Tom",16,7,3,9,0,0,0,3
Geelong,"Mackie, Andrew",19,13,8,6,0,0,0,2
Geelong,"Menegola, Sam",15,8,1,7,0,0,0,4
Geelong,"Motlop, Steven",18,10,4,8,1,0,0,6
Geelong,"Murdoch, Jordan",8,5,1,3,0,0,0,6
Geelong,"Parfitt, Brandan",12,8,2,4,0,0,0,2
Geelong,"Parsons, James",6,5,0,1,1,2,0,0
Geelong,"Selwood, Joel",19,6,1,13,0,0,0,5
Geelong,"Selwood, Scott",27,12,2,15,0,0,0,8
Geelong,"Smith, Zac",11,5,2,6,0,0,51,5
Geelong,"Stewart, Tom",11,9,2,2,0,0,0,5
Geelong,"Taylor, Harry",8,5,1,3,1,1,0,3
Geelong,"Tuohy, Zach",27,16,4,11,0,1,0,2
Geelong,"Bews, Jed",19,13,6,6,0,0,0,1
Geelong,"Blicavs, Mark",19,6,1,13,1,0,0,14
Geelong,"Dangerfield, Patrick",26,18,8,8,4,3,0,4
Geelong,"Duncan, Mitch",36,24,14,12,2,0,0,3
Geelong,"Guthrie, Zach",13,8,6,5,0,0,0,3
Geelong,"Hawkins, Tom",13,7,3,6,1,0,0,2
Geelong,"Henderson, Lachie",22,17,13,5,0,0,0,1
Geelong,"Kolodjashnij, Jake",18,10,7,8,0,0,0,3
Geelong,"Lang, Darcy",24,16,10,8,0,1,0,6
Geelong,"Mackie, Andrew",21,14,8,7,0,0,0,1
Geelong,"Menegola, Sam",26,16,7,10,2,1,0,8
Geelong,"Menzel, Daniel",12,10,5,2,2,1,0,1
Geelong,"Motlop, Steven",23,15,3,8,1,0,0,6
Geelong,"Parfitt, Brandan",17,10,0,7,0,0,0,1
Geelong,"Parsons, James",5,2,0,3,0,0,0,5
Geelong,"Selwood, Joel",18,11,3,7,0,0,0,2
Geelong,"Selwood, Scott",26,7,7,19,0,0,0,10
Geelong,"Smith, Zac",19,7,2,12,1,0,30,1
Geelong,"Stanley, Rhys",13,7,7,6,1,1,6,4
Geelong,"Stewart, Tom",11,6,3,5,0,0,0,2
Geelong,"Taylor, Harry",24,14,9,10,0,0,0,3
Geelong,"Tuohy, Zach",25,18,7,7,0,0,0,2
Geelong,"Bews, Jed",14,8,3,6,0,1,0,0
Geelong,"Blicavs, Mark",12,3,5,9,0,0,0,8
Geelong,"Cockatoo, Nakia",9,6,5,3,1,0,0,5
Geelong,"Dangerfield, Patrick",24,13,3,11,2,3,0,9
Geelong,"Duncan, Mitch",25,14,6,11,1,2,0,6
Geelong,"Hawkins, Tom",8,5,3,3,1,0,0,1
Geelong,"Henderson, Lachie",15,10,6,5,1,0,0,2
Geelong,"Kolodjashnij, Jake",16,9,6,7,0,1,0,3
Geelong,"Lang, Darcy",11,7,1,4,1,3,0,8
Geelong,"Lonergan, Tom",10,1,2,9,0,0,0,2
Geelong,"Mackie, Andrew",19,9,5,10,0,0,0,2
Geelong,"Menegola, Sam",23,13,6,10,1,1,0,6
Geelong,"Menzel, Daniel",9,5,5,4,0,1,0,3
Geelong,"Motlop, Steven",26,17,3,9,1,0,0,3
Geelong,"Parfitt, Brandan",11,7,1,4,0,0,0,4
Geelong,"Selwood, Joel",34,13,2,21,1,1,0,10
Geelong,"Selwood, Scott",13,4,4,9,0,0,0,4
Geelong,"Smith, Zac",12,5,1,7,0,0,31,1
Geelong,"Stanley, Rhys",11,4,3,7,0,1,10,3
Geelong,"Stewart, Tom",15,9,4,6,0,0,0,3
Geelong,"Taylor, Harry",10,3,4,7,0,0,0,1
Geelong,"Tuohy, Zach",22,14,3,8,0,0,0,1
Greater Western Sydney,"Buntine, Matt",16,11,3,5,0,0,0,1
Greater Western Sydney,"Cameron, Jeremy",12,9,5,3,4,0,0,3
Greater Western Sydney,"Davis, Phil",14,10,5,4,0,0,0,2
Greater Western Sydney,"Greene, Toby",16,11,6,5,1,2,0,2
Greater Western Sydney,"Griffen, Ryan",16,9,2,7,0,1,0,3
Greater Western Sydney,"Haynes, Nick",13,9,7,4,0,0,0,2
Greater Western Sydney,"Johnson, Steve",18,14,7,4,1,2,0,2
Greater Western Sydney,"Kelly, Josh",27,11,3,16,0,0,0,3
Greater Western Sydney,"Kennedy, Adam",11,6,2,5,0,0,0,2
Greater Western Sydney,"Kennedy, Matthew",14,5,2,9,1,0,0,1
Greater Western Sydney,"Lobb, Rory",11,6,5,5,1,1,2,4
Greater Western Sydney,"Mumford, Shane",9,1,3,8,0,0,41,5
Greater Western Sydney,"Mzungu, Tendai",4,2,0,2,0,0,0,2
Greater Western Sydney,"Patton, Jonathon",9,7,3,2,1,0,0,1
Greater Western Sydney,"Scully, Tom",25,14,5,11,2,0,0,2
Greater Western Sydney,"Shaw, Heath",23,21,6,2,0,0,0,0
Greater Western Sydney,"Shiel, Dylan",25,15,4,10,0,0,0,3
Greater Western Sydney,"Smith, Devon",13,10,4,3,3,0,0,1
Greater Western Sydney,"Taranto, Tim",13,10,0,3,0,0,0,2
Greater Western Sydney,"Tomlinson, Adam",12,9,6,3,0,0,0,2
Greater Western Sydney,"Ward, Callan",21,8,3,13,0,1,0,3
Greater Western Sydney,"Williams, Zac",27,17,7,10,0,0,0,4
Greater Western Sydney,"Buntine, Matt",7,5,3,2,0,0,0,3
Greater Western Sydney,"Cameron, Jeremy",15,15,12,0,6,1,0,2
Greater Western Sydney,"Davis, Phil",15,6,5,9,0,0,0,0
Greater Western Sydney,"Greene, Toby",22,11,6,11,5,2,0,0
Greater Western Sydney,"Griffen, Ryan",20,8,3,12,0,1,0,4
Greater Western Sydney,"Haynes, Nick",18,10,6,8,0,2,0,1
Greater Western Sydney,"Hopper, Jacob",15,5,1,10,0,0,0,1
Greater Western Sydney,"Johnson, Steve",13,8,2,5,3,2,0,4
Greater Western Sydney,"Kelly, Josh",27,16,5,11,3,1,0,1
Greater Western Sydney,"Kennedy, Adam",18,8,4,10,0,0,0,6
Greater Western Sydney,"Lobb, Rory",11,7,4,4,2,0,3,2
Greater Western Sydney,"Mumford, Shane",9,1,2,8,0,0,38,5
Greater Western Sydney,"Reid, Sam",10,7,2,3,1,2,0,4
Greater Western Sydney,"Scully, Tom",16,7,3,9,0,0,0,1
Greater Western Sydney,"Shaw, Heath",15,13,6,2,0,1,0,3
Greater Western Sydney,"Shiel, Dylan",28,15,2,13,1,1,0,2
Greater Western Sydney,"Smith, Devon",15,11,6,4,3,0,0,5
Greater Western Sydney,"Taranto, Tim",15,8,0,7,0,0,0,4
Greater Western Sydney,"Tomlinson, Adam",16,12,7,4,0,0,0,0
Greater Western Sydney,"Ward, Callan",32,12,2,20,0,0,0,1
Greater Western Sydney,"Williams, Zac",20,12,3,8,0,0,0,2
Greater Western Sydney,"Wilson, Nathan",21,19,0,2,0,0,0,0
Greater Western Sydney,"Cameron, Jeremy",19,13,7,6,3,3,0,3
Greater Western Sydney,"Corr, Aidan",11,8,3,3,0,0,0,1
Greater Western Sydney,"Davis, Phil",11,3,1,8,0,0,0,2
Greater Western Sydney,"Greene, Toby",19,10,5,9,3,1,0,2
Greater Western Sydney,"Griffen, Ryan",10,3,0,7,0,0,0,2
Greater Western Sydney,"Haynes, Nick",15,11,4,4,0,0,0,0
Greater Western Sydney,"Hopper, Jacob",19,10,4,9,1,1,0,5
Greater Western Sydney,"Johnson, Steve",15,7,3,8,1,1,0,0
Greater Western Sydney,"Kelly, Josh",31,12,3,19,1,1,0,7
Greater Western Sydney,"Kennedy, Adam",17,5,3,12,0,0,0,5
Greater Western Sydney,"Lobb, Rory",9,8,2,1,2,0,6,2
Greater Western Sydney,"Mumford, Shane",19,5,1,14,0,0,33,2
Greater Western Sydney,"Reid, Sam",19,12,4,7,2,3,0,2
Greater Western Sydney,"Scully, Tom",25,13,6,12,0,0,0,3
Greater Western Sydney,"Shaw, Heath",16,12,3,4,0,0,0,6
Greater Western Sydney,"Shiel, Dylan",27,18,1,9,0,3,0,5
Greater Western Sydney,"Smith, Devon",23,14,4,9,0,1,0,6
Greater Western Sydney,"Taranto, Tim",12,8,3,4,0,1,0,3
Greater Western Sydney,"Tomlinson, Adam",8,4,5,4,0,0,0,4
Greater Western Sydney,"Ward, Callan",29,13,2,16,1,1,0,3
Greater Western Sydney,"Williams, Zac",23,11,2,12,0,0,0,6
Greater Western Sydney,"Wilson, Nathan",9,8,2,1,1,0,0,2
Greater Western Sydney,"Cameron, Jeremy",21,11,8,10,1,2,0,0
Greater Western Sydney,"Corr, Aidan",8,4,5,4,0,0,0,1
Greater Western Sydney,"Davis, Phil",18,12,4,6,0,0,0,4
Greater Western Sydney,"Greene, Toby",16,10,5,6,4,2,0,4
Greater Western Sydney,"Haynes, Nick",27,19,9,8,0,0,0,2
Greater Western Sydney,"Hopper, Jacob",23,6,2,17,1,0,0,5
Greater Western Sydney,"Kelly, Josh",30,17,3,13,0,2,0,10
Greater Western Sydney,"Kennedy, Adam",14,6,4,8,0,0,0,3
Greater Western Sydney,"Kennedy, Matthew",16,8,1,8,0,1,0,8
Greater Western Sydney,"Lobb, Rory",17,9,6,8,1,2,8,4
Greater Western Sydney,"Mumford, Shane",13,2,2,11,0,0,46,6
Greater Western Sydney,"Patton, Jonathon",15,9,5,6,6,0,0,0
Greater Western Sydney,"Reid, Sam",13,9,2,4,2,1,0,5
Greater Western Sydney,"Scully, Tom",32,12,8,20,0,0,0,2
Greater Western Sydney,"Shaw, Heath",20,15,5,5,0,1,0,1
Greater Western Sydney,"Shiel, Dylan",28,14,3,14,1,0,0,8
Greater Western Sydney,"Smith, Devon",21,10,4,11,0,2,0,1
Greater Western Sydney,"Taranto, Tim",18,7,2,11,0,0,0,4
Greater Western Sydney,"Tomlinson, Adam",22,17,7,5,0,0,0,1
Greater Western Sydney,"Ward, Callan",15,7,0,8,0,0,0,5
Greater Western Sydney,"Williams, Zac",25,15,4,10,0,0,0,1
Greater Western Sydney,"Wilson, Nathan",18,14,2,4,0,0,0,2
Greater Western Sydney,"Cameron, Jeremy",24,17,9,7,2,4,0,3
Greater Western Sydney,"Corr, Aidan",8,3,3,5,0,0,0,1
Greater Western Sydney,"Davis, Phil",10,4,5,6,0,0,0,3
Greater Western Sydney,"Greene, Toby",16,12,2,4,4,1,0,4
Greater Western Sydney,"Haynes, Nick",24,20,11,4,0,0,0,1
Greater Western Sydney,"Hopper, Jacob",16,7,2,9,0,0,0,8
Greater Western Sydney,"Johnson, Steve",19,13,6,6,1,2,0,2
Greater Western Sydney,"Kelly, Josh",21,12,2,9,0,0,0,6
Greater Western Sydney,"Kennedy, Adam",14,9,6,5,0,0,0,1
Greater Western Sydney,"Kennedy, Matthew",17,9,5,8,0,1,0,8
Greater Western Sydney,"Lobb, Rory",14,6,4,8,1,1,5,1
Greater Western Sydney,"Mumford, Shane",11,3,1,8,0,0,62,4
Greater Western Sydney,"Patton, Jonathon",12,5,6,7,1,0,0,2
Greater Western Sydney,"Reid, Sam",15,6,5,9,1,0,0,4
Greater Western Sydney,"Scully, Tom",23,11,3,12,0,0,0,6
Greater Western Sydney,"Shaw, Heath",21,15,6,6,0,0,0,1
Greater Western Sydney,"Shiel, Dylan",21,13,4,8,0,0,0,2
Greater Western Sydney,"Smith, Devon",20,14,4,6,2,0,0,2
Greater Western Sydney,"Tomlinson, Adam",15,13,8,2,1,0,0,1
Greater Western Sydney,"Ward, Callan",27,12,3,15,1,1,0,1
Greater Western Sydney,"Williams, Zac",23,11,4,12,1,1,0,4
Greater Western Sydney,"Wilson, Nathan",15,11,7,4,0,1,0,2
Greater Western Sydney,"Cameron, Jeremy",11,10,5,1,4,1,0,1
Greater Western Sydney,"Corr, Aidan",15,10,9,5,0,0,0,1
Greater Western Sydney,"Greene, Toby",17,13,7,4,3,1,0,4
Greater Western Sydney,"Haynes, Nick",19,12,8,7,0,0,0,3
Greater Western Sydney,"Hopper, Jacob",18,8,4,10,0,0,0,5
Greater Western Sydney,"Johnson, Steve",11,5,2,6,0,1,0,3
Greater Western Sydney,"Kelly, Josh",24,11,4,13,0,0,0,5
Greater Western Sydney,"Kennedy, Adam",14,8,5,6,0,0,0,1
Greater Western Sydney,"Kennedy, Matthew",13,6,1,7,0,1,0,6
Greater Western Sydney,"Lobb, Rory",11,6,5,5,1,0,10,2
Greater Western Sydney,"Mumford, Shane",8,1,1,7,0,0,52,7
Greater Western Sydney,"Patton, Jonathon",12,10,9,2,3,2,0,0
Greater Western Sydney,"Reid, Sam",5,3,0,2,0,0,0,1
Greater Western Sydney,"Scully, Tom",23,12,4,11,0,0,0,5
Greater Western Sydney,"Shaw, Heath",24,23,5,1,0,0,0,3
Greater Western Sydney,"Shiel, Dylan",29,15,4,14,0,0,0,2
Greater Western Sydney,"Smith, Devon",24,10,3,14,0,1,0,7
Greater Western Sydney,"Taranto, Tim",20,5,4,15,0,0,0,7
Greater Western Sydney,"Tomlinson, Adam",13,9,5,4,0,0,0,2
Greater Western Sydney,"Ward, Callan",27,11,2,16,0,0,0,1
Greater Western Sydney,"Williams, Zac",25,16,5,9,0,0,0,6
Greater Western Sydney,"Wilson, Nathan",18,14,3,4,0,0,0,2
Greater Western Sydney,"Cameron, Jeremy",15,9,6,6,2,3,0,2
Greater Western Sydney,"Coniglio, Stephen",24,14,4,10,1,1,0,9
Greater Western Sydney,"Corr, Aidan",9,5,1,4,0,0,0,2
Greater Western Sydney,"Davis, Phil",12,2,4,10,0,0,0,3
Greater Western Sydney,"Himmelberg, Harry",13,3,2,10,0,1,0,4
Greater Western Sydney,"Hopper, Jacob",10,4,4,6,1,0,0,4
Greater Western Sydney,"Johnson, Steve",20,9,5,11,0,0,0,1
Greater Western Sydney,"Kelly, Josh",28,12,2,16,0,1,0,9
Greater Western Sydney,"Kennedy, Adam",3,2,2,1,0,0,0,0
Greater Western Sydney,"Kennedy, Matthew",22,10,5,12,0,1,0,5
Greater Western Sydney,"Lobb, Rory",11,6,3,5,1,0,13,1
Greater Western Sydney,"Mumford, Shane",8,3,1,5,0,0,32,6
Greater Western Sydney,"Patton, Jonathon",9,6,3,3,1,0,0,1
Greater Western Sydney,"Scully, Tom",30,14,6,16,2,0,0,3
Greater Western Sydney,"Shaw, Heath",30,21,9,9,0,1,0,0
Greater Western Sydney,"Shiel, Dylan",28,15,3,13,1,0,0,4
Greater Western Sydney,"Smith, Devon",26,10,1,16,1,2,0,8
Greater Western Sydney,"Taranto, Tim",12,5,2,7,1,0,0,6
Greater Western Sydney,"Tomlinson, Adam",12,8,2,4,0,0,0,2
Greater Western Sydney,"Ward, Callan",28,9,2,19,0,0,0,3
Greater Western Sydney,"Williams, Zac",22,11,2,11,0,0,0,3
Greater Western Sydney,"Wilson, Nathan",19,16,5,3,1,0,0,2
Greater Western Sydney,"Cameron, Jeremy",18,13,10,5,6,1,0,5
Greater Western Sydney,"Coniglio, Stephen",21,12,2,9,0,0,0,6
Greater Western Sydney,"Corr, Aidan",0,0,1,0,0,0,0,0
Greater Western Sydney,"Davis, Phil",17,6,6,11,0,0,0,3
Greater Western Sydney,"Himmelberg, Harry",9,5,4,4,0,1,0,0
Greater Western Sydney,"Johnson, Steve",24,11,7,13,2,0,0,3
Greater Western Sydney,"Kelly, Josh",36,21,6,15,1,1,0,11
Greater Western Sydney,"Lloyd, Daniel",17,6,2,11,1,1,0,2
Greater Western Sydney,"Lobb, Rory",12,4,3,8,2,0,9,0
Greater Western Sydney,"Mumford, Shane",14,4,4,10,1,0,29,2
Greater Western Sydney,"Patton, Jonathon",15,9,6,6,2,1,0,4
Greater Western Sydney,"Reid, Sam",1,1,0,0,0,0,0,0
Greater Western Sydney,"Scully, Tom",26,11,3,15,0,0,0,5
Greater Western Sydney,"Shaw, Heath",23,18,7,5,0,0,0,0
Greater Western Sydney,"Shiel, Dylan",27,10,2,17,0,1,0,7
Greater Western Sydney,"Smith, Devon",24,13,3,11,0,1,0,5
Greater Western Sydney,"Taranto, Tim",21,9,1,12,0,2,0,5
Greater Western Sydney,"Tomlinson, Adam",11,6,4,5,0,0,0,3
Greater Western Sydney,"Ward, Callan",18,9,2,9,0,0,0,6
Greater Western Sydney,"Whitfield, Lachie",25,11,6,14,0,1,0,4
Greater Western Sydney,"Williams, Zac",23,13,1,10,0,0,0,5
Greater Western Sydney,"Wilson, Nathan",23,20,7,3,0,0,0,3
Greater Western Sydney,"Cameron, Jeremy",14,8,5,6,3,0,0,0
Greater Western Sydney,"Corr, Aidan",16,12,4,4,0,0,0,3
Greater Western Sydney,"Davis, Phil",7,5,4,2,0,0,0,1
Greater Western Sydney,"Greene, Toby",17,13,5,4,1,2,0,3
Greater Western Sydney,"Johnson, Steve",11,8,5,3,0,0,0,1
Greater Western Sydney,"Kelly, Josh",32,17,2,15,0,0,0,5
Greater Western Sydney,"Lloyd, Daniel",13,4,2,9,0,0,0,2
Greater Western Sydney,"Lobb, Rory",7,5,4,2,1,0,1,1
Greater Western Sydney,"Mumford, Shane",5,1,1,4,0,1,40,6
Greater Western Sydney,"Patton, Jonathon",9,4,4,5,0,1,0,1
Greater Western Sydney,"Perryman, Harry",7,4,3,3,0,0,0,7
Greater Western Sydney,"Reid, Sam",13,8,3,5,2,2,0,2
Greater Western Sydney,"Scully, Tom",24,11,2,13,1,1,0,1
Greater Western Sydney,"Shaw, Heath",19,13,4,6,0,0,0,2
Greater Western Sydney,"Shiel, Dylan",28,15,6,13,0,0,0,1
Greater Western Sydney,"Taranto, Tim",19,11,4,8,1,1,0,4
Greater Western Sydney,"Tomlinson, Adam",16,9,4,7,0,0,0,2
Greater Western Sydney,"Ward, Callan",15,5,1,10,0,0,0,8
Greater Western Sydney,"Whitfield, Lachie",30,13,7,17,0,0,0,4
Greater Western Sydney,"Williams, Zac",15,9,1,6,1,0,0,3
Greater Western Sydney,"Wilson, Nathan",20,18,4,2,0,0,0,2
Greater Western Sydney,"de Boer, Matt",17,9,3,8,1,0,0,5
Greater Western Sydney,"Cameron, Jeremy",17,8,7,9,2,0,0,3
Greater Western Sydney,"Corr, Aidan",14,9,4,5,0,0,0,2
Greater Western Sydney,"Davis, Phil",14,6,3,8,0,0,0,1
Greater Western Sydney,"Greene, Toby",25,14,7,11,2,3,0,4
Greater Western Sydney,"Himmelberg, Harry",14,7,3,7,1,1,1,4
Greater Western Sydney,"Kelly, Josh",29,13,4,16,1,1,0,6
Greater Western Sydney,"Kennedy, Matthew",28,13,4,15,0,0,0,3
Greater Western Sydney,"Lloyd, Daniel",12,9,4,3,1,0,0,2
Greater Western Sydney,"Mohr, Tim",9,7,4,2,0,0,0,1
Greater Western Sydney,"Mumford, Shane",13,3,2,10,0,0,50,4
Greater Western Sydney,"Patton, Jonathon",10,8,7,2,2,1,1,0
Greater Western Sydney,"Perryman, Harry",10,2,1,8,0,0,0,0
Greater Western Sydney,"Reid, Sam",13,8,0,5,0,1,0,3
Greater Western Sydney,"Shaw, Heath",23,18,9,5,0,0,0,1
Greater Western Sydney,"Shiel, Dylan",26,14,1,12,2,1,0,2
Greater Western Sydney,"Taranto, Tim",18,8,2,10,1,0,0,4
Greater Western Sydney,"Tomlinson, Adam",12,8,6,4,0,0,0,4
Greater Western Sydney,"Ward, Callan",33,15,5,18,0,0,0,6
Greater Western Sydney,"Whitfield, Lachie",22,15,7,7,1,0,0,0
Greater Western Sydney,"Williams, Zac",28,16,3,12,1,1,0,2
Greater Western Sydney,"Wilson, Nathan",20,17,7,3,0,0,0,1
Greater Western Sydney,"de Boer, Matt",10,1,0,9,0,0,0,6
Greater Western Sydney,"Cameron, Jeremy",18,13,9,5,1,3,0,3
Greater Western Sydney,"Corr, Aidan",7,3,2,4,0,0,0,4
Greater Western Sydney,"Davis, Phil",11,7,6,4,0,0,0,2
Greater Western Sydney,"Greene, Toby",20,16,6,4,3,2,0,1
Greater Western Sydney,"Himmelberg, Harry",10,6,3,4,0,0,0,1
Greater Western Sydney,"Kelly, Josh",38,22,5,16,1,1,0,10
Greater Western Sydney,"Kennedy, Matthew",13,5,5,8,1,0,0,6
Greater Western Sydney,"Lloyd, Daniel",6,4,1,2,1,0,0,2
Greater Western Sydney,"Mumford, Shane",10,2,1,8,0,0,34,3
Greater Western Sydney,"Patton, Jonathon",12,9,8,3,0,0,3,0
Greater Western Sydney,"Perryman, Harry",12,7,4,5,1,0,0,2
Greater Western Sydney,"Reid, Sam",10,6,0,4,0,0,0,1
Greater Western Sydney,"Scully, Tom",15,9,4,6,3,0,0,0
Greater Western Sydney,"Shaw, Heath",27,20,14,7,0,0,0,0
Greater Western Sydney,"Shiel, Dylan",31,16,6,15,1,0,0,5
Greater Western Sydney,"Taranto, Tim",17,7,5,10,1,0,0,4
Greater Western Sydney,"Tomlinson, Adam",14,11,4,3,0,0,0,1
Greater Western Sydney,"Ward, Callan",22,15,5,7,0,0,0,3
Greater Western Sydney,"Whitfield, Lachie",31,14,10,17,1,0,0,1
Greater Western Sydney,"Williams, Zac",25,16,6,9,3,1,0,7
Greater Western Sydney,"Wilson, Nathan",16,15,5,1,0,0,0,2
Greater Western Sydney,"de Boer, Matt",14,6,6,8,1,0,0,1
Greater Western Sydney,"Cameron, Jeremy",11,8,6,3,1,0,0,3
Greater Western Sydney,"Corr, Aidan",17,9,5,8,0,0,0,2
Greater Western Sydney,"Davis, Phil",13,4,6,9,0,0,0,1
Greater Western Sydney,"Greene, Toby",23,14,10,9,0,5,0,5
Greater Western Sydney,"Himmelberg, Harry",9,7,1,2,0,0,0,2
Greater Western Sydney,"Johnson, Steve",17,10,6,7,0,1,0,3
Greater Western Sydney,"Kelly, Josh",29,10,1,19,0,2,0,10
Greater Western Sydney,"Kennedy, Matthew",18,10,3,8,0,0,0,5
Greater Western Sydney,"Mumford, Shane",12,3,3,9,0,0,30,7
Greater Western Sydney,"Patton, Jonathon",10,6,3,4,2,0,0,1
Greater Western Sydney,"Perryman, Harry",7,3,3,4,0,0,0,3
Greater Western Sydney,"Reid, Sam",11,4,2,7,0,1,0,1
Greater Western Sydney,"Scully, Tom",25,9,3,16,0,1,0,2
Greater Western Sydney,"Shaw, Heath",25,17,9,8,0,0,0,1
Greater Western Sydney,"Shiel, Dylan",32,18,3,14,2,1,0,4
Greater Western Sydney,"Taranto, Tim",9,3,1,6,1,0,0,4
Greater Western Sydney,"Tomlinson, Adam",13,5,2,8,0,0,0,0
Greater Western Sydney,"Ward, Callan",26,14,6,12,1,1,0,1
Greater Western Sydney,"Whitfield, Lachie",29,11,10,18,1,1,0,5
Greater Western Sydney,"Williams, Zac",18,14,2,4,0,1,0,1
Greater Western Sydney,"Wilson, Nathan",17,11,4,6,0,0,0,2
Greater Western Sydney,"de Boer, Matt",17,6,6,11,1,0,0,6
Greater Western Sydney,"Cameron, Jeremy",21,15,11,6,4,2,0,4
Greater Western Sydney,"Corr, Aidan",10,7,4,3,0,0,0,1
Greater Western Sydney,"Davis, Phil",10,6,7,4,0,1,0,1
Greater Western Sydney,"Greene, Toby",20,15,8,5,4,0,0,3
Greater Western Sydney,"Haynes, Nick",9,7,3,2,0,0,0,0
Greater Western Sydney,"Himmelberg, Harry",8,2,2,6,1,0,0,1
Greater Western Sydney,"Johnson, Steve",20,15,6,5,2,4,0,7
Greater Western Sydney,"Kennedy, Matthew",17,3,1,14,0,0,0,2
Greater Western Sydney,"Lloyd, Daniel",10,4,4,6,1,0,0,1
Greater Western Sydney,"Mumford, Shane",12,4,1,8,0,0,31,4
Greater Western Sydney,"Patton, Jonathon",23,15,13,8,4,2,3,1
Greater Western Sydney,"Reid, Sam",17,9,3,8,2,0,0,0
Greater Western Sydney,"Scully, Tom",21,8,6,13,0,1,0,1
Greater Western Sydney,"Shaw, Heath",9,7,1,2,0,0,0,1
Greater Western Sydney,"Shiel, Dylan",38,17,3,21,1,1,0,3
Greater Western Sydney,"Taranto, Tim",9,4,1,5,1,0,0,0
Greater Western Sydney,"Tomlinson, Adam",9,7,4,2,0,0,0,1
Greater Western Sydney,"Ward, Callan",28,15,6,13,1,0,0,7
Greater Western Sydney,"Whitfield, Lachie",29,15,5,14,0,0,0,4
Greater Western Sydney,"Williams, Zac",16,9,1,7,1,0,0,0
Greater Western Sydney,"Wilson, Nathan",17,13,8,4,0,1,0,2
Greater Western Sydney,"de Boer, Matt",14,3,2,11,0,1,0,2
Greater Western Sydney,"Cameron, Jeremy",19,10,7,9,1,0,0,1
Greater Western Sydney,"Corr, Aidan",12,8,3,4,0,0,0,5
Greater Western Sydney,"Davis, Phil",14,8,5,6,0,0,0,4
Greater Western Sydney,"Finlayson, Jeremy",4,0,0,4,0,0,0,3
Greater Western Sydney,"Haynes, Nick",26,19,9,7,0,0,0,2
Greater Western Sydney,"Johnson, Steve",17,11,4,6,1,1,0,6
Greater Western Sydney,"Kelly, Josh",33,8,4,25,0,0,0,3
Greater Western Sydney,"Kennedy, Matthew",14,2,2,12,0,0,0,3
Greater Western Sydney,"Lloyd, Daniel",12,9,2,3,0,0,0,3
Greater Western Sydney,"Lobb, Rory",12,5,6,7,1,2,10,0
Greater Western Sydney,"Mumford, Shane",11,3,1,8,0,0,32,7
Greater Western Sydney,"Patton, Jonathon",13,9,6,4,4,1,0,4
Greater Western Sydney,"Reid, Sam",11,4,0,7,0,0,0,2
Greater Western Sydney,"Scully, Tom",26,10,2,16,0,1,0,3
Greater Western Sydney,"Shaw, Heath",23,15,6,8,0,0,0,2
Greater Western Sydney,"Shiel, Dylan",27,12,2,15,0,0,0,2
Greater Western Sydney,"Smith, Devon",13,6,2,7,0,0,0,7
Greater Western Sydney,"Tomlinson, Adam",18,14,7,4,0,0,0,0
Greater Western Sydney,"Ward, Callan",33,13,3,20,1,0,0,6
Greater Western Sydney,"Whitfield, Lachie",27,18,5,9,1,0,0,8
Greater Western Sydney,"Wilson, Nathan",25,18,8,7,1,0,0,3
Greater Western Sydney,"de Boer, Matt",14,4,2,10,0,0,0,5
Greater Western Sydney,"Cameron, Jeremy",16,14,6,2,1,1,0,4
Greater Western Sydney,"Corr, Aidan",12,9,9,3,0,0,0,1
Greater Western Sydney,"Davis, Phil",10,6,6,4,0,0,0,4
Greater Western Sydney,"Haynes, Nick",14,9,7,5,0,0,0,0
Greater Western Sydney,"Kelly, Josh",34,11,5,23,1,2,0,10
Greater Western Sydney,"Kennedy, Matthew",25,11,6,14,0,0,0,6
Greater Western Sydney,"Lloyd, Daniel",11,7,4,4,0,1,0,2
Greater Western Sydney,"Lobb, Rory",11,6,3,5,1,0,10,5
Greater Western Sydney,"Mumford, Shane",6,1,0,5,0,0,33,6
Greater Western Sydney,"Mzungu, Tendai",15,7,3,8,1,1,0,7
Greater Western Sydney,"Patton, Jonathon",14,12,10,2,5,0,0,3
Greater Western Sydney,"Perryman, Harry",13,10,6,3,0,0,0,2
Greater Western Sydney,"Reid, Sam",6,3,2,3,0,0,0,2
Greater Western Sydney,"Scully, Tom",25,10,5,15,2,0,0,1
Greater Western Sydney,"Shaw, Heath",26,18,13,8,0,0,0,2
Greater Western Sydney,"Shiel, Dylan",31,9,0,22,0,2,0,7
Greater Western Sydney,"Smith, Devon",21,9,4,12,2,0,0,4
Greater Western Sydney,"Tomlinson, Adam",24,22,14,2,0,0,0,0
Greater Western Sydney,"Ward, Callan",32,19,4,13,1,0,0,8
Greater Western Sydney,"Whitfield, Lachie",20,16,4,4,1,0,0,3
Greater Western Sydney,"Wilson, Nathan",17,13,5,4,0,0,0,3
Greater Western Sydney,"de Boer, Matt",17,6,6,11,0,0,0,4
Greater Western Sydney,"Corr, Aidan",7,3,3,4,0,0,0,4
Greater Western Sydney,"Davis, Phil",7,3,2,4,0,0,0,1
Greater Western Sydney,"Greene, Toby",17,11,5,6,2,1,0,4
Greater Western Sydney,"Haynes, Nick",19,14,6,5,0,0,0,2
Greater Western Sydney,"Johnson, Steve",13,7,3,6,2,0,0,5
Greater Western Sydney,"Kelly, Josh",27,20,3,7,2,2,0,4
Greater Western Sydney,"Kennedy, Matthew",15,2,0,13,0,0,0,7
Greater Western Sydney,"Lobb, Rory",10,10,8,0,0,0,14,0
Greater Western Sydney,"Mumford, Shane",12,4,0,8,2,0,37,9
Greater Western Sydney,"Mzungu, Tendai",9,4,1,5,0,1,0,1
Greater Western Sydney,"Patton, Jonathon",18,11,7,7,2,2,0,1
Greater Western Sydney,"Perryman, Harry",20,13,5,7,0,0,0,6
Greater Western Sydney,"Scully, Tom",28,14,2,14,1,1,0,3
Greater Western Sydney,"Shaw, Heath",23,18,3,5,0,0,0,1
Greater Western Sydney,"Shiel, Dylan",32,15,6,17,0,1,0,5
Greater Western Sydney,"Smith, Devon",15,7,2,8,1,0,0,5
Greater Western Sydney,"Tomlinson, Adam",15,12,6,3,0,0,0,1
Greater Western Sydney,"Ward, Callan",32,11,1,21,0,0,0,2
Greater Western Sydney,"Whitfield, Lachie",23,11,2,12,0,0,0,7
Greater Western Sydney,"Williams, Zac",25,13,3,12,0,0,0,3
Greater Western Sydney,"Wilson, Nathan",8,6,1,2,0,0,0,2
Greater Western Sydney,"de Boer, Matt",2,0,0,2,0,0,0,1
Greater Western Sydney,"Corr, Aidan",16,9,4,7,0,0,0,1
Greater Western Sydney,"Davis, Phil",23,18,7,5,0,0,0,3
Greater Western Sydney,"Greene, Toby",17,13,7,4,1,0,0,1
Greater Western Sydney,"Haynes, Nick",14,9,3,5,1,0,0,0
Greater Western Sydney,"Johnson, Steve",9,6,4,3,0,0,0,3
Greater Western Sydney,"Kelly, Josh",23,10,3,13,1,2,0,6
Greater Western Sydney,"Kennedy, Matthew",15,10,5,5,0,0,0,4
Greater Western Sydney,"Lobb, Rory",7,3,1,4,0,0,11,1
Greater Western Sydney,"Mumford, Shane",12,2,3,10,0,0,33,6
Greater Western Sydney,"Mzungu, Tendai",10,6,3,4,0,0,0,1
Greater Western Sydney,"Patton, Jonathon",12,7,4,5,1,1,0,2
Greater Western Sydney,"Perryman, Harry",14,9,5,5,0,0,0,4
Greater Western Sydney,"Scully, Tom",21,8,3,13,0,1,0,5
Greater Western Sydney,"Setterfield, Will",12,8,3,4,0,2,0,6
Greater Western Sydney,"Shaw, Heath",17,17,4,0,0,0,0,1
Greater Western Sydney,"Shiel, Dylan",22,12,1,10,0,0,0,1
Greater Western Sydney,"Smith, Devon",23,12,4,11,0,1,0,6
Greater Western Sydney,"Tomlinson, Adam",13,9,5,4,0,0,0,2
Greater Western Sydney,"Ward, Callan",37,23,2,14,1,0,0,2
Greater Western Sydney,"Whitfield, Lachie",22,14,6,8,1,0,0,0
Greater Western Sydney,"Williams, Zac",28,19,7,9,0,0,0,2
Greater Western Sydney,"Wilson, Nathan",22,18,8,4,0,0,0,0
Greater Western Sydney,"Cameron, Jeremy",16,13,5,3,1,3,0,0
Greater Western Sydney,"Coniglio, Stephen",27,15,5,12,0,2,0,6
Greater Western Sydney,"Corr, Aidan",12,10,5,2,0,0,0,2
Greater Western Sydney,"Davis, Phil",12,8,8,4,0,0,0,1
Greater Western Sydney,"Haynes, Nick",19,11,6,8,1,0,0,1
Greater Western Sydney,"Kelly, Josh",27,14,4,13,1,1,0,1
Greater Western Sydney,"Kennedy, Matthew",15,6,5,9,2,0,0,2
Greater Western Sydney,"Lobb, Rory",11,7,7,4,2,0,14,6
Greater Western Sydney,"Patton, Jonathon",9,8,1,1,2,3,0,1
Greater Western Sydney,"Perryman, Harry",11,8,7,3,0,0,0,2
Greater Western Sydney,"Scully, Tom",20,5,2,15,1,0,0,1
Greater Western Sydney,"Setterfield, Will",6,4,2,2,0,0,0,4
Greater Western Sydney,"Shaw, Heath",16,13,3,3,0,1,0,2
Greater Western Sydney,"Shiel, Dylan",26,11,5,15,0,1,0,3
Greater Western Sydney,"Simpson, Dawson",9,5,4,4,0,1,44,5
Greater Western Sydney,"Smith, Devon",22,8,0,14,1,2,0,4
Greater Western Sydney,"Tomlinson, Adam",11,9,4,2,0,0,0,3
Greater Western Sydney,"Ward, Callan",20,11,7,9,0,1,0,4
Greater Western Sydney,"Whitfield, Lachie",24,15,4,9,1,1,0,2
Greater Western Sydney,"Williams, Zac",20,13,5,7,0,0,0,3
Greater Western Sydney,"Wilson, Nathan",15,13,5,2,0,0,0,1
Greater Western Sydney,"de Boer, Matt",19,8,1,11,1,0,0,5
Greater Western Sydney,"Coniglio, Stephen",28,14,1,14,1,0,0,6
Greater Western Sydney,"Corr, Aidan",15,9,1,6,0,0,0,2
Greater Western Sydney,"Davis, Phil",11,6,2,5,0,0,0,5
Greater Western Sydney,"Deledio, Brett",8,8,3,0,1,2,0,5
Greater Western Sydney,"Haynes, Nick",17,12,2,5,0,0,0,4
Greater Western Sydney,"Himmelberg, Harry",12,4,2,8,1,0,0,5
Greater Western Sydney,"Hopper, Jacob",17,7,0,10,0,0,0,9
Greater Western Sydney,"Johnson, Steve",18,12,5,6,2,1,0,2
Greater Western Sydney,"Kelly, Josh",27,15,3,12,3,2,0,9
Greater Western Sydney,"Kennedy, Matthew",20,10,2,10,0,0,0,6
Greater Western Sydney,"Lobb, Rory",16,7,2,9,0,0,12,3
Greater Western Sydney,"Mumford, Shane",11,2,1,9,1,0,46,13
Greater Western Sydney,"Scully, Tom",24,9,1,15,1,0,0,8
Greater Western Sydney,"Shaw, Heath",16,10,8,6,0,0,0,3
Greater Western Sydney,"Shiel, Dylan",25,13,2,12,1,0,0,5
Greater Western Sydney,"Smith, Devon",9,8,2,1,2,1,0,11
Greater Western Sydney,"Tomlinson, Adam",12,7,2,5,0,0,0,1
Greater Western Sydney,"Ward, Callan",29,15,3,14,1,1,0,5
Greater Western Sydney,"Whitfield, Lachie",18,12,6,6,0,2,0,4
Greater Western Sydney,"Williams, Zac",20,10,1,10,0,0,0,5
Greater Western Sydney,"Wilson, Nathan",21,15,2,6,0,2,0,2
Greater Western Sydney,"de Boer, Matt",13,1,2,12,0,1,0,6
Greater Western Sydney,"Coniglio, Stephen",25,12,2,13,1,1,0,6
Greater Western Sydney,"Corr, Aidan",13,10,7,3,0,0,0,0
Greater Western Sydney,"Davis, Phil",21,9,6,12,0,0,0,0
Greater Western Sydney,"Deledio, Brett",13,5,3,8,0,0,0,2
Greater Western Sydney,"Greene, Toby",16,9,6,7,2,0,0,3
Greater Western Sydney,"Haynes, Nick",21,16,11,5,0,0,0,1
Greater Western Sydney,"Himmelberg, Harry",12,4,5,8,0,0,0,2
Greater Western Sydney,"Hopper, Jacob",16,10,6,6,1,1,0,4
Greater Western Sydney,"Johnson, Steve",13,4,5,9,0,1,0,4
Greater Western Sydney,"Kelly, Josh",25,10,4,15,2,1,0,6
Greater Western Sydney,"Kennedy, Matthew",13,9,5,4,0,0,0,1
Greater Western Sydney,"Lobb, Rory",13,7,7,6,1,0,8,3
Greater Western Sydney,"Patton, Jonathon",15,11,8,4,4,1,0,0
Greater Western Sydney,"Scully, Tom",20,6,1,14,0,0,0,4
Greater Western Sydney,"Shaw, Heath",18,15,7,3,0,0,0,1
Greater Western Sydney,"Shiel, Dylan",30,18,3,12,0,1,0,5
Greater Western Sydney,"Simpson, Dawson",4,0,1,4,0,0,33,6
Greater Western Sydney,"Ward, Callan",19,14,3,5,1,1,0,3
Greater Western Sydney,"Whitfield, Lachie",22,12,6,10,2,0,0,2
Greater Western Sydney,"Williams, Zac",27,23,6,4,0,0,0,4
Greater Western Sydney,"Wilson, Nathan",17,14,6,3,0,0,0,3
Greater Western Sydney,"de Boer, Matt",12,3,2,9,2,0,0,2
Greater Western Sydney,"Cameron, Jeremy",15,9,7,6,0,1,0,0
Greater Western Sydney,"Coniglio, Stephen",28,16,4,12,0,1,0,3
Greater Western Sydney,"Corr, Aidan",14,10,4,4,0,0,0,1
Greater Western Sydney,"Davis, Phil",12,7,2,5,0,0,0,2
Greater Western Sydney,"Deledio, Brett",18,7,5,11,2,0,0,3
Greater Western Sydney,"Greene, Toby",17,12,5,5,3,2,0,2
Greater Western Sydney,"Haynes, Nick",17,11,8,6,0,0,0,2
Greater Western Sydney,"Himmelberg, Harry",12,3,4,9,0,0,1,0
Greater Western Sydney,"Hopper, Jacob",13,3,1,10,0,1,0,4
Greater Western Sydney,"Kelly, Josh",43,18,3,25,1,0,0,2
Greater Western Sydney,"Mumford, Shane",10,1,2,9,1,0,35,4
Greater Western Sydney,"Patton, Jonathon",9,8,8,1,1,2,0,1
Greater Western Sydney,"Scully, Tom",21,13,5,8,1,0,0,2
Greater Western Sydney,"Shaw, Heath",25,17,7,8,0,0,0,1
Greater Western Sydney,"Shiel, Dylan",21,11,1,10,1,0,0,3
Greater Western Sydney,"Smith, Devon",13,7,5,6,0,1,0,4
Greater Western Sydney,"Tomlinson, Adam",9,6,4,3,0,0,0,0
Greater Western Sydney,"Ward, Callan",32,19,4,13,0,0,0,4
Greater Western Sydney,"Whitfield, Lachie",31,21,10,10,1,0,0,3
Greater Western Sydney,"Williams, Zac",22,10,2,12,0,0,0,2
Greater Western Sydney,"Wilson, Nathan",24,17,1,7,1,0,0,2
Greater Western Sydney,"de Boer, Matt",11,4,2,7,0,0,0,3
Greater Western Sydney,"Cameron, Jeremy",12,7,6,5,3,0,0,1
Greater Western Sydney,"Coniglio, Stephen",18,10,4,8,0,0,0,6
Greater Western Sydney,"Corr, Aidan",9,7,4,2,0,0,0,3
Greater Western Sydney,"Davis, Phil",10,8,3,2,0,0,0,5
Greater Western Sydney,"Deledio, Brett",20,11,8,9,1,0,0,5
Greater Western Sydney,"Greene, Toby",16,11,5,5,3,2,0,2
Greater Western Sydney,"Haynes, Nick",11,7,5,4,0,0,0,2
Greater Western Sydney,"Hopper, Jacob",11,6,2,5,0,0,0,8
Greater Western Sydney,"Johnson, Steve",8,4,1,4,0,0,0,2
Greater Western Sydney,"Kelly, Josh",23,14,3,9,0,0,0,9
Greater Western Sydney,"Lobb, Rory",17,9,3,8,0,1,12,4
Greater Western Sydney,"Mumford, Shane",11,1,3,10,0,0,30,4
Greater Western Sydney,"Patton, Jonathon",11,7,7,4,1,1,0,1
Greater Western Sydney,"Scully, Tom",13,3,2,10,0,0,0,2
Greater Western Sydney,"Shaw, Heath",14,9,2,5,0,0,0,1
Greater Western Sydney,"Shiel, Dylan",24,10,2,14,0,0,0,4
Greater Western Sydney,"Smith, Devon",14,9,3,5,0,2,0,3
Greater Western Sydney,"Tomlinson, Adam",13,8,3,5,0,0,0,1
Greater Western Sydney,"Ward, Callan",37,22,7,15,0,2,0,2
Greater Western Sydney,"Whitfield, Lachie",18,9,4,9,0,0,0,4
Greater Western Sydney,"Williams, Zac",23,10,0,13,0,1,0,5
Greater Western Sydney,"Wilson, Nathan",16,8,3,8,0,0,0,2
Greater Western Sydney,"Cameron, Jeremy",7,5,3,2,0,0,0,1
Greater Western Sydney,"Coniglio, Stephen",27,15,2,12,2,0,0,11
Greater Western Sydney,"Corr, Aidan",12,4,3,8,0,0,0,1
Greater Western Sydney,"Davis, Phil",10,5,1,5,0,0,0,3
Greater Western Sydney,"Deledio, Brett",13,3,1,10,0,0,0,5
Greater Western Sydney,"Greene, Toby",16,13,4,3,1,0,0,5
Greater Western Sydney,"Haynes, Nick",13,11,2,2,0,0,0,1
Greater Western Sydney,"Himmelberg, Harry",13,7,3,6,1,1,0,8
Greater Western Sydney,"Hopper, Jacob",18,5,1,13,0,1,0,10
Greater Western Sydney,"Kelly, Josh",33,17,6,16,0,2,0,7
Greater Western Sydney,"Lobb, Rory",8,4,4,4,0,1,3,2
Greater Western Sydney,"Mumford, Shane",3,1,0,2,0,0,38,7
Greater Western Sydney,"Patton, Jonathon",10,4,6,6,0,2,4,8
Greater Western Sydney,"Scully, Tom",26,7,3,19,0,0,0,7
Greater Western Sydney,"Shaw, Heath",23,18,3,5,0,0,0,1
Greater Western Sydney,"Shiel, Dylan",18,8,0,10,0,0,0,2
Greater Western Sydney,"Tomlinson, Adam",10,5,2,5,0,0,0,2
Greater Western Sydney,"Ward, Callan",32,24,5,8,1,0,0,3
Greater Western Sydney,"Whitfield, Lachie",14,10,4,4,0,0,0,4
Greater Western Sydney,"Williams, Zac",20,14,4,6,0,2,0,8
Greater Western Sydney,"Wilson, Nathan",11,9,2,2,0,0,0,4
Greater Western Sydney,"de Boer, Matt",17,5,4,12,1,0,0,10
Greater Western Sydney,"Coniglio, Stephen",35,14,3,21,1,0,0,7
Greater Western Sydney,"Corr, Aidan",11,6,4,5,0,0,0,1
Greater Western Sydney,"Davis, Phil",10,5,2,5,0,0,0,3
Greater Western Sydney,"Deledio, Brett",15,7,4,8,1,0,0,0
Greater Western Sydney,"Greene, Toby",17,13,8,4,3,1,0,2
Greater Western Sydney,"Haynes, Nick",19,11,5,8,0,0,0,2
Greater Western Sydney,"Himmelberg, Harry",9,4,3,5,1,1,1,3
Greater Western Sydney,"Hopper, Jacob",19,11,4,8,0,0,0,6
Greater Western Sydney,"Johnson, Steve",13,10,4,3,6,0,0,2
Greater Western Sydney,"Kelly, Josh",33,12,3,21,0,1,0,8
Greater Western Sydney,"Lobb, Rory",11,3,3,8,0,0,39,4
Greater Western Sydney,"Patton, Jonathon",23,15,10,8,2,2,7,3
Greater Western Sydney,"Scully, Tom",20,10,6,10,1,0,0,4
Greater Western Sydney,"Shaw, Heath",17,13,5,4,0,0,0,2
Greater Western Sydney,"Shiel, Dylan",25,11,1,14,1,1,0,7
Greater Western Sydney,"Taranto, Tim",17,10,4,7,1,0,0,1
Greater Western Sydney,"Tomlinson, Adam",6,1,1,5,0,0,0,1
Greater Western Sydney,"Ward, Callan",28,19,9,9,1,0,0,5
Greater Western Sydney,"Whitfield, Lachie",28,17,11,11,0,2,0,5
Greater Western Sydney,"Williams, Zac",14,5,1,9,0,0,0,10
Greater Western Sydney,"Wilson, Nathan",18,13,3,5,0,0,0,1
Greater Western Sydney,"de Boer, Matt",13,5,2,8,1,0,0,6
Greater Western Sydney,"Coniglio, Stephen",24,8,8,16,0,0,0,4
Greater Western Sydney,"Corr, Aidan",7,4,2,3,0,0,0,2
Greater Western Sydney,"Davis, Phil",13,6,8,7,0,0,0,2
Greater Western Sydney,"Deledio, Brett",11,8,5,3,0,0,0,4
Greater Western Sydney,"Greene, Toby",19,6,3,13,0,1,0,2
Greater Western Sydney,"Haynes, Nick",20,9,3,11,0,0,0,3
Greater Western Sydney,"Himmelberg, Harry",10,8,3,2,4,1,0,2
Greater Western Sydney,"Hopper, Jacob",27,7,4,20,0,0,0,4
Greater Western Sydney,"Johnson, Steve",15,5,4,10,0,0,0,0
Greater Western Sydney,"Kelly, Josh",28,15,4,13,1,1,0,8
Greater Western Sydney,"Lobb, Rory",9,5,6,4,0,0,31,2
Greater Western Sydney,"Patton, Jonathon",21,11,8,10,1,1,10,1
Greater Western Sydney,"Scully, Tom",25,14,5,11,0,1,0,4
Greater Western Sydney,"Shaw, Heath",22,17,6,5,0,0,0,1
Greater Western Sydney,"Shiel, Dylan",7,4,0,3,0,1,0,0
Greater Western Sydney,"Taranto, Tim",15,10,2,5,0,0,0,6
Greater Western Sydney,"Tomlinson, Adam",26,16,7,10,0,0,0,5
Greater Western Sydney,"Ward, Callan",25,18,3,7,3,1,0,6
Greater Western Sydney,"Whitfield, Lachie",19,12,2,7,0,0,0,0
Greater Western Sydney,"Williams, Zac",21,15,5,6,0,1,0,3
Greater Western Sydney,"Wilson, Nathan",11,9,3,2,0,0,0,1
Greater Western Sydney,"de Boer, Matt",17,4,1,13,0,1,0,7
Hawthorn,"Birchall, Grant",22,12,4,10,0,0,0,1
Hawthorn,"Breust, Luke",16,9,3,7,1,1,0,2
Hawthorn,"Burgoyne, Shaun",22,11,4,11,0,1,0,0
Hawthorn,"Duryea, Taylor",12,7,4,5,0,0,0,0
Hawthorn,"Frawley, James",13,6,5,7,0,0,0,3
Hawthorn,"Gibson, Josh",14,8,3,6,0,0,0,1
Hawthorn,"Gunston, Jack",16,8,5,8,0,0,0,1
Hawthorn,"Hartung, Billy",21,12,3,9,1,1,0,0
Hawthorn,"Henderson, Ricky",21,13,3,8,0,0,0,2
Hawthorn,"Langford, Will",27,17,3,10,0,2,0,3
Hawthorn,"McEvoy, Ben",10,6,3,4,2,0,27,2
Hawthorn,"Mitchell, Tom",37,17,9,20,0,2,0,4
Hawthorn,"OMeara, Jaeger",23,9,3,14,0,3,0,1
Hawthorn,"Puopolo, Paul",13,5,2,8,2,0,0,7
Hawthorn,"Rioli, Cyril",8,7,1,1,1,1,0,3
Hawthorn,"Roughead, Jarryd",12,8,4,4,2,1,0,6
Hawthorn,"Schoenmakers, Ryan",11,9,5,2,1,0,1,1
Hawthorn,"Shiels, Liam",20,11,4,9,1,0,0,2
Hawthorn,"Sicily, James",11,5,4,6,0,0,0,1
Hawthorn,"Smith, Isaac",22,18,5,4,1,0,0,1
Hawthorn,"Stratton, Ben",11,7,3,4,0,0,0,2
Hawthorn,"Vickery, Ty",12,5,2,7,0,2,11,5
Hawthorn,"Birchall, Grant",22,15,7,7,0,0,0,1
Hawthorn,"Breust, Luke",17,12,6,5,4,1,0,1
Hawthorn,"Burgoyne, Shaun",18,11,5,7,0,0,0,2
Hawthorn,"Burton, Ryan",26,15,9,11,0,0,0,4
Hawthorn,"Frawley, James",12,9,4,3,0,0,0,1
Hawthorn,"Gibson, Josh",14,5,2,9,0,0,0,0
Hawthorn,"Gunston, Jack",22,14,7,8,0,1,0,8
Hawthorn,"Henderson, Ricky",24,10,4,14,0,2,0,4
Hawthorn,"Hodge, Luke",24,13,1,11,0,0,0,5
Hawthorn,"Langford, Will",28,11,4,17,0,2,0,2
Hawthorn,"McEvoy, Ben",11,2,3,9,0,0,27,0
Hawthorn,"Miles, Teia",15,7,3,8,0,0,0,2
Hawthorn,"Mitchell, Tom",38,10,2,28,1,0,0,7
Hawthorn,"OMeara, Jaeger",36,6,2,30,0,0,0,1
Hawthorn,"Puopolo, Paul",12,7,1,5,3,0,0,9
Hawthorn,"Rioli, Cyril",13,9,3,4,1,0,2,4
Hawthorn,"Roughead, Jarryd",12,7,4,5,2,2,2,4
Hawthorn,"Shiels, Liam",11,6,0,5,1,0,0,9
Hawthorn,"Smith, Isaac",20,14,4,6,0,0,0,2
Hawthorn,"Stewart, Kade",14,5,2,9,0,0,0,4
Hawthorn,"Stratton, Ben",12,7,5,5,0,0,0,4
Hawthorn,"Vickery, Ty",9,3,3,6,1,0,9,3
Hawthorn,"Brand, Kaiden",17,11,4,6,0,0,0,1
Hawthorn,"Breust, Luke",7,3,1,4,0,1,0,3
Hawthorn,"Burgoyne, Shaun",17,11,8,6,0,1,0,4
Hawthorn,"Burton, Ryan",17,13,4,4,1,0,0,5
Hawthorn,"Frawley, James",12,9,9,3,0,0,0,3
Hawthorn,"Gibson, Josh",20,10,1,10,0,0,0,3
Hawthorn,"Gunston, Jack",15,13,9,2,0,3,0,3
Hawthorn,"Henderson, Ricky",29,14,9,15,0,0,0,2
Hawthorn,"Hodge, Luke",20,12,5,8,0,0,0,3
Hawthorn,"Langford, Will",15,6,0,9,0,0,0,3
Hawthorn,"McEvoy, Ben",9,2,4,7,0,0,28,3
Hawthorn,"Miles, Teia",7,5,3,2,0,0,0,1
Hawthorn,"Mitchell, Tom",27,11,6,16,0,1,0,8
Hawthorn,"OMeara, Jaeger",14,7,3,7,1,0,0,3
Hawthorn,"Puopolo, Paul",9,3,1,6,1,0,0,1
Hawthorn,"Rioli, Cyril",13,5,4,8,1,1,0,3
Hawthorn,"Roughead, Jarryd",14,10,5,4,3,0,2,3
Hawthorn,"Shiels, Liam",21,9,3,12,0,0,0,7
Hawthorn,"Smith, Isaac",21,16,4,5,0,1,0,7
Hawthorn,"Stratton, Ben",18,9,3,9,0,0,0,0
Hawthorn,"Vickery, Ty",9,3,0,6,0,1,9,4
Hawthorn,"Whitecross, Brendan",12,8,3,4,0,1,0,4
Hawthorn,"Brand, Kaiden",17,13,6,4,0,0,0,3
Hawthorn,"Breust, Luke",13,5,2,8,0,0,0,8
Hawthorn,"Burgoyne, Shaun",21,10,4,11,0,1,0,4
Hawthorn,"Burton, Ryan",19,11,2,8,0,0,0,4
Hawthorn,"Frawley, James",15,9,3,6,0,0,0,2
Hawthorn,"Gibson, Josh",17,7,4,10,0,0,0,1
Hawthorn,"Gunston, Jack",14,6,5,8,2,0,0,5
Hawthorn,"Hardwick, Blake",10,6,5,4,0,0,0,3
Hawthorn,"Hartung, Billy",18,8,4,10,0,1,0,4
Hawthorn,"Henderson, Ricky",21,10,5,11,0,0,0,2
Hawthorn,"Hodge, Luke",35,21,5,14,0,2,0,5
Hawthorn,"Langford, Will",14,4,2,10,0,0,0,3
Hawthorn,"McEvoy, Ben",16,8,7,8,0,0,18,5
Hawthorn,"Mitchell, Tom",32,12,5,20,0,1,0,10
Hawthorn,"OBrien, Tim",5,2,1,3,0,0,6,4
Hawthorn,"Puopolo, Paul",6,3,2,3,1,1,0,5
Hawthorn,"Rioli, Cyril",11,10,3,1,0,1,0,5
Hawthorn,"Roughead, Jarryd",15,7,4,8,0,0,3,1
Hawthorn,"Shiels, Liam",24,11,3,13,0,0,0,3
Hawthorn,"Sicily, James",15,12,10,3,2,2,0,0
Hawthorn,"Smith, Isaac",30,17,9,13,1,0,0,4
Hawthorn,"Stratton, Ben",13,6,2,7,0,0,0,3
Hawthorn,"Brand, Kaiden",19,13,9,6,0,0,0,1
Hawthorn,"Breust, Luke",20,12,4,8,3,1,0,3
Hawthorn,"Burgoyne, Shaun",24,10,3,14,1,0,0,5
Hawthorn,"Burton, Ryan",24,15,6,9,0,0,0,3
Hawthorn,"Frawley, James",18,15,7,3,0,0,0,1
Hawthorn,"Gibson, Josh",21,8,4,13,0,0,0,1
Hawthorn,"Gunston, Jack",21,15,6,6,3,1,0,2
Hawthorn,"Hardwick, Blake",19,10,4,9,0,0,0,0
Hawthorn,"Hartung, Billy",26,13,4,13,0,0,0,2
Hawthorn,"Hodge, Luke",22,11,5,11,0,0,0,2
Hawthorn,"Howe, Daniel",13,6,0,7,0,0,0,9
Hawthorn,"Langford, Will",23,10,2,13,0,0,0,3
Hawthorn,"McEvoy, Ben",17,8,7,9,1,0,43,5
Hawthorn,"Mitchell, Tom",37,12,5,25,0,0,0,6
Hawthorn,"OBrien, Tim",15,9,6,6,3,2,8,2
Hawthorn,"Puopolo, Paul",17,13,1,4,1,1,0,8
Hawthorn,"Rioli, Cyril",15,7,3,8,1,1,0,6
Hawthorn,"Roughead, Jarryd",15,6,3,9,3,0,0,1
Hawthorn,"Shiels, Liam",26,17,6,9,1,1,0,7
Hawthorn,"Sicily, James",17,10,5,7,2,1,0,0
Hawthorn,"Smith, Isaac",25,17,6,8,0,1,0,1
Hawthorn,"Stratton, Ben",22,8,3,14,0,0,0,4
Hawthorn,"Brand, Kaiden",16,11,10,5,0,0,0,1
Hawthorn,"Breust, Luke",14,7,2,7,1,0,0,0
Hawthorn,"Burgoyne, Shaun",22,7,4,15,0,1,0,1
Hawthorn,"Burton, Ryan",16,13,4,3,0,0,0,3
Hawthorn,"Frawley, James",19,11,13,8,0,0,0,0
Hawthorn,"Gibson, Josh",18,12,10,6,0,0,0,0
Hawthorn,"Gunston, Jack",12,10,5,2,1,1,0,1
Hawthorn,"Hardwick, Blake",20,11,8,9,0,0,0,1
Hawthorn,"Hartung, Billy",22,13,9,9,0,1,0,2
Hawthorn,"Hodge, Luke",29,18,9,11,0,0,0,1
Hawthorn,"Howe, Daniel",13,7,2,6,1,0,0,3
Hawthorn,"Langford, Will",13,9,2,4,0,0,0,4
Hawthorn,"McEvoy, Ben",18,6,5,12,2,0,26,2
Hawthorn,"Mitchell, Tom",35,15,6,20,1,0,0,4
Hawthorn,"OBrien, Tim",9,7,4,2,1,0,6,2
Hawthorn,"OMeara, Jaeger",14,6,3,8,0,0,0,5
Hawthorn,"Puopolo, Paul",11,4,1,7,0,0,0,5
Hawthorn,"Roughead, Jarryd",20,7,5,13,0,2,1,1
Hawthorn,"Shiels, Liam",21,12,3,9,0,0,0,4
Hawthorn,"Sicily, James",12,8,6,4,1,2,0,0
Hawthorn,"Smith, Isaac",18,14,5,4,0,0,0,1
Hawthorn,"Stratton, Ben",13,7,4,6,0,0,0,3
Hawthorn,"Birchall, Grant",3,3,2,0,0,0,0,1
Hawthorn,"Breust, Luke",10,6,1,4,1,1,0,8
Hawthorn,"Burgoyne, Shaun",23,11,5,12,1,1,0,4
Hawthorn,"Burton, Ryan",23,14,6,9,0,0,0,4
Hawthorn,"Frawley, James",15,10,7,5,0,0,0,2
Hawthorn,"Gibson, Josh",20,10,5,10,0,0,0,0
Hawthorn,"Gunston, Jack",13,10,3,3,2,0,0,0
Hawthorn,"Hardwick, Blake",18,12,7,6,0,0,0,0
Hawthorn,"Hartung, Billy",20,15,7,5,0,1,0,1
Hawthorn,"Hodge, Luke",26,13,5,13,0,0,0,4
Hawthorn,"Howe, Daniel",14,8,5,6,0,0,0,4
Hawthorn,"Langford, Will",20,15,5,5,1,1,0,9
Hawthorn,"McEvoy, Ben",12,6,4,6,2,0,53,4
Hawthorn,"Mitchell, Tom",31,12,5,19,0,1,0,12
Hawthorn,"OBrien, Tim",13,11,10,2,2,0,4,3
Hawthorn,"Puopolo, Paul",13,3,1,10,0,0,0,6
Hawthorn,"Rioli, Cyril",12,9,3,3,0,1,0,1
Hawthorn,"Roughead, Jarryd",15,11,6,4,4,1,4,4
Hawthorn,"Shiels, Liam",13,9,3,4,0,1,0,4
Hawthorn,"Sicily, James",7,5,3,2,0,0,0,0
Hawthorn,"Smith, Isaac",23,17,9,6,1,2,0,5
Hawthorn,"Stratton, Ben",12,8,4,4,0,0,0,7
Hawthorn,"Breust, Luke",19,14,7,5,1,2,0,5
Hawthorn,"Burgoyne, Shaun",19,11,4,8,1,0,0,4
Hawthorn,"Burton, Ryan",25,16,5,9,0,0,0,2
Hawthorn,"Fitzpatrick, Jack",11,3,4,8,0,0,13,0
Hawthorn,"Frawley, James",12,8,4,4,0,0,0,1
Hawthorn,"Gibson, Josh",12,6,6,6,0,0,0,2
Hawthorn,"Gunston, Jack",15,15,7,0,1,0,0,2
Hawthorn,"Hardwick, Blake",5,3,2,2,0,0,0,1
Hawthorn,"Hartung, Billy",26,15,8,11,1,0,0,0
Hawthorn,"Henderson, Ricky",21,13,9,8,3,1,0,4
Hawthorn,"Hodge, Luke",20,17,9,3,0,0,0,7
Hawthorn,"Howe, Daniel",21,11,10,10,1,0,0,3
Hawthorn,"Langford, Will",16,11,1,5,0,0,0,5
Hawthorn,"McEvoy, Ben",18,8,4,10,1,0,34,4
Hawthorn,"Mitchell, Tom",36,14,6,22,0,0,0,9
Hawthorn,"OBrien, Tim",9,7,5,2,2,1,2,5
Hawthorn,"Puopolo, Paul",20,11,2,9,0,1,0,8
Hawthorn,"Rioli, Cyril",15,9,4,6,1,2,0,0
Hawthorn,"Roughead, Jarryd",19,7,3,12,2,0,1,3
Hawthorn,"Shiels, Liam",25,17,5,8,1,1,0,8
Hawthorn,"Smith, Isaac",16,11,3,5,2,0,0,0
Hawthorn,"Stratton, Ben",3,2,3,1,0,0,0,1
Hawthorn,"Breust, Luke",15,11,1,4,3,0,0,2
Hawthorn,"Burgoyne, Shaun",15,8,2,7,0,0,0,2
Hawthorn,"Burton, Ryan",16,13,9,3,0,0,0,3
Hawthorn,"Duryea, Taylor",14,11,6,3,0,0,0,3
Hawthorn,"Gibson, Josh",8,3,4,5,0,0,0,0
Hawthorn,"Gunston, Jack",17,10,4,7,0,1,0,6
Hawthorn,"Hardwick, Blake",16,9,6,7,0,0,0,4
Hawthorn,"Hartung, Billy",15,7,3,8,0,0,0,2
Hawthorn,"Heatherley, Kurt",11,6,4,5,0,0,0,4
Hawthorn,"Henderson, Ricky",21,16,9,5,0,0,0,0
Hawthorn,"Hodge, Luke",20,13,6,7,0,0,0,3
Hawthorn,"Howe, Daniel",14,9,3,5,0,0,0,8
Hawthorn,"Langford, Will",16,10,3,6,0,0,0,4
Hawthorn,"McEvoy, Ben",11,2,0,9,1,0,37,7
Hawthorn,"Mitchell, Tom",50,22,8,28,0,1,0,8
Hawthorn,"Puopolo, Paul",15,6,1,9,2,0,0,13
Hawthorn,"Roughead, Jarryd",18,10,6,8,0,1,1,3
Hawthorn,"Shiels, Liam",25,15,3,10,1,0,0,8
Hawthorn,"Sicily, James",12,6,3,6,3,1,0,6
Hawthorn,"Smith, Isaac",26,15,5,11,0,0,0,5
Hawthorn,"Vickery, Ty",5,2,2,3,1,0,14,0
Hawthorn,"Whitecross, Brendan",12,8,5,4,0,1,0,1
Hawthorn,"Brand, Kaiden",20,13,6,7,0,0,0,0
Hawthorn,"Breust, Luke",13,10,3,3,3,0,0,5
Hawthorn,"Burgoyne, Shaun",26,9,4,17,2,0,0,5
Hawthorn,"Burton, Ryan",20,16,9,4,0,0,0,0
Hawthorn,"Cousins, James",14,7,1,7,1,0,0,6
Hawthorn,"Duryea, Taylor",16,14,10,2,0,0,0,3
Hawthorn,"Gibson, Josh",18,10,8,8,0,0,0,2
Hawthorn,"Gunston, Jack",20,12,4,8,1,0,0,3
Hawthorn,"Hardwick, Blake",15,10,8,5,0,0,0,0
Hawthorn,"Henderson, Ricky",24,10,8,14,0,0,0,1
Hawthorn,"Hodge, Luke",24,19,8,5,0,0,0,0
Hawthorn,"Howe, Daniel",15,14,10,1,0,0,0,3
Hawthorn,"McEvoy, Ben",9,4,2,5,0,0,41,4
Hawthorn,"Mitchell, Tom",31,17,6,14,0,0,0,5
Hawthorn,"Puopolo, Paul",12,8,1,4,1,0,0,3
Hawthorn,"Roughead, Jarryd",18,12,2,6,1,1,0,3
Hawthorn,"Shiels, Liam",31,18,4,13,0,1,0,10
Hawthorn,"Sicily, James",13,7,3,6,1,2,0,2
Hawthorn,"Smith, Isaac",30,21,11,9,0,1,0,5
Hawthorn,"Vickery, Ty",15,8,5,7,0,1,6,2
Hawthorn,"Whitecross, Brendan",15,12,7,3,2,0,0,2
Hawthorn,"Willsmore, Dallas",9,4,3,5,0,0,0,3
Hawthorn,"Brand, Kaiden",15,7,3,8,0,0,0,1
Hawthorn,"Breust, Luke",13,8,5,5,2,1,0,3
Hawthorn,"Burgoyne, Shaun",15,8,3,7,0,0,0,9
Hawthorn,"Burton, Ryan",25,18,11,7,0,0,0,5
Hawthorn,"Cousins, James",12,10,3,2,0,0,0,6
Hawthorn,"Duryea, Taylor",18,12,5,6,0,0,0,2
Hawthorn,"Gibson, Josh",15,9,6,6,0,0,0,4
Hawthorn,"Gunston, Jack",7,4,2,3,0,0,0,1
Hawthorn,"Hardwick, Blake",10,6,3,4,0,0,0,5
Hawthorn,"Henderson, Ricky",21,11,5,10,0,0,0,4
Hawthorn,"Hodge, Luke",27,17,5,10,0,0,0,2
Hawthorn,"Howe, Daniel",17,8,5,9,0,0,0,1
Hawthorn,"McEvoy, Ben",10,6,4,4,0,0,34,3
Hawthorn,"Mitchell, Tom",30,15,9,15,0,0,0,5
Hawthorn,"Puopolo, Paul",7,4,2,3,1,0,0,3
Hawthorn,"Roughead, Jarryd",18,11,6,7,2,0,0,5
Hawthorn,"Shiels, Liam",20,11,3,9,0,0,0,6
Hawthorn,"Sicily, James",11,5,3,6,2,0,0,3
Hawthorn,"Smith, Isaac",20,11,4,9,0,1,0,4
Hawthorn,"Vickery, Ty",11,8,2,3,0,2,9,3
Hawthorn,"Whitecross, Brendan",13,6,4,7,0,1,0,2
Hawthorn,"Willsmore, Dallas",10,8,6,2,0,0,0,4
Hawthorn,"Brand, Kaiden",9,3,3,6,0,0,0,1
Hawthorn,"Burgoyne, Shaun",24,9,9,15,0,1,0,1
Hawthorn,"Burton, Ryan",19,9,1,10,0,0,0,4
Hawthorn,"Cousins, James",13,5,1,8,0,0,0,1
Hawthorn,"Duryea, Taylor",14,6,4,8,0,0,0,6
Hawthorn,"Gibson, Josh",9,2,0,7,0,0,0,0
Hawthorn,"Gunston, Jack",19,16,12,3,5,1,0,4
Hawthorn,"Hardwick, Blake",10,6,4,4,0,0,0,7
Hawthorn,"Hartung, Billy",25,12,6,13,0,1,0,3
Hawthorn,"Henderson, Ricky",22,14,8,8,1,1,0,2
Hawthorn,"Howe, Daniel",16,8,1,8,0,0,0,2
Hawthorn,"Langford, Will",17,9,3,8,0,0,0,8
Hawthorn,"McEvoy, Ben",11,5,4,6,1,0,32,3
Hawthorn,"Mitchell, Tom",39,13,5,26,1,0,0,8
Hawthorn,"OBrien, Tim",17,13,6,4,2,1,1,3
Hawthorn,"Puopolo, Paul",11,4,1,7,0,1,0,5
Hawthorn,"Roughead, Jarryd",21,10,5,11,0,1,3,4
Hawthorn,"Shiels, Liam",19,8,3,11,0,0,0,10
Hawthorn,"Sicily, James",13,7,3,6,0,0,0,2
Hawthorn,"Smith, Isaac",24,15,4,9,1,0,0,3
Hawthorn,"Stewart, Kade",5,2,1,3,1,0,0,6
Hawthorn,"Whitecross, Brendan",13,5,3,8,0,0,0,6
Hawthorn,"Birchall, Grant",28,18,7,10,0,0,0,1
Hawthorn,"Brand, Kaiden",10,5,5,5,0,0,0,2
Hawthorn,"Breust, Luke",8,4,2,4,0,0,0,1
Hawthorn,"Burgoyne, Shaun",26,15,5,11,2,1,0,6
Hawthorn,"Burton, Ryan",21,13,5,8,2,0,0,1
Hawthorn,"Duryea, Taylor",20,12,8,8,0,0,0,5
Hawthorn,"Gunston, Jack",10,6,3,4,0,2,0,3
Hawthorn,"Hardwick, Blake",19,11,6,8,0,0,0,4
Hawthorn,"Hartung, Billy",21,12,6,9,1,0,0,1
Hawthorn,"Henderson, Ricky",30,16,8,14,2,0,0,2
Hawthorn,"Hodge, Luke",22,11,3,11,0,0,0,2
Hawthorn,"Howe, Daniel",15,7,1,8,0,0,0,5
Hawthorn,"Langford, Will",22,14,3,8,1,2,0,5
Hawthorn,"McEvoy, Ben",8,3,2,5,0,0,36,5
Hawthorn,"Mitchell, Tom",38,10,4,28,1,1,0,5
Hawthorn,"OBrien, Tim",8,7,0,1,2,0,4,0
Hawthorn,"Puopolo, Paul",15,8,4,7,2,0,0,3
Hawthorn,"Roughead, Jarryd",20,10,5,10,1,2,1,4
Hawthorn,"Schoenmakers, Ryan",13,8,5,5,0,1,0,2
Hawthorn,"Shiels, Liam",21,9,3,12,0,0,0,7
Hawthorn,"Sicily, James",25,11,10,14,0,0,0,0
Hawthorn,"Smith, Isaac",19,10,2,9,0,1,0,4
Hawthorn,"Birchall, Grant",20,11,6,9,0,0,0,2
Hawthorn,"Brand, Kaiden",20,13,11,7,0,0,0,2
Hawthorn,"Breust, Luke",18,11,6,7,2,1,0,6
Hawthorn,"Burgoyne, Shaun",23,10,5,13,1,0,0,5
Hawthorn,"Burton, Ryan",29,15,6,14,0,0,0,3
Hawthorn,"Duryea, Taylor",18,12,5,6,2,2,0,3
Hawthorn,"Gunston, Jack",21,8,3,13,1,0,0,7
Hawthorn,"Hardwick, Blake",19,9,5,10,0,0,0,3
Hawthorn,"Hartung, Billy",22,11,8,11,0,0,0,1
Hawthorn,"Heatherley, Kurt",15,6,4,9,0,0,0,2
Hawthorn,"Henderson, Ricky",18,10,7,8,1,0,0,5
Hawthorn,"Hodge, Luke",27,18,12,9,0,0,0,0
Hawthorn,"Howe, Daniel",26,13,6,13,0,0,0,8
Hawthorn,"Langford, Will",19,10,4,9,0,1,0,5
Hawthorn,"McEvoy, Ben",9,3,1,6,1,0,32,1
Hawthorn,"Mitchell, Tom",35,14,7,21,2,0,0,6
Hawthorn,"OBrien, Tim",14,11,7,3,2,1,2,1
Hawthorn,"Roughead, Jarryd",19,5,3,14,2,1,1,3
Hawthorn,"Schoenmakers, Ryan",16,11,5,5,2,1,0,0
Hawthorn,"Shiels, Liam",20,15,5,5,1,1,0,4
Hawthorn,"Sicily, James",25,15,11,10,1,0,0,2
Hawthorn,"Smith, Isaac",20,11,4,9,0,1,0,2
Hawthorn,"Brand, Kaiden",15,10,4,5,0,0,0,0
Hawthorn,"Breust, Luke",11,4,3,7,2,1,0,5
Hawthorn,"Burgoyne, Shaun",23,11,4,12,1,1,0,8
Hawthorn,"Burton, Ryan",18,10,5,8,0,0,0,4
Hawthorn,"Duryea, Taylor",9,5,3,4,2,1,0,1
Hawthorn,"Gunston, Jack",17,6,5,11,0,0,0,2
Hawthorn,"Hardwick, Blake",9,2,1,7,0,0,0,8
Hawthorn,"Hartung, Billy",25,14,2,11,0,0,0,2
Hawthorn,"Heatherley, Kurt",9,4,4,5,0,0,0,1
Hawthorn,"Henderson, Ricky",16,10,3,6,2,1,0,0
Hawthorn,"Hodge, Luke",18,9,7,9,0,0,0,2
Hawthorn,"Howe, Daniel",18,7,1,11,0,0,0,4
Hawthorn,"Langford, Will",17,11,6,6,3,2,0,1
Hawthorn,"McEvoy, Ben",13,5,5,8,0,1,53,4
Hawthorn,"Mitchell, Tom",39,17,3,22,1,0,0,9
Hawthorn,"OBrien, Tim",7,6,1,1,1,1,4,1
Hawthorn,"Roughead, Jarryd",17,8,5,9,1,1,0,3
Hawthorn,"Schoenmakers, Ryan",12,10,7,2,0,1,0,1
Hawthorn,"Shiels, Liam",17,8,2,9,0,1,0,6
Hawthorn,"Sicily, James",22,14,7,8,0,0,0,2
Hawthorn,"Smith, Isaac",21,10,1,11,0,1,0,0
Hawthorn,"Stewart, Kade",9,5,2,4,1,1,0,3
Hawthorn,"Brand, Kaiden",17,10,6,7,0,0,0,2
Hawthorn,"Breust, Luke",14,8,3,6,1,4,0,2
Hawthorn,"Burgoyne, Shaun",19,7,2,12,1,0,0,2
Hawthorn,"Burton, Ryan",19,11,3,8,0,1,0,1
Hawthorn,"Duryea, Taylor",17,8,3,9,0,2,0,2
Hawthorn,"Gunston, Jack",24,19,8,5,1,0,0,0
Hawthorn,"Hardwick, Blake",10,7,1,3,0,0,0,3
Hawthorn,"Hartung, Billy",22,7,2,15,0,0,0,0
Hawthorn,"Heatherley, Kurt",12,9,6,3,0,0,0,0
Hawthorn,"Henderson, Ricky",22,10,6,12,0,0,0,1
Hawthorn,"Hodge, Luke",23,15,8,8,1,0,0,0
Hawthorn,"Howe, Daniel",20,11,6,9,0,1,0,10
Hawthorn,"Langford, Will",19,11,7,8,1,1,0,0
Hawthorn,"McEvoy, Ben",10,3,2,7,0,0,30,3
Hawthorn,"Mitchell, Tom",43,16,6,27,2,0,0,3
Hawthorn,"OBrien, Tim",6,3,1,3,1,0,3,2
Hawthorn,"Roughead, Jarryd",21,8,5,13,0,1,0,5
Hawthorn,"Schoenmakers, Ryan",11,5,4,6,2,0,0,4
Hawthorn,"Shiels, Liam",29,13,7,16,1,1,0,6
Hawthorn,"Sicily, James",14,9,5,5,0,0,0,1
Hawthorn,"Smith, Isaac",21,8,7,13,1,2,0,2
Hawthorn,"Stewart, Kade",6,3,2,3,0,0,0,3
Hawthorn,"Brand, Kaiden",18,9,9,9,0,0,0,0
Hawthorn,"Breust, Luke",22,14,5,8,2,0,0,6
Hawthorn,"Burgoyne, Shaun",19,8,5,11,1,1,0,4
Hawthorn,"Burton, Ryan",21,11,5,10,0,0,0,2
Hawthorn,"Duryea, Taylor",17,7,5,10,0,2,0,0
Hawthorn,"Glass, Conor",15,10,5,5,0,0,0,2
Hawthorn,"Gunston, Jack",35,23,8,12,1,0,0,2
Hawthorn,"Hardwick, Blake",23,17,6,6,0,0,0,2
Hawthorn,"Hartung, Billy",20,11,9,9,1,0,0,0
Hawthorn,"Henderson, Ricky",19,13,10,6,2,1,0,2
Hawthorn,"Hodge, Luke",21,13,6,8,0,0,0,3
Hawthorn,"Howe, Daniel",12,7,5,5,2,0,0,6
Hawthorn,"Langford, Will",16,5,2,11,0,1,0,3
Hawthorn,"McEvoy, Ben",14,7,6,7,1,0,29,2
Hawthorn,"Mitchell, Tom",37,16,7,21,0,1,0,5
Hawthorn,"OBrien, Tim",8,5,3,3,1,0,3,4
Hawthorn,"Roughead, Jarryd",20,6,3,14,2,0,0,3
Hawthorn,"Schoenmakers, Ryan",17,9,2,8,1,2,0,1
Hawthorn,"Shiels, Liam",25,11,5,14,0,2,0,5
Hawthorn,"Sicily, James",29,15,11,14,0,0,0,0
Hawthorn,"Smith, Isaac",20,13,6,7,1,0,0,2
Hawthorn,"Whitecross, Brendan",18,7,7,11,0,0,0,1
Hawthorn,"Brand, Kaiden",18,10,6,8,0,0,0,0
Hawthorn,"Breust, Luke",13,5,2,8,0,1,0,8
Hawthorn,"Burgoyne, Shaun",17,11,4,6,2,1,0,5
Hawthorn,"Burton, Ryan",21,13,5,8,0,0,0,2
Hawthorn,"Duryea, Taylor",13,9,7,4,1,0,0,3
Hawthorn,"Glass, Conor",11,7,3,4,0,0,0,1
Hawthorn,"Gunston, Jack",18,13,7,5,0,0,0,0
Hawthorn,"Hardwick, Blake",6,4,1,2,0,0,0,3
Hawthorn,"Hartung, Billy",15,12,5,3,0,1,0,2
Hawthorn,"Henderson, Ricky",12,8,8,4,0,0,0,2
Hawthorn,"Hodge, Luke",23,16,9,7,0,0,0,3
Hawthorn,"Howe, Daniel",19,8,3,11,0,1,0,6
Hawthorn,"Langford, Will",22,14,4,8,0,1,0,1
Hawthorn,"McEvoy, Ben",16,9,8,7,0,0,23,3
Hawthorn,"Mitchell, Tom",26,12,1,14,0,0,0,8
Hawthorn,"OBrien, Tim",16,12,4,4,1,0,3,3
Hawthorn,"Roughead, Jarryd",24,12,8,12,2,1,2,3
Hawthorn,"Schoenmakers, Ryan",10,7,6,3,2,1,0,1
Hawthorn,"Shiels, Liam",28,17,3,11,2,0,0,5
Hawthorn,"Sicily, James",26,16,14,10,0,1,0,0
Hawthorn,"Smith, Isaac",26,16,12,10,0,0,0,3
Hawthorn,"Whitecross, Brendan",16,10,7,6,0,0,0,3
Hawthorn,"Brand, Kaiden",13,6,4,7,0,0,0,0
Hawthorn,"Breust, Luke",14,10,6,4,2,1,0,8
Hawthorn,"Burgoyne, Shaun",21,14,3,7,0,0,0,3
Hawthorn,"Burton, Ryan",18,8,6,10,0,0,0,2
Hawthorn,"Duryea, Taylor",6,2,1,4,0,1,0,6
Hawthorn,"Glass, Conor",14,7,1,7,0,0,0,2
Hawthorn,"Gunston, Jack",23,13,4,10,0,1,0,0
Hawthorn,"Hardwick, Blake",11,5,4,6,0,0,0,1
Hawthorn,"Hartung, Billy",18,11,6,7,0,0,0,5
Hawthorn,"Henderson, Ricky",20,12,3,8,0,1,0,2
Hawthorn,"Howe, Daniel",21,9,2,12,0,0,0,10
Hawthorn,"Langford, Will",9,4,3,5,0,0,0,3
Hawthorn,"McEvoy, Ben",8,2,4,6,0,0,30,2
Hawthorn,"Miles, Teia",14,9,4,5,2,0,0,2
Hawthorn,"Mitchell, Tom",35,9,1,26,1,0,0,3
Hawthorn,"OBrien, Tim",10,6,4,4,0,0,5,4
Hawthorn,"Roughead, Jarryd",23,13,7,10,2,3,0,6
Hawthorn,"Schoenmakers, Ryan",8,5,3,3,2,1,1,2
Hawthorn,"Shiels, Liam",24,8,5,16,0,0,0,2
Hawthorn,"Sicily, James",29,18,10,11,0,0,0,1
Hawthorn,"Smith, Isaac",22,12,9,10,0,0,0,4
Hawthorn,"Whitecross, Brendan",9,4,4,5,0,0,0,1
Hawthorn,"Brand, Kaiden",16,7,7,9,0,0,0,1
Hawthorn,"Breust, Luke",18,14,3,4,4,0,0,7
Hawthorn,"Burgoyne, Shaun",13,5,2,8,2,0,0,5
Hawthorn,"Burton, Ryan",26,17,5,9,0,0,0,2
Hawthorn,"Duryea, Taylor",11,7,2,4,0,1,0,3
Hawthorn,"Glass, Conor",12,7,3,5,0,0,0,4
Hawthorn,"Gunston, Jack",27,22,11,5,1,0,0,3
Hawthorn,"Hardwick, Blake",16,9,5,7,0,0,0,3
Hawthorn,"Hartung, Billy",26,10,5,16,1,0,0,2
Hawthorn,"Henderson, Ricky",23,14,8,9,2,1,0,1
Hawthorn,"Hodge, Luke",29,21,9,8,0,0,0,4
Hawthorn,"Howe, Daniel",20,7,5,13,1,0,0,3
Hawthorn,"Langford, Will",17,9,4,8,0,2,0,3
Hawthorn,"McEvoy, Ben",12,4,6,8,1,0,20,2
Hawthorn,"Miles, Teia",7,4,3,3,1,0,0,0
Hawthorn,"Mitchell, Tom",35,15,5,20,0,1,0,5
Hawthorn,"OBrien, Tim",10,6,4,4,0,0,6,0
Hawthorn,"Roughead, Jarryd",20,8,8,12,3,0,0,1
Hawthorn,"Schoenmakers, Ryan",8,6,5,2,0,1,0,1
Hawthorn,"Shiels, Liam",13,2,1,11,0,0,0,8
Hawthorn,"Sicily, James",27,14,9,13,0,0,0,1
Hawthorn,"Smith, Isaac",29,18,11,11,2,1,0,1
Hawthorn,"Brand, Kaiden",16,11,5,5,0,0,0,1
Hawthorn,"Breust, Luke",11,3,1,8,1,0,0,2
Hawthorn,"Burgoyne, Shaun",20,13,4,7,1,0,0,6
Hawthorn,"Burton, Ryan",23,17,8,6,1,0,0,4
Hawthorn,"Duryea, Taylor",14,9,6,5,1,0,0,1
Hawthorn,"Glass, Conor",10,6,5,4,0,0,0,7
Hawthorn,"Gunston, Jack",24,17,6,7,0,0,0,2
Hawthorn,"Hardwick, Blake",18,11,9,7,0,1,0,2
Hawthorn,"Hartung, Billy",32,17,9,15,0,0,0,2
Hawthorn,"Henderson, Ricky",25,13,6,12,0,1,0,2
Hawthorn,"Hodge, Luke",16,10,4,6,0,0,0,0
Hawthorn,"Howe, Daniel",14,5,4,9,0,0,0,7
Hawthorn,"Langford, Will",17,7,3,10,1,0,0,3
Hawthorn,"McEvoy, Ben",15,4,2,11,1,0,30,3
Hawthorn,"Mitchell, Tom",44,15,4,29,0,1,0,7
Hawthorn,"OBrien, Tim",7,5,4,2,0,0,2,4
Hawthorn,"OMeara, Jaeger",17,6,1,11,0,1,0,3
Hawthorn,"Puopolo, Paul",9,7,4,2,2,0,0,5
Hawthorn,"Roughead, Jarryd",12,6,2,6,1,1,6,3
Hawthorn,"Schoenmakers, Ryan",7,2,2,5,0,0,0,1
Hawthorn,"Sicily, James",13,7,2,6,0,0,0,1
Hawthorn,"Smith, Isaac",26,15,4,11,1,0,0,5
Hawthorn,"Brand, Kaiden",16,9,6,7,0,0,0,3
Hawthorn,"Breust, Luke",15,6,3,9,0,1,0,0
Hawthorn,"Burgoyne, Shaun",21,6,4,15,1,0,0,2
Hawthorn,"Duryea, Taylor",17,9,6,8,0,0,0,3
Hawthorn,"Glass, Conor",14,8,3,6,0,0,0,1
Hawthorn,"Gunston, Jack",26,18,8,8,0,0,0,3
Hawthorn,"Hardwick, Blake",20,12,4,8,0,0,0,3
Hawthorn,"Hartung, Billy",23,11,3,12,0,1,0,0
Hawthorn,"Hodge, Luke",14,9,3,5,0,0,0,1
Hawthorn,"Howe, Daniel",12,6,3,6,0,0,0,4
Hawthorn,"Langford, Will",15,9,4,6,0,0,0,2
Hawthorn,"McEvoy, Ben",17,7,5,10,0,0,29,9
Hawthorn,"Mitchell, Tom",32,13,7,19,0,0,0,6
Hawthorn,"Morrison, Harry",21,10,6,11,0,1,0,1
Hawthorn,"OBrien, Tim",18,14,10,4,1,0,2,0
Hawthorn,"OMeara, Jaeger",25,7,0,18,0,0,0,11
Hawthorn,"Puopolo, Paul",19,11,3,8,3,0,0,6
Hawthorn,"Roughead, Jarryd",19,11,10,8,5,2,0,6
Hawthorn,"Schoenmakers, Ryan",11,7,5,4,1,0,2,0
Hawthorn,"Shiels, Liam",22,12,5,10,0,1,0,8
Hawthorn,"Sicily, James",31,20,12,11,1,0,0,0
Hawthorn,"Smith, Isaac",21,14,5,7,3,0,0,4
Melbourne,"Brayshaw, Angus",21,8,5,13,1,0,0,3
Melbourne,"Garlett, Jeff",9,7,1,2,3,1,0,4
Melbourne,"Gawn, Max",13,9,4,4,0,1,49,4
Melbourne,"Hannan, Mitch",16,10,7,6,2,0,0,4
Melbourne,"Hogan, Jesse",21,16,8,5,3,1,0,4
Melbourne,"Hunt, Jayden",19,14,5,5,0,1,0,5
Melbourne,"Jetta, Neville",20,11,5,9,1,0,0,2
Melbourne,"Jones, Nathan",35,15,6,20,1,0,0,4
Melbourne,"Lewis, Jordan",32,18,9,14,0,0,0,3
Melbourne,"McDonald, Oscar",19,13,5,6,0,0,0,2
Melbourne,"McDonald, Tom",24,18,13,6,0,0,0,1
Melbourne,"Melksham, Jake",15,11,9,4,0,0,0,1
Melbourne,"Neal-Bullen, Alex",23,16,5,7,1,3,0,6
Melbourne,"Oliver, Clayton",36,9,5,27,0,0,0,7
Melbourne,"Petracca, Christian",23,14,6,9,2,0,0,0
Melbourne,"Salem, Christian",20,17,8,3,0,0,0,2
Melbourne,"Smith, Joel",5,3,1,2,0,0,0,1
Melbourne,"Stretch, Billy",26,6,3,20,1,1,0,2
Melbourne,"Vince, Bernie",30,19,8,11,1,0,0,0
Melbourne,"Viney, Jack",23,9,2,14,0,0,0,5
Melbourne,"Watts, Jack",12,8,6,4,1,1,5,0
Melbourne,"Weideman, Sam",12,4,2,8,1,1,0,1
Melbourne,"Brayshaw, Angus",11,9,3,2,0,1,0,1
Melbourne,"Garlett, Jeff",14,12,5,2,3,0,0,3
Melbourne,"Gawn, Max",15,6,4,9,1,0,28,4
Melbourne,"Hannan, Mitch",10,5,2,5,0,1,0,2
Melbourne,"Harmes, James",23,8,5,15,0,1,0,5
Melbourne,"Hogan, Jesse",21,15,10,6,0,3,0,0
Melbourne,"Hunt, Jayden",17,14,6,3,0,0,0,0
Melbourne,"Jetta, Neville",17,10,11,7,0,0,0,3
Melbourne,"Jones, Nathan",26,19,5,7,2,0,0,1
Melbourne,"Lewis, Jordan",17,10,3,7,0,0,0,3
Melbourne,"McDonald, Oscar",12,5,4,7,0,0,0,1
Melbourne,"McDonald, Tom",17,14,9,3,0,0,0,2
Melbourne,"Melksham, Jake",22,15,7,7,0,0,0,0
Melbourne,"Neal-Bullen, Alex",12,6,3,6,0,0,0,5
Melbourne,"Oliver, Clayton",35,11,7,24,0,0,1,9
Melbourne,"Petracca, Christian",18,13,9,5,1,1,0,2
Melbourne,"Salem, Christian",31,24,7,7,1,0,0,3
Melbourne,"Stretch, Billy",22,8,4,14,0,0,0,4
Melbourne,"Tyson, Dom",32,17,12,15,1,0,0,7
Melbourne,"Viney, Jack",22,12,4,10,0,0,0,4
Melbourne,"Watts, Jack",19,12,8,7,2,0,1,2
Melbourne,"Weideman, Sam",9,6,5,3,2,0,0,1
Melbourne,"Garlett, Jeff",9,7,2,2,1,2,0,3
Melbourne,"Gawn, Max",4,1,1,3,0,0,20,3
Melbourne,"Hannan, Mitch",10,5,3,5,1,0,0,2
Melbourne,"Harmes, James",13,6,3,7,1,1,0,3
Melbourne,"Hunt, Jayden",30,23,9,7,1,0,0,3
Melbourne,"Jetta, Neville",15,12,6,3,1,0,0,3
Melbourne,"Jones, Nathan",36,19,6,17,0,3,0,5
Melbourne,"Kent, Dean",22,16,8,6,2,3,0,1
Melbourne,"McDonald, Oscar",14,8,4,6,0,0,0,2
Melbourne,"McDonald, Tom",18,12,7,6,0,0,0,2
Melbourne,"Melksham, Jake",20,14,6,6,0,0,0,3
Melbourne,"Neal-Bullen, Alex",28,25,4,3,1,1,0,10
Melbourne,"Oliver, Clayton",28,8,5,20,0,0,0,8
Melbourne,"Petracca, Christian",24,11,6,13,1,1,0,1
Melbourne,"Salem, Christian",24,16,6,8,0,0,0,2
Melbourne,"Smith, Tim",6,5,3,1,1,1,3,3
Melbourne,"Stretch, Billy",26,9,5,17,1,2,0,5
Melbourne,"Tyson, Dom",15,6,3,9,0,1,0,5
Melbourne,"Vince, Bernie",14,7,2,7,0,1,0,2
Melbourne,"Viney, Jack",25,6,4,19,0,1,0,8
Melbourne,"Watts, Jack",24,13,6,11,2,1,9,3
Melbourne,"Weideman, Sam",4,1,1,3,0,1,0,1
Melbourne,"Bugg, Tomas",22,6,3,16,0,1,0,4
Melbourne,"Frost, Sam",16,9,6,7,0,0,0,1
Melbourne,"Garlett, Jeff",15,9,5,6,3,1,0,8
Melbourne,"Hannan, Mitch",12,9,5,3,0,1,0,0
Melbourne,"Harmes, James",19,12,8,7,2,2,0,2
Melbourne,"Hunt, Jayden",18,10,4,8,0,0,0,2
Melbourne,"Jetta, Neville",12,5,3,7,0,0,0,4
Melbourne,"Jones, Nathan",18,8,1,10,0,0,0,8
Melbourne,"Kent, Dean",16,10,6,6,1,1,0,1
Melbourne,"McDonald, Tom",21,15,6,6,0,0,0,0
Melbourne,"Melksham, Jake",10,10,3,0,0,1,0,3
Melbourne,"Neal-Bullen, Alex",24,12,3,12,1,0,0,5
Melbourne,"Oliver, Clayton",26,9,3,17,0,0,0,8
Melbourne,"Petracca, Christian",20,9,4,11,2,0,0,4
Melbourne,"Salem, Christian",23,14,4,9,1,0,0,2
Melbourne,"Spencer, Jake",13,6,4,7,2,0,15,3
Melbourne,"Stretch, Billy",16,5,2,11,0,0,0,1
Melbourne,"Tyson, Dom",28,18,9,10,0,1,0,5
Melbourne,"Vince, Bernie",25,17,6,8,0,0,0,1
Melbourne,"Viney, Jack",16,6,4,10,1,1,0,8
Melbourne,"Watts, Jack",14,8,5,6,2,2,7,2
Melbourne,"Weideman, Sam",5,3,1,2,0,1,0,0
Melbourne,"Frost, Sam",12,8,1,4,0,0,3,7
Melbourne,"Garlett, Jeff",10,9,2,1,2,0,0,3
Melbourne,"Harmes, James",18,10,2,8,0,0,0,8
Melbourne,"Hibberd, Michael",27,18,6,9,1,0,0,0
Melbourne,"Hogan, Jesse",11,8,1,3,3,0,0,1
Melbourne,"Hunt, Jayden",24,17,4,7,1,0,0,4
Melbourne,"Jetta, Neville",12,4,0,8,0,0,0,2
Melbourne,"Jones, Nathan",24,7,1,17,0,0,0,5
Melbourne,"Kennedy Harris, Jay",11,7,5,4,0,0,0,7
Melbourne,"McDonald, Tom",20,11,2,9,1,0,0,1
Melbourne,"Melksham, Jake",17,11,3,6,0,0,0,0
Melbourne,"Neal-Bullen, Alex",21,10,1,11,0,0,0,9
Melbourne,"Oliver, Clayton",32,8,3,24,0,0,0,7
Melbourne,"Petracca, Christian",14,7,3,7,1,0,0,1
Melbourne,"Salem, Christian",17,9,3,8,1,0,0,4
Melbourne,"Smith, Tim",4,2,0,2,0,1,0,3
Melbourne,"Spencer, Jake",4,1,0,3,0,0,13,2
Melbourne,"Stretch, Billy",19,9,4,10,0,1,0,3
Melbourne,"Tyson, Dom",24,9,4,15,0,0,0,3
Melbourne,"Vince, Bernie",22,18,2,4,0,0,0,2
Melbourne,"Viney, Jack",23,7,2,16,0,1,0,6
Melbourne,"Watts, Jack",18,9,4,9,1,0,11,1
Melbourne,"Bugg, Tomas",13,8,1,5,0,1,0,2
Melbourne,"Frost, Sam",16,12,6,4,0,0,0,3
Melbourne,"Garlett, Jeff",8,6,3,2,3,0,0,3
Melbourne,"Hannan, Mitch",14,9,5,5,3,1,0,3
Melbourne,"Hibberd, Michael",24,16,6,8,0,0,0,1
Melbourne,"Hunt, Jayden",16,13,5,3,0,1,0,2
Melbourne,"Jetta, Neville",12,6,4,6,0,0,0,3
Melbourne,"Jones, Nathan",30,12,4,18,0,0,0,2
Melbourne,"Kennedy Harris, Jay",11,4,2,7,0,0,0,1
Melbourne,"Lewis, Jordan",30,15,7,15,1,0,0,2
Melbourne,"McDonald, Oscar",15,11,8,4,0,0,0,2
Melbourne,"McDonald, Tom",26,17,12,9,1,0,6,1
Melbourne,"Melksham, Jake",14,11,4,3,0,1,0,1
Melbourne,"Neal-Bullen, Alex",10,2,1,8,0,0,0,2
Melbourne,"Oliver, Clayton",33,8,5,25,0,0,0,5
Melbourne,"Pedersen, Cameron",19,11,8,8,1,2,18,0
Melbourne,"Petracca, Christian",11,8,5,3,4,0,0,1
Melbourne,"Salem, Christian",22,14,5,8,0,0,0,2
Melbourne,"Tyson, Dom",29,19,9,10,0,1,0,2
Melbourne,"Vince, Bernie",28,16,5,12,0,0,0,1
Melbourne,"Viney, Jack",19,9,1,10,0,0,0,6
Melbourne,"Watts, Jack",19,13,5,6,4,1,1,3
Melbourne,"Bugg, Tomas",20,10,3,10,0,0,0,1
Melbourne,"Frost, Sam",20,8,7,12,0,0,0,2
Melbourne,"Garlett, Jeff",10,7,2,3,3,1,0,5
Melbourne,"Hannan, Mitch",9,6,0,3,0,1,0,6
Melbourne,"Hibberd, Michael",27,15,2,12,0,0,0,1
Melbourne,"Hogan, Jesse",16,9,4,7,3,0,0,3
Melbourne,"Hunt, Jayden",17,7,5,10,2,0,0,3
Melbourne,"Jetta, Neville",13,4,5,9,0,0,0,2
Melbourne,"Jones, Nathan",27,13,6,14,1,1,0,7
Melbourne,"Kennedy Harris, Jay",13,6,3,7,0,1,0,0
Melbourne,"Lewis, Jordan",30,11,3,19,2,0,0,3
Melbourne,"McDonald, Oscar",15,9,7,6,0,0,0,3
Melbourne,"McDonald, Tom",19,10,5,9,0,0,3,4
Melbourne,"Oliver, Clayton",28,4,1,24,0,0,0,5
Melbourne,"Pedersen, Cameron",16,6,4,10,1,1,16,6
Melbourne,"Petracca, Christian",13,5,3,8,0,0,0,2
Melbourne,"Salem, Christian",16,9,2,7,0,0,0,3
Melbourne,"Tyson, Dom",28,10,2,18,0,0,0,3
Melbourne,"Vince, Bernie",31,19,3,12,0,0,0,2
Melbourne,"Viney, Jack",32,12,2,20,1,0,0,15
Melbourne,"Wagner, Josh",15,8,4,7,0,0,0,3
Melbourne,"Watts, Jack",15,5,2,10,1,0,5,4
Melbourne,"Bugg, Tomas",11,5,2,6,2,0,0,3
Melbourne,"Frost, Sam",18,10,4,8,0,0,0,5
Melbourne,"Garlett, Jeff",10,7,2,3,2,1,0,6
Melbourne,"Hannan, Mitch",8,5,2,3,1,0,0,2
Melbourne,"Hibberd, Michael",34,20,8,14,0,0,0,0
Melbourne,"Hunt, Jayden",12,7,2,5,0,0,0,2
Melbourne,"Jetta, Neville",17,6,5,11,0,0,0,1
Melbourne,"Jones, Nathan",25,12,8,13,2,0,0,6
Melbourne,"Kent, Dean",19,12,4,7,2,0,0,2
Melbourne,"Lewis, Jordan",27,10,3,17,0,0,0,1
Melbourne,"McDonald, Oscar",14,8,4,6,0,0,0,2
Melbourne,"McDonald, Tom",20,11,7,9,2,1,2,2
Melbourne,"Oliver, Clayton",30,9,1,21,1,0,0,10
Melbourne,"Pedersen, Cameron",13,12,2,1,3,0,22,3
Melbourne,"Petracca, Christian",24,13,5,11,1,0,0,5
Melbourne,"Salem, Christian",31,21,3,10,0,0,0,5
Melbourne,"Tyson, Dom",20,11,2,9,0,1,0,6
Melbourne,"Vince, Bernie",14,9,0,5,0,0,0,6
Melbourne,"Viney, Jack",30,11,2,19,1,1,0,12
Melbourne,"Wagner, Josh",19,8,1,11,0,0,0,2
Melbourne,"Watts, Jack",14,3,4,11,0,0,5,3
Melbourne,"Weideman, Sam",10,3,2,7,0,0,0,5
Melbourne,"Bugg, Tomas",14,8,4,6,0,4,0,3
Melbourne,"Frost, Sam",15,8,5,7,1,0,0,5
Melbourne,"Garlett, Jeff",7,6,1,1,0,0,0,3
Melbourne,"Hannan, Mitch",14,12,5,2,3,0,0,1
Melbourne,"Hibberd, Michael",33,17,7,16,0,0,0,1
Melbourne,"Hunt, Jayden",12,7,2,5,0,0,0,3
Melbourne,"Jetta, Neville",10,5,1,5,1,0,0,4
Melbourne,"Jones, Nathan",26,14,0,12,1,0,0,6
Melbourne,"Kent, Dean",13,8,4,5,1,0,0,2
Melbourne,"Lewis, Jordan",25,7,2,18,1,1,0,2
Melbourne,"McDonald, Oscar",12,8,5,4,0,0,0,0
Melbourne,"McDonald, Tom",21,10,7,11,0,1,5,3
Melbourne,"Oliver, Clayton",26,8,2,18,1,1,0,6
Melbourne,"Pedersen, Cameron",18,8,5,10,2,0,18,9
Melbourne,"Petracca, Christian",17,7,4,10,0,0,0,4
Melbourne,"Salem, Christian",13,7,2,6,1,0,0,2
Melbourne,"Tyson, Dom",26,14,4,12,0,0,0,2
Melbourne,"Vince, Bernie",12,8,1,4,0,1,0,5
Melbourne,"Viney, Jack",21,6,1,15,1,0,0,9
Melbourne,"Wagner, Josh",12,3,0,9,0,0,0,7
Melbourne,"Watts, Jack",14,4,2,10,0,0,5,1
Melbourne,"Weideman, Sam",10,3,5,7,0,0,0,0
Melbourne,"Bugg, Tomas",17,11,5,6,0,3,0,2
Melbourne,"Frost, Sam",11,4,1,7,0,0,0,4
Melbourne,"Garlett, Jeff",24,18,8,6,5,4,0,4
Melbourne,"Hannan, Mitch",18,10,4,8,3,1,0,1
Melbourne,"Harmes, James",16,10,3,6,3,0,0,2
Melbourne,"Hibberd, Michael",28,21,7,7,0,0,0,0
Melbourne,"Hunt, Jayden",17,7,5,10,0,0,0,1
Melbourne,"Jetta, Neville",12,7,4,5,0,0,0,4
Melbourne,"Jones, Nathan",27,12,6,15,3,1,0,5
Melbourne,"Lewis, Jordan",29,16,7,13,0,1,0,2
Melbourne,"McDonald, Oscar",13,10,6,3,0,0,0,1
Melbourne,"McDonald, Tom",12,5,4,7,0,0,7,3
Melbourne,"Melksham, Jake",32,15,6,17,0,0,0,5
Melbourne,"Neal-Bullen, Alex",17,14,2,3,1,0,0,4
Melbourne,"Oliver, Clayton",35,7,3,28,0,1,0,3
Melbourne,"Pedersen, Cameron",19,8,9,11,0,0,7,5
Melbourne,"Petracca, Christian",15,8,2,7,1,1,0,6
Melbourne,"Tyson, Dom",28,17,3,11,1,0,0,3
Melbourne,"Vince, Bernie",17,14,4,3,0,0,0,2
Melbourne,"Viney, Jack",23,6,2,17,0,0,0,11
Melbourne,"Wagner, Josh",13,7,5,6,0,0,0,2
Melbourne,"Watts, Jack",20,12,8,8,1,2,2,3
Melbourne,"Bugg, Tomas",11,6,2,5,2,1,0,3
Melbourne,"Frost, Sam",11,7,2,4,0,0,0,1
Melbourne,"Garlett, Jeff",13,10,3,3,2,0,0,3
Melbourne,"Hannan, Mitch",15,6,1,9,1,1,0,3
Melbourne,"Harmes, James",14,6,3,8,1,0,0,4
Melbourne,"Hibberd, Michael",21,8,1,13,0,0,0,1
Melbourne,"Hunt, Jayden",21,15,2,6,0,1,0,3
Melbourne,"Jetta, Neville",10,5,1,5,0,0,0,4
Melbourne,"Jones, Nathan",23,13,4,10,0,1,0,12
Melbourne,"Lewis, Jordan",14,7,2,7,0,0,0,2
Melbourne,"McDonald, Oscar",18,10,4,8,0,0,0,1
Melbourne,"McDonald, Tom",15,8,1,7,1,0,2,4
Melbourne,"Melksham, Jake",10,6,2,4,1,0,0,4
Melbourne,"Neal-Bullen, Alex",22,8,2,14,0,0,0,6
Melbourne,"Oliver, Clayton",26,15,5,11,0,0,0,5
Melbourne,"Pedersen, Cameron",13,4,4,9,1,0,12,5
Melbourne,"Petracca, Christian",18,11,7,7,3,2,0,1
Melbourne,"Salem, Christian",23,16,5,7,0,0,0,5
Melbourne,"Tyson, Dom",25,11,2,14,0,0,0,4
Melbourne,"Vince, Bernie",17,10,2,7,0,0,0,3
Melbourne,"Viney, Jack",25,10,4,15,0,1,0,7
Melbourne,"Watts, Jack",13,7,3,6,3,2,0,5
Melbourne,"Bugg, Tomas",16,8,5,8,2,1,0,5
Melbourne,"Frost, Sam",14,11,6,3,0,0,0,2
Melbourne,"Garlett, Jeff",15,10,4,5,2,4,0,9
Melbourne,"Hannan, Mitch",15,9,3,6,2,0,0,4
Melbourne,"Harmes, James",18,8,4,10,1,4,0,6
Melbourne,"Hibberd, Michael",27,17,11,10,0,0,0,1
Melbourne,"Hunt, Jayden",17,11,4,6,0,0,0,2
Melbourne,"Jetta, Neville",13,7,5,6,0,0,0,4
Melbourne,"Jones, Nathan",17,13,3,4,0,0,0,4
Melbourne,"Lewis, Jordan",31,10,7,21,0,0,0,2
Melbourne,"McDonald, Oscar",23,17,12,6,0,0,0,2
Melbourne,"McDonald, Tom",19,11,7,8,2,0,11,4
Melbourne,"Melksham, Jake",15,8,4,7,1,0,0,2
Melbourne,"Neal-Bullen, Alex",20,11,3,9,1,0,0,2
Melbourne,"Oliver, Clayton",29,6,1,23,0,0,0,8
Melbourne,"Pedersen, Cameron",24,11,6,13,0,0,6,3
Melbourne,"Petracca, Christian",19,8,2,11,1,0,0,2
Melbourne,"Salem, Christian",23,15,5,8,1,0,0,6
Melbourne,"Tyson, Dom",21,14,5,7,1,1,0,2
Melbourne,"Vince, Bernie",21,13,3,8,0,0,0,2
Melbourne,"Viney, Jack",16,4,2,12,0,0,0,8
Melbourne,"Watts, Jack",16,9,6,7,3,0,2,5
Melbourne,"Bugg, Tomas",9,5,2,4,1,0,0,4
Melbourne,"Frost, Sam",13,7,3,6,0,0,0,2
Melbourne,"Garlett, Jeff",4,3,2,1,0,0,0,0
Melbourne,"Gawn, Max",15,7,4,8,0,0,42,1
Melbourne,"Hannan, Mitch",17,9,3,8,1,2,0,3
Melbourne,"Harmes, James",21,7,2,14,1,0,0,5
Melbourne,"Hibberd, Michael",26,12,3,14,0,0,0,1
Melbourne,"Hunt, Jayden",13,4,0,9,0,0,0,4
Melbourne,"Jetta, Neville",11,6,2,5,0,0,0,2
Melbourne,"Lewis, Jordan",29,7,3,22,0,0,0,1
Melbourne,"McDonald, Oscar",7,3,2,4,0,0,0,3
Melbourne,"McDonald, Tom",17,12,8,5,5,2,6,0
Melbourne,"Melksham, Jake",18,12,4,6,1,0,0,3
Melbourne,"Neal-Bullen, Alex",13,6,0,7,2,1,0,4
Melbourne,"Oliver, Clayton",28,7,2,21,0,1,0,7
Melbourne,"Pedersen, Cameron",15,7,3,8,1,1,7,2
Melbourne,"Petracca, Christian",20,7,1,13,1,0,0,2
Melbourne,"Salem, Christian",16,7,3,9,0,0,0,4
Melbourne,"Stretch, Billy",22,5,1,17,1,0,0,4
Melbourne,"Tyson, Dom",33,12,2,21,0,1,0,5
Melbourne,"Vince, Bernie",27,18,8,9,0,0,0,5
Melbourne,"Viney, Jack",38,11,3,27,1,0,0,2
Melbourne,"Bugg, Tomas",6,3,2,3,0,1,0,4
Melbourne,"Frost, Sam",12,9,5,3,0,0,0,0
Melbourne,"Gawn, Max",12,7,5,5,0,0,29,2
Melbourne,"Hannan, Mitch",11,6,0,5,1,1,0,5
Melbourne,"Harmes, James",12,6,2,6,0,1,0,1
Melbourne,"Hibberd, Michael",33,21,4,12,0,0,0,2
Melbourne,"Hunt, Jayden",7,3,4,4,1,0,0,3
Melbourne,"Jetta, Neville",16,5,3,11,0,0,0,8
Melbourne,"Lewis, Jordan",16,11,3,5,0,0,0,1
Melbourne,"McDonald, Oscar",18,12,8,6,0,0,0,2
Melbourne,"McDonald, Tom",19,8,6,11,2,0,2,2
Melbourne,"Melksham, Jake",17,8,3,9,1,0,0,3
Melbourne,"Neal-Bullen, Alex",12,5,1,7,0,2,0,2
Melbourne,"Oliver, Clayton",24,7,4,17,0,0,0,6
Melbourne,"Pedersen, Cameron",15,5,3,10,0,0,6,4
Melbourne,"Petracca, Christian",19,5,1,14,2,0,0,4
Melbourne,"Stretch, Billy",9,2,1,7,0,0,0,4
Melbourne,"Tyson, Dom",21,10,1,11,0,0,0,8
Melbourne,"Vince, Bernie",20,14,1,6,0,1,0,3
Melbourne,"Viney, Jack",17,9,4,8,0,0,0,3
Melbourne,"Wagner, Josh",20,10,3,10,0,0,0,2
Melbourne,"White, Mitch",11,5,4,6,0,0,0,1
Melbourne,"Frost, Sam",19,12,4,7,0,0,0,1
Melbourne,"Garlett, Jeff",7,6,2,1,3,1,0,3
Melbourne,"Gawn, Max",8,2,2,6,0,0,38,5
Melbourne,"Hannan, Mitch",15,8,3,7,0,0,0,5
Melbourne,"Harmes, James",19,7,1,12,0,0,0,2
Melbourne,"Hibberd, Michael",21,13,2,8,0,0,0,1
Melbourne,"Hogan, Jesse",10,6,4,4,1,1,0,1
Melbourne,"Hunt, Jayden",16,8,1,8,0,0,0,3
Melbourne,"Jetta, Neville",14,6,5,8,0,0,0,2
Melbourne,"Kent, Dean",15,7,4,8,0,1,0,4
Melbourne,"Lewis, Jordan",24,10,7,14,1,0,0,2
Melbourne,"McDonald, Oscar",17,11,3,6,0,0,0,3
Melbourne,"McDonald, Tom",15,10,5,5,4,0,1,1
Melbourne,"Melksham, Jake",19,13,3,6,1,1,0,6
Melbourne,"Neal-Bullen, Alex",24,13,6,11,2,0,0,1
Melbourne,"Oliver, Clayton",29,8,2,21,0,0,0,9
Melbourne,"Pedersen, Cameron",10,6,5,4,0,0,8,2
Melbourne,"Petracca, Christian",25,10,0,15,0,0,0,2
Melbourne,"Smith, Joel",9,4,0,5,0,0,0,2
Melbourne,"Stretch, Billy",12,6,4,6,0,0,0,5
Melbourne,"Vince, Bernie",19,13,3,6,0,0,0,7
Melbourne,"Wagner, Josh",18,7,3,11,2,0,0,1
Melbourne,"Frost, Sam",12,5,3,7,0,0,0,1
Melbourne,"Garlett, Jeff",19,12,3,7,0,4,0,2
Melbourne,"Gawn, Max",11,7,2,4,1,0,31,2
Melbourne,"Hannan, Mitch",13,5,0,8,0,0,0,3
Melbourne,"Harmes, James",17,5,1,12,0,0,0,4
Melbourne,"Hibberd, Michael",32,23,5,9,0,0,0,0
Melbourne,"Hogan, Jesse",11,7,7,4,0,1,0,1
Melbourne,"Hunt, Jayden",27,19,7,8,1,0,0,2
Melbourne,"Jetta, Neville",14,3,2,11,0,0,0,1
Melbourne,"Kennedy Harris, Jay",28,13,4,15,0,0,0,5
Melbourne,"Kent, Dean",5,3,1,2,1,1,0,3
Melbourne,"Lewis, Jordan",33,13,3,20,0,0,0,4
Melbourne,"McDonald, Oscar",15,8,4,7,0,0,0,1
Melbourne,"McDonald, Tom",12,7,5,5,1,1,1,1
Melbourne,"Melksham, Jake",13,12,4,1,3,1,0,4
Melbourne,"Neal-Bullen, Alex",23,11,2,12,1,0,0,6
Melbourne,"Oliver, Clayton",27,8,2,19,1,0,0,4
Melbourne,"Pedersen, Cameron",12,7,4,5,0,1,10,2
Melbourne,"Petracca, Christian",23,7,1,16,1,0,0,1
Melbourne,"Smith, Joel",12,5,1,7,0,0,0,5
Melbourne,"Vince, Bernie",16,10,5,6,0,0,0,5
Melbourne,"Wagner, Josh",18,7,1,11,0,0,0,1
Melbourne,"Frost, Sam",10,7,3,3,0,0,0,3
Melbourne,"Garlett, Jeff",11,10,2,1,2,3,0,2
Melbourne,"Gawn, Max",12,7,4,5,0,0,33,4
Melbourne,"Hannan, Mitch",15,6,1,9,1,0,0,5
Melbourne,"Harmes, James",16,9,4,7,1,0,0,3
Melbourne,"Hibberd, Michael",36,24,5,12,0,0,0,4
Melbourne,"Hogan, Jesse",23,11,5,12,3,0,0,2
Melbourne,"Hunt, Jayden",26,20,6,6,0,1,0,5
Melbourne,"Jetta, Neville",16,7,7,9,0,0,0,3
Melbourne,"Kennedy Harris, Jay",14,7,3,7,0,0,0,5
Melbourne,"Lewis, Jordan",18,6,6,12,0,0,0,5
Melbourne,"McDonald, Oscar",23,15,9,8,0,0,0,2
Melbourne,"McDonald, Tom",24,9,5,15,1,0,1,1
Melbourne,"Melksham, Jake",13,8,5,5,3,0,0,1
Melbourne,"Neal-Bullen, Alex",19,11,2,8,0,0,0,4
Melbourne,"Oliver, Clayton",30,7,1,23,0,0,0,10
Melbourne,"Petracca, Christian",19,8,4,11,2,0,0,5
Melbourne,"Salem, Christian",17,12,4,5,0,0,0,4
Melbourne,"Trengove, Jack",16,11,3,5,0,0,0,4
Melbourne,"Tyson, Dom",29,11,5,18,0,1,0,6
Melbourne,"Viney, Jack",25,11,0,14,0,0,0,7
Melbourne,"Watts, Jack",9,4,2,5,0,0,0,3
Melbourne,"Frost, Sam",9,5,2,4,0,0,0,2
Melbourne,"Garlett, Jeff",14,10,2,4,3,2,0,2
Melbourne,"Gawn, Max",18,5,3,13,0,0,52,3
Melbourne,"Hannan, Mitch",3,0,0,3,0,0,0,5
Melbourne,"Harmes, James",24,10,0,14,0,2,0,4
Melbourne,"Hibberd, Michael",27,22,9,5,0,1,0,0
Melbourne,"Hogan, Jesse",11,7,2,4,1,0,0,1
Melbourne,"Hunt, Jayden",18,16,6,2,1,0,0,5
Melbourne,"Jetta, Neville",17,11,7,6,0,0,0,3
Melbourne,"Kennedy Harris, Jay",19,8,1,11,0,0,0,5
Melbourne,"Lewis, Jordan",33,16,3,17,0,0,0,4
Melbourne,"McDonald, Oscar",12,7,3,5,0,0,0,1
Melbourne,"McDonald, Tom",15,10,6,5,2,2,4,4
Melbourne,"Melksham, Jake",11,6,0,5,2,1,0,1
Melbourne,"Neal-Bullen, Alex",16,4,2,12,0,0,0,4
Melbourne,"Oliver, Clayton",33,6,3,27,1,0,0,12
Melbourne,"Petracca, Christian",17,2,0,15,0,0,0,3
Melbourne,"Salem, Christian",22,13,4,9,0,0,0,3
Melbourne,"Trengove, Jack",13,6,1,7,0,0,0,0
Melbourne,"Tyson, Dom",30,13,3,17,0,1,0,2
Melbourne,"Viney, Jack",17,8,3,9,0,0,0,8
Melbourne,"Watts, Jack",16,6,4,10,0,0,0,3
Melbourne,"Frost, Sam",8,5,3,3,0,0,0,1
Melbourne,"Garlett, Jeff",3,1,0,2,0,0,0,3
Melbourne,"Gawn, Max",19,10,6,9,1,1,52,5
Melbourne,"Harmes, James",20,8,3,12,0,0,0,0
Melbourne,"Hibberd, Michael",30,15,3,15,0,0,0,3
Melbourne,"Hunt, Jayden",10,5,2,5,0,0,0,4
Melbourne,"Jetta, Neville",17,7,4,10,0,0,0,6
Melbourne,"Jones, Nathan",29,11,2,18,0,0,0,5
Melbourne,"Lewis, Jordan",35,13,3,22,0,0,0,3
Melbourne,"Maynard, Corey",18,5,0,13,1,0,0,7
Melbourne,"McDonald, Oscar",16,11,4,5,0,0,0,3
Melbourne,"McDonald, Tom",16,10,8,6,1,0,2,8
Melbourne,"Melksham, Jake",14,7,2,7,2,0,0,2
Melbourne,"Neal-Bullen, Alex",17,16,7,1,2,0,0,5
Melbourne,"Oliver, Clayton",32,10,1,22,0,0,0,9
Melbourne,"Pedersen, Cameron",8,3,3,5,1,0,2,3
Melbourne,"Petracca, Christian",16,3,1,13,0,0,0,1
Melbourne,"Salem, Christian",21,11,4,10,0,0,0,4
Melbourne,"Tyson, Dom",21,5,3,16,1,0,0,3
Melbourne,"Vince, Bernie",33,20,7,13,0,0,0,3
Melbourne,"Viney, Jack",22,7,2,15,0,0,0,6
Melbourne,"Watts, Jack",10,6,3,4,1,0,0,2
Melbourne,"Brayshaw, Angus",26,12,4,14,0,0,0,3
Melbourne,"Garlett, Jeff",8,6,1,2,1,1,0,1
Melbourne,"Gawn, Max",16,8,5,8,1,1,19,2
Melbourne,"Hannan, Mitch",9,5,3,4,2,0,0,1
Melbourne,"Harmes, James",21,14,6,7,3,1,0,2
Melbourne,"Hibberd, Michael",22,15,4,7,0,0,0,3
Melbourne,"Hunt, Jayden",19,12,3,7,0,1,0,3
Melbourne,"Jetta, Neville",15,6,4,9,0,0,0,2
Melbourne,"Jones, Nathan",35,12,6,23,0,0,0,4
Melbourne,"Lewis, Jordan",25,14,7,11,0,0,0,2
Melbourne,"McDonald, Oscar",16,13,8,3,0,0,0,1
Melbourne,"McDonald, Tom",21,10,8,11,0,0,0,1
Melbourne,"Melksham, Jake",16,8,8,8,2,0,0,3
Melbourne,"Neal-Bullen, Alex",24,14,9,10,1,1,0,4
Melbourne,"Oliver, Clayton",32,6,2,26,0,0,0,6
Melbourne,"Pedersen, Cameron",26,13,8,13,2,1,4,6
Melbourne,"Petracca, Christian",14,6,1,8,0,0,0,2
Melbourne,"Tyson, Dom",19,7,3,12,1,0,0,5
Melbourne,"Vince, Bernie",18,11,4,7,0,0,0,1
Melbourne,"Viney, Jack",21,7,2,14,1,0,0,1
Melbourne,"Wagner, Josh",14,9,2,5,0,1,0,1
Melbourne,"Weideman, Sam",6,4,2,2,0,1,0,4
Melbourne,"Brayshaw, Angus",17,11,8,6,1,0,0,2
Melbourne,"Garlett, Jeff",8,4,2,4,2,1,0,2
Melbourne,"Gawn, Max",9,3,3,6,0,0,38,0
Melbourne,"Hannan, Mitch",14,8,1,6,0,1,0,3
Melbourne,"Harmes, James",13,9,3,4,1,0,0,3
Melbourne,"Hibberd, Michael",23,13,7,10,0,0,0,4
Melbourne,"Hogan, Jesse",15,10,9,5,6,0,0,1
Melbourne,"Hunt, Jayden",18,9,1,9,0,0,0,5
Melbourne,"Jetta, Neville",13,10,7,3,0,0,0,2
Melbourne,"Jones, Nathan",32,13,2,19,0,0,0,7
Melbourne,"Lewis, Jordan",25,12,9,13,0,0,0,3
Melbourne,"McDonald, Oscar",9,7,4,2,0,0,0,0
Melbourne,"McDonald, Tom",5,4,1,1,0,0,0,4
Melbourne,"Melksham, Jake",29,20,7,9,1,1,0,4
Melbourne,"Neal-Bullen, Alex",17,7,0,10,0,0,0,3
Melbourne,"Oliver, Clayton",30,8,3,22,0,0,0,5
Melbourne,"Pedersen, Cameron",24,13,7,11,3,2,9,3
Melbourne,"Petracca, Christian",22,6,4,16,1,0,0,3
Melbourne,"Stretch, Billy",12,7,6,5,0,0,0,2
Melbourne,"Tyson, Dom",27,8,3,19,0,0,0,3
Melbourne,"Vince, Bernie",10,8,3,2,1,0,0,3
Melbourne,"Wagner, Josh",14,4,2,10,0,0,0,6
Melbourne,"Brayshaw, Angus",20,13,8,7,0,0,0,3
Melbourne,"Garlett, Jeff",18,11,4,7,2,2,0,5
Melbourne,"Gawn, Max",8,5,3,3,0,1,35,1
Melbourne,"Hannan, Mitch",10,5,1,5,1,0,0,2
Melbourne,"Harmes, James",10,3,0,7,0,0,0,3
Melbourne,"Hibberd, Michael",22,15,7,7,0,0,0,0
Melbourne,"Hogan, Jesse",3,2,1,1,0,0,0,1
Melbourne,"Hunt, Jayden",22,13,2,9,0,0,0,5
Melbourne,"Jetta, Neville",19,8,3,11,0,0,0,3
Melbourne,"Jones, Nathan",29,14,3,15,0,0,0,5
Melbourne,"Lewis, Jordan",27,10,6,17,0,1,0,2
Melbourne,"McDonald, Oscar",20,6,4,14,0,0,0,0
Melbourne,"McDonald, Tom",12,5,7,7,0,0,0,1
Melbourne,"Melksham, Jake",13,7,4,6,3,0,0,2
Melbourne,"Neal-Bullen, Alex",17,13,8,4,2,1,0,5
Melbourne,"Oliver, Clayton",30,8,7,22,0,0,0,3
Melbourne,"Pedersen, Cameron",11,5,2,6,1,0,2,0
Melbourne,"Petracca, Christian",23,13,3,10,2,1,0,2
Melbourne,"Salem, Christian",24,14,8,10,0,0,0,3
Melbourne,"Tyson, Dom",24,12,3,12,0,1,0,1
Melbourne,"Vince, Bernie",29,19,6,10,0,1,0,2
Melbourne,"Watts, Jack",18,10,9,8,1,0,0,2
North Melbourne,"Atley, Shaun",17,7,3,10,1,1,0,0
North Melbourne,"Brown, Ben",11,6,6,5,2,1,0,2
North Melbourne,"Dumont, Trent",25,15,2,10,0,0,0,3
North Melbourne,"Gibson, Sam",22,11,2,11,0,1,0,4
North Melbourne,"Goldstein, Todd",11,3,3,8,3,0,32,1
North Melbourne,"Hansen, Lachlan",9,5,2,4,0,0,0,2
North Melbourne,"Hibberd, Mitchell",10,3,2,7,0,0,0,1
North Melbourne,"Higgins, Shaun",25,13,2,12,0,1,0,4
North Melbourne,"Hrovat, Nathan",14,5,2,9,1,1,0,1
North Melbourne,"Macmillan, Jamie",18,8,1,10,0,0,0,2
North Melbourne,"McDonald, Luke",19,12,3,7,0,0,0,5
North Melbourne,"Mountford, Declan",11,1,3,10,0,0,0,3
North Melbourne,"Preuss, Braydon",5,4,2,1,1,0,19,2
North Melbourne,"Simpkin, Jy",9,2,2,7,0,0,0,2
North Melbourne,"Swallow, Andrew",23,13,3,10,0,1,0,8
North Melbourne,"Tarrant, Robbie",15,8,3,7,1,0,0,2
North Melbourne,"Thomas, Lindsay",12,8,1,4,0,2,0,6
North Melbourne,"Thompson, Scott",17,8,2,9,0,0,0,3
North Melbourne,"Turner, Kayne",9,3,2,6,2,0,0,2
North Melbourne,"Waite, Jarrad",17,12,7,5,1,7,0,4
North Melbourne,"Williams, Marley",11,4,0,7,0,0,0,3
North Melbourne,"Ziebell, Jack",31,17,1,14,1,0,0,5
North Melbourne,"Atley, Shaun",20,12,2,8,0,0,0,3
North Melbourne,"Brown, Ben",14,10,6,4,3,1,0,0
North Melbourne,"Cunnington, Ben",28,7,3,21,0,0,0,7
North Melbourne,"Daw, Majak",10,6,5,4,1,0,8,1
North Melbourne,"Dumont, Trent",24,14,1,10,1,0,0,2
North Melbourne,"Garner, Taylor",11,9,5,2,1,1,0,3
North Melbourne,"Gibson, Sam",27,14,6,13,1,0,0,4
North Melbourne,"Hansen, Lachlan",14,10,9,4,0,0,0,0
North Melbourne,"Higgins, Shaun",27,15,4,12,2,1,0,7
North Melbourne,"Hrovat, Nathan",16,10,7,6,0,0,0,0
North Melbourne,"Macmillan, Jamie",20,11,7,9,1,0,0,1
North Melbourne,"McDonald, Luke",18,8,2,10,1,0,0,1
North Melbourne,"Mullett, Aaron",14,9,3,5,0,0,0,1
North Melbourne,"Preuss, Braydon",13,6,4,7,0,0,46,5
North Melbourne,"Simpkin, Jy",8,5,2,3,1,2,0,2
North Melbourne,"Swallow, Andrew",11,5,3,6,0,0,0,5
North Melbourne,"Tarrant, Robbie",28,19,9,9,0,0,0,2
North Melbourne,"Thomas, Lindsay",9,6,3,3,2,0,0,5
North Melbourne,"Thompson, Scott",11,8,4,3,0,0,0,2
North Melbourne,"Turner, Kayne",9,9,5,0,2,2,0,5
North Melbourne,"Williams, Marley",12,7,4,5,1,0,0,3
North Melbourne,"Ziebell, Jack",14,11,3,3,0,1,0,7
North Melbourne,"Atley, Shaun",18,8,2,10,0,0,0,6
North Melbourne,"Brown, Ben",11,7,2,4,1,2,0,2
North Melbourne,"Clarke, Ryan",13,8,2,5,1,0,0,3
North Melbourne,"Cunnington, Ben",21,6,3,15,0,0,0,5
North Melbourne,"Dumont, Trent",14,9,4,5,1,0,0,6
North Melbourne,"Durdin, Sam",10,6,2,4,0,0,0,1
North Melbourne,"Garner, Taylor",14,8,4,6,1,0,0,4
North Melbourne,"Gibson, Sam",20,9,4,11,0,0,0,3
North Melbourne,"Goldstein, Todd",12,5,3,7,1,0,10,2
North Melbourne,"Hansen, Lachlan",21,12,11,9,0,0,0,3
North Melbourne,"Higgins, Shaun",18,7,1,11,0,0,0,4
North Melbourne,"Hrovat, Nathan",20,11,5,9,0,0,0,3
North Melbourne,"Macmillan, Jamie",20,13,2,7,0,0,0,0
North Melbourne,"McDonald, Luke",21,14,6,7,0,0,0,4
North Melbourne,"Mullett, Aaron",28,16,7,12,0,0,0,0
North Melbourne,"Preuss, Braydon",16,10,9,6,2,1,26,2
North Melbourne,"Swallow, Andrew",14,4,0,10,1,0,0,3
North Melbourne,"Tarrant, Robbie",23,12,6,11,0,0,0,3
North Melbourne,"Thomas, Lindsay",13,4,3,9,0,1,0,4
North Melbourne,"Turner, Kayne",17,9,5,8,1,2,0,0
North Melbourne,"Williams, Marley",23,5,3,18,0,0,0,2
North Melbourne,"Ziebell, Jack",28,13,5,15,1,0,0,5
North Melbourne,"Atley, Shaun",15,7,3,8,0,0,0,2
North Melbourne,"Brown, Ben",14,8,8,6,4,1,0,1
North Melbourne,"Cunnington, Ben",33,10,6,23,0,0,0,4
North Melbourne,"Dumont, Trent",20,12,2,8,0,0,0,4
North Melbourne,"Garner, Taylor",21,11,7,10,1,1,0,2
North Melbourne,"Gibson, Sam",20,11,3,9,0,1,0,5
North Melbourne,"Goldstein, Todd",21,8,7,13,1,0,29,1
North Melbourne,"Hansen, Lachlan",9,6,6,3,0,0,0,0
North Melbourne,"Higgins, Shaun",19,8,2,11,1,3,0,6
North Melbourne,"Hrovat, Nathan",24,12,1,12,0,0,0,2
North Melbourne,"Macmillan, Jamie",23,11,3,12,0,1,0,0
North Melbourne,"McDonald, Luke",17,9,2,8,0,0,0,6
North Melbourne,"Mullett, Aaron",24,10,4,14,0,0,0,0
North Melbourne,"Preuss, Braydon",11,5,4,6,0,1,17,2
North Melbourne,"Simpkin, Jy",13,7,4,6,2,0,0,3
North Melbourne,"Swallow, Andrew",18,9,1,9,0,0,0,11
North Melbourne,"Tarrant, Robbie",14,8,5,6,0,0,0,10
North Melbourne,"Thomas, Lindsay",16,9,4,7,0,3,0,4
North Melbourne,"Thompson, Scott",11,5,4,6,0,0,0,5
North Melbourne,"Turner, Kayne",10,5,4,5,2,0,0,3
North Melbourne,"Williams, Marley",15,5,1,10,0,0,0,3
North Melbourne,"Ziebell, Jack",27,17,5,10,1,0,0,1
North Melbourne,"Atley, Shaun",20,10,5,10,1,0,0,3
North Melbourne,"Brown, Ben",10,8,6,2,1,1,6,1
North Melbourne,"Cunnington, Ben",29,9,3,20,1,0,0,5
North Melbourne,"Dumont, Trent",24,11,3,13,1,0,0,5
North Melbourne,"Garner, Taylor",17,8,4,9,0,1,0,3
North Melbourne,"Gibson, Sam",18,8,6,10,0,0,0,2
North Melbourne,"Goldstein, Todd",13,6,2,7,1,0,21,3
North Melbourne,"Hansen, Lachlan",13,6,4,7,0,0,0,2
North Melbourne,"Hrovat, Nathan",21,8,2,13,1,0,0,4
North Melbourne,"Macmillan, Jamie",26,15,5,11,0,0,0,3
North Melbourne,"McDonald, Luke",19,11,4,8,0,1,0,8
North Melbourne,"Mullett, Aaron",19,11,6,8,0,0,0,5
North Melbourne,"Simpkin, Jy",12,8,3,4,1,0,0,3
North Melbourne,"Swallow, Andrew",15,8,3,7,0,1,0,6
North Melbourne,"Tarrant, Robbie",17,8,2,9,0,0,0,3
North Melbourne,"Thomas, Lindsay",6,3,1,3,0,0,0,3
North Melbourne,"Thompson, Scott",12,4,3,8,0,0,0,1
North Melbourne,"Turner, Kayne",9,5,4,4,1,0,0,2
North Melbourne,"Vickers-Willis, Ed",15,8,5,7,0,1,0,1
North Melbourne,"Williams, Marley",24,14,5,10,0,0,0,3
North Melbourne,"Wood, Mason",14,11,8,3,1,1,0,2
North Melbourne,"Ziebell, Jack",17,10,3,7,0,0,0,3
North Melbourne,"Anderson, Jed",10,5,0,5,1,0,0,3
North Melbourne,"Atley, Shaun",13,5,2,8,0,0,0,1
North Melbourne,"Brown, Ben",17,13,8,4,6,2,3,1
North Melbourne,"Cunnington, Ben",12,3,0,9,0,0,0,5
North Melbourne,"Dumont, Trent",22,8,3,14,0,0,0,3
North Melbourne,"Garner, Taylor",23,15,11,8,0,0,0,1
North Melbourne,"Gibson, Sam",21,11,3,10,1,0,0,2
North Melbourne,"Goldstein, Todd",16,7,6,9,0,1,30,1
North Melbourne,"Hansen, Lachlan",16,8,8,8,1,0,0,0
North Melbourne,"Higgins, Shaun",28,17,5,11,1,0,0,6
North Melbourne,"Hrovat, Nathan",22,15,4,7,2,0,0,5
North Melbourne,"Macmillan, Jamie",17,10,3,7,0,1,0,5
North Melbourne,"McDonald, Luke",16,11,4,5,1,1,0,3
North Melbourne,"Mullett, Aaron",24,15,4,9,0,0,0,1
North Melbourne,"Simpkin, Jy",8,6,3,2,1,1,0,2
North Melbourne,"Tarrant, Robbie",17,10,5,7,0,0,0,3
North Melbourne,"Thompson, Scott",13,8,5,5,0,0,0,1
North Melbourne,"Turner, Kayne",16,8,8,8,1,2,0,4
North Melbourne,"Vickers-Willis, Ed",14,2,3,12,0,0,0,2
North Melbourne,"Williams, Marley",16,6,1,10,1,0,0,2
North Melbourne,"Wood, Mason",14,7,5,7,0,1,0,5
North Melbourne,"Ziebell, Jack",24,12,6,12,0,1,0,5
North Melbourne,"Anderson, Jed",13,4,2,9,0,0,0,4
North Melbourne,"Atley, Shaun",15,7,2,8,1,0,0,2
North Melbourne,"Brown, Ben",11,4,3,7,2,1,5,3
North Melbourne,"Clarke, Ryan",19,7,2,12,1,0,0,5
North Melbourne,"Cunnington, Ben",29,14,1,15,2,0,0,6
North Melbourne,"Dumont, Trent",18,10,2,8,2,2,0,8
North Melbourne,"Gibson, Sam",20,9,2,11,0,0,0,6
North Melbourne,"Goldstein, Todd",13,5,1,8,0,1,39,6
North Melbourne,"Hansen, Lachlan",17,11,9,6,0,0,0,3
North Melbourne,"Higgins, Shaun",19,13,3,6,2,1,0,4
North Melbourne,"Hrovat, Nathan",19,12,3,7,1,1,0,6
North Melbourne,"Macmillan, Jamie",20,12,3,8,0,0,0,3
North Melbourne,"McDonald, Luke",24,14,0,10,1,0,0,2
North Melbourne,"Tarrant, Robbie",17,11,8,6,0,0,0,2
North Melbourne,"Thompson, Scott",24,14,10,10,0,1,0,3
North Melbourne,"Turner, Kayne",18,10,2,8,1,0,0,5
North Melbourne,"Vickers-Willis, Ed",12,4,1,8,0,0,0,4
North Melbourne,"Wagner, Corey",2,2,1,0,0,0,0,1
North Melbourne,"Waite, Jarrad",22,17,8,5,6,2,1,6
North Melbourne,"Williams, Marley",13,8,2,5,0,0,0,1
North Melbourne,"Wood, Mason",24,14,10,10,2,3,0,5
North Melbourne,"Ziebell, Jack",19,16,2,3,1,0,0,5
North Melbourne,"Anderson, Jed",11,4,2,7,1,0,0,8
North Melbourne,"Atley, Shaun",17,11,3,6,0,1,0,3
North Melbourne,"Brown, Ben",7,3,2,4,2,0,2,0
North Melbourne,"Clarke, Ryan",16,7,3,9,0,1,0,2
North Melbourne,"Cunnington, Ben",28,10,3,18,1,0,0,6
North Melbourne,"Dumont, Trent",12,6,1,6,0,1,0,5
North Melbourne,"Durdin, Sam",9,5,2,4,0,1,0,1
North Melbourne,"Gibson, Sam",27,17,5,10,0,2,0,3
North Melbourne,"Goldstein, Todd",11,6,2,5,2,0,41,2
North Melbourne,"Hansen, Lachlan",13,7,4,6,1,0,0,2
North Melbourne,"Higgins, Shaun",21,12,6,9,1,1,0,4
North Melbourne,"Hrovat, Nathan",12,5,3,7,1,1,0,4
North Melbourne,"Macmillan, Jamie",19,9,4,10,0,0,0,1
North Melbourne,"McDonald, Luke",11,7,0,4,0,0,0,8
North Melbourne,"Simpkin, Jy",4,3,0,1,0,0,0,1
North Melbourne,"Tarrant, Robbie",20,10,6,10,0,0,0,2
North Melbourne,"Thompson, Scott",17,8,3,9,0,0,0,4
North Melbourne,"Turner, Kayne",9,8,2,1,2,1,0,10
North Melbourne,"Vickers-Willis, Ed",21,6,3,15,0,0,0,2
North Melbourne,"Williams, Marley",19,8,4,11,0,0,0,1
North Melbourne,"Wood, Mason",11,3,1,8,0,0,0,2
North Melbourne,"Ziebell, Jack",22,11,2,11,0,1,0,12
North Melbourne,"Atley, Shaun",15,4,3,11,0,0,0,3
North Melbourne,"Brown, Ben",13,10,6,3,5,2,3,1
North Melbourne,"Clarke, Ryan",18,7,3,11,0,0,0,2
North Melbourne,"Cunnington, Ben",26,11,3,15,1,0,0,4
North Melbourne,"Garner, Taylor",13,7,3,6,2,0,0,4
North Melbourne,"Gibson, Sam",26,13,5,13,0,0,0,2
North Melbourne,"Goldstein, Todd",17,8,3,9,0,1,61,8
North Melbourne,"Hansen, Lachlan",8,3,5,5,0,0,0,2
North Melbourne,"Higgins, Shaun",18,11,4,7,1,4,0,4
North Melbourne,"Hrovat, Nathan",15,10,6,5,0,0,0,9
North Melbourne,"Macmillan, Jamie",17,11,2,6,0,0,0,5
North Melbourne,"McDonald, Luke",16,10,4,6,1,0,0,9
North Melbourne,"Mullett, Aaron",17,8,5,9,0,0,0,2
North Melbourne,"Swallow, Andrew",17,7,2,10,0,0,0,9
North Melbourne,"Tarrant, Robbie",15,10,3,5,0,0,0,3
North Melbourne,"Thompson, Scott",16,10,8,6,0,0,0,2
North Melbourne,"Turner, Kayne",20,11,6,9,0,0,0,6
North Melbourne,"Vickers-Willis, Ed",14,3,0,11,0,0,0,6
North Melbourne,"Waite, Jarrad",10,4,4,6,0,1,3,1
North Melbourne,"Williams, Marley",16,9,1,7,1,0,0,3
North Melbourne,"Wood, Mason",16,13,4,3,3,3,0,2
North Melbourne,"Ziebell, Jack",20,16,5,4,1,1,0,7
North Melbourne,"Atley, Shaun",17,10,2,7,1,2,0,5
North Melbourne,"Brown, Ben",10,6,4,4,1,1,3,0
North Melbourne,"Clarke, Ryan",15,7,3,8,0,1,0,6
North Melbourne,"Cunnington, Ben",17,5,0,12,0,0,0,4
North Melbourne,"Dumont, Trent",26,6,1,20,1,0,0,7
North Melbourne,"Garner, Taylor",8,7,1,1,3,0,0,3
North Melbourne,"Gibson, Sam",14,9,6,5,0,0,0,4
North Melbourne,"Goldstein, Todd",10,1,0,9,0,0,36,4
North Melbourne,"Hansen, Lachlan",12,8,7,4,2,2,0,3
North Melbourne,"Higgins, Shaun",27,14,4,13,2,1,0,5
North Melbourne,"Hrovat, Nathan",17,10,4,7,1,0,0,0
North Melbourne,"Macmillan, Jamie",13,7,7,6,0,0,0,2
North Melbourne,"McDonald, Luke",28,15,4,13,1,1,0,7
North Melbourne,"Mullett, Aaron",11,8,5,3,0,0,0,2
North Melbourne,"Tarrant, Robbie",15,10,7,5,0,0,0,4
North Melbourne,"Thompson, Scott",19,11,6,8,0,0,0,2
North Melbourne,"Turner, Kayne",12,6,5,6,2,0,0,5
North Melbourne,"Vickers-Willis, Ed",8,4,2,4,0,0,0,5
North Melbourne,"Waite, Jarrad",16,9,2,7,1,1,1,1
North Melbourne,"Williams, Marley",24,10,3,14,0,0,0,0
North Melbourne,"Wood, Mason",8,6,2,2,2,0,0,3
North Melbourne,"Ziebell, Jack",29,14,5,15,0,1,0,7
North Melbourne,"Atley, Shaun",16,8,2,8,2,0,0,3
North Melbourne,"Brown, Ben",12,7,2,5,1,1,6,1
North Melbourne,"Clarke, Ryan",21,6,3,15,0,0,0,2
North Melbourne,"Cunnington, Ben",20,5,1,15,0,1,0,1
North Melbourne,"Dumont, Trent",24,12,3,12,0,0,0,2
North Melbourne,"Garner, Taylor",14,8,3,6,0,0,0,2
North Melbourne,"Gibson, Sam",25,10,4,15,1,2,0,4
North Melbourne,"Goldstein, Todd",14,5,0,9,0,0,33,4
North Melbourne,"Hansen, Lachlan",14,6,4,8,1,0,0,2
North Melbourne,"Higgins, Shaun",21,12,5,9,1,1,0,1
North Melbourne,"Hrovat, Nathan",17,4,0,13,0,0,0,3
North Melbourne,"Macmillan, Jamie",26,17,5,9,0,1,0,1
North Melbourne,"McDonald, Luke",18,11,5,7,0,1,0,3
North Melbourne,"Mullett, Aaron",21,9,2,12,0,0,0,1
North Melbourne,"Tarrant, Robbie",24,15,8,9,0,0,0,2
North Melbourne,"Thompson, Scott",18,9,4,9,0,0,0,3
North Melbourne,"Turner, Kayne",9,4,3,5,0,1,0,3
North Melbourne,"Vickers-Willis, Ed",12,7,2,5,0,0,0,2
North Melbourne,"Waite, Jarrad",12,6,3,6,1,3,0,1
North Melbourne,"Williams, Marley",18,5,2,13,0,0,0,2
North Melbourne,"Wood, Mason",14,5,2,9,2,1,0,0
North Melbourne,"Ziebell, Jack",24,16,0,8,0,0,0,5
North Melbourne,"Anderson, Jed",9,4,1,5,0,0,0,2
North Melbourne,"Atley, Shaun",20,10,3,10,0,0,0,2
North Melbourne,"Brown, Ben",8,7,4,1,1,2,4,0
North Melbourne,"Clarke, Ryan",19,9,0,10,2,0,0,0
North Melbourne,"Cunnington, Ben",32,6,4,26,0,0,0,5
North Melbourne,"Dumont, Trent",20,7,3,13,0,0,0,4
North Melbourne,"Garner, Taylor",12,5,2,7,0,0,0,4
North Melbourne,"Gibson, Sam",30,17,5,13,0,0,0,5
North Melbourne,"Goldstein, Todd",17,2,2,15,1,0,33,0
North Melbourne,"Hansen, Lachlan",12,8,8,4,0,0,0,3
North Melbourne,"Higgins, Shaun",18,8,2,10,0,3,0,9
North Melbourne,"Hrovat, Nathan",21,13,3,8,1,0,0,3
North Melbourne,"McDonald, Luke",22,11,4,11,0,1,0,5
North Melbourne,"Mountford, Declan",15,5,3,10,0,0,0,5
North Melbourne,"Mullett, Aaron",15,9,3,6,1,0,0,1
North Melbourne,"Tarrant, Robbie",13,10,7,3,0,1,0,4
North Melbourne,"Thompson, Scott",14,5,6,9,0,0,0,1
North Melbourne,"Turner, Kayne",9,4,3,5,1,0,0,4
North Melbourne,"Waite, Jarrad",9,6,2,3,1,2,0,2
North Melbourne,"Williams, Marley",24,5,3,19,0,0,0,2
North Melbourne,"Wood, Mason",15,6,3,9,1,1,0,1
North Melbourne,"Ziebell, Jack",24,17,5,7,1,0,0,7
North Melbourne,"Atley, Shaun",14,8,3,6,0,0,0,4
North Melbourne,"Brown, Ben",16,9,6,7,2,1,2,2
North Melbourne,"Clarke, Ryan",9,2,0,7,1,0,0,4
North Melbourne,"Cunnington, Ben",28,12,2,16,2,1,0,4
North Melbourne,"Daw, Majak",6,5,3,1,2,1,9,3
North Melbourne,"Dumont, Trent",11,8,2,3,0,0,0,4
North Melbourne,"Garner, Taylor",8,4,2,4,1,0,0,2
North Melbourne,"Gibson, Sam",15,7,3,8,0,0,0,0
North Melbourne,"Goldstein, Todd",17,6,3,11,1,0,25,2
North Melbourne,"Higgins, Shaun",19,11,4,8,0,2,0,9
North Melbourne,"Hrovat, Nathan",17,8,4,9,1,1,0,6
North Melbourne,"Macmillan, Jamie",17,8,2,9,1,0,0,1
North Melbourne,"McDonald, Luke",16,8,4,8,0,0,0,2
North Melbourne,"Mountford, Declan",13,4,0,9,0,2,0,3
North Melbourne,"Mullett, Aaron",17,12,2,5,0,0,0,2
North Melbourne,"Swallow, Andrew",18,8,0,10,0,1,0,11
North Melbourne,"Tarrant, Robbie",12,7,8,5,0,0,0,1
North Melbourne,"Thompson, Scott",8,5,4,3,0,0,0,2
North Melbourne,"Waite, Jarrad",13,9,9,4,3,0,0,2
North Melbourne,"Williams, Marley",12,8,2,4,0,0,0,2
North Melbourne,"Wood, Mason",7,6,2,1,2,0,0,4
North Melbourne,"Ziebell, Jack",18,11,3,7,0,0,0,9
North Melbourne,"Atley, Shaun",18,12,4,6,1,1,0,2
North Melbourne,"Brown, Ben",12,8,4,4,3,2,0,2
North Melbourne,"Clarke, Ryan",14,6,0,8,1,1,0,0
North Melbourne,"Daw, Majak",5,4,1,1,1,1,8,3
North Melbourne,"Garner, Taylor",14,9,8,5,0,3,0,4
North Melbourne,"Gibson, Sam",18,9,2,9,0,0,0,3
North Melbourne,"Goldstein, Todd",13,4,3,9,0,0,42,2
North Melbourne,"Hibberd, Mitchell",13,4,1,9,0,0,0,3
North Melbourne,"Higgins, Shaun",19,5,0,14,1,1,0,9
North Melbourne,"Hrovat, Nathan",14,4,3,10,1,1,0,2
North Melbourne,"Macmillan, Jamie",8,5,3,3,0,0,0,2
North Melbourne,"McDonald, Luke",31,21,4,10,0,1,0,4
North Melbourne,"Mountford, Declan",17,9,3,8,0,0,0,10
North Melbourne,"Mullett, Aaron",21,13,2,8,1,0,0,1
North Melbourne,"Swallow, Andrew",24,6,5,18,0,0,0,3
North Melbourne,"Tarrant, Robbie",13,4,6,9,0,0,0,2
North Melbourne,"Thomas, Lindsay",13,8,2,5,0,0,0,1
North Melbourne,"Thompson, Scott",11,8,3,3,0,0,0,0
North Melbourne,"Wagner, Corey",10,6,1,4,0,2,0,0
North Melbourne,"Waite, Jarrad",19,15,4,4,4,0,0,6
North Melbourne,"Wood, Mason",14,8,5,6,1,1,0,1
North Melbourne,"Ziebell, Jack",19,11,2,8,0,0,0,4
North Melbourne,"Atley, Shaun",19,8,6,11,1,0,0,2
North Melbourne,"Brown, Ben",13,11,7,2,4,2,0,4
North Melbourne,"Cunnington, Ben",28,7,1,21,0,1,0,8
North Melbourne,"Daw, Majak",4,3,1,1,0,0,15,2
North Melbourne,"Dumont, Trent",13,3,2,10,0,0,0,6
North Melbourne,"Garner, Taylor",15,5,0,10,0,0,0,2
North Melbourne,"Gibson, Sam",21,10,5,11,0,0,0,7
North Melbourne,"Goldstein, Todd",15,7,3,8,0,2,32,4
North Melbourne,"Hibberd, Mitchell",22,10,7,12,0,0,0,3
North Melbourne,"Higgins, Shaun",26,18,6,8,1,0,0,5
North Melbourne,"Hrovat, Nathan",16,8,5,8,0,0,0,2
North Melbourne,"McDonald, Luke",22,12,5,10,1,0,0,5
North Melbourne,"Mountford, Declan",16,10,3,6,1,0,0,2
North Melbourne,"Mullett, Aaron",24,20,5,4,2,1,0,1
North Melbourne,"Nielson, Dan",15,7,4,8,0,0,0,1
North Melbourne,"Simpkin, Jy",12,6,2,6,0,0,0,4
North Melbourne,"Swallow, Andrew",22,6,0,16,1,0,0,4
North Melbourne,"Tarrant, Robbie",16,11,6,5,0,0,0,2
North Melbourne,"Thomas, Lindsay",19,14,4,5,0,0,0,2
North Melbourne,"Thompson, Scott",21,10,10,11,0,0,0,4
North Melbourne,"Wagner, Corey",7,3,3,4,0,0,0,1
North Melbourne,"Ziebell, Jack",28,16,4,12,1,1,0,8
North Melbourne,"Atley, Shaun",18,7,4,11,2,0,0,3
North Melbourne,"Brown, Ben",10,7,4,3,3,0,0,0
North Melbourne,"Cunnington, Ben",33,14,5,19,0,0,0,8
North Melbourne,"Daw, Majak",5,4,1,1,0,1,21,2
North Melbourne,"Garner, Taylor",15,6,2,9,1,0,0,9
North Melbourne,"Gibson, Sam",16,6,5,10,0,0,0,3
North Melbourne,"Goldstein, Todd",6,2,0,4,0,0,22,6
North Melbourne,"Hibberd, Mitchell",2,1,0,1,0,0,0,1
North Melbourne,"Higgins, Shaun",26,16,3,10,1,0,0,6
North Melbourne,"Hrovat, Nathan",15,9,3,6,1,0,0,1
North Melbourne,"McDonald, Luke",24,13,9,11,0,1,0,3
North Melbourne,"Mountford, Declan",11,4,0,7,0,0,0,6
North Melbourne,"Mullett, Aaron",27,15,3,12,0,1,0,3
North Melbourne,"Nielson, Dan",9,5,6,4,0,0,0,2
North Melbourne,"Simpkin, Jy",15,7,4,8,0,1,0,4
North Melbourne,"Swallow, Andrew",24,11,2,13,0,0,0,11
North Melbourne,"Tarrant, Robbie",20,11,8,9,0,0,0,2
North Melbourne,"Thomas, Lindsay",12,8,4,4,0,0,0,2
North Melbourne,"Thompson, Scott",10,2,1,8,0,0,0,4
North Melbourne,"Wagner, Corey",12,7,1,5,0,0,0,4
North Melbourne,"Ziebell, Jack",16,11,4,5,0,0,0,8
North Melbourne,"Zurhaar, Cameron",6,4,1,2,0,1,0,3
North Melbourne,"Atley, Shaun",25,11,8,14,0,1,0,3
North Melbourne,"Brown, Ben",13,12,9,1,6,2,1,3
North Melbourne,"Clarke, Ryan",19,10,6,9,0,0,0,0
North Melbourne,"Cunnington, Ben",18,9,2,9,0,0,0,4
North Melbourne,"Daw, Majak",14,4,4,10,0,0,33,5
North Melbourne,"Dumont, Trent",28,14,5,14,1,0,0,3
North Melbourne,"Durdin, Sam",18,14,11,4,0,0,0,1
North Melbourne,"Garner, Taylor",25,17,10,8,1,0,0,7
North Melbourne,"Gibson, Sam",28,19,7,9,1,1,0,1
North Melbourne,"Higgins, Shaun",23,15,4,8,0,1,0,5
North Melbourne,"Hrovat, Nathan",21,11,6,10,0,0,0,2
North Melbourne,"Larkey, Nick",0,0,0,0,0,0,2,0
North Melbourne,"McDonald, Luke",22,14,7,8,0,0,0,1
North Melbourne,"Mountford, Declan",14,9,7,5,0,0,0,2
North Melbourne,"Mullett, Aaron",16,15,3,1,1,0,0,4
North Melbourne,"Nielson, Dan",11,5,5,6,0,0,0,0
North Melbourne,"Simpkin, Jy",8,3,3,5,0,0,0,3
North Melbourne,"Swallow, Andrew",20,7,2,13,1,0,0,2
North Melbourne,"Thompson, Scott",16,11,9,5,0,0,0,1
North Melbourne,"Waite, Jarrad",14,12,8,2,4,2,0,1
North Melbourne,"Williams, Josh",14,7,6,7,1,0,0,3
North Melbourne,"Zurhaar, Cameron",10,6,3,4,0,1,0,0
North Melbourne,"Atley, Shaun",19,4,2,15,0,1,0,2
North Melbourne,"Brown, Ben",14,9,8,5,4,1,0,1
North Melbourne,"Clarke, Ryan",24,8,3,16,0,0,0,4
North Melbourne,"Cunnington, Ben",23,11,5,12,0,0,0,3
North Melbourne,"Daw, Majak",4,2,2,2,0,0,18,7
North Melbourne,"Dumont, Trent",14,5,0,9,0,0,0,4
North Melbourne,"Durdin, Sam",13,8,2,5,0,1,0,3
North Melbourne,"Garner, Taylor",17,7,1,10,0,2,0,3
North Melbourne,"Gibson, Sam",23,12,1,11,0,0,0,3
North Melbourne,"Higgins, Shaun",28,13,5,15,1,1,0,3
North Melbourne,"Hrovat, Nathan",17,8,4,9,0,0,0,1
North Melbourne,"McDonald, Luke",21,14,3,7,1,0,0,10
North Melbourne,"Mountford, Declan",16,7,3,9,0,0,0,1
North Melbourne,"Mullett, Aaron",20,10,2,10,0,0,0,2
North Melbourne,"Nielson, Dan",11,6,2,5,0,0,0,4
North Melbourne,"Preuss, Braydon",4,2,1,2,0,1,23,5
North Melbourne,"Simpkin, Jy",12,5,2,7,2,1,0,2
North Melbourne,"Swallow, Andrew",27,10,2,17,1,0,0,7
North Melbourne,"Tarrant, Robbie",9,6,1,3,0,0,0,7
North Melbourne,"Thompson, Scott",17,5,3,12,1,0,0,1
North Melbourne,"Waite, Jarrad",9,6,2,3,1,0,0,1
North Melbourne,"Ziebell, Jack",26,20,2,6,0,0,0,4
North Melbourne,"Atley, Shaun",19,6,4,13,0,2,0,2
North Melbourne,"Brown, Ben",6,4,4,2,0,2,0,0
North Melbourne,"Clarke, Ryan",31,12,10,19,0,0,0,0
North Melbourne,"Cunnington, Ben",28,13,4,15,0,0,0,4
North Melbourne,"Dumont, Trent",27,13,5,14,0,0,0,4
North Melbourne,"Durdin, Sam",6,4,3,2,0,1,0,2
North Melbourne,"Garner, Taylor",19,7,5,12,1,0,0,4
North Melbourne,"Gibson, Sam",27,10,7,17,0,1,0,2
North Melbourne,"Goldstein, Todd",14,8,5,6,0,1,13,1
North Melbourne,"Higgins, Shaun",19,11,4,8,0,1,0,4
North Melbourne,"Hrovat, Nathan",20,8,6,12,0,0,0,1
North Melbourne,"Larkey, Nick",6,2,1,4,0,0,0,1
North Melbourne,"McDonald, Luke",23,14,3,9,0,0,0,0
North Melbourne,"Mountford, Declan",19,6,4,13,1,0,0,4
North Melbourne,"Mullett, Aaron",21,15,5,6,0,0,0,1
North Melbourne,"Nielson, Dan",2,1,2,1,0,0,0,0
North Melbourne,"Preuss, Braydon",5,4,0,1,0,1,11,4
North Melbourne,"Swallow, Andrew",19,7,2,12,0,0,0,5
North Melbourne,"Tarrant, Robbie",21,13,9,8,0,0,0,0
North Melbourne,"Thompson, Scott",16,6,6,10,0,0,0,3
North Melbourne,"Williams, Josh",12,6,4,6,0,2,0,1
North Melbourne,"Ziebell, Jack",22,16,7,6,5,0,0,5
North Melbourne,"Atley, Shaun",17,7,5,10,1,1,0,2
North Melbourne,"Brown, Ben",11,9,4,2,3,1,0,1
North Melbourne,"Clarke, Ryan",27,10,8,17,0,0,0,0
North Melbourne,"Cunnington, Ben",21,10,3,11,0,0,0,5
North Melbourne,"Dumont, Trent",25,15,1,10,0,0,0,3
North Melbourne,"Durdin, Sam",10,7,4,3,0,1,0,1
North Melbourne,"Garner, Taylor",16,11,6,5,2,0,0,3
North Melbourne,"Gibson, Sam",26,10,7,16,0,0,0,2
North Melbourne,"Goldstein, Todd",4,1,0,3,0,0,22,1
North Melbourne,"Higgins, Shaun",31,15,4,16,1,0,0,4
North Melbourne,"Hrovat, Nathan",18,6,3,12,0,1,0,1
North Melbourne,"McDonald, Luke",22,15,5,7,1,0,0,3
North Melbourne,"Mountford, Declan",15,8,5,7,1,0,0,1
North Melbourne,"Mullett, Aaron",20,14,5,6,0,0,0,1
North Melbourne,"Nielson, Dan",13,9,5,4,0,0,0,1
North Melbourne,"Preuss, Braydon",9,6,5,3,2,1,25,3
North Melbourne,"Simpkin, Jy",12,7,3,5,0,0,0,3
North Melbourne,"Swallow, Andrew",19,11,1,8,0,0,0,13
North Melbourne,"Tarrant, Robbie",24,16,12,8,0,0,0,0
North Melbourne,"Thompson, Scott",14,9,4,5,0,0,0,4
North Melbourne,"Turner, Kayne",9,3,1,6,1,0,0,3
North Melbourne,"Zurhaar, Cameron",13,6,2,7,2,0,0,0
North Melbourne,"Atley, Shaun",17,11,3,6,0,0,0,2
North Melbourne,"Brown, Ben",9,9,8,0,2,2,0,2
North Melbourne,"Clarke, Ryan",25,12,4,13,0,0,0,1
North Melbourne,"Cunnington, Ben",36,12,5,24,2,0,0,7
North Melbourne,"Dumont, Trent",18,10,1,8,0,0,0,4
North Melbourne,"Durdin, Sam",7,3,2,4,0,0,0,2
North Melbourne,"Garner, Taylor",24,9,6,15,2,0,0,1
North Melbourne,"Gibson, Sam",21,10,5,11,1,0,0,5
North Melbourne,"Goldstein, Todd",15,5,7,10,1,0,24,3
North Melbourne,"Higgins, Shaun",32,14,4,18,0,1,0,4
North Melbourne,"Hrovat, Nathan",10,6,5,4,2,1,0,1
North Melbourne,"McDonald, Luke",26,11,5,15,0,0,0,3
North Melbourne,"Mountford, Declan",20,10,5,10,0,0,0,4
North Melbourne,"Nielson, Dan",0,0,0,0,0,0,0,0
North Melbourne,"Preuss, Braydon",8,5,4,3,0,1,13,0
North Melbourne,"Simpkin, Jy",11,4,3,7,1,0,0,2
North Melbourne,"Swallow, Andrew",20,9,3,11,0,0,0,7
North Melbourne,"Tarrant, Robbie",20,14,4,6,0,0,0,1
North Melbourne,"Thompson, Scott",18,7,6,11,0,0,0,3
North Melbourne,"Turner, Kayne",18,5,1,13,0,0,0,5
North Melbourne,"Ziebell, Jack",14,7,2,7,1,0,0,3
North Melbourne,"Zurhaar, Cameron",7,6,3,1,0,1,0,4
North Melbourne,"Anderson, Jed",13,11,3,2,1,2,0,7
North Melbourne,"Atley, Shaun",16,12,5,4,0,1,0,2
North Melbourne,"Brown, Ben",14,13,9,1,7,2,0,0
North Melbourne,"Clarke, Ryan",27,16,9,11,0,1,0,2
North Melbourne,"Cunnington, Ben",21,10,4,11,1,2,0,2
North Melbourne,"Dumont, Trent",26,13,5,13,0,0,0,6
North Melbourne,"Durdin, Sam",17,11,6,6,1,0,0,3
North Melbourne,"Gibson, Sam",21,13,7,8,0,1,0,1
North Melbourne,"Goldstein, Todd",16,5,4,11,1,0,31,4
North Melbourne,"Hansen, Lachlan",18,11,10,7,0,0,0,0
North Melbourne,"Higgins, Shaun",29,21,5,8,2,2,0,3
North Melbourne,"Hrovat, Nathan",18,10,7,8,1,1,0,1
North Melbourne,"McDonald, Luke",27,21,9,6,0,1,0,2
North Melbourne,"McKay, Ben",9,2,1,7,0,0,3,3
North Melbourne,"Mountford, Declan",10,5,2,5,0,0,0,5
North Melbourne,"Mullett, Aaron",21,16,8,5,0,0,0,2
North Melbourne,"Simpkin, Jy",17,9,4,8,1,0,0,0
North Melbourne,"Swallow, Andrew",22,13,4,9,0,0,0,1
North Melbourne,"Tarrant, Robbie",20,16,8,4,0,0,0,0
North Melbourne,"Thomas, Lindsay",10,8,3,2,3,1,0,5
North Melbourne,"Thompson, Scott",19,15,7,4,0,0,0,3
North Melbourne,"Turner, Kayne",9,4,3,5,1,0,0,4
Port Adelaide,"Amon, Karl",9,4,2,5,1,0,0,1
Port Adelaide,"Boak, Travis",26,15,4,11,2,0,0,3
Port Adelaide,"Broadbent, Matthew",12,11,3,1,0,0,0,1
Port Adelaide,"Byrne-Jones, Darcy",15,12,3,3,1,0,0,3
Port Adelaide,"Clurey, Tom",12,8,6,4,0,0,0,2
Port Adelaide,"Dixon, Charlie",12,8,2,4,2,3,2,5
Port Adelaide,"Ebert, Brad",25,17,2,8,0,0,0,11
Port Adelaide,"Eddy, Brett",3,2,1,1,0,0,0,2
Port Adelaide,"Gray, Robbie",8,3,1,5,0,0,0,1
Port Adelaide,"Gray, Sam",17,13,5,4,0,0,0,2
Port Adelaide,"Hartlett, Hamish",17,12,4,5,1,0,0,3
Port Adelaide,"Hombsch, Jack",12,9,5,3,0,0,0,1
Port Adelaide,"Houston, Dan",12,10,6,2,0,0,0,2
Port Adelaide,"Jonas, Tom",13,10,8,3,0,0,0,3
Port Adelaide,"Polec, Jared",19,13,1,6,1,0,0,5
Port Adelaide,"Powell-Pepper, Sam",19,12,3,7,2,1,0,2
Port Adelaide,"Ryder, Paddy",13,7,3,6,0,1,28,3
Port Adelaide,"Trengove, Jackson",12,7,3,5,1,0,12,2
Port Adelaide,"Westhoff, Justin",14,9,5,5,0,0,0,2
Port Adelaide,"Wines, Ollie",33,17,3,16,0,1,0,5
Port Adelaide,"Wingard, Chad",19,8,4,11,3,1,0,3
Port Adelaide,"Young, Aaron",17,8,3,9,3,1,0,3
Port Adelaide,"Amon, Karl",18,9,3,9,0,0,0,4
Port Adelaide,"Boak, Travis",25,12,3,13,1,2,0,3
Port Adelaide,"Broadbent, Matthew",20,9,4,11,0,0,0,4
Port Adelaide,"Byrne-Jones, Darcy",16,11,3,5,0,0,0,2
Port Adelaide,"Clurey, Tom",11,9,3,2,0,0,0,0
Port Adelaide,"Dixon, Charlie",12,8,7,4,4,1,6,3
Port Adelaide,"Ebert, Brad",28,15,6,13,0,0,0,4
Port Adelaide,"Eddy, Brett",11,10,2,1,2,3,0,3
Port Adelaide,"Gray, Robbie",30,17,7,13,6,0,0,2
Port Adelaide,"Gray, Sam",22,14,7,8,1,0,0,3
Port Adelaide,"Hombsch, Jack",8,5,2,3,0,1,0,0
Port Adelaide,"Houston, Dan",18,18,11,0,0,0,0,3
Port Adelaide,"Impey, Jarman",19,11,5,8,1,0,0,3
Port Adelaide,"Jonas, Tom",16,9,4,7,0,0,0,2
Port Adelaide,"Polec, Jared",19,10,3,9,1,0,0,5
Port Adelaide,"Powell-Pepper, Sam",25,9,4,16,1,0,0,3
Port Adelaide,"Ryder, Paddy",7,2,1,5,0,0,23,5
Port Adelaide,"Trengove, Jackson",11,6,4,5,0,0,1,4
Port Adelaide,"Westhoff, Justin",21,13,6,8,0,1,0,2
Port Adelaide,"Wines, Ollie",31,13,5,18,2,0,0,4
Port Adelaide,"Wingard, Chad",16,7,5,9,2,1,0,2
Port Adelaide,"Young, Aaron",16,8,5,8,1,3,0,1
Port Adelaide,"Amon, Karl",13,5,3,8,0,0,0,3
Port Adelaide,"Boak, Travis",26,13,6,13,1,0,0,4
Port Adelaide,"Broadbent, Matthew",13,9,2,4,0,0,0,3
Port Adelaide,"Byrne-Jones, Darcy",21,15,5,6,0,1,0,4
Port Adelaide,"Clurey, Tom",7,7,3,0,0,0,0,0
Port Adelaide,"Dixon, Charlie",12,6,5,6,1,0,4,6
Port Adelaide,"Ebert, Brad",26,15,2,11,0,0,0,9
Port Adelaide,"Eddy, Brett",7,4,2,3,1,0,0,2
Port Adelaide,"Gray, Robbie",19,9,2,10,2,0,0,8
Port Adelaide,"Gray, Sam",13,7,1,6,0,2,0,3
Port Adelaide,"Hartlett, Hamish",19,10,4,9,0,0,0,1
Port Adelaide,"Houston, Dan",17,12,4,5,0,1,0,3
Port Adelaide,"Impey, Jarman",11,5,4,6,1,0,0,3
Port Adelaide,"Jonas, Tom",9,6,5,3,0,0,0,2
Port Adelaide,"Polec, Jared",22,15,3,7,0,1,0,1
Port Adelaide,"Powell-Pepper, Sam",16,12,1,4,1,1,0,4
Port Adelaide,"Ryder, Paddy",11,5,4,6,0,1,48,3
Port Adelaide,"Trengove, Jackson",14,8,5,6,0,0,0,2
Port Adelaide,"Westhoff, Justin",16,13,3,3,1,0,0,6
Port Adelaide,"Wines, Ollie",30,17,3,13,2,1,0,7
Port Adelaide,"Wingard, Chad",9,8,2,1,2,1,0,3
Port Adelaide,"Young, Aaron",5,1,0,4,0,0,0,3
Port Adelaide,"Amon, Karl",18,14,3,4,1,1,0,1
Port Adelaide,"Boak, Travis",20,10,3,10,2,2,0,4
Port Adelaide,"Broadbent, Matthew",20,14,6,6,0,0,0,2
Port Adelaide,"Byrne-Jones, Darcy",10,3,3,7,0,0,0,1
Port Adelaide,"Clurey, Tom",10,8,5,2,0,0,0,1
Port Adelaide,"Dixon, Charlie",12,8,6,4,1,2,2,1
Port Adelaide,"Ebert, Brad",21,12,7,9,0,0,0,6
Port Adelaide,"Gray, Robbie",17,9,3,8,1,0,0,4
Port Adelaide,"Gray, Sam",14,7,6,7,1,2,0,1
Port Adelaide,"Hartlett, Hamish",14,8,3,6,0,0,0,4
Port Adelaide,"Houston, Dan",19,12,9,7,0,0,0,1
Port Adelaide,"Impey, Jarman",9,7,3,2,0,0,0,3
Port Adelaide,"Jonas, Tom",9,5,2,4,0,0,0,2
Port Adelaide,"Pittard, Jasper",24,18,7,6,0,1,0,1
Port Adelaide,"Polec, Jared",14,8,0,6,0,0,0,2
Port Adelaide,"Powell-Pepper, Sam",8,3,2,5,0,0,0,4
Port Adelaide,"Trengove, Jackson",9,6,3,3,1,0,27,5
Port Adelaide,"Westhoff, Justin",15,9,4,6,1,1,2,2
Port Adelaide,"White, Matt",11,5,2,6,0,0,0,5
Port Adelaide,"Wines, Ollie",19,10,1,9,1,0,0,7
Port Adelaide,"Wingard, Chad",14,9,3,5,1,2,0,0
Port Adelaide,"Young, Aaron",11,6,3,5,1,1,0,1
Port Adelaide,"Amon, Karl",24,11,6,13,0,0,0,6
Port Adelaide,"Boak, Travis",18,3,2,15,0,0,0,2
Port Adelaide,"Broadbent, Matthew",32,17,6,15,1,0,0,2
Port Adelaide,"Byrne-Jones, Darcy",24,13,6,11,0,0,0,1
Port Adelaide,"Clurey, Tom",16,11,6,5,0,0,0,2
Port Adelaide,"Dixon, Charlie",5,3,2,2,2,0,0,4
Port Adelaide,"Ebert, Brad",31,19,3,12,0,2,0,14
Port Adelaide,"Gray, Robbie",22,14,9,8,5,4,0,2
Port Adelaide,"Gray, Sam",22,7,11,15,1,1,0,4
Port Adelaide,"Houston, Dan",17,10,5,7,0,0,0,4
Port Adelaide,"Impey, Jarman",16,11,4,5,0,0,0,2
Port Adelaide,"Johnson, Aidyn",14,8,5,6,2,0,0,1
Port Adelaide,"Jonas, Tom",15,8,6,7,0,0,0,2
Port Adelaide,"Pittard, Jasper",28,19,6,9,0,1,0,1
Port Adelaide,"Polec, Jared",25,15,3,10,2,2,0,3
Port Adelaide,"Powell-Pepper, Sam",17,6,2,11,0,0,0,5
Port Adelaide,"Ryder, Paddy",9,6,1,3,0,0,41,5
Port Adelaide,"Trengove, Jackson",17,11,3,6,3,1,2,1
Port Adelaide,"Westhoff, Justin",20,10,5,10,1,1,4,3
Port Adelaide,"Wines, Ollie",35,9,5,26,0,0,0,2
Port Adelaide,"Wingard, Chad",25,16,4,9,1,4,0,10
Port Adelaide,"Young, Aaron",16,10,5,6,2,1,0,3
Port Adelaide,"Amon, Karl",21,13,5,8,1,0,0,4
Port Adelaide,"Broadbent, Matthew",18,10,5,8,0,0,0,2
Port Adelaide,"Byrne-Jones, Darcy",9,4,2,5,0,0,0,1
Port Adelaide,"Clurey, Tom",12,11,7,1,0,0,0,1
Port Adelaide,"Dixon, Charlie",20,15,12,5,4,3,0,3
Port Adelaide,"Ebert, Brad",25,11,6,14,1,0,0,5
Port Adelaide,"Gray, Robbie",13,12,5,1,4,4,0,0
Port Adelaide,"Gray, Sam",21,8,9,13,1,0,0,1
Port Adelaide,"Hartlett, Hamish",22,16,7,6,0,0,0,0
Port Adelaide,"Hombsch, Jack",14,8,5,6,0,0,0,1
Port Adelaide,"Houston, Dan",14,8,2,6,0,1,0,1
Port Adelaide,"Impey, Jarman",13,10,3,3,4,1,0,5
Port Adelaide,"Jonas, Tom",13,9,8,4,0,0,0,1
Port Adelaide,"Pittard, Jasper",24,17,8,7,0,1,0,0
Port Adelaide,"Polec, Jared",20,12,4,8,0,2,0,2
Port Adelaide,"Powell-Pepper, Sam",25,10,2,15,2,0,0,1
Port Adelaide,"Ryder, Paddy",14,7,5,7,1,0,26,0
Port Adelaide,"Trengove, Jackson",11,8,6,3,3,1,7,4
Port Adelaide,"Westhoff, Justin",18,13,10,5,0,0,0,3
Port Adelaide,"Wines, Ollie",20,10,3,10,1,1,0,6
Port Adelaide,"Wingard, Chad",31,15,1,16,0,1,0,1
Port Adelaide,"Young, Aaron",8,6,5,2,0,1,0,6
Port Adelaide,"Boak, Travis",20,8,6,12,1,1,0,6
Port Adelaide,"Broadbent, Matthew",23,12,7,11,1,0,0,3
Port Adelaide,"Byrne-Jones, Darcy",22,17,6,5,0,0,0,4
Port Adelaide,"Clurey, Tom",13,13,8,0,0,0,0,0
Port Adelaide,"Dixon, Charlie",22,10,10,12,3,1,0,5
Port Adelaide,"Ebert, Brad",30,14,4,16,1,0,0,5
Port Adelaide,"Gray, Robbie",15,3,1,12,0,0,0,1
Port Adelaide,"Gray, Sam",15,10,2,5,1,3,0,0
Port Adelaide,"Hartlett, Hamish",19,11,6,8,0,1,0,4
Port Adelaide,"Hombsch, Jack",16,16,9,0,0,0,0,1
Port Adelaide,"Houston, Dan",12,5,5,7,0,0,0,3
Port Adelaide,"Impey, Jarman",15,5,5,10,2,0,0,1
Port Adelaide,"Jonas, Tom",11,9,4,2,0,0,0,1
Port Adelaide,"Pittard, Jasper",27,16,9,11,0,0,0,4
Port Adelaide,"Polec, Jared",26,19,4,7,0,1,0,1
Port Adelaide,"Powell-Pepper, Sam",10,4,3,6,0,1,0,6
Port Adelaide,"Ryder, Paddy",20,13,7,7,1,0,42,2
Port Adelaide,"Trengove, Jackson",15,6,6,9,0,1,6,3
Port Adelaide,"Westhoff, Justin",21,14,6,7,1,0,0,2
Port Adelaide,"Wines, Ollie",20,5,0,15,0,0,0,5
Port Adelaide,"Wingard, Chad",34,25,7,9,1,2,0,3
Port Adelaide,"Young, Aaron",15,6,3,9,0,1,0,2
Port Adelaide,"Ah Chee, Brendon",13,8,0,5,3,0,0,3
Port Adelaide,"Amon, Karl",26,13,7,13,1,0,0,2
Port Adelaide,"Boak, Travis",30,20,11,10,2,3,0,6
Port Adelaide,"Broadbent, Matthew",28,16,10,12,0,0,0,0
Port Adelaide,"Byrne-Jones, Darcy",17,7,2,10,0,0,0,3
Port Adelaide,"Clurey, Tom",10,8,4,2,0,0,0,3
Port Adelaide,"Dixon, Charlie",17,13,6,4,2,2,0,3
Port Adelaide,"Ebert, Brad",31,15,4,16,0,0,0,4
Port Adelaide,"Gray, Robbie",13,7,3,6,2,2,0,1
Port Adelaide,"Gray, Sam",21,14,7,7,1,1,0,4
Port Adelaide,"Hartlett, Hamish",13,4,1,9,0,1,0,3
Port Adelaide,"Hombsch, Jack",18,12,8,6,0,0,0,4
Port Adelaide,"Impey, Jarman",10,7,0,3,2,0,0,8
Port Adelaide,"Jonas, Tom",17,11,7,6,0,0,0,1
Port Adelaide,"Pittard, Jasper",27,17,5,10,0,0,0,1
Port Adelaide,"Polec, Jared",29,17,7,12,1,0,0,6
Port Adelaide,"Powell-Pepper, Sam",21,9,5,12,0,0,0,3
Port Adelaide,"Ryder, Paddy",13,6,1,7,0,0,35,4
Port Adelaide,"Trengove, Jackson",13,5,4,8,1,0,7,4
Port Adelaide,"Westhoff, Justin",28,14,4,14,1,2,0,3
Port Adelaide,"Wines, Ollie",29,14,1,15,0,0,0,5
Port Adelaide,"Wingard, Chad",28,18,5,10,0,0,0,2
Port Adelaide,"Ah Chee, Brendon",16,7,2,9,1,1,0,1
Port Adelaide,"Amon, Karl",10,7,1,3,0,1,0,3
Port Adelaide,"Boak, Travis",18,7,2,11,0,0,0,3
Port Adelaide,"Broadbent, Matthew",9,6,2,3,0,0,0,2
Port Adelaide,"Byrne-Jones, Darcy",12,9,4,3,0,0,0,2
Port Adelaide,"Clurey, Tom",10,9,5,1,0,0,0,1
Port Adelaide,"Dixon, Charlie",13,10,7,3,1,2,1,3
Port Adelaide,"Ebert, Brad",19,8,2,11,0,0,0,10
Port Adelaide,"Gray, Robbie",15,9,4,6,3,1,0,1
Port Adelaide,"Gray, Sam",12,7,4,5,1,0,0,2
Port Adelaide,"Hartlett, Hamish",12,8,3,4,0,0,0,2
Port Adelaide,"Hombsch, Jack",7,5,0,2,0,0,0,5
Port Adelaide,"Impey, Jarman",9,7,0,2,0,0,0,4
Port Adelaide,"Jonas, Tom",13,10,4,3,0,0,0,2
Port Adelaide,"Pittard, Jasper",9,8,2,1,0,1,0,6
Port Adelaide,"Polec, Jared",29,19,7,10,1,1,0,5
Port Adelaide,"Powell-Pepper, Sam",15,9,1,6,1,0,0,4
Port Adelaide,"Ryder, Paddy",12,7,3,5,1,0,31,1
Port Adelaide,"Trengove, Jackson",12,7,0,5,0,1,9,6
Port Adelaide,"Westhoff, Justin",19,14,9,5,1,2,0,3
Port Adelaide,"Wines, Ollie",31,13,3,18,0,0,0,8
Port Adelaide,"Young, Aaron",11,6,6,5,1,0,0,0
Port Adelaide,"Ah Chee, Brendon",26,12,2,14,1,0,0,4
Port Adelaide,"Boak, Travis",23,11,7,12,1,0,0,3
Port Adelaide,"Broadbent, Matthew",24,13,5,11,1,0,0,3
Port Adelaide,"Byrne-Jones, Darcy",16,10,2,6,0,1,0,0
Port Adelaide,"Clurey, Tom",13,8,6,5,0,0,0,0
Port Adelaide,"Dixon, Charlie",20,13,8,7,4,1,0,6
Port Adelaide,"Ebert, Brad",34,16,5,18,0,1,0,12
Port Adelaide,"Gray, Robbie",10,3,1,7,1,0,0,2
Port Adelaide,"Gray, Sam",22,14,7,8,1,2,0,1
Port Adelaide,"Hartlett, Hamish",24,14,8,10,0,0,0,1
Port Adelaide,"Hombsch, Jack",14,12,8,2,0,0,0,1
Port Adelaide,"Impey, Jarman",14,9,5,5,2,4,0,2
Port Adelaide,"Jonas, Tom",7,4,4,3,0,0,0,1
Port Adelaide,"Pittard, Jasper",17,13,4,4,0,0,0,2
Port Adelaide,"Polec, Jared",24,14,6,10,0,2,0,5
Port Adelaide,"Powell-Pepper, Sam",18,6,0,12,1,1,0,6
Port Adelaide,"Ryder, Paddy",13,10,5,3,1,2,23,0
Port Adelaide,"Toumpas, Jimmy",26,20,7,6,0,1,0,1
Port Adelaide,"Trengove, Jackson",14,4,2,10,0,0,19,5
Port Adelaide,"Westhoff, Justin",18,7,5,11,0,1,0,4
Port Adelaide,"Wines, Ollie",28,14,4,14,0,1,0,6
Port Adelaide,"Young, Aaron",15,9,6,6,0,2,0,3
Port Adelaide,"Ah Chee, Brendon",9,6,2,3,1,0,0,0
Port Adelaide,"Boak, Travis",20,3,3,17,0,0,0,9
Port Adelaide,"Broadbent, Matthew",18,12,5,6,0,0,0,5
Port Adelaide,"Byrne-Jones, Darcy",12,10,4,2,0,0,0,6
Port Adelaide,"Clurey, Tom",16,11,10,5,0,0,0,1
Port Adelaide,"Dixon, Charlie",7,3,2,4,0,1,3,2
Port Adelaide,"Ebert, Brad",26,16,6,10,0,0,0,8
Port Adelaide,"Gray, Robbie",14,11,3,3,3,0,0,3
Port Adelaide,"Gray, Sam",19,10,5,9,1,3,0,1
Port Adelaide,"Hartlett, Hamish",17,6,3,11,0,0,0,1
Port Adelaide,"Hombsch, Jack",7,4,4,3,0,0,0,2
Port Adelaide,"Impey, Jarman",11,7,2,4,0,1,0,5
Port Adelaide,"Jonas, Tom",18,10,7,8,0,0,0,1
Port Adelaide,"Pittard, Jasper",15,6,2,9,0,0,0,3
Port Adelaide,"Polec, Jared",22,16,1,6,0,0,0,4
Port Adelaide,"Powell-Pepper, Sam",16,7,3,9,1,0,0,6
Port Adelaide,"Ryder, Paddy",10,6,0,4,0,0,37,1
Port Adelaide,"Toumpas, Jimmy",14,9,2,5,0,0,0,3
Port Adelaide,"Trengove, Jackson",13,9,8,4,1,1,8,0
Port Adelaide,"Westhoff, Justin",33,16,5,17,1,2,1,6
Port Adelaide,"Wines, Ollie",27,14,7,13,0,1,0,5
Port Adelaide,"Wingard, Chad",18,10,6,8,0,2,0,2
Port Adelaide,"Boak, Travis",19,8,2,11,1,1,0,3
Port Adelaide,"Broadbent, Matthew",20,11,3,9,0,0,0,1
Port Adelaide,"Byrne-Jones, Darcy",25,18,4,7,0,0,0,4
Port Adelaide,"Clurey, Tom",15,8,5,7,0,0,0,2
Port Adelaide,"Dixon, Charlie",16,8,6,8,1,0,0,0
Port Adelaide,"Ebert, Brad",24,15,2,9,0,1,0,8
Port Adelaide,"Gray, Robbie",21,13,7,8,2,4,0,6
Port Adelaide,"Gray, Sam",22,18,7,4,1,3,0,3
Port Adelaide,"Hartlett, Hamish",15,7,4,8,1,0,0,0
Port Adelaide,"Hombsch, Jack",11,8,6,3,0,0,0,4
Port Adelaide,"Houston, Dan",17,7,4,10,0,0,0,3
Port Adelaide,"Impey, Jarman",10,6,2,4,0,0,0,1
Port Adelaide,"Jonas, Tom",13,10,4,3,0,0,0,1
Port Adelaide,"Neade, Jake",11,4,2,7,1,0,0,6
Port Adelaide,"Polec, Jared",21,9,1,12,0,0,0,3
Port Adelaide,"Powell-Pepper, Sam",16,7,1,9,2,1,0,5
Port Adelaide,"Ryder, Paddy",11,9,4,2,2,0,40,1
Port Adelaide,"Trengove, Jackson",17,8,2,9,0,1,13,1
Port Adelaide,"Westhoff, Justin",22,10,5,12,0,0,0,5
Port Adelaide,"Wines, Ollie",29,18,8,11,2,2,0,1
Port Adelaide,"Wingard, Chad",19,14,2,5,3,0,0,6
Port Adelaide,"Young, Aaron",9,2,1,7,2,0,0,2
Port Adelaide,"Boak, Travis",21,9,4,12,0,0,0,3
Port Adelaide,"Byrne-Jones, Darcy",16,10,6,6,0,1,0,4
Port Adelaide,"Clurey, Tom",17,13,7,4,0,0,0,1
Port Adelaide,"Dixon, Charlie",12,10,6,2,1,1,0,2
Port Adelaide,"Ebert, Brad",15,7,1,8,0,0,0,7
Port Adelaide,"Gray, Robbie",20,8,5,12,5,1,0,1
Port Adelaide,"Gray, Sam",20,16,7,4,2,2,0,1
Port Adelaide,"Hartlett, Hamish",25,11,4,14,0,1,0,3
Port Adelaide,"Hombsch, Jack",10,4,1,6,0,0,0,2
Port Adelaide,"Houston, Dan",13,6,5,7,0,0,0,0
Port Adelaide,"Impey, Jarman",15,14,6,1,1,3,0,1
Port Adelaide,"Jonas, Tom",17,12,9,5,0,0,0,3
Port Adelaide,"Neade, Jake",12,6,3,6,1,0,0,1
Port Adelaide,"Pittard, Jasper",23,11,6,12,0,0,0,1
Port Adelaide,"Powell-Pepper, Sam",20,9,4,11,0,0,0,8
Port Adelaide,"Ryder, Paddy",10,9,5,1,0,1,29,2
Port Adelaide,"Trengove, Jackson",15,10,3,5,0,0,6,5
Port Adelaide,"Westhoff, Justin",12,6,5,6,0,0,0,2
Port Adelaide,"White, Matt",21,15,5,6,1,1,0,2
Port Adelaide,"Wines, Ollie",23,12,3,11,1,2,0,5
Port Adelaide,"Wingard, Chad",14,11,4,3,1,0,0,7
Port Adelaide,"Young, Aaron",12,1,3,11,0,0,0,3
Port Adelaide,"Boak, Travis",18,13,9,5,0,0,0,5
Port Adelaide,"Broadbent, Matthew",13,9,4,4,0,0,0,1
Port Adelaide,"Byrne-Jones, Darcy",16,14,6,2,0,0,0,2
Port Adelaide,"Clurey, Tom",9,7,5,2,0,0,0,3
Port Adelaide,"Dixon, Charlie",12,8,9,4,1,1,3,2
Port Adelaide,"Ebert, Brad",18,7,4,11,1,0,0,4
Port Adelaide,"Gray, Robbie",14,10,5,4,1,3,0,0
Port Adelaide,"Gray, Sam",18,12,7,6,1,2,0,7
Port Adelaide,"Hartlett, Hamish",14,8,7,6,0,0,0,1
Port Adelaide,"Houston, Dan",21,12,9,9,0,0,0,5
Port Adelaide,"Impey, Jarman",12,10,4,2,0,1,0,4
Port Adelaide,"Jonas, Tom",20,11,6,9,0,0,0,3
Port Adelaide,"Neade, Jake",13,7,1,6,1,0,0,5
Port Adelaide,"Pittard, Jasper",17,11,4,6,0,0,0,3
Port Adelaide,"Polec, Jared",25,16,7,9,0,0,0,0
Port Adelaide,"Powell-Pepper, Sam",24,13,3,11,2,2,0,2
Port Adelaide,"Ryder, Paddy",17,10,5,7,0,0,42,5
Port Adelaide,"Trengove, Jackson",11,6,1,5,1,1,0,1
Port Adelaide,"Westhoff, Justin",21,12,4,9,0,0,7,3
Port Adelaide,"White, Matt",17,14,9,3,0,3,0,3
Port Adelaide,"Wines, Ollie",28,13,7,15,0,1,0,4
Port Adelaide,"Wingard, Chad",39,27,6,12,0,1,0,4
Port Adelaide,"Atley, Joe",14,3,2,11,0,0,0,3
Port Adelaide,"Boak, Travis",25,11,9,14,1,0,0,5
Port Adelaide,"Byrne-Jones, Darcy",12,9,2,3,0,0,0,2
Port Adelaide,"Clurey, Tom",11,5,5,6,0,0,0,0
Port Adelaide,"Dixon, Charlie",14,10,7,4,5,1,0,1
Port Adelaide,"Ebert, Brad",31,14,6,17,0,0,0,8
Port Adelaide,"Gray, Robbie",13,9,5,4,3,1,0,1
Port Adelaide,"Gray, Sam",8,6,4,2,0,0,0,3
Port Adelaide,"Hartlett, Hamish",16,11,9,5,1,1,0,0
Port Adelaide,"Hombsch, Jack",7,5,2,2,0,0,0,0
Port Adelaide,"Houston, Dan",19,14,11,5,0,0,0,1
Port Adelaide,"Impey, Jarman",8,6,3,2,0,0,0,3
Port Adelaide,"Jonas, Tom",17,8,3,9,0,0,0,4
Port Adelaide,"Pittard, Jasper",17,6,2,11,0,0,0,3
Port Adelaide,"Polec, Jared",19,12,3,7,0,1,0,0
Port Adelaide,"Powell-Pepper, Sam",16,11,3,5,0,2,0,5
Port Adelaide,"Ryder, Paddy",17,9,5,8,2,0,39,6
Port Adelaide,"Trengove, Jackson",15,7,5,8,2,1,11,3
Port Adelaide,"Westhoff, Justin",23,14,7,9,2,1,0,3
Port Adelaide,"White, Matt",10,6,2,4,0,0,0,4
Port Adelaide,"Wines, Ollie",28,13,2,15,1,1,0,7
Port Adelaide,"Wingard, Chad",21,13,1,8,1,1,0,1
Port Adelaide,"Atley, Joe",13,3,2,10,0,0,0,2
Port Adelaide,"Austin, Logan",10,7,4,3,0,0,0,3
Port Adelaide,"Boak, Travis",24,9,9,15,0,0,0,4
Port Adelaide,"Byrne-Jones, Darcy",13,7,4,6,0,0,0,2
Port Adelaide,"Clurey, Tom",10,8,3,2,0,0,0,1
Port Adelaide,"Dixon, Charlie",18,12,7,6,1,0,0,4
Port Adelaide,"Ebert, Brad",30,18,2,12,0,2,0,5
Port Adelaide,"Gray, Robbie",19,7,5,12,2,3,0,2
Port Adelaide,"Gray, Sam",25,15,10,10,4,1,0,1
Port Adelaide,"Hartlett, Hamish",19,12,1,7,1,0,0,4
Port Adelaide,"Houston, Dan",10,9,5,1,0,0,0,5
Port Adelaide,"Impey, Jarman",11,7,1,4,0,0,0,2
Port Adelaide,"Jonas, Tom",10,5,4,5,0,0,0,1
Port Adelaide,"Pittard, Jasper",17,12,4,5,0,0,0,0
Port Adelaide,"Polec, Jared",23,15,6,8,1,0,0,3
Port Adelaide,"Powell-Pepper, Sam",26,13,8,13,2,1,0,3
Port Adelaide,"Ryder, Paddy",14,8,5,6,0,1,37,1
Port Adelaide,"Trengove, Jackson",14,8,3,6,2,2,10,2
Port Adelaide,"Westhoff, Justin",27,21,12,6,1,0,0,1
Port Adelaide,"White, Matt",15,9,1,6,1,0,0,2
Port Adelaide,"Wines, Ollie",31,14,6,17,1,0,0,5
Port Adelaide,"Wingard, Chad",30,17,6,13,3,1,0,5
Port Adelaide,"Atley, Joe",10,3,0,7,0,0,0,7
Port Adelaide,"Austin, Logan",3,2,1,1,0,0,0,2
Port Adelaide,"Boak, Travis",24,12,6,12,4,0,0,6
Port Adelaide,"Broadbent, Matthew",18,9,3,9,0,0,0,1
Port Adelaide,"Byrne-Jones, Darcy",17,10,3,7,0,0,0,2
Port Adelaide,"Clurey, Tom",14,7,3,7,0,0,0,1
Port Adelaide,"Dixon, Charlie",13,10,7,3,1,1,0,1
Port Adelaide,"Ebert, Brad",28,12,4,16,0,0,0,11
Port Adelaide,"Gray, Robbie",31,17,4,14,0,0,0,4
Port Adelaide,"Gray, Sam",18,8,5,10,0,0,0,6
Port Adelaide,"Hartlett, Hamish",14,7,4,7,0,0,0,3
Port Adelaide,"Houston, Dan",13,8,2,5,0,1,0,9
Port Adelaide,"Impey, Jarman",14,7,1,7,0,2,0,3
Port Adelaide,"Jonas, Tom",10,8,4,2,0,0,0,5
Port Adelaide,"Polec, Jared",16,11,2,5,0,0,0,3
Port Adelaide,"Powell-Pepper, Sam",16,6,3,10,0,1,0,7
Port Adelaide,"Ryder, Paddy",13,12,3,1,0,1,48,2
Port Adelaide,"Trengove, Jackson",10,5,1,5,1,0,2,7
Port Adelaide,"Westhoff, Justin",16,7,6,9,2,0,0,2
Port Adelaide,"White, Matt",10,7,1,3,0,0,0,1
Port Adelaide,"Wines, Ollie",23,11,5,12,0,0,0,9
Port Adelaide,"Wingard, Chad",13,11,3,2,1,3,0,2
Port Adelaide,"Amon, Karl",20,17,6,3,1,0,0,0
Port Adelaide,"Boak, Travis",13,6,3,7,0,0,0,2
Port Adelaide,"Broadbent, Matthew",12,8,2,4,0,0,0,1
Port Adelaide,"Byrne-Jones, Darcy",15,13,7,2,0,0,0,5
Port Adelaide,"Clurey, Tom",11,8,5,3,0,0,0,2
Port Adelaide,"Dixon, Charlie",14,9,7,5,1,1,0,3
Port Adelaide,"Ebert, Brad",14,10,2,4,1,0,0,5
Port Adelaide,"Gray, Robbie",27,15,5,12,1,1,0,3
Port Adelaide,"Gray, Sam",14,12,3,2,0,0,0,2
Port Adelaide,"Hartlett, Hamish",19,12,7,7,0,0,0,3
Port Adelaide,"Hombsch, Jack",9,7,2,2,0,0,0,3
Port Adelaide,"Impey, Jarman",9,8,5,1,1,1,0,4
Port Adelaide,"Jonas, Tom",14,12,5,2,0,0,0,3
Port Adelaide,"Pittard, Jasper",24,15,5,9,0,0,0,3
Port Adelaide,"Polec, Jared",30,18,6,12,1,0,0,3
Port Adelaide,"Powell-Pepper, Sam",10,7,1,3,0,0,0,9
Port Adelaide,"Ryder, Paddy",15,11,4,4,0,0,45,0
Port Adelaide,"Trengove, Jackson",14,9,2,5,1,1,6,2
Port Adelaide,"Westhoff, Justin",11,6,1,5,1,1,0,4
Port Adelaide,"White, Matt",9,4,2,5,0,0,0,3
Port Adelaide,"Wines, Ollie",23,15,1,8,0,1,0,6
Port Adelaide,"Young, Aaron",12,8,2,4,1,0,0,6
Port Adelaide,"Amon, Karl",12,5,1,7,0,1,0,1
Port Adelaide,"Boak, Travis",19,13,2,6,0,0,0,11
Port Adelaide,"Byrne-Jones, Darcy",7,3,1,4,0,0,0,5
Port Adelaide,"Clurey, Tom",6,4,1,2,0,0,0,2
Port Adelaide,"Dixon, Charlie",10,8,3,2,2,1,4,6
Port Adelaide,"Ebert, Brad",21,9,2,12,1,0,0,5
Port Adelaide,"Gray, Robbie",33,17,4,16,1,0,0,5
Port Adelaide,"Gray, Sam",16,10,3,6,0,0,0,2
Port Adelaide,"Hartlett, Hamish",17,6,5,11,0,0,0,2
Port Adelaide,"Hombsch, Jack",10,6,4,4,1,0,0,3
Port Adelaide,"Impey, Jarman",11,7,1,4,0,0,0,3
Port Adelaide,"Johnson, Aidyn",7,3,2,4,0,0,0,5
Port Adelaide,"Jonas, Tom",18,14,7,4,0,0,0,6
Port Adelaide,"Monfries, Angus",8,2,0,6,0,0,0,1
Port Adelaide,"Pittard, Jasper",18,11,3,7,0,0,0,1
Port Adelaide,"Polec, Jared",18,14,4,4,1,0,0,2
Port Adelaide,"Powell-Pepper, Sam",6,2,0,4,0,1,0,4
Port Adelaide,"Ryder, Paddy",11,4,2,7,0,0,40,6
Port Adelaide,"Trengove, Jackson",12,7,2,5,0,1,3,0
Port Adelaide,"Westhoff, Justin",14,8,1,6,1,0,2,4
Port Adelaide,"Wines, Ollie",23,9,0,14,0,0,0,4
Port Adelaide,"Young, Aaron",10,2,0,8,0,0,0,3
Port Adelaide,"Ah Chee, Brendon",15,3,2,12,1,0,0,1
Port Adelaide,"Amon, Karl",21,13,6,8,0,1,0,2
Port Adelaide,"Boak, Travis",23,9,1,14,2,0,0,3
Port Adelaide,"Byrne-Jones, Darcy",10,5,2,5,0,0,0,4
Port Adelaide,"Clurey, Tom",15,8,4,7,0,0,0,2
Port Adelaide,"Dixon, Charlie",17,9,6,8,1,1,0,3
Port Adelaide,"Ebert, Brad",28,10,5,18,0,2,0,4
Port Adelaide,"Gray, Robbie",16,9,6,7,2,1,0,2
Port Adelaide,"Gray, Sam",16,11,8,5,2,2,0,0
Port Adelaide,"Hartlett, Hamish",21,11,10,10,0,0,0,2
Port Adelaide,"Houston, Dan",21,12,4,9,1,0,0,2
Port Adelaide,"Howard, Dougal",12,9,5,3,1,0,0,0
Port Adelaide,"Impey, Jarman",11,5,4,6,1,0,0,2
Port Adelaide,"Johnson, Aidyn",13,5,3,8,0,1,0,3
Port Adelaide,"Jonas, Tom",10,6,5,4,0,0,0,6
Port Adelaide,"Neade, Jake",18,9,4,9,1,0,0,3
Port Adelaide,"Pittard, Jasper",26,15,7,11,0,2,0,1
Port Adelaide,"Polec, Jared",22,11,6,11,0,1,0,0
Port Adelaide,"Ryder, Paddy",9,5,2,4,1,0,31,2
Port Adelaide,"Westhoff, Justin",17,11,8,6,0,0,3,1
Port Adelaide,"Wines, Ollie",29,8,1,21,1,0,0,2
Port Adelaide,"Wingard, Chad",32,19,8,13,0,1,0,3
Port Adelaide,"Amon, Karl",22,14,4,8,0,0,0,2
Port Adelaide,"Boak, Travis",33,14,7,19,1,1,0,7
Port Adelaide,"Bonner, Riley",18,11,6,7,0,0,0,1
Port Adelaide,"Byrne-Jones, Darcy",19,12,5,7,0,0,0,1
Port Adelaide,"Clurey, Tom",9,7,6,2,0,0,0,0
Port Adelaide,"Dixon, Charlie",18,10,8,8,4,0,3,4
Port Adelaide,"Ebert, Brad",18,11,3,7,0,0,0,8
Port Adelaide,"Gray, Robbie",18,11,4,7,2,2,0,2
Port Adelaide,"Gray, Sam",15,13,7,2,1,1,0,3
Port Adelaide,"Hartlett, Hamish",17,14,5,3,0,0,0,5
Port Adelaide,"Houston, Dan",15,12,6,3,0,0,0,3
Port Adelaide,"Howard, Dougal",11,8,6,3,0,0,0,0
Port Adelaide,"Johnson, Aidyn",6,2,1,4,0,0,0,4
Port Adelaide,"Jonas, Tom",16,9,5,7,0,0,0,4
Port Adelaide,"Marshall, Todd",10,5,3,5,0,0,0,4
Port Adelaide,"Neade, Jake",18,8,2,10,0,1,0,5
Port Adelaide,"Polec, Jared",23,12,6,11,1,0,0,7
Port Adelaide,"Powell-Pepper, Sam",16,8,4,8,0,0,0,12
Port Adelaide,"Ryder, Paddy",12,7,3,5,2,0,55,5
Port Adelaide,"Westhoff, Justin",13,9,3,4,0,0,3,6
Port Adelaide,"Wines, Ollie",28,11,3,17,1,2,0,6
Port Adelaide,"Wingard, Chad",15,9,5,6,2,1,0,4
Port Adelaide,"Amon, Karl",24,14,6,10,0,0,0,3
Port Adelaide,"Boak, Travis",24,7,4,17,0,0,0,1
Port Adelaide,"Bonner, Riley",17,11,6,6,0,0,0,4
Port Adelaide,"Byrne-Jones, Darcy",25,15,8,10,0,0,0,2
Port Adelaide,"Clurey, Tom",16,12,8,4,0,0,0,0
Port Adelaide,"Dixon, Charlie",16,9,9,7,4,1,0,0
Port Adelaide,"Ebert, Brad",24,12,3,12,1,0,0,12
Port Adelaide,"Gray, Robbie",18,7,4,11,1,1,0,1
Port Adelaide,"Gray, Sam",24,17,8,7,6,3,0,0
Port Adelaide,"Hartlett, Hamish",21,13,6,8,0,1,0,3
Port Adelaide,"Houston, Dan",20,12,7,8,1,0,0,3
Port Adelaide,"Howard, Dougal",18,14,9,4,0,0,0,1
Port Adelaide,"Johnson, Aidyn",7,5,3,2,0,0,0,4
Port Adelaide,"Marshall, Todd",6,5,4,1,1,2,0,2
Port Adelaide,"Neade, Jake",15,9,3,6,2,0,0,9
Port Adelaide,"Pittard, Jasper",19,8,9,11,0,1,0,2
Port Adelaide,"Polec, Jared",20,11,3,9,1,0,0,1
Port Adelaide,"Powell-Pepper, Sam",16,9,3,7,0,1,0,5
Port Adelaide,"Ryder, Paddy",20,14,3,6,0,0,37,4
Port Adelaide,"Westhoff, Justin",21,13,5,8,1,0,5,1
Port Adelaide,"Wines, Ollie",32,15,4,17,0,2,0,5
Port Adelaide,"Wingard, Chad",20,12,4,8,2,1,0,3
Port Adelaide,"Amon, Karl",24,14,5,10,0,1,0,2
Port Adelaide,"Boak, Travis",26,14,2,12,0,3,0,6
Port Adelaide,"Bonner, Riley",19,10,3,9,0,0,0,2
Port Adelaide,"Byrne-Jones, Darcy",24,12,5,12,0,0,0,5
Port Adelaide,"Clurey, Tom",8,5,3,3,0,0,0,1
Port Adelaide,"Dixon, Charlie",23,18,7,5,3,6,1,4
Port Adelaide,"Ebert, Brad",22,6,3,16,1,0,0,11
Port Adelaide,"Gray, Robbie",30,12,6,18,0,1,0,6
Port Adelaide,"Gray, Sam",17,12,6,5,2,0,0,3
Port Adelaide,"Hartlett, Hamish",21,13,5,8,0,0,0,2
Port Adelaide,"Houston, Dan",18,8,6,10,0,0,0,4
Port Adelaide,"Howard, Dougal",14,12,7,2,0,0,0,2
Port Adelaide,"Impey, Jarman",10,9,2,1,0,1,0,3
Port Adelaide,"Marshall, Todd",10,5,3,5,0,0,0,4
Port Adelaide,"Neade, Jake",19,8,3,11,0,0,0,1
Port Adelaide,"Pittard, Jasper",11,9,4,2,0,0,0,2
Port Adelaide,"Polec, Jared",25,19,4,6,0,0,0,4
Port Adelaide,"Powell-Pepper, Sam",19,10,1,9,1,1,0,10
Port Adelaide,"Ryder, Paddy",7,3,0,4,0,1,54,5
Port Adelaide,"Westhoff, Justin",21,11,6,10,0,0,4,2
Port Adelaide,"Wines, Ollie",28,9,4,19,2,0,0,3
Port Adelaide,"Wingard, Chad",24,13,6,11,1,2,0,2
Richmond,"Astbury, David",13,7,3,6,0,0,0,2
Richmond,"Butler, Dan",19,12,1,7,2,1,0,3
Richmond,"Caddy, Josh",17,9,3,8,1,1,0,2
Richmond,"Castagna, Jason",20,12,3,8,2,4,0,4
Richmond,"Conca, Reece",19,13,4,6,0,1,0,5
Richmond,"Cotchin, Trent",21,11,3,10,1,0,0,8
Richmond,"Edwards, Shane",15,5,3,10,1,1,0,2
Richmond,"Ellis, Brandon",21,11,0,10,0,0,0,1
Richmond,"Griffiths, Ben",9,5,4,4,0,0,8,6
Richmond,"Grigg, Shaun",27,16,4,11,1,0,0,6
Richmond,"Grimes, Dylan",11,4,1,7,0,0,0,7
Richmond,"Houli, Bachar",14,4,1,10,0,0,0,3
Richmond,"Hunt, Taylor",9,1,0,8,0,0,0,0
Richmond,"Lloyd, Sam",10,5,3,5,1,0,0,1
Richmond,"Martin, Dustin",33,23,5,10,4,0,0,4
Richmond,"McIntosh, Kamdyn",16,11,5,5,0,0,0,1
Richmond,"Nankervis, Toby",8,7,3,1,2,0,27,3
Richmond,"Prestia, Dion",28,15,2,13,1,0,0,5
Richmond,"Rance, Alex",9,7,4,2,0,0,0,3
Richmond,"Riewoldt, Jack",12,10,5,2,1,1,0,7
Richmond,"Rioli, Daniel",10,6,3,4,2,0,0,2
Richmond,"Vlastuin, Nick",11,6,5,5,1,0,0,12
Richmond,"Astbury, David",10,7,6,3,0,0,0,0
Richmond,"Butler, Dan",13,4,3,9,1,1,0,3
Richmond,"Caddy, Josh",19,14,4,5,1,2,0,5
Richmond,"Castagna, Jason",8,3,2,5,0,0,0,2
Richmond,"Conca, Reece",18,14,3,4,0,0,0,3
Richmond,"Cotchin, Trent",26,17,2,9,2,1,0,7
Richmond,"Edwards, Shane",17,12,3,5,1,2,0,6
Richmond,"Ellis, Brandon",14,11,3,3,1,1,0,3
Richmond,"Griffiths, Ben",6,5,4,1,0,1,3,0
Richmond,"Grigg, Shaun",17,10,4,7,1,0,0,1
Richmond,"Grimes, Dylan",3,2,2,1,0,0,0,4
Richmond,"Houli, Bachar",23,12,3,11,1,1,0,1
Richmond,"Lambert, Kane",12,2,2,10,0,0,0,1
Richmond,"Lennon, Ben",9,6,2,3,1,0,0,3
Richmond,"Martin, Dustin",25,17,3,8,2,2,0,1
Richmond,"Nankervis, Toby",21,12,5,9,0,0,18,2
Richmond,"Prestia, Dion",24,15,1,9,0,2,0,4
Richmond,"Rance, Alex",17,9,7,8,0,0,0,1
Richmond,"Riewoldt, Jack",11,6,4,5,2,1,0,6
Richmond,"Rioli, Daniel",13,6,6,7,1,0,0,1
Richmond,"Short, Jayden",18,15,3,3,0,0,0,2
Richmond,"Vlastuin, Nick",12,8,3,4,0,0,0,2
Richmond,"Astbury, David",13,6,6,7,0,0,0,1
Richmond,"Butler, Dan",17,9,2,8,2,1,0,1
Richmond,"Caddy, Josh",15,6,0,9,0,0,0,4
Richmond,"Castagna, Jason",16,11,8,5,1,1,0,6
Richmond,"Conca, Reece",25,16,6,9,0,3,0,4
Richmond,"Cotchin, Trent",34,21,3,13,0,0,0,5
Richmond,"Ellis, Brandon",20,15,4,5,0,0,0,3
Richmond,"Elton, Todd",9,3,3,6,0,0,5,4
Richmond,"Grigg, Shaun",21,9,5,12,1,0,1,4
Richmond,"Grimes, Dylan",9,4,3,5,0,0,0,3
Richmond,"Houli, Bachar",23,16,2,7,1,0,0,3
Richmond,"Lambert, Kane",19,11,1,8,1,0,0,6
Richmond,"Lennon, Ben",8,5,1,3,0,0,0,1
Richmond,"Martin, Dustin",40,33,3,7,2,1,0,5
Richmond,"McIntosh, Kamdyn",22,12,4,10,0,1,0,6
Richmond,"Nankervis, Toby",18,8,4,10,0,0,21,2
Richmond,"Prestia, Dion",18,7,1,11,0,0,0,4
Richmond,"Rance, Alex",20,12,4,8,0,0,0,3
Richmond,"Riewoldt, Jack",22,17,8,5,1,2,0,4
Richmond,"Rioli, Daniel",9,3,0,6,2,0,0,2
Richmond,"Short, Jayden",11,7,0,4,0,0,0,1
Richmond,"Vlastuin, Nick",10,5,1,5,0,0,0,4
Richmond,"Astbury, David",16,11,5,5,0,0,0,1
Richmond,"Butler, Dan",14,7,4,7,1,1,0,3
Richmond,"Caddy, Josh",18,11,2,7,1,0,0,0
Richmond,"Castagna, Jason",16,12,6,4,4,1,0,2
Richmond,"Conca, Reece",17,9,4,8,0,0,0,0
Richmond,"Cotchin, Trent",20,12,4,8,1,0,0,1
Richmond,"Ellis, Brandon",21,11,3,10,0,1,0,4
Richmond,"Elton, Todd",13,4,2,9,0,2,2,1
Richmond,"Grigg, Shaun",31,17,6,14,1,0,0,4
Richmond,"Grimes, Dylan",11,7,2,4,1,0,0,2
Richmond,"Houli, Bachar",20,11,4,9,0,1,0,3
Richmond,"Lambert, Kane",9,6,2,3,0,0,0,5
Richmond,"Martin, Dustin",16,12,4,4,0,3,0,3
Richmond,"McIntosh, Kamdyn",15,9,2,6,0,0,0,2
Richmond,"Menadue, Connor",9,5,3,4,1,0,0,0
Richmond,"Nankervis, Toby",11,8,3,3,1,0,17,4
Richmond,"Prestia, Dion",22,10,2,12,0,0,0,7
Richmond,"Rance, Alex",10,6,3,4,0,0,0,2
Richmond,"Riewoldt, Jack",15,12,8,3,4,2,1,0
Richmond,"Rioli, Daniel",10,5,2,5,2,0,0,1
Richmond,"Short, Jayden",12,10,3,2,0,0,0,1
Richmond,"Vlastuin, Nick",11,5,0,6,0,0,0,4
Richmond,"Astbury, David",11,5,2,6,0,0,0,0
Richmond,"Butler, Dan",12,8,2,4,1,0,0,6
Richmond,"Caddy, Josh",21,11,2,10,1,0,0,5
Richmond,"Castagna, Jason",11,6,5,5,1,1,0,4
Richmond,"Conca, Reece",15,10,1,5,0,0,0,3
Richmond,"Cotchin, Trent",19,15,3,4,0,0,0,7
Richmond,"Ellis, Brandon",20,10,3,10,0,0,0,1
Richmond,"Elton, Todd",7,3,2,4,0,0,2,2
Richmond,"Grigg, Shaun",20,14,5,6,1,1,1,7
Richmond,"Grimes, Dylan",6,3,0,3,0,0,0,7
Richmond,"Houli, Bachar",24,14,3,10,0,0,0,6
Richmond,"Lambert, Kane",20,10,2,10,0,2,0,7
Richmond,"Markov, Oleg",8,2,2,6,0,0,0,1
Richmond,"Martin, Dustin",32,22,2,10,1,2,0,6
Richmond,"McIntosh, Kamdyn",9,7,3,2,0,0,0,4
Richmond,"Menadue, Connor",11,6,1,5,0,0,0,4
Richmond,"Nankervis, Toby",16,13,1,3,0,0,56,7
Richmond,"Prestia, Dion",20,9,0,11,0,1,0,2
Richmond,"Rance, Alex",11,6,4,5,0,0,0,2
Richmond,"Riewoldt, Jack",12,10,3,2,6,2,1,1
Richmond,"Rioli, Daniel",11,7,3,4,1,2,0,4
Richmond,"Short, Jayden",10,7,2,3,0,1,0,2
Richmond,"Astbury, David",20,11,8,9,0,0,0,0
Richmond,"Butler, Dan",9,6,1,3,1,0,0,5
Richmond,"Caddy, Josh",11,6,4,5,0,1,0,6
Richmond,"Castagna, Jason",8,3,1,5,0,0,0,2
Richmond,"Conca, Reece",14,6,2,8,0,0,0,3
Richmond,"Cotchin, Trent",26,16,4,10,0,0,0,11
Richmond,"Ellis, Brandon",21,7,1,14,0,0,0,2
Richmond,"Grigg, Shaun",17,7,1,10,0,0,2,5
Richmond,"Grimes, Dylan",9,4,1,5,0,0,0,2
Richmond,"Houli, Bachar",17,8,2,9,0,0,0,3
Richmond,"Lambert, Kane",24,9,4,15,1,1,0,8
Richmond,"Markov, Oleg",11,7,1,4,2,0,0,0
Richmond,"Martin, Dustin",25,16,4,9,1,0,0,6
Richmond,"McIntosh, Kamdyn",17,12,2,5,0,0,0,2
Richmond,"Morris, Steven",8,5,1,3,0,0,0,6
Richmond,"Nankervis, Toby",14,5,2,9,0,0,38,7
Richmond,"Prestia, Dion",16,10,1,6,0,0,0,4
Richmond,"Rance, Alex",19,9,5,10,0,0,0,0
Richmond,"Riewoldt, Jack",13,9,4,4,2,0,1,2
Richmond,"Rioli, Daniel",12,5,6,7,2,1,0,3
Richmond,"Short, Jayden",14,13,2,1,1,0,0,2
Richmond,"Vlastuin, Nick",9,3,1,6,0,0,0,3
Richmond,"Astbury, David",19,9,10,10,0,0,0,1
Richmond,"Butler, Dan",13,6,0,7,1,1,0,4
Richmond,"Caddy, Josh",20,10,5,10,1,0,0,4
Richmond,"Castagna, Jason",11,4,3,7,0,1,0,4
Richmond,"Cotchin, Trent",20,8,5,12,0,0,0,8
Richmond,"Ellis, Brandon",20,18,8,2,0,0,0,3
Richmond,"Ellis, Corey",6,2,0,4,0,0,0,2
Richmond,"Elton, Todd",10,8,6,2,0,1,7,2
Richmond,"Grigg, Shaun",29,16,5,13,1,0,0,4
Richmond,"Grimes, Dylan",7,3,2,4,0,0,0,1
Richmond,"Houli, Bachar",26,16,7,10,0,0,0,3
Richmond,"Lambert, Kane",23,9,2,14,1,2,0,2
Richmond,"Markov, Oleg",10,5,5,5,0,0,0,1
Richmond,"Martin, Dustin",28,15,3,13,2,0,0,4
Richmond,"McIntosh, Kamdyn",15,10,3,5,0,1,0,3
Richmond,"Miles, Anthony",19,9,3,10,1,0,0,4
Richmond,"Rance, Alex",16,12,8,4,0,0,0,3
Richmond,"Riewoldt, Jack",15,9,8,6,4,1,1,4
Richmond,"Rioli, Daniel",9,4,1,5,0,1,0,4
Richmond,"Short, Jayden",19,17,2,2,0,0,0,2
Richmond,"Soldo, Ivan",9,4,3,5,0,0,42,2
Richmond,"Vlastuin, Nick",7,6,2,1,0,0,0,2
Richmond,"Astbury, David",14,9,6,5,0,0,0,4
Richmond,"Batchelor, Jake",9,5,2,4,0,0,0,4
Richmond,"Butler, Dan",11,4,1,7,0,1,0,2
Richmond,"Caddy, Josh",17,11,3,6,2,0,0,4
Richmond,"Castagna, Jason",12,8,1,4,1,0,0,1
Richmond,"Cotchin, Trent",25,11,2,14,1,0,0,7
Richmond,"Edwards, Shane",22,9,3,13,0,0,0,2
Richmond,"Ellis, Brandon",15,7,4,8,1,0,0,1
Richmond,"Ellis, Corey",12,7,5,5,0,0,0,0
Richmond,"Elton, Todd",6,5,3,1,0,2,3,1
Richmond,"Grigg, Shaun",31,16,5,15,0,2,0,2
Richmond,"Grimes, Dylan",17,6,5,11,0,0,0,2
Richmond,"Houli, Bachar",21,12,2,9,0,0,0,2
Richmond,"Lambert, Kane",20,8,3,12,0,0,0,4
Richmond,"Markov, Oleg",6,4,2,2,0,0,0,2
Richmond,"Martin, Dustin",27,14,3,13,1,2,0,2
Richmond,"McIntosh, Kamdyn",18,12,4,6,0,0,0,2
Richmond,"Nankervis, Toby",15,7,6,8,0,0,20,5
Richmond,"Rance, Alex",20,9,7,11,0,0,0,1
Richmond,"Riewoldt, Jack",12,9,4,3,3,2,0,1
Richmond,"Rioli, Daniel",14,8,4,6,1,0,0,6
Richmond,"Short, Jayden",16,12,6,4,0,0,0,2
Richmond,"Astbury, David",14,10,10,4,0,0,0,3
Richmond,"Bolton, Shai",9,3,1,6,0,1,0,3
Richmond,"Castagna, Jason",11,7,4,4,2,1,0,1
Richmond,"Cotchin, Trent",26,16,3,10,2,0,0,4
Richmond,"Edwards, Shane",16,7,1,9,0,0,0,4
Richmond,"Ellis, Brandon",25,18,2,7,0,0,0,1
Richmond,"Grigg, Shaun",26,16,12,10,1,2,0,0
Richmond,"Grimes, Dylan",12,6,5,6,0,0,0,2
Richmond,"Houli, Bachar",25,14,4,11,0,1,0,2
Richmond,"Lambert, Kane",21,9,3,12,0,0,0,5
Richmond,"Lloyd, Sam",13,9,5,4,1,2,0,2
Richmond,"Martin, Dustin",35,23,6,12,0,2,0,3
Richmond,"McIntosh, Kamdyn",10,7,3,3,0,0,0,6
Richmond,"Menadue, Connor",11,7,3,4,2,0,0,3
Richmond,"Miles, Anthony",15,9,2,6,0,0,0,1
Richmond,"Nankervis, Toby",19,8,4,11,0,1,19,5
Richmond,"Prestia, Dion",20,8,1,12,0,0,0,3
Richmond,"Rance, Alex",19,12,5,7,0,0,0,2
Richmond,"Riewoldt, Jack",12,11,8,1,2,3,0,0
Richmond,"Rioli, Daniel",11,7,5,4,0,2,0,2
Richmond,"Short, Jayden",18,16,9,2,0,0,0,2
Richmond,"Soldo, Ivan",5,3,2,2,0,0,6,3
Richmond,"Astbury, David",15,7,5,8,0,0,0,3
Richmond,"Bolton, Shai",8,4,1,4,0,2,0,5
Richmond,"Caddy, Josh",14,10,5,4,2,4,0,2
Richmond,"Castagna, Jason",9,4,1,5,0,0,0,5
Richmond,"Cotchin, Trent",31,17,3,14,0,0,0,3
Richmond,"Edwards, Shane",18,13,2,5,2,1,0,2
Richmond,"Ellis, Brandon",30,20,9,10,1,0,0,3
Richmond,"Elton, Todd",5,3,2,2,1,0,2,0
Richmond,"Grigg, Shaun",24,16,8,8,0,0,0,2
Richmond,"Grimes, Dylan",14,7,2,7,0,0,0,2
Richmond,"Houli, Bachar",27,17,9,10,0,0,0,6
Richmond,"Lambert, Kane",15,7,2,8,0,0,0,4
Richmond,"Lloyd, Sam",12,8,3,4,1,1,0,3
Richmond,"Martin, Dustin",30,23,5,7,1,1,0,7
Richmond,"McIntosh, Kamdyn",16,10,4,6,0,0,0,1
Richmond,"Menadue, Connor",12,7,5,5,0,0,0,5
Richmond,"Nankervis, Toby",13,8,2,5,1,0,22,1
Richmond,"Prestia, Dion",22,14,2,8,0,0,0,1
Richmond,"Rance, Alex",19,14,6,5,0,0,0,6
Richmond,"Riewoldt, Jack",14,11,8,3,2,3,4,3
Richmond,"Rioli, Daniel",10,4,2,6,0,1,0,3
Richmond,"Short, Jayden",10,10,6,0,0,0,0,3
Richmond,"Astbury, David",20,7,4,13,0,0,0,2
Richmond,"Bolton, Shai",11,5,5,6,0,1,0,1
Richmond,"Butler, Dan",13,9,4,4,2,1,0,1
Richmond,"Caddy, Josh",22,11,9,11,0,0,0,3
Richmond,"Castagna, Jason",8,7,3,1,1,0,0,2
Richmond,"Cotchin, Trent",32,17,5,15,1,1,0,12
Richmond,"Edwards, Shane",16,7,4,9,1,1,0,1
Richmond,"Ellis, Brandon",30,18,7,12,1,0,0,0
Richmond,"Grigg, Shaun",21,8,7,13,1,0,0,3
Richmond,"Grimes, Dylan",7,4,5,3,0,0,0,5
Richmond,"Houli, Bachar",31,17,7,14,0,0,0,7
Richmond,"Lambert, Kane",25,13,5,12,2,1,0,3
Richmond,"Lloyd, Sam",11,9,7,2,0,1,0,5
Richmond,"Martin, Dustin",38,25,8,13,2,1,0,6
Richmond,"McIntosh, Kamdyn",24,15,4,9,0,0,0,5
Richmond,"Menadue, Connor",14,5,4,9,0,1,0,1
Richmond,"Nankervis, Toby",14,4,3,10,0,0,26,3
Richmond,"Prestia, Dion",35,20,9,15,0,2,0,5
Richmond,"Rance, Alex",14,7,4,7,0,0,1,3
Richmond,"Riewoldt, Jack",21,15,10,6,2,2,1,2
Richmond,"Rioli, Daniel",12,9,4,3,1,1,0,4
Richmond,"Short, Jayden",14,12,2,2,0,0,0,1
Richmond,"Astbury, David",19,14,13,5,0,0,0,1
Richmond,"Bolton, Shai",14,7,3,7,2,0,0,1
Richmond,"Butler, Dan",4,2,0,2,0,1,0,3
Richmond,"Caddy, Josh",23,14,9,9,0,0,0,0
Richmond,"Castagna, Jason",9,6,2,3,1,2,0,0
Richmond,"Cotchin, Trent",28,18,8,10,1,0,0,4
Richmond,"Edwards, Shane",12,7,1,5,1,1,0,3
Richmond,"Ellis, Brandon",25,16,7,9,0,0,0,4
Richmond,"Grigg, Shaun",20,12,7,8,0,1,0,2
Richmond,"Grimes, Dylan",20,8,5,12,0,0,0,6
Richmond,"Houli, Bachar",28,19,6,9,0,0,0,6
Richmond,"Lambert, Kane",19,9,4,10,0,0,0,9
Richmond,"Lloyd, Sam",19,12,6,7,1,1,0,1
Richmond,"Martin, Dustin",23,15,4,8,2,0,0,4
Richmond,"McIntosh, Kamdyn",20,13,5,7,0,0,0,2
Richmond,"Menadue, Connor",12,8,4,4,0,0,0,4
Richmond,"Nankervis, Toby",9,3,1,6,0,2,21,9
Richmond,"Prestia, Dion",23,9,5,14,0,0,0,4
Richmond,"Rance, Alex",21,12,5,9,0,0,0,0
Richmond,"Riewoldt, Jack",15,9,8,6,2,1,0,2
Richmond,"Rioli, Daniel",8,6,1,2,0,0,0,7
Richmond,"Short, Jayden",17,14,3,3,0,0,0,1
Richmond,"Astbury, David",15,7,6,8,0,0,0,2
Richmond,"Bolton, Shai",4,4,0,0,1,0,0,3
Richmond,"Butler, Dan",8,4,2,4,2,0,0,7
Richmond,"Caddy, Josh",22,8,3,14,0,1,2,3
Richmond,"Castagna, Jason",10,7,4,3,2,2,0,4
Richmond,"Cotchin, Trent",17,11,6,6,0,1,0,2
Richmond,"Edwards, Shane",13,5,3,8,0,1,0,1
Richmond,"Ellis, Brandon",23,13,6,10,1,0,0,2
Richmond,"Grigg, Shaun",26,11,12,15,0,1,0,4
Richmond,"Grimes, Dylan",13,5,3,8,0,0,0,3
Richmond,"Houli, Bachar",28,10,9,18,0,1,0,5
Richmond,"Lambert, Kane",26,12,6,14,1,2,0,6
Richmond,"Lloyd, Sam",21,15,5,6,0,0,0,5
Richmond,"Martin, Dustin",30,18,6,12,0,1,0,1
Richmond,"McIntosh, Kamdyn",13,10,2,3,0,0,0,1
Richmond,"Menadue, Connor",17,10,3,7,0,0,0,3
Richmond,"Nankervis, Toby",9,4,0,5,1,0,23,2
Richmond,"Prestia, Dion",17,7,2,10,0,1,0,3
Richmond,"Rance, Alex",17,8,3,9,0,0,0,4
Richmond,"Riewoldt, Jack",13,11,9,2,3,1,0,0
Richmond,"Rioli, Daniel",9,5,3,4,0,2,0,1
Richmond,"Short, Jayden",17,8,3,9,0,0,0,0
Richmond,"Astbury, David",17,9,4,8,0,0,0,2
Richmond,"Butler, Dan",8,5,3,3,3,0,0,6
Richmond,"Caddy, Josh",20,12,4,8,0,1,0,7
Richmond,"Castagna, Jason",13,4,4,9,0,0,0,3
Richmond,"Cotchin, Trent",15,11,4,4,1,0,0,5
Richmond,"Edwards, Shane",20,8,2,12,0,1,0,1
Richmond,"Ellis, Brandon",29,16,8,13,0,0,0,3
Richmond,"Grigg, Shaun",26,13,5,13,0,1,0,1
Richmond,"Grimes, Dylan",13,6,3,7,0,0,0,3
Richmond,"Lambert, Kane",33,19,7,14,0,1,0,10
Richmond,"Lloyd, Sam",13,8,4,5,1,0,0,5
Richmond,"Markov, Oleg",9,4,0,5,0,1,0,1
Richmond,"Martin, Dustin",36,22,8,14,1,2,0,4
Richmond,"McIntosh, Kamdyn",20,12,6,8,0,0,0,5
Richmond,"Menadue, Connor",16,3,3,13,0,0,0,2
Richmond,"Nankervis, Toby",21,8,5,13,0,0,28,5
Richmond,"Prestia, Dion",24,11,3,13,0,0,0,3
Richmond,"Rance, Alex",19,10,3,9,0,0,0,6
Richmond,"Riewoldt, Jack",10,4,6,6,1,0,1,4
Richmond,"Rioli, Daniel",6,3,1,3,1,0,0,2
Richmond,"Short, Jayden",20,15,8,5,1,0,0,1
Richmond,"Stengle, Tyson",8,6,1,2,2,0,0,0
Richmond,"Astbury, David",17,12,9,5,0,0,0,3
Richmond,"Butler, Dan",11,8,3,3,1,1,0,1
Richmond,"Caddy, Josh",21,14,3,7,1,2,0,4
Richmond,"Castagna, Jason",10,5,5,5,2,1,0,4
Richmond,"Cotchin, Trent",17,10,3,7,1,0,0,3
Richmond,"Edwards, Shane",21,4,4,17,0,0,0,1
Richmond,"Ellis, Brandon",21,16,7,5,1,1,0,1
Richmond,"Grigg, Shaun",29,15,8,14,1,2,0,5
Richmond,"Grimes, Dylan",6,2,1,4,0,0,0,0
Richmond,"Hunt, Taylor",10,3,2,7,0,0,0,1
Richmond,"Lambert, Kane",24,10,7,14,0,0,0,5
Richmond,"Lloyd, Sam",10,6,6,4,1,1,0,1
Richmond,"Martin, Dustin",19,13,1,6,1,0,0,5
Richmond,"McIntosh, Kamdyn",8,6,4,2,0,0,0,3
Richmond,"Menadue, Connor",16,8,3,8,0,0,0,2
Richmond,"Nankervis, Toby",13,7,5,6,0,0,18,3
Richmond,"Prestia, Dion",18,7,2,11,0,1,0,1
Richmond,"Rance, Alex",11,5,5,6,0,0,0,3
Richmond,"Riewoldt, Jack",7,6,6,1,1,1,0,2
Richmond,"Rioli, Daniel",8,2,1,6,0,0,0,2
Richmond,"Short, Jayden",14,11,5,3,0,0,0,0
Richmond,"Stengle, Tyson",8,5,3,3,0,1,0,4
Richmond,"Astbury, David",15,10,9,5,0,0,0,1
Richmond,"Broad, Nathan",11,9,4,2,0,0,0,2
Richmond,"Butler, Dan",16,10,4,6,3,0,0,7
Richmond,"Caddy, Josh",19,8,1,11,0,0,0,4
Richmond,"Castagna, Jason",10,6,2,4,2,1,0,1
Richmond,"Cotchin, Trent",28,13,4,15,1,1,0,6
Richmond,"Edwards, Shane",21,9,3,12,1,2,0,1
Richmond,"Ellis, Brandon",27,15,5,12,1,0,0,1
Richmond,"Grigg, Shaun",21,6,1,15,0,0,0,1
Richmond,"Grimes, Dylan",9,3,1,6,0,1,0,1
Richmond,"Lambert, Kane",22,8,2,14,0,0,0,4
Richmond,"Martin, Dustin",40,24,4,16,2,2,0,2
Richmond,"McIntosh, Kamdyn",15,10,6,5,0,1,0,1
Richmond,"Miles, Anthony",24,10,8,14,0,0,0,4
Richmond,"Nankervis, Toby",18,5,4,13,0,0,14,2
Richmond,"Prestia, Dion",19,14,2,5,1,1,0,4
Richmond,"Rance, Alex",13,5,3,8,0,0,0,1
Richmond,"Riewoldt, Jack",14,11,6,3,4,4,0,2
Richmond,"Rioli, Daniel",13,6,6,7,1,0,0,1
Richmond,"Short, Jayden",19,17,5,2,0,0,0,0
Richmond,"Soldo, Ivan",8,4,2,4,0,0,21,4
Richmond,"Vlastuin, Nick",17,9,8,8,0,1,0,4
Richmond,"Astbury, David",10,8,3,2,0,0,0,0
Richmond,"Broad, Nathan",12,10,1,2,0,0,0,3
Richmond,"Butler, Dan",10,6,1,4,0,0,0,2
Richmond,"Caddy, Josh",14,8,5,6,1,0,0,5
Richmond,"Castagna, Jason",12,7,2,5,1,0,0,9
Richmond,"Cotchin, Trent",27,18,4,9,0,1,0,7
Richmond,"Edwards, Shane",13,10,3,3,0,3,0,3
Richmond,"Ellis, Brandon",23,15,8,8,0,0,0,2
Richmond,"Ellis, Corey",9,5,2,4,0,0,0,3
Richmond,"Grigg, Shaun",21,12,1,9,0,0,0,5
Richmond,"Grimes, Dylan",11,8,4,3,0,0,0,3
Richmond,"Lambert, Kane",17,13,3,4,1,0,0,3
Richmond,"Martin, Dustin",31,25,4,6,1,1,0,4
Richmond,"McIntosh, Kamdyn",13,7,1,6,1,0,0,3
Richmond,"Nankervis, Toby",13,11,1,2,1,1,18,2
Richmond,"Prestia, Dion",19,11,1,8,0,0,0,3
Richmond,"Rance, Alex",17,12,7,5,0,0,0,0
Richmond,"Riewoldt, Jack",10,5,3,5,2,1,0,1
Richmond,"Rioli, Daniel",10,6,4,4,1,0,0,3
Richmond,"Short, Jayden",7,6,2,1,0,0,0,1
Richmond,"Soldo, Ivan",4,2,0,2,0,0,13,3
Richmond,"Vlastuin, Nick",21,14,11,7,0,0,0,0
Richmond,"Astbury, David",19,12,9,7,0,0,0,2
Richmond,"Bolton, Shai",5,3,2,2,0,0,0,2
Richmond,"Broad, Nathan",15,8,4,7,0,0,0,2
Richmond,"Butler, Dan",7,5,0,2,0,0,0,4
Richmond,"Caddy, Josh",12,9,4,3,1,2,0,1
Richmond,"Castagna, Jason",16,11,6,5,3,3,0,2
Richmond,"Cotchin, Trent",25,18,2,7,1,1,0,4
Richmond,"Edwards, Shane",19,4,2,15,0,0,0,6
Richmond,"Ellis, Brandon",27,14,7,13,0,0,0,1
Richmond,"Ellis, Corey",14,8,3,6,1,0,0,3
Richmond,"Grigg, Shaun",17,9,2,8,1,0,0,7
Richmond,"Grimes, Dylan",15,5,3,10,0,0,0,0
Richmond,"Houli, Bachar",25,14,4,11,0,1,0,2
Richmond,"Lambert, Kane",16,8,2,8,0,1,0,5
Richmond,"Martin, Dustin",34,24,5,10,1,1,0,0
Richmond,"McIntosh, Kamdyn",16,11,3,5,0,1,0,4
Richmond,"Miles, Anthony",23,7,5,16,0,0,0,8
Richmond,"Nankervis, Toby",11,7,1,4,3,1,10,2
Richmond,"Rance, Alex",17,11,8,6,0,0,0,6
Richmond,"Rioli, Daniel",16,10,4,6,3,1,0,5
Richmond,"Soldo, Ivan",6,2,1,4,0,0,25,4
Richmond,"Vlastuin, Nick",19,12,7,7,0,0,0,3
Richmond,"Astbury, David",17,12,10,5,0,0,0,1
Richmond,"Broad, Nathan",18,8,4,10,0,0,0,1
Richmond,"Butler, Dan",16,11,2,5,0,2,0,2
Richmond,"Caddy, Josh",28,21,9,7,4,4,0,3
Richmond,"Castagna, Jason",11,5,3,6,0,0,0,0
Richmond,"Cotchin, Trent",22,9,4,13,1,1,0,2
Richmond,"Edwards, Shane",15,7,4,8,0,0,0,3
Richmond,"Ellis, Brandon",19,11,5,8,0,1,0,0
Richmond,"Ellis, Corey",10,5,2,5,2,0,0,4
Richmond,"Grigg, Shaun",22,10,6,12,0,0,0,4
Richmond,"Grimes, Dylan",13,3,2,10,0,0,0,2
Richmond,"Houli, Bachar",21,11,4,10,0,0,0,1
Richmond,"Lambert, Kane",30,15,5,15,0,0,0,4
Richmond,"Martin, Dustin",32,20,6,12,2,1,0,2
Richmond,"McIntosh, Kamdyn",14,8,1,6,0,0,0,5
Richmond,"Miles, Anthony",16,5,3,11,0,0,0,4
Richmond,"Nankervis, Toby",17,10,3,7,1,2,26,3
Richmond,"Prestia, Dion",31,17,5,14,1,0,0,6
Richmond,"Rance, Alex",16,9,4,7,0,0,0,3
Richmond,"Rioli, Daniel",15,4,1,11,1,0,0,7
Richmond,"Soldo, Ivan",5,3,3,2,1,0,16,1
Richmond,"Vlastuin, Nick",15,9,5,6,0,0,0,0
Richmond,"Astbury, David",15,6,5,9,0,0,0,0
Richmond,"Broad, Nathan",19,13,7,6,0,0,0,3
Richmond,"Butler, Dan",4,4,1,0,1,0,0,6
Richmond,"Caddy, Josh",2,1,0,1,1,0,0,0
Richmond,"Castagna, Jason",3,1,0,2,0,0,0,6
Richmond,"Cotchin, Trent",20,11,2,9,1,0,0,8
Richmond,"Edwards, Shane",17,8,0,9,1,0,0,5
Richmond,"Ellis, Brandon",28,16,5,12,0,0,0,3
Richmond,"Ellis, Corey",9,3,2,6,0,0,0,1
Richmond,"Grigg, Shaun",19,13,3,6,0,1,0,5
Richmond,"Grimes, Dylan",12,7,6,5,0,0,0,3
Richmond,"Houli, Bachar",22,15,8,7,1,2,0,3
Richmond,"Lambert, Kane",28,16,5,12,0,0,0,2
Richmond,"Martin, Dustin",21,13,3,8,2,1,0,7
Richmond,"McIntosh, Kamdyn",13,8,4,5,0,0,0,5
Richmond,"Nankervis, Toby",10,3,3,7,0,0,21,5
Richmond,"Prestia, Dion",29,11,3,18,0,1,0,9
Richmond,"Rance, Alex",15,6,5,9,0,0,0,2
Richmond,"Riewoldt, Jack",14,10,7,4,1,3,0,1
Richmond,"Rioli, Daniel",12,6,3,6,1,0,0,5
Richmond,"Soldo, Ivan",6,3,1,3,0,0,25,5
Richmond,"Vlastuin, Nick",24,16,10,8,0,0,0,0
Richmond,"Astbury, David",19,9,8,10,0,0,0,0
Richmond,"Broad, Nathan",19,8,5,11,0,0,0,3
Richmond,"Butler, Dan",17,10,3,7,3,1,0,1
Richmond,"Castagna, Jason",8,1,3,7,0,1,0,1
Richmond,"Cotchin, Trent",18,11,1,7,0,0,0,1
Richmond,"Edwards, Shane",14,4,1,10,1,0,0,5
Richmond,"Ellis, Brandon",33,16,9,17,0,0,0,1
Richmond,"Graham, Jack",13,5,0,8,1,0,0,11
Richmond,"Grigg, Shaun",36,24,8,12,0,1,1,8
Richmond,"Grimes, Dylan",11,6,5,5,0,0,0,5
Richmond,"Houli, Bachar",29,18,7,11,1,0,0,7
Richmond,"Lambert, Kane",22,13,4,9,3,0,0,5
Richmond,"Markov, Oleg",15,11,8,4,0,0,0,1
Richmond,"Martin, Dustin",36,17,6,19,2,0,0,1
Richmond,"McIntosh, Kamdyn",16,8,4,8,1,0,0,4
Richmond,"Nankervis, Toby",26,13,4,13,1,0,32,6
Richmond,"Prestia, Dion",23,6,6,17,0,0,0,7
Richmond,"Rance, Alex",20,7,5,13,1,0,0,2
Richmond,"Riewoldt, Jack",11,6,3,5,4,0,0,0
Richmond,"Rioli, Daniel",13,9,1,4,1,1,0,3
Richmond,"Townsend, Jacob",16,10,5,6,6,1,0,4
Richmond,"Vlastuin, Nick",22,15,10,7,0,0,0,1
Richmond,"Astbury, David",15,10,9,5,0,0,0,1
Richmond,"Broad, Nathan",12,9,5,3,0,0,0,4
Richmond,"Butler, Dan",14,10,2,4,2,2,0,1
Richmond,"Castagna, Jason",4,2,2,2,0,0,0,4
Richmond,"Cotchin, Trent",26,13,4,13,1,0,0,2
Richmond,"Edwards, Shane",16,3,4,13,0,1,0,4
Richmond,"Ellis, Brandon",30,14,7,16,0,0,0,2
Richmond,"Graham, Jack",18,7,3,11,1,0,0,7
Richmond,"Grigg, Shaun",24,18,7,6,3,1,1,5
Richmond,"Grimes, Dylan",10,7,5,3,0,0,0,3
Richmond,"Houli, Bachar",26,14,3,12,0,0,0,3
Richmond,"Lambert, Kane",21,10,5,11,0,0,0,3
Richmond,"Markov, Oleg",13,3,4,10,0,0,0,1
Richmond,"Martin, Dustin",36,20,4,16,2,0,0,1
Richmond,"McIntosh, Kamdyn",13,12,6,1,0,0,0,3
Richmond,"Nankervis, Toby",18,9,4,9,0,0,31,9
Richmond,"Prestia, Dion",23,12,2,11,2,0,0,3
Richmond,"Rance, Alex",17,8,6,9,0,0,0,1
Richmond,"Riewoldt, Jack",14,10,6,4,3,1,0,1
Richmond,"Rioli, Daniel",7,2,0,5,0,1,0,2
Richmond,"Townsend, Jacob",12,9,5,3,5,0,0,2
Richmond,"Vlastuin, Nick",22,17,8,5,0,0,0,2
Richmond,"Astbury, David",12,10,4,2,0,0,0,3
Richmond,"Broad, Nathan",15,12,8,3,0,0,0,2
Richmond,"Butler, Dan",9,8,2,1,1,1,0,5
Richmond,"Caddy, Josh",17,13,7,4,2,2,0,3
Richmond,"Castagna, Jason",6,3,1,3,1,0,0,4
Richmond,"Cotchin, Trent",20,13,1,7,1,0,0,9
Richmond,"Edwards, Shane",24,11,6,13,1,1,0,4
Richmond,"Ellis, Brandon",9,7,2,2,0,0,0,4
Richmond,"Graham, Jack",9,4,0,5,0,0,0,9
Richmond,"Grigg, Shaun",19,16,6,3,1,0,0,5
Richmond,"Grimes, Dylan",8,7,2,1,0,0,0,4
Richmond,"Houli, Bachar",20,14,5,6,0,0,0,3
Richmond,"Lambert, Kane",24,12,4,12,1,3,0,4
Richmond,"Martin, Dustin",28,18,2,10,0,1,0,7
Richmond,"McIntosh, Kamdyn",11,8,5,3,0,0,0,1
Richmond,"Nankervis, Toby",10,5,1,5,0,0,32,2
Richmond,"Prestia, Dion",31,18,6,13,1,1,0,6
Richmond,"Rance, Alex",16,13,6,3,0,0,0,1
Richmond,"Riewoldt, Jack",16,13,6,3,1,3,1,5
Richmond,"Rioli, Daniel",8,3,1,5,0,0,0,4
Richmond,"Townsend, Jacob",3,2,1,1,2,0,0,3
Richmond,"Vlastuin, Nick",19,16,10,3,1,0,0,4
Richmond,"Astbury, David",13,9,4,4,0,0,0,3
Richmond,"Broad, Nathan",6,6,1,0,0,0,0,3
Richmond,"Butler, Dan",7,6,0,1,2,0,0,6
Richmond,"Caddy, Josh",16,9,5,7,1,1,0,0
Richmond,"Castagna, Jason",18,10,3,8,1,1,0,1
Richmond,"Cotchin, Trent",26,16,1,10,0,1,0,9
Richmond,"Edwards, Shane",19,9,4,10,1,1,0,2
Richmond,"Ellis, Brandon",12,6,3,6,0,0,0,2
Richmond,"Graham, Jack",14,8,4,6,0,0,0,5
Richmond,"Grigg, Shaun",16,8,2,8,0,0,0,1
Richmond,"Grimes, Dylan",11,5,2,6,0,1,0,4
Richmond,"Houli, Bachar",21,15,7,6,0,0,0,1
Richmond,"Lambert, Kane",23,10,2,13,1,0,0,2
Richmond,"Martin, Dustin",20,13,3,7,3,3,0,2
Richmond,"McIntosh, Kamdyn",15,8,2,7,0,1,0,5
Richmond,"Nankervis, Toby",13,11,5,2,0,0,27,5
Richmond,"Prestia, Dion",22,12,2,10,0,0,0,6
Richmond,"Rance, Alex",16,11,7,5,0,0,0,1
Richmond,"Riewoldt, Jack",8,6,2,2,1,0,1,2
Richmond,"Rioli, Daniel",14,9,5,5,4,0,0,6
Richmond,"Townsend, Jacob",10,7,1,3,1,1,0,5
Richmond,"Vlastuin, Nick",13,9,3,4,0,0,0,1
Richmond,"Astbury, David",7,4,1,3,0,0,0,0
Richmond,"Broad, Nathan",13,10,2,3,0,0,0,2
Richmond,"Butler, Dan",9,5,0,4,1,0,0,4
Richmond,"Caddy, Josh",12,9,5,3,1,1,0,3
Richmond,"Castagna, Jason",10,4,0,6,1,0,0,3
Richmond,"Cotchin, Trent",21,14,4,7,0,0,0,4
Richmond,"Edwards, Shane",25,12,2,13,0,0,0,2
Richmond,"Ellis, Brandon",14,10,3,4,0,0,0,3
Richmond,"Graham, Jack",16,6,2,10,3,0,0,3
Richmond,"Grigg, Shaun",17,10,1,7,1,0,0,3
Richmond,"Grimes, Dylan",6,4,2,2,0,0,0,2
Richmond,"Houli, Bachar",25,20,11,5,1,2,0,5
Richmond,"Lambert, Kane",22,13,4,9,1,0,0,3
Richmond,"Martin, Dustin",29,14,1,15,2,2,0,1
Richmond,"McIntosh, Kamdyn",9,5,2,4,0,0,0,2
Richmond,"Nankervis, Toby",18,10,4,8,0,0,28,3
Richmond,"Prestia, Dion",27,16,4,11,1,2,0,3
Richmond,"Rance, Alex",11,9,6,2,0,0,0,3
Richmond,"Riewoldt, Jack",14,11,6,3,2,3,0,7
Richmond,"Rioli, Daniel",11,9,2,2,0,0,0,5
Richmond,"Townsend, Jacob",8,4,2,4,2,0,0,5
Richmond,"Vlastuin, Nick",16,13,6,3,0,0,0,1
St Kilda,"Armitage, David",16,6,2,10,1,1,0,3
St Kilda,"Billings, Jack",20,10,2,10,1,1,0,3
St Kilda,"Brown, Nathan",9,2,2,7,0,0,0,1
St Kilda,"Bruce, Josh",13,6,2,7,1,0,0,1
St Kilda,"Carlisle, Jake",11,5,2,6,0,0,0,1
St Kilda,"Dunstan, Luke",16,8,4,8,1,0,0,3
St Kilda,"Geary, Jarryn",20,10,3,10,0,0,0,1
St Kilda,"Gilbert, Sam",11,6,3,5,0,0,0,3
St Kilda,"Gresham, Jade",12,9,4,3,3,1,0,1
St Kilda,"Hickey, Tom",8,4,1,4,0,0,18,2
St Kilda,"Lonie, Jack",15,8,0,7,1,1,0,6
St Kilda,"Membrey, Tim",15,10,2,5,1,1,0,3
St Kilda,"Newnes, Jack",20,12,6,8,0,0,0,2
St Kilda,"Riewoldt, Nick",14,12,7,2,4,0,0,3
St Kilda,"Roberton, Dylan",19,10,4,9,0,1,0,2
St Kilda,"Ross, Sebastian",16,8,1,8,0,0,1,1
St Kilda,"Savage, Shane",15,8,3,7,0,0,0,2
St Kilda,"Steele, Jack",23,8,7,15,0,1,0,4
St Kilda,"Steven, Jack",27,17,4,10,0,1,0,3
St Kilda,"Webster, Jimmy",14,10,1,4,0,0,0,2
St Kilda,"Weller, Maverick",15,7,4,8,0,2,0,5
St Kilda,"Wright, Nathan",8,3,0,5,0,0,0,1
St Kilda,"Acres, Blake",17,12,6,5,1,0,0,2
St Kilda,"Billings, Jack",19,7,1,12,0,1,0,3
St Kilda,"Brown, Nathan",6,0,1,6,0,0,0,2
St Kilda,"Bruce, Josh",14,9,5,5,2,0,2,3
St Kilda,"Carlisle, Jake",12,7,1,5,0,0,0,0
St Kilda,"Dunstan, Luke",20,8,2,12,1,1,0,5
St Kilda,"Geary, Jarryn",11,8,1,3,0,0,0,3
St Kilda,"Gilbert, Sam",16,6,5,10,0,0,0,7
St Kilda,"Gresham, Jade",11,8,5,3,1,3,0,1
St Kilda,"Hickey, Tom",14,8,2,6,0,0,44,2
St Kilda,"Lonie, Jack",16,11,3,5,2,2,0,4
St Kilda,"McCartin, Paddy",12,9,4,3,2,3,0,1
St Kilda,"Membrey, Tim",16,14,9,2,1,0,0,0
St Kilda,"Montagna, Leigh",21,12,3,9,1,0,0,3
St Kilda,"Newnes, Jack",20,9,6,11,0,0,0,3
St Kilda,"Roberton, Dylan",26,20,8,6,0,0,0,4
St Kilda,"Ross, Sebastian",29,19,2,10,0,2,0,5
St Kilda,"Savage, Shane",11,4,3,7,0,0,0,4
St Kilda,"Steele, Jack",18,5,1,13,0,0,0,4
St Kilda,"Steven, Jack",20,13,4,7,0,1,0,7
St Kilda,"Webster, Jimmy",18,13,2,5,0,0,0,3
St Kilda,"Weller, Maverick",14,7,2,7,2,1,0,0
St Kilda,"Acres, Blake",17,10,6,7,1,0,0,4
St Kilda,"Billings, Jack",14,5,2,9,0,0,0,2
St Kilda,"Brown, Nathan",9,5,3,4,0,0,0,2
St Kilda,"Bruce, Josh",11,8,5,3,1,4,3,4
St Kilda,"Carlisle, Jake",10,7,4,3,0,0,0,1
St Kilda,"Dunstan, Luke",22,10,5,12,1,1,0,3
St Kilda,"Geary, Jarryn",12,10,2,2,1,0,0,3
St Kilda,"Gilbert, Sam",13,5,2,8,0,1,0,4
St Kilda,"Gresham, Jade",17,11,2,6,1,3,0,4
St Kilda,"Hickey, Tom",15,9,3,6,0,0,33,7
St Kilda,"Lonie, Jack",11,9,6,2,0,1,0,4
St Kilda,"McCartin, Paddy",5,5,2,0,0,1,0,1
St Kilda,"Membrey, Tim",15,11,10,4,1,3,0,0
St Kilda,"Montagna, Leigh",30,24,9,6,1,0,0,4
St Kilda,"Newnes, Jack",23,15,6,8,0,2,0,1
St Kilda,"Riewoldt, Nick",28,20,12,8,3,2,1,1
St Kilda,"Roberton, Dylan",20,18,6,2,0,0,0,4
St Kilda,"Ross, Sebastian",23,10,1,13,0,0,0,9
St Kilda,"Savage, Shane",12,6,2,6,1,0,0,4
St Kilda,"Steele, Jack",18,7,4,11,1,0,0,9
St Kilda,"Webster, Jimmy",21,12,6,9,0,0,0,1
St Kilda,"Weller, Maverick",15,8,6,7,2,3,0,1
St Kilda,"Acres, Blake",21,13,4,8,1,0,0,3
St Kilda,"Armitage, David",17,12,7,5,0,0,0,5
St Kilda,"Billings, Jack",28,19,10,9,1,4,0,1
St Kilda,"Brown, Nathan",14,7,5,7,0,0,0,1
St Kilda,"Bruce, Josh",15,7,4,8,2,1,3,5
St Kilda,"Carlisle, Jake",15,9,8,6,0,0,0,5
St Kilda,"Dunstan, Luke",11,5,6,6,0,1,0,7
St Kilda,"Geary, Jarryn",17,8,7,9,0,0,0,5
St Kilda,"Gilbert, Sam",14,9,4,5,0,0,0,4
St Kilda,"Gresham, Jade",14,12,4,2,1,1,0,4
St Kilda,"Hickey, Tom",11,6,5,5,0,0,24,3
St Kilda,"Long, Ben",8,6,2,2,0,1,0,2
St Kilda,"Lonie, Jack",11,6,2,5,0,1,0,3
St Kilda,"Membrey, Tim",12,11,8,1,2,1,0,2
St Kilda,"Montagna, Leigh",23,11,6,12,1,0,0,3
St Kilda,"Newnes, Jack",32,22,8,10,0,0,0,3
St Kilda,"Riewoldt, Nick",22,15,12,7,1,0,0,5
St Kilda,"Roberton, Dylan",32,24,12,8,0,1,0,2
St Kilda,"Ross, Sebastian",36,19,7,17,0,1,0,3
St Kilda,"Steele, Jack",20,5,6,15,0,1,0,9
St Kilda,"Webster, Jimmy",25,13,6,12,0,0,0,5
St Kilda,"Weller, Maverick",20,9,4,11,0,0,0,7
St Kilda,"Acres, Blake",18,10,10,8,1,0,0,3
St Kilda,"Billings, Jack",20,9,6,11,0,0,0,2
St Kilda,"Brown, Nathan",6,3,0,3,0,0,0,1
St Kilda,"Bruce, Josh",11,7,3,4,1,2,1,4
St Kilda,"Carlisle, Jake",12,5,3,7,0,0,0,0
St Kilda,"Dunstan, Luke",12,4,2,8,1,0,0,2
St Kilda,"Geary, Jarryn",14,6,2,8,0,0,0,2
St Kilda,"Gilbert, Sam",15,9,2,6,0,0,0,3
St Kilda,"Gresham, Jade",11,6,1,5,0,1,0,2
St Kilda,"Long, Ben",6,2,2,4,0,1,0,1
St Kilda,"Longer, Billy",8,1,1,7,0,0,29,5
St Kilda,"Membrey, Tim",7,6,5,1,2,0,0,4
St Kilda,"Minchington, Darren",16,8,5,8,3,0,0,3
St Kilda,"Montagna, Leigh",27,15,5,12,0,0,0,7
St Kilda,"Newnes, Jack",20,11,4,9,1,0,0,6
St Kilda,"Riewoldt, Nick",17,14,5,3,1,0,0,0
St Kilda,"Roberton, Dylan",28,24,9,4,0,0,0,3
St Kilda,"Ross, Sebastian",33,17,6,16,1,1,0,3
St Kilda,"Steele, Jack",21,6,4,15,0,0,0,10
St Kilda,"Steven, Jack",30,12,1,18,1,0,0,2
St Kilda,"Webster, Jimmy",20,9,4,11,0,0,0,0
St Kilda,"Weller, Maverick",19,13,2,6,1,1,0,4
St Kilda,"Acres, Blake",23,8,6,15,0,0,0,1
St Kilda,"Billings, Jack",20,11,5,9,0,3,0,4
St Kilda,"Brown, Nathan",9,5,5,4,0,0,0,2
St Kilda,"Bruce, Josh",10,7,7,3,3,2,0,0
St Kilda,"Carlisle, Jake",16,11,9,5,1,0,0,1
St Kilda,"Geary, Jarryn",22,12,7,10,0,0,0,0
St Kilda,"Gilbert, Sam",12,6,3,6,0,1,2,2
St Kilda,"Gresham, Jade",9,7,3,2,2,0,0,2
St Kilda,"Longer, Billy",5,0,2,5,0,0,36,2
St Kilda,"Membrey, Tim",19,14,8,5,3,2,0,2
St Kilda,"Minchington, Darren",14,5,1,9,0,0,0,2
St Kilda,"Montagna, Leigh",33,17,5,16,0,0,0,3
St Kilda,"Newnes, Jack",29,18,4,11,0,2,0,3
St Kilda,"Riewoldt, Nick",20,13,8,7,4,0,0,2
St Kilda,"Roberton, Dylan",29,25,8,4,2,0,0,3
St Kilda,"Ross, Sebastian",32,16,7,16,0,0,0,4
St Kilda,"Sinclair, Jack",21,15,5,6,0,1,0,2
St Kilda,"Steele, Jack",27,10,4,17,0,0,0,10
St Kilda,"Steven, Jack",36,18,5,18,0,0,0,8
St Kilda,"Stevens, Koby",28,7,6,21,2,0,0,4
St Kilda,"Webster, Jimmy",26,17,8,9,0,0,0,2
St Kilda,"Weller, Maverick",28,11,7,17,2,0,0,2
St Kilda,"Acres, Blake",23,13,8,10,2,0,0,3
St Kilda,"Billings, Jack",22,14,6,8,2,3,0,6
St Kilda,"Brown, Nathan",6,2,1,4,0,0,0,1
St Kilda,"Bruce, Josh",7,4,2,3,1,0,0,0
St Kilda,"Carlisle, Jake",17,12,5,5,0,0,0,1
St Kilda,"Geary, Jarryn",13,5,1,8,0,0,0,6
St Kilda,"Gilbert, Sam",11,5,2,6,0,0,0,7
St Kilda,"Gresham, Jade",10,8,3,2,3,0,0,3
St Kilda,"Longer, Billy",4,0,1,4,0,0,48,2
St Kilda,"Membrey, Tim",16,9,7,7,1,2,1,1
St Kilda,"Minchington, Darren",17,7,2,10,1,1,0,7
St Kilda,"Montagna, Leigh",18,10,4,8,0,0,0,6
St Kilda,"Newnes, Jack",24,16,4,8,1,0,0,5
St Kilda,"Riewoldt, Nick",13,5,3,8,0,1,0,3
St Kilda,"Roberton, Dylan",20,19,6,1,1,0,0,4
St Kilda,"Ross, Sebastian",31,14,2,17,0,1,0,1
St Kilda,"Sinclair, Jack",23,14,6,9,0,0,0,7
St Kilda,"Steele, Jack",16,5,3,11,0,0,0,7
St Kilda,"Steven, Jack",29,18,3,11,2,0,0,4
St Kilda,"Stevens, Koby",28,12,6,16,0,0,0,5
St Kilda,"Webster, Jimmy",29,17,6,12,0,0,0,1
St Kilda,"Wright, Nathan",12,7,3,5,2,2,0,7
St Kilda,"Acres, Blake",21,7,6,14,0,0,0,1
St Kilda,"Billings, Jack",30,19,12,11,5,0,0,2
St Kilda,"Brown, Nathan",7,5,2,2,0,0,0,1
St Kilda,"Bruce, Josh",7,4,3,3,2,0,2,1
St Kilda,"Carlisle, Jake",18,12,8,6,0,0,0,0
St Kilda,"Dunstan, Luke",28,14,4,14,0,0,0,4
St Kilda,"Geary, Jarryn",16,6,3,10,0,0,0,2
St Kilda,"Gilbert, Sam",23,13,9,10,0,0,0,3
St Kilda,"Gresham, Jade",15,7,4,8,0,2,0,2
St Kilda,"Longer, Billy",6,2,0,4,0,0,32,4
St Kilda,"Membrey, Tim",10,8,6,2,1,1,0,2
St Kilda,"Minchington, Darren",9,5,3,4,0,3,0,3
St Kilda,"Montagna, Leigh",27,16,4,11,0,0,0,2
St Kilda,"Newnes, Jack",33,16,9,17,0,0,0,1
St Kilda,"Riewoldt, Nick",19,14,6,5,1,1,0,2
St Kilda,"Roberton, Dylan",23,15,6,8,0,1,0,0
St Kilda,"Ross, Sebastian",31,11,6,20,2,0,0,3
St Kilda,"Sinclair, Jack",18,6,6,12,0,0,0,3
St Kilda,"Steele, Jack",29,7,2,22,1,1,0,7
St Kilda,"Steven, Jack",32,17,2,15,0,1,0,3
St Kilda,"Webster, Jimmy",3,2,1,1,0,0,0,0
St Kilda,"Weller, Maverick",15,9,4,6,0,2,0,3
St Kilda,"Acres, Blake",27,13,3,14,1,0,0,5
St Kilda,"Billings, Jack",32,15,7,17,0,0,0,3
St Kilda,"Brown, Nathan",7,0,0,7,0,0,0,1
St Kilda,"Carlisle, Jake",16,8,4,8,0,0,0,4
St Kilda,"Dunstan, Luke",21,8,5,13,0,0,0,2
St Kilda,"Geary, Jarryn",15,7,3,8,0,0,0,4
St Kilda,"Gilbert, Sam",22,8,2,14,0,0,3,1
St Kilda,"Gresham, Jade",12,4,2,8,2,0,0,1
St Kilda,"Longer, Billy",5,0,0,5,0,0,37,5
St Kilda,"McCartin, Paddy",11,7,3,4,1,2,0,1
St Kilda,"McKenzie, Daniel",20,12,6,8,0,0,0,6
St Kilda,"Membrey, Tim",11,7,5,4,2,0,0,2
St Kilda,"Montagna, Leigh",24,14,6,10,0,0,0,5
St Kilda,"Newnes, Jack",3,0,0,3,0,0,0,1
St Kilda,"Riewoldt, Nick",19,10,7,9,3,0,0,2
St Kilda,"Roberton, Dylan",32,21,7,11,1,0,0,2
St Kilda,"Ross, Sebastian",37,15,5,22,0,1,0,8
St Kilda,"Sinclair, Jack",16,11,3,5,0,1,0,3
St Kilda,"Steele, Jack",24,9,7,15,0,0,0,7
St Kilda,"Steven, Jack",27,16,5,11,0,0,0,3
St Kilda,"Stevens, Koby",21,9,6,12,0,0,0,5
St Kilda,"Weller, Maverick",22,10,8,12,0,3,0,2
St Kilda,"Acres, Blake",22,9,2,13,0,0,0,6
St Kilda,"Billings, Jack",16,9,2,7,1,0,0,4
St Kilda,"Brown, Nathan",9,2,2,7,0,0,0,5
St Kilda,"Carlisle, Jake",21,12,8,9,0,0,1,0
St Kilda,"Geary, Jarryn",19,12,4,7,0,0,0,1
St Kilda,"Gilbert, Sam",20,9,3,11,0,0,2,4
St Kilda,"Gresham, Jade",15,11,6,4,1,2,0,3
St Kilda,"Longer, Billy",18,3,4,15,0,0,55,6
St Kilda,"McCartin, Paddy",15,9,9,6,1,1,0,0
St Kilda,"McKenzie, Daniel",17,6,9,11,1,0,0,3
St Kilda,"Membrey, Tim",14,10,5,4,1,0,0,2
St Kilda,"Minchington, Darren",13,4,2,9,0,0,0,5
St Kilda,"Montagna, Leigh",34,22,9,12,0,1,0,2
St Kilda,"Newnes, Jack",35,21,8,14,1,0,0,7
St Kilda,"Roberton, Dylan",25,20,9,5,0,1,0,0
St Kilda,"Ross, Sebastian",30,15,1,15,0,0,0,8
St Kilda,"Savage, Shane",21,9,8,12,0,0,0,4
St Kilda,"Sinclair, Jack",12,6,0,6,0,0,0,5
St Kilda,"Steele, Jack",20,7,5,13,0,0,0,8
St Kilda,"Steven, Jack",17,6,3,11,0,0,0,11
St Kilda,"Stevens, Koby",28,7,6,21,0,0,0,8
St Kilda,"Weller, Maverick",15,8,4,7,1,1,0,3
St Kilda,"Acres, Blake",15,6,2,9,0,2,0,2
St Kilda,"Billings, Jack",25,10,3,15,1,1,0,2
St Kilda,"Brown, Nathan",11,3,0,8,0,0,0,0
St Kilda,"Bruce, Josh",13,11,7,2,4,1,1,2
St Kilda,"Carlisle, Jake",5,3,2,2,0,0,0,0
St Kilda,"Geary, Jarryn",20,5,4,15,0,0,0,3
St Kilda,"Gilbert, Sam",19,12,6,7,0,0,0,1
St Kilda,"Gresham, Jade",14,5,1,9,0,0,0,4
St Kilda,"Longer, Billy",16,1,2,15,0,0,33,3
St Kilda,"McCartin, Paddy",15,10,5,5,1,1,0,2
St Kilda,"Membrey, Tim",10,5,3,5,0,0,0,1
St Kilda,"Montagna, Leigh",20,10,5,10,0,0,0,4
St Kilda,"Newnes, Jack",28,15,7,13,0,0,0,6
St Kilda,"Roberton, Dylan",25,19,4,6,0,0,0,0
St Kilda,"Ross, Sebastian",39,17,4,22,0,0,0,3
St Kilda,"Sinclair, Jack",25,12,4,13,0,2,0,1
St Kilda,"Steele, Jack",15,5,3,10,0,0,0,4
St Kilda,"Steven, Jack",33,16,2,17,0,2,0,3
St Kilda,"Stevens, Koby",18,7,5,11,1,1,0,5
St Kilda,"Webster, Jimmy",22,12,4,10,0,0,0,5
St Kilda,"Weller, Maverick",17,9,4,8,0,2,0,7
St Kilda,"Wright, Nathan",8,1,1,7,0,0,0,2
St Kilda,"Acres, Blake",18,8,6,10,1,0,0,1
St Kilda,"Billings, Jack",18,11,4,7,2,4,0,8
St Kilda,"Brown, Nathan",6,0,2,6,0,0,0,2
St Kilda,"Bruce, Josh",11,6,7,5,2,0,2,2
St Kilda,"Carlisle, Jake",11,6,6,5,0,0,0,2
St Kilda,"Dunstan, Luke",18,7,4,11,0,1,0,6
St Kilda,"Geary, Jarryn",21,11,3,10,0,0,0,2
St Kilda,"Gilbert, Sam",14,10,4,4,0,0,0,5
St Kilda,"Gresham, Jade",19,10,2,9,1,3,0,5
St Kilda,"Longer, Billy",6,0,2,6,0,0,30,0
St Kilda,"Lonie, Jack",17,10,2,7,0,2,0,1
St Kilda,"Membrey, Tim",13,11,6,2,2,1,0,1
St Kilda,"Montagna, Leigh",28,21,7,7,0,0,0,3
St Kilda,"Newnes, Jack",23,14,5,9,0,0,0,3
St Kilda,"Riewoldt, Nick",21,11,11,10,0,3,0,5
St Kilda,"Roberton, Dylan",22,18,8,4,1,0,0,2
St Kilda,"Ross, Sebastian",32,13,5,19,0,0,0,6
St Kilda,"Sinclair, Jack",21,9,2,12,1,0,0,3
St Kilda,"Steven, Jack",16,7,0,9,2,0,0,4
St Kilda,"Stevens, Koby",14,4,4,10,0,1,0,7
St Kilda,"Webster, Jimmy",16,9,4,7,0,0,0,1
St Kilda,"Weller, Maverick",16,10,7,6,0,1,0,3
St Kilda,"Acres, Blake",8,6,2,2,0,1,0,3
St Kilda,"Billings, Jack",30,16,8,14,1,1,0,1
St Kilda,"Brown, Nathan",6,2,0,4,0,0,0,1
St Kilda,"Bruce, Josh",16,12,6,4,1,2,1,4
St Kilda,"Carlisle, Jake",16,9,6,7,1,0,0,3
St Kilda,"Dunstan, Luke",20,12,4,8,1,0,0,9
St Kilda,"Geary, Jarryn",15,8,5,7,0,0,0,2
St Kilda,"Gilbert, Sam",12,7,3,5,0,0,0,1
St Kilda,"Gresham, Jade",18,11,4,7,0,2,0,2
St Kilda,"Longer, Billy",9,1,0,8,0,0,30,3
St Kilda,"Lonie, Jack",15,6,3,9,1,1,0,2
St Kilda,"Membrey, Tim",16,13,8,3,2,1,0,2
St Kilda,"Montagna, Leigh",22,10,7,12,0,0,0,5
St Kilda,"Newnes, Jack",17,12,7,5,2,1,0,4
St Kilda,"Riewoldt, Nick",13,10,8,3,3,1,0,1
St Kilda,"Roberton, Dylan",20,16,7,4,0,0,0,0
St Kilda,"Ross, Sebastian",22,13,3,9,0,1,0,3
St Kilda,"Sinclair, Jack",26,10,4,16,1,0,0,3
St Kilda,"Steven, Jack",29,14,3,15,0,3,0,7
St Kilda,"Stevens, Koby",21,5,2,16,0,1,0,15
St Kilda,"Webster, Jimmy",14,8,3,6,0,0,0,2
St Kilda,"Weller, Maverick",11,7,5,4,1,2,0,2
St Kilda,"Billings, Jack",27,12,9,15,1,2,0,0
St Kilda,"Brown, Nathan",6,0,0,6,0,0,0,1
St Kilda,"Bruce, Josh",13,8,6,5,3,0,3,2
St Kilda,"Carlisle, Jake",17,13,7,4,2,1,0,1
St Kilda,"Dunstan, Luke",11,3,2,8,0,0,0,7
St Kilda,"Geary, Jarryn",21,12,4,9,0,0,0,2
St Kilda,"Gilbert, Sam",15,8,3,7,0,2,0,3
St Kilda,"Gresham, Jade",17,9,2,8,3,1,0,1
St Kilda,"Longer, Billy",8,1,4,7,0,0,48,4
St Kilda,"Lonie, Jack",12,9,5,3,0,1,0,7
St Kilda,"Membrey, Tim",15,7,5,8,2,0,0,0
St Kilda,"Montagna, Leigh",22,13,8,9,0,0,0,4
St Kilda,"Newnes, Jack",24,17,7,7,0,1,0,1
St Kilda,"Riewoldt, Nick",16,10,3,6,0,2,0,0
St Kilda,"Roberton, Dylan",15,9,4,6,0,0,0,4
St Kilda,"Ross, Sebastian",34,21,2,13,0,0,0,3
St Kilda,"Sinclair, Jack",22,10,2,12,0,1,0,2
St Kilda,"Steele, Jack",15,7,2,8,1,1,0,17
St Kilda,"Steven, Jack",17,7,0,10,0,2,0,5
St Kilda,"Stevens, Koby",28,9,5,19,0,0,0,7
St Kilda,"Webster, Jimmy",18,9,3,9,0,0,0,1
St Kilda,"Weller, Maverick",15,4,1,11,0,0,0,2
St Kilda,"Billings, Jack",19,4,2,15,1,0,0,1
St Kilda,"Brown, Nathan",3,1,1,2,0,0,0,0
St Kilda,"Bruce, Josh",14,9,7,5,2,5,2,1
St Kilda,"Carlisle, Jake",11,9,5,2,0,0,0,1
St Kilda,"Geary, Jarryn",18,8,7,10,0,0,0,1
St Kilda,"Gilbert, Sam",19,7,4,12,0,0,6,7
St Kilda,"Gresham, Jade",21,13,3,8,2,1,0,1
St Kilda,"Long, Ben",11,5,2,6,0,0,0,5
St Kilda,"Longer, Billy",11,2,4,9,1,0,39,5
St Kilda,"Lonie, Jack",18,5,3,13,0,1,0,3
St Kilda,"McKenzie, Daniel",9,7,5,2,1,0,0,2
St Kilda,"Membrey, Tim",11,7,9,4,5,0,0,2
St Kilda,"Montagna, Leigh",31,18,7,13,2,0,0,3
St Kilda,"Newnes, Jack",25,14,5,11,0,0,0,2
St Kilda,"Riewoldt, Nick",15,13,12,2,3,2,0,3
St Kilda,"Roberton, Dylan",20,17,2,3,0,0,0,1
St Kilda,"Ross, Sebastian",33,18,4,15,1,0,0,8
St Kilda,"Savage, Shane",22,16,8,6,0,0,0,3
St Kilda,"Sinclair, Jack",28,11,4,17,0,0,0,2
St Kilda,"Steele, Jack",28,9,1,19,0,1,0,9
St Kilda,"Steven, Jack",33,16,8,17,1,1,0,3
St Kilda,"Stevens, Koby",29,12,6,17,2,0,0,3
St Kilda,"Battle, Josh",5,3,2,2,1,0,0,0
St Kilda,"Billings, Jack",18,11,7,7,0,3,0,1
St Kilda,"Brown, Nathan",5,1,1,4,0,0,0,1
St Kilda,"Bruce, Josh",15,6,6,9,1,0,4,1
St Kilda,"Carlisle, Jake",19,12,11,7,1,0,0,3
St Kilda,"Geary, Jarryn",19,12,4,7,0,0,0,1
St Kilda,"Gilbert, Sam",9,6,0,3,0,0,2,4
St Kilda,"Gresham, Jade",12,7,3,5,1,2,0,1
St Kilda,"Hickey, Tom",12,6,0,6,0,1,19,2
St Kilda,"Long, Ben",11,2,0,9,0,0,0,5
St Kilda,"Lonie, Jack",17,10,1,7,1,2,0,4
St Kilda,"McKenzie, Daniel",13,6,3,7,0,0,0,0
St Kilda,"Montagna, Leigh",19,9,5,10,0,0,0,2
St Kilda,"Newnes, Jack",27,13,5,14,0,1,0,2
St Kilda,"Riewoldt, Nick",16,9,5,7,1,0,0,3
St Kilda,"Roberton, Dylan",26,20,8,6,0,0,0,2
St Kilda,"Ross, Sebastian",20,9,3,11,0,0,0,4
St Kilda,"Savage, Shane",31,16,8,15,0,0,0,1
St Kilda,"Sinclair, Jack",19,6,8,13,1,1,0,2
St Kilda,"Steele, Jack",17,8,2,9,0,1,0,3
St Kilda,"Steven, Jack",30,17,4,13,0,3,0,4
St Kilda,"Stevens, Koby",16,4,4,12,0,0,0,4
St Kilda,"Acres, Blake",20,13,6,7,0,0,0,2
St Kilda,"Billings, Jack",23,11,5,12,1,1,0,3
St Kilda,"Brown, Nathan",7,3,0,4,0,0,0,1
St Kilda,"Bruce, Josh",12,5,4,7,3,0,0,3
St Kilda,"Carlisle, Jake",12,8,8,4,0,0,0,1
St Kilda,"Dunstan, Luke",29,14,7,15,1,1,0,3
St Kilda,"Geary, Jarryn",19,12,6,7,0,0,0,3
St Kilda,"Gresham, Jade",14,10,2,4,0,0,0,2
St Kilda,"Longer, Billy",12,1,1,11,0,1,43,4
St Kilda,"Lonie, Jack",8,4,3,4,0,0,0,4
St Kilda,"Marshall, Rowan",14,5,4,9,0,0,5,2
St Kilda,"Montagna, Leigh",21,13,6,8,0,0,0,3
St Kilda,"Newnes, Jack",20,13,6,7,1,0,0,1
St Kilda,"Riewoldt, Nick",10,6,4,4,1,0,0,3
St Kilda,"Roberton, Dylan",23,18,3,5,0,0,0,1
St Kilda,"Ross, Sebastian",37,16,6,21,0,0,0,2
St Kilda,"Savage, Shane",27,17,7,10,1,0,0,1
St Kilda,"Sinclair, Jack",15,6,1,9,0,0,0,3
St Kilda,"Steele, Jack",25,8,4,17,0,0,0,5
St Kilda,"Steven, Jack",21,7,2,14,0,0,0,3
St Kilda,"Stevens, Koby",14,5,4,9,1,0,0,2
St Kilda,"Webster, Jimmy",19,14,4,5,0,0,0,2
St Kilda,"Acres, Blake",22,7,2,15,1,0,0,2
St Kilda,"Billings, Jack",19,9,2,10,0,2,0,6
St Kilda,"Brown, Nathan",4,1,0,3,0,0,0,3
St Kilda,"Bruce, Josh",11,7,6,4,0,3,1,1
St Kilda,"Carlisle, Jake",16,10,8,6,0,0,0,2
St Kilda,"Dunstan, Luke",27,18,4,9,1,0,0,8
St Kilda,"Geary, Jarryn",12,7,1,5,0,0,0,0
St Kilda,"Gresham, Jade",7,6,1,1,1,2,0,5
St Kilda,"Longer, Billy",5,0,0,5,0,0,32,8
St Kilda,"Lonie, Jack",8,6,1,2,1,1,0,4
St Kilda,"McKenzie, Daniel",13,7,0,6,0,0,0,2
St Kilda,"Membrey, Tim",10,7,4,3,3,0,0,0
St Kilda,"Newnes, Jack",19,7,3,12,0,0,0,5
St Kilda,"Roberton, Dylan",24,18,4,6,0,0,0,0
St Kilda,"Ross, Sebastian",31,16,3,15,0,1,0,6
St Kilda,"Savage, Shane",21,16,3,5,0,0,0,0
St Kilda,"Sinclair, Jack",21,13,5,8,1,1,0,6
St Kilda,"Steele, Jack",22,9,2,13,0,1,0,7
St Kilda,"Steven, Jack",22,9,3,13,0,0,0,5
St Kilda,"Webster, Jimmy",22,10,4,12,0,0,0,3
St Kilda,"Weller, Maverick",10,5,2,5,0,0,0,2
St Kilda,"White, Brandon",13,10,4,3,0,0,0,0
St Kilda,"Acres, Blake",30,14,5,16,1,0,0,6
St Kilda,"Billings, Jack",25,18,7,7,2,3,0,4
St Kilda,"Brown, Nathan",5,0,0,5,0,0,0,2
St Kilda,"Bruce, Josh",10,5,6,5,2,2,2,0
St Kilda,"Carlisle, Jake",14,8,5,6,0,0,0,0
St Kilda,"Dunstan, Luke",25,14,5,11,1,0,0,5
St Kilda,"Geary, Jarryn",17,7,3,10,0,0,0,4
St Kilda,"Gresham, Jade",18,10,7,8,0,2,0,3
St Kilda,"Longer, Billy",13,2,2,11,0,0,51,6
St Kilda,"Membrey, Tim",10,8,8,2,2,0,0,4
St Kilda,"Newnes, Jack",24,19,7,5,1,1,0,3
St Kilda,"Riewoldt, Nick",13,5,6,8,1,0,0,1
St Kilda,"Roberton, Dylan",20,17,8,3,0,0,0,0
St Kilda,"Ross, Sebastian",23,12,4,11,1,0,0,4
St Kilda,"Savage, Shane",26,20,5,6,1,1,0,5
St Kilda,"Sinclair, Jack",20,11,3,9,1,0,0,3
St Kilda,"Steele, Jack",26,9,2,17,2,1,0,12
St Kilda,"Steven, Jack",22,13,3,9,0,0,0,6
St Kilda,"Stevens, Koby",27,10,7,17,0,0,0,6
St Kilda,"Webster, Jimmy",26,17,5,9,0,0,0,1
St Kilda,"Weller, Maverick",17,3,3,14,0,0,0,7
St Kilda,"White, Brandon",16,14,6,2,0,0,0,1
St Kilda,"Acres, Blake",16,7,0,9,0,0,0,4
St Kilda,"Billings, Jack",30,14,9,16,1,3,0,6
St Kilda,"Brown, Nathan",7,1,1,6,0,0,0,2
St Kilda,"Bruce, Josh",10,6,5,4,1,1,0,3
St Kilda,"Carlisle, Jake",17,16,7,1,0,0,0,1
St Kilda,"Dunstan, Luke",24,14,6,10,2,0,0,4
St Kilda,"Geary, Jarryn",15,5,2,10,0,0,0,4
St Kilda,"Gilbert, Sam",21,8,1,13,0,0,0,4
St Kilda,"Gresham, Jade",17,8,8,9,0,2,0,5
St Kilda,"Longer, Billy",15,3,1,12,0,0,34,3
St Kilda,"Membrey, Tim",12,9,7,3,2,1,0,1
St Kilda,"Newnes, Jack",20,10,5,10,0,1,0,4
St Kilda,"Roberton, Dylan",27,19,8,8,0,0,0,0
St Kilda,"Ross, Sebastian",27,14,3,13,0,0,0,3
St Kilda,"Savage, Shane",26,18,4,8,0,1,0,3
St Kilda,"Sinclair, Jack",22,10,5,12,2,1,0,2
St Kilda,"Steele, Jack",27,13,0,14,0,0,0,7
St Kilda,"Steven, Jack",19,7,2,12,0,0,0,3
St Kilda,"Stevens, Koby",6,2,1,4,0,0,0,0
St Kilda,"Webster, Jimmy",9,8,2,1,1,0,0,2
St Kilda,"Weller, Maverick",16,7,6,9,1,0,0,6
St Kilda,"White, Brandon",10,4,2,6,0,0,0,3
St Kilda,"Acres, Blake",30,13,4,17,1,1,0,3
St Kilda,"Billings, Jack",25,8,8,17,1,2,0,3
St Kilda,"Brown, Nathan",6,0,1,6,0,0,0,1
St Kilda,"Bruce, Josh",13,9,8,4,3,3,1,1
St Kilda,"Carlisle, Jake",12,9,6,3,0,0,0,2
St Kilda,"Dunstan, Luke",32,15,4,17,0,2,0,6
St Kilda,"Geary, Jarryn",17,8,5,9,0,0,0,7
St Kilda,"Gilbert, Sam",8,4,4,4,0,0,0,2
St Kilda,"Gresham, Jade",16,10,3,6,3,1,0,1
St Kilda,"Longer, Billy",6,2,1,4,0,1,33,3
St Kilda,"Membrey, Tim",14,11,8,3,3,0,0,0
St Kilda,"Newnes, Jack",25,10,8,15,0,1,0,3
St Kilda,"Riewoldt, Nick",15,9,8,6,2,0,0,2
St Kilda,"Roberton, Dylan",19,10,5,9,0,0,0,3
St Kilda,"Ross, Sebastian",36,12,2,24,0,1,0,4
St Kilda,"Savage, Shane",19,15,4,4,2,0,0,1
St Kilda,"Sinclair, Jack",23,10,3,13,1,0,0,5
St Kilda,"Steele, Jack",22,8,3,14,1,0,0,11
St Kilda,"Steven, Jack",40,14,1,26,0,1,0,5
St Kilda,"Stevens, Koby",24,6,7,18,0,0,0,3
St Kilda,"Webster, Jimmy",18,11,2,7,0,0,0,1
St Kilda,"Weller, Maverick",12,7,3,5,1,0,0,3
St Kilda,"Acres, Blake",18,9,3,9,0,0,2,0
St Kilda,"Billings, Jack",28,12,5,16,2,2,0,4
St Kilda,"Brown, Nathan",6,0,1,6,0,0,0,2
St Kilda,"Bruce, Josh",11,7,5,4,1,1,0,3
St Kilda,"Carlisle, Jake",19,11,8,8,0,0,0,3
St Kilda,"Dunstan, Luke",30,12,3,18,0,2,0,5
St Kilda,"Geary, Jarryn",1,0,0,1,0,0,0,0
St Kilda,"Gresham, Jade",16,14,4,2,5,1,0,2
St Kilda,"Longer, Billy",12,5,2,7,1,0,46,5
St Kilda,"Lonie, Jack",11,6,1,5,0,1,0,6
St Kilda,"Membrey, Tim",13,7,7,6,2,1,0,1
St Kilda,"Newnes, Jack",14,9,4,5,0,0,0,2
St Kilda,"Riewoldt, Nick",15,10,8,5,1,0,0,2
St Kilda,"Roberton, Dylan",13,8,1,5,0,0,0,1
St Kilda,"Ross, Sebastian",25,13,2,12,0,0,0,3
St Kilda,"Savage, Shane",25,16,2,9,0,0,0,1
St Kilda,"Sinclair, Jack",21,8,2,13,0,0,0,4
St Kilda,"Steele, Jack",28,7,3,21,0,0,0,8
St Kilda,"Steven, Jack",26,15,0,11,0,0,0,4
St Kilda,"Stevens, Koby",24,6,4,18,0,1,0,4
St Kilda,"Webster, Jimmy",18,10,0,8,0,0,0,0
St Kilda,"Weller, Maverick",20,5,1,15,0,0,0,3
Sydney,"Cunningham, Harry",12,7,2,5,0,0,0,3
Sydney,"Florent, Oliver",8,5,0,3,0,0,0,3
Sydney,"Foote, Jordan",12,8,4,4,0,2,0,5
Sydney,"Franklin, Lance",18,13,7,5,4,2,0,3
Sydney,"Grundy, Heath",21,14,11,7,0,0,0,1
Sydney,"Hannebery, Dan",18,7,3,11,0,0,0,0
Sydney,"Hewett, George",19,5,2,14,0,0,0,9
Sydney,"Jack, Kieren",21,13,7,8,1,1,0,0
Sydney,"Jones, Zak",25,14,7,11,1,0,0,2
Sydney,"Kennedy, Josh",28,13,2,15,1,1,0,9
Sydney,"Laidler, Jeremy",13,8,3,5,0,1,0,3
Sydney,"Lloyd, Jake",23,16,6,7,0,0,0,2
Sydney,"Marsh, Harrison",24,12,4,12,0,0,0,2
Sydney,"Mills, Callum",18,14,4,4,0,0,0,2
Sydney,"Naismith, Sam",9,5,3,4,0,1,34,5
Sydney,"Parker, Luke",25,17,2,8,0,0,0,7
Sydney,"Rampe, Dane",9,6,4,3,0,0,0,4
Sydney,"Reid, Sam",13,8,7,5,3,0,0,3
Sydney,"Robinson, Dan",6,2,0,4,1,0,0,0
Sydney,"Smith, Nick",15,7,4,8,0,0,0,1
Sydney,"Tippett, Kurt",10,7,4,3,1,0,15,4
Sydney,"Towers, Dean",11,7,2,4,0,1,0,2
Sydney,"Aliir, Aliir",14,6,3,8,0,0,0,1
Sydney,"Cunningham, Harry",15,8,3,7,0,0,0,2
Sydney,"Florent, Oliver",13,8,1,5,1,0,0,2
Sydney,"Fox, Robbie",13,2,0,11,0,0,0,3
Sydney,"Franklin, Lance",22,18,11,4,4,3,0,4
Sydney,"Grundy, Heath",13,3,3,10,0,0,0,1
Sydney,"Hannebery, Dan",19,7,2,12,0,0,0,7
Sydney,"Hayward, Will",16,11,3,5,0,1,0,6
Sydney,"Hewett, George",17,9,1,8,0,0,0,6
Sydney,"Jack, Kieren",19,12,2,7,0,1,0,3
Sydney,"Jones, Zak",20,9,4,11,0,0,0,0
Sydney,"Kennedy, Josh",24,6,1,18,0,0,0,8
Sydney,"Laidler, Jeremy",16,8,5,8,1,0,0,3
Sydney,"Lloyd, Jake",34,20,4,14,0,0,0,3
Sydney,"Marsh, Harrison",7,4,1,3,0,0,0,0
Sydney,"Mills, Callum",15,10,1,5,0,1,0,4
Sydney,"Naismith, Sam",10,4,1,6,0,0,25,5
Sydney,"Newman, Nic",16,6,4,10,1,0,0,6
Sydney,"Parker, Luke",21,12,4,9,0,1,0,6
Sydney,"Reid, Sam",15,9,5,6,6,1,5,1
Sydney,"Smith, Nick",12,9,2,3,0,0,0,2
Sydney,"Tippett, Kurt",1,1,1,0,0,0,2,1
Sydney,"Aliir, Aliir",12,10,5,2,0,0,0,6
Sydney,"Dawson, Jordan",10,6,3,4,0,1,0,3
Sydney,"Florent, Oliver",9,7,2,2,1,0,0,3
Sydney,"Foote, Jordan",13,2,2,11,0,0,0,6
Sydney,"Fox, Robbie",15,7,1,8,1,0,0,7
Sydney,"Franklin, Lance",17,12,7,5,0,3,0,4
Sydney,"Grundy, Heath",17,10,5,7,0,0,0,0
Sydney,"Hannebery, Dan",31,11,4,20,1,1,0,9
Sydney,"Hayward, Will",8,6,3,2,3,1,0,1
Sydney,"Hewett, George",17,5,2,12,0,0,0,6
Sydney,"Jack, Kieren",13,7,2,6,2,0,0,3
Sydney,"Jones, Zak",22,12,4,10,0,0,0,5
Sydney,"Kennedy, Josh",32,14,1,18,1,2,0,2
Sydney,"Lloyd, Jake",34,17,5,17,0,0,0,2
Sydney,"Marsh, Harrison",16,7,2,9,0,0,0,1
Sydney,"Mills, Callum",21,14,3,7,0,0,0,5
Sydney,"Naismith, Sam",10,2,4,8,0,0,31,2
Sydney,"Newman, Nic",23,15,4,8,1,1,0,4
Sydney,"Parker, Luke",23,11,0,12,0,0,0,6
Sydney,"Reid, Sam",8,4,2,4,1,1,0,4
Sydney,"Sinclair, Callum",8,6,3,2,0,1,14,6
Sydney,"Smith, Nick",7,5,3,2,0,0,0,3
Sydney,"Aliir, Aliir",9,4,3,5,0,0,0,2
Sydney,"Cunningham, Harry",14,5,3,9,1,0,0,7
Sydney,"Florent, Oliver",8,7,1,1,1,0,0,2
Sydney,"Foote, Jordan",9,3,0,6,1,0,0,4
Sydney,"Fox, Robbie",11,5,0,6,0,0,0,5
Sydney,"Franklin, Lance",15,9,7,6,2,0,2,3
Sydney,"Grundy, Heath",18,11,8,7,0,0,0,4
Sydney,"Hannebery, Dan",23,8,1,15,0,1,0,6
Sydney,"Hayward, Will",11,10,4,1,2,1,0,1
Sydney,"Hewett, George",20,11,4,9,0,0,0,6
Sydney,"Jack, Kieren",14,9,2,5,0,0,0,4
Sydney,"Jones, Zak",19,12,4,7,0,0,0,4
Sydney,"Kennedy, Josh",33,14,3,19,0,0,0,5
Sydney,"Lloyd, Jake",29,22,6,7,1,0,0,2
Sydney,"Marsh, Harrison",19,10,2,9,0,0,0,0
Sydney,"Mills, Callum",14,10,3,4,0,0,0,1
Sydney,"Newman, Nic",19,13,4,6,0,0,0,2
Sydney,"Papley, Tom",6,4,2,2,1,1,0,1
Sydney,"Parker, Luke",27,12,4,15,0,0,0,4
Sydney,"Reid, Sam",16,8,6,8,1,0,7,2
Sydney,"Sinclair, Callum",13,9,1,4,0,0,24,4
Sydney,"Smith, Nick",14,7,4,7,0,0,0,3
Sydney,"Cunningham, Harry",15,9,2,6,0,0,0,8
Sydney,"Foote, Jordan",7,1,0,6,0,0,0,5
Sydney,"Franklin, Lance",15,13,7,2,3,3,0,2
Sydney,"Grundy, Heath",13,8,3,5,0,0,0,3
Sydney,"Hannebery, Dan",23,8,0,15,0,0,0,8
Sydney,"Hayward, Will",5,1,1,4,0,0,0,3
Sydney,"Heeney, Isaac",16,9,4,7,0,0,0,2
Sydney,"Hewett, George",19,7,3,12,0,0,0,2
Sydney,"Jack, Kieren",12,9,2,3,0,1,0,3
Sydney,"Jones, Zak",19,14,5,5,0,0,0,6
Sydney,"Kennedy, Josh",22,12,2,10,1,0,0,2
Sydney,"Lloyd, Jake",29,14,6,15,0,0,0,0
Sydney,"Marsh, Harrison",17,7,5,10,0,1,0,2
Sydney,"Melican, Lewis",13,9,8,4,0,0,0,1
Sydney,"Mills, Callum",21,14,7,7,0,0,0,3
Sydney,"Papley, Tom",9,6,4,3,1,1,0,2
Sydney,"Parker, Luke",17,12,5,5,1,2,0,4
Sydney,"Reid, Sam",18,8,7,10,0,0,0,2
Sydney,"Rohan, Gary",9,9,6,0,1,0,0,2
Sydney,"Sinclair, Callum",10,8,1,2,1,0,14,4
Sydney,"Smith, Nick",12,4,6,8,0,0,0,0
Sydney,"Tippett, Kurt",5,1,2,4,1,0,15,1
Sydney,"Cunningham, Harry",16,8,0,8,0,1,0,3
Sydney,"Franklin, Lance",19,11,2,8,1,1,0,3
Sydney,"Grundy, Heath",10,6,4,4,0,1,0,0
Sydney,"Hannebery, Dan",25,12,5,13,1,1,0,6
Sydney,"Hayward, Will",7,3,2,4,2,0,0,6
Sydney,"Heeney, Isaac",26,16,7,10,1,0,0,6
Sydney,"Hewett, George",17,9,4,8,0,2,0,10
Sydney,"Jack, Brandon",9,2,3,7,0,0,0,5
Sydney,"Jones, Zak",22,13,8,9,1,0,0,2
Sydney,"Kennedy, Josh",27,15,4,12,1,1,0,2
Sydney,"Laidler, Jeremy",14,5,2,9,0,0,0,3
Sydney,"Lloyd, Jake",32,19,7,13,0,0,0,0
Sydney,"Melican, Lewis",11,6,3,5,0,0,0,2
Sydney,"Mills, Callum",14,9,3,5,0,0,0,0
Sydney,"Newman, Nic",19,11,4,8,0,0,0,2
Sydney,"Papley, Tom",16,15,8,1,2,2,0,5
Sydney,"Parker, Luke",26,10,3,16,1,0,0,8
Sydney,"Reid, Sam",13,6,4,7,0,0,17,3
Sydney,"Rohan, Gary",2,1,0,1,0,0,0,1
Sydney,"Rose, James",6,5,0,1,0,1,0,4
Sydney,"Sinclair, Callum",19,7,5,12,1,1,15,6
Sydney,"Smith, Nick",11,5,2,6,0,0,0,2
Sydney,"Cunningham, Harry",17,13,8,4,2,0,0,5
Sydney,"Florent, Oliver",10,4,1,6,0,0,0,1
Sydney,"Franklin, Lance",16,16,9,0,8,4,0,2
Sydney,"Grundy, Heath",20,10,7,10,0,1,0,4
Sydney,"Hannebery, Dan",26,13,5,13,1,0,0,8
Sydney,"Hayward, Will",9,6,1,3,2,2,0,2
Sydney,"Heeney, Isaac",22,15,5,7,1,0,0,5
Sydney,"Hewett, George",16,7,3,9,0,0,0,4
Sydney,"Jones, Zak",27,13,6,14,1,1,0,2
Sydney,"Kennedy, Josh",20,7,1,13,1,0,0,3
Sydney,"Lloyd, Jake",29,15,7,14,0,0,0,2
Sydney,"Marsh, Harrison",16,10,6,6,0,0,0,1
Sydney,"McVeigh, Jarrad",15,9,4,6,0,0,0,1
Sydney,"Melican, Lewis",16,10,5,6,0,0,0,3
Sydney,"Mills, Callum",17,9,4,8,0,0,0,2
Sydney,"Naismith, Sam",9,5,3,4,0,0,16,3
Sydney,"Papley, Tom",19,10,6,9,0,1,0,1
Sydney,"Parker, Luke",30,15,4,15,1,1,0,1
Sydney,"Reid, Sam",12,4,5,8,0,1,0,0
Sydney,"Sinclair, Callum",15,8,5,7,2,0,16,0
Sydney,"Smith, Nick",10,6,3,4,0,0,0,2
Sydney,"Towers, Dean",20,9,4,11,1,0,0,3
Sydney,"Cunningham, Harry",12,6,3,6,0,0,0,5
Sydney,"Franklin, Lance",21,20,8,1,1,3,0,2
Sydney,"Grundy, Heath",22,15,10,7,0,0,0,0
Sydney,"Hannebery, Dan",33,11,5,22,2,0,0,4
Sydney,"Hayward, Will",10,6,1,4,1,0,0,1
Sydney,"Heeney, Isaac",25,14,9,11,2,2,0,4
Sydney,"Hewett, George",29,15,5,14,1,1,0,2
Sydney,"Jones, Zak",15,8,5,7,1,0,0,5
Sydney,"Kennedy, Josh",37,11,2,26,1,0,0,6
Sydney,"Lloyd, Jake",28,20,8,8,0,1,0,1
Sydney,"Marsh, Harrison",14,8,5,6,0,1,0,1
Sydney,"McVeigh, Jarrad",5,4,2,1,2,0,0,3
Sydney,"Melican, Lewis",6,3,3,3,0,0,0,2
Sydney,"Mills, Callum",23,16,7,7,0,0,0,1
Sydney,"Naismith, Sam",7,2,0,5,0,0,23,0
Sydney,"Newman, Nic",35,19,11,16,0,0,0,4
Sydney,"Papley, Tom",15,10,5,5,2,1,0,3
Sydney,"Parker, Luke",36,19,3,17,2,1,0,5
Sydney,"Reid, Sam",22,14,12,8,3,0,0,0
Sydney,"Sinclair, Callum",7,5,2,2,0,0,15,0
Sydney,"Smith, Nick",13,6,5,7,0,0,0,0
Sydney,"Towers, Dean",20,11,6,9,0,1,0,5
Sydney,"Cunningham, Harry",12,8,2,4,2,0,0,1
Sydney,"Franklin, Lance",17,10,6,7,4,2,0,1
Sydney,"Grundy, Heath",16,9,5,7,0,0,0,1
Sydney,"Hannebery, Dan",30,18,12,12,2,0,0,8
Sydney,"Hayward, Will",14,9,7,5,1,1,0,2
Sydney,"Heeney, Isaac",18,9,5,9,0,0,0,4
Sydney,"Hewett, George",19,10,6,9,1,0,0,5
Sydney,"Jones, Zak",20,6,5,14,0,0,0,1
Sydney,"Kennedy, Josh",35,12,4,23,1,0,0,5
Sydney,"Lloyd, Jake",35,21,10,14,0,0,0,1
Sydney,"Melican, Lewis",9,4,3,5,0,0,0,2
Sydney,"Mills, Callum",22,15,9,7,0,0,0,1
Sydney,"Newman, Nic",30,24,7,6,1,0,0,1
Sydney,"Papley, Tom",20,11,6,9,2,2,0,4
Sydney,"Parker, Luke",28,12,2,16,0,0,0,2
Sydney,"Rampe, Dane",13,8,4,5,0,0,0,2
Sydney,"Reid, Sam",16,8,3,8,1,0,0,3
Sydney,"Rohan, Gary",6,5,4,1,1,0,0,3
Sydney,"Sinclair, Callum",17,9,5,8,0,1,25,1
Sydney,"Smith, Nick",23,11,14,12,0,0,0,1
Sydney,"Tippett, Kurt",12,9,4,3,1,2,8,0
Sydney,"Towers, Dean",19,13,6,6,1,0,0,2
Sydney,"Florent, Oliver",7,3,1,4,0,0,0,4
Sydney,"Franklin, Lance",16,12,6,4,5,1,0,2
Sydney,"Grundy, Heath",8,2,3,6,0,0,0,0
Sydney,"Hannebery, Dan",35,17,3,18,0,0,0,3
Sydney,"Hayward, Will",9,8,3,1,0,1,0,1
Sydney,"Heeney, Isaac",19,14,1,5,2,0,0,7
Sydney,"Hewett, George",16,6,1,10,0,0,0,2
Sydney,"Jones, Zak",22,10,4,12,1,1,0,11
Sydney,"Kennedy, Josh",33,10,2,23,1,0,0,6
Sydney,"Lloyd, Jake",1,0,0,1,0,0,0,0
Sydney,"Melican, Lewis",13,7,2,6,0,0,0,1
Sydney,"Mills, Callum",14,13,4,1,0,1,0,3
Sydney,"Newman, Nic",18,13,4,5,0,0,0,4
Sydney,"Papley, Tom",18,10,6,8,1,2,0,3
Sydney,"Parker, Luke",22,10,1,12,0,1,0,3
Sydney,"Rampe, Dane",18,12,6,6,0,0,0,0
Sydney,"Reid, Sam",4,0,0,4,0,0,1,2
Sydney,"Rohan, Gary",9,6,0,3,1,1,0,4
Sydney,"Sinclair, Callum",9,6,2,3,0,0,30,2
Sydney,"Smith, Nick",12,6,4,6,0,0,0,2
Sydney,"Tippett, Kurt",12,7,4,5,0,1,28,4
Sydney,"Towers, Dean",15,4,1,11,0,0,0,3
Sydney,"Franklin, Lance",16,13,9,3,3,5,0,2
Sydney,"Grundy, Heath",22,12,7,10,0,0,0,2
Sydney,"Hannebery, Dan",28,12,6,16,1,0,0,4
Sydney,"Hayward, Will",11,9,6,2,0,2,0,3
Sydney,"Heeney, Isaac",31,17,5,14,0,1,0,4
Sydney,"Hewett, George",12,8,5,4,1,0,0,1
Sydney,"Jack, Kieren",16,9,2,7,0,1,0,2
Sydney,"Jones, Zak",16,8,1,8,0,1,0,3
Sydney,"Kennedy, Josh",37,15,2,22,1,0,0,3
Sydney,"Lloyd, Jake",31,23,10,8,1,0,0,0
Sydney,"Marsh, Harrison",15,10,6,5,0,0,0,0
Sydney,"Melican, Lewis",14,8,4,6,0,0,0,2
Sydney,"Mills, Callum",14,10,9,4,0,0,0,3
Sydney,"Naismith, Sam",8,4,1,4,0,0,33,3
Sydney,"Newman, Nic",18,14,7,4,0,0,1,3
Sydney,"Papley, Tom",21,9,0,12,2,1,0,8
Sydney,"Parker, Luke",23,15,4,8,1,0,0,8
Sydney,"Rampe, Dane",16,8,6,8,0,0,0,2
Sydney,"Reid, Sam",16,10,10,6,2,2,0,2
Sydney,"Sinclair, Callum",16,5,1,11,0,0,31,4
Sydney,"Smith, Nick",18,12,4,6,0,0,0,1
Sydney,"Towers, Dean",15,10,1,5,0,0,0,3
Sydney,"Franklin, Lance",16,11,6,5,1,1,0,1
Sydney,"Grundy, Heath",13,5,3,8,0,0,0,0
Sydney,"Hannebery, Dan",25,15,4,10,0,0,0,3
Sydney,"Hayward, Will",10,7,4,3,1,0,0,1
Sydney,"Heeney, Isaac",22,13,5,9,1,2,0,7
Sydney,"Hewett, George",17,7,6,10,1,0,0,2
Sydney,"Jack, Kieren",13,7,2,6,1,1,0,3
Sydney,"Jones, Zak",26,11,3,15,0,0,0,4
Sydney,"Kennedy, Josh",23,9,4,14,1,0,0,8
Sydney,"Lloyd, Jake",25,14,5,11,1,0,0,2
Sydney,"Marsh, Harrison",8,4,4,4,0,0,0,3
Sydney,"Mills, Callum",19,11,5,8,0,0,0,2
Sydney,"Naismith, Sam",8,3,2,5,0,0,24,1
Sydney,"Newman, Nic",26,19,4,7,0,0,0,7
Sydney,"Papley, Tom",19,13,6,6,1,2,0,7
Sydney,"Parker, Luke",20,11,2,9,1,0,0,5
Sydney,"Rampe, Dane",16,11,3,5,0,0,0,2
Sydney,"Reid, Sam",15,12,10,3,2,1,0,0
Sydney,"Rohan, Gary",11,5,2,6,1,0,0,2
Sydney,"Sinclair, Callum",9,5,1,4,0,0,26,2
Sydney,"Smith, Nick",6,5,6,1,0,0,0,4
Sydney,"Towers, Dean",6,3,1,3,0,0,0,1
Sydney,"Florent, Oliver",13,7,4,6,1,0,0,0
Sydney,"Franklin, Lance",17,15,5,2,0,6,0,3
Sydney,"Grundy, Heath",26,15,8,11,0,0,0,1
Sydney,"Hannebery, Dan",29,9,3,20,1,0,0,3
Sydney,"Hayward, Will",8,6,4,2,1,1,0,1
Sydney,"Heeney, Isaac",21,16,5,5,2,0,0,9
Sydney,"Hewett, George",16,8,5,8,0,0,0,3
Sydney,"Jack, Kieren",13,9,6,4,0,2,0,4
Sydney,"Kennedy, Josh",36,19,5,17,0,0,0,3
Sydney,"Lloyd, Jake",31,19,10,12,0,0,0,1
Sydney,"Melican, Lewis",15,5,3,10,0,0,0,0
Sydney,"Mills, Callum",26,17,8,9,0,0,0,4
Sydney,"Naismith, Sam",10,6,1,4,0,1,24,1
Sydney,"Newman, Nic",13,9,4,4,2,1,0,5
Sydney,"Papley, Tom",12,5,4,7,1,0,0,6
Sydney,"Parker, Luke",26,12,9,14,1,1,0,4
Sydney,"Rampe, Dane",17,11,4,6,0,1,0,2
Sydney,"Reid, Sam",13,12,9,1,1,3,0,1
Sydney,"Rohan, Gary",12,7,5,5,1,0,0,2
Sydney,"Sinclair, Callum",12,7,2,5,0,0,10,4
Sydney,"Smith, Nick",13,10,5,3,0,1,0,1
Sydney,"Towers, Dean",12,10,3,2,0,1,0,6
Sydney,"Florent, Oliver",9,5,3,4,0,1,0,2
Sydney,"Franklin, Lance",19,15,11,4,4,3,0,1
Sydney,"Grundy, Heath",20,10,7,10,0,0,0,1
Sydney,"Hannebery, Dan",16,5,3,11,0,0,0,2
Sydney,"Heeney, Isaac",24,16,3,8,1,1,0,2
Sydney,"Hewett, George",29,15,10,14,0,0,0,4
Sydney,"Jack, Kieren",23,16,5,7,1,0,0,10
Sydney,"Jones, Zak",26,17,6,9,0,0,0,5
Sydney,"Kennedy, Josh",28,12,3,16,0,1,0,6
Sydney,"Lloyd, Jake",27,19,5,8,1,0,0,1
Sydney,"McVeigh, Jarrad",24,14,10,10,0,0,0,1
Sydney,"Melican, Lewis",14,9,5,5,0,0,0,3
Sydney,"Mills, Callum",0,0,0,0,0,0,0,0
Sydney,"Naismith, Sam",12,5,4,7,0,1,27,2
Sydney,"Newman, Nic",25,19,8,6,0,1,0,5
Sydney,"Papley, Tom",25,12,5,13,2,1,0,4
Sydney,"Parker, Luke",38,20,6,18,1,2,0,6
Sydney,"Rampe, Dane",21,11,6,10,0,0,0,1
Sydney,"Reid, Sam",14,9,8,5,1,1,2,1
Sydney,"Rohan, Gary",16,11,8,5,0,3,0,3
Sydney,"Smith, Nick",13,4,5,9,0,0,0,1
Sydney,"Towers, Dean",16,10,5,6,0,1,0,4
Sydney,"Florent, Oliver",11,4,2,7,0,0,0,2
Sydney,"Franklin, Lance",19,15,7,4,3,4,0,4
Sydney,"Grundy, Heath",24,11,7,13,0,0,0,2
Sydney,"Hannebery, Dan",15,7,2,8,0,0,0,10
Sydney,"Heeney, Isaac",20,12,6,8,0,0,0,5
Sydney,"Hewett, George",17,8,3,9,2,0,0,6
Sydney,"Jack, Kieren",22,14,5,8,0,1,0,4
Sydney,"Jones, Zak",9,6,4,3,2,1,0,2
Sydney,"Lloyd, Jake",30,18,3,12,0,1,0,0
Sydney,"McVeigh, Jarrad",20,9,6,11,0,1,0,1
Sydney,"Melican, Lewis",14,7,3,7,1,0,0,1
Sydney,"Mills, Callum",22,13,4,9,0,0,0,2
Sydney,"Naismith, Sam",3,1,1,2,0,0,31,3
Sydney,"Newman, Nic",21,10,4,11,0,2,0,5
Sydney,"Papley, Tom",20,11,1,9,1,0,0,6
Sydney,"Parker, Luke",29,12,6,17,0,2,0,7
Sydney,"Rampe, Dane",25,16,13,9,0,0,0,1
Sydney,"Reid, Sam",10,6,4,4,1,1,0,2
Sydney,"Robinson, Dan",14,6,2,8,0,0,0,2
Sydney,"Rohan, Gary",16,15,9,1,5,2,0,2
Sydney,"Smith, Nick",16,11,5,5,0,0,0,2
Sydney,"Towers, Dean",21,11,2,10,2,0,0,3
Sydney,"Franklin, Lance",18,16,8,2,4,4,0,0
Sydney,"Grundy, Heath",9,8,2,1,0,0,0,2
Sydney,"Hannebery, Dan",22,11,6,11,1,0,0,9
Sydney,"Heeney, Isaac",18,11,5,7,0,1,0,7
Sydney,"Hewett, George",14,4,0,10,0,0,0,4
Sydney,"Jack, Kieren",22,12,3,10,1,0,0,11
Sydney,"Jones, Zak",21,17,5,4,1,1,0,3
Sydney,"Kennedy, Josh",28,13,0,15,1,0,0,5
Sydney,"Lloyd, Jake",22,15,4,7,1,0,0,2
Sydney,"McVeigh, Jarrad",21,13,2,8,0,0,0,3
Sydney,"Melican, Lewis",11,7,3,4,0,0,0,2
Sydney,"Mills, Callum",14,12,4,2,0,0,0,3
Sydney,"Naismith, Sam",9,2,0,7,0,0,45,2
Sydney,"Newman, Nic",16,9,3,7,0,1,0,4
Sydney,"Papley, Tom",10,9,1,1,3,0,0,8
Sydney,"Parker, Luke",22,7,5,15,1,0,0,3
Sydney,"Rampe, Dane",17,6,4,11,0,0,0,2
Sydney,"Reid, Sam",3,2,2,1,0,1,0,1
Sydney,"Robinson, Dan",12,4,2,8,1,0,0,8
Sydney,"Rohan, Gary",9,7,5,2,0,2,0,2
Sydney,"Smith, Nick",13,7,2,6,0,0,0,5
Sydney,"Towers, Dean",16,9,2,7,0,0,2,1
Sydney,"Franklin, Lance",16,14,6,2,3,4,0,1
Sydney,"Grundy, Heath",13,8,6,5,0,0,0,0
Sydney,"Hannebery, Dan",25,13,5,12,0,1,0,1
Sydney,"Heeney, Isaac",19,14,4,5,1,1,0,1
Sydney,"Hewett, George",19,10,2,9,1,0,0,5
Sydney,"Jack, Kieren",18,9,1,9,0,1,0,4
Sydney,"Jones, Zak",9,4,3,5,0,0,0,0
Sydney,"Kennedy, Josh",25,13,2,12,1,0,0,5
Sydney,"Lloyd, Jake",21,11,3,10,0,0,0,0
Sydney,"McVeigh, Jarrad",21,10,6,11,1,0,0,1
Sydney,"Melican, Lewis",15,9,3,6,0,0,0,3
Sydney,"Mills, Callum",18,9,6,9,0,0,0,1
Sydney,"Naismith, Sam",9,2,1,7,0,0,21,2
Sydney,"Newman, Nic",14,9,2,5,0,0,0,4
Sydney,"Papley, Tom",15,10,3,5,0,0,0,3
Sydney,"Parker, Luke",21,13,4,8,0,2,0,6
Sydney,"Rampe, Dane",10,5,4,5,0,0,0,5
Sydney,"Robinson, Dan",11,2,3,9,0,0,0,3
Sydney,"Rohan, Gary",10,8,5,2,1,1,0,5
Sydney,"Sinclair, Callum",19,13,10,6,5,3,4,1
Sydney,"Smith, Nick",13,4,3,9,0,0,0,2
Sydney,"Towers, Dean",19,12,8,7,1,2,2,0
Sydney,"Foote, Jordan",9,3,0,6,0,0,0,0
Sydney,"Franklin, Lance",13,11,5,2,1,1,0,5
Sydney,"Grundy, Heath",17,9,2,8,0,0,0,1
Sydney,"Hannebery, Dan",20,6,2,14,0,0,0,2
Sydney,"Hayward, Will",5,3,0,2,1,0,0,1
Sydney,"Heeney, Isaac",25,10,4,15,0,0,0,3
Sydney,"Hewett, George",18,8,5,10,2,0,0,2
Sydney,"Jack, Kieren",17,14,4,3,0,1,0,2
Sydney,"Jones, Zak",19,7,3,12,0,0,0,2
Sydney,"Kennedy, Josh",14,4,2,10,0,0,0,3
Sydney,"McVeigh, Jarrad",21,14,4,7,1,0,0,2
Sydney,"Melican, Lewis",9,6,2,3,0,0,0,3
Sydney,"Mills, Callum",21,14,5,7,0,0,0,3
Sydney,"Naismith, Sam",11,4,1,7,0,0,21,1
Sydney,"Newman, Nic",29,14,7,15,0,0,0,4
Sydney,"Papley, Tom",17,15,4,2,3,3,0,4
Sydney,"Parker, Luke",24,13,6,11,0,1,0,8
Sydney,"Rampe, Dane",18,12,12,6,0,0,0,2
Sydney,"Robinson, Dan",10,4,1,6,0,0,0,4
Sydney,"Sinclair, Callum",11,6,3,5,1,1,17,3
Sydney,"Smith, Nick",13,9,6,4,0,0,0,4
Sydney,"Towers, Dean",14,7,3,7,0,0,1,8
Sydney,"Franklin, Lance",8,5,1,3,1,1,0,2
Sydney,"Grundy, Heath",13,7,3,6,0,0,0,1
Sydney,"Hannebery, Dan",21,8,4,13,2,0,0,5
Sydney,"Hayward, Will",12,9,4,3,3,1,0,5
Sydney,"Heeney, Isaac",19,10,4,9,1,1,0,3
Sydney,"Hewett, George",17,6,2,11,0,0,0,8
Sydney,"Jack, Kieren",21,16,2,5,0,0,0,1
Sydney,"Jones, Zak",15,10,4,5,0,0,0,5
Sydney,"Lloyd, Jake",20,13,6,7,0,0,0,3
Sydney,"McVeigh, Jarrad",21,11,5,10,0,1,0,6
Sydney,"Melican, Lewis",9,5,3,4,0,1,0,1
Sydney,"Mills, Callum",16,8,2,8,0,0,0,4
Sydney,"Newman, Nic",19,9,3,10,1,0,0,7
Sydney,"Papley, Tom",12,8,2,4,3,2,0,4
Sydney,"Parker, Luke",23,11,2,12,1,1,0,13
Sydney,"Rampe, Dane",18,11,4,7,0,0,0,2
Sydney,"Reid, Sam",16,12,7,4,2,1,1,1
Sydney,"Rohan, Gary",9,7,3,2,2,1,0,1
Sydney,"Sinclair, Callum",17,11,3,6,0,1,18,6
Sydney,"Smith, Nick",10,6,4,4,0,0,0,0
Sydney,"Tippett, Kurt",8,6,2,2,0,0,16,4
Sydney,"Towers, Dean",7,5,1,2,0,0,0,2
Sydney,"Franklin, Lance",24,16,8,8,4,2,0,3
Sydney,"Grundy, Heath",19,12,6,7,0,0,0,0
Sydney,"Hannebery, Dan",29,15,6,14,0,0,0,5
Sydney,"Hayward, Will",9,6,5,3,2,1,0,5
Sydney,"Heeney, Isaac",23,13,8,10,1,0,0,5
Sydney,"Hewett, George",23,9,6,14,0,0,0,4
Sydney,"Jack, Kieren",23,18,8,5,1,1,0,3
Sydney,"Jones, Zak",22,8,7,14,1,1,0,3
Sydney,"Lloyd, Jake",26,15,6,11,0,0,0,2
Sydney,"McVeigh, Jarrad",18,11,7,7,1,0,0,2
Sydney,"Melican, Lewis",10,3,3,7,0,0,0,2
Sydney,"Mills, Callum",19,10,8,9,0,0,0,1
Sydney,"Newman, Nic",12,9,3,3,0,0,0,1
Sydney,"Papley, Tom",16,7,0,9,2,0,0,3
Sydney,"Parker, Luke",29,14,4,15,3,0,0,4
Sydney,"Rampe, Dane",25,12,6,13,0,0,0,2
Sydney,"Reid, Sam",11,8,7,3,2,3,0,0
Sydney,"Rohan, Gary",11,9,7,2,2,0,0,3
Sydney,"Sinclair, Callum",9,6,1,3,1,0,19,1
Sydney,"Smith, Nick",16,8,5,8,0,0,0,2
Sydney,"Tippett, Kurt",13,9,7,4,2,1,11,8
Sydney,"Towers, Dean",20,12,7,8,0,1,2,4
Sydney,"Franklin, Lance",16,13,5,3,3,1,0,1
Sydney,"Grundy, Heath",13,7,1,6,0,0,0,4
Sydney,"Hannebery, Dan",28,13,3,15,0,0,0,5
Sydney,"Hayward, Will",6,3,0,3,0,1,0,3
Sydney,"Heeney, Isaac",18,11,4,7,0,0,0,10
Sydney,"Hewett, George",23,6,0,17,0,0,0,10
Sydney,"Jack, Kieren",11,6,0,5,1,0,0,9
Sydney,"Jones, Zak",21,14,5,7,1,0,0,3
Sydney,"Kennedy, Josh",31,18,5,13,1,0,0,7
Sydney,"Lloyd, Jake",23,20,5,3,0,1,0,3
Sydney,"McVeigh, Jarrad",21,14,3,7,1,1,0,5
Sydney,"Melican, Lewis",13,9,5,4,0,0,0,2
Sydney,"Mills, Callum",14,8,7,6,0,0,0,3
Sydney,"Papley, Tom",16,12,0,4,1,0,0,9
Sydney,"Parker, Luke",30,14,1,16,0,0,0,4
Sydney,"Rampe, Dane",16,9,4,7,0,0,0,1
Sydney,"Reid, Sam",13,7,7,6,2,1,0,0
Sydney,"Rohan, Gary",8,5,1,3,2,0,0,7
Sydney,"Sinclair, Callum",8,5,1,3,0,0,25,1
Sydney,"Smith, Nick",10,7,5,3,0,0,0,0
Sydney,"Tippett, Kurt",14,7,2,7,1,0,17,3
Sydney,"Towers, Dean",6,2,3,4,0,0,0,3
Sydney,"Cunningham, Harry",14,4,2,10,0,0,0,4
Sydney,"Franklin, Lance",25,21,10,4,10,2,0,2
Sydney,"Grundy, Heath",22,14,8,8,0,0,0,1
Sydney,"Hayward, Will",3,3,2,0,3,0,0,2
Sydney,"Heeney, Isaac",12,9,6,3,1,2,0,1
Sydney,"Hewett, George",20,11,4,9,0,2,0,2
Sydney,"Jack, Kieren",16,11,5,5,0,0,0,3
Sydney,"Jones, Zak",25,16,3,9,0,0,0,4
Sydney,"Kennedy, Josh",30,13,2,17,1,1,0,6
Sydney,"Lloyd, Jake",22,11,4,11,0,1,0,3
Sydney,"McVeigh, Jarrad",14,8,6,6,0,2,0,2
Sydney,"Melican, Lewis",11,5,4,6,0,0,0,1
Sydney,"Mills, Callum",20,10,7,10,0,0,0,4
Sydney,"Newman, Nic",21,16,5,5,1,0,0,3
Sydney,"Parker, Luke",28,12,4,16,0,0,0,8
Sydney,"Rampe, Dane",17,12,7,5,0,0,0,1
Sydney,"Reid, Sam",12,6,9,6,1,0,3,1
Sydney,"Rohan, Gary",11,10,4,1,3,0,0,6
Sydney,"Sinclair, Callum",17,10,6,7,0,0,22,4
Sydney,"Smith, Nick",11,4,4,7,0,0,0,2
Sydney,"Tippett, Kurt",8,3,2,5,1,0,6,1
Sydney,"Towers, Dean",16,12,4,4,0,2,1,2
Sydney,"Cunningham, Harry",19,9,6,10,0,0,0,1
Sydney,"Franklin, Lance",8,7,3,1,4,1,0,1
Sydney,"Grundy, Heath",22,10,10,12,0,0,0,0
Sydney,"Hannebery, Dan",21,8,8,13,0,0,0,6
Sydney,"Heeney, Isaac",13,9,6,4,2,2,0,5
Sydney,"Hewett, George",19,7,4,12,0,0,0,6
Sydney,"Jack, Kieren",19,14,3,5,1,0,0,3
Sydney,"Jones, Zak",21,19,9,2,0,0,0,4
Sydney,"Kennedy, Josh",29,11,3,18,2,0,0,5
Sydney,"Lloyd, Jake",25,16,14,9,1,0,0,0
Sydney,"McVeigh, Jarrad",21,17,5,4,0,0,0,1
Sydney,"Mills, Callum",16,11,9,5,0,0,0,5
Sydney,"Naismith, Sam",10,4,2,6,0,0,33,5
Sydney,"Newman, Nic",15,11,5,4,0,0,0,2
Sydney,"Papley, Tom",16,8,2,8,1,0,0,3
Sydney,"Parker, Luke",27,15,3,12,0,1,0,7
Sydney,"Rampe, Dane",15,11,6,4,0,0,0,2
Sydney,"Reid, Sam",12,7,6,5,0,0,0,2
Sydney,"Rohan, Gary",7,5,5,2,2,0,0,5
Sydney,"Sinclair, Callum",10,9,9,1,3,1,3,3
Sydney,"Smith, Nick",13,9,7,4,0,0,0,2
Sydney,"Towers, Dean",14,9,2,5,3,1,2,5
Sydney,"Cunningham, Harry",10,6,1,4,0,0,0,3
Sydney,"Franklin, Lance",14,10,4,4,0,3,0,3
Sydney,"Grundy, Heath",11,6,1,5,0,0,0,3
Sydney,"Hannebery, Dan",27,7,1,20,0,0,0,5
Sydney,"Heeney, Isaac",20,12,4,8,0,0,0,5
Sydney,"Hewett, George",16,8,3,8,0,1,0,6
Sydney,"Jack, Kieren",23,14,3,9,1,0,0,6
Sydney,"Jones, Zak",17,8,4,9,0,0,0,3
Sydney,"Kennedy, Josh",20,7,2,13,0,0,0,4
Sydney,"Lloyd, Jake",20,12,2,8,0,0,0,4
Sydney,"McVeigh, Jarrad",19,13,4,6,1,1,0,1
Sydney,"Mills, Callum",17,10,2,7,1,0,0,2
Sydney,"Naismith, Sam",8,3,1,5,0,0,31,5
Sydney,"Newman, Nic",17,11,2,6,0,1,0,2
Sydney,"Papley, Tom",10,8,2,2,1,0,0,2
Sydney,"Parker, Luke",13,5,1,8,0,1,0,5
Sydney,"Rampe, Dane",11,4,6,7,0,0,0,1
Sydney,"Reid, Sam",9,6,4,3,1,0,0,0
Sydney,"Rohan, Gary",7,6,0,1,0,0,0,4
Sydney,"Sinclair, Callum",2,1,0,1,0,0,9,1
Sydney,"Smith, Nick",8,2,3,6,0,0,0,2
Sydney,"Towers, Dean",12,5,3,7,0,0,1,9
West Coast,"Cripps, Jamie",15,12,6,3,3,2,0,5
West Coast,"Darling, Jack",7,5,3,2,2,0,3,5
West Coast,"Gaff, Andrew",36,20,13,16,0,0,0,3
West Coast,"Hill, Josh",15,8,2,7,1,2,0,3
West Coast,"Hurn, Shannon",21,14,8,7,0,1,0,3
West Coast,"Hutchings, Mark",16,10,2,6,0,0,0,2
West Coast,"Jetta, Lewis",9,4,0,5,1,0,0,2
West Coast,"Kennedy, Josh",16,12,9,4,7,0,0,4
West Coast,"LeCras, Mark",15,11,5,4,4,1,0,1
West Coast,"Mackenzie, Eric",11,6,3,5,0,0,0,1
West Coast,"Masten, Chris",23,12,7,11,0,0,0,5
West Coast,"McGovern, Jeremy",21,15,12,6,0,1,0,1
West Coast,"Mitchell, Sam",38,14,5,24,0,1,0,1
West Coast,"Nelson, Jackson",8,6,2,2,0,0,0,1
West Coast,"Petrie, Drew",7,7,1,0,1,0,10,2
West Coast,"Priddis, Matt",29,7,3,22,0,0,0,5
West Coast,"Redden, Jack",22,10,8,12,0,0,0,8
West Coast,"Sheppard, Brad",16,10,6,6,0,0,0,3
West Coast,"Shuey, Luke",31,11,3,20,0,0,0,4
West Coast,"Vardy, Nathan",10,5,3,5,0,0,16,1
West Coast,"Wellingham, Sharrod",22,11,4,11,0,0,0,2
West Coast,"Yeo, Elliot",26,16,10,10,2,1,0,2
West Coast,"Barrass, Tom",22,11,10,11,0,0,0,1
West Coast,"Cripps, Jamie",15,6,2,9,1,0,0,3
West Coast,"Darling, Jack",11,8,6,3,2,1,2,0
West Coast,"Gaff, Andrew",36,23,6,13,0,1,0,0
West Coast,"Giles, Jonathan",8,5,1,3,1,1,16,4
West Coast,"Hill, Josh",14,12,6,2,3,1,0,2
West Coast,"Hurn, Shannon",23,13,6,10,0,0,0,0
West Coast,"Hutchings, Mark",17,8,4,9,0,0,0,4
West Coast,"Kennedy, Josh",9,7,5,2,4,1,0,1
West Coast,"LeCras, Mark",14,9,3,5,1,0,0,2
West Coast,"Masten, Chris",27,11,3,16,2,0,0,1
West Coast,"McGovern, Jeremy",20,17,9,3,0,0,0,0
West Coast,"Mitchell, Sam",25,15,4,10,0,0,0,4
West Coast,"Nelson, Jackson",15,6,3,9,0,1,0,3
West Coast,"Priddis, Matt",31,9,4,22,1,0,0,5
West Coast,"Redden, Jack",15,6,3,9,0,0,0,4
West Coast,"Sheed, Dom",11,7,4,4,0,0,0,2
West Coast,"Sheppard, Brad",20,6,6,14,0,0,0,5
West Coast,"Shuey, Luke",30,13,4,17,2,0,0,11
West Coast,"Vardy, Nathan",11,4,2,7,1,0,20,2
West Coast,"Wellingham, Sharrod",23,13,8,10,0,0,0,1
West Coast,"Yeo, Elliot",25,17,13,8,0,0,0,0
West Coast,"Barrass, Tom",10,8,5,2,0,0,0,0
West Coast,"Cripps, Jamie",10,8,5,2,1,0,0,2
West Coast,"Darling, Jack",16,10,6,6,1,2,0,4
West Coast,"Gaff, Andrew",33,20,2,13,0,0,0,3
West Coast,"Giles, Jonathan",9,4,2,5,0,0,22,4
West Coast,"Hill, Josh",12,9,5,3,0,1,0,3
West Coast,"Hurn, Shannon",17,9,7,8,0,0,0,1
West Coast,"Hutchings, Mark",16,6,3,10,1,1,0,3
West Coast,"Jetta, Lewis",14,9,3,5,0,0,0,1
West Coast,"Kennedy, Josh",10,7,5,3,2,1,2,1
West Coast,"LeCras, Mark",17,11,4,6,3,4,0,2
West Coast,"Masten, Chris",26,11,5,15,0,1,0,5
West Coast,"McGovern, Jeremy",13,9,4,4,0,0,0,1
West Coast,"Mitchell, Sam",25,14,4,11,0,0,0,2
West Coast,"Nelson, Jackson",12,7,4,5,0,0,0,3
West Coast,"Priddis, Matt",23,10,0,13,0,0,0,8
West Coast,"Redden, Jack",18,5,1,13,0,0,0,6
West Coast,"Sheppard, Brad",11,5,2,6,0,0,0,6
West Coast,"Shuey, Luke",30,15,5,15,0,0,0,4
West Coast,"Vardy, Nathan",7,5,2,2,0,0,28,0
West Coast,"Wellingham, Sharrod",21,13,8,8,0,0,0,3
West Coast,"Yeo, Elliot",20,13,4,7,0,1,0,5
West Coast,"Barrass, Tom",17,13,7,4,0,0,0,0
West Coast,"Butler, Sam",21,12,4,9,0,0,0,1
West Coast,"Cripps, Jamie",16,10,4,6,3,0,0,7
West Coast,"Duggan, Liam",14,8,3,6,0,0,0,3
West Coast,"Gaff, Andrew",28,22,3,6,2,1,0,0
West Coast,"Giles, Jonathan",7,1,1,6,0,0,36,4
West Coast,"Hill, Josh",11,6,0,5,1,4,0,3
West Coast,"Hurn, Shannon",19,12,8,7,0,0,0,2
West Coast,"Kennedy, Josh",15,10,6,5,2,3,0,2
West Coast,"LeCras, Mark",11,9,3,2,2,1,0,4
West Coast,"Masten, Chris",20,11,5,9,0,0,0,3
West Coast,"McGovern, Jeremy",19,14,8,5,2,1,0,2
West Coast,"Mitchell, Sam",17,9,1,8,0,0,0,7
West Coast,"Nelson, Jackson",14,9,4,5,0,0,0,1
West Coast,"Priddis, Matt",29,9,5,20,0,0,0,7
West Coast,"Redden, Jack",20,8,2,12,0,0,0,5
West Coast,"Schofield, Will",10,4,4,6,0,0,0,0
West Coast,"Sheppard, Brad",20,10,4,10,0,0,0,5
West Coast,"Shuey, Luke",30,16,8,14,1,1,0,7
West Coast,"Vardy, Nathan",10,8,2,2,0,0,22,3
West Coast,"Wellingham, Sharrod",19,12,5,7,0,1,0,6
West Coast,"Yeo, Elliot",29,18,11,11,0,0,0,1
West Coast,"Barrass, Tom",12,9,8,3,0,0,0,3
West Coast,"Butler, Sam",13,6,2,7,0,0,0,2
West Coast,"Cripps, Jamie",18,10,4,8,1,2,0,7
West Coast,"Darling, Jack",10,7,5,3,4,1,0,1
West Coast,"Duggan, Liam",18,7,3,11,0,0,0,1
West Coast,"Gaff, Andrew",27,13,4,14,0,0,0,2
West Coast,"Hill, Josh",8,3,2,5,2,0,0,2
West Coast,"Hurn, Shannon",15,10,5,5,0,0,0,2
West Coast,"Kennedy, Josh",12,8,6,4,1,3,2,2
West Coast,"LeCras, Mark",11,4,1,7,0,0,0,5
West Coast,"Masten, Chris",26,9,3,17,0,0,0,6
West Coast,"McGovern, Jeremy",16,12,9,4,0,1,11,2
West Coast,"Nelson, Jackson",17,12,3,5,0,0,0,5
West Coast,"Priddis, Matt",22,4,0,18,0,0,0,11
West Coast,"Redden, Jack",17,7,3,10,1,0,0,4
West Coast,"Schofield, Will",10,6,0,4,0,0,0,4
West Coast,"Sheed, Dom",23,9,3,14,0,0,0,2
West Coast,"Sheppard, Brad",11,7,4,4,0,0,0,2
West Coast,"Shuey, Luke",33,20,4,13,2,0,0,5
West Coast,"Vardy, Nathan",8,4,2,4,0,1,27,2
West Coast,"Wellingham, Sharrod",16,8,3,8,0,0,0,3
West Coast,"Yeo, Elliot",16,11,6,5,0,0,0,6
West Coast,"Barrass, Tom",14,10,8,4,0,0,0,4
West Coast,"Butler, Sam",22,17,10,5,0,0,0,3
West Coast,"Darling, Jack",12,8,2,4,2,2,0,5
West Coast,"Duggan, Liam",15,8,6,7,1,0,0,1
West Coast,"Gaff, Andrew",34,19,4,15,0,0,0,3
West Coast,"Giles, Jonathan",11,6,2,5,0,1,17,1
West Coast,"Hill, Josh",15,10,4,5,3,0,0,3
West Coast,"Hurn, Shannon",21,13,11,8,0,0,0,1
West Coast,"Kennedy, Josh",17,11,11,6,6,2,0,1
West Coast,"LeCras, Mark",19,14,7,5,3,1,0,1
West Coast,"Masten, Chris",32,15,6,17,0,0,0,2
West Coast,"McGovern, Jeremy",22,13,13,9,0,0,0,1
West Coast,"Mitchell, Sam",28,14,5,14,0,0,0,4
West Coast,"Mutimer, Kurt",7,4,3,3,0,0,0,4
West Coast,"Priddis, Matt",32,7,3,25,1,0,0,9
West Coast,"Redden, Jack",17,7,4,10,0,0,0,5
West Coast,"Sheed, Dom",25,15,6,10,0,0,0,3
West Coast,"Sheppard, Brad",17,7,4,10,0,0,0,1
West Coast,"Shuey, Luke",28,19,5,9,0,1,0,5
West Coast,"Vardy, Nathan",5,3,2,2,0,0,8,2
West Coast,"Wellingham, Sharrod",22,17,7,5,0,0,0,4
West Coast,"Yeo, Elliot",32,24,14,8,0,0,0,6
West Coast,"Barrass, Tom",19,8,9,11,0,0,0,2
West Coast,"Butler, Sam",12,8,4,4,0,0,0,1
West Coast,"Darling, Jack",10,9,4,1,2,1,0,2
West Coast,"Gaff, Andrew",25,19,4,6,0,0,0,1
West Coast,"Giles, Jonathan",4,3,0,1,0,0,18,2
West Coast,"Hill, Josh",11,5,2,6,2,0,0,2
West Coast,"Hurn, Shannon",19,13,5,6,0,0,0,5
West Coast,"Hutchings, Mark",12,8,3,4,0,0,0,2
West Coast,"Kennedy, Josh",16,12,9,4,2,3,0,0
West Coast,"LeCras, Mark",17,13,5,4,4,1,0,1
West Coast,"Masten, Chris",18,7,3,11,1,0,0,1
West Coast,"McGovern, Jeremy",10,7,3,3,0,0,0,2
West Coast,"Mitchell, Sam",20,14,3,6,0,0,0,4
West Coast,"Mutimer, Kurt",10,6,3,4,1,0,0,3
West Coast,"Priddis, Matt",26,10,3,16,0,0,0,3
West Coast,"Redden, Jack",12,4,4,8,0,0,0,7
West Coast,"Sheed, Dom",13,8,3,5,1,0,0,1
West Coast,"Sheppard, Brad",14,5,2,9,1,0,0,4
West Coast,"Shuey, Luke",26,18,10,8,0,1,0,6
West Coast,"Vardy, Nathan",6,2,1,4,0,0,12,5
West Coast,"Wellingham, Sharrod",23,13,7,10,0,0,0,1
West Coast,"Yeo, Elliot",27,20,10,7,1,0,0,3
West Coast,"Barrass, Tom",14,7,6,7,0,0,0,0
West Coast,"Butler, Sam",9,4,3,5,0,0,0,2
West Coast,"Darling, Jack",11,9,5,2,2,0,0,2
West Coast,"Duggan, Liam",14,8,1,6,1,0,0,1
West Coast,"Gaff, Andrew",35,22,15,13,1,1,0,1
West Coast,"Hill, Josh",10,4,4,6,0,0,0,2
West Coast,"Hurn, Shannon",28,18,6,10,0,1,0,1
West Coast,"Kennedy, Josh",14,13,9,1,3,6,0,3
West Coast,"LeCras, Mark",18,15,6,3,0,3,0,0
West Coast,"Masten, Chris",27,8,3,19,0,0,0,2
West Coast,"McGovern, Jeremy",18,9,5,9,0,0,0,3
West Coast,"McInnes, Fraser",11,5,4,6,0,0,15,5
West Coast,"Mitchell, Sam",33,15,6,18,0,0,0,2
West Coast,"Mutimer, Kurt",15,8,6,7,0,2,0,1
West Coast,"Priddis, Matt",24,7,2,17,0,0,0,11
West Coast,"Redden, Jack",18,6,8,12,0,0,0,2
West Coast,"Sheed, Dom",23,16,7,7,2,1,0,2
West Coast,"Sheppard, Brad",14,10,5,4,0,0,0,0
West Coast,"Shuey, Luke",20,6,5,14,0,0,0,10
West Coast,"Vardy, Nathan",12,8,5,4,0,1,21,4
West Coast,"Wellingham, Sharrod",16,10,4,6,0,0,0,1
West Coast,"Yeo, Elliot",29,18,8,11,0,0,0,3
West Coast,"Barrass, Tom",9,4,3,5,0,0,0,1
West Coast,"Butler, Sam",12,5,3,7,0,0,0,2
West Coast,"Cripps, Jamie",7,5,2,2,0,0,0,6
West Coast,"Darling, Jack",12,9,7,3,2,5,0,6
West Coast,"Duggan, Liam",14,8,4,6,0,1,0,6
West Coast,"Gaff, Andrew",27,13,4,14,0,0,0,4
West Coast,"Hurn, Shannon",17,8,4,9,0,0,0,4
West Coast,"Kennedy, Josh",7,6,4,1,4,2,1,1
West Coast,"LeCras, Mark",14,11,5,3,0,3,0,4
West Coast,"Masten, Chris",24,7,6,17,0,1,0,5
West Coast,"McGovern, Jeremy",13,8,6,5,0,0,4,1
West Coast,"McInnes, Fraser",14,3,4,11,0,0,5,1
West Coast,"Mitchell, Sam",24,13,3,11,0,0,0,3
West Coast,"Mutimer, Kurt",11,9,3,2,0,0,0,3
West Coast,"Priddis, Matt",22,10,6,12,0,0,0,6
West Coast,"Redden, Jack",8,4,3,4,0,0,0,6
West Coast,"Sheed, Dom",18,13,4,5,0,0,0,2
West Coast,"Sheppard, Brad",16,10,1,6,0,0,0,3
West Coast,"Shuey, Luke",26,7,3,19,0,2,0,4
West Coast,"Vardy, Nathan",9,6,6,3,2,0,22,1
West Coast,"Wellingham, Sharrod",11,6,2,5,0,0,0,0
West Coast,"Yeo, Elliot",19,14,5,5,0,0,0,4
West Coast,"Butler, Sam",24,14,5,10,0,0,0,0
West Coast,"Cripps, Jamie",19,11,7,8,1,2,0,3
West Coast,"Darling, Jack",7,6,4,1,2,1,1,4
West Coast,"Duggan, Liam",13,6,2,7,0,0,0,2
West Coast,"Gaff, Andrew",35,18,8,17,0,0,0,3
West Coast,"Hill, Josh",15,4,4,11,0,0,0,0
West Coast,"Hurn, Shannon",19,14,6,5,0,0,0,0
West Coast,"Hutchings, Mark",16,9,2,7,1,0,0,6
West Coast,"Jetta, Lewis",28,18,4,10,2,0,0,2
West Coast,"Karpany, Malcolm",11,7,2,4,1,1,0,3
West Coast,"Kennedy, Josh",6,5,1,1,3,1,0,1
West Coast,"Masten, Chris",21,6,2,15,0,0,0,3
West Coast,"McGovern, Jeremy",22,12,9,10,0,0,0,1
West Coast,"Mitchell, Sam",31,9,3,22,1,0,0,2
West Coast,"Nelson, Jackson",22,12,2,10,0,0,0,3
West Coast,"Petrie, Drew",14,11,4,3,1,0,9,3
West Coast,"Priddis, Matt",26,9,2,17,0,0,0,6
West Coast,"Schofield, Will",15,5,2,10,0,0,0,1
West Coast,"Sheed, Dom",31,11,4,20,0,0,0,3
West Coast,"Sheppard, Brad",17,8,4,9,0,0,0,5
West Coast,"Vardy, Nathan",6,5,0,1,2,0,32,5
West Coast,"Yeo, Elliot",31,15,8,16,0,0,0,4
West Coast,"Butler, Sam",13,8,4,5,0,0,0,1
West Coast,"Cripps, Jamie",9,8,5,1,1,1,0,2
West Coast,"Darling, Jack",8,6,4,2,0,0,0,4
West Coast,"Duggan, Liam",13,7,4,6,0,0,0,3
West Coast,"Gaff, Andrew",24,12,7,12,0,0,0,1
West Coast,"Hill, Josh",13,9,4,4,2,0,0,4
West Coast,"Hurn, Shannon",20,12,4,8,0,0,0,2
West Coast,"Hutchings, Mark",10,4,4,6,0,0,0,3
West Coast,"Jetta, Lewis",19,12,5,7,1,1,0,1
West Coast,"LeCras, Mark",10,9,5,1,0,1,0,0
West Coast,"Mackenzie, Eric",11,4,4,7,0,0,0,1
West Coast,"McGovern, Jeremy",15,9,9,6,1,0,0,2
West Coast,"Mitchell, Sam",33,17,4,16,0,0,0,3
West Coast,"Nelson, Jackson",14,9,5,5,0,1,0,0
West Coast,"Petrie, Drew",12,8,8,4,1,0,21,1
West Coast,"Priddis, Matt",22,10,1,12,0,1,0,5
West Coast,"Schofield, Will",11,8,3,3,1,0,0,1
West Coast,"Sheed, Dom",30,14,8,16,0,2,0,6
West Coast,"Sheppard, Brad",14,10,3,4,0,0,0,4
West Coast,"Shuey, Luke",26,13,5,13,1,0,0,9
West Coast,"Vardy, Nathan",10,6,4,4,0,1,14,1
West Coast,"Yeo, Elliot",22,16,6,6,3,0,0,3
West Coast,"Barrass, Tom",9,8,4,1,0,0,0,1
West Coast,"Cole, Tom",8,8,2,0,0,0,0,5
West Coast,"Cripps, Jamie",9,6,2,3,1,3,0,2
West Coast,"Darling, Jack",14,9,7,5,2,1,0,4
West Coast,"Duggan, Liam",18,13,3,5,1,0,0,5
West Coast,"Gaff, Andrew",32,13,5,19,1,0,0,2
West Coast,"Hurn, Shannon",17,11,5,6,0,0,0,2
West Coast,"Hutchings, Mark",5,2,0,3,0,1,0,4
West Coast,"Jetta, Lewis",20,10,4,10,2,0,0,2
West Coast,"LeCras, Mark",10,5,5,5,0,2,0,5
West Coast,"Mackenzie, Eric",10,7,5,3,0,0,0,0
West Coast,"McGovern, Jeremy",14,9,4,5,0,2,9,6
West Coast,"Mitchell, Sam",29,14,4,15,0,1,0,8
West Coast,"Nelson, Jackson",5,2,0,3,0,0,0,1
West Coast,"Petrie, Drew",11,8,3,3,1,0,0,1
West Coast,"Priddis, Matt",24,10,1,14,0,2,0,12
West Coast,"Schofield, Will",6,3,2,3,1,0,0,2
West Coast,"Sheed, Dom",22,13,6,9,2,0,0,6
West Coast,"Sheppard, Brad",15,6,2,9,0,0,0,4
West Coast,"Shuey, Luke",32,16,3,16,0,0,0,7
West Coast,"Vardy, Nathan",15,5,1,10,0,1,31,7
West Coast,"Yeo, Elliot",22,15,4,7,0,2,0,7
West Coast,"Barrass, Tom",18,11,10,7,0,0,0,0
West Coast,"Cole, Tom",8,4,1,4,0,0,0,1
West Coast,"Cripps, Jamie",13,8,3,5,0,2,0,3
West Coast,"Darling, Jack",14,8,5,6,0,1,0,2
West Coast,"Duggan, Liam",19,11,5,8,0,1,0,1
West Coast,"Gaff, Andrew",27,16,2,11,1,0,0,6
West Coast,"Hill, Josh",8,5,1,3,2,0,0,5
West Coast,"Hurn, Shannon",5,3,0,2,0,0,0,1
West Coast,"Hutchings, Mark",13,11,3,2,2,0,0,7
West Coast,"Jetta, Lewis",22,14,3,8,0,1,0,2
West Coast,"Karpany, Malcolm",15,7,1,8,1,0,0,2
West Coast,"Mackenzie, Eric",16,10,7,6,0,0,0,2
West Coast,"McGovern, Jeremy",15,11,9,4,3,3,0,5
West Coast,"Mitchell, Sam",27,11,0,16,0,0,0,1
West Coast,"Petrie, Drew",19,14,8,5,4,0,8,3
West Coast,"Priddis, Matt",17,6,1,11,0,0,0,9
West Coast,"Schofield, Will",6,3,1,3,0,0,0,4
West Coast,"Sheed, Dom",21,14,3,7,1,1,0,6
West Coast,"Sheppard, Brad",13,4,4,9,0,0,0,2
West Coast,"Shuey, Luke",20,10,2,10,0,1,0,4
West Coast,"Vardy, Nathan",13,6,3,7,0,0,33,6
West Coast,"Yeo, Elliot",22,10,4,12,0,0,0,6
West Coast,"Barrass, Tom",10,7,5,3,0,0,0,2
West Coast,"Butler, Sam",5,2,1,3,0,0,0,0
West Coast,"Cole, Tom",7,3,1,4,0,0,0,1
West Coast,"Cripps, Jamie",12,6,3,6,2,0,0,3
West Coast,"Darling, Jack",18,8,7,10,3,2,0,3
West Coast,"Duggan, Liam",17,8,4,9,0,0,0,2
West Coast,"Gaff, Andrew",42,22,5,20,0,0,0,3
West Coast,"Hutchings, Mark",7,4,1,3,0,0,0,3
West Coast,"Jetta, Lewis",15,9,3,6,0,1,0,3
West Coast,"Karpany, Malcolm",17,11,8,6,3,0,0,2
West Coast,"Mackenzie, Eric",12,7,8,5,0,0,0,3
West Coast,"Masten, Chris",16,9,2,7,0,0,0,0
West Coast,"McGovern, Jeremy",15,11,10,4,1,2,7,1
West Coast,"Mitchell, Sam",25,13,1,12,0,2,0,2
West Coast,"Petrie, Drew",18,11,8,7,1,2,9,5
West Coast,"Redden, Jack",21,9,4,12,0,0,0,8
West Coast,"Sheed, Dom",28,21,3,7,1,2,0,2
West Coast,"Sheppard, Brad",20,10,3,10,0,0,0,2
West Coast,"Shuey, Luke",25,11,1,14,0,0,0,9
West Coast,"Vardy, Nathan",12,6,3,6,1,1,16,2
West Coast,"Wellingham, Sharrod",12,6,1,6,0,0,0,0
West Coast,"Yeo, Elliot",20,12,2,8,0,0,0,5
West Coast,"Barrass, Tom",10,5,5,5,0,0,0,1
West Coast,"Cripps, Jamie",16,7,5,9,1,1,0,4
West Coast,"Darling, Jack",11,8,5,3,4,1,0,1
West Coast,"Duggan, Liam",22,16,5,6,0,1,0,3
West Coast,"Gaff, Andrew",28,15,3,13,0,0,0,2
West Coast,"Hurn, Shannon",14,7,2,7,0,0,0,1
West Coast,"Hutchings, Mark",17,6,3,11,0,1,0,5
West Coast,"Jetta, Lewis",12,9,3,3,2,0,0,3
West Coast,"Karpany, Malcolm",10,5,2,5,0,0,0,3
West Coast,"LeCras, Mark",13,10,4,3,4,0,0,2
West Coast,"Lycett, Scott",12,6,3,6,0,0,18,0
West Coast,"Mackenzie, Eric",4,0,2,4,0,0,0,1
West Coast,"McGovern, Jeremy",12,6,6,6,0,1,0,4
West Coast,"Mitchell, Sam",26,12,3,14,0,0,0,1
West Coast,"Petrie, Drew",10,4,5,6,1,0,1,1
West Coast,"Priddis, Matt",19,7,1,12,0,1,0,6
West Coast,"Sheed, Dom",15,8,0,7,0,1,0,4
West Coast,"Sheppard, Brad",9,6,4,3,0,0,0,1
West Coast,"Shuey, Luke",21,12,3,9,0,0,0,1
West Coast,"Vardy, Nathan",7,3,2,4,1,0,14,3
West Coast,"Wellingham, Sharrod",15,8,3,7,0,1,0,2
West Coast,"Yeo, Elliot",21,16,6,5,0,0,0,2
West Coast,"Barrass, Tom",15,12,8,3,0,0,0,0
West Coast,"Cripps, Jamie",17,13,10,4,0,0,0,5
West Coast,"Darling, Jack",11,7,7,4,2,1,0,1
West Coast,"Duggan, Liam",31,20,11,11,0,0,0,2
West Coast,"Gaff, Andrew",35,20,8,15,0,0,0,0
West Coast,"Hurn, Shannon",34,22,14,12,0,0,0,1
West Coast,"Hutchings, Mark",15,7,5,8,0,0,0,3
West Coast,"Jetta, Lewis",16,9,6,7,0,0,0,2
West Coast,"Kennedy, Josh",10,7,6,3,3,2,0,3
West Coast,"LeCras, Mark",13,9,7,4,2,0,0,2
West Coast,"Masten, Chris",19,13,8,6,0,0,0,1
West Coast,"McGovern, Jeremy",13,8,8,5,1,0,0,0
West Coast,"Mitchell, Sam",26,7,3,19,0,0,0,3
West Coast,"Nelson, Jackson",16,13,5,3,0,0,0,1
West Coast,"Petrie, Drew",14,12,7,2,1,1,11,0
West Coast,"Priddis, Matt",26,8,1,18,1,1,0,6
West Coast,"Redden, Jack",29,16,11,13,0,0,0,4
West Coast,"Schofield, Will",14,9,4,5,0,0,0,2
West Coast,"Sheed, Dom",27,13,5,14,1,1,0,1
West Coast,"Sheppard, Brad",17,10,6,7,0,0,0,3
West Coast,"Shuey, Luke",22,8,3,14,0,0,0,8
West Coast,"Vardy, Nathan",4,1,0,3,0,0,32,2
West Coast,"Barrass, Tom",8,7,3,1,0,0,0,0
West Coast,"Cole, Tom",10,2,3,8,0,0,0,3
West Coast,"Cripps, Jamie",13,9,5,4,2,0,0,5
West Coast,"Darling, Jack",15,10,9,5,2,0,0,2
West Coast,"Duggan, Liam",16,6,7,10,0,0,0,3
West Coast,"Gaff, Andrew",16,8,2,8,0,0,0,2
West Coast,"Hurn, Shannon",29,19,10,10,0,0,0,3
West Coast,"Hutchings, Mark",12,8,4,4,0,0,0,1
West Coast,"Jetta, Lewis",19,15,6,4,0,0,0,2
West Coast,"Kennedy, Josh",11,9,6,2,6,1,0,1
West Coast,"LeCras, Mark",13,11,5,2,0,1,0,0
West Coast,"McGovern, Jeremy",18,13,8,5,0,0,0,3
West Coast,"Nelson, Jackson",14,8,5,6,0,0,0,0
West Coast,"Petrie, Drew",13,6,5,7,0,0,15,3
West Coast,"Priddis, Matt",16,3,0,13,0,0,0,12
West Coast,"Redden, Jack",24,15,6,9,0,0,0,7
West Coast,"Schofield, Will",7,5,4,2,0,0,0,1
West Coast,"Sheed, Dom",26,14,9,12,0,0,0,3
West Coast,"Sheppard, Brad",15,10,9,5,0,0,0,0
West Coast,"Shuey, Luke",26,17,3,9,1,1,0,3
West Coast,"Vardy, Nathan",4,2,1,2,1,0,16,4
West Coast,"Yeo, Elliot",23,15,7,8,1,2,0,3
West Coast,"Barrass, Tom",16,10,8,6,0,0,0,1
West Coast,"Cripps, Jamie",16,9,5,7,0,1,0,3
West Coast,"Darling, Jack",17,13,9,4,2,2,0,2
West Coast,"Duggan, Liam",24,13,3,11,1,0,0,2
West Coast,"Gaff, Andrew",30,22,3,8,0,1,0,0
West Coast,"Hurn, Shannon",16,10,2,6,0,0,0,1
West Coast,"Hutchings, Mark",13,4,5,9,0,0,0,7
West Coast,"Karpany, Malcolm",8,2,2,6,0,0,0,4
West Coast,"Kennedy, Josh",16,14,9,2,6,4,0,1
West Coast,"LeCras, Mark",20,14,3,6,2,0,0,3
West Coast,"Mackenzie, Eric",15,6,7,9,0,0,0,1
West Coast,"McGovern, Jeremy",15,7,6,8,1,1,13,2
West Coast,"Mitchell, Sam",27,15,4,12,1,0,0,3
West Coast,"Nelson, Jackson",11,9,4,2,0,0,0,2
West Coast,"Partington, Luke",16,8,3,8,1,0,0,3
West Coast,"Petrie, Drew",13,8,2,5,0,0,25,8
West Coast,"Redden, Jack",27,12,5,15,0,0,0,6
West Coast,"Schofield, Will",9,3,3,6,0,0,0,1
West Coast,"Sheed, Dom",29,20,6,9,2,1,0,0
West Coast,"Sheppard, Brad",14,7,4,7,0,0,0,6
West Coast,"Shuey, Luke",27,18,4,9,0,0,0,5
West Coast,"Yeo, Elliot",20,12,6,8,1,0,0,2
West Coast,"Cripps, Jamie",8,6,5,2,1,0,0,1
West Coast,"Darling, Jack",16,11,4,5,2,2,2,0
West Coast,"Duggan, Liam",14,10,3,4,0,0,0,3
West Coast,"Gaff, Andrew",30,15,2,15,0,0,0,3
West Coast,"Hurn, Shannon",22,16,8,6,0,0,0,4
West Coast,"Hutchings, Mark",13,8,0,5,0,0,0,1
West Coast,"Karpany, Malcolm",10,4,1,6,1,0,0,0
West Coast,"Kennedy, Josh",14,7,7,7,5,1,0,1
West Coast,"LeCras, Mark",15,10,9,5,3,1,0,2
West Coast,"Mackenzie, Eric",15,6,6,9,0,0,0,1
West Coast,"Masten, Chris",14,7,2,7,0,0,0,1
West Coast,"McGovern, Jeremy",17,10,6,7,1,1,6,1
West Coast,"Mitchell, Sam",23,12,2,11,0,0,0,5
West Coast,"Nelson, Jackson",10,6,4,4,0,0,0,1
West Coast,"Partington, Luke",14,7,1,7,0,3,0,0
West Coast,"Petrie, Drew",13,8,5,5,0,0,15,8
West Coast,"Redden, Jack",22,10,4,12,0,1,0,5
West Coast,"Schofield, Will",3,1,1,2,0,0,0,0
West Coast,"Sheed, Dom",23,14,6,9,1,1,0,1
West Coast,"Sheppard, Brad",9,5,2,4,0,0,0,4
West Coast,"Shuey, Luke",18,5,2,13,0,0,0,3
West Coast,"Yeo, Elliot",17,10,4,7,0,0,0,6
West Coast,"Cripps, Jamie",18,12,3,6,3,1,0,2
West Coast,"Darling, Jack",12,9,4,3,2,2,0,3
West Coast,"Duggan, Liam",16,9,5,7,0,0,0,0
West Coast,"Gaff, Andrew",24,12,4,12,0,0,0,2
West Coast,"Hurn, Shannon",17,8,1,9,0,0,0,3
West Coast,"Hutchings, Mark",8,3,0,5,1,0,0,2
West Coast,"Jetta, Lewis",15,11,3,4,0,0,0,2
West Coast,"Kennedy, Josh",12,10,5,2,6,3,0,1
West Coast,"Mackenzie, Eric",13,6,3,7,0,0,0,2
West Coast,"McGovern, Jeremy",20,14,11,6,0,1,0,0
West Coast,"Mitchell, Sam",24,15,5,9,0,0,0,1
West Coast,"Nelson, Jackson",8,5,3,3,0,0,0,1
West Coast,"Partington, Luke",7,4,2,3,1,1,0,1
West Coast,"Petrie, Drew",8,6,3,2,0,0,9,2
West Coast,"Priddis, Matt",17,5,1,12,0,0,0,10
West Coast,"Redden, Jack",21,12,2,9,2,0,0,6
West Coast,"Sheed, Dom",16,9,4,7,0,0,0,1
West Coast,"Sheppard, Brad",17,8,5,9,0,0,0,1
West Coast,"Shuey, Luke",23,13,1,10,0,0,0,2
West Coast,"Vardy, Nathan",12,5,4,7,0,0,35,1
West Coast,"Wellingham, Sharrod",11,7,3,4,0,1,0,1
West Coast,"Yeo, Elliot",22,13,6,9,0,0,0,1
West Coast,"Barrass, Tom",12,7,4,5,0,0,0,2
West Coast,"Cripps, Jamie",12,9,5,3,1,1,0,7
West Coast,"Darling, Jack",9,6,3,3,0,0,0,2
West Coast,"Duggan, Liam",17,11,4,6,0,0,0,4
West Coast,"Gaff, Andrew",18,9,3,9,0,0,0,2
West Coast,"Hill, Josh",6,4,3,2,0,0,0,2
West Coast,"Hurn, Shannon",18,10,4,8,0,0,0,2
West Coast,"Hutchings, Mark",11,7,3,4,0,0,0,1
West Coast,"Jetta, Lewis",10,5,2,5,0,1,0,3
West Coast,"Kennedy, Josh",9,7,5,2,4,1,0,0
West Coast,"Mackenzie, Eric",12,7,6,5,0,0,0,4
West Coast,"McGovern, Jeremy",16,12,4,4,0,0,0,1
West Coast,"Mitchell, Sam",23,13,4,10,0,0,0,4
West Coast,"Partington, Luke",15,8,2,7,1,1,0,0
West Coast,"Petrie, Drew",9,6,3,3,1,0,16,3
West Coast,"Priddis, Matt",31,10,5,21,2,1,0,7
West Coast,"Redden, Jack",27,16,5,11,0,0,0,4
West Coast,"Sheed, Dom",22,16,6,6,0,1,0,2
West Coast,"Sheppard, Brad",17,8,5,9,0,0,0,2
West Coast,"Shuey, Luke",22,16,6,6,0,0,0,2
West Coast,"Vardy, Nathan",6,2,1,4,0,0,31,1
West Coast,"Yeo, Elliot",30,19,8,11,0,0,0,4
West Coast,"Barrass, Tom",14,7,6,7,0,1,0,1
West Coast,"Cripps, Jamie",15,11,2,4,3,2,0,3
West Coast,"Darling, Jack",13,9,7,4,1,0,1,2
West Coast,"Duggan, Liam",18,11,7,7,0,0,0,1
West Coast,"Gaff, Andrew",32,18,5,14,1,0,0,3
West Coast,"Hurn, Shannon",24,17,11,7,0,0,0,0
West Coast,"Hutchings, Mark",13,7,1,6,2,0,0,1
West Coast,"Jetta, Lewis",16,15,6,1,1,0,0,2
West Coast,"Kennedy, Josh",12,9,4,3,1,4,0,1
West Coast,"LeCras, Mark",15,8,5,7,2,0,0,3
West Coast,"Mackenzie, Eric",9,7,3,2,0,0,0,3
West Coast,"McGovern, Jeremy",17,10,10,7,0,0,0,1
West Coast,"Mitchell, Sam",34,14,7,20,0,0,0,4
West Coast,"Partington, Luke",8,3,4,5,0,0,0,2
West Coast,"Petrie, Drew",10,7,2,3,1,0,10,6
West Coast,"Priddis, Matt",20,9,1,11,0,0,0,8
West Coast,"Redden, Jack",21,13,5,8,1,0,0,3
West Coast,"Sheed, Dom",25,12,5,13,0,1,0,1
West Coast,"Sheppard, Brad",17,7,3,10,0,0,0,5
West Coast,"Shuey, Luke",28,17,5,11,1,0,0,5
West Coast,"Vardy, Nathan",7,5,3,2,1,0,31,3
West Coast,"Yeo, Elliot",24,15,6,9,0,1,0,1
West Coast,"Barrass, Tom",11,8,5,3,0,0,0,1
West Coast,"Cripps, Jamie",17,12,7,5,1,0,0,2
West Coast,"Darling, Jack",11,4,3,7,3,0,0,7
West Coast,"Duggan, Liam",10,8,4,2,0,0,0,3
West Coast,"Gaff, Andrew",34,23,8,11,0,2,0,1
West Coast,"Hurn, Shannon",19,16,8,3,0,0,0,2
West Coast,"Hutchings, Mark",16,9,7,7,0,0,0,3
West Coast,"Jetta, Lewis",17,15,6,2,0,1,0,3
West Coast,"Kennedy, Josh",10,6,2,4,3,0,0,2
West Coast,"LeCras, Mark",9,6,3,3,0,1,0,4
West Coast,"Mackenzie, Eric",15,9,8,6,0,0,0,2
West Coast,"McGovern, Jeremy",25,18,15,7,0,0,0,2
West Coast,"Mitchell, Sam",26,12,5,14,0,0,0,0
West Coast,"Partington, Luke",11,5,3,6,0,0,0,2
West Coast,"Petrie, Drew",15,13,7,2,2,0,18,6
West Coast,"Priddis, Matt",33,17,5,16,1,0,0,10
West Coast,"Redden, Jack",21,10,2,11,0,0,0,6
West Coast,"Sheed, Dom",19,13,6,6,0,1,0,3
West Coast,"Sheppard, Brad",14,11,7,3,0,0,0,2
West Coast,"Shuey, Luke",32,17,5,15,2,0,0,11
West Coast,"Vardy, Nathan",7,6,3,1,0,1,24,4
West Coast,"Yeo, Elliot",20,14,6,6,0,0,0,1
West Coast,"Barrass, Tom",15,12,7,3,0,0,0,1
West Coast,"Cripps, Jamie",10,5,0,5,0,0,0,4
West Coast,"Darling, Jack",12,5,3,7,1,0,0,5
West Coast,"Duggan, Liam",10,3,2,7,0,0,0,2
West Coast,"Gaff, Andrew",25,20,7,5,0,0,0,2
West Coast,"Hurn, Shannon",23,17,10,6,0,0,0,3
West Coast,"Hutchings, Mark",13,8,2,5,0,0,0,2
West Coast,"Jetta, Lewis",7,3,3,4,0,0,0,3
West Coast,"Kennedy, Josh",9,6,2,3,1,1,0,1
West Coast,"LeCras, Mark",16,11,9,5,2,1,0,4
West Coast,"Mackenzie, Eric",14,3,6,11,0,0,0,0
West Coast,"McGovern, Jeremy",15,12,8,3,0,0,0,1
West Coast,"Mitchell, Sam",28,17,5,11,2,0,0,3
West Coast,"Petrie, Drew",7,3,5,4,1,0,18,1
West Coast,"Priddis, Matt",30,11,3,19,0,0,0,7
West Coast,"Redden, Jack",29,17,7,12,0,0,0,2
West Coast,"Sheed, Dom",21,12,6,9,0,0,0,2
West Coast,"Sheppard, Brad",10,8,4,2,0,0,0,1
West Coast,"Shuey, Luke",29,14,3,15,1,0,0,9
West Coast,"Vardy, Nathan",5,2,2,3,1,0,33,5
West Coast,"Wellingham, Sharrod",14,10,5,4,0,0,0,1
West Coast,"Yeo, Elliot",15,12,7,3,0,0,0,1
Western Bulldogs,"Biggs, Shane",17,14,5,3,0,0,0,3
Western Bulldogs,"Bontempelli, Marcus",22,8,3,14,2,0,0,4
Western Bulldogs,"Boyd, Matthew",26,14,2,12,1,1,0,2
Western Bulldogs,"Boyd, Tom",5,1,1,4,0,0,24,2
Western Bulldogs,"Cloke, Travis",14,12,6,2,1,0,1,1
Western Bulldogs,"Cordy, Zaine",14,10,2,4,0,0,0,2
Western Bulldogs,"Crameri, Stewart",17,8,4,9,1,0,0,4
Western Bulldogs,"Dahlhaus, Luke",24,9,4,15,0,1,0,7
Western Bulldogs,"Daniel, Caleb",22,10,1,12,0,0,0,2
Western Bulldogs,"Hunter, Lachie",21,13,6,8,3,0,0,2
Western Bulldogs,"Johannisen, Jason",30,18,7,12,2,0,0,0
Western Bulldogs,"Jong, Lin",11,2,2,9,0,1,0,14
Western Bulldogs,"Liberatore, Tom",16,8,4,8,1,0,0,14
Western Bulldogs,"Macrae, Jack",25,15,7,10,0,0,0,7
Western Bulldogs,"McLean, Toby",13,8,5,5,1,0,0,7
Western Bulldogs,"Morris, Dale",16,6,7,10,0,0,0,1
Western Bulldogs,"Murphy, Robert",22,15,6,7,0,0,0,1
Western Bulldogs,"Picken, Liam",20,12,8,8,2,0,0,4
Western Bulldogs,"Roberts, Fletcher",10,8,2,2,0,0,0,2
Western Bulldogs,"Stringer, Jake",14,11,7,3,1,3,0,4
Western Bulldogs,"Suckling, Matt",19,17,11,2,0,0,0,2
Western Bulldogs,"Wood, Easton",14,9,8,5,0,0,0,2
Western Bulldogs,"Adams, Marcus",20,9,7,11,0,0,0,5
Western Bulldogs,"Biggs, Shane",25,16,3,9,0,0,0,2
Western Bulldogs,"Bontempelli, Marcus",30,17,4,13,2,1,0,7
Western Bulldogs,"Boyd, Matthew",21,13,5,8,0,0,0,0
Western Bulldogs,"Boyd, Tom",7,5,2,2,2,0,15,2
Western Bulldogs,"Campbell, Tom",14,7,1,7,0,1,33,6
Western Bulldogs,"Cloke, Travis",18,11,7,7,3,2,0,1
Western Bulldogs,"Cordy, Zaine",15,10,5,5,0,0,0,1
Western Bulldogs,"Crameri, Stewart",7,4,2,3,0,1,0,7
Western Bulldogs,"Dahlhaus, Luke",25,9,6,16,0,0,0,2
Western Bulldogs,"Daniel, Caleb",18,11,2,7,0,0,0,4
Western Bulldogs,"Hunter, Lachie",25,11,6,14,1,1,0,1
Western Bulldogs,"Johannisen, Jason",23,17,2,6,0,0,0,2
Western Bulldogs,"Jong, Lin",23,8,8,15,1,1,0,7
Western Bulldogs,"Liberatore, Tom",19,5,2,14,0,0,0,16
Western Bulldogs,"Macrae, Jack",20,9,3,11,0,0,0,8
Western Bulldogs,"Murphy, Robert",20,16,6,4,1,1,0,3
Western Bulldogs,"Picken, Liam",21,15,6,6,2,1,0,2
Western Bulldogs,"Roberts, Fletcher",10,7,3,3,0,0,0,3
Western Bulldogs,"Stringer, Jake",15,9,3,6,3,1,0,3
Western Bulldogs,"Suckling, Matt",20,10,3,10,1,0,0,1
Western Bulldogs,"Wood, Easton",16,10,9,6,0,0,0,1
Western Bulldogs,"Adams, Marcus",17,10,6,7,0,0,0,2
Western Bulldogs,"Biggs, Shane",17,14,5,3,0,0,0,0
Western Bulldogs,"Bontempelli, Marcus",24,9,5,15,1,2,1,6
Western Bulldogs,"Boyd, Matthew",21,11,7,10,1,1,0,3
Western Bulldogs,"Boyd, Tom",17,7,5,10,0,1,7,1
Western Bulldogs,"Campbell, Tom",10,6,3,4,0,0,16,4
Western Bulldogs,"Cloke, Travis",10,7,2,3,0,0,0,0
Western Bulldogs,"Cordy, Zaine",10,7,4,3,0,0,0,3
Western Bulldogs,"Dahlhaus, Luke",31,11,1,20,0,0,0,3
Western Bulldogs,"Daniel, Caleb",18,10,2,8,0,0,0,4
Western Bulldogs,"Hunter, Lachie",26,17,6,9,3,1,0,2
Western Bulldogs,"Johannisen, Jason",29,12,2,17,1,0,0,2
Western Bulldogs,"Jong, Lin",24,11,6,13,0,0,0,4
Western Bulldogs,"Liberatore, Tom",28,6,0,22,0,0,0,8
Western Bulldogs,"Macrae, Jack",26,13,6,13,0,1,0,9
Western Bulldogs,"McLean, Toby",13,5,3,8,1,1,0,3
Western Bulldogs,"Murphy, Robert",20,9,7,11,2,1,0,2
Western Bulldogs,"Picken, Liam",11,3,2,8,0,1,0,0
Western Bulldogs,"Roberts, Fletcher",10,5,4,5,0,0,0,1
Western Bulldogs,"Stringer, Jake",18,10,4,8,1,2,0,2
Western Bulldogs,"Suckling, Matt",30,19,6,11,0,1,0,2
Western Bulldogs,"Wood, Easton",12,7,3,5,0,0,0,2
Western Bulldogs,"Adams, Marcus",17,9,7,8,0,0,0,5
Western Bulldogs,"Bontempelli, Marcus",25,15,3,10,1,1,0,6
Western Bulldogs,"Boyd, Matthew",18,11,9,7,0,0,0,0
Western Bulldogs,"Boyd, Tom",1,1,1,0,0,0,2,1
Western Bulldogs,"Campbell, Tom",8,3,0,5,0,0,37,6
Western Bulldogs,"Cloke, Travis",11,9,4,2,1,2,0,2
Western Bulldogs,"Cordy, Zaine",8,5,1,3,0,0,0,3
Western Bulldogs,"Dahlhaus, Luke",32,8,4,24,2,0,0,6
Western Bulldogs,"Dunkley, Josh",12,7,6,5,1,2,0,3
Western Bulldogs,"Hunter, Lachie",19,13,3,6,0,1,0,2
Western Bulldogs,"Johannisen, Jason",19,9,5,10,0,0,0,4
Western Bulldogs,"Jong, Lin",24,6,1,18,0,1,0,1
Western Bulldogs,"Liberatore, Tom",14,4,2,10,1,0,0,9
Western Bulldogs,"Macrae, Jack",23,10,5,13,1,0,0,7
Western Bulldogs,"McLean, Toby",27,10,3,17,0,0,0,0
Western Bulldogs,"Murphy, Robert",24,14,4,10,1,0,0,0
Western Bulldogs,"Picken, Liam",25,13,6,12,0,1,0,4
Western Bulldogs,"Roberts, Fletcher",8,5,4,3,0,0,0,1
Western Bulldogs,"Smith, Clay",8,3,2,5,0,0,0,15
Western Bulldogs,"Stringer, Jake",19,12,4,7,2,3,0,2
Western Bulldogs,"Suckling, Matt",26,17,6,9,2,2,0,3
Western Bulldogs,"Wood, Easton",9,4,3,5,0,0,0,1
Western Bulldogs,"Adams, Marcus",16,12,10,4,1,1,0,2
Western Bulldogs,"Biggs, Shane",18,9,4,9,0,0,0,1
Western Bulldogs,"Bontempelli, Marcus",22,12,6,10,1,1,0,7
Western Bulldogs,"Boyd, Matthew",23,14,5,9,0,0,0,2
Western Bulldogs,"Boyd, Tom",9,3,2,6,1,1,13,2
Western Bulldogs,"Campbell, Tom",9,3,2,6,0,0,26,3
Western Bulldogs,"Cordy, Zaine",13,9,7,4,0,0,0,4
Western Bulldogs,"Dahlhaus, Luke",28,10,8,18,1,1,0,8
Western Bulldogs,"Dunkley, Josh",15,8,4,7,3,0,0,4
Western Bulldogs,"Hunter, Lachie",18,11,2,7,0,1,0,3
Western Bulldogs,"Johannisen, Jason",28,18,2,10,1,0,0,2
Western Bulldogs,"Jong, Lin",20,7,2,13,0,2,0,3
Western Bulldogs,"Liberatore, Tom",20,3,1,17,0,0,0,3
Western Bulldogs,"Macrae, Jack",29,13,3,16,1,0,0,3
Western Bulldogs,"McLean, Toby",24,13,5,11,2,1,0,6
Western Bulldogs,"Murphy, Robert",20,12,6,8,1,1,0,3
Western Bulldogs,"Picken, Liam",26,13,4,13,1,1,0,4
Western Bulldogs,"Roberts, Fletcher",13,8,4,5,0,0,0,0
Western Bulldogs,"Smith, Clay",16,12,4,4,1,1,0,3
Western Bulldogs,"Stringer, Jake",16,12,5,4,3,3,0,2
Western Bulldogs,"Suckling, Matt",22,11,5,11,0,2,0,2
Western Bulldogs,"Wood, Easton",14,10,9,4,0,2,0,2
Western Bulldogs,"Adams, Marcus",12,8,5,4,0,0,0,0
Western Bulldogs,"Bontempelli, Marcus",22,10,2,12,3,0,0,7
Western Bulldogs,"Boyd, Tom",12,6,3,6,0,0,22,3
Western Bulldogs,"Cordy, Zaine",12,7,3,5,0,0,0,3
Western Bulldogs,"Dahlhaus, Luke",27,10,4,17,0,0,0,4
Western Bulldogs,"Dale, Bailey",18,7,4,11,0,1,0,1
Western Bulldogs,"Daniel, Caleb",24,14,8,10,2,1,0,1
Western Bulldogs,"Dunkley, Josh",16,8,3,8,0,4,3,4
Western Bulldogs,"Hunter, Lachie",20,15,7,5,0,0,0,4
Western Bulldogs,"Johannisen, Jason",21,14,0,7,0,1,0,3
Western Bulldogs,"Jong, Lin",16,9,3,7,0,0,0,7
Western Bulldogs,"Liberatore, Tom",11,6,3,5,0,1,0,7
Western Bulldogs,"Macrae, Jack",26,10,1,16,0,1,0,8
Western Bulldogs,"McLean, Toby",22,11,1,11,0,2,0,5
Western Bulldogs,"Murphy, Robert",21,14,3,7,0,0,0,2
Western Bulldogs,"Picken, Liam",15,4,3,11,0,1,0,4
Western Bulldogs,"Roberts, Fletcher",10,7,2,3,0,0,0,0
Western Bulldogs,"Smith, Clay",10,4,2,6,0,1,0,2
Western Bulldogs,"Stringer, Jake",13,8,0,5,3,2,0,2
Western Bulldogs,"Suckling, Matt",22,15,6,7,1,0,0,1
Western Bulldogs,"Williams, Bailey",11,9,3,2,0,0,0,3
Western Bulldogs,"Wood, Easton",11,7,6,4,0,0,0,1
Western Bulldogs,"Adams, Marcus",12,6,6,6,2,2,0,3
Western Bulldogs,"Bontempelli, Marcus",27,12,4,15,1,1,0,9
Western Bulldogs,"Boyd, Matthew",23,11,4,12,0,0,0,0
Western Bulldogs,"Boyd, Tom",19,7,5,12,0,0,25,3
Western Bulldogs,"Cordy, Zaine",13,7,4,6,0,0,0,2
Western Bulldogs,"Dahlhaus, Luke",31,14,5,17,0,1,0,5
Western Bulldogs,"Daniel, Caleb",20,11,4,9,0,1,0,2
Western Bulldogs,"Dunkley, Josh",6,5,2,1,0,0,1,4
Western Bulldogs,"Hunter, Lachie",28,13,8,15,1,0,0,8
Western Bulldogs,"Johannisen, Jason",24,17,3,7,0,2,0,3
Western Bulldogs,"Jong, Lin",21,6,3,15,0,0,0,2
Western Bulldogs,"Liberatore, Tom",22,3,0,19,0,0,0,7
Western Bulldogs,"Macrae, Jack",30,13,1,17,0,1,0,4
Western Bulldogs,"McLean, Toby",20,4,2,16,1,1,0,3
Western Bulldogs,"Murphy, Robert",23,17,9,6,0,0,0,2
Western Bulldogs,"Picken, Liam",18,13,5,5,1,1,0,3
Western Bulldogs,"Roberts, Fletcher",10,6,3,4,0,0,1,1
Western Bulldogs,"Smith, Clay",15,8,4,7,4,0,0,4
Western Bulldogs,"Stringer, Jake",7,5,0,2,1,0,0,0
Western Bulldogs,"Suckling, Matt",20,16,7,4,0,2,0,4
Western Bulldogs,"Williams, Bailey",23,11,4,12,0,1,0,4
Western Bulldogs,"Wood, Easton",16,7,5,9,0,0,0,1
Western Bulldogs,"Adams, Marcus",14,9,6,5,1,4,0,3
Western Bulldogs,"Bontempelli, Marcus",25,12,4,13,0,0,0,10
Western Bulldogs,"Boyd, Matthew",20,10,3,10,0,0,0,2
Western Bulldogs,"Boyd, Tom",9,4,0,5,0,0,34,2
Western Bulldogs,"Cordy, Zaine",14,7,4,7,0,0,3,5
Western Bulldogs,"Dahlhaus, Luke",25,8,5,17,0,0,0,0
Western Bulldogs,"Dale, Bailey",13,6,2,7,0,1,0,3
Western Bulldogs,"Daniel, Caleb",30,13,3,17,0,1,0,4
Western Bulldogs,"Hunter, Lachie",26,12,3,14,0,0,0,4
Western Bulldogs,"Johannisen, Jason",26,22,5,4,0,1,0,0
Western Bulldogs,"Jong, Lin",25,9,2,16,0,0,0,1
Western Bulldogs,"Liberatore, Tom",8,1,1,7,0,0,0,4
Western Bulldogs,"Macrae, Jack",32,8,4,24,0,1,0,4
Western Bulldogs,"McLean, Toby",18,4,3,14,1,0,0,5
Western Bulldogs,"Picken, Liam",25,12,2,13,0,0,0,3
Western Bulldogs,"Redpath, Jack",13,12,10,1,3,1,0,1
Western Bulldogs,"Roberts, Fletcher",10,3,2,7,0,0,0,1
Western Bulldogs,"Smith, Clay",11,4,2,7,0,1,0,5
Western Bulldogs,"Suckling, Matt",21,12,2,9,0,1,0,2
Western Bulldogs,"Webb, Lukas",12,8,4,4,2,1,0,7
Western Bulldogs,"Williams, Bailey",14,8,3,6,0,0,0,3
Western Bulldogs,"Wood, Easton",15,7,5,8,1,0,0,1
Western Bulldogs,"Adams, Marcus",15,8,4,7,0,0,0,5
Western Bulldogs,"Bontempelli, Marcus",19,8,2,11,0,3,0,6
Western Bulldogs,"Boyd, Tom",20,8,4,12,2,1,33,3
Western Bulldogs,"Cloke, Travis",11,7,3,4,1,0,9,4
Western Bulldogs,"Dahlhaus, Luke",23,8,2,15,0,0,0,9
Western Bulldogs,"Dale, Bailey",16,8,2,8,0,0,0,5
Western Bulldogs,"Daniel, Caleb",28,13,5,15,0,0,0,4
Western Bulldogs,"Dickson, Tory",11,7,6,4,2,0,0,7
Western Bulldogs,"Hunter, Lachie",13,6,1,7,0,0,0,3
Western Bulldogs,"Johannisen, Jason",24,15,1,9,0,1,0,7
Western Bulldogs,"Jong, Lin",24,12,0,12,0,0,1,6
Western Bulldogs,"Macrae, Jack",23,7,2,16,0,0,0,5
Western Bulldogs,"Morris, Dale",8,2,2,6,0,0,0,2
Western Bulldogs,"Murphy, Robert",25,14,4,11,0,0,0,3
Western Bulldogs,"Picken, Liam",20,4,4,16,0,0,0,7
Western Bulldogs,"Redpath, Jack",7,6,4,1,2,1,0,1
Western Bulldogs,"Smith, Clay",13,8,2,5,2,0,0,7
Western Bulldogs,"Suckling, Matt",12,7,0,5,0,0,0,5
Western Bulldogs,"Wallis, Mitch",26,8,0,18,2,0,0,6
Western Bulldogs,"Webb, Lukas",12,5,0,7,1,0,0,6
Western Bulldogs,"Williams, Bailey",19,9,2,10,0,1,0,2
Western Bulldogs,"Wood, Easton",20,12,7,8,0,0,0,1
Western Bulldogs,"Adams, Marcus",17,6,7,11,0,0,0,4
Western Bulldogs,"Biggs, Shane",21,10,4,11,0,0,0,3
Western Bulldogs,"Bontempelli, Marcus",22,11,7,11,1,4,0,4
Western Bulldogs,"Boyd, Tom",15,3,2,12,1,0,9,2
Western Bulldogs,"Dahlhaus, Luke",27,9,0,18,0,0,0,3
Western Bulldogs,"Dale, Bailey",27,15,3,12,1,1,0,3
Western Bulldogs,"Daniel, Caleb",22,9,3,13,0,1,0,4
Western Bulldogs,"Dickson, Tory",14,8,5,6,1,0,0,4
Western Bulldogs,"English, Tim",7,1,1,6,0,0,3,3
Western Bulldogs,"Hunter, Lachie",21,11,3,10,0,0,0,2
Western Bulldogs,"Johannisen, Jason",29,16,3,13,1,2,0,1
Western Bulldogs,"Jong, Lin",23,4,3,19,0,0,0,4
Western Bulldogs,"Macrae, Jack",25,12,3,13,0,0,0,4
Western Bulldogs,"Morris, Dale",15,6,5,9,0,0,0,4
Western Bulldogs,"Murphy, Robert",23,13,7,10,1,0,0,2
Western Bulldogs,"Picken, Liam",21,8,3,13,1,0,0,4
Western Bulldogs,"Roughead, Jordan",14,5,2,9,0,1,17,3
Western Bulldogs,"Stringer, Jake",15,11,7,4,5,2,0,1
Western Bulldogs,"Suckling, Matt",17,9,1,8,1,0,0,3
Western Bulldogs,"Wallis, Mitch",28,7,2,21,0,1,0,4
Western Bulldogs,"Williams, Bailey",12,3,0,9,0,0,0,0
Western Bulldogs,"Wood, Easton",20,11,5,9,0,0,0,1
Western Bulldogs,"Adams, Marcus",14,9,7,5,0,0,0,1
Western Bulldogs,"Biggs, Shane",19,12,4,7,0,0,0,3
Western Bulldogs,"Bontempelli, Marcus",18,12,6,6,0,1,1,11
Western Bulldogs,"Boyd, Matthew",22,14,7,8,0,0,0,2
Western Bulldogs,"Cloke, Travis",8,5,3,3,0,0,2,4
Western Bulldogs,"Dahlhaus, Luke",28,12,2,16,1,0,0,5
Western Bulldogs,"Dale, Bailey",11,6,1,5,0,1,0,0
Western Bulldogs,"Daniel, Caleb",28,8,1,20,1,0,0,4
Western Bulldogs,"Dickson, Tory",12,4,2,8,1,1,0,5
Western Bulldogs,"English, Tim",7,0,1,7,0,0,8,3
Western Bulldogs,"Hunter, Lachie",22,9,3,13,0,0,0,1
Western Bulldogs,"Johannisen, Jason",9,5,0,4,0,0,0,1
Western Bulldogs,"Jong, Lin",13,4,1,9,0,0,0,4
Western Bulldogs,"Macrae, Jack",32,9,5,23,0,0,0,4
Western Bulldogs,"McLean, Toby",21,9,2,12,1,0,0,5
Western Bulldogs,"Picken, Liam",23,13,2,10,0,0,0,3
Western Bulldogs,"Roberts, Fletcher",5,2,1,3,0,0,0,3
Western Bulldogs,"Roughead, Jordan",9,5,2,4,0,0,5,5
Western Bulldogs,"Stringer, Jake",11,6,1,5,1,2,0,1
Western Bulldogs,"Suckling, Matt",20,11,6,9,0,0,0,1
Western Bulldogs,"Wallis, Mitch",24,10,3,14,0,0,0,2
Western Bulldogs,"Wood, Easton",15,11,5,4,1,0,0,3
Western Bulldogs,"Biggs, Shane",15,13,4,2,0,0,0,3
Western Bulldogs,"Bontempelli, Marcus",24,11,1,13,1,0,1,7
Western Bulldogs,"Boyd, Tom",11,4,1,7,1,0,36,4
Western Bulldogs,"Cordy, Zaine",22,14,7,8,0,0,0,5
Western Bulldogs,"Dahlhaus, Luke",26,6,0,20,1,1,0,1
Western Bulldogs,"Dale, Bailey",20,11,3,9,0,0,0,3
Western Bulldogs,"Daniel, Caleb",28,9,4,19,1,0,0,2
Western Bulldogs,"Dickson, Tory",11,6,1,5,1,0,0,2
Western Bulldogs,"Honeychurch, Mitch",20,9,3,11,0,3,0,4
Western Bulldogs,"Hunter, Lachie",26,11,5,15,0,0,0,2
Western Bulldogs,"Johannisen, Jason",15,7,3,8,0,0,0,2
Western Bulldogs,"Jong, Lin",3,1,1,2,0,0,0,0
Western Bulldogs,"Liberatore, Tom",29,10,1,19,1,1,0,9
Western Bulldogs,"Macrae, Jack",23,10,2,13,0,0,0,5
Western Bulldogs,"McLean, Toby",14,6,4,8,0,0,0,3
Western Bulldogs,"Morris, Dale",6,3,2,3,0,0,0,2
Western Bulldogs,"Picken, Liam",23,8,3,15,1,0,0,6
Western Bulldogs,"Roughead, Jordan",19,8,3,11,1,0,24,9
Western Bulldogs,"Stringer, Jake",13,7,3,6,0,1,0,1
Western Bulldogs,"Suckling, Matt",25,16,6,9,0,1,0,4
Western Bulldogs,"Wallis, Mitch",23,8,3,15,0,0,0,9
Western Bulldogs,"Wood, Easton",16,11,2,5,0,0,0,2
Western Bulldogs,"Biggs, Shane",19,15,2,4,0,0,0,3
Western Bulldogs,"Bontempelli, Marcus",28,21,3,7,1,0,0,10
Western Bulldogs,"Campbell, Tom",12,8,4,4,1,2,49,6
Western Bulldogs,"Cordy, Zaine",8,2,2,6,0,0,0,5
Western Bulldogs,"Dahlhaus, Luke",26,7,3,19,1,0,0,4
Western Bulldogs,"Dale, Bailey",18,12,4,6,2,0,0,2
Western Bulldogs,"Daniel, Caleb",16,8,2,8,0,0,0,5
Western Bulldogs,"Dickson, Tory",6,2,2,4,0,0,0,1
Western Bulldogs,"Honeychurch, Mitch",16,12,5,4,0,3,0,3
Western Bulldogs,"Hunter, Lachie",22,18,9,4,1,1,0,3
Western Bulldogs,"Johannisen, Jason",19,11,1,8,0,0,0,3
Western Bulldogs,"Liberatore, Tom",13,6,2,7,0,0,0,4
Western Bulldogs,"Macrae, Jack",32,14,7,18,0,0,0,10
Western Bulldogs,"McLean, Toby",26,11,3,15,0,1,0,7
Western Bulldogs,"Morris, Dale",8,4,1,4,0,0,0,3
Western Bulldogs,"Picken, Liam",17,7,4,10,3,1,0,0
Western Bulldogs,"Redpath, Jack",9,9,7,0,2,1,0,1
Western Bulldogs,"Roughead, Jordan",7,1,1,6,0,0,0,3
Western Bulldogs,"Stringer, Jake",18,13,6,5,1,4,0,4
Western Bulldogs,"Suckling, Matt",21,15,6,6,1,1,0,0
Western Bulldogs,"Wallis, Mitch",19,11,6,8,1,0,0,3
Western Bulldogs,"Wood, Easton",21,12,7,9,1,0,0,3
Western Bulldogs,"Biggs, Shane",24,13,6,11,0,0,0,1
Western Bulldogs,"Bontempelli, Marcus",24,16,5,8,0,2,0,5
Western Bulldogs,"Campbell, Tom",9,3,3,6,0,1,47,5
Western Bulldogs,"Cordy, Zaine",17,12,7,5,0,0,0,3
Western Bulldogs,"Dahlhaus, Luke",21,10,2,11,0,1,0,7
Western Bulldogs,"Dale, Bailey",17,13,3,4,1,1,0,4
Western Bulldogs,"Daniel, Caleb",22,11,1,11,0,1,0,4
Western Bulldogs,"Dickson, Tory",10,4,4,6,1,0,0,0
Western Bulldogs,"Honeychurch, Mitch",10,4,0,6,0,0,0,10
Western Bulldogs,"Hunter, Lachie",26,16,1,10,2,0,0,5
Western Bulldogs,"Johannisen, Jason",12,7,3,5,0,0,0,2
Western Bulldogs,"Macrae, Jack",24,10,3,14,0,0,0,8
Western Bulldogs,"McLean, Toby",21,8,2,13,1,0,0,6
Western Bulldogs,"Morris, Dale",12,6,3,6,0,0,0,3
Western Bulldogs,"Murphy, Robert",19,16,7,3,0,1,0,5
Western Bulldogs,"Picken, Liam",16,6,2,10,0,0,0,2
Western Bulldogs,"Redpath, Jack",17,14,9,3,2,1,3,2
Western Bulldogs,"Roughead, Jordan",6,4,1,2,1,0,4,1
Western Bulldogs,"Stringer, Jake",9,4,1,5,1,0,0,1
Western Bulldogs,"Suckling, Matt",15,11,4,4,0,0,0,1
Western Bulldogs,"Wallis, Mitch",13,8,3,5,2,1,0,1
Western Bulldogs,"Wood, Easton",21,8,8,13,0,0,0,4
Western Bulldogs,"Bontempelli, Marcus",24,15,1,9,0,2,0,6
Western Bulldogs,"Boyd, Matthew",23,14,3,9,0,0,0,4
Western Bulldogs,"Cordy, Zaine",16,10,6,6,0,0,0,2
Western Bulldogs,"Dahlhaus, Luke",18,8,5,10,1,0,0,5
Western Bulldogs,"Dale, Bailey",15,13,2,2,1,0,0,3
Western Bulldogs,"Daniel, Caleb",11,6,0,5,0,0,0,2
Western Bulldogs,"Honeychurch, Mitch",10,3,2,7,0,0,0,7
Western Bulldogs,"Hunter, Lachie",27,21,4,6,0,1,0,3
Western Bulldogs,"Johannisen, Jason",16,10,1,6,0,0,0,2
Western Bulldogs,"Liberatore, Tom",15,7,1,8,0,0,0,6
Western Bulldogs,"Macrae, Jack",27,11,4,16,0,0,0,7
Western Bulldogs,"McLean, Toby",32,15,4,17,0,0,0,8
Western Bulldogs,"Morris, Dale",11,1,0,10,0,0,0,2
Western Bulldogs,"Picken, Liam",14,9,1,5,0,1,0,2
Western Bulldogs,"Redpath, Jack",12,8,5,4,1,3,1,3
Western Bulldogs,"Roberts, Fletcher",9,4,2,5,0,0,0,1
Western Bulldogs,"Roughead, Jordan",16,12,3,4,0,0,22,2
Western Bulldogs,"Smith, Clay",8,5,3,3,0,1,0,3
Western Bulldogs,"Stringer, Jake",11,7,1,4,1,1,0,4
Western Bulldogs,"Suckling, Matt",23,17,4,6,1,2,0,1
Western Bulldogs,"Wallis, Mitch",18,6,3,12,0,1,0,2
Western Bulldogs,"Wood, Easton",10,8,5,2,0,0,0,0
Western Bulldogs,"Biggs, Shane",22,13,4,9,0,0,0,1
Western Bulldogs,"Bontempelli, Marcus",30,19,6,11,2,1,0,4
Western Bulldogs,"Cordy, Zaine",14,8,5,6,0,0,0,4
Western Bulldogs,"Dahlhaus, Luke",29,10,3,19,0,0,0,4
Western Bulldogs,"Dale, Bailey",27,18,5,9,2,1,0,1
Western Bulldogs,"Daniel, Caleb",25,18,2,7,0,0,0,0
Western Bulldogs,"Honeychurch, Mitch",17,6,4,11,1,2,0,4
Western Bulldogs,"Hunter, Lachie",12,9,7,3,1,1,0,5
Western Bulldogs,"Johannisen, Jason",23,13,2,10,1,1,0,1
Western Bulldogs,"Liberatore, Tom",18,4,5,14,0,0,0,7
Western Bulldogs,"Macrae, Jack",31,14,8,17,0,0,0,6
Western Bulldogs,"McLean, Toby",26,12,4,14,2,1,0,5
Western Bulldogs,"Morris, Dale",11,3,5,8,0,0,0,1
Western Bulldogs,"Murphy, Robert",20,6,2,14,0,0,0,0
Western Bulldogs,"Picken, Liam",18,9,6,9,1,1,0,2
Western Bulldogs,"Redpath, Jack",6,3,2,3,0,0,1,1
Western Bulldogs,"Roughead, Jordan",7,3,4,4,0,0,18,7
Western Bulldogs,"Stringer, Jake",7,2,1,5,1,0,0,1
Western Bulldogs,"Suckling, Matt",25,19,3,6,0,0,0,3
Western Bulldogs,"Wallis, Mitch",25,7,3,18,1,0,0,3
Western Bulldogs,"Williams, Bailey",14,7,7,7,0,0,0,1
Western Bulldogs,"Young, Lewis",21,10,9,11,0,0,0,0
Western Bulldogs,"Biggs, Shane",27,18,10,9,0,0,0,2
Western Bulldogs,"Bontempelli, Marcus",20,13,3,7,0,0,0,7
Western Bulldogs,"Cordy, Zaine",9,8,3,1,0,0,0,2
Western Bulldogs,"Dahlhaus, Luke",23,12,7,11,2,0,0,4
Western Bulldogs,"Dale, Bailey",17,9,4,8,3,0,0,1
Western Bulldogs,"Daniel, Caleb",19,15,6,4,0,0,0,3
Western Bulldogs,"Honeychurch, Mitch",14,9,5,5,0,0,0,6
Western Bulldogs,"Hunter, Lachie",31,24,10,7,0,0,0,1
Western Bulldogs,"Johannisen, Jason",22,8,4,14,0,0,0,1
Western Bulldogs,"Liberatore, Tom",13,5,0,8,1,0,0,4
Western Bulldogs,"Macrae, Jack",25,13,4,12,0,0,0,4
Western Bulldogs,"McLean, Toby",27,10,3,17,0,1,0,5
Western Bulldogs,"Morris, Dale",5,2,2,3,0,0,0,1
Western Bulldogs,"Murphy, Robert",17,11,4,6,1,1,0,0
Western Bulldogs,"Picken, Liam",15,14,8,1,6,2,0,1
Western Bulldogs,"Redpath, Jack",18,13,11,5,1,1,1,1
Western Bulldogs,"Roughead, Jordan",7,4,3,3,1,0,26,5
Western Bulldogs,"Suckling, Matt",23,11,7,12,0,1,0,0
Western Bulldogs,"Wallis, Mitch",26,5,3,21,1,1,0,4
Western Bulldogs,"Williams, Bailey",19,12,6,7,0,1,0,2
Western Bulldogs,"Wood, Easton",15,10,6,5,0,2,0,2
Western Bulldogs,"Young, Lewis",16,6,10,10,0,0,0,3
Western Bulldogs,"Biggs, Shane",29,22,11,7,0,0,0,0
Western Bulldogs,"Bontempelli, Marcus",23,17,7,6,2,3,0,1
Western Bulldogs,"Cloke, Travis",10,7,5,3,1,1,3,1
Western Bulldogs,"Cordy, Zaine",10,5,5,5,0,0,0,0
Western Bulldogs,"Dahlhaus, Luke",23,10,5,13,0,0,0,4
Western Bulldogs,"Dale, Bailey",15,9,4,6,0,0,0,1
Western Bulldogs,"Daniel, Caleb",19,12,6,7,1,0,0,2
Western Bulldogs,"Dickson, Tory",9,6,6,3,3,1,0,0
Western Bulldogs,"Hunter, Lachie",25,18,9,7,1,1,0,0
Western Bulldogs,"Johannisen, Jason",18,12,4,6,4,0,0,1
Western Bulldogs,"Liberatore, Tom",14,9,4,5,1,1,0,3
Western Bulldogs,"Macrae, Jack",25,12,7,13,0,0,0,4
Western Bulldogs,"McLean, Toby",19,9,1,10,1,1,0,2
Western Bulldogs,"Murphy, Robert",19,11,3,8,1,1,0,1
Western Bulldogs,"Picken, Liam",17,9,3,8,0,1,0,5
Western Bulldogs,"Roughead, Jordan",19,10,5,9,1,1,22,2
Western Bulldogs,"Suckling, Matt",19,11,6,8,1,0,0,1
Western Bulldogs,"Wallis, Mitch",18,6,4,12,0,0,0,3
Western Bulldogs,"Webb, Lukas",12,7,1,5,2,1,0,1
Western Bulldogs,"Williams, Bailey",16,14,4,2,0,0,0,3
Western Bulldogs,"Wood, Easton",7,5,3,2,0,0,0,2
Western Bulldogs,"Young, Lewis",8,6,4,2,0,0,0,1
Western Bulldogs,"Biggs, Shane",23,17,5,6,0,0,0,4
Western Bulldogs,"Bontempelli, Marcus",23,17,7,6,2,4,0,5
Western Bulldogs,"Cloke, Travis",17,11,7,6,1,1,8,2
Western Bulldogs,"Cordy, Zaine",11,7,1,4,0,0,0,0
Western Bulldogs,"Dahlhaus, Luke",19,11,2,8,2,0,0,2
Western Bulldogs,"Dale, Bailey",18,13,4,5,0,0,0,1
Western Bulldogs,"Daniel, Caleb",22,9,2,13,0,0,0,6
Western Bulldogs,"Hunter, Lachie",29,16,7,13,1,0,0,2
Western Bulldogs,"Liberatore, Tom",19,4,3,15,0,1,0,3
Western Bulldogs,"Macrae, Jack",32,17,11,15,0,1,0,4
Western Bulldogs,"McLean, Toby",28,13,6,15,1,1,0,2
Western Bulldogs,"Murphy, Robert",17,11,6,6,0,0,0,3
Western Bulldogs,"Picken, Liam",17,6,2,11,3,0,0,1
Western Bulldogs,"Redpath, Jack",12,11,9,1,3,4,0,0
Western Bulldogs,"Roughead, Jordan",12,7,1,5,0,0,23,1
Western Bulldogs,"Smith, Clay",11,8,5,3,1,1,0,2
Western Bulldogs,"Suckling, Matt",18,12,4,6,0,1,0,1
Western Bulldogs,"Wallis, Mitch",19,9,7,10,0,1,0,4
Western Bulldogs,"Webb, Lukas",6,3,1,3,0,0,0,3
Western Bulldogs,"Williams, Bailey",20,12,5,8,0,1,0,2
Western Bulldogs,"Wood, Easton",2,1,0,1,0,0,0,0
Western Bulldogs,"Young, Lewis",16,10,4,6,0,0,0,4
Western Bulldogs,"Biggs, Shane",20,11,3,9,0,0,0,3
Western Bulldogs,"Bontempelli, Marcus",20,11,2,9,0,2,0,7
Western Bulldogs,"Cloke, Travis",12,7,3,5,1,2,7,4
Western Bulldogs,"Cordy, Zaine",11,8,6,3,0,0,0,2
Western Bulldogs,"Dahlhaus, Luke",17,4,2,13,1,0,0,3
Western Bulldogs,"Dale, Bailey",16,9,4,7,1,0,0,1
Western Bulldogs,"Daniel, Caleb",18,6,2,12,0,0,0,1
Western Bulldogs,"Dickson, Tory",12,6,7,6,2,1,0,3
Western Bulldogs,"Dunkley, Josh",9,5,3,4,0,1,0,8
Western Bulldogs,"Hunter, Lachie",26,18,7,8,0,0,0,2
Western Bulldogs,"Liberatore, Tom",10,3,0,7,0,0,0,4
Western Bulldogs,"Macrae, Jack",21,10,5,11,0,0,0,2
Western Bulldogs,"McLean, Toby",23,14,3,9,0,1,0,2
Western Bulldogs,"Murphy, Robert",18,11,4,7,1,0,0,4
Western Bulldogs,"Picken, Liam",13,3,3,10,0,0,0,2
Western Bulldogs,"Redpath, Jack",6,5,4,1,1,1,0,1
Western Bulldogs,"Roughead, Jordan",12,6,2,6,0,0,25,3
Western Bulldogs,"Stringer, Jake",11,7,5,4,0,2,0,0
Western Bulldogs,"Suckling, Matt",21,15,6,6,0,1,0,1
Western Bulldogs,"Wallis, Mitch",9,1,0,8,0,0,0,2
Western Bulldogs,"Williams, Bailey",15,8,7,7,0,1,0,1
Western Bulldogs,"Young, Lewis",11,9,5,2,0,0,0,2
Western Bulldogs,"Biggs, Shane",23,12,3,11,0,0,0,1
Western Bulldogs,"Bontempelli, Marcus",12,7,2,5,0,1,0,5
Western Bulldogs,"Cloke, Travis",10,6,1,4,2,1,1,3
Western Bulldogs,"Cordy, Zaine",11,6,3,5,0,0,0,3
Western Bulldogs,"Dahlhaus, Luke",29,6,1,23,0,0,0,6
Western Bulldogs,"Dale, Bailey",14,8,3,6,4,1,0,0
Western Bulldogs,"Daniel, Caleb",27,12,3,15,0,0,0,3
Western Bulldogs,"Dickson, Tory",7,1,0,6,0,0,0,5
Western Bulldogs,"Dunkley, Josh",12,6,3,6,1,0,0,1
Western Bulldogs,"Hunter, Lachie",19,10,6,9,2,0,0,0
Western Bulldogs,"Johannisen, Jason",27,18,6,9,0,4,0,3
Western Bulldogs,"Liberatore, Tom",18,7,2,11,1,0,0,7
Western Bulldogs,"Macrae, Jack",41,18,6,23,0,0,0,7
Western Bulldogs,"McLean, Toby",26,7,2,19,0,0,0,6
Western Bulldogs,"Morris, Dale",9,4,3,5,0,0,0,4
Western Bulldogs,"Murphy, Robert",13,8,2,5,0,1,0,4
Western Bulldogs,"Picken, Liam",19,8,3,11,0,0,0,4
Western Bulldogs,"Roughead, Jordan",14,7,0,7,0,0,31,6
Western Bulldogs,"Stringer, Jake",1,0,0,1,0,0,0,1
Western Bulldogs,"Suckling, Matt",22,14,3,8,1,0,0,2
Western Bulldogs,"Williams, Bailey",19,11,3,8,0,0,0,3
Western Bulldogs,"Young, Lewis",10,4,4,6,0,0,0,1
Western Bulldogs,"Biggs, Shane",16,8,5,8,0,0,0,0
Western Bulldogs,"Bontempelli, Marcus",21,12,5,9,0,0,0,4
Western Bulldogs,"Boyd, Matthew",33,21,12,12,1,0,0,1
Western Bulldogs,"Campbell, Tom",3,1,2,2,1,0,25,3
Western Bulldogs,"Cordy, Zaine",13,7,7,6,0,0,0,0
Western Bulldogs,"Dahlhaus, Luke",19,7,3,12,1,1,0,1
Western Bulldogs,"Dale, Bailey",14,7,3,7,2,0,0,2
Western Bulldogs,"Daniel, Caleb",17,5,2,12,0,0,0,0
Western Bulldogs,"Dunkley, Josh",16,8,4,8,0,0,0,5
Western Bulldogs,"Hunter, Lachie",15,10,3,5,2,1,0,1
Western Bulldogs,"Johannisen, Jason",15,9,4,6,0,0,0,1
Western Bulldogs,"Liberatore, Tom",23,10,5,13,1,0,0,2
Western Bulldogs,"Lipinski, Patrick",18,6,4,12,0,3,0,1
Western Bulldogs,"Macrae, Jack",33,12,3,21,0,0,0,7
Western Bulldogs,"McLean, Toby",26,10,4,16,1,1,0,6
Western Bulldogs,"Morris, Dale",11,1,4,10,0,0,0,1
Western Bulldogs,"Murphy, Robert",15,10,4,5,1,0,0,1
Western Bulldogs,"Picken, Liam",16,8,4,8,3,2,0,4
Western Bulldogs,"Roughead, Jordan",10,5,3,5,0,0,29,0
Western Bulldogs,"Suckling, Matt",17,13,4,4,0,0,0,1
Western Bulldogs,"Williams, Bailey",14,7,3,7,0,1,0,4
Western Bulldogs,"Young, Lewis",8,3,2,5,0,0,0,1
Adelaide,"Atkins, Rory",18,9,3,9,0,0,0,2
Adelaide,"Betts, Eddie",15,11,3,4,1,3,0,8
Adelaide,"Brown, Luke",13,9,4,4,0,0,0,2
Adelaide,"Cheney, Kyle",11,5,1,6,0,0,0,2
Adelaide,"Crouch, Brad",20,12,2,8,0,0,0,9
Adelaide,"Crouch, Matt",23,14,3,9,1,0,0,2
Adelaide,"Douglas, Richard",20,14,2,6,1,0,0,3
Adelaide,"Jacobs, Sam",10,4,3,6,1,0,35,1
Adelaide,"Jenkins, Josh",10,8,5,2,5,0,5,1
Adelaide,"Laird, Rory",24,14,9,10,0,0,0,1
Adelaide,"Lever, Jake",11,7,2,4,0,0,0,0
Adelaide,"Lynch, Tom",11,10,4,1,1,0,0,2
Adelaide,"Mackay, David",13,8,2,5,1,0,0,4
Adelaide,"McGovern, Mitch",9,7,5,2,0,3,0,3
Adelaide,"Milera, Wayne",7,4,2,3,0,1,0,2
Adelaide,"Seedsman, Paul",11,6,3,5,1,0,0,4
Adelaide,"Sloane, Rory",19,5,1,14,0,1,4,7
Adelaide,"Smith, Brodie",24,16,5,8,0,0,0,1
Adelaide,"Talia, Daniel",16,7,3,9,0,0,0,3
Adelaide,"Thompson, Scott",30,15,3,15,0,1,0,2
Adelaide,"Walker, Taylor",18,13,10,5,2,3,0,1
Adelaide,"van Berlo, Nathan",9,5,0,4,0,0,0,3
Adelaide,"Atkins, Rory",13,8,4,5,0,0,0,1
Adelaide,"Betts, Eddie",17,12,6,5,5,1,0,1
Adelaide,"Brown, Luke",26,20,7,6,0,0,0,6
Adelaide,"Cheney, Kyle",13,10,5,3,0,0,0,3
Adelaide,"Crouch, Brad",23,14,0,9,1,0,0,3
Adelaide,"Crouch, Matt",24,11,1,13,0,0,0,5
Adelaide,"Douglas, Richard",14,6,2,8,0,1,0,2
Adelaide,"Hartigan, Kyle",13,5,5,8,0,0,0,5
Adelaide,"Jacobs, Sam",15,5,2,10,0,0,41,1
Adelaide,"Jenkins, Josh",13,10,7,3,4,2,5,2
Adelaide,"Laird, Rory",33,15,12,18,1,0,0,3
Adelaide,"Lever, Jake",19,13,10,6,0,0,0,0
Adelaide,"Lynch, Tom",21,15,8,6,6,1,0,4
Adelaide,"Mackay, David",25,15,4,10,0,0,0,2
Adelaide,"McGovern, Mitch",12,6,5,6,2,2,0,1
Adelaide,"Milera, Wayne",20,10,9,10,1,0,0,1
Adelaide,"Seedsman, Paul",19,8,6,11,0,0,0,5
Adelaide,"Sloane, Rory",21,8,4,13,0,0,2,3
Adelaide,"Smith, Brodie",21,17,3,4,0,0,0,3
Adelaide,"Talia, Daniel",10,7,3,3,0,0,0,2
Adelaide,"Thompson, Scott",29,12,3,17,0,0,1,10
Adelaide,"Walker, Taylor",11,7,3,4,2,2,0,1
Adelaide,"Atkins, Rory",9,2,1,7,0,0,0,3
Adelaide,"Betts, Eddie",12,6,4,6,3,1,0,4
Adelaide,"Brown, Luke",16,10,5,6,0,1,0,2
Adelaide,"Cheney, Kyle",18,8,6,10,0,0,0,2
Adelaide,"Crouch, Matt",28,8,3,20,0,0,0,4
Adelaide,"Douglas, Richard",18,11,2,7,3,0,0,4
Adelaide,"Hartigan, Kyle",10,8,4,2,0,0,0,3
Adelaide,"Jacobs, Sam",17,8,2,9,0,0,28,2
Adelaide,"Jenkins, Josh",11,4,5,7,1,1,7,2
Adelaide,"Knight, Riley",10,2,2,8,0,0,0,1
Adelaide,"Laird, Rory",25,12,3,13,0,0,0,2
Adelaide,"Lever, Jake",15,11,7,4,0,1,0,0
Adelaide,"Lyons, Jarryd",21,10,4,11,2,0,0,1
Adelaide,"Mackay, David",15,10,4,5,0,2,0,2
Adelaide,"McGovern, Mitch",10,7,3,3,1,1,0,5
Adelaide,"Milera, Wayne",12,8,1,4,0,1,0,1
Adelaide,"Seedsman, Paul",18,8,6,10,0,0,0,3
Adelaide,"Sloane, Rory",21,8,4,13,2,1,3,3
Adelaide,"Smith, Brodie",26,14,4,12,2,0,0,2
Adelaide,"Talia, Daniel",17,11,8,6,0,0,0,0
Adelaide,"Thompson, Scott",28,18,5,10,2,0,0,7
Adelaide,"Walker, Taylor",11,8,5,3,3,2,0,0
Adelaide,"Atkins, Rory",25,15,6,10,1,0,0,2
Adelaide,"Betts, Eddie",19,12,2,7,4,1,0,5
Adelaide,"Brown, Luke",10,4,2,6,0,0,0,1
Adelaide,"Cheney, Kyle",11,7,2,4,0,0,0,0
Adelaide,"Crouch, Matt",27,8,2,19,0,0,0,5
Adelaide,"Douglas, Richard",24,18,3,6,1,2,0,7
Adelaide,"Hartigan, Kyle",13,7,4,6,0,0,0,0
Adelaide,"Jacobs, Sam",16,6,1,10,0,0,35,2
Adelaide,"Jenkins, Josh",16,10,4,6,1,3,9,3
Adelaide,"Laird, Rory",27,12,5,15,0,0,0,2
Adelaide,"Lever, Jake",7,7,2,0,0,0,0,1
Adelaide,"Lynch, Tom",21,16,6,5,3,2,0,1
Adelaide,"Lyons, Jarryd",15,10,1,5,0,0,0,8
Adelaide,"Mackay, David",15,9,1,6,0,0,0,8
Adelaide,"McGovern, Mitch",11,8,4,3,2,0,0,3
Adelaide,"Milera, Wayne",9,1,1,8,0,1,0,1
Adelaide,"Seedsman, Paul",12,9,1,3,2,0,0,5
Adelaide,"Sloane, Rory",24,14,4,10,0,0,3,10
Adelaide,"Smith, Brodie",18,13,3,5,0,0,0,3
Adelaide,"Talia, Daniel",9,5,3,4,0,0,0,0
Adelaide,"Thompson, Scott",27,9,3,18,0,0,0,10
Adelaide,"Walker, Taylor",16,11,9,5,2,2,0,3
Adelaide,"Atkins, Rory",27,11,6,16,0,0,0,1
Adelaide,"Betts, Eddie",10,9,3,1,3,0,0,1
Adelaide,"Brown, Luke",15,7,3,8,1,0,0,4
Adelaide,"Cameron, Charlie",12,8,1,4,1,0,0,5
Adelaide,"Cheney, Kyle",15,7,5,8,0,0,0,0
Adelaide,"Crouch, Matt",25,8,3,17,0,0,0,4
Adelaide,"Douglas, Richard",21,9,2,12,0,0,0,7
Adelaide,"Hartigan, Kyle",9,4,3,5,0,0,0,1
Adelaide,"Jacobs, Sam",17,6,3,11,0,1,40,1
Adelaide,"Jenkins, Josh",7,6,4,1,2,0,1,4
Adelaide,"Laird, Rory",21,12,4,9,0,0,0,6
Adelaide,"Lever, Jake",17,11,5,6,0,0,0,1
Adelaide,"Lynch, Tom",21,11,5,10,2,1,0,0
Adelaide,"Lyons, Jarryd",18,6,1,12,2,0,1,4
Adelaide,"Mackay, David",23,10,2,13,0,0,0,10
Adelaide,"McGovern, Mitch",12,6,3,6,2,0,0,3
Adelaide,"Seedsman, Paul",23,11,3,12,1,1,0,6
Adelaide,"Sloane, Rory",26,8,3,18,1,0,0,7
Adelaide,"Smith, Brodie",28,13,0,15,0,1,0,4
Adelaide,"Talia, Daniel",15,7,3,8,0,0,0,1
Adelaide,"Thompson, Scott",33,13,6,20,0,0,1,7
Adelaide,"Walker, Taylor",10,7,3,3,2,2,0,0
Adelaide,"Atkins, Rory",21,14,5,7,1,0,0,2
Adelaide,"Betts, Eddie",17,13,4,4,4,3,0,4
Adelaide,"Brown, Luke",27,16,6,11,0,0,0,4
Adelaide,"Cameron, Charlie",16,10,4,6,0,3,0,4
Adelaide,"Cheney, Kyle",11,4,4,7,0,0,0,1
Adelaide,"Crouch, Matt",27,8,2,19,0,0,0,2
Adelaide,"Douglas, Richard",21,6,5,15,1,1,0,3
Adelaide,"Hartigan, Kyle",18,10,8,8,0,0,0,5
Adelaide,"Jacobs, Sam",21,8,6,13,0,0,30,2
Adelaide,"Jenkins, Josh",11,5,4,6,2,1,5,3
Adelaide,"Laird, Rory",24,13,5,11,0,0,0,1
Adelaide,"Lever, Jake",19,7,2,12,0,0,0,2
Adelaide,"Lynch, Tom",19,11,7,8,2,0,0,1
Adelaide,"Lyons, Jarryd",19,9,2,10,1,0,1,4
Adelaide,"Mackay, David",22,13,2,9,0,2,0,5
Adelaide,"McGovern, Mitch",10,4,4,6,1,1,0,3
Adelaide,"Seedsman, Paul",19,14,9,5,0,0,0,2
Adelaide,"Sloane, Rory",31,14,7,17,1,1,2,8
Adelaide,"Smith, Brodie",21,13,9,8,1,1,0,1
Adelaide,"Talia, Daniel",16,11,8,5,0,0,0,0
Adelaide,"Thompson, Scott",30,13,2,17,0,0,0,3
Adelaide,"Walker, Taylor",10,6,6,4,0,0,0,1
Adelaide,"Atkins, Rory",16,8,3,8,1,1,0,0
Adelaide,"Betts, Eddie",12,4,2,8,0,1,0,3
Adelaide,"Brown, Luke",19,12,3,7,0,0,0,1
Adelaide,"Cameron, Charlie",12,7,1,5,2,0,0,9
Adelaide,"Cheney, Kyle",14,10,8,4,0,0,0,0
Adelaide,"Crouch, Brad",14,6,2,8,0,0,0,4
Adelaide,"Crouch, Matt",24,13,3,11,0,0,0,4
Adelaide,"Douglas, Richard",9,8,3,1,0,1,0,4
Adelaide,"Hartigan, Kyle",15,6,3,9,0,0,0,3
Adelaide,"Henderson, Ricky",21,10,6,11,0,0,0,0
Adelaide,"Jacobs, Sam",14,6,3,8,1,0,27,3
Adelaide,"Jenkins, Josh",13,9,7,4,8,0,3,1
Adelaide,"Lever, Jake",16,8,3,8,0,0,0,1
Adelaide,"Lynch, Tom",24,13,4,11,3,1,0,1
Adelaide,"Mackay, David",11,5,1,6,0,0,0,3
Adelaide,"McGovern, Mitch",8,5,3,3,0,1,0,2
Adelaide,"Seedsman, Paul",17,10,5,7,0,0,0,2
Adelaide,"Sloane, Rory",19,10,4,9,1,0,0,4
Adelaide,"Smith, Brodie",20,12,2,8,0,0,0,0
Adelaide,"Talia, Daniel",16,9,6,7,0,0,0,1
Adelaide,"Thompson, Scott",16,7,2,9,0,0,0,9
Adelaide,"Walker, Taylor",12,9,4,3,1,0,0,1
Adelaide,"Atkins, Rory",22,13,4,9,1,0,0,0
Adelaide,"Betts, Eddie",15,7,2,8,2,2,0,5
Adelaide,"Brown, Luke",16,12,3,4,0,0,0,7
Adelaide,"Cameron, Charlie",18,13,5,5,1,0,0,4
Adelaide,"Cheney, Kyle",10,9,7,1,0,0,0,2
Adelaide,"Crouch, Brad",14,7,2,7,0,0,0,7
Adelaide,"Crouch, Matt",16,8,3,8,0,0,0,3
Adelaide,"Douglas, Richard",8,5,0,3,0,0,0,5
Adelaide,"Hartigan, Kyle",14,11,8,3,0,0,0,2
Adelaide,"Henderson, Ricky",25,20,11,5,0,1,0,2
Adelaide,"Jacobs, Sam",20,14,4,6,0,0,37,1
Adelaide,"Jenkins, Josh",10,9,3,1,2,0,4,2
Adelaide,"Lever, Jake",14,11,6,3,0,0,0,3
Adelaide,"Lynch, Tom",19,15,4,4,0,0,0,2
Adelaide,"McGovern, Mitch",11,6,3,5,2,0,0,3
Adelaide,"Milera, Wayne",9,6,2,3,0,1,0,2
Adelaide,"Seedsman, Paul",9,8,2,1,0,1,0,8
Adelaide,"Sloane, Rory",28,15,6,13,1,0,2,11
Adelaide,"Smith, Brodie",6,5,2,1,0,0,0,3
Adelaide,"Talia, Daniel",12,8,6,4,0,0,0,1
Adelaide,"Thompson, Scott",20,10,3,10,0,0,0,5
Adelaide,"Walker, Taylor",10,8,7,2,2,0,0,2
Adelaide,"Atkins, Rory",22,9,5,13,1,1,0,2
Adelaide,"Betts, Eddie",11,6,3,5,0,0,0,6
Adelaide,"Brown, Luke",14,7,6,7,1,0,0,2
Adelaide,"Cameron, Charlie",12,9,2,3,1,1,0,8
Adelaide,"Cheney, Kyle",11,7,5,4,0,0,0,2
Adelaide,"Douglas, Richard",21,8,5,13,1,1,0,4
Adelaide,"Hartigan, Kyle",16,8,7,8,0,0,0,2
Adelaide,"Henderson, Ricky",23,13,6,10,0,0,0,2
Adelaide,"Jacobs, Sam",12,10,4,2,0,0,29,2
Adelaide,"Jenkins, Josh",13,6,4,7,1,1,6,2
Adelaide,"Lever, Jake",14,9,2,5,0,1,0,1
Adelaide,"Lynch, Tom",22,16,10,6,2,2,0,0
Adelaide,"Lyons, Jarryd",20,13,5,7,1,0,0,6
Adelaide,"McGovern, Mitch",15,6,5,9,3,0,0,0
Adelaide,"Milera, Wayne",12,9,5,3,3,0,0,5
Adelaide,"Seedsman, Paul",21,16,7,5,1,0,0,5
Adelaide,"Sloane, Rory",27,10,5,17,0,0,1,7
Adelaide,"Smith, Brodie",24,17,2,7,1,0,0,1
Adelaide,"Talia, Daniel",23,12,9,11,1,0,0,1
Adelaide,"Thompson, Scott",22,8,3,14,0,0,0,3
Adelaide,"Walker, Taylor",19,10,9,9,5,2,0,2
Adelaide,"van Berlo, Nathan",21,15,8,6,0,1,0,2
Adelaide,"Atkins, Rory",28,19,8,9,0,1,2,0
Adelaide,"Betts, Eddie",15,15,3,0,5,2,0,3
Adelaide,"Brown, Luke",19,15,6,4,0,1,0,1
Adelaide,"Cameron, Charlie",19,14,4,5,0,1,0,2
Adelaide,"Cheney, Kyle",14,9,6,5,0,0,0,3
Adelaide,"Douglas, Richard",20,14,0,6,0,1,0,7
Adelaide,"Hartigan, Kyle",14,9,6,5,0,0,0,2
Adelaide,"Henderson, Ricky",13,7,4,6,0,0,0,4
Adelaide,"Jacobs, Sam",9,5,0,4,0,0,27,4
Adelaide,"Jenkins, Josh",15,7,5,8,1,0,2,0
Adelaide,"Lever, Jake",19,14,9,5,0,0,0,0
Adelaide,"Lynch, Tom",19,8,7,11,0,3,0,1
Adelaide,"Lyons, Jarryd",20,15,6,5,1,0,0,2
Adelaide,"McGovern, Mitch",11,7,3,4,1,1,0,5
Adelaide,"Milera, Wayne",8,5,1,3,1,1,0,1
Adelaide,"Seedsman, Paul",18,14,3,4,0,1,0,1
Adelaide,"Sloane, Rory",17,6,2,11,1,0,0,8
Adelaide,"Smith, Brodie",26,18,8,8,0,0,0,2
Adelaide,"Talia, Daniel",20,14,7,6,0,0,0,1
Adelaide,"Thompson, Scott",22,8,3,14,0,0,0,5
Adelaide,"Walker, Taylor",18,15,10,3,5,3,0,1
Adelaide,"van Berlo, Nathan",6,3,1,3,0,0,0,3
Adelaide,"Atkins, Rory",19,13,8,6,0,0,1,0
Adelaide,"Betts, Eddie",11,6,1,5,1,2,0,3
Adelaide,"Brown, Luke",24,12,7,12,0,0,0,1
Adelaide,"Cameron, Charlie",10,8,3,2,2,0,0,2
Adelaide,"Cheney, Kyle",18,12,9,6,0,0,0,0
Adelaide,"Crouch, Matt",36,17,7,19,0,2,0,3
Adelaide,"Douglas, Richard",16,11,4,5,0,1,0,2
Adelaide,"Hartigan, Kyle",19,9,9,10,0,0,0,4
Adelaide,"Henderson, Ricky",20,10,7,10,0,1,0,0
Adelaide,"Jacobs, Sam",24,16,6,8,1,1,27,4
Adelaide,"Jenkins, Josh",24,20,13,4,7,3,2,0
Adelaide,"Laird, Rory",30,11,8,19,0,0,0,0
Adelaide,"Lever, Jake",30,19,13,11,0,0,0,0
Adelaide,"Lynch, Tom",21,11,7,10,1,0,0,0
Adelaide,"Lyons, Jarryd",28,16,4,12,1,0,0,2
Adelaide,"McGovern, Mitch",7,6,7,1,1,3,0,0
Adelaide,"Milera, Wayne",12,6,4,6,0,1,0,4
Adelaide,"Seedsman, Paul",22,14,10,8,1,0,0,2
Adelaide,"Sloane, Rory",32,15,7,17,1,0,0,8
Adelaide,"Smith, Brodie",24,16,7,8,0,1,0,1
Adelaide,"Talia, Daniel",26,18,17,8,0,0,0,0
Adelaide,"Walker, Taylor",21,15,10,6,3,3,0,0
Adelaide,"Atkins, Rory",15,8,2,7,1,1,0,5
Adelaide,"Betts, Eddie",14,13,5,1,5,2,0,3
Adelaide,"Brown, Luke",13,9,4,4,0,0,0,3
Adelaide,"Cameron, Charlie",13,8,6,5,1,1,0,3
Adelaide,"Cheney, Kyle",13,7,4,6,0,0,0,3
Adelaide,"Crouch, Matt",24,6,1,18,0,0,0,7
Adelaide,"Douglas, Richard",14,7,3,7,1,1,0,5
Adelaide,"Hartigan, Kyle",11,10,4,1,0,0,0,2
Adelaide,"Jacobs, Sam",14,9,7,5,0,1,36,5
Adelaide,"Jenkins, Josh",12,9,7,3,3,1,4,1
Adelaide,"Laird, Rory",25,18,10,7,0,0,0,4
Adelaide,"Lever, Jake",18,14,8,4,0,0,0,1
Adelaide,"Lynch, Tom",23,17,10,6,1,2,0,1
Adelaide,"Lyons, Jarryd",23,11,2,12,0,1,0,6
Adelaide,"Mackay, David",20,11,5,9,0,1,0,5
Adelaide,"McGovern, Mitch",10,7,4,3,1,0,0,4
Adelaide,"Seedsman, Paul",22,10,6,12,0,1,0,7
Adelaide,"Sloane, Rory",29,19,2,10,0,0,0,6
Adelaide,"Smith, Brodie",22,12,6,10,0,2,0,1
Adelaide,"Talia, Daniel",12,8,6,4,0,0,0,4
Adelaide,"Thompson, Scott",24,13,2,11,0,0,0,12
Adelaide,"Walker, Taylor",12,7,3,5,2,0,0,1
Adelaide,"Atkins, Rory",21,13,6,8,1,3,1,2
Adelaide,"Betts, Eddie",14,10,2,4,2,4,0,3
Adelaide,"Brown, Luke",15,6,2,9,0,0,0,2
Adelaide,"Cameron, Charlie",9,5,2,4,0,2,0,8
Adelaide,"Cheney, Kyle",12,9,6,3,0,0,0,1
Adelaide,"Crouch, Brad",20,11,1,9,0,0,0,9
Adelaide,"Crouch, Matt",32,14,3,18,2,0,0,7
Adelaide,"Douglas, Richard",19,10,5,9,2,1,0,2
Adelaide,"Hartigan, Kyle",7,4,3,3,0,0,0,2
Adelaide,"Jacobs, Sam",16,9,4,7,0,1,32,0
Adelaide,"Jenkins, Josh",10,8,4,2,1,2,6,3
Adelaide,"Laird, Rory",20,12,4,8,0,1,0,3
Adelaide,"Lever, Jake",18,12,6,6,0,0,0,0
Adelaide,"Lynch, Tom",27,11,4,16,1,2,0,2
Adelaide,"Lyons, Jarryd",19,12,5,7,0,1,0,4
Adelaide,"Mackay, David",23,15,2,8,0,1,0,2
Adelaide,"McGovern, Mitch",13,8,7,5,1,1,0,5
Adelaide,"Sloane, Rory",30,16,2,14,0,2,1,13
Adelaide,"Smith, Brodie",17,12,2,5,0,0,0,1
Adelaide,"Talia, Daniel",9,3,1,6,0,0,0,4
Adelaide,"Thompson, Scott",24,10,2,14,0,0,0,9
Adelaide,"Walker, Taylor",12,9,7,3,2,2,0,3
Adelaide,"Atkins, Rory",20,10,2,10,1,0,0,2
Adelaide,"Betts, Eddie",13,11,4,2,3,0,0,6
Adelaide,"Brown, Luke",11,7,1,4,0,0,0,3
Adelaide,"Cameron, Charlie",17,10,4,7,2,2,0,3
Adelaide,"Cheney, Kyle",13,8,4,5,0,0,0,2
Adelaide,"Crouch, Brad",26,9,1,17,0,0,0,9
Adelaide,"Crouch, Matt",21,7,1,14,0,0,0,7
Adelaide,"Douglas, Richard",14,12,4,2,3,1,0,4
Adelaide,"Hartigan, Kyle",10,5,2,5,0,0,0,0
Adelaide,"Jacobs, Sam",15,9,2,6,0,0,29,2
Adelaide,"Jenkins, Josh",13,7,5,6,2,1,13,3
Adelaide,"Laird, Rory",25,13,10,12,0,0,0,3
Adelaide,"Lever, Jake",10,6,4,4,0,1,0,0
Adelaide,"Lynch, Tom",21,14,8,7,1,0,0,5
Adelaide,"Lyons, Jarryd",23,16,3,7,1,1,0,5
Adelaide,"Mackay, David",20,12,5,8,0,1,0,6
Adelaide,"McGovern, Mitch",11,6,3,5,2,1,0,6
Adelaide,"Sloane, Rory",23,12,5,11,0,0,0,13
Adelaide,"Smith, Brodie",15,9,3,6,0,0,0,8
Adelaide,"Talia, Daniel",13,9,4,4,0,0,0,1
Adelaide,"Thompson, Scott",18,10,0,8,0,0,0,9
Adelaide,"Walker, Taylor",18,14,8,4,3,0,0,4
Adelaide,"Atkins, Rory",19,9,4,10,0,1,1,3
Adelaide,"Betts, Eddie",17,7,2,10,3,0,0,2
Adelaide,"Cameron, Charlie",9,6,2,3,0,2,0,7
Adelaide,"Cheney, Kyle",19,11,4,8,0,1,0,3
Adelaide,"Crouch, Brad",29,14,4,15,1,0,0,7
Adelaide,"Crouch, Matt",32,8,2,24,0,0,0,0
Adelaide,"Douglas, Richard",13,8,2,5,1,1,0,6
Adelaide,"Hartigan, Kyle",18,8,2,10,0,0,0,0
Adelaide,"Henderson, Ricky",26,12,6,14,0,0,0,1
Adelaide,"Jacobs, Sam",15,9,3,6,3,0,36,5
Adelaide,"Jenkins, Josh",14,12,7,2,3,2,3,3
Adelaide,"Laird, Rory",35,18,4,17,0,0,0,0
Adelaide,"Lever, Jake",26,16,4,10,0,0,0,0
Adelaide,"Lynch, Tom",17,10,8,7,1,1,0,3
Adelaide,"Lyons, Jarryd",20,12,2,8,1,0,0,4
Adelaide,"Mackay, David",20,11,2,9,1,0,0,4
Adelaide,"McGovern, Mitch",9,4,3,5,1,0,0,3
Adelaide,"Sloane, Rory",34,15,4,19,0,1,0,8
Adelaide,"Smith, Brodie",18,11,4,7,0,1,0,2
Adelaide,"Talia, Daniel",28,17,7,11,0,0,0,2
Adelaide,"Thompson, Scott",20,10,3,10,0,0,0,9
Adelaide,"Walker, Taylor",14,9,5,5,1,0,0,3
Adelaide,"Atkins, Rory",25,14,5,11,1,1,0,2
Adelaide,"Betts, Eddie",10,9,3,1,3,2,0,5
Adelaide,"Cameron, Charlie",8,6,2,2,1,0,0,3
Adelaide,"Cheney, Kyle",9,5,4,4,0,0,0,1
Adelaide,"Crouch, Brad",29,11,1,18,0,1,0,10
Adelaide,"Crouch, Matt",25,9,4,16,0,0,0,3
Adelaide,"Douglas, Richard",18,12,6,6,0,0,0,1
Adelaide,"Hartigan, Kyle",8,4,3,4,0,0,0,2
Adelaide,"Henderson, Ricky",27,13,6,14,1,0,0,0
Adelaide,"Jacobs, Sam",17,13,5,4,1,0,27,3
Adelaide,"Jenkins, Josh",13,8,7,5,1,1,8,0
Adelaide,"Lever, Jake",12,8,3,4,0,0,0,1
Adelaide,"Lynch, Tom",21,9,4,12,2,1,0,0
Adelaide,"Lyons, Jarryd",21,18,5,3,2,0,0,7
Adelaide,"Mackay, David",18,10,3,8,0,1,0,0
Adelaide,"McGovern, Mitch",8,4,4,4,1,0,0,1
Adelaide,"Seedsman, Paul",18,6,1,12,0,0,0,5
Adelaide,"Sloane, Rory",27,12,3,15,0,1,0,8
Adelaide,"Smith, Brodie",23,14,8,9,0,1,0,2
Adelaide,"Talia, Daniel",17,8,8,9,0,0,0,2
Adelaide,"Thompson, Scott",22,12,3,10,0,1,0,9
Adelaide,"Walker, Taylor",10,8,4,2,1,1,0,0
Adelaide,"Atkins, Rory",14,11,4,3,0,2,0,2
Adelaide,"Betts, Eddie",11,8,2,3,1,0,0,2
Adelaide,"Brown, Luke",12,9,0,3,0,0,0,2
Adelaide,"Cameron, Charlie",18,14,5,4,0,3,0,4
Adelaide,"Cheney, Kyle",17,12,8,5,0,0,0,1
Adelaide,"Crouch, Brad",21,9,2,12,0,0,0,7
Adelaide,"Crouch, Matt",31,19,4,12,0,1,0,8
Adelaide,"Douglas, Richard",18,12,5,6,1,0,0,1
Adelaide,"Hartigan, Kyle",9,6,4,3,0,0,0,1
Adelaide,"Henderson, Ricky",19,13,5,6,0,1,0,1
Adelaide,"Jacobs, Sam",14,9,3,5,0,0,41,3
Adelaide,"Jenkins, Josh",8,6,1,2,3,1,6,0
Adelaide,"Laird, Rory",22,13,6,9,0,0,0,4
Adelaide,"Lever, Jake",15,11,7,4,0,0,0,2
Adelaide,"Lynch, Tom",15,9,4,6,2,0,0,5
Adelaide,"Lyons, Jarryd",24,13,3,11,0,0,0,7
Adelaide,"McGovern, Mitch",2,1,1,1,0,0,0,2
Adelaide,"Sloane, Rory",22,13,2,9,0,0,1,5
Adelaide,"Smith, Brodie",20,15,5,5,0,0,0,4
Adelaide,"Talia, Daniel",6,3,1,3,0,0,0,3
Adelaide,"Thompson, Scott",18,10,3,8,0,0,0,7
Adelaide,"Walker, Taylor",11,7,3,4,0,2,0,0
Adelaide,"Atkins, Rory",26,7,2,19,0,0,0,0
Adelaide,"Betts, Eddie",16,12,5,4,5,2,0,2
Adelaide,"Brown, Luke",22,12,6,10,0,0,0,5
Adelaide,"Cameron, Charlie",14,8,4,6,4,1,0,4
Adelaide,"Cheney, Kyle",13,8,7,5,0,0,0,1
Adelaide,"Crouch, Brad",31,9,2,22,0,0,0,4
Adelaide,"Crouch, Matt",33,11,4,22,0,0,0,4
Adelaide,"Douglas, Richard",17,8,4,9,2,0,0,7
Adelaide,"Hartigan, Kyle",13,8,5,5,1,0,0,1
Adelaide,"Jacobs, Sam",5,3,1,2,0,0,7,1
Adelaide,"Jenkins, Josh",11,7,3,4,2,0,13,4
Adelaide,"Laird, Rory",36,13,7,23,0,0,0,0
Adelaide,"Lever, Jake",14,8,5,6,0,0,0,2
Adelaide,"Lynch, Tom",18,10,6,8,0,0,1,4
Adelaide,"Lyons, Jarryd",21,8,4,13,1,1,0,6
Adelaide,"Mackay, David",24,11,2,13,0,2,0,4
Adelaide,"McGovern, Mitch",14,8,8,6,4,1,0,1
Adelaide,"Seedsman, Paul",23,14,3,9,2,1,0,4
Adelaide,"Sloane, Rory",33,17,5,16,1,1,5,4
Adelaide,"Smith, Brodie",24,13,3,11,0,2,0,2
Adelaide,"Talia, Daniel",20,9,7,11,0,0,0,3
Adelaide,"Thompson, Scott",29,12,4,17,0,0,0,6
Adelaide,"Atkins, Rory",25,12,3,13,0,0,0,3
Adelaide,"Betts, Eddie",10,8,2,2,4,1,0,2
Adelaide,"Brown, Luke",18,11,5,7,1,0,0,1
Adelaide,"Cameron, Charlie",15,9,3,6,1,0,0,2
Adelaide,"Cheney, Kyle",18,10,7,8,0,0,0,2
Adelaide,"Crouch, Brad",34,12,2,22,1,0,0,6
Adelaide,"Crouch, Matt",32,18,6,14,1,0,0,1
Adelaide,"Douglas, Richard",14,7,2,7,0,0,0,4
Adelaide,"Ellis-Yolmen, Cam",18,10,4,8,2,3,0,5
Adelaide,"Hartigan, Kyle",21,11,8,10,0,0,0,1
Adelaide,"Jenkins, Josh",21,14,10,7,3,2,9,2
Adelaide,"Laird, Rory",36,11,9,25,0,0,0,0
Adelaide,"Lever, Jake",17,10,5,7,0,0,0,2
Adelaide,"Lynch, Tom",20,17,15,3,4,0,0,4
Adelaide,"Lyons, Jarryd",29,16,3,13,1,2,0,2
Adelaide,"Mackay, David",22,6,4,16,0,0,0,3
Adelaide,"OBrien, Reilly",16,5,3,11,1,1,29,2
Adelaide,"Seedsman, Paul",3,3,0,0,1,0,0,1
Adelaide,"Sloane, Rory",34,16,5,18,2,0,1,2
Adelaide,"Smith, Brodie",25,19,7,6,1,1,0,8
Adelaide,"Talia, Daniel",27,12,13,15,0,0,0,3
Adelaide,"Walker, Taylor",22,17,12,5,4,1,0,1
Adelaide,"Atkins, Rory",32,10,3,22,1,0,0,1
Adelaide,"Betts, Eddie",13,11,7,2,6,1,0,5
Adelaide,"Brown, Luke",23,15,4,8,1,0,0,4
Adelaide,"Cameron, Charlie",13,8,0,5,1,0,0,4
Adelaide,"Cheney, Kyle",19,9,4,10,0,0,0,1
Adelaide,"Crouch, Brad",29,11,2,18,0,0,0,5
Adelaide,"Crouch, Matt",24,7,3,17,0,0,0,6
Adelaide,"Douglas, Richard",30,13,7,17,0,0,0,3
Adelaide,"Hartigan, Kyle",10,9,4,1,0,0,0,2
Adelaide,"Jenkins, Josh",13,12,4,1,5,3,4,2
Adelaide,"Laird, Rory",33,11,7,22,0,0,0,4
Adelaide,"Lever, Jake",24,16,6,8,1,0,0,0
Adelaide,"Lynch, Tom",21,12,10,9,2,2,0,2
Adelaide,"Lyons, Jarryd",28,15,3,13,0,1,0,7
Adelaide,"Mackay, David",24,12,4,12,0,0,0,8
Adelaide,"McGovern, Mitch",7,5,3,2,1,1,0,1
Adelaide,"OBrien, Reilly",12,4,1,8,0,1,18,4
Adelaide,"Sloane, Rory",20,7,0,13,1,0,1,7
Adelaide,"Smith, Brodie",21,16,4,5,0,1,0,1
Adelaide,"Talia, Daniel",19,6,6,13,0,0,0,3
Adelaide,"Thompson, Scott",26,14,7,12,1,0,0,7
Adelaide,"Walker, Taylor",14,9,5,5,1,2,0,4
Adelaide,"Atkins, Rory",18,12,7,6,0,0,0,1
Adelaide,"Betts, Eddie",18,15,3,3,5,2,0,2
Adelaide,"Brown, Luke",15,12,5,3,1,0,0,3
Adelaide,"Cameron, Charlie",17,9,5,8,0,1,0,4
Adelaide,"Cheney, Kyle",13,4,3,9,0,0,0,3
Adelaide,"Crouch, Brad",17,4,0,13,0,0,0,4
Adelaide,"Crouch, Matt",33,13,6,20,0,0,0,6
Adelaide,"Douglas, Richard",19,11,2,8,0,0,0,1
Adelaide,"Hartigan, Kyle",14,11,6,3,0,0,0,1
Adelaide,"Jacobs, Sam",13,6,5,7,0,1,38,1
Adelaide,"Jenkins, Josh",9,6,5,3,2,2,3,1
Adelaide,"Laird, Rory",23,12,5,11,0,0,0,0
Adelaide,"Lever, Jake",13,9,3,4,0,0,0,2
Adelaide,"Lynch, Tom",16,11,6,5,2,3,0,4
Adelaide,"Lyons, Jarryd",21,11,6,10,0,0,0,6
Adelaide,"Mackay, David",17,10,2,7,0,1,0,4
Adelaide,"McGovern, Mitch",11,10,6,1,3,2,0,1
Adelaide,"Sloane, Rory",19,10,4,9,0,0,1,10
Adelaide,"Smith, Brodie",7,5,3,2,0,0,0,0
Adelaide,"Talia, Daniel",9,5,3,4,0,0,0,2
Adelaide,"Thompson, Scott",22,12,3,10,0,1,1,3
Adelaide,"Walker, Taylor",13,10,7,3,2,4,0,2
Adelaide,"Atkins, Rory",17,8,1,9,1,0,1,2
Adelaide,"Betts, Eddie",10,9,3,1,1,0,0,4
Adelaide,"Brown, Luke",10,8,3,2,0,0,0,1
Adelaide,"Cameron, Charlie",8,3,1,5,0,0,0,5
Adelaide,"Cheney, Kyle",11,9,6,2,0,0,0,2
Adelaide,"Crouch, Brad",21,11,2,10,1,0,0,7
Adelaide,"Crouch, Matt",29,15,5,14,0,0,0,10
Adelaide,"Douglas, Richard",19,15,4,4,2,1,0,3
Adelaide,"Ellis-Yolmen, Cam",13,4,3,9,2,0,1,4
Adelaide,"Hartigan, Kyle",15,6,7,9,0,0,0,0
Adelaide,"Henderson, Ricky",25,16,3,9,0,0,0,2
Adelaide,"Jacobs, Sam",7,5,0,2,1,0,28,0
Adelaide,"Jenkins, Josh",11,5,3,6,1,0,6,2
Adelaide,"Laird, Rory",28,12,6,16,0,0,0,4
Adelaide,"Lever, Jake",12,9,5,3,0,0,0,2
Adelaide,"Lynch, Tom",14,10,3,4,0,0,0,0
Adelaide,"Lyons, Jarryd",21,13,5,8,0,3,0,2
Adelaide,"Mackay, David",23,6,0,17,0,1,0,5
Adelaide,"McGovern, Mitch",8,6,4,2,1,1,0,2
Adelaide,"Talia, Daniel",13,8,4,5,0,0,0,3
Adelaide,"Thompson, Scott",23,14,4,9,0,0,0,9
Adelaide,"Walker, Taylor",14,10,6,4,0,1,0,3
Adelaide,"Atkins, Rory",18,11,6,7,0,1,0,2
Adelaide,"Betts, Eddie",12,9,6,3,6,0,0,2
Adelaide,"Brown, Luke",16,13,6,3,0,0,0,3
Adelaide,"Cameron, Charlie",11,7,1,4,1,1,0,1
Adelaide,"Cheney, Kyle",10,6,6,4,0,0,0,0
Adelaide,"Crouch, Brad",22,7,0,15,0,0,0,5
Adelaide,"Crouch, Matt",29,12,4,17,1,0,0,4
Adelaide,"Douglas, Richard",20,12,1,8,0,0,0,3
Adelaide,"Hartigan, Kyle",10,5,5,5,0,0,0,0
Adelaide,"Jacobs, Sam",13,10,3,3,0,0,40,5
Adelaide,"Jenkins, Josh",5,5,4,0,2,2,8,3
Adelaide,"Laird, Rory",26,13,7,13,0,0,0,2
Adelaide,"Lever, Jake",12,7,4,5,1,0,0,1
Adelaide,"Lynch, Tom",21,12,5,9,4,0,0,3
Adelaide,"Lyons, Jarryd",23,14,2,9,1,3,0,9
Adelaide,"Mackay, David",22,10,3,12,0,0,0,3
Adelaide,"McGovern, Mitch",9,6,3,3,0,1,0,5
Adelaide,"Sloane, Rory",21,9,7,12,1,0,1,2
Adelaide,"Smith, Brodie",29,18,6,11,2,1,0,2
Adelaide,"Talia, Daniel",12,6,7,6,0,0,0,1
Adelaide,"Thompson, Scott",24,12,4,12,0,0,0,8
Adelaide,"Walker, Taylor",20,15,11,5,2,3,0,1
Adelaide,"Atkins, Rory",22,16,5,6,0,0,0,1
Adelaide,"Betts, Eddie",8,8,2,0,3,1,0,4
Adelaide,"Brown, Luke",11,6,2,5,0,0,0,5
Adelaide,"Cameron, Charlie",17,12,1,5,2,0,0,5
Adelaide,"Cheney, Kyle",11,7,4,4,0,0,0,2
Adelaide,"Crouch, Brad",18,8,3,10,0,0,0,6
Adelaide,"Crouch, Matt",34,16,5,18,0,0,0,5
Adelaide,"Douglas, Richard",17,8,4,9,0,3,0,4
Adelaide,"Hartigan, Kyle",13,8,6,5,0,0,0,0
Adelaide,"Jacobs, Sam",11,7,3,4,0,0,33,3
Adelaide,"Jenkins, Josh",7,2,1,5,0,1,3,2
Adelaide,"Laird, Rory",28,16,6,12,0,0,0,1
Adelaide,"Lever, Jake",6,5,3,1,0,0,0,2
Adelaide,"Lynch, Tom",16,9,5,7,2,0,0,0
Adelaide,"Lyons, Jarryd",19,4,0,15,0,0,0,2
Adelaide,"Mackay, David",19,13,1,6,0,0,0,4
Adelaide,"McGovern, Mitch",12,9,5,3,2,1,0,1
Adelaide,"Sloane, Rory",23,12,2,11,0,2,6,9
Adelaide,"Smith, Brodie",16,7,4,9,0,0,0,0
Adelaide,"Talia, Daniel",9,5,3,4,0,0,0,4
Adelaide,"Thompson, Scott",20,14,4,6,1,0,0,9
Adelaide,"Walker, Taylor",16,11,8,5,2,2,0,0
Brisbane Lions,"Andrews, Harris",6,3,2,3,0,0,1,3
Brisbane Lions,"Bastinac, Ryan",23,11,3,12,0,0,0,4
Brisbane Lions,"Beams, Claye",7,2,0,5,0,0,0,7
Brisbane Lions,"Bell, Tom",24,7,4,17,0,0,1,5
Brisbane Lions,"Bewick, Rohan",9,4,2,5,0,1,1,4
Brisbane Lions,"Christensen, Allen",19,12,6,7,3,2,0,1
Brisbane Lions,"Cutler, Tom",13,8,2,5,0,0,0,4
Brisbane Lions,"Freeman, Jonathan",6,3,2,3,0,1,0,1
Brisbane Lions,"Gardiner, Darcy",9,2,1,7,0,0,0,1
Brisbane Lions,"Hanley, Pearce",19,10,0,9,1,0,1,4
Brisbane Lions,"Harwood, Ryan",15,8,2,7,0,0,0,0
Brisbane Lions,"Lester, Ryan",15,8,2,7,0,0,0,2
Brisbane Lions,"Martin, Stefan",21,6,2,15,0,0,21,1
Brisbane Lions,"Mayes, Sam",16,6,3,10,0,0,0,3
Brisbane Lions,"McStay, Daniel",12,6,4,6,0,0,0,2
Brisbane Lions,"Paparone, Marco",9,5,2,4,0,0,0,1
Brisbane Lions,"Rich, Daniel",23,14,2,9,2,1,0,11
Brisbane Lions,"Robinson, Mitch",23,6,0,17,0,0,1,4
Brisbane Lions,"Rockliff, Tom",21,9,5,12,2,1,0,8
Brisbane Lions,"Schache, Josh",9,7,5,2,2,1,0,4
Brisbane Lions,"Taylor, Lewis",18,12,4,6,3,1,0,2
Brisbane Lions,"Walker, Josh",6,5,3,1,2,1,2,2
Brisbane Lions,"Andrews, Harris",13,9,8,4,0,0,0,0
Brisbane Lions,"Bastinac, Ryan",19,6,1,13,0,0,0,2
Brisbane Lions,"Beams, Claye",15,10,5,5,1,0,0,2
Brisbane Lions,"Bell, Tom",13,6,2,7,1,0,1,2
Brisbane Lions,"Bewick, Rohan",19,11,5,8,0,0,1,3
Brisbane Lions,"Christensen, Allen",15,5,2,10,0,0,0,6
Brisbane Lions,"Cutler, Tom",17,13,2,4,0,1,0,1
Brisbane Lions,"Gardiner, Darcy",11,6,1,5,0,0,0,0
Brisbane Lions,"Green, Josh",13,9,3,4,2,1,0,2
Brisbane Lions,"Hanley, Pearce",24,16,3,8,0,3,1,2
Brisbane Lions,"Harwood, Ryan",7,3,0,4,0,1,0,1
Brisbane Lions,"Lester, Ryan",11,3,3,8,1,1,0,0
Brisbane Lions,"Martin, Stefan",18,7,7,11,0,1,28,1
Brisbane Lions,"Mayes, Sam",7,4,4,3,0,0,0,3
Brisbane Lions,"McStay, Daniel",5,3,3,2,0,0,0,2
Brisbane Lions,"Merrett, Daniel",6,4,1,2,0,0,0,3
Brisbane Lions,"Rich, Daniel",7,5,0,2,0,0,0,5
Brisbane Lions,"Rockliff, Tom",10,2,0,8,1,0,0,2
Brisbane Lions,"Schache, Josh",9,8,5,1,0,2,0,3
Brisbane Lions,"Taylor, Lewis",22,12,8,10,2,2,0,3
Brisbane Lions,"Walker, Josh",11,7,8,4,1,0,1,3
Brisbane Lions,"Zorko, Dayne",24,18,5,6,2,1,0,5
Brisbane Lions,"Andrews, Harris",11,4,2,7,0,0,0,4
Brisbane Lions,"Bastinac, Ryan",22,8,2,14,1,0,0,6
Brisbane Lions,"Beams, Claye",11,5,2,6,0,0,0,0
Brisbane Lions,"Bell, Tom",22,13,6,9,2,2,0,3
Brisbane Lions,"Bewick, Rohan",11,8,2,3,0,1,0,2
Brisbane Lions,"Christensen, Allen",9,3,1,6,0,0,0,2
Brisbane Lions,"Cutler, Tom",21,14,2,7,0,1,0,1
Brisbane Lions,"Evans, Billy",10,5,4,5,0,0,0,3
Brisbane Lions,"Gardiner, Darcy",17,10,3,7,0,0,0,2
Brisbane Lions,"Green, Josh",12,7,3,5,1,1,0,3
Brisbane Lions,"Hanley, Pearce",27,11,2,16,0,1,0,5
Brisbane Lions,"Harwood, Ryan",22,11,3,11,0,0,0,0
Brisbane Lions,"Lester, Ryan",7,5,3,2,0,1,0,2
Brisbane Lions,"Martin, Stefan",18,5,1,13,1,1,29,0
Brisbane Lions,"Mayes, Sam",16,9,5,7,0,0,0,0
Brisbane Lions,"McStay, Daniel",6,3,3,3,1,0,0,2
Brisbane Lions,"Merrett, Daniel",4,3,1,1,0,0,0,2
Brisbane Lions,"Robinson, Mitch",31,12,4,19,0,0,0,3
Brisbane Lions,"Schache, Josh",9,7,4,2,0,0,0,3
Brisbane Lions,"Taylor, Lewis",14,10,7,4,1,2,0,2
Brisbane Lions,"Walker, Josh",7,6,3,1,0,2,2,1
Brisbane Lions,"Zorko, Dayne",25,13,2,12,0,0,0,6
Brisbane Lions,"Andrews, Harris",12,3,3,9,0,0,4,1
Brisbane Lions,"Bastinac, Ryan",23,13,7,10,1,0,0,4
Brisbane Lions,"Beams, Claye",15,10,3,5,0,0,0,1
Brisbane Lions,"Bell, Tom",16,12,7,4,2,2,0,3
Brisbane Lions,"Bewick, Rohan",18,12,7,6,1,0,0,4
Brisbane Lions,"Christensen, Allen",24,12,5,12,1,1,0,5
Brisbane Lions,"Cutler, Tom",20,10,0,10,2,0,0,3
Brisbane Lions,"Dawson, Liam",17,8,4,9,0,0,0,0
Brisbane Lions,"Gardiner, Darcy",15,4,1,11,0,0,0,3
Brisbane Lions,"Green, Josh",14,13,4,1,1,2,0,3
Brisbane Lions,"Hanley, Pearce",28,18,4,10,2,2,2,4
Brisbane Lions,"Harwood, Ryan",16,6,2,10,0,0,0,4
Brisbane Lions,"Lester, Ryan",9,6,4,3,0,3,0,5
Brisbane Lions,"Martin, Stefan",10,7,3,3,1,0,12,0
Brisbane Lions,"Mayes, Sam",18,11,5,7,0,1,1,8
Brisbane Lions,"Merrett, Daniel",12,6,4,6,0,0,0,1
Brisbane Lions,"Rich, Daniel",21,10,2,11,0,2,0,7
Brisbane Lions,"Robinson, Mitch",18,8,2,10,0,0,3,9
Brisbane Lions,"Schache, Josh",15,7,5,8,1,1,0,1
Brisbane Lions,"Taylor, Lewis",9,6,2,3,1,0,0,2
Brisbane Lions,"Walker, Josh",15,6,5,9,0,2,21,3
Brisbane Lions,"Zorko, Dayne",22,15,3,7,1,1,0,10
Brisbane Lions,"Andrews, Harris",11,9,8,2,0,0,0,3
Brisbane Lions,"Bastinac, Ryan",20,8,6,12,0,0,0,5
Brisbane Lions,"Beams, Claye",12,7,3,5,0,0,0,4
Brisbane Lions,"Bell, Tom",19,12,5,7,0,0,0,4
Brisbane Lions,"Bewick, Rohan",14,9,5,5,1,0,0,2
Brisbane Lions,"Christensen, Allen",6,2,0,4,0,0,0,1
Brisbane Lions,"Cutler, Tom",6,4,0,2,0,0,0,1
Brisbane Lions,"Dawson, Liam",5,3,2,2,0,0,0,3
Brisbane Lions,"Gardiner, Darcy",10,5,3,5,0,0,0,8
Brisbane Lions,"Green, Josh",12,10,2,2,0,0,0,2
Brisbane Lions,"Hanley, Pearce",20,13,6,7,1,3,0,4
Brisbane Lions,"Harwood, Ryan",12,6,5,6,0,0,0,4
Brisbane Lions,"Lester, Ryan",17,10,8,7,2,0,0,5
Brisbane Lions,"Martin, Stefan",18,9,7,9,0,0,20,3
Brisbane Lions,"Merrett, Daniel",17,9,4,8,0,0,0,3
Brisbane Lions,"Rich, Daniel",17,10,3,7,1,0,0,7
Brisbane Lions,"Robinson, Mitch",27,16,3,11,0,0,1,4
Brisbane Lions,"Rockliff, Tom",26,10,6,16,1,0,0,2
Brisbane Lions,"Schache, Josh",9,7,4,2,1,0,0,0
Brisbane Lions,"Taylor, Lewis",20,10,3,10,0,1,0,2
Brisbane Lions,"Walker, Josh",9,4,4,5,1,0,8,3
Brisbane Lions,"Zorko, Dayne",21,13,6,8,2,0,0,5
Brisbane Lions,"Andrews, Harris",9,7,2,2,0,0,0,1
Brisbane Lions,"Bastinac, Ryan",18,10,3,8,1,1,0,7
Brisbane Lions,"Beams, Claye",4,4,1,0,0,0,0,1
Brisbane Lions,"Bell, Tom",24,19,2,5,0,1,2,1
Brisbane Lions,"Bewick, Rohan",13,13,3,0,0,0,0,9
Brisbane Lions,"Christensen, Allen",17,15,7,2,3,1,0,3
Brisbane Lions,"Dawson, Liam",3,1,0,2,0,0,0,2
Brisbane Lions,"Gardiner, Darcy",10,5,1,5,0,0,0,2
Brisbane Lions,"Hanley, Pearce",25,15,5,10,2,1,0,12
Brisbane Lions,"Harwood, Ryan",7,4,2,3,0,0,0,6
Brisbane Lions,"Keays, Ben",11,5,0,6,1,1,0,8
Brisbane Lions,"Lester, Ryan",11,7,1,4,2,0,0,2
Brisbane Lions,"Martin, Stefan",13,6,5,7,0,0,28,4
Brisbane Lions,"Mayes, Sam",13,8,1,5,0,0,0,2
Brisbane Lions,"McStay, Daniel",10,5,3,5,1,0,0,2
Brisbane Lions,"Merrett, Daniel",9,8,3,1,0,0,0,2
Brisbane Lions,"Rich, Daniel",23,17,3,6,2,1,0,5
Brisbane Lions,"Robinson, Mitch",28,15,4,13,0,0,5,7
Brisbane Lions,"Rockliff, Tom",32,17,5,15,0,0,1,10
Brisbane Lions,"Taylor, Lewis",11,3,1,8,0,0,0,3
Brisbane Lions,"Walker, Josh",8,3,1,5,1,0,5,2
Brisbane Lions,"Zorko, Dayne",33,25,6,8,1,2,1,7
Brisbane Lions,"Andrews, Harris",8,4,4,4,0,0,0,4
Brisbane Lions,"Bastinac, Ryan",25,13,4,12,0,0,0,4
Brisbane Lions,"Beams, Claye",10,8,3,2,1,0,0,0
Brisbane Lions,"Beams, Dayne",30,20,4,10,1,1,0,1
Brisbane Lions,"Bell, Tom",20,12,1,8,0,1,0,3
Brisbane Lions,"Bewick, Rohan",14,12,2,2,0,2,0,5
Brisbane Lions,"Christensen, Allen",20,11,1,9,0,1,0,4
Brisbane Lions,"Gardiner, Darcy",16,12,4,4,0,0,0,0
Brisbane Lions,"Hanley, Pearce",11,8,3,3,1,0,0,5
Brisbane Lions,"Harwood, Ryan",12,7,3,5,0,0,0,5
Brisbane Lions,"Keays, Ben",12,7,2,5,0,4,0,6
Brisbane Lions,"Lester, Ryan",9,5,2,4,1,1,0,1
Brisbane Lions,"Martin, Stefan",22,12,5,10,0,0,51,4
Brisbane Lions,"Mayes, Sam",11,9,3,2,0,0,0,4
Brisbane Lions,"McStay, Daniel",12,2,2,10,0,0,0,0
Brisbane Lions,"Paparone, Marco",15,11,5,4,0,0,0,1
Brisbane Lions,"Rich, Daniel",19,10,1,9,0,0,0,7
Brisbane Lions,"Robinson, Mitch",13,8,1,5,0,2,1,8
Brisbane Lions,"Rockliff, Tom",9,3,0,6,0,0,0,3
Brisbane Lions,"Schache, Josh",5,3,2,2,1,1,0,0
Brisbane Lions,"Walker, Josh",5,4,3,1,0,0,6,1
Brisbane Lions,"Zorko, Dayne",22,15,0,7,2,1,0,9
Brisbane Lions,"Bastinac, Ryan",14,6,3,8,0,0,0,2
Brisbane Lions,"Beams, Claye",6,3,0,3,0,0,0,1
Brisbane Lions,"Beams, Dayne",18,7,3,11,0,0,0,4
Brisbane Lions,"Bell, Tom",13,5,0,8,0,0,0,1
Brisbane Lions,"Bewick, Rohan",16,6,1,10,1,0,0,3
Brisbane Lions,"Christensen, Allen",15,8,3,7,0,0,0,4
Brisbane Lions,"Gardiner, Darcy",4,2,1,2,0,0,0,4
Brisbane Lions,"Green, Josh",7,4,0,3,1,1,0,4
Brisbane Lions,"Hanley, Pearce",17,8,2,9,0,0,0,4
Brisbane Lions,"Harwood, Ryan",16,11,6,5,0,0,0,1
Brisbane Lions,"Keays, Ben",16,4,1,12,0,0,0,5
Brisbane Lions,"Lester, Ryan",17,8,6,9,1,0,0,3
Brisbane Lions,"Martin, Stefan",18,6,2,12,0,0,24,4
Brisbane Lions,"Mayes, Sam",21,13,3,8,0,0,0,3
Brisbane Lions,"Merrett, Daniel",10,4,4,6,0,0,0,0
Brisbane Lions,"Paparone, Marco",14,10,3,4,0,0,0,0
Brisbane Lions,"Rich, Daniel",18,10,0,8,1,0,0,3
Brisbane Lions,"Robinson, Mitch",16,14,3,2,0,0,1,6
Brisbane Lions,"Schache, Josh",12,7,6,5,0,2,0,1
Brisbane Lions,"Taylor, Lewis",12,7,2,5,0,0,0,1
Brisbane Lions,"Walker, Josh",12,4,5,8,2,1,7,1
Brisbane Lions,"Zorko, Dayne",19,13,6,6,4,0,0,7
Brisbane Lions,"Bastinac, Ryan",21,9,1,12,0,0,0,7
Brisbane Lions,"Bell, Tom",17,11,3,6,3,0,0,1
Brisbane Lions,"Christensen, Allen",21,11,3,10,0,0,0,1
Brisbane Lions,"Evans, Billy",10,1,0,9,0,0,0,5
Brisbane Lions,"Freeman, Jonathan",8,6,5,2,1,2,0,2
Brisbane Lions,"Hanley, Pearce",22,14,4,8,0,0,0,1
Brisbane Lions,"Harwood, Ryan",15,8,5,7,0,0,0,1
Brisbane Lions,"Keays, Ben",11,5,3,6,1,2,0,1
Brisbane Lions,"Lester, Ryan",15,8,4,7,2,0,0,0
Brisbane Lions,"Martin, Stefan",10,6,4,4,0,1,19,1
Brisbane Lions,"Mathieson, Rhys",14,11,3,3,0,0,0,2
Brisbane Lions,"Mayes, Sam",18,10,8,8,0,0,0,1
Brisbane Lions,"McStay, Daniel",19,8,7,11,0,0,0,2
Brisbane Lions,"Merrett, Daniel",6,5,2,1,0,0,0,1
Brisbane Lions,"Paine, Jackson",11,8,5,3,0,1,0,2
Brisbane Lions,"Rich, Daniel",26,15,6,11,0,1,0,6
Brisbane Lions,"Robertson, Nick",13,9,2,4,0,0,0,4
Brisbane Lions,"Robinson, Mitch",24,11,7,13,0,0,2,10
Brisbane Lions,"Schache, Josh",5,2,1,3,0,1,0,1
Brisbane Lions,"Taylor, Lewis",18,11,1,7,1,1,0,2
Brisbane Lions,"West, Trent",8,4,2,4,0,1,20,3
Brisbane Lions,"Zorko, Dayne",22,14,2,8,1,0,0,5
Brisbane Lions,"Bastinac, Ryan",15,7,1,8,0,0,0,1
Brisbane Lions,"Bell, Tom",16,12,0,4,4,0,0,4
Brisbane Lions,"Christensen, Allen",31,19,4,12,0,0,0,3
Brisbane Lions,"Cutler, Tom",18,9,2,9,0,0,1,4
Brisbane Lions,"Freeman, Jonathan",4,3,1,1,1,1,0,2
Brisbane Lions,"Hanley, Pearce",25,17,7,8,0,0,1,5
Brisbane Lions,"Harwood, Ryan",21,11,2,10,0,0,0,5
Brisbane Lions,"Keays, Ben",15,3,1,12,0,0,0,2
Brisbane Lions,"Lester, Ryan",7,2,0,5,0,1,0,2
Brisbane Lions,"Martin, Stefan",7,3,1,4,0,0,20,1
Brisbane Lions,"Mathieson, Rhys",14,8,3,6,0,1,0,3
Brisbane Lions,"Mayes, Sam",25,14,5,11,0,0,0,1
Brisbane Lions,"McStay, Daniel",12,9,3,3,0,0,0,2
Brisbane Lions,"Merrett, Daniel",10,7,4,3,0,0,0,6
Brisbane Lions,"Paine, Jackson",12,4,1,8,0,0,0,3
Brisbane Lions,"Rich, Daniel",19,12,3,7,0,1,0,6
Brisbane Lions,"Robertson, Nick",22,14,7,8,1,0,0,3
Brisbane Lions,"Robinson, Mitch",26,11,3,15,0,0,0,3
Brisbane Lions,"Schache, Josh",13,5,8,8,2,2,0,0
Brisbane Lions,"Taylor, Lewis",23,10,5,13,3,0,0,2
Brisbane Lions,"West, Trent",8,3,1,5,0,0,21,2
Brisbane Lions,"Zorko, Dayne",23,13,2,10,2,0,0,9
Brisbane Lions,"Bastinac, Ryan",20,12,6,8,0,0,0,7
Brisbane Lions,"Bell, Tom",7,4,2,3,0,1,0,6
Brisbane Lions,"Christensen, Allen",6,6,1,0,0,0,0,0
Brisbane Lions,"Cutler, Tom",16,13,7,3,1,0,0,2
Brisbane Lions,"Freeman, Jonathan",6,4,3,2,1,1,0,3
Brisbane Lions,"Hanley, Pearce",18,9,3,9,0,1,0,2
Brisbane Lions,"Harwood, Ryan",20,12,6,8,0,0,0,2
Brisbane Lions,"Jansen, Jarrad",21,8,2,13,1,0,0,5
Brisbane Lions,"Keays, Ben",10,3,2,7,1,0,0,5
Brisbane Lions,"Martin, Stefan",13,6,8,7,1,0,19,0
Brisbane Lions,"Mayes, Sam",18,13,6,5,0,0,0,0
Brisbane Lions,"McStay, Daniel",11,6,4,5,0,0,0,1
Brisbane Lions,"Merrett, Daniel",9,5,2,4,0,0,0,1
Brisbane Lions,"Paine, Jackson",8,5,1,3,0,0,0,1
Brisbane Lions,"Rich, Daniel",16,11,3,5,2,0,0,4
Brisbane Lions,"Robertson, Nick",11,6,3,5,0,0,0,4
Brisbane Lions,"Robinson, Mitch",25,11,4,14,0,0,1,9
Brisbane Lions,"Rockliff, Tom",48,21,8,27,1,0,0,9
Brisbane Lions,"Schache, Josh",9,5,2,4,1,2,0,2
Brisbane Lions,"Taylor, Lewis",14,4,0,10,0,0,0,0
Brisbane Lions,"West, Trent",11,4,2,7,0,0,23,2
Brisbane Lions,"Zorko, Dayne",25,16,4,9,0,4,0,6
Brisbane Lions,"Andrews, Harris",15,8,9,7,0,0,1,1
Brisbane Lions,"Bastinac, Ryan",26,16,7,10,1,1,0,2
Brisbane Lions,"Bell, Tom",14,8,6,6,0,0,0,3
Brisbane Lions,"Bewick, Rohan",21,15,9,6,1,1,0,5
Brisbane Lions,"Cutler, Tom",28,19,13,9,2,1,0,3
Brisbane Lions,"Gardiner, Darcy",23,9,7,14,0,0,0,2
Brisbane Lions,"Hanley, Pearce",30,17,5,13,0,1,0,2
Brisbane Lions,"Harwood, Ryan",15,8,5,7,0,0,0,5
Brisbane Lions,"Jansen, Jarrad",9,2,0,7,0,1,0,7
Brisbane Lions,"Keays, Ben",5,1,2,4,0,1,0,3
Brisbane Lions,"Martin, Stefan",13,2,2,11,0,0,30,1
Brisbane Lions,"Mayes, Sam",20,18,8,2,0,0,0,2
Brisbane Lions,"McStay, Daniel",21,10,8,11,0,0,0,5
Brisbane Lions,"Merrett, Daniel",10,7,5,3,0,0,0,2
Brisbane Lions,"Rich, Daniel",18,12,2,6,1,0,0,4
Brisbane Lions,"Robertson, Nick",22,9,7,13,0,0,0,2
Brisbane Lions,"Robinson, Mitch",26,12,6,14,0,1,0,8
Brisbane Lions,"Rockliff, Tom",34,14,8,20,0,0,0,9
Brisbane Lions,"Schache, Josh",5,3,3,2,2,0,0,0
Brisbane Lions,"Taylor, Lewis",13,7,4,6,2,1,0,1
Brisbane Lions,"West, Trent",9,3,4,6,0,0,18,1
Brisbane Lions,"Zorko, Dayne",26,18,6,8,0,0,0,3
Brisbane Lions,"Bastinac, Ryan",29,13,1,16,1,0,0,3
Brisbane Lions,"Beams, Claye",18,14,9,4,0,0,0,2
Brisbane Lions,"Bewick, Rohan",22,12,5,10,0,0,0,2
Brisbane Lions,"Cutler, Tom",24,13,2,11,0,0,0,1
Brisbane Lions,"Gardiner, Darcy",17,10,7,7,0,0,0,2
Brisbane Lions,"Hanley, Pearce",36,21,12,15,2,0,0,1
Brisbane Lions,"Harwood, Ryan",3,1,0,2,0,0,0,1
Brisbane Lions,"Hipwood, Eric",9,6,2,3,1,0,0,3
Brisbane Lions,"Jansen, Jarrad",19,5,2,14,0,0,0,3
Brisbane Lions,"Keays, Ben",13,2,0,11,0,0,0,3
Brisbane Lions,"Lester, Ryan",6,2,4,4,0,1,0,3
Brisbane Lions,"Martin, Stefan",17,6,3,11,0,0,51,3
Brisbane Lions,"Mayes, Sam",23,13,8,10,0,0,0,2
Brisbane Lions,"Merrett, Daniel",11,5,3,6,0,0,0,0
Brisbane Lions,"Paparone, Marco",18,11,6,7,0,0,0,4
Brisbane Lions,"Rich, Daniel",20,16,9,4,0,0,0,3
Brisbane Lions,"Robinson, Mitch",39,15,2,24,1,0,0,6
Brisbane Lions,"Rockliff, Tom",38,15,2,23,0,0,0,10
Brisbane Lions,"Schache, Josh",15,13,9,2,2,3,0,1
Brisbane Lions,"Taylor, Lewis",21,9,5,12,1,3,0,2
Brisbane Lions,"Walker, Josh",16,11,9,5,4,0,5,2
Brisbane Lions,"Zorko, Dayne",31,19,11,12,0,1,0,8
Brisbane Lions,"Andrews, Harris",8,5,5,3,0,0,0,0
Brisbane Lions,"Bastinac, Ryan",28,16,5,12,0,1,0,1
Brisbane Lions,"Bewick, Rohan",17,14,6,3,0,2,0,3
Brisbane Lions,"Gardiner, Darcy",6,4,3,2,0,0,0,2
Brisbane Lions,"Green, Josh",14,9,2,5,1,0,0,7
Brisbane Lions,"Hammelmann, Matthew",10,7,5,3,0,0,0,0
Brisbane Lions,"Hanley, Pearce",10,4,3,6,1,0,0,2
Brisbane Lions,"Hipwood, Eric",7,6,3,1,3,2,0,2
Brisbane Lions,"Jansen, Jarrad",16,6,3,10,1,0,0,1
Brisbane Lions,"Keays, Ben",6,2,1,4,0,0,0,4
Brisbane Lions,"Lester, Ryan",19,8,4,11,0,0,0,2
Brisbane Lions,"Martin, Stefan",23,8,4,15,1,1,21,2
Brisbane Lions,"Mathieson, Rhys",24,9,3,15,0,0,0,7
Brisbane Lions,"Mayes, Sam",27,19,5,8,0,0,1,1
Brisbane Lions,"McStay, Daniel",12,5,5,7,0,0,0,1
Brisbane Lions,"Merrett, Daniel",4,2,2,2,0,0,0,2
Brisbane Lions,"Rich, Daniel",25,13,6,12,0,1,0,4
Brisbane Lions,"Robinson, Mitch",5,3,0,2,0,0,0,2
Brisbane Lions,"Rockliff, Tom",30,10,0,20,0,0,0,9
Brisbane Lions,"Schache, Josh",8,5,4,3,1,0,0,2
Brisbane Lions,"Taylor, Lewis",15,9,2,6,2,1,0,0
Brisbane Lions,"Walker, Josh",10,4,3,6,1,1,2,1
Brisbane Lions,"Andrews, Harris",10,6,3,4,2,1,3,3
Brisbane Lions,"Bastinac, Ryan",12,7,0,5,0,1,0,3
Brisbane Lions,"Bewick, Rohan",15,12,3,3,1,0,0,4
Brisbane Lions,"Gardiner, Darcy",8,1,1,7,0,0,0,0
Brisbane Lions,"Green, Josh",17,8,4,9,1,3,0,1
Brisbane Lions,"Hammelmann, Matthew",10,5,3,5,0,0,0,2
Brisbane Lions,"Hanley, Pearce",23,12,5,11,0,1,2,4
Brisbane Lions,"Hipwood, Eric",10,8,3,2,4,1,1,0
Brisbane Lions,"Jansen, Jarrad",14,4,2,10,2,0,0,4
Brisbane Lions,"Lester, Ryan",18,8,4,10,1,1,0,2
Brisbane Lions,"Martin, Stefan",19,13,5,6,0,1,30,2
Brisbane Lions,"Mathieson, Rhys",24,10,1,14,0,0,0,4
Brisbane Lions,"Mayes, Sam",21,16,3,5,0,0,0,4
Brisbane Lions,"McStay, Daniel",11,5,4,6,2,0,2,1
Brisbane Lions,"Merrett, Daniel",9,4,4,5,0,0,0,0
Brisbane Lions,"Rich, Daniel",12,7,3,5,2,0,0,2
Brisbane Lions,"Robinson, Mitch",21,9,5,12,0,0,1,8
Brisbane Lions,"Rockliff, Tom",28,7,1,21,0,0,0,10
Brisbane Lions,"Schache, Josh",8,5,2,3,1,1,0,0
Brisbane Lions,"Taylor, Lewis",11,4,3,7,0,0,0,3
Brisbane Lions,"William, Reuben",13,5,2,8,0,0,0,3
Brisbane Lions,"Zorko, Dayne",19,8,1,11,1,0,0,8
Brisbane Lions,"Andrews, Harris",8,3,0,5,0,0,6,5
Brisbane Lions,"Bastinac, Ryan",11,6,1,5,0,0,0,2
Brisbane Lions,"Bewick, Rohan",7,4,2,3,1,0,0,0
Brisbane Lions,"Cutler, Tom",15,4,0,11,0,0,0,4
Brisbane Lions,"Gardiner, Darcy",13,5,1,8,0,0,0,4
Brisbane Lions,"Green, Josh",18,9,2,9,0,1,0,5
Brisbane Lions,"Hammelmann, Matthew",9,8,2,1,0,0,0,2
Brisbane Lions,"Hanley, Pearce",23,15,5,8,1,1,3,2
Brisbane Lions,"Hipwood, Eric",11,9,5,2,1,2,0,2
Brisbane Lions,"Jansen, Jarrad",10,4,2,6,0,0,0,5
Brisbane Lions,"Keays, Ben",12,5,0,7,0,0,0,4
Brisbane Lions,"Lester, Ryan",8,3,1,5,0,0,0,7
Brisbane Lions,"Martin, Stefan",22,13,1,9,0,0,32,5
Brisbane Lions,"Mathieson, Rhys",16,9,1,7,1,1,0,4
Brisbane Lions,"Mayes, Sam",21,14,2,7,0,0,0,3
Brisbane Lions,"McStay, Daniel",7,4,0,3,0,0,0,4
Brisbane Lions,"Rich, Daniel",19,10,5,9,0,0,0,3
Brisbane Lions,"Robinson, Mitch",21,9,2,12,0,0,0,5
Brisbane Lions,"Rockliff, Tom",34,23,2,11,2,1,0,5
Brisbane Lions,"Schache, Josh",5,4,3,1,2,1,0,1
Brisbane Lions,"William, Reuben",11,4,2,7,0,0,0,3
Brisbane Lions,"Zorko, Dayne",28,21,6,7,1,3,0,6
Brisbane Lions,"Andrews, Harris",5,3,3,2,0,0,1,3
Brisbane Lions,"Bastinac, Ryan",30,19,6,11,1,0,0,3
Brisbane Lions,"Bewick, Rohan",13,9,3,4,1,0,0,0
Brisbane Lions,"Cutler, Tom",16,12,6,4,2,1,0,2
Brisbane Lions,"Dawson, Liam",13,9,6,4,2,0,0,0
Brisbane Lions,"Gardiner, Darcy",11,4,4,7,0,1,0,3
Brisbane Lions,"Green, Josh",15,10,2,5,2,2,0,1
Brisbane Lions,"Hammelmann, Matthew",6,2,1,4,0,0,0,5
Brisbane Lions,"Hanley, Pearce",31,20,4,11,1,0,1,6
Brisbane Lions,"Hipwood, Eric",12,6,4,6,1,1,0,1
Brisbane Lions,"Keays, Ben",8,1,1,7,0,0,0,4
Brisbane Lions,"Martin, Stefan",25,11,4,14,1,1,29,5
Brisbane Lions,"Mathieson, Rhys",17,9,2,8,2,0,0,4
Brisbane Lions,"Mayes, Sam",23,12,0,11,1,0,0,1
Brisbane Lions,"Merrett, Daniel",10,1,2,9,0,0,0,0
Brisbane Lions,"Rich, Daniel",27,22,5,5,1,0,0,2
Brisbane Lions,"Robinson, Mitch",17,7,0,10,0,0,0,1
Brisbane Lions,"Rockliff, Tom",38,24,12,14,1,0,0,9
Brisbane Lions,"Schache, Josh",8,3,5,5,0,1,0,6
Brisbane Lions,"Walker, Josh",8,6,4,2,4,0,4,2
Brisbane Lions,"William, Reuben",11,6,2,5,0,0,0,1
Brisbane Lions,"Zorko, Dayne",28,15,4,13,0,0,0,6
Brisbane Lions,"Andrews, Harris",8,2,3,6,0,0,0,0
Brisbane Lions,"Bastinac, Ryan",18,9,1,9,0,1,0,2
Brisbane Lions,"Close, Michael",7,4,2,3,2,0,0,2
Brisbane Lions,"Cutler, Tom",14,12,4,2,0,1,0,3
Brisbane Lions,"Dawson, Liam",9,5,3,4,1,0,0,2
Brisbane Lions,"Green, Josh",15,9,0,6,1,1,0,2
Brisbane Lions,"Hammelmann, Matthew",4,3,2,1,0,0,0,5
Brisbane Lions,"Hanley, Pearce",15,8,2,7,0,1,3,3
Brisbane Lions,"Hipwood, Eric",6,4,4,2,1,3,1,1
Brisbane Lions,"Keays, Ben",12,4,1,8,0,0,0,4
Brisbane Lions,"Lester, Ryan",16,10,4,6,0,0,0,0
Brisbane Lions,"Mathieson, Rhys",20,11,4,9,0,0,0,2
Brisbane Lions,"Mayes, Sam",14,12,4,2,0,0,0,2
Brisbane Lions,"Merrett, Daniel",6,2,0,4,0,0,0,2
Brisbane Lions,"Rich, Daniel",24,17,2,7,0,0,0,2
Brisbane Lions,"Robertson, Nick",10,6,5,4,1,0,0,4
Brisbane Lions,"Robinson, Mitch",14,6,0,8,0,0,0,11
Brisbane Lions,"Rockliff, Tom",26,10,1,16,1,0,0,1
Brisbane Lions,"Smith, Archie",19,2,1,17,0,0,30,5
Brisbane Lions,"Taylor, Lewis",9,5,2,4,0,1,0,2
Brisbane Lions,"Walker, Josh",7,4,3,3,2,0,6,1
Brisbane Lions,"Zorko, Dayne",16,8,2,8,2,0,0,7
Brisbane Lions,"Andrews, Harris",14,9,6,5,0,0,0,3
Brisbane Lions,"Bastinac, Ryan",27,14,3,13,0,0,0,12
Brisbane Lions,"Dawson, Liam",7,7,1,0,0,0,0,2
Brisbane Lions,"Gardiner, Darcy",11,8,2,3,0,0,0,1
Brisbane Lions,"Green, Josh",10,7,1,3,0,0,0,2
Brisbane Lions,"Hammelmann, Matthew",7,6,2,1,0,0,0,3
Brisbane Lions,"Hanley, Pearce",14,7,0,7,0,0,3,6
Brisbane Lions,"Hipwood, Eric",12,6,2,6,0,1,0,0
Brisbane Lions,"Keays, Ben",18,5,2,13,0,0,0,5
Brisbane Lions,"Lester, Ryan",7,6,3,1,0,0,0,5
Brisbane Lions,"Mathieson, Rhys",20,7,1,13,2,0,0,2
Brisbane Lions,"Mayes, Sam",11,9,2,2,0,0,0,1
Brisbane Lions,"Merrett, Daniel",8,3,3,5,0,0,0,0
Brisbane Lions,"Rich, Daniel",19,12,1,7,1,0,0,3
Brisbane Lions,"Robertson, Nick",3,2,1,1,0,0,0,0
Brisbane Lions,"Robinson, Mitch",19,9,2,10,1,1,1,2
Brisbane Lions,"Rockliff, Tom",31,16,2,15,1,0,0,9
Brisbane Lions,"Schache, Josh",3,0,0,3,0,0,0,1
Brisbane Lions,"Smith, Archie",15,6,1,9,0,0,32,3
Brisbane Lions,"Taylor, Lewis",10,3,1,7,1,0,0,2
Brisbane Lions,"Walker, Josh",4,2,1,2,0,1,8,1
Brisbane Lions,"Zorko, Dayne",14,5,1,9,0,0,0,12
Brisbane Lions,"Andrews, Harris",10,5,1,5,0,0,0,4
Brisbane Lions,"Bastinac, Ryan",22,12,4,10,0,1,1,3
Brisbane Lions,"Close, Michael",9,6,5,3,4,0,0,5
Brisbane Lions,"Cutler, Tom",18,12,4,6,1,0,0,3
Brisbane Lions,"Gardiner, Darcy",11,8,1,3,0,0,0,3
Brisbane Lions,"Hammelmann, Matthew",6,4,1,2,0,0,0,2
Brisbane Lions,"Hanley, Pearce",13,7,4,6,1,0,3,6
Brisbane Lions,"Hipwood, Eric",8,4,1,4,0,2,0,1
Brisbane Lions,"Jansen, Jarrad",12,4,4,8,0,0,0,2
Brisbane Lions,"Keays, Ben",8,5,1,3,0,0,0,3
Brisbane Lions,"Lester, Ryan",8,4,4,4,1,0,0,5
Brisbane Lions,"Martin, Stefan",9,6,5,3,0,1,25,1
Brisbane Lions,"Mathieson, Rhys",16,9,2,7,0,0,0,5
Brisbane Lions,"Mayes, Sam",13,10,6,3,0,0,0,2
Brisbane Lions,"Merrett, Daniel",8,5,3,3,0,0,0,0
Brisbane Lions,"Rich, Daniel",13,9,3,4,1,1,0,1
Brisbane Lions,"Robinson, Mitch",22,16,2,6,0,0,1,11
Brisbane Lions,"Rockliff, Tom",39,24,5,15,2,0,0,12
Brisbane Lions,"Smith, Archie",6,2,1,4,1,1,8,2
Brisbane Lions,"Taylor, Lewis",10,6,1,4,0,0,0,3
Brisbane Lions,"Walker, Josh",7,2,3,5,1,0,0,1
Brisbane Lions,"Zorko, Dayne",27,21,7,6,3,0,0,4
Brisbane Lions,"Andrews, Harris",19,13,9,6,0,0,1,2
Brisbane Lions,"Bastinac, Ryan",22,6,2,16,0,0,0,3
Brisbane Lions,"Bell, Tom",12,8,6,4,2,1,0,0
Brisbane Lions,"Clayton, Josh",6,3,1,3,0,1,0,2
Brisbane Lions,"Cutler, Tom",24,17,5,7,1,0,0,2
Brisbane Lions,"Gardiner, Darcy",13,6,1,7,0,0,0,3
Brisbane Lions,"Hammelmann, Matthew",10,3,3,7,0,0,0,1
Brisbane Lions,"Hanley, Pearce",19,10,5,9,0,1,0,1
Brisbane Lions,"Hipwood, Eric",10,6,2,4,0,2,0,1
Brisbane Lions,"Keays, Ben",11,4,3,7,0,0,0,4
Brisbane Lions,"Lester, Ryan",9,3,2,6,0,0,0,2
Brisbane Lions,"Martin, Stefan",18,8,6,10,0,0,33,4
Brisbane Lions,"Mathieson, Rhys",19,11,4,8,1,0,1,4
Brisbane Lions,"Mayes, Sam",18,9,5,9,0,0,0,1
Brisbane Lions,"Merrett, Daniel",16,11,7,5,0,0,0,5
Brisbane Lions,"Paine, Jackson",5,1,3,4,0,0,0,2
Brisbane Lions,"Rich, Daniel",24,13,3,11,2,0,0,7
Brisbane Lions,"Robinson, Mitch",22,12,4,10,1,0,0,7
Brisbane Lions,"Rockliff, Tom",27,20,7,7,1,1,0,5
Brisbane Lions,"Taylor, Lewis",15,9,6,6,1,0,0,3
Brisbane Lions,"Walker, Josh",9,6,2,3,1,0,8,2
Brisbane Lions,"Zorko, Dayne",16,10,6,6,0,2,0,1
Brisbane Lions,"Andrews, Harris",8,5,4,3,0,0,0,1
Brisbane Lions,"Bastinac, Ryan",16,10,1,6,0,0,0,4
Brisbane Lions,"Bell, Tom",17,10,6,7,1,0,0,2
Brisbane Lions,"Clayton, Josh",6,5,4,1,0,0,0,2
Brisbane Lions,"Cutler, Tom",27,16,4,11,0,1,0,1
Brisbane Lions,"Dawson, Liam",7,5,4,2,2,0,0,2
Brisbane Lions,"Gardiner, Darcy",10,6,3,4,0,0,0,3
Brisbane Lions,"Hammelmann, Matthew",4,3,2,1,0,0,0,3
Brisbane Lions,"Hanley, Pearce",16,9,7,7,1,1,2,2
Brisbane Lions,"Hipwood, Eric",10,5,4,5,0,2,0,0
Brisbane Lions,"Keays, Ben",14,4,2,10,1,0,0,2
Brisbane Lions,"Lester, Ryan",15,5,4,10,0,0,0,2
Brisbane Lions,"Martin, Stefan",21,9,6,12,0,0,36,0
Brisbane Lions,"Mathieson, Rhys",17,6,2,11,2,1,0,4
Brisbane Lions,"Mayes, Sam",17,10,2,7,0,0,0,1
Brisbane Lions,"Merrett, Daniel",7,5,3,2,1,0,0,2
Brisbane Lions,"Rich, Daniel",22,11,5,11,1,0,0,1
Brisbane Lions,"Robinson, Mitch",24,10,5,14,0,0,0,4
Brisbane Lions,"Rockliff, Tom",37,18,3,19,2,0,0,4
Brisbane Lions,"Taylor, Lewis",14,3,4,11,0,0,0,1
Brisbane Lions,"Walker, Josh",16,9,9,7,3,1,0,2
Brisbane Lions,"Zorko, Dayne",30,20,3,10,1,1,0,4
Carlton,"Boekhorst, Blaine",15,11,6,4,0,1,0,3
Carlton,"Buckley, Dylan",3,2,3,1,0,0,0,3
Carlton,"Casboult, Levi",12,8,7,4,0,2,1,2
Carlton,"Cripps, Patrick",27,8,4,19,1,1,1,3
Carlton,"Curnow, Ed",20,9,1,11,0,0,0,4
Carlton,"Docherty, Sam",29,13,6,16,0,0,0,2
Carlton,"Everitt, Andrejs",17,8,5,9,2,0,0,2
Carlton,"Gibbs, Bryce",30,15,6,15,1,0,2,7
Carlton,"Graham, Nick",23,13,7,10,0,1,0,3
Carlton,"Jamison, Michael",9,4,3,5,0,0,0,0
Carlton,"Kerridge, Sam",24,16,7,8,0,1,0,2
Carlton,"Kreuzer, Matthew",10,5,2,5,1,0,16,3
Carlton,"Lamb, Jed",13,9,2,4,1,0,0,1
Carlton,"Murphy, Marc",27,16,7,11,1,1,0,6
Carlton,"Phillips, Andrew",5,3,2,2,1,0,21,2
Carlton,"Rowe, Sam",12,7,6,5,0,0,0,0
Carlton,"Simpson, Kade",31,21,10,10,0,0,0,1
Carlton,"Tuohy, Zach",18,13,5,5,0,0,0,1
Carlton,"Walker, Andrew",9,7,4,2,1,1,0,1
Carlton,"Weitering, Jacob",17,12,7,5,0,0,0,1
Carlton,"White, Simon",13,8,2,5,0,0,0,1
Carlton,"Wright, Matthew",12,7,3,5,3,1,0,3
Carlton,"Boekhorst, Blaine",10,5,6,5,1,1,0,1
Carlton,"Casboult, Levi",8,5,5,3,2,0,0,0
Carlton,"Cripps, Patrick",18,9,3,9,0,1,2,10
Carlton,"Curnow, Charlie",11,6,4,5,1,1,0,1
Carlton,"Curnow, Ed",24,14,3,10,0,0,0,10
Carlton,"Docherty, Sam",21,10,8,11,0,0,0,2
Carlton,"Everitt, Andrejs",7,5,5,2,1,0,0,1
Carlton,"Gibbs, Bryce",25,13,3,12,1,0,1,1
Carlton,"Graham, Nick",21,9,3,12,0,2,0,4
Carlton,"Jamison, Michael",6,2,1,4,0,0,0,4
Carlton,"Kerridge, Sam",22,11,4,11,2,1,0,2
Carlton,"Kreuzer, Matthew",6,3,1,3,1,1,25,4
Carlton,"Lamb, Jed",11,7,3,4,0,1,0,0
Carlton,"Murphy, Marc",20,11,5,9,1,1,0,4
Carlton,"Phillips, Andrew",3,2,0,1,0,0,18,3
Carlton,"Rowe, Sam",7,4,4,3,0,0,0,1
Carlton,"Simpson, Kade",25,16,9,9,0,0,0,1
Carlton,"Thomas, Dale",25,13,4,12,0,1,0,8
Carlton,"Tuohy, Zach",24,15,4,9,0,0,0,1
Carlton,"Weitering, Jacob",15,8,6,7,0,0,0,0
Carlton,"White, Simon",13,7,3,6,0,0,0,2
Carlton,"Wright, Matthew",26,12,1,14,0,0,0,2
Carlton,"Boekhorst, Blaine",13,7,3,6,0,0,0,1
Carlton,"Buckley, Dylan",11,4,2,7,0,1,0,2
Carlton,"Byrne, Ciaran",20,10,5,10,0,0,0,1
Carlton,"Casboult, Levi",9,6,5,3,1,2,0,1
Carlton,"Cripps, Patrick",23,9,1,14,1,1,1,8
Carlton,"Curnow, Charlie",10,7,3,3,1,1,0,1
Carlton,"Curnow, Ed",30,14,6,16,0,0,0,4
Carlton,"Docherty, Sam",22,11,8,11,0,0,0,5
Carlton,"Gibbs, Bryce",21,10,6,11,0,0,0,5
Carlton,"Graham, Nick",20,10,5,10,0,0,0,1
Carlton,"Jamison, Michael",12,5,4,7,0,0,0,2
Carlton,"Kerridge, Sam",21,11,4,10,0,1,1,3
Carlton,"Kreuzer, Matthew",11,5,1,6,0,0,23,3
Carlton,"Murphy, Marc",20,11,2,9,0,0,0,1
Carlton,"Phillips, Andrew",5,1,2,4,0,0,11,4
Carlton,"Rowe, Sam",8,4,2,4,0,0,1,0
Carlton,"Simpson, Kade",23,11,2,12,0,0,0,0
Carlton,"Thomas, Dale",17,8,3,9,0,1,0,3
Carlton,"Tuohy, Zach",19,14,3,5,1,0,0,1
Carlton,"Weitering, Jacob",26,17,9,9,0,0,0,2
Carlton,"Whiley, Mark",16,8,2,8,0,0,1,1
Carlton,"Wright, Matthew",23,11,4,12,1,1,0,4
Carlton,"Buckley, Dylan",12,8,3,4,1,0,0,2
Carlton,"Byrne, Ciaran",15,11,4,4,0,0,0,2
Carlton,"Casboult, Levi",8,5,6,3,0,0,0,4
Carlton,"Cripps, Patrick",23,12,4,11,1,2,3,8
Carlton,"Curnow, Charlie",15,8,3,7,0,0,0,3
Carlton,"Curnow, Ed",21,8,2,13,0,0,0,4
Carlton,"Docherty, Sam",25,18,10,7,0,1,0,4
Carlton,"Gibbs, Bryce",17,14,4,3,1,1,2,5
Carlton,"Graham, Nick",12,6,4,6,0,0,0,4
Carlton,"Kerridge, Sam",26,10,5,16,0,0,0,2
Carlton,"Kreuzer, Matthew",11,9,3,2,0,1,24,3
Carlton,"Lamb, Jed",13,11,6,2,1,0,0,1
Carlton,"Murphy, Marc",10,5,2,5,0,0,0,1
Carlton,"Phillips, Andrew",6,3,3,3,1,0,21,2
Carlton,"Plowman, Lachie",10,7,2,3,0,0,0,1
Carlton,"Rowe, Sam",9,4,4,5,0,0,0,0
Carlton,"Simpson, Kade",26,16,10,10,0,0,0,1
Carlton,"Sumner, Liam",7,4,2,3,2,0,0,2
Carlton,"Thomas, Dale",18,12,5,6,0,0,0,2
Carlton,"Tuohy, Zach",15,13,5,2,0,0,0,2
Carlton,"Weitering, Jacob",15,11,5,4,0,0,0,0
Carlton,"Wright, Matthew",22,14,5,8,0,0,0,4
Carlton,"Buckley, Dylan",7,3,1,4,0,1,0,2
Carlton,"Byrne, Ciaran",19,10,5,9,0,0,0,1
Carlton,"Casboult, Levi",16,8,6,8,0,2,0,2
Carlton,"Cripps, Patrick",29,9,2,20,0,0,1,5
Carlton,"Curnow, Charlie",11,7,3,4,1,0,0,1
Carlton,"Curnow, Ed",31,12,3,19,0,2,0,6
Carlton,"Docherty, Sam",15,11,4,4,0,0,0,2
Carlton,"Gibbs, Bryce",27,11,4,16,1,2,1,6
Carlton,"Jones, Liam",8,6,3,2,2,1,0,2
Carlton,"Kerridge, Sam",28,13,5,15,0,1,0,5
Carlton,"Kreuzer, Matthew",5,3,1,2,0,0,24,5
Carlton,"Lamb, Jed",10,6,3,4,1,1,0,3
Carlton,"Murphy, Marc",28,12,3,16,1,1,0,6
Carlton,"Phillips, Andrew",5,4,1,1,0,0,19,2
Carlton,"Plowman, Lachie",9,4,0,5,0,0,0,4
Carlton,"Rowe, Sam",9,3,3,6,0,0,0,4
Carlton,"Simpson, Kade",30,19,7,11,0,0,0,1
Carlton,"Sumner, Liam",10,7,2,3,0,0,0,3
Carlton,"Thomas, Dale",15,7,1,8,3,0,0,5
Carlton,"Tuohy, Zach",10,6,1,4,0,0,0,3
Carlton,"Weitering, Jacob",11,6,3,5,0,0,0,1
Carlton,"Wright, Matthew",23,14,5,9,1,0,0,8
Carlton,"Armfield, Dennis",14,8,2,6,1,2,0,2
Carlton,"Byrne, Ciaran",18,11,5,7,0,0,0,1
Carlton,"Casboult, Levi",10,6,6,4,0,0,0,2
Carlton,"Curnow, Ed",26,18,7,8,0,1,0,2
Carlton,"Docherty, Sam",22,15,7,7,0,0,0,2
Carlton,"Gibbs, Bryce",32,19,6,13,1,0,5,4
Carlton,"Graham, Nick",22,13,7,9,0,0,0,8
Carlton,"Jones, Liam",9,4,2,5,1,1,0,2
Carlton,"Kerridge, Sam",19,11,10,8,0,1,1,4
Carlton,"Kreuzer, Matthew",12,7,4,5,0,1,15,5
Carlton,"Lamb, Jed",13,9,5,4,1,1,0,4
Carlton,"Murphy, Marc",26,13,7,13,1,0,1,2
Carlton,"Phillips, Andrew",11,7,6,4,1,0,17,2
Carlton,"Plowman, Lachie",12,3,3,9,0,0,0,3
Carlton,"Rowe, Sam",9,1,2,8,0,0,0,2
Carlton,"Simpson, Kade",25,18,9,7,0,0,0,1
Carlton,"Sumner, Liam",9,8,4,1,1,1,0,3
Carlton,"Thomas, Dale",31,20,6,11,1,0,0,7
Carlton,"Tuohy, Zach",16,8,5,8,0,0,0,1
Carlton,"Weitering, Jacob",8,5,2,3,0,0,0,0
Carlton,"White, Simon",15,9,6,6,0,0,0,5
Carlton,"Wright, Matthew",19,14,4,5,2,1,0,5
Carlton,"Armfield, Dennis",11,5,1,6,0,0,0,2
Carlton,"Byrne, Ciaran",14,8,3,6,0,1,0,4
Carlton,"Casboult, Levi",17,14,11,3,3,1,4,1
Carlton,"Cripps, Patrick",29,4,3,25,0,0,1,6
Carlton,"Curnow, Ed",24,10,2,14,0,0,0,13
Carlton,"Docherty, Sam",24,16,8,8,0,0,0,5
Carlton,"Everitt, Andrejs",20,14,8,6,3,1,0,1
Carlton,"Gibbs, Bryce",30,16,3,14,3,0,3,8
Carlton,"Jamison, Michael",3,1,0,2,0,0,0,3
Carlton,"Jones, Liam",8,5,3,3,1,0,0,1
Carlton,"Kerridge, Sam",24,8,3,16,1,0,0,5
Carlton,"Kreuzer, Matthew",13,6,1,7,0,0,20,3
Carlton,"Lamb, Jed",19,10,3,9,1,0,0,2
Carlton,"Murphy, Marc",24,17,1,7,1,0,0,3
Carlton,"Plowman, Lachie",8,3,3,5,0,0,0,0
Carlton,"Rowe, Sam",8,3,3,5,0,0,0,2
Carlton,"Simpson, Kade",31,14,7,17,0,0,0,2
Carlton,"Sumner, Liam",11,7,3,4,1,1,0,3
Carlton,"Thomas, Dale",21,16,7,5,1,1,0,3
Carlton,"Tuohy, Zach",16,12,3,4,0,1,1,1
Carlton,"Walker, Andrew",3,3,2,0,0,1,1,4
Carlton,"Wright, Matthew",23,12,2,11,0,0,0,1
Carlton,"Armfield, Dennis",16,8,4,8,0,2,0,2
Carlton,"Byrne, Ciaran",9,6,3,3,0,0,0,1
Carlton,"Casboult, Levi",0,0,1,0,0,0,0,0
Carlton,"Cripps, Patrick",30,9,5,21,0,1,1,7
Carlton,"Curnow, Ed",27,15,5,12,0,0,0,7
Carlton,"Docherty, Sam",33,22,13,11,0,0,0,4
Carlton,"Everitt, Andrejs",17,8,6,9,3,1,1,2
Carlton,"Gibbs, Bryce",30,18,5,12,1,0,3,7
Carlton,"Jamison, Michael",7,6,6,1,0,0,0,1
Carlton,"Jones, Liam",8,8,6,0,2,2,0,1
Carlton,"Kerridge, Sam",15,6,4,9,0,0,2,3
Carlton,"Kreuzer, Matthew",15,8,6,7,2,0,38,2
Carlton,"Lamb, Jed",13,9,3,4,2,1,0,4
Carlton,"Murphy, Marc",26,14,3,12,1,0,0,3
Carlton,"Plowman, Lachie",17,13,9,4,0,0,0,4
Carlton,"Rowe, Sam",13,10,8,3,1,1,12,0
Carlton,"Simpson, Kade",25,20,10,5,0,0,0,4
Carlton,"Sumner, Liam",11,6,2,5,1,0,0,4
Carlton,"Thomas, Dale",17,10,4,7,0,0,0,3
Carlton,"Tuohy, Zach",20,10,3,10,1,0,0,4
Carlton,"Walker, Andrew",15,10,1,5,0,0,2,3
Carlton,"Wright, Matthew",21,10,5,11,0,0,0,4
Carlton,"Armfield, Dennis",13,6,4,7,0,0,0,1
Carlton,"Byrne, Ciaran",23,13,7,10,0,0,0,2
Carlton,"Cripps, Patrick",28,7,5,21,0,0,1,6
Carlton,"Curnow, Ed",22,11,1,11,0,1,0,4
Carlton,"Docherty, Sam",29,18,8,11,0,0,0,1
Carlton,"Everitt, Andrejs",10,2,2,8,0,0,0,1
Carlton,"Gibbs, Bryce",29,15,6,14,0,2,5,4
Carlton,"Gorringe, Daniel",13,7,3,6,1,0,7,1
Carlton,"Jones, Liam",12,3,1,9,2,1,0,2
Carlton,"Kerridge, Sam",29,14,4,15,0,1,1,4
Carlton,"Lamb, Jed",8,6,2,2,0,1,0,1
Carlton,"Murphy, Marc",22,13,7,9,0,0,0,4
Carlton,"Plowman, Lachie",15,12,6,3,0,0,0,2
Carlton,"Rowe, Sam",6,3,1,3,0,0,5,1
Carlton,"Simpson, Kade",23,15,6,8,1,0,0,3
Carlton,"Sumner, Liam",13,10,0,3,0,2,0,3
Carlton,"Thomas, Dale",16,12,6,4,1,0,1,1
Carlton,"Tuohy, Zach",19,12,6,7,0,0,0,2
Carlton,"Walker, Andrew",8,7,6,1,1,0,0,2
Carlton,"Weitering, Jacob",11,6,6,5,0,0,0,0
Carlton,"White, Simon",8,2,2,6,0,0,0,2
Carlton,"Wright, Matthew",23,9,4,14,0,0,0,4
Carlton,"Armfield, Dennis",17,10,1,7,3,1,0,3
Carlton,"Casboult, Levi",8,6,4,2,1,1,0,1
Carlton,"Cripps, Patrick",30,9,1,21,0,0,3,7
Carlton,"Curnow, Ed",29,14,6,15,1,0,0,9
Carlton,"Docherty, Sam",30,18,8,12,0,0,0,0
Carlton,"Everitt, Andrejs",20,13,7,7,4,1,0,0
Carlton,"Gibbs, Bryce",34,17,3,17,2,1,2,7
Carlton,"Gorringe, Daniel",14,7,2,7,2,0,8,2
Carlton,"Kerridge, Sam",14,5,1,9,0,0,0,7
Carlton,"Kreuzer, Matthew",15,9,1,6,0,0,17,12
Carlton,"Lamb, Jed",15,10,5,5,1,2,0,4
Carlton,"Murphy, Marc",2,2,1,0,1,0,0,0
Carlton,"Plowman, Lachie",16,10,6,6,0,0,0,3
Carlton,"Rowe, Sam",5,3,1,2,0,0,0,2
Carlton,"Simpson, Kade",27,17,6,10,0,0,0,4
Carlton,"Sumner, Liam",1,0,0,1,0,0,0,0
Carlton,"Thomas, Dale",17,11,6,6,0,0,0,3
Carlton,"Tuohy, Zach",21,11,5,10,0,0,0,3
Carlton,"Walker, Andrew",18,10,6,8,1,0,1,4
Carlton,"Weitering, Jacob",17,9,8,8,0,0,0,1
Carlton,"White, Simon",20,14,6,6,0,0,0,4
Carlton,"Wright, Matthew",18,6,1,12,0,2,0,4
Carlton,"Armfield, Dennis",19,11,5,8,3,0,0,2
Carlton,"Byrne, Ciaran",18,9,4,9,0,0,0,2
Carlton,"Casboult, Levi",7,5,5,2,1,0,0,3
Carlton,"Cripps, Patrick",26,10,4,16,2,0,2,2
Carlton,"Curnow, Ed",28,16,3,12,1,0,0,12
Carlton,"Docherty, Sam",20,12,8,8,0,0,0,3
Carlton,"Everitt, Andrejs",11,7,4,4,0,1,0,0
Carlton,"Gibbs, Bryce",12,7,1,5,0,1,0,6
Carlton,"Gorringe, Daniel",18,7,7,11,1,1,12,3
Carlton,"Graham, Nick",16,6,6,10,0,0,1,7
Carlton,"Kerridge, Sam",30,17,16,13,1,0,0,2
Carlton,"Kreuzer, Matthew",2,2,0,0,0,0,12,3
Carlton,"Lamb, Jed",13,9,4,4,3,0,0,3
Carlton,"Plowman, Lachie",16,5,3,11,0,0,0,1
Carlton,"Rowe, Sam",7,4,3,3,1,0,4,0
Carlton,"Simpson, Kade",24,15,9,9,0,0,0,3
Carlton,"Thomas, Dale",15,7,3,8,0,0,0,3
Carlton,"Tuohy, Zach",23,15,4,8,1,0,0,3
Carlton,"Walker, Andrew",16,8,3,8,0,3,0,4
Carlton,"Weitering, Jacob",24,16,14,8,0,0,0,3
Carlton,"White, Simon",15,7,3,8,0,0,0,2
Carlton,"Wright, Matthew",15,10,4,5,2,0,0,3
Carlton,"Armfield, Dennis",17,11,2,6,0,0,0,3
Carlton,"Byrne, Ciaran",14,6,5,8,0,0,0,1
Carlton,"Casboult, Levi",8,6,6,2,3,0,0,1
Carlton,"Cripps, Patrick",26,5,2,21,0,0,1,6
Carlton,"Curnow, Ed",29,14,5,15,0,1,0,7
Carlton,"Docherty, Sam",29,20,8,9,0,0,0,3
Carlton,"Everitt, Andrejs",12,8,5,4,1,2,1,1
Carlton,"Gibbs, Bryce",27,13,2,14,1,0,5,0
Carlton,"Gorringe, Daniel",7,6,5,1,0,2,9,2
Carlton,"Kerridge, Sam",27,8,8,19,0,0,0,1
Carlton,"Kreuzer, Matthew",13,8,0,5,0,0,18,2
Carlton,"Lamb, Jed",15,9,3,6,1,0,0,2
Carlton,"Plowman, Lachie",15,9,8,6,0,0,0,0
Carlton,"Rowe, Sam",13,6,6,7,0,0,1,2
Carlton,"Simpson, Kade",30,18,8,12,1,0,0,3
Carlton,"Sumner, Liam",13,8,4,5,0,0,0,4
Carlton,"Thomas, Dale",31,20,9,11,0,0,0,1
Carlton,"Tuohy, Zach",23,10,5,13,0,0,0,0
Carlton,"Walker, Andrew",10,7,2,3,3,1,0,1
Carlton,"Weitering, Jacob",16,11,6,5,0,0,0,1
Carlton,"White, Simon",14,3,2,11,0,0,0,0
Carlton,"Wright, Matthew",27,16,7,11,2,0,0,2
Carlton,"Byrne, Ciaran",15,9,3,6,0,0,0,8
Carlton,"Casboult, Levi",12,6,7,6,0,1,1,0
Carlton,"Cripps, Patrick",19,8,4,11,0,0,1,4
Carlton,"Curnow, Ed",26,17,4,9,0,1,0,5
Carlton,"Docherty, Sam",30,23,3,7,0,0,0,3
Carlton,"Everitt, Andrejs",16,5,4,11,1,1,2,3
Carlton,"Gibbs, Bryce",29,19,3,10,0,0,1,9
Carlton,"Kerridge, Sam",22,5,1,17,0,2,1,3
Carlton,"Kreuzer, Matthew",12,4,1,8,0,0,28,4
Carlton,"Lamb, Jed",9,5,4,4,0,0,0,5
Carlton,"Phillips, Andrew",4,2,2,2,0,0,16,2
Carlton,"Plowman, Lachie",15,8,6,7,0,0,0,3
Carlton,"Rowe, Sam",5,1,3,4,0,0,1,1
Carlton,"Simpson, Kade",18,12,7,6,1,0,0,7
Carlton,"Sumner, Liam",11,6,2,5,0,0,0,2
Carlton,"Thomas, Dale",15,9,3,6,0,0,0,4
Carlton,"Tuohy, Zach",18,12,3,6,0,0,0,3
Carlton,"Tutt, Jason",18,10,4,8,1,0,0,4
Carlton,"Walker, Andrew",15,11,3,4,3,1,0,2
Carlton,"Weitering, Jacob",11,5,4,6,0,0,0,3
Carlton,"White, Simon",17,9,8,8,1,1,0,4
Carlton,"Wright, Matthew",16,10,5,6,2,1,0,9
Carlton,"Byrne, Ciaran",19,10,4,9,0,0,0,1
Carlton,"Casboult, Levi",7,4,4,3,0,1,0,1
Carlton,"Cripps, Patrick",21,4,4,17,0,0,4,5
Carlton,"Curnow, Ed",23,12,5,11,0,0,0,12
Carlton,"Docherty, Sam",23,12,7,11,0,0,0,4
Carlton,"Everitt, Andrejs",10,7,5,3,0,0,2,2
Carlton,"Gibbs, Bryce",22,15,5,7,2,1,2,4
Carlton,"Kerridge, Sam",20,8,5,12,0,2,0,1
Carlton,"Kreuzer, Matthew",9,5,3,4,0,0,16,5
Carlton,"Lamb, Jed",20,12,7,8,1,0,0,3
Carlton,"Phillips, Andrew",12,6,2,6,1,0,9,1
Carlton,"Plowman, Lachie",14,3,5,11,0,0,0,3
Carlton,"Rowe, Sam",8,7,5,1,0,0,0,2
Carlton,"Silvagni, Jack",15,11,6,4,0,1,0,4
Carlton,"Simpson, Kade",28,21,6,7,0,0,0,2
Carlton,"Sumner, Liam",6,6,3,0,0,0,0,3
Carlton,"Thomas, Dale",22,13,4,9,0,0,1,1
Carlton,"Tuohy, Zach",12,9,3,3,0,0,0,4
Carlton,"Walker, Andrew",12,7,3,5,0,1,0,1
Carlton,"Weitering, Jacob",10,5,5,5,0,0,0,0
Carlton,"White, Simon",10,6,5,4,1,0,0,1
Carlton,"Wright, Matthew",24,16,5,8,1,0,0,2
Carlton,"Armfield, Dennis",17,10,8,7,4,1,0,2
Carlton,"Casboult, Levi",7,3,1,4,1,1,0,3
Carlton,"Cripps, Patrick",27,9,2,18,0,0,1,5
Carlton,"Curnow, Ed",19,8,2,11,0,0,0,10
Carlton,"Docherty, Sam",27,16,8,11,0,0,0,1
Carlton,"Everitt, Andrejs",12,6,5,6,0,0,0,1
Carlton,"Gibbs, Bryce",34,18,2,16,0,0,2,2
Carlton,"Kerridge, Sam",19,6,2,13,0,0,0,5
Carlton,"Kreuzer, Matthew",8,7,2,1,0,0,15,9
Carlton,"Lamb, Jed",9,7,1,2,0,2,0,3
Carlton,"Phillips, Andrew",9,5,2,4,0,0,19,0
Carlton,"Plowman, Lachie",10,6,4,4,0,0,0,2
Carlton,"Rowe, Sam",11,7,6,4,0,0,0,0
Carlton,"Silvagni, Jack",7,5,1,2,1,1,0,3
Carlton,"Simpson, Kade",21,16,6,5,0,0,0,3
Carlton,"Sumner, Liam",10,7,3,3,0,0,0,4
Carlton,"Thomas, Dale",12,7,4,5,0,0,0,4
Carlton,"Tuohy, Zach",26,21,6,5,0,0,0,0
Carlton,"Walker, Andrew",13,5,2,8,0,0,0,2
Carlton,"Weitering, Jacob",13,8,4,5,0,0,0,0
Carlton,"White, Simon",15,7,5,8,0,0,0,3
Carlton,"Wright, Matthew",24,16,0,8,1,0,0,4
Carlton,"Armfield, Dennis",21,10,5,11,0,0,0,0
Carlton,"Buckley, Dylan",17,10,5,7,1,0,0,5
Carlton,"Cripps, Patrick",29,9,3,20,1,2,3,6
Carlton,"Curnow, Charlie",7,4,3,3,1,0,0,2
Carlton,"Curnow, Ed",15,8,3,7,1,0,0,7
Carlton,"Docherty, Sam",32,21,12,11,0,0,0,3
Carlton,"Gibbs, Bryce",26,16,3,10,2,0,3,2
Carlton,"Graham, Nick",16,9,10,7,0,0,0,8
Carlton,"Jaksch, Kristian",8,7,2,1,0,0,0,2
Carlton,"Kerridge, Sam",27,12,6,15,1,0,0,5
Carlton,"Kreuzer, Matthew",12,5,0,7,0,0,17,5
Carlton,"Lamb, Jed",5,3,3,2,0,0,0,2
Carlton,"Phillips, Andrew",9,6,4,3,0,2,19,4
Carlton,"Plowman, Lachie",15,10,5,5,0,0,0,0
Carlton,"Rowe, Sam",6,4,2,2,0,0,0,3
Carlton,"Silvagni, Jack",12,9,6,3,1,2,0,0
Carlton,"Simpson, Kade",28,13,10,15,0,0,0,2
Carlton,"Sumner, Liam",6,3,2,3,0,1,0,2
Carlton,"Tuohy, Zach",19,11,2,8,0,0,0,1
Carlton,"Weitering, Jacob",7,4,4,3,2,0,0,1
Carlton,"White, Simon",23,12,10,11,0,0,1,4
Carlton,"Wright, Matthew",19,16,5,3,1,0,0,1
Carlton,"Armfield, Dennis",13,6,2,7,1,1,0,4
Carlton,"Boekhorst, Blaine",13,6,3,7,1,0,0,3
Carlton,"Buckley, Dylan",12,8,3,4,1,1,0,4
Carlton,"Casboult, Levi",11,3,3,8,1,0,0,0
Carlton,"Cripps, Patrick",32,10,4,22,0,0,4,13
Carlton,"Curnow, Charlie",6,3,2,3,1,0,0,1
Carlton,"Curnow, Ed",28,18,5,10,2,0,0,6
Carlton,"Docherty, Sam",30,22,11,8,0,1,0,2
Carlton,"Gibbs, Bryce",31,16,1,15,0,1,3,11
Carlton,"Graham, Nick",22,12,2,10,0,0,0,10
Carlton,"Kerridge, Sam",17,9,3,8,0,1,0,0
Carlton,"Kreuzer, Matthew",17,10,6,7,1,0,23,2
Carlton,"Phillips, Andrew",6,5,2,1,0,0,17,4
Carlton,"Plowman, Lachie",10,3,3,7,0,0,0,2
Carlton,"Rowe, Sam",7,6,3,1,0,0,0,2
Carlton,"Silvagni, Jack",5,2,0,3,1,0,0,3
Carlton,"Simpson, Kade",34,23,5,11,0,0,0,4
Carlton,"Sumner, Liam",13,5,1,8,1,0,0,2
Carlton,"Tuohy, Zach",21,13,0,8,0,0,0,3
Carlton,"Weitering, Jacob",14,5,4,9,0,0,0,2
Carlton,"White, Simon",14,5,2,9,0,0,0,4
Carlton,"Wright, Matthew",27,14,2,13,0,2,0,7
Carlton,"Armfield, Dennis",12,2,3,10,0,0,0,2
Carlton,"Boekhorst, Blaine",20,9,4,11,0,0,0,3
Carlton,"Buckley, Dylan",19,11,7,8,1,0,0,1
Carlton,"Casboult, Levi",9,5,6,4,0,1,0,0
Carlton,"Cripps, Patrick",31,9,4,22,1,0,2,3
Carlton,"Curnow, Ed",23,17,4,6,0,1,0,5
Carlton,"Docherty, Sam",25,15,7,10,0,0,0,1
Carlton,"Everitt, Andrejs",12,7,5,5,1,0,0,2
Carlton,"Gibbs, Bryce",21,12,3,9,1,0,1,9
Carlton,"Graham, Nick",18,8,2,10,0,1,0,3
Carlton,"Kerridge, Sam",16,10,4,6,0,0,0,5
Carlton,"Kreuzer, Matthew",14,8,3,6,1,2,14,2
Carlton,"Phillips, Andrew",8,6,5,2,0,0,14,2
Carlton,"Plowman, Lachie",14,7,0,7,0,0,0,1
Carlton,"Rowe, Sam",12,5,6,7,0,0,0,2
Carlton,"Silvagni, Jack",7,4,4,3,1,1,0,4
Carlton,"Simpson, Kade",22,15,1,7,0,0,0,2
Carlton,"Sumner, Liam",10,7,4,3,1,0,0,3
Carlton,"Tuohy, Zach",35,19,3,16,0,3,0,1
Carlton,"Weitering, Jacob",15,8,1,7,0,0,0,2
Carlton,"White, Simon",20,9,5,11,0,0,0,2
Carlton,"Wright, Matthew",18,12,4,6,0,0,0,6
Carlton,"Armfield, Dennis",14,8,6,6,1,2,0,2
Carlton,"Boekhorst, Blaine",12,9,3,3,0,0,0,0
Carlton,"Buckley, Dylan",14,5,2,9,0,1,0,6
Carlton,"Casboult, Levi",12,9,8,3,0,1,0,1
Carlton,"Cripps, Patrick",32,11,6,21,2,2,0,6
Carlton,"Curnow, Ed",27,16,3,11,0,0,0,5
Carlton,"Docherty, Sam",30,19,8,11,0,0,0,4
Carlton,"Gibbs, Bryce",26,9,2,17,1,1,1,7
Carlton,"Graham, Nick",11,6,3,5,0,0,0,4
Carlton,"Kerridge, Sam",15,9,0,6,0,0,0,4
Carlton,"Kreuzer, Matthew",10,6,3,4,0,1,18,4
Carlton,"Phillips, Andrew",7,2,0,5,0,0,21,3
Carlton,"Plowman, Lachie",5,2,1,3,0,0,0,1
Carlton,"Rowe, Sam",10,5,2,5,0,0,0,2
Carlton,"Silvagni, Jack",14,9,4,5,0,0,0,0
Carlton,"Simpson, Kade",39,22,10,17,0,0,0,2
Carlton,"Thomas, Dale",16,5,4,11,0,0,0,0
Carlton,"Tuohy, Zach",25,12,2,13,3,0,0,5
Carlton,"Walker, Andrew",11,2,2,9,0,0,0,1
Carlton,"Weitering, Jacob",15,4,4,11,0,0,0,4
Carlton,"White, Simon",15,9,3,6,0,0,0,1
Carlton,"Wright, Matthew",20,10,3,10,0,0,0,1
Carlton,"Armfield, Dennis",12,10,3,2,1,0,0,4
Carlton,"Boekhorst, Blaine",11,6,2,5,1,1,0,3
Carlton,"Buckley, Dylan",14,11,1,3,1,3,0,3
Carlton,"Casboult, Levi",13,8,5,5,4,2,0,3
Carlton,"Cripps, Patrick",24,8,0,16,0,2,1,8
Carlton,"Cuningham, David",7,2,3,5,0,0,0,8
Carlton,"Curnow, Ed",29,11,4,18,0,1,0,9
Carlton,"Docherty, Sam",18,12,7,6,0,0,0,1
Carlton,"Gibbs, Bryce",24,17,2,7,0,1,2,2
Carlton,"Jones, Liam",11,7,5,4,0,2,0,1
Carlton,"Kerridge, Sam",16,10,5,6,0,0,0,3
Carlton,"Kreuzer, Matthew",14,10,1,4,0,0,30,1
Carlton,"Phillips, Andrew",5,3,2,2,1,0,13,3
Carlton,"Plowman, Lachie",10,8,5,2,0,0,0,3
Carlton,"Rowe, Sam",9,2,4,7,0,0,0,0
Carlton,"Silvagni, Jack",8,6,2,2,3,0,0,4
Carlton,"Simpson, Kade",26,18,2,8,0,0,0,1
Carlton,"Thomas, Dale",14,10,1,4,0,1,0,2
Carlton,"Tuohy, Zach",24,12,4,12,0,0,0,1
Carlton,"Weitering, Jacob",13,7,3,6,0,0,0,0
Carlton,"White, Simon",17,11,3,6,0,1,1,3
Carlton,"Wright, Matthew",10,5,1,5,2,0,0,4
Carlton,"Armfield, Dennis",19,14,4,5,0,1,0,4
Carlton,"Buckley, Dylan",12,7,3,5,3,0,0,2
Carlton,"Casboult, Levi",9,6,4,3,0,1,0,0
Carlton,"Cripps, Patrick",30,10,3,20,1,2,2,13
Carlton,"Cuningham, David",11,4,2,7,0,0,0,6
Carlton,"Curnow, Ed",23,13,2,10,0,1,0,6
Carlton,"Docherty, Sam",26,19,6,7,0,0,0,4
Carlton,"Everitt, Andrejs",16,9,6,7,1,1,0,1
Carlton,"Gibbs, Bryce",33,17,4,16,0,0,3,5
Carlton,"Graham, Nick",19,14,2,5,2,2,0,7
Carlton,"Jones, Liam",17,9,2,8,1,0,0,7
Carlton,"Kreuzer, Matthew",12,8,3,4,0,1,21,4
Carlton,"Phillips, Andrew",7,4,2,3,1,0,11,2
Carlton,"Plowman, Lachie",10,4,5,6,0,0,0,1
Carlton,"Rowe, Sam",10,7,5,3,0,0,0,1
Carlton,"Simpson, Kade",26,21,5,5,0,0,0,4
Carlton,"Sumner, Liam",10,5,5,5,1,0,0,2
Carlton,"Thomas, Dale",16,11,3,5,0,1,0,2
Carlton,"Tuohy, Zach",15,11,3,4,0,0,0,5
Carlton,"Weitering, Jacob",16,8,8,8,0,0,0,3
Carlton,"White, Simon",17,7,6,10,0,0,0,2
Carlton,"Wright, Matthew",20,13,3,7,1,0,0,2
Carlton,"Armfield, Dennis",10,4,1,6,2,0,0,1
Carlton,"Buckley, Dylan",21,12,4,9,1,1,0,2
Carlton,"Casboult, Levi",8,6,7,2,1,2,0,1
Carlton,"Cripps, Patrick",32,7,4,25,0,0,1,8
Carlton,"Cuningham, David",13,8,3,5,0,0,0,2
Carlton,"Docherty, Sam",26,16,8,10,1,0,0,1
Carlton,"Gibbs, Bryce",30,13,3,17,0,1,3,3
Carlton,"Graham, Nick",20,12,5,8,0,3,0,0
Carlton,"Jones, Liam",5,2,2,3,0,0,0,2
Carlton,"Kerridge, Sam",17,11,2,6,1,3,0,4
Carlton,"Kreuzer, Matthew",10,8,4,2,1,1,15,3
Carlton,"Phillips, Andrew",7,4,2,3,0,0,12,3
Carlton,"Plowman, Lachie",12,4,3,8,0,0,0,1
Carlton,"Rowe, Sam",14,3,5,11,0,0,0,1
Carlton,"Silvagni, Jack",8,7,3,1,0,2,0,7
Carlton,"Simpson, Kade",35,22,7,13,0,0,0,3
Carlton,"Sumner, Liam",9,5,1,4,0,1,0,2
Carlton,"Thomas, Dale",15,11,4,4,0,0,0,3
Carlton,"Tuohy, Zach",24,16,5,8,0,1,0,3
Carlton,"Weitering, Jacob",17,9,3,8,0,0,0,0
Carlton,"White, Simon",15,7,5,8,0,0,0,2
Carlton,"Wright, Matthew",20,15,7,5,3,2,0,2
Collingwood,"Adams, Taylor",24,14,5,10,0,0,0,4
Collingwood,"Blair, Jarryd",19,11,2,8,0,2,0,7
Collingwood,"Brown, Nathan",10,7,5,3,0,0,0,2
Collingwood,"Cloke, Travis",7,5,1,2,0,0,4,1
Collingwood,"Crisp, Jack",13,7,2,6,1,0,0,6
Collingwood,"Fasolo, Alex",13,9,2,4,1,0,0,2
Collingwood,"Frost, Jack",12,7,4,5,0,0,0,3
Collingwood,"Gault, Corey",7,3,2,4,0,0,1,3
Collingwood,"Greenwood, Levi",22,15,6,7,1,0,0,8
Collingwood,"Langdon, Tom",17,10,3,7,0,0,0,2
Collingwood,"Macaffer, Brent",9,4,0,5,0,1,0,5
Collingwood,"Maynard, Brayden",8,4,0,4,1,0,0,2
Collingwood,"Moore, Darcy",10,7,3,3,1,0,0,3
Collingwood,"Pendlebury, Scott",25,11,3,14,0,1,0,3
Collingwood,"Ramsay, Jackson",19,13,7,6,0,0,0,3
Collingwood,"Sidebottom, Steele",24,11,5,13,0,1,0,5
Collingwood,"Sinclair, Ben",19,11,7,8,0,1,0,1
Collingwood,"Swan, Dane",0,0,0,0,0,0,0,0
Collingwood,"Treloar, Adam",34,15,3,19,1,1,0,4
Collingwood,"Williams, Marley",18,9,4,9,0,0,0,1
Collingwood,"Witts, Jarrod",8,4,0,4,0,0,21,6
Collingwood,"de Goey, Jordan",16,7,5,9,1,1,0,5
Collingwood,"Adams, Taylor",21,11,6,10,0,0,0,7
Collingwood,"Aish, James",10,1,0,9,1,0,0,3
Collingwood,"Blair, Jarryd",16,10,4,6,0,0,0,6
Collingwood,"Brown, Nathan",12,6,4,6,0,0,0,0
Collingwood,"Cloke, Travis",9,9,6,0,1,3,0,1
Collingwood,"Crisp, Jack",17,4,3,13,0,0,0,5
Collingwood,"Fasolo, Alex",14,12,6,2,6,0,0,3
Collingwood,"Frost, Jack",7,1,0,6,0,0,0,1
Collingwood,"Gault, Corey",4,3,0,1,0,0,6,3
Collingwood,"Greenwood, Levi",21,12,1,9,0,1,0,3
Collingwood,"Grundy, Brodie",17,6,3,11,2,0,16,4
Collingwood,"Langdon, Tom",12,5,2,7,1,1,0,3
Collingwood,"Macaffer, Brent",8,5,3,3,0,0,0,4
Collingwood,"Moore, Darcy",7,4,3,3,1,1,0,2
Collingwood,"Oxley, Adam",21,14,8,7,0,0,1,2
Collingwood,"Pendlebury, Scott",26,14,5,12,0,0,0,4
Collingwood,"Ramsay, Jackson",23,11,7,12,0,0,0,2
Collingwood,"Reid, Ben",19,13,8,6,0,0,0,1
Collingwood,"Sinclair, Ben",18,9,4,9,0,0,0,5
Collingwood,"Treloar, Adam",32,17,7,15,0,0,0,1
Collingwood,"Williams, Marley",18,14,2,4,0,0,0,5
Collingwood,"de Goey, Jordan",14,10,2,4,1,0,0,4
Collingwood,"Adams, Taylor",28,13,3,15,1,0,0,6
Collingwood,"Aish, James",11,7,5,4,1,0,0,0
Collingwood,"Blair, Jarryd",11,6,1,5,0,0,0,0
Collingwood,"Brown, Nathan",11,4,3,7,0,0,0,0
Collingwood,"Cloke, Travis",16,13,7,3,2,1,8,1
Collingwood,"Crisp, Jack",17,9,1,8,1,2,1,3
Collingwood,"Fasolo, Alex",14,7,1,7,2,0,0,0
Collingwood,"Goldsack, Tyson",9,5,3,4,0,0,0,3
Collingwood,"Goodyear, Matthew",11,7,4,4,0,0,0,0
Collingwood,"Greenwood, Levi",24,13,3,11,0,0,1,2
Collingwood,"Grundy, Brodie",16,11,2,5,0,1,22,4
Collingwood,"Howe, Jeremy",8,7,2,1,1,0,0,3
Collingwood,"Langdon, Tom",27,13,7,14,1,0,0,2
Collingwood,"Maynard, Brayden",19,13,2,6,0,0,0,5
Collingwood,"Moore, Darcy",6,3,1,3,0,0,0,1
Collingwood,"Oxley, Adam",25,13,8,12,1,0,0,3
Collingwood,"Pendlebury, Scott",27,17,3,10,2,0,0,4
Collingwood,"Reid, Ben",16,9,5,7,0,0,0,2
Collingwood,"Sinclair, Ben",8,5,2,3,0,0,0,2
Collingwood,"Treloar, Adam",25,5,1,20,0,0,0,8
Collingwood,"Williams, Marley",3,2,3,1,0,0,0,0
Collingwood,"de Goey, Jordan",17,10,5,7,2,2,0,4
Collingwood,"Adams, Taylor",29,22,6,7,0,0,0,4
Collingwood,"Aish, James",20,11,4,9,0,0,0,3
Collingwood,"Blair, Jarryd",16,5,1,11,0,0,0,8
Collingwood,"Brown, Nathan",15,7,3,8,0,0,0,2
Collingwood,"Cloke, Travis",15,11,5,4,2,0,4,2
Collingwood,"Crisp, Jack",19,8,4,11,0,0,4,6
Collingwood,"Fasolo, Alex",18,8,3,10,1,2,0,5
Collingwood,"Greenwood, Levi",18,7,2,11,0,1,0,13
Collingwood,"Grundy, Brodie",23,8,4,15,0,0,25,5
Collingwood,"Howe, Jeremy",14,6,5,8,0,0,0,6
Collingwood,"Langdon, Tom",26,17,2,9,0,0,0,4
Collingwood,"Moore, Darcy",10,5,7,5,1,1,0,6
Collingwood,"Oxley, Adam",21,16,4,5,0,0,0,1
Collingwood,"Pendlebury, Scott",25,11,2,14,0,0,1,9
Collingwood,"Reid, Ben",18,10,10,8,0,0,0,0
Collingwood,"Sidebottom, Steele",26,14,6,12,2,1,0,7
Collingwood,"Sinclair, Ben",9,5,0,4,1,0,0,1
Collingwood,"Toovey, Alan",12,5,2,7,0,0,0,3
Collingwood,"Treloar, Adam",31,17,7,14,1,1,0,4
Collingwood,"Varcoe, Travis",13,7,3,6,1,1,0,4
Collingwood,"White, Jesse",12,6,3,6,0,0,0,2
Collingwood,"de Goey, Jordan",22,9,2,13,0,1,0,4
Collingwood,"Adams, Taylor",36,17,4,19,1,0,0,1
Collingwood,"Aish, James",14,6,3,8,0,1,0,1
Collingwood,"Blair, Jarryd",16,7,4,9,3,1,0,7
Collingwood,"Brown, Nathan",6,2,2,4,0,0,0,1
Collingwood,"Cox, Mason",10,6,3,4,1,1,11,3
Collingwood,"Crisp, Jack",25,12,3,13,0,0,0,3
Collingwood,"Fasolo, Alex",22,13,6,9,4,1,0,3
Collingwood,"Frost, Jack",14,8,5,6,0,0,0,3
Collingwood,"Greenwood, Levi",18,13,2,5,2,0,0,8
Collingwood,"Grundy, Brodie",16,10,4,6,0,1,29,3
Collingwood,"Howe, Jeremy",17,9,6,8,2,0,0,5
Collingwood,"Maynard, Brayden",15,9,2,6,0,1,0,4
Collingwood,"Moore, Darcy",10,6,5,4,2,0,2,0
Collingwood,"Oxley, Adam",19,12,6,7,1,0,0,4
Collingwood,"Pendlebury, Scott",35,15,6,20,0,1,0,6
Collingwood,"Reid, Ben",16,8,7,8,0,0,0,1
Collingwood,"Sidebottom, Steele",33,19,7,14,4,0,0,4
Collingwood,"Smith, Josh",23,12,3,11,1,1,0,4
Collingwood,"Toovey, Alan",15,4,1,11,0,0,0,3
Collingwood,"Treloar, Adam",32,14,6,18,0,0,0,9
Collingwood,"Varcoe, Travis",8,4,1,4,0,1,0,2
Collingwood,"de Goey, Jordan",23,10,6,13,1,0,0,5
Collingwood,"Blair, Jarryd",16,8,3,8,1,0,0,2
Collingwood,"Broomhead, Tim",7,2,2,5,2,0,0,1
Collingwood,"Brown, Nathan",6,4,3,2,0,0,0,1
Collingwood,"Cox, Mason",10,5,3,5,2,1,5,4
Collingwood,"Crisp, Jack",26,13,7,13,1,0,3,5
Collingwood,"Fasolo, Alex",16,10,8,6,0,0,0,4
Collingwood,"Frost, Jack",10,3,3,7,0,0,0,3
Collingwood,"Greenwood, Levi",19,8,1,11,1,0,0,5
Collingwood,"Grundy, Brodie",21,10,4,11,0,1,15,5
Collingwood,"Howe, Jeremy",11,7,5,4,0,1,1,1
Collingwood,"Langdon, Tom",14,4,2,10,0,0,0,2
Collingwood,"Maynard, Brayden",19,9,7,10,0,1,0,3
Collingwood,"Moore, Darcy",8,5,4,3,2,0,1,1
Collingwood,"Oxley, Adam",24,13,3,11,0,0,0,4
Collingwood,"Pendlebury, Scott",28,8,2,20,0,0,0,5
Collingwood,"Reid, Ben",17,10,8,7,0,0,0,0
Collingwood,"Sidebottom, Steele",23,13,3,10,0,0,0,7
Collingwood,"Sinclair, Ben",20,11,3,9,0,0,0,2
Collingwood,"Smith, Josh",29,17,4,12,0,0,0,2
Collingwood,"Toovey, Alan",14,3,1,11,0,0,0,7
Collingwood,"Treloar, Adam",32,11,2,21,0,0,0,10
Collingwood,"de Goey, Jordan",18,8,1,10,0,1,0,5
Collingwood,"Aish, James",10,6,2,4,0,0,0,1
Collingwood,"Blair, Jarryd",19,6,0,13,1,0,0,1
Collingwood,"Broomhead, Tim",9,3,1,6,1,0,0,2
Collingwood,"Cox, Mason",7,4,1,3,0,1,10,2
Collingwood,"Crisp, Jack",17,6,3,11,0,2,1,1
Collingwood,"Crocker, Ben",8,3,2,5,0,1,0,3
Collingwood,"Fasolo, Alex",17,10,2,7,4,0,0,3
Collingwood,"Frost, Jack",6,5,3,1,0,0,0,7
Collingwood,"Greenwood, Levi",16,9,2,7,1,0,0,2
Collingwood,"Grundy, Brodie",6,2,1,4,0,0,24,4
Collingwood,"Howe, Jeremy",22,12,9,10,0,1,0,4
Collingwood,"Maynard, Brayden",12,9,5,3,0,0,0,4
Collingwood,"Moore, Darcy",13,7,6,6,3,0,0,0
Collingwood,"Oxley, Adam",11,10,2,1,0,0,0,2
Collingwood,"Pendlebury, Scott",34,17,3,17,0,1,0,7
Collingwood,"Reid, Ben",19,17,12,2,0,0,0,1
Collingwood,"Sidebottom, Steele",29,12,7,17,0,1,0,4
Collingwood,"Smith, Josh",18,9,4,9,0,0,0,1
Collingwood,"Toovey, Alan",12,2,2,10,0,0,0,3
Collingwood,"Treloar, Adam",27,8,1,19,0,1,0,8
Collingwood,"White, Jesse",15,12,5,3,2,2,0,3
Collingwood,"de Goey, Jordan",18,8,2,10,0,0,0,5
Collingwood,"Adams, Taylor",33,18,6,15,1,0,0,3
Collingwood,"Blair, Jarryd",25,13,3,12,1,0,0,2
Collingwood,"Cox, Mason",9,8,3,1,4,2,11,2
Collingwood,"Crisp, Jack",15,7,0,8,0,0,2,8
Collingwood,"Crocker, Ben",12,8,3,4,3,2,0,0
Collingwood,"Fasolo, Alex",13,8,3,5,1,1,0,3
Collingwood,"Frost, Jack",9,5,4,4,0,0,0,1
Collingwood,"Greenwood, Levi",15,10,3,5,0,1,0,0
Collingwood,"Grundy, Brodie",17,10,4,7,1,2,19,7
Collingwood,"Howe, Jeremy",20,14,7,6,0,0,0,2
Collingwood,"Maynard, Brayden",7,4,0,3,0,1,0,2
Collingwood,"Moore, Darcy",7,4,4,3,1,1,0,0
Collingwood,"Oxley, Adam",22,15,7,7,0,1,0,4
Collingwood,"Pendlebury, Scott",34,15,2,19,0,0,0,3
Collingwood,"Sidebottom, Steele",31,17,5,14,0,0,0,2
Collingwood,"Sinclair, Ben",7,4,1,3,0,1,0,3
Collingwood,"Smith, Josh",19,8,3,11,0,0,0,2
Collingwood,"Toovey, Alan",11,5,3,6,0,0,0,4
Collingwood,"Treloar, Adam",36,16,4,20,3,3,0,3
Collingwood,"Varcoe, Travis",9,4,4,5,1,1,0,1
Collingwood,"White, Jesse",15,11,7,4,3,2,2,2
Collingwood,"de Goey, Jordan",23,12,6,11,1,3,0,2
Collingwood,"Adams, Taylor",23,14,8,9,0,0,0,2
Collingwood,"Blair, Jarryd",10,3,3,7,0,0,0,7
Collingwood,"Cox, Mason",9,4,3,5,2,0,4,1
Collingwood,"Crisp, Jack",24,14,4,10,1,0,1,8
Collingwood,"Crocker, Ben",7,5,2,2,1,0,0,0
Collingwood,"Fasolo, Alex",10,5,2,5,2,0,0,6
Collingwood,"Frost, Jack",10,4,3,6,0,0,0,4
Collingwood,"Greenwood, Levi",21,13,2,8,0,0,0,4
Collingwood,"Grundy, Brodie",20,15,4,5,2,0,13,3
Collingwood,"Howe, Jeremy",22,17,11,5,0,0,0,1
Collingwood,"Maynard, Brayden",14,11,3,3,0,0,0,0
Collingwood,"Moore, Darcy",12,7,6,5,1,1,1,2
Collingwood,"Oxley, Adam",14,10,6,4,0,0,0,3
Collingwood,"Pendlebury, Scott",26,11,6,15,3,0,0,4
Collingwood,"Reid, Ben",14,12,8,2,0,0,0,1
Collingwood,"Sidebottom, Steele",31,21,9,10,0,0,0,5
Collingwood,"Smith, Josh",17,7,2,10,0,0,0,0
Collingwood,"Toovey, Alan",13,6,3,7,0,0,0,1
Collingwood,"Treloar, Adam",29,10,5,19,1,1,0,8
Collingwood,"Varcoe, Travis",12,10,2,2,0,2,0,5
Collingwood,"White, Jesse",10,8,5,2,2,0,2,3
Collingwood,"de Goey, Jordan",22,10,5,12,1,0,0,2
Collingwood,"Adams, Taylor",17,13,7,4,0,1,0,1
Collingwood,"Blair, Jarryd",20,7,4,13,1,1,0,6
Collingwood,"Cox, Mason",6,2,2,4,0,0,8,3
Collingwood,"Crisp, Jack",23,14,7,9,0,1,0,7
Collingwood,"Crocker, Ben",11,6,4,5,1,0,0,4
Collingwood,"Fasolo, Alex",17,7,5,10,1,1,0,2
Collingwood,"Frost, Jack",13,8,6,5,0,0,0,4
Collingwood,"Greenwood, Levi",14,7,3,7,0,0,0,11
Collingwood,"Grundy, Brodie",17,10,2,7,0,0,25,6
Collingwood,"Howe, Jeremy",28,16,11,12,0,0,0,3
Collingwood,"Maynard, Brayden",21,17,9,4,0,0,0,8
Collingwood,"Moore, Darcy",10,7,5,3,2,1,1,0
Collingwood,"Oxley, Adam",14,10,5,4,0,1,0,2
Collingwood,"Pendlebury, Scott",32,19,4,13,1,1,1,6
Collingwood,"Reid, Ben",22,16,13,6,0,0,0,0
Collingwood,"Sidebottom, Steele",26,18,9,8,0,0,0,3
Collingwood,"Smith, Josh",22,14,7,8,0,0,0,1
Collingwood,"Toovey, Alan",1,0,0,1,0,0,0,1
Collingwood,"Treloar, Adam",31,13,4,18,1,0,0,6
Collingwood,"Varcoe, Travis",17,7,5,10,0,1,0,6
Collingwood,"White, Jesse",18,9,8,9,0,1,1,2
Collingwood,"de Goey, Jordan",19,12,5,7,0,0,0,3
Collingwood,"Blair, Jarryd",21,8,3,13,0,0,0,8
Collingwood,"Cloke, Travis",13,10,6,3,0,1,0,4
Collingwood,"Cox, Mason",8,6,6,2,2,1,13,0
Collingwood,"Crisp, Jack",22,9,3,13,0,1,0,8
Collingwood,"Crocker, Ben",7,3,3,4,0,1,0,3
Collingwood,"Frost, Jack",8,3,2,5,0,0,0,0
Collingwood,"Goodyear, Matthew",7,3,1,4,0,1,0,2
Collingwood,"Greenwood, Levi",21,11,2,10,0,0,0,12
Collingwood,"Grundy, Brodie",18,9,1,9,1,0,25,0
Collingwood,"Howe, Jeremy",20,14,10,6,0,0,0,1
Collingwood,"Maynard, Brayden",22,16,10,6,0,0,0,1
Collingwood,"Oxley, Adam",13,6,4,7,0,0,0,2
Collingwood,"Pendlebury, Scott",30,15,5,15,1,2,0,9
Collingwood,"Reid, Ben",25,18,7,7,0,0,0,1
Collingwood,"Sidebottom, Steele",20,11,3,9,2,0,0,4
Collingwood,"Sinclair, Ben",27,14,3,13,0,0,0,2
Collingwood,"Smith, Josh",21,9,4,12,0,0,0,3
Collingwood,"Toovey, Alan",10,6,1,4,0,0,0,2
Collingwood,"Treloar, Adam",28,9,3,19,0,1,0,7
Collingwood,"Varcoe, Travis",20,7,7,13,0,0,0,2
Collingwood,"White, Jesse",14,14,8,0,0,3,1,2
Collingwood,"de Goey, Jordan",19,11,4,8,1,1,0,3
Collingwood,"Blair, Jarryd",18,7,2,11,0,1,0,5
Collingwood,"Cox, Mason",5,5,3,0,2,1,1,2
Collingwood,"Crisp, Jack",18,7,2,11,0,1,1,8
Collingwood,"Crocker, Ben",7,5,3,2,0,0,0,2
Collingwood,"Frost, Jack",7,4,2,3,0,0,0,5
Collingwood,"Greenwood, Levi",14,6,1,8,1,0,1,15
Collingwood,"Grundy, Brodie",15,7,4,8,1,0,22,3
Collingwood,"Howe, Jeremy",18,10,3,8,0,0,0,1
Collingwood,"Marsh, Jonathon",11,7,4,4,0,1,0,6
Collingwood,"Maynard, Brayden",16,13,7,3,1,0,0,4
Collingwood,"Pendlebury, Scott",26,14,2,12,0,0,1,3
Collingwood,"Phillips, Tom",15,7,3,8,0,0,0,5
Collingwood,"Reid, Ben",14,11,6,3,0,0,0,0
Collingwood,"Sidebottom, Steele",17,9,5,8,1,0,0,4
Collingwood,"Sinclair, Ben",11,6,2,5,0,0,0,4
Collingwood,"Smith, Josh",17,8,4,9,0,0,0,1
Collingwood,"Treloar, Adam",31,11,2,20,0,0,0,4
Collingwood,"Varcoe, Travis",16,11,6,5,1,3,0,3
Collingwood,"White, Jesse",19,15,6,4,1,1,0,2
Collingwood,"Williams, Marley",19,7,0,12,0,0,0,2
Collingwood,"Witts, Jarrod",8,4,3,4,0,1,10,2
Collingwood,"de Goey, Jordan",22,12,4,10,0,0,0,4
Collingwood,"Aish, James",16,10,5,6,1,0,0,4
Collingwood,"Blair, Jarryd",19,8,2,11,0,1,0,7
Collingwood,"Brown, Nathan",12,4,5,8,0,0,0,2
Collingwood,"Cloke, Travis",14,11,7,3,2,2,1,2
Collingwood,"Cox, Mason",10,5,3,5,2,0,7,4
Collingwood,"Crisp, Jack",24,13,2,11,0,0,1,4
Collingwood,"Greenwood, Levi",16,9,0,7,1,1,0,12
Collingwood,"Grundy, Brodie",18,9,4,9,0,0,34,4
Collingwood,"Howe, Jeremy",20,14,4,6,0,0,0,1
Collingwood,"Marsh, Jonathon",17,12,8,5,0,0,0,2
Collingwood,"Maynard, Brayden",22,18,12,4,0,1,0,6
Collingwood,"Pendlebury, Scott",25,13,1,12,0,0,0,5
Collingwood,"Phillips, Tom",19,13,6,6,1,3,0,3
Collingwood,"Reid, Ben",22,16,12,6,0,0,0,0
Collingwood,"Sidebottom, Steele",24,10,4,14,0,1,0,3
Collingwood,"Sinclair, Ben",17,10,5,7,0,0,0,3
Collingwood,"Smith, Josh",25,12,4,13,1,0,0,4
Collingwood,"Treloar, Adam",33,17,3,16,1,0,0,7
Collingwood,"Varcoe, Travis",8,4,3,4,0,0,0,5
Collingwood,"White, Jesse",10,7,3,3,2,0,1,1
Collingwood,"Williams, Marley",18,14,5,4,0,0,0,1
Collingwood,"de Goey, Jordan",16,8,4,8,1,0,0,5
Collingwood,"Aish, James",18,10,4,8,1,0,0,2
Collingwood,"Blair, Jarryd",13,9,6,4,2,0,0,3
Collingwood,"Brown, Nathan",12,4,4,8,0,0,0,1
Collingwood,"Cloke, Travis",13,12,9,1,0,2,1,4
Collingwood,"Cox, Mason",2,1,2,1,0,0,8,3
Collingwood,"Crisp, Jack",14,7,4,7,0,0,1,4
Collingwood,"Goldsack, Tyson",18,10,5,8,0,0,0,2
Collingwood,"Greenwood, Levi",23,10,2,13,1,1,0,9
Collingwood,"Grundy, Brodie",17,8,4,9,2,1,12,5
Collingwood,"Howe, Jeremy",18,12,3,6,0,0,0,2
Collingwood,"Maynard, Brayden",16,12,5,4,0,1,0,4
Collingwood,"Moore, Darcy",11,7,8,4,1,2,1,4
Collingwood,"Pendlebury, Scott",34,17,5,17,1,0,1,4
Collingwood,"Phillips, Tom",12,6,4,6,0,0,0,2
Collingwood,"Reid, Ben",18,12,7,6,0,0,0,1
Collingwood,"Sidebottom, Steele",21,10,2,11,0,0,0,2
Collingwood,"Sinclair, Ben",24,10,2,14,0,0,0,4
Collingwood,"Smith, Josh",18,7,2,11,0,0,0,1
Collingwood,"Treloar, Adam",23,9,2,14,0,0,0,5
Collingwood,"Varcoe, Travis",16,10,7,6,0,1,0,3
Collingwood,"Williams, Marley",7,5,2,2,0,0,0,2
Collingwood,"de Goey, Jordan",17,7,7,10,0,1,0,0
Collingwood,"Adams, Taylor",31,14,3,17,1,0,0,3
Collingwood,"Aish, James",11,6,0,5,1,0,0,6
Collingwood,"Blair, Jarryd",15,5,2,10,2,0,0,7
Collingwood,"Brown, Nathan",9,6,3,3,0,0,0,4
Collingwood,"Cloke, Travis",20,18,12,2,4,1,0,1
Collingwood,"Crisp, Jack",20,9,1,11,0,1,1,6
Collingwood,"Fasolo, Alex",14,8,4,6,2,1,0,3
Collingwood,"Grundy, Brodie",26,12,3,14,1,1,28,3
Collingwood,"Howe, Jeremy",22,12,6,10,0,0,0,5
Collingwood,"Macaffer, Brent",6,3,0,3,1,0,0,3
Collingwood,"Marsh, Jonathon",16,11,5,5,0,0,0,4
Collingwood,"Maynard, Brayden",15,11,4,4,0,0,0,2
Collingwood,"Moore, Darcy",9,5,4,4,0,1,0,3
Collingwood,"Pendlebury, Scott",26,11,2,15,0,0,0,6
Collingwood,"Reid, Ben",13,11,6,2,0,0,0,0
Collingwood,"Sidebottom, Steele",28,13,7,15,1,0,0,6
Collingwood,"Sinclair, Ben",16,10,2,6,1,0,0,0
Collingwood,"Smith, Josh",23,11,9,12,1,0,0,0
Collingwood,"Treloar, Adam",27,12,3,15,0,1,0,5
Collingwood,"Varcoe, Travis",16,6,0,10,1,0,0,7
Collingwood,"White, Jesse",13,12,10,1,3,2,8,1
Collingwood,"de Goey, Jordan",17,8,4,9,0,1,0,5
Collingwood,"Adams, Taylor",34,16,4,18,1,0,0,5
Collingwood,"Aish, James",22,11,4,11,1,0,0,6
Collingwood,"Blair, Jarryd",10,3,2,7,0,0,0,5
Collingwood,"Brown, Nathan",9,3,2,6,0,0,0,2
Collingwood,"Cloke, Travis",17,15,7,2,2,1,0,5
Collingwood,"Crisp, Jack",19,8,2,11,2,1,4,9
Collingwood,"Greenwood, Levi",13,8,0,5,2,0,0,8
Collingwood,"Grundy, Brodie",23,12,10,11,0,0,32,5
Collingwood,"Howe, Jeremy",19,11,3,8,0,1,0,6
Collingwood,"Macaffer, Brent",10,5,1,5,0,0,0,3
Collingwood,"Marsh, Jonathon",15,11,5,4,0,0,0,1
Collingwood,"Maynard, Brayden",14,7,2,7,0,0,0,5
Collingwood,"Moore, Darcy",9,6,2,3,1,0,0,2
Collingwood,"Pendlebury, Scott",30,8,4,22,0,0,1,5
Collingwood,"Reid, Ben",18,13,8,5,0,0,0,2
Collingwood,"Sidebottom, Steele",26,10,8,16,0,0,0,6
Collingwood,"Sinclair, Ben",23,10,5,13,0,0,0,3
Collingwood,"Smith, Josh",12,9,4,3,0,0,0,1
Collingwood,"Treloar, Adam",36,11,3,25,0,1,0,7
Collingwood,"Varcoe, Travis",13,6,4,7,1,1,0,6
Collingwood,"White, Jesse",14,9,6,5,0,0,8,1
Collingwood,"de Goey, Jordan",19,9,3,10,0,1,0,4
Collingwood,"Adams, Taylor",30,17,2,13,0,0,0,6
Collingwood,"Aish, James",17,10,1,7,0,1,0,1
Collingwood,"Blair, Jarryd",14,7,2,7,2,1,0,9
Collingwood,"Brown, Nathan",6,3,0,3,0,0,0,1
Collingwood,"Cloke, Travis",8,7,3,1,0,0,0,2
Collingwood,"Crisp, Jack",21,10,0,11,0,2,1,9
Collingwood,"Fasolo, Alex",4,2,2,2,1,0,0,2
Collingwood,"Greenwood, Levi",10,8,3,2,2,0,0,8
Collingwood,"Grundy, Brodie",19,7,4,12,0,0,29,2
Collingwood,"Howe, Jeremy",18,10,6,8,0,1,0,4
Collingwood,"Marsh, Jonathon",10,7,2,3,0,0,0,4
Collingwood,"Maynard, Brayden",17,9,2,8,0,0,0,1
Collingwood,"Moore, Darcy",8,4,5,4,2,1,0,3
Collingwood,"Pendlebury, Scott",30,13,2,17,1,1,0,3
Collingwood,"Reid, Ben",14,10,6,4,0,0,0,1
Collingwood,"Sidebottom, Steele",28,13,3,15,2,0,0,3
Collingwood,"Sinclair, Ben",0,0,0,0,0,0,0,0
Collingwood,"Smith, Josh",18,7,3,11,0,0,0,5
Collingwood,"Treloar, Adam",25,10,4,15,0,0,0,6
Collingwood,"Varcoe, Travis",15,8,2,7,0,0,0,5
Collingwood,"White, Jesse",11,6,3,5,2,1,1,3
Collingwood,"Williams, Marley",19,9,4,10,0,0,0,3
Collingwood,"Adams, Taylor",36,17,3,19,0,0,0,11
Collingwood,"Aish, James",26,11,3,15,2,0,0,4
Collingwood,"Brown, Nathan",13,6,6,7,0,0,0,2
Collingwood,"Cloke, Travis",11,8,7,3,1,2,0,4
Collingwood,"Crisp, Jack",21,7,3,14,1,0,0,8
Collingwood,"Crocker, Ben",14,5,2,9,0,0,0,1
Collingwood,"Greenwood, Levi",14,6,1,8,1,1,0,3
Collingwood,"Grundy, Brodie",19,8,5,11,0,1,45,7
Collingwood,"Howe, Jeremy",14,10,3,4,0,0,0,2
Collingwood,"Marsh, Jonathon",11,7,5,4,0,0,0,3
Collingwood,"Maynard, Brayden",15,10,2,5,1,0,0,6
Collingwood,"Moore, Darcy",8,8,6,0,3,2,0,1
Collingwood,"Pendlebury, Scott",34,11,4,23,0,0,1,13
Collingwood,"Reid, Ben",16,10,7,6,0,0,0,3
Collingwood,"Sidebottom, Steele",26,16,3,10,2,0,0,5
Collingwood,"Smith, Josh",28,18,7,10,0,0,0,7
Collingwood,"Treloar, Adam",28,12,1,16,1,0,0,9
Collingwood,"Varcoe, Travis",14,6,2,8,0,0,0,8
Collingwood,"White, Jesse",11,8,2,3,1,1,7,5
Collingwood,"Williams, Marley",22,7,4,15,0,0,0,3
Collingwood,"Wills, Rupert",17,5,1,12,0,0,0,11
Collingwood,"de Goey, Jordan",14,3,1,11,0,0,0,2
Collingwood,"Adams, Taylor",25,13,4,12,1,0,0,4
Collingwood,"Aish, James",18,13,5,5,2,0,0,2
Collingwood,"Blair, Jarryd",8,0,4,8,0,0,0,2
Collingwood,"Brown, Nathan",11,8,7,3,0,0,0,3
Collingwood,"Cloke, Travis",11,11,9,0,1,1,0,1
Collingwood,"Cox, Mason",6,4,1,2,2,0,1,0
Collingwood,"Crisp, Jack",25,11,4,14,0,1,1,5
Collingwood,"Crocker, Ben",4,3,2,1,1,0,0,0
Collingwood,"Greenwood, Levi",13,7,4,6,0,1,0,5
Collingwood,"Grundy, Brodie",19,10,6,9,0,0,17,4
Collingwood,"Howe, Jeremy",17,11,8,6,0,1,0,3
Collingwood,"Marsh, Jonathon",9,5,2,4,0,0,0,0
Collingwood,"Maynard, Brayden",12,10,6,2,0,0,0,2
Collingwood,"Pendlebury, Scott",17,8,3,9,1,0,0,3
Collingwood,"Reid, Ben",15,13,6,2,0,0,0,2
Collingwood,"Sidebottom, Steele",22,11,8,11,0,0,0,6
Collingwood,"Smith, Josh",20,12,5,8,0,0,0,3
Collingwood,"Treloar, Adam",24,15,4,9,0,2,0,9
Collingwood,"Varcoe, Travis",13,7,4,6,1,1,0,6
Collingwood,"White, Jesse",9,7,1,2,1,1,2,1
Collingwood,"Williams, Marley",10,3,3,7,0,0,0,2
Collingwood,"Wills, Rupert",20,7,3,13,1,0,0,8
Collingwood,"Adams, Taylor",21,13,3,8,0,0,0,5
Collingwood,"Aish, James",28,17,4,11,0,0,0,4
Collingwood,"Blair, Jarryd",21,7,5,14,0,0,0,3
Collingwood,"Brown, Nathan",17,6,6,11,0,0,0,4
Collingwood,"Crisp, Jack",20,8,3,12,0,0,1,8
Collingwood,"Goldsack, Tyson",19,13,7,6,0,0,0,1
Collingwood,"Greenwood, Levi",15,8,0,7,1,0,0,2
Collingwood,"Grundy, Brodie",13,6,3,7,0,0,47,8
Collingwood,"Howe, Jeremy",23,14,11,9,0,0,0,0
Collingwood,"Marsh, Jonathon",9,5,4,4,0,0,0,3
Collingwood,"Maynard, Brayden",10,8,2,2,1,1,0,2
Collingwood,"Moore, Darcy",13,7,6,6,3,3,0,1
Collingwood,"Oxley, Adam",7,4,2,3,2,0,0,1
Collingwood,"Pendlebury, Scott",24,11,2,13,0,0,0,7
Collingwood,"Phillips, Tom",9,7,6,2,1,0,0,0
Collingwood,"Sidebottom, Steele",20,12,2,8,2,0,0,6
Collingwood,"Smith, Josh",17,12,8,5,0,0,0,1
Collingwood,"Treloar, Adam",35,13,1,22,1,1,0,9
Collingwood,"Varcoe, Travis",18,6,2,12,0,1,0,6
Collingwood,"White, Jesse",12,7,3,5,1,1,3,2
Collingwood,"Wills, Rupert",16,7,3,9,0,1,0,12
Collingwood,"de Goey, Jordan",19,11,7,8,2,0,0,3
Collingwood,"Aish, James",10,7,1,3,0,1,0,5
Collingwood,"Blair, Jarryd",13,7,3,6,0,0,0,2
Collingwood,"Brown, Nathan",17,12,9,5,0,0,0,1
Collingwood,"Crisp, Jack",23,7,6,16,2,0,2,3
Collingwood,"Crocker, Ben",10,6,3,4,1,1,0,0
Collingwood,"Greenwood, Levi",21,13,4,8,2,1,0,2
Collingwood,"Grundy, Brodie",26,12,5,14,0,0,36,9
Collingwood,"Howe, Jeremy",29,21,18,8,0,0,0,0
Collingwood,"Marsh, Jonathon",12,9,6,3,0,0,0,3
Collingwood,"Maynard, Brayden",22,15,3,7,0,1,0,7
Collingwood,"Moore, Darcy",3,3,2,0,0,0,0,0
Collingwood,"Oxley, Adam",12,6,4,6,0,0,0,0
Collingwood,"Pendlebury, Scott",32,15,9,17,1,0,1,8
Collingwood,"Phillips, Tom",25,12,7,13,1,1,0,5
Collingwood,"Sidebottom, Steele",26,13,5,13,1,2,0,5
Collingwood,"Smith, Josh",35,19,9,16,1,1,0,2
Collingwood,"Treloar, Adam",38,18,3,20,1,4,0,6
Collingwood,"Varcoe, Travis",28,13,8,15,0,0,0,2
Collingwood,"White, Jesse",17,13,10,4,3,4,9,4
Collingwood,"Williams, Marley",21,8,1,13,0,0,0,2
Collingwood,"Wills, Rupert",18,8,4,10,0,0,0,10
Collingwood,"de Goey, Jordan",15,8,5,7,3,1,0,1
Collingwood,"Aish, James",6,2,1,4,0,0,0,0
Collingwood,"Blair, Jarryd",11,5,3,6,2,0,0,8
Collingwood,"Brown, Nathan",9,2,3,7,0,0,0,2
Collingwood,"Cloke, Travis",10,9,8,1,2,2,0,1
Collingwood,"Crisp, Jack",22,12,2,10,0,0,2,4
Collingwood,"Crocker, Ben",11,6,6,5,3,1,0,0
Collingwood,"Goldsack, Tyson",11,3,2,8,1,0,0,0
Collingwood,"Greenwood, Levi",17,11,7,6,2,1,0,3
Collingwood,"Grundy, Brodie",21,8,4,13,1,0,33,1
Collingwood,"Howe, Jeremy",24,17,11,7,0,0,0,2
Collingwood,"Marsh, Jonathon",14,9,3,5,0,0,0,4
Collingwood,"Maynard, Brayden",14,10,6,4,0,0,0,3
Collingwood,"Pendlebury, Scott",30,15,3,15,0,0,2,6
Collingwood,"Phillips, Tom",22,12,7,10,0,0,0,2
Collingwood,"Sidebottom, Steele",33,20,7,13,0,1,0,3
Collingwood,"Smith, Josh",12,7,3,5,0,0,0,5
Collingwood,"Treloar, Adam",36,20,2,16,2,1,0,4
Collingwood,"Varcoe, Travis",16,12,9,4,0,0,0,2
Collingwood,"White, Jesse",11,8,6,3,2,1,2,1
Collingwood,"Williams, Marley",16,10,6,6,0,0,0,1
Collingwood,"Wills, Rupert",17,10,3,7,0,0,0,2
Collingwood,"de Goey, Jordan",15,11,3,4,2,1,0,5
Essendon,"Ambrose, Patrick",12,8,3,4,0,0,0,4
Essendon,"Baguley, Mark",16,11,7,5,0,0,0,3
Essendon,"Bird, Craig",11,4,1,7,0,0,0,6
Essendon,"Brown, Mitch",13,10,4,3,0,0,0,2
Essendon,"Cooney, Adam",14,7,4,7,0,0,0,3
Essendon,"Crowley, Ryan",13,6,3,7,1,0,1,2
Essendon,"Daniher, Joe",11,7,5,4,1,1,1,1
Essendon,"Dea, Matt",15,6,5,9,0,0,0,5
Essendon,"Gleeson, Martin",19,11,5,8,0,0,0,2
Essendon,"Goddard, Brendon",24,8,7,16,0,0,0,1
Essendon,"Gwilt, James",18,11,5,7,0,0,0,1
Essendon,"Kelly, James",26,15,8,11,0,0,0,7
Essendon,"Langford, Kyle",13,7,3,6,1,0,0,0
Essendon,"Leuenberger, Matthew",8,2,3,6,0,0,32,0
Essendon,"McDonald-Tipungwuti, Anthony",10,6,0,4,0,1,0,2
Essendon,"McKernan, Shaun",6,4,1,2,1,0,5,0
Essendon,"Merrett, Jackson",21,9,4,12,0,0,0,3
Essendon,"Merrett, Zach",31,18,10,13,0,0,0,3
Essendon,"Parish, Darcy",25,8,5,17,0,0,0,6
Essendon,"Simpkin, Jonathan",17,8,3,9,0,0,0,2
Essendon,"Stokes, Mathew",27,18,7,9,3,1,0,1
Essendon,"Zaharakis, David",33,21,5,12,2,2,0,2
Essendon,"Ambrose, Patrick",13,5,3,8,0,0,3,5
Essendon,"Baguley, Mark",21,10,9,11,0,0,0,5
Essendon,"Brown, Mitch",13,9,3,4,2,0,0,1
Essendon,"Cooney, Adam",20,14,5,6,0,1,0,4
Essendon,"Crowley, Ryan",14,10,8,4,0,1,0,0
Essendon,"Daniher, Joe",21,14,15,7,2,4,0,0
Essendon,"Dea, Matt",18,12,4,6,0,1,0,2
Essendon,"Fantasia, Orazio",23,9,3,14,0,0,0,3
Essendon,"Gleeson, Martin",20,15,12,5,0,0,0,1
Essendon,"Goddard, Brendon",27,15,10,12,0,1,2,3
Essendon,"Gwilt, James",24,13,9,11,0,0,0,1
Essendon,"Hartley, Michael",14,9,6,5,1,0,0,5
Essendon,"Kelly, James",28,12,6,16,0,0,0,2
Essendon,"Kommer, Nick",9,5,2,4,1,0,0,1
Essendon,"Langford, Kyle",15,7,7,8,1,1,0,2
Essendon,"Leuenberger, Matthew",12,4,1,8,0,0,16,2
Essendon,"McDonald-Tipungwuti, Anthony",20,13,8,7,0,0,0,1
Essendon,"Merrett, Jackson",28,13,10,15,0,1,0,3
Essendon,"Merrett, Zach",32,19,3,13,2,0,0,8
Essendon,"Parish, Darcy",21,10,3,11,1,0,0,8
Essendon,"Stokes, Mathew",17,5,5,12,1,0,0,4
Essendon,"Zaharakis, David",34,20,7,14,0,0,0,5
Essendon,"Ambrose, Patrick",16,9,9,7,1,1,2,3
Essendon,"Baguley, Mark",16,8,5,8,0,0,0,0
Essendon,"Brown, Mitch",9,5,2,4,0,0,0,5
Essendon,"Cooney, Adam",26,15,4,11,0,1,0,3
Essendon,"Crowley, Ryan",14,9,4,5,0,1,0,1
Essendon,"Daniher, Joe",11,8,6,3,2,1,1,0
Essendon,"Dea, Matt",20,10,4,10,0,0,0,4
Essendon,"Fantasia, Orazio",23,9,5,14,0,1,1,7
Essendon,"Gleeson, Martin",17,8,5,9,0,0,0,4
Essendon,"Goddard, Brendon",22,10,4,12,1,0,3,8
Essendon,"Gwilt, James",20,13,3,7,0,0,0,2
Essendon,"Hartley, Michael",11,5,2,6,0,0,0,4
Essendon,"Kelly, James",29,15,6,14,0,0,0,2
Essendon,"Kommer, Nick",8,3,3,5,2,0,0,2
Essendon,"Langford, Kyle",14,7,6,7,0,0,0,7
Essendon,"Leuenberger, Matthew",11,4,3,7,0,0,33,4
Essendon,"McDonald-Tipungwuti, Anthony",16,6,3,10,0,0,0,8
Essendon,"Merrett, Jackson",7,1,0,6,1,0,0,2
Essendon,"Merrett, Zach",28,15,9,13,0,0,0,8
Essendon,"Parish, Darcy",21,5,1,16,0,0,0,4
Essendon,"Stokes, Mathew",19,9,3,10,0,1,0,2
Essendon,"Zaharakis, David",27,16,4,11,0,0,0,7
Essendon,"Ambrose, Patrick",11,1,1,10,0,0,3,2
Essendon,"Baguley, Mark",22,13,9,9,0,0,0,3
Essendon,"Bird, Craig",24,8,4,16,0,1,0,4
Essendon,"Brown, Mitch",10,9,7,1,1,0,0,2
Essendon,"Cooney, Adam",28,13,6,15,0,0,1,1
Essendon,"Daniher, Joe",6,3,1,3,0,1,0,2
Essendon,"Dea, Matt",16,12,7,4,0,0,0,3
Essendon,"Fantasia, Orazio",29,11,8,18,1,1,0,5
Essendon,"Gleeson, Martin",19,10,4,9,0,0,0,3
Essendon,"Goddard, Brendon",26,11,5,15,0,0,3,1
Essendon,"Gwilt, James",25,15,16,10,0,0,0,0
Essendon,"Hartley, Michael",5,3,2,2,0,0,0,5
Essendon,"Kelly, James",23,14,6,9,0,0,0,5
Essendon,"Langford, Kyle",13,3,0,10,0,0,0,1
Essendon,"Laverde, Jayden",8,3,1,5,1,0,0,2
Essendon,"Leuenberger, Matthew",16,5,3,11,0,2,25,0
Essendon,"McDonald-Tipungwuti, Anthony",23,14,3,9,0,0,0,0
Essendon,"McKenna, Conor",13,6,4,7,0,0,0,1
Essendon,"Merrett, Zach",29,16,5,13,1,0,0,8
Essendon,"Parish, Darcy",24,8,1,16,0,0,0,2
Essendon,"Stokes, Mathew",22,12,4,10,1,0,0,6
Essendon,"Zaharakis, David",34,17,7,17,1,0,0,3
Essendon,"Baguley, Mark",18,8,6,10,0,0,0,2
Essendon,"Bird, Craig",25,8,2,17,0,0,0,7
Essendon,"Brown, Mitch",13,8,7,5,1,3,0,0
Essendon,"Cooney, Adam",20,10,4,10,1,0,0,2
Essendon,"Daniher, Joe",7,6,6,1,1,1,0,1
Essendon,"Dea, Matt",11,7,6,4,0,0,0,0
Essendon,"Dempsey, Courtenay",16,12,4,4,0,1,0,2
Essendon,"Fantasia, Orazio",25,11,4,14,2,1,0,2
Essendon,"Gleeson, Martin",16,7,4,9,0,0,0,1
Essendon,"Goddard, Brendon",25,15,5,10,0,0,3,6
Essendon,"Grimley, Sam",12,9,6,3,2,0,1,3
Essendon,"Gwilt, James",19,13,4,6,0,0,0,2
Essendon,"Hartley, Michael",13,12,8,1,0,0,1,2
Essendon,"Kelly, James",29,12,7,17,1,0,0,3
Essendon,"Langford, Kyle",19,12,4,7,1,0,0,6
Essendon,"Leuenberger, Matthew",20,7,1,13,0,0,30,3
Essendon,"McDonald-Tipungwuti, Anthony",15,9,2,6,0,0,0,5
Essendon,"McKenna, Conor",13,8,4,5,0,0,0,3
Essendon,"Merrett, Zach",20,9,2,11,1,0,0,2
Essendon,"Parish, Darcy",20,7,6,13,0,0,0,2
Essendon,"Stokes, Mathew",12,5,4,7,1,1,0,5
Essendon,"Zaharakis, David",24,13,2,11,0,0,0,4
Essendon,"Brown, Mitch",18,13,9,5,2,1,0,2
Essendon,"Cooney, Adam",28,15,3,13,0,0,0,4
Essendon,"Crowley, Ryan",21,9,1,12,0,0,1,6
Essendon,"Daniher, Joe",13,11,6,2,1,3,0,0
Essendon,"Dea, Matt",12,7,1,5,0,0,0,1
Essendon,"Dempsey, Courtenay",25,15,7,10,0,0,0,4
Essendon,"Fantasia, Orazio",9,5,2,4,1,1,0,4
Essendon,"Gleeson, Martin",12,5,1,7,0,0,0,3
Essendon,"Goddard, Brendon",23,13,5,10,0,0,1,3
Essendon,"Grimley, Sam",4,3,1,1,1,0,1,2
Essendon,"Gwilt, James",20,12,5,8,0,0,0,3
Essendon,"Hartley, Michael",9,8,6,1,0,0,0,3
Essendon,"Kelly, James",18,10,6,8,0,0,0,6
Essendon,"Langford, Kyle",20,9,5,11,0,0,2,4
Essendon,"Leuenberger, Matthew",11,6,4,5,0,0,34,0
Essendon,"McDonald-Tipungwuti, Anthony",12,3,2,9,0,0,0,2
Essendon,"Merrett, Zach",25,12,4,13,0,0,0,6
Essendon,"Parish, Darcy",11,4,1,7,2,0,0,3
Essendon,"Polkinghorne, James",11,5,2,6,1,0,0,1
Essendon,"Simpkin, Jonathan",25,7,4,18,0,0,0,2
Essendon,"Stokes, Mathew",15,7,5,8,0,1,0,1
Essendon,"Zaharakis, David",24,15,3,9,0,0,0,7
Essendon,"Baguley, Mark",16,9,5,7,0,3,0,5
Essendon,"Bird, Craig",20,11,3,9,1,0,0,4
Essendon,"Brown, Mitch",23,14,9,9,1,0,0,2
Essendon,"Cooney, Adam",17,8,3,9,0,0,1,3
Essendon,"Crowley, Ryan",26,15,6,11,0,0,2,1
Essendon,"Daniher, Joe",15,7,5,8,0,1,2,1
Essendon,"Dea, Matt",18,9,9,9,0,0,0,3
Essendon,"Dempsey, Courtenay",24,16,8,8,0,0,0,2
Essendon,"Fantasia, Orazio",13,6,2,7,1,1,0,4
Essendon,"Goddard, Brendon",28,14,5,14,0,1,2,1
Essendon,"Grima, Nathan",13,9,5,4,0,0,0,1
Essendon,"Gwilt, James",15,10,3,5,0,0,0,1
Essendon,"Hartley, Michael",10,7,3,3,0,0,0,4
Essendon,"Kelly, James",29,13,7,16,0,0,0,2
Essendon,"Leuenberger, Matthew",12,3,1,9,0,0,21,3
Essendon,"McDonald-Tipungwuti, Anthony",18,14,7,4,0,1,0,2
Essendon,"McKernan, Shaun",11,7,5,4,1,0,5,2
Essendon,"Merrett, Zach",24,11,6,13,0,1,0,8
Essendon,"Polkinghorne, James",12,6,1,6,0,0,0,2
Essendon,"Redman, Mason",10,4,2,6,0,0,0,6
Essendon,"Simpkin, Jonathan",8,6,2,2,1,0,0,0
Essendon,"Zaharakis, David",33,22,2,11,2,2,0,3
Essendon,"Ambrose, Patrick",11,4,1,7,0,0,0,2
Essendon,"Baguley, Mark",24,14,5,10,0,0,0,6
Essendon,"Bird, Craig",27,7,1,20,0,0,0,5
Essendon,"Brown, Mitch",7,3,3,4,0,0,0,1
Essendon,"Cooney, Adam",33,16,5,17,1,1,0,3
Essendon,"Crowley, Ryan",18,10,4,8,0,1,0,1
Essendon,"Daniher, Joe",16,14,7,2,2,1,8,1
Essendon,"Dea, Matt",19,13,8,6,0,0,0,1
Essendon,"Fantasia, Orazio",9,5,3,4,2,1,0,3
Essendon,"Goddard, Brendon",38,18,4,20,0,2,2,1
Essendon,"Grima, Nathan",14,7,5,7,0,0,0,1
Essendon,"Hartley, Michael",12,4,5,8,0,0,0,1
Essendon,"Kelly, James",26,13,5,13,0,0,0,2
Essendon,"Langford, Kyle",17,12,8,5,2,0,0,2
Essendon,"Leuenberger, Matthew",11,4,4,7,0,0,17,0
Essendon,"McDonald-Tipungwuti, Anthony",17,8,5,9,0,0,0,3
Essendon,"McKenna, Conor",14,6,5,8,0,0,0,0
Essendon,"Merrett, Zach",36,16,6,20,0,2,0,8
Essendon,"Parish, Darcy",24,9,6,15,0,0,0,1
Essendon,"Polkinghorne, James",17,10,5,7,0,2,0,1
Essendon,"Redman, Mason",7,4,4,3,1,2,0,0
Essendon,"Zaharakis, David",12,6,1,6,0,0,0,6
Essendon,"Ambrose, Patrick",18,10,6,8,0,0,0,2
Essendon,"Baguley, Mark",13,10,10,3,1,0,0,4
Essendon,"Bird, Craig",20,6,4,14,0,0,0,6
Essendon,"Brown, Mitch",12,11,6,1,4,2,0,1
Essendon,"Cooney, Adam",26,13,6,13,1,1,0,4
Essendon,"Daniher, Joe",10,7,5,3,2,0,6,1
Essendon,"Dea, Matt",26,17,15,9,0,0,0,2
Essendon,"Fantasia, Orazio",12,4,5,8,0,0,0,0
Essendon,"Gleeson, Martin",19,13,8,6,0,1,0,1
Essendon,"Goddard, Brendon",30,10,9,20,0,0,3,5
Essendon,"Gwilt, James",23,17,9,6,0,0,0,1
Essendon,"Hartley, Michael",15,6,3,9,0,0,0,1
Essendon,"Kelly, James",33,20,10,13,0,0,0,5
Essendon,"Langford, Kyle",12,8,6,4,1,1,0,2
Essendon,"Leuenberger, Matthew",12,5,2,7,0,0,30,3
Essendon,"McDonald-Tipungwuti, Anthony",20,12,9,8,0,0,0,4
Essendon,"McKenna, Conor",3,1,0,2,0,0,0,1
Essendon,"Merrett, Zach",29,13,3,16,0,0,0,4
Essendon,"Parish, Darcy",20,2,2,18,0,0,0,3
Essendon,"Polkinghorne, James",9,4,4,5,0,0,2,1
Essendon,"Redman, Mason",2,2,1,0,0,0,0,2
Essendon,"Zaharakis, David",31,17,4,14,0,1,0,3
Essendon,"Ambrose, Patrick",5,3,2,2,0,0,0,5
Essendon,"Baguley, Mark",13,10,3,3,0,0,0,4
Essendon,"Bird, Craig",19,6,2,13,0,0,0,7
Essendon,"Brown, Mitch",9,6,3,3,2,0,0,3
Essendon,"Cooney, Adam",25,13,6,12,0,0,0,4
Essendon,"Crowley, Ryan",14,5,5,9,1,0,0,1
Essendon,"Daniher, Joe",17,7,7,10,2,0,5,1
Essendon,"Dea, Matt",18,9,6,9,0,0,0,1
Essendon,"Dempsey, Courtenay",17,13,7,4,0,0,0,2
Essendon,"Edwards, Shaun",14,7,2,7,0,1,0,2
Essendon,"Fantasia, Orazio",10,5,4,5,2,2,0,4
Essendon,"Gleeson, Martin",16,8,3,8,0,0,0,1
Essendon,"Goddard, Brendon",34,22,6,12,0,1,4,5
Essendon,"Gwilt, James",20,14,7,6,0,0,0,0
Essendon,"Hartley, Michael",3,1,1,2,0,0,0,1
Essendon,"Jamar, Mark",7,2,3,5,1,0,19,2
Essendon,"Kelly, James",24,12,3,12,0,0,0,10
Essendon,"Langford, Kyle",12,6,3,6,0,0,0,3
Essendon,"McDonald-Tipungwuti, Anthony",14,10,5,4,0,0,0,5
Essendon,"Merrett, Zach",22,11,7,11,0,1,0,9
Essendon,"Parish, Darcy",25,12,7,13,2,1,0,0
Essendon,"Zaharakis, David",30,13,4,17,0,0,0,4
Essendon,"Ambrose, Patrick",11,7,4,4,0,0,0,4
Essendon,"Baguley, Mark",16,10,4,6,0,0,0,3
Essendon,"Bird, Craig",22,8,3,14,0,0,0,9
Essendon,"Brown, Mitch",10,4,1,6,0,1,0,3
Essendon,"Cooney, Adam",21,12,6,9,0,2,0,0
Essendon,"Crowley, Ryan",21,10,5,11,0,0,1,2
Essendon,"Daniher, Joe",10,3,1,7,2,1,5,1
Essendon,"Dea, Matt",13,7,2,6,0,0,0,2
Essendon,"Dempsey, Courtenay",14,10,4,4,0,0,0,3
Essendon,"Edwards, Shaun",20,15,3,5,0,0,0,3
Essendon,"Fantasia, Orazio",8,3,3,5,1,2,0,4
Essendon,"Gleeson, Martin",21,9,7,12,0,0,0,2
Essendon,"Goddard, Brendon",24,11,9,13,1,1,1,3
Essendon,"Gwilt, James",17,13,7,4,0,0,0,6
Essendon,"Hams, Will",14,9,3,5,1,1,0,5
Essendon,"Langford, Kyle",12,10,6,2,0,1,0,1
Essendon,"Leuenberger, Matthew",16,7,3,9,0,0,27,8
Essendon,"McDonald-Tipungwuti, Anthony",16,7,3,9,1,0,0,1
Essendon,"Merrett, Jackson",19,4,3,15,0,0,0,3
Essendon,"Merrett, Zach",37,12,2,25,0,0,0,7
Essendon,"Parish, Darcy",22,7,3,15,0,0,0,3
Essendon,"Zaharakis, David",11,3,0,8,0,0,0,1
Essendon,"Ambrose, Patrick",14,6,2,8,0,0,0,4
Essendon,"Bird, Craig",16,4,0,12,1,0,0,5
Essendon,"Brown, Mitch",16,10,8,6,1,1,0,1
Essendon,"Cooney, Adam",27,12,7,15,0,0,0,1
Essendon,"Daniher, Joe",16,12,10,4,2,2,0,2
Essendon,"Dea, Matt",22,14,10,8,0,0,0,5
Essendon,"Dempsey, Courtenay",11,7,0,4,0,0,0,1
Essendon,"Edwards, Shaun",15,11,2,4,0,0,3,0
Essendon,"Fantasia, Orazio",27,15,5,12,0,0,0,2
Essendon,"Gleeson, Martin",23,10,5,13,0,0,0,2
Essendon,"Goddard, Brendon",25,9,7,16,0,0,1,2
Essendon,"Gwilt, James",21,7,4,14,0,0,0,3
Essendon,"Hams, Will",14,6,4,8,0,0,0,6
Essendon,"Jamar, Mark",9,4,5,5,0,2,12,0
Essendon,"Kelly, James",27,14,6,13,0,0,0,2
Essendon,"Langford, Kyle",14,3,2,11,1,0,0,7
Essendon,"Leuenberger, Matthew",15,5,2,10,0,0,29,4
Essendon,"Merrett, Jackson",20,8,4,12,1,0,0,1
Essendon,"Merrett, Zach",31,16,5,15,0,1,0,6
Essendon,"Parish, Darcy",27,8,3,19,0,0,0,3
Essendon,"Stokes, Mathew",11,7,5,4,0,0,0,1
Essendon,"Zaharakis, David",33,15,3,18,0,0,0,5
Essendon,"Ambrose, Patrick",6,4,2,2,0,0,0,3
Essendon,"Ashby, Jason",13,7,2,6,0,0,0,5
Essendon,"Bird, Craig",12,4,1,8,0,0,0,7
Essendon,"Brown, Mitch",12,11,3,1,2,4,0,0
Essendon,"Cooney, Adam",25,18,12,7,0,2,0,5
Essendon,"Daniher, Joe",11,9,6,2,2,2,0,4
Essendon,"Dempsey, Courtenay",18,14,4,4,0,2,0,5
Essendon,"Fantasia, Orazio",12,11,6,1,4,4,0,3
Essendon,"Gleeson, Martin",18,7,6,11,0,0,0,0
Essendon,"Goddard, Brendon",25,14,8,11,0,0,3,3
Essendon,"Gwilt, James",21,14,6,7,0,0,0,2
Essendon,"Hams, Will",15,7,6,8,0,0,0,3
Essendon,"Hartley, Michael",8,7,3,1,0,0,0,3
Essendon,"Jamar, Mark",12,6,6,6,2,1,14,0
Essendon,"Kelly, James",21,11,5,10,0,0,0,6
Essendon,"Leuenberger, Matthew",7,4,3,3,2,0,27,4
Essendon,"McDonald-Tipungwuti, Anthony",17,15,5,2,0,0,0,3
Essendon,"Merrett, Jackson",17,11,4,6,0,1,0,0
Essendon,"Merrett, Zach",22,14,5,8,0,0,0,8
Essendon,"Parish, Darcy",13,6,3,7,0,2,0,0
Essendon,"Stokes, Mathew",16,9,4,7,0,0,0,2
Essendon,"Zaharakis, David",25,11,2,14,0,0,0,5
Essendon,"Ashby, Jason",10,5,0,5,0,0,0,3
Essendon,"Bird, Craig",26,12,5,14,0,0,0,8
Essendon,"Brown, Mitch",9,6,4,3,1,1,0,1
Essendon,"Cooney, Adam",13,6,4,7,0,0,0,4
Essendon,"Daniher, Joe",14,12,6,2,3,1,6,1
Essendon,"Dea, Matt",16,9,8,7,0,0,0,0
Essendon,"Dempsey, Courtenay",15,11,4,4,1,0,0,1
Essendon,"Fantasia, Orazio",12,4,3,8,1,1,0,3
Essendon,"Gleeson, Martin",19,11,6,8,0,0,0,3
Essendon,"Goddard, Brendon",22,9,3,13,1,0,7,7
Essendon,"Gwilt, James",21,17,7,4,0,0,0,1
Essendon,"Hams, Will",8,5,3,3,0,0,0,2
Essendon,"Hartley, Michael",7,5,4,2,0,0,0,0
Essendon,"Jamar, Mark",4,2,4,2,0,0,9,1
Essendon,"Kelly, James",29,21,4,8,0,2,0,7
Essendon,"Leuenberger, Matthew",5,2,2,3,0,1,31,2
Essendon,"McDonald-Tipungwuti, Anthony",10,9,2,1,0,0,0,3
Essendon,"Merrett, Jackson",23,14,6,9,0,1,0,4
Essendon,"Merrett, Zach",24,17,4,7,0,0,0,11
Essendon,"Parish, Darcy",13,3,1,10,0,0,0,4
Essendon,"Stokes, Mathew",8,6,5,2,0,0,0,3
Essendon,"Zaharakis, David",15,11,1,4,0,0,0,3
Essendon,"Ambrose, Patrick",9,6,3,3,0,0,0,1
Essendon,"Bird, Craig",19,10,1,9,0,1,0,6
Essendon,"Brown, Mitch",12,6,3,6,1,1,0,4
Essendon,"Cooney, Adam",28,16,11,12,0,0,0,0
Essendon,"Daniher, Joe",16,11,7,5,2,3,0,0
Essendon,"Dea, Matt",12,9,6,3,0,0,0,4
Essendon,"Dempsey, Courtenay",18,11,1,7,1,1,0,3
Essendon,"Fantasia, Orazio",13,8,3,5,3,3,0,5
Essendon,"Gleeson, Martin",12,6,5,6,0,0,0,1
Essendon,"Goddard, Brendon",28,14,2,14,0,0,3,6
Essendon,"Gwilt, James",19,13,7,6,0,0,0,0
Essendon,"Hams, Will",16,8,6,8,1,0,0,1
Essendon,"Hartley, Michael",13,8,6,5,0,0,0,4
Essendon,"Kelly, James",21,9,3,12,0,0,0,7
Essendon,"Langford, Kyle",21,9,4,12,0,0,1,4
Essendon,"Laverde, Jayden",9,4,1,5,2,0,0,4
Essendon,"McDonald-Tipungwuti, Anthony",17,10,6,7,2,2,0,5
Essendon,"McKenna, Conor",9,5,4,4,0,0,0,1
Essendon,"McKernan, Shaun",11,4,3,7,0,0,14,1
Essendon,"Merrett, Zach",36,19,2,17,1,0,0,5
Essendon,"Michael, Sam",9,7,4,2,0,0,16,5
Essendon,"Parish, Darcy",21,11,3,10,1,1,0,1
Essendon,"Ambrose, Patrick",8,5,1,3,0,0,0,0
Essendon,"Bird, Craig",24,9,3,15,0,0,0,7
Essendon,"Brown, Mitch",14,10,7,4,0,1,0,2
Essendon,"Daniher, Joe",6,6,4,0,2,0,0,3
Essendon,"Dea, Matt",15,6,4,9,0,0,0,2
Essendon,"Dempsey, Courtenay",12,11,5,1,0,0,0,0
Essendon,"Fantasia, Orazio",11,10,2,1,3,3,0,7
Essendon,"Gleeson, Martin",17,9,2,8,0,0,0,1
Essendon,"Goddard, Brendon",27,15,5,12,0,1,1,4
Essendon,"Gwilt, James",6,3,1,3,0,0,0,0
Essendon,"Hams, Will",12,6,2,6,1,0,0,8
Essendon,"Hartley, Michael",6,3,2,3,0,0,0,4
Essendon,"Kelly, James",23,13,8,10,1,0,0,4
Essendon,"Langford, Kyle",17,7,2,10,0,1,1,5
Essendon,"Laverde, Jayden",11,8,8,3,2,0,0,2
Essendon,"Leuenberger, Matthew",12,9,4,3,0,2,20,4
Essendon,"McDonald-Tipungwuti, Anthony",9,8,6,1,0,1,0,6
Essendon,"McKenna, Conor",15,11,5,4,0,0,0,4
Essendon,"McKernan, Shaun",11,10,3,1,1,1,9,2
Essendon,"Merrett, Zach",34,18,7,16,1,0,0,10
Essendon,"Parish, Darcy",20,9,4,11,0,1,0,7
Essendon,"Zaharakis, David",15,11,2,4,0,0,0,5
Essendon,"Ambrose, Patrick",13,4,1,9,0,0,0,3
Essendon,"Brown, Mitch",12,6,3,6,1,2,0,1
Essendon,"Cooney, Adam",19,11,4,8,0,2,0,4
Essendon,"Daniher, Joe",10,8,5,2,4,1,0,1
Essendon,"Dea, Matt",16,13,6,3,0,0,0,3
Essendon,"Dempsey, Courtenay",15,11,3,4,1,0,0,1
Essendon,"Fantasia, Orazio",10,8,4,2,3,1,0,9
Essendon,"Francis, Aaron",16,9,7,7,0,1,0,2
Essendon,"Gleeson, Martin",17,12,4,5,0,0,0,0
Essendon,"Goddard, Brendon",31,18,11,13,0,0,2,6
Essendon,"Hams, Will",15,6,3,9,1,1,0,1
Essendon,"Hartley, Michael",7,2,0,5,0,0,0,5
Essendon,"Kelly, James",16,8,3,8,0,0,0,5
Essendon,"Langford, Kyle",19,11,7,8,1,0,2,3
Essendon,"Laverde, Jayden",14,11,6,3,0,2,0,5
Essendon,"Leuenberger, Matthew",18,13,2,5,0,1,36,3
Essendon,"McDonald-Tipungwuti, Anthony",13,8,4,5,1,3,0,3
Essendon,"McKenna, Conor",14,7,2,7,0,2,0,2
Essendon,"McKernan, Shaun",10,6,3,4,0,0,5,2
Essendon,"Merrett, Zach",34,15,6,19,0,0,0,8
Essendon,"Parish, Darcy",21,8,5,13,0,0,0,4
Essendon,"Zaharakis, David",13,7,2,6,0,1,0,7
Essendon,"Ambrose, Patrick",11,9,8,2,0,0,0,4
Essendon,"Bird, Craig",21,11,5,10,0,0,0,9
Essendon,"Cooney, Adam",23,16,7,7,1,0,3,3
Essendon,"Daniher, Joe",21,15,11,6,4,1,0,1
Essendon,"Dea, Matt",19,10,5,9,0,0,0,3
Essendon,"Dempsey, Courtenay",10,7,5,3,0,0,0,0
Essendon,"Fantasia, Orazio",13,7,4,6,1,2,0,3
Essendon,"Francis, Aaron",7,5,0,2,0,1,0,1
Essendon,"Gleeson, Martin",13,4,1,9,0,0,0,3
Essendon,"Goddard, Brendon",29,18,7,11,0,0,1,1
Essendon,"Hams, Will",17,9,6,8,0,0,0,1
Essendon,"Hartley, Michael",9,6,6,3,0,0,0,6
Essendon,"Langford, Kyle",15,6,4,9,1,0,0,2
Essendon,"Laverde, Jayden",17,7,5,10,2,0,0,1
Essendon,"Leuenberger, Matthew",11,7,0,4,0,0,53,5
Essendon,"McDonald-Tipungwuti, Anthony",14,3,1,11,0,1,0,3
Essendon,"McKenna, Conor",16,12,3,4,0,1,0,4
Essendon,"Merrett, Zach",31,17,4,14,0,0,0,2
Essendon,"Michael, Sam",7,2,3,5,0,0,3,2
Essendon,"Parish, Darcy",21,5,1,16,0,0,0,4
Essendon,"Polkinghorne, James",20,7,3,13,0,1,0,0
Essendon,"Zaharakis, David",18,8,2,10,0,0,0,4
Essendon,"Ambrose, Patrick",14,8,3,6,0,0,0,3
Essendon,"Bird, Craig",19,7,1,12,0,0,0,5
Essendon,"Brown, Mitch",25,19,18,6,0,0,0,2
Essendon,"Cooney, Adam",22,16,9,6,0,2,0,3
Essendon,"Daniher, Joe",14,13,8,1,1,2,0,0
Essendon,"Dea, Matt",10,6,4,4,0,0,0,2
Essendon,"Dempsey, Courtenay",14,11,5,3,0,1,0,0
Essendon,"Francis, Aaron",8,6,5,2,1,0,0,2
Essendon,"Gleeson, Martin",23,14,14,9,0,0,0,3
Essendon,"Goddard, Brendon",6,3,0,3,0,0,1,1
Essendon,"Grimley, Sam",6,5,2,1,1,0,2,0
Essendon,"Hartley, Michael",12,8,4,4,0,0,0,5
Essendon,"Kelly, James",26,17,10,9,0,1,0,4
Essendon,"Laverde, Jayden",16,10,8,6,0,2,0,3
Essendon,"Leuenberger, Matthew",13,10,4,3,0,0,26,3
Essendon,"McDonald-Tipungwuti, Anthony",13,9,5,4,0,0,0,3
Essendon,"McKenna, Conor",14,11,5,3,1,0,0,0
Essendon,"Merrett, Jackson",18,12,7,6,0,1,0,1
Essendon,"Merrett, Zach",25,19,5,6,0,1,0,1
Essendon,"Parish, Darcy",24,13,7,11,0,0,0,1
Essendon,"Polkinghorne, James",15,3,4,12,0,0,0,1
Essendon,"Zaharakis, David",17,12,6,5,0,0,0,6
Essendon,"Ambrose, Patrick",17,5,3,12,0,0,0,3
Essendon,"Bird, Craig",25,8,1,17,1,0,0,9
Essendon,"Brown, Mitch",21,14,11,7,1,0,0,2
Essendon,"Cooney, Adam",20,15,4,5,1,1,1,3
Essendon,"Daniher, Joe",17,11,8,6,1,1,1,0
Essendon,"Dea, Matt",20,15,7,5,0,0,0,3
Essendon,"Fantasia, Orazio",9,7,4,2,3,1,0,2
Essendon,"Gleeson, Martin",23,7,5,16,0,0,0,1
Essendon,"Grimley, Sam",5,2,1,3,1,1,4,0
Essendon,"Hartley, Michael",8,5,4,3,0,0,0,2
Essendon,"Kelly, James",26,12,7,14,0,0,0,1
Essendon,"Laverde, Jayden",12,7,3,5,0,2,0,1
Essendon,"Leuenberger, Matthew",9,3,3,6,0,0,29,0
Essendon,"Long, Jake",13,6,4,7,0,1,0,3
Essendon,"McDonald-Tipungwuti, Anthony",19,13,8,6,0,0,0,3
Essendon,"McKenna, Conor",22,15,3,7,2,0,0,1
Essendon,"Merrett, Jackson",17,6,3,11,1,1,0,1
Essendon,"Merrett, Zach",38,20,6,18,0,0,0,3
Essendon,"Polkinghorne, James",21,3,5,18,0,0,0,1
Essendon,"Simpkin, Jonathan",24,12,4,12,0,0,0,2
Essendon,"Stokes, Mathew",32,13,7,19,0,0,0,2
Essendon,"Zaharakis, David",40,19,4,21,0,0,0,6
Essendon,"Ambrose, Patrick",14,10,6,4,0,1,0,1
Essendon,"Bird, Craig",19,7,2,12,0,0,0,7
Essendon,"Brown, Mitch",22,12,13,10,0,0,0,1
Essendon,"Cooney, Adam",22,13,6,9,1,1,0,3
Essendon,"Daniher, Joe",11,8,6,3,2,3,0,0
Essendon,"Dea, Matt",14,10,5,4,0,0,0,0
Essendon,"Fantasia, Orazio",14,8,5,6,1,0,0,2
Essendon,"Gleeson, Martin",13,8,5,5,0,0,0,0
Essendon,"Hartley, Michael",18,12,8,6,0,0,0,2
Essendon,"Jamar, Mark",8,3,3,5,0,0,17,2
Essendon,"Kelly, James",30,13,11,17,0,0,0,1
Essendon,"Langford, Kyle",13,7,5,6,0,1,0,4
Essendon,"Laverde, Jayden",8,5,4,3,0,1,0,7
Essendon,"Leuenberger, Matthew",13,5,0,8,1,0,24,1
Essendon,"Long, Jake",10,5,3,5,0,0,0,4
Essendon,"McDonald-Tipungwuti, Anthony",10,3,2,7,0,0,0,2
Essendon,"McKenna, Conor",16,8,3,8,0,0,0,2
Essendon,"Merrett, Jackson",15,10,9,5,1,1,0,1
Essendon,"Merrett, Zach",35,22,5,13,1,1,0,8
Essendon,"Parish, Darcy",19,5,2,14,0,0,0,2
Essendon,"Stokes, Mathew",31,16,9,15,0,1,0,3
Essendon,"Zaharakis, David",31,12,8,19,0,0,0,10
Essendon,"Ambrose, Patrick",12,7,4,5,0,0,0,1
Essendon,"Bird, Craig",22,10,5,12,0,1,0,5
Essendon,"Brown, Mitch",21,12,6,9,0,0,1,1
Essendon,"Daniher, Joe",17,12,6,5,5,2,0,0
Essendon,"Dea, Matt",27,17,10,10,0,0,0,2
Essendon,"Dempsey, Courtenay",13,10,6,3,1,1,0,0
Essendon,"Gleeson, Martin",16,7,4,9,0,0,0,3
Essendon,"Goddard, Brendon",24,9,5,15,0,0,0,6
Essendon,"Hartley, Michael",8,6,4,2,0,1,0,2
Essendon,"Kelly, James",22,14,8,8,0,0,0,5
Essendon,"Kommer, Nick",9,4,3,5,0,1,0,2
Essendon,"Langford, Kyle",14,10,9,4,3,2,0,5
Essendon,"Laverde, Jayden",10,9,7,1,1,2,0,1
Essendon,"Leuenberger, Matthew",15,4,3,11,0,1,18,1
Essendon,"Long, Jake",10,5,4,5,0,0,0,0
Essendon,"McDonald-Tipungwuti, Anthony",10,6,3,4,4,0,0,3
Essendon,"McKenna, Conor",18,12,3,6,0,0,0,2
Essendon,"McKernan, Shaun",16,13,5,3,1,0,3,1
Essendon,"Merrett, Jackson",17,8,5,9,0,0,0,0
Essendon,"Merrett, Zach",34,20,4,14,0,0,0,3
Essendon,"Parish, Darcy",23,9,5,14,0,0,0,8
Essendon,"Zaharakis, David",22,12,6,10,0,0,0,3
Fremantle,"Ballantyne, Hayden",9,7,4,2,0,1,0,5
Fremantle,"Barlow, Michael",22,13,6,9,0,0,3,2
Fremantle,"Clarke, Zac",7,1,2,6,0,0,5,1
Fremantle,"Dawson, Zac",15,4,8,11,0,0,0,3
Fremantle,"Fyfe, Nat",15,6,4,9,0,0,4,2
Fremantle,"Griffin, Jonathon",7,2,0,5,0,0,14,2
Fremantle,"Hill, Stephen",12,6,2,6,0,0,0,3
Fremantle,"Ibbotson, Garrick",22,15,7,7,0,0,0,3
Fremantle,"Mayne, Chris",10,5,3,5,0,2,0,0
Fremantle,"Mundy, David",21,10,2,11,0,0,0,3
Fremantle,"Mzungu, Tendai",12,6,2,6,0,0,0,2
Fremantle,"Neale, Lachie",32,13,4,19,0,0,0,4
Fremantle,"Pavlich, Matthew",6,5,4,1,1,1,0,1
Fremantle,"Pearce, Clancee",28,19,8,9,0,0,0,1
Fremantle,"Pearce, Danyle",16,9,2,7,0,1,0,4
Fremantle,"Sheridan, Tom",27,20,11,7,0,0,0,3
Fremantle,"Spurr, Lee",17,15,9,2,0,0,0,2
Fremantle,"Suban, Nick",15,11,3,4,1,0,0,3
Fremantle,"Sutcliffe, Cam",21,15,8,6,0,1,0,2
Fremantle,"Taberner, Matthew",8,4,4,4,1,1,0,1
Fremantle,"Walters, Michael",13,9,4,4,1,1,0,4
Fremantle,"Weller, Lachie",5,3,1,2,1,0,0,4
Fremantle,"Ballantyne, Hayden",8,5,1,3,4,0,0,1
Fremantle,"Barlow, Michael",16,3,1,13,1,1,0,4
Fremantle,"Dawson, Zac",4,2,1,2,0,0,0,0
Fremantle,"Fyfe, Nat",34,14,3,20,3,2,2,4
Fremantle,"Hill, Stephen",29,21,1,8,0,0,0,7
Fremantle,"Ibbotson, Garrick",7,4,2,3,0,0,0,1
Fremantle,"Johnson, Michael",17,11,6,6,0,0,1,1
Fremantle,"Langdon, Ed",13,7,3,6,0,0,0,3
Fremantle,"Mayne, Chris",15,8,4,7,1,1,0,6
Fremantle,"Mundy, David",21,16,2,5,0,1,0,5
Fremantle,"Neale, Lachie",27,14,4,13,0,0,0,5
Fremantle,"Pavlich, Matthew",18,10,4,8,2,2,1,3
Fremantle,"Pearce, Alex",7,2,0,5,0,1,7,2
Fremantle,"Pearce, Clancee",16,7,4,9,0,0,0,2
Fremantle,"Pearce, Danyle",16,12,3,4,0,2,0,3
Fremantle,"Sandilands, Aaron",6,1,2,5,0,0,48,2
Fremantle,"Sheridan, Tom",16,8,3,8,0,0,0,1
Fremantle,"Spurr, Lee",14,10,9,4,0,0,0,1
Fremantle,"Suban, Nick",13,7,1,6,0,0,0,6
Fremantle,"Sutcliffe, Cam",9,6,2,3,0,0,0,5
Fremantle,"Walters, Michael",16,12,5,4,3,3,0,2
Fremantle,"Weller, Lachie",12,6,2,6,0,2,0,1
Fremantle,"Ballantyne, Hayden",11,9,5,2,1,2,0,5
Fremantle,"Barlow, Michael",22,11,5,11,0,1,0,7
Fremantle,"Dawson, Zac",13,5,6,8,0,0,0,1
Fremantle,"Fyfe, Nat",26,9,6,17,1,0,3,10
Fremantle,"Hill, Stephen",21,16,4,5,0,1,1,6
Fremantle,"Ibbotson, Garrick",25,19,8,6,0,0,0,0
Fremantle,"Johnson, Michael",11,9,5,2,0,0,2,1
Fremantle,"Langdon, Ed",9,2,0,7,1,0,0,2
Fremantle,"Mayne, Chris",15,9,6,6,0,2,0,4
Fremantle,"Mzungu, Tendai",12,5,1,7,0,0,0,1
Fremantle,"Neale, Lachie",26,11,1,15,0,0,0,4
Fremantle,"Pavlich, Matthew",11,7,6,4,3,0,0,1
Fremantle,"Pearce, Alex",10,7,3,3,0,0,5,5
Fremantle,"Pearce, Danyle",18,15,8,3,0,1,0,1
Fremantle,"Sandilands, Aaron",3,0,0,3,0,0,11,0
Fremantle,"Sheridan, Tom",22,16,5,6,0,0,0,1
Fremantle,"Spurr, Lee",22,17,8,5,0,0,0,3
Fremantle,"Suban, Nick",9,4,1,5,0,0,0,5
Fremantle,"Sutcliffe, Cam",23,17,6,6,0,1,0,4
Fremantle,"Walters, Michael",13,8,3,5,2,0,0,0
Fremantle,"Weller, Lachie",11,9,4,2,0,2,0,5
Fremantle,"de Boer, Matt",8,4,2,4,0,0,1,7
Fremantle,"Ballantyne, Hayden",12,10,2,2,2,0,0,1
Fremantle,"Barlow, Michael",14,4,2,10,1,0,1,9
Fremantle,"Crozier, Hayden",9,7,1,2,0,2,0,3
Fremantle,"Dawson, Zac",8,2,3,6,0,0,0,3
Fremantle,"Fyfe, Nat",27,12,7,15,4,0,0,7
Fremantle,"Griffin, Jonathon",11,3,0,8,0,0,16,0
Fremantle,"Hill, Stephen",24,18,3,6,1,1,1,6
Fremantle,"Ibbotson, Garrick",18,8,6,10,0,0,0,1
Fremantle,"Johnson, Michael",15,12,8,3,0,1,0,1
Fremantle,"Langdon, Ed",11,3,0,8,0,0,0,2
Fremantle,"Mayne, Chris",14,5,6,9,1,1,0,7
Fremantle,"Neale, Lachie",35,15,5,20,1,1,0,6
Fremantle,"Pavlich, Matthew",18,10,1,8,2,3,1,2
Fremantle,"Pearce, Alex",11,5,4,6,0,0,0,2
Fremantle,"Pearce, Danyle",17,10,2,7,0,0,0,1
Fremantle,"Sheridan, Tom",16,8,3,8,0,0,0,2
Fremantle,"Spurr, Lee",20,12,9,8,0,0,0,2
Fremantle,"Suban, Nick",11,2,1,9,0,0,0,4
Fremantle,"Sutcliffe, Cam",19,9,7,10,0,1,0,0
Fremantle,"Taberner, Matthew",13,7,2,6,0,0,4,3
Fremantle,"Walters, Michael",14,12,6,2,2,1,0,2
Fremantle,"Weller, Lachie",15,10,2,5,0,1,0,3
Fremantle,"Ballantyne, Hayden",4,1,0,3,0,1,0,1
Fremantle,"Barlow, Michael",32,12,2,20,0,0,2,14
Fremantle,"Clarke, Zac",5,1,0,4,0,0,19,3
Fremantle,"Crozier, Hayden",11,8,2,3,2,2,0,5
Fremantle,"Dawson, Zac",9,5,3,4,0,0,2,2
Fremantle,"Fyfe, Nat",15,6,1,9,1,0,1,3
Fremantle,"Grey, Brady",16,3,1,13,0,0,0,10
Fremantle,"Griffin, Jonathon",13,6,3,7,1,1,19,2
Fremantle,"Hill, Stephen",23,15,1,8,0,2,2,4
Fremantle,"Johnson, Michael",19,14,9,5,0,0,0,0
Fremantle,"Mayne, Chris",12,7,5,5,1,1,0,9
Fremantle,"Neale, Lachie",35,23,10,12,0,1,0,2
Fremantle,"Pavlich, Matthew",12,5,2,7,0,3,0,10
Fremantle,"Pearce, Alex",7,2,0,5,0,0,0,0
Fremantle,"Pearce, Danyle",23,15,1,8,0,0,0,2
Fremantle,"Sheridan, Tom",20,6,3,14,0,0,0,0
Fremantle,"Spurr, Lee",20,11,6,9,0,0,0,9
Fremantle,"Sutcliffe, Cam",16,8,4,8,1,0,0,5
Fremantle,"Taberner, Matthew",18,10,8,8,1,0,1,3
Fremantle,"Tucker, Darcy",16,6,3,10,0,0,0,3
Fremantle,"Walters, Michael",18,11,4,7,2,0,0,6
Fremantle,"Weller, Lachie",18,9,0,9,0,1,0,7
Fremantle,"Ballantyne, Hayden",10,6,2,4,0,1,0,3
Fremantle,"Barlow, Michael",33,16,2,17,0,0,1,8
Fremantle,"Blakely, Connor",10,2,0,8,0,1,1,5
Fremantle,"Clarke, Zac",9,3,4,6,0,1,15,3
Fremantle,"Crozier, Hayden",8,6,2,2,1,1,0,5
Fremantle,"Dawson, Zac",8,1,2,7,0,0,1,1
Fremantle,"Grey, Brady",14,6,1,8,0,0,0,7
Fremantle,"Griffin, Jonathon",9,3,3,6,1,0,16,3
Fremantle,"Hill, Stephen",25,18,4,7,0,0,0,5
Fremantle,"Mayne, Chris",20,9,7,11,1,1,0,3
Fremantle,"Mundy, David",19,16,5,3,0,1,0,1
Fremantle,"Neale, Lachie",40,14,3,26,0,1,0,3
Fremantle,"Pavlich, Matthew",15,12,6,3,1,4,0,2
Fremantle,"Pearce, Alex",11,4,4,7,0,0,0,3
Fremantle,"Pearce, Danyle",25,15,2,10,0,0,0,2
Fremantle,"Sheridan, Tom",9,7,4,2,0,0,0,2
Fremantle,"Spurr, Lee",17,9,7,8,0,0,0,0
Fremantle,"Sutcliffe, Cam",16,9,7,7,0,0,0,5
Fremantle,"Taberner, Matthew",19,7,7,12,1,1,0,4
Fremantle,"Tucker, Darcy",13,6,2,7,0,1,0,1
Fremantle,"Walters, Michael",29,19,4,10,3,2,0,7
Fremantle,"Weller, Lachie",17,12,5,5,0,0,0,0
Fremantle,"Ballantyne, Hayden",19,12,3,7,2,2,0,1
Fremantle,"Barlow, Michael",15,3,2,12,0,0,0,5
Fremantle,"Blakely, Connor",10,6,2,4,0,0,5,2
Fremantle,"Crozier, Hayden",8,4,4,4,1,0,0,3
Fremantle,"Dawson, Zac",7,1,2,6,0,0,4,1
Fremantle,"Griffin, Jonathon",17,9,2,8,0,0,41,3
Fremantle,"Hill, Stephen",27,16,1,11,0,1,0,3
Fremantle,"Hughes, Ethan",10,8,6,2,0,0,0,5
Fremantle,"Ibbotson, Garrick",11,11,8,0,0,0,0,4
Fremantle,"Mayne, Chris",11,6,3,5,3,1,1,8
Fremantle,"Mundy, David",20,12,2,8,0,0,1,3
Fremantle,"Neale, Lachie",33,13,6,20,0,0,0,1
Fremantle,"Pavlich, Matthew",11,5,6,6,1,2,0,2
Fremantle,"Pearce, Alex",6,4,2,2,0,0,0,1
Fremantle,"Pearce, Danyle",26,19,6,7,1,0,0,2
Fremantle,"Sheridan, Tom",11,9,3,2,0,0,0,3
Fremantle,"Spurr, Lee",14,9,4,5,0,0,0,9
Fremantle,"Suban, Nick",9,5,1,4,1,0,0,6
Fremantle,"Sutcliffe, Cam",14,9,6,5,0,0,0,4
Fremantle,"Taberner, Matthew",7,3,3,4,1,0,0,1
Fremantle,"Walters, Michael",22,18,7,4,1,2,0,5
Fremantle,"Weller, Lachie",15,7,4,8,0,1,0,3
Fremantle,"Ballantyne, Hayden",13,8,1,5,1,2,0,3
Fremantle,"Blakely, Connor",18,10,0,8,0,1,6,2
Fremantle,"Clarke, Zac",5,2,1,3,0,0,17,6
Fremantle,"Crozier, Hayden",15,11,6,4,1,0,0,4
Fremantle,"Griffin, Jonathon",10,5,3,5,1,0,27,3
Fremantle,"Hill, Stephen",16,12,1,4,1,1,2,6
Fremantle,"Hughes, Ethan",14,3,2,11,0,0,0,3
Fremantle,"Ibbotson, Garrick",16,8,4,8,0,0,0,0
Fremantle,"Langdon, Ed",9,3,0,6,1,0,0,4
Fremantle,"Mayne, Chris",14,5,3,9,1,1,0,9
Fremantle,"Mundy, David",29,16,5,13,1,0,2,3
Fremantle,"Mzungu, Tendai",14,9,3,5,0,1,0,6
Fremantle,"Neale, Lachie",38,8,3,30,1,0,0,5
Fremantle,"Pearce, Alex",10,3,4,7,0,0,0,1
Fremantle,"Pearce, Clancee",26,8,5,18,0,0,0,1
Fremantle,"Pearce, Danyle",16,11,1,5,0,1,0,2
Fremantle,"Spurr, Lee",20,10,6,10,0,0,0,2
Fremantle,"Suban, Nick",10,7,0,3,0,0,0,5
Fremantle,"Sutcliffe, Cam",16,12,4,4,0,0,0,3
Fremantle,"Taberner, Matthew",13,8,7,5,0,0,0,2
Fremantle,"Walters, Michael",26,16,5,10,2,0,0,7
Fremantle,"Weller, Lachie",14,6,3,8,1,0,0,4
Fremantle,"Ballantyne, Hayden",13,8,2,5,3,0,0,0
Fremantle,"Blakely, Connor",22,14,1,8,0,0,7,7
Fremantle,"Clarke, Zac",8,1,1,7,0,0,15,2
Fremantle,"Crozier, Hayden",15,11,5,4,0,0,0,3
Fremantle,"Dawson, Zac",9,3,1,6,0,0,0,0
Fremantle,"Griffin, Jonathon",3,1,0,2,0,0,19,6
Fremantle,"Hughes, Ethan",17,9,5,8,0,0,0,1
Fremantle,"Ibbotson, Garrick",12,6,1,6,0,0,0,2
Fremantle,"Langdon, Ed",12,9,3,3,1,2,0,5
Fremantle,"Mayne, Chris",14,6,3,8,0,0,0,6
Fremantle,"Mundy, David",23,9,2,14,0,0,3,6
Fremantle,"Neale, Lachie",37,15,7,22,0,0,0,9
Fremantle,"Pavlich, Matthew",9,6,3,3,0,0,0,6
Fremantle,"Pearce, Alex",15,9,3,6,0,0,0,3
Fremantle,"Pearce, Clancee",10,7,2,3,0,0,0,5
Fremantle,"Pearce, Danyle",23,19,2,4,0,0,0,3
Fremantle,"Sheridan, Tom",15,9,3,6,0,0,0,1
Fremantle,"Spurr, Lee",15,11,5,4,0,0,0,2
Fremantle,"Suban, Nick",20,11,1,9,0,2,0,7
Fremantle,"Taberner, Matthew",11,5,2,6,1,0,0,3
Fremantle,"Walters, Michael",11,8,0,3,1,3,0,5
Fremantle,"Weller, Lachie",12,6,0,6,0,0,0,3
Fremantle,"Ballantyne, Hayden",6,4,4,2,0,0,0,5
Fremantle,"Barlow, Michael",24,13,2,11,0,0,0,6
Fremantle,"Blakely, Connor",25,13,3,12,0,0,3,2
Fremantle,"Collins, Sam",12,8,7,4,0,0,0,1
Fremantle,"Crozier, Hayden",24,16,10,8,0,0,0,0
Fremantle,"Dawson, Zac",8,4,3,4,0,0,4,2
Fremantle,"Griffin, Jonathon",11,3,3,8,0,0,35,2
Fremantle,"Hill, Stephen",26,14,0,12,0,0,0,3
Fremantle,"Ibbotson, Garrick",15,10,9,5,0,0,0,1
Fremantle,"Langdon, Ed",11,2,1,9,2,0,0,4
Fremantle,"Mayne, Chris",14,5,6,9,0,0,1,4
Fremantle,"Neale, Lachie",31,11,3,20,1,0,0,4
Fremantle,"Pavlich, Matthew",8,3,1,5,1,0,0,8
Fremantle,"Pearce, Danyle",23,15,2,8,0,0,0,2
Fremantle,"Sheridan, Tom",18,11,4,7,1,1,0,4
Fremantle,"Spurr, Lee",18,12,5,6,0,1,0,3
Fremantle,"Suban, Nick",15,9,2,6,0,1,0,4
Fremantle,"Sutcliffe, Cam",11,8,7,3,0,0,0,3
Fremantle,"Taberner, Matthew",13,9,5,4,2,1,5,1
Fremantle,"Walters, Michael",20,10,4,10,1,1,0,1
Fremantle,"Weller, Lachie",11,4,1,7,2,1,0,5
Fremantle,"de Boer, Matt",16,2,1,14,0,0,0,5
Fremantle,"Apeness, Michael",4,1,1,3,0,0,1,0
Fremantle,"Ballantyne, Hayden",22,14,5,8,2,1,0,4
Fremantle,"Barlow, Michael",26,12,6,14,1,0,0,6
Fremantle,"Blakely, Connor",25,12,5,13,0,0,3,7
Fremantle,"Collins, Sam",24,14,11,10,0,0,0,1
Fremantle,"Crozier, Hayden",23,19,14,4,0,0,0,0
Fremantle,"Dawson, Zac",7,3,3,4,0,0,1,1
Fremantle,"Griffin, Jonathon",12,4,1,8,1,0,28,3
Fremantle,"Hill, Stephen",26,18,6,8,0,0,0,1
Fremantle,"Mayne, Chris",17,7,8,10,3,2,0,2
Fremantle,"Mundy, David",33,16,6,17,1,0,4,4
Fremantle,"Neale, Lachie",42,13,5,29,1,0,0,3
Fremantle,"Pavlich, Matthew",15,11,6,4,3,0,1,0
Fremantle,"Pearce, Danyle",26,15,6,11,1,1,0,2
Fremantle,"Sheridan, Tom",30,10,4,20,1,0,0,0
Fremantle,"Spurr, Lee",19,8,6,11,0,0,0,0
Fremantle,"Suban, Nick",16,9,4,7,0,0,2,9
Fremantle,"Sutcliffe, Cam",13,12,8,1,0,0,0,2
Fremantle,"Taberner, Matthew",13,7,5,6,1,1,2,3
Fremantle,"Tucker, Darcy",16,10,4,6,1,0,0,4
Fremantle,"Walters, Michael",23,11,7,12,3,1,0,2
Fremantle,"Weller, Lachie",22,9,4,13,1,0,0,5
Fremantle,"Ballantyne, Hayden",23,13,7,10,4,0,0,2
Fremantle,"Barlow, Michael",23,11,8,12,0,0,0,2
Fremantle,"Blakely, Connor",29,7,2,22,0,0,2,3
Fremantle,"Clarke, Zac",7,4,0,3,0,0,20,3
Fremantle,"Collins, Sam",8,5,5,3,0,0,0,2
Fremantle,"Crozier, Hayden",20,17,4,3,0,0,0,4
Fremantle,"Dawson, Zac",6,1,4,5,0,0,4,0
Fremantle,"Hannath, Jack",12,8,1,4,0,1,12,2
Fremantle,"Hill, Stephen",25,14,8,11,0,0,2,1
Fremantle,"Mayne, Chris",18,8,5,10,4,2,0,9
Fremantle,"Mundy, David",20,6,1,14,0,0,3,6
Fremantle,"Neale, Lachie",18,7,1,11,0,0,0,2
Fremantle,"Pearce, Danyle",23,12,5,11,0,0,0,4
Fremantle,"Sheridan, Tom",22,12,4,10,1,1,0,3
Fremantle,"Smith, Tanner",11,5,2,6,1,0,0,4
Fremantle,"Spurr, Lee",17,12,8,5,0,0,0,2
Fremantle,"Suban, Nick",21,13,7,8,1,1,1,4
Fremantle,"Sutcliffe, Cam",13,8,6,5,0,0,0,6
Fremantle,"Taberner, Matthew",17,12,8,5,5,0,0,0
Fremantle,"Tucker, Darcy",19,16,4,3,2,0,0,3
Fremantle,"Walters, Michael",19,9,4,10,1,0,0,5
Fremantle,"Weller, Lachie",22,12,3,10,4,0,0,3
Fremantle,"Ballantyne, Hayden",16,7,4,9,1,2,0,4
Fremantle,"Barlow, Michael",43,19,3,24,2,0,0,8
Fremantle,"Blakely, Connor",21,11,3,10,0,1,1,3
Fremantle,"Clarke, Zac",15,8,4,7,0,1,43,4
Fremantle,"Collins, Sam",10,5,2,5,0,0,1,4
Fremantle,"Crozier, Hayden",21,12,5,9,0,1,0,3
Fremantle,"Dawson, Zac",12,3,5,9,0,0,0,2
Fremantle,"Hill, Stephen",16,11,2,5,1,1,0,2
Fremantle,"Mayne, Chris",13,5,5,8,1,0,1,7
Fremantle,"Mundy, David",27,15,5,12,0,0,0,5
Fremantle,"Neale, Lachie",38,14,4,24,0,1,0,6
Fremantle,"Pavlich, Matthew",15,10,7,5,4,2,1,5
Fremantle,"Pearce, Danyle",25,16,5,9,0,1,0,6
Fremantle,"Sheridan, Tom",14,10,4,4,0,0,0,0
Fremantle,"Smith, Tanner",7,4,2,3,1,0,1,1
Fremantle,"Spurr, Lee",26,16,9,10,0,0,0,3
Fremantle,"Suban, Nick",20,10,4,10,0,0,0,1
Fremantle,"Sutcliffe, Cam",14,8,2,6,0,0,0,4
Fremantle,"Taberner, Matthew",16,11,6,5,1,1,2,2
Fremantle,"Tucker, Darcy",8,2,2,6,0,0,0,3
Fremantle,"Walters, Michael",13,6,3,7,0,0,0,0
Fremantle,"Weller, Lachie",12,5,2,7,1,0,0,1
Fremantle,"Ballantyne, Hayden",13,7,4,6,2,0,0,5
Fremantle,"Barlow, Michael",31,11,4,20,0,0,1,6
Fremantle,"Blakely, Connor",24,10,1,14,0,2,1,1
Fremantle,"Clarke, Zac",11,3,3,8,0,0,15,3
Fremantle,"Collins, Sam",18,8,6,10,0,0,0,4
Fremantle,"Crozier, Hayden",23,18,3,5,0,0,0,4
Fremantle,"Dawson, Zac",14,3,5,11,0,0,2,4
Fremantle,"Hannath, Jack",3,1,1,2,0,0,10,5
Fremantle,"Hill, Stephen",25,16,1,9,0,0,1,5
Fremantle,"Mayne, Chris",6,2,3,4,0,1,0,4
Fremantle,"Mundy, David",18,5,2,13,0,0,1,5
Fremantle,"Neale, Lachie",27,5,3,22,0,0,0,6
Fremantle,"Pavlich, Matthew",16,8,1,8,2,2,0,2
Fremantle,"Pearce, Danyle",21,17,4,4,0,0,0,1
Fremantle,"Sheridan, Tom",20,9,1,11,0,0,1,0
Fremantle,"Spurr, Lee",10,5,2,5,0,0,0,1
Fremantle,"Suban, Nick",8,7,0,1,0,0,0,10
Fremantle,"Sutcliffe, Cam",14,8,5,6,0,0,0,4
Fremantle,"Taberner, Matthew",13,8,3,5,0,0,3,3
Fremantle,"Tucker, Darcy",8,3,2,5,0,0,0,5
Fremantle,"Walters, Michael",28,20,6,8,1,1,0,4
Fremantle,"Weller, Lachie",8,5,2,3,0,1,0,6
Fremantle,"Ballantyne, Hayden",17,13,4,4,1,1,0,4
Fremantle,"Blakely, Connor",20,10,6,10,0,0,2,5
Fremantle,"Collins, Sam",7,3,2,4,0,0,1,5
Fremantle,"Crozier, Hayden",20,14,8,6,0,0,0,3
Fremantle,"Dawson, Zac",12,2,2,10,0,0,0,1
Fremantle,"Griffin, Jonathon",7,3,3,4,0,1,20,1
Fremantle,"Hill, Stephen",22,15,4,7,0,0,3,2
Fremantle,"Ibbotson, Garrick",11,9,7,2,0,0,0,1
Fremantle,"Langdon, Ed",16,11,5,5,0,0,0,2
Fremantle,"Mayne, Chris",10,5,5,5,2,0,0,7
Fremantle,"Mundy, David",14,10,1,4,0,0,3,4
Fremantle,"Neale, Lachie",33,15,5,18,0,0,0,8
Fremantle,"Pavlich, Matthew",13,9,5,4,3,0,0,2
Fremantle,"Pearce, Danyle",19,17,2,2,0,0,0,0
Fremantle,"Sheridan, Tom",17,12,4,5,0,0,0,2
Fremantle,"Spurr, Lee",14,7,4,7,0,0,0,3
Fremantle,"Suban, Nick",9,8,0,1,1,1,2,4
Fremantle,"Sutcliffe, Cam",22,13,7,9,0,0,0,3
Fremantle,"Taberner, Matthew",10,7,7,3,1,1,1,1
Fremantle,"Tucker, Darcy",8,2,2,6,0,0,0,4
Fremantle,"Walters, Michael",18,15,3,3,0,1,0,3
Fremantle,"Weller, Lachie",10,2,1,8,0,0,0,3
Fremantle,"Ballantyne, Hayden",6,5,3,1,1,1,0,3
Fremantle,"Barlow, Michael",17,5,2,12,1,0,0,2
Fremantle,"Blakely, Connor",22,7,3,15,1,0,4,3
Fremantle,"Collins, Sam",11,9,4,2,0,0,0,5
Fremantle,"Crozier, Hayden",14,7,4,7,0,0,0,4
Fremantle,"Dawson, Zac",9,1,2,8,0,0,0,1
Fremantle,"Griffin, Jonathon",8,4,0,4,0,0,25,5
Fremantle,"Hill, Stephen",37,23,4,14,0,0,1,5
Fremantle,"Ibbotson, Garrick",10,7,3,3,0,0,0,4
Fremantle,"Mayne, Chris",8,3,1,5,0,0,1,5
Fremantle,"Mundy, David",24,12,3,12,1,0,5,8
Fremantle,"Mzungu, Tendai",14,9,3,5,0,0,0,2
Fremantle,"Neale, Lachie",26,12,1,14,0,0,0,3
Fremantle,"Pavlich, Matthew",18,11,6,7,1,2,0,1
Fremantle,"Pearce, Danyle",18,11,3,7,0,0,0,5
Fremantle,"Sheridan, Tom",20,12,2,8,0,0,0,3
Fremantle,"Spurr, Lee",18,12,5,6,0,0,0,2
Fremantle,"Suban, Nick",14,8,2,6,0,0,1,4
Fremantle,"Sutcliffe, Cam",18,11,6,7,1,1,0,5
Fremantle,"Taberner, Matthew",13,6,5,7,1,0,3,4
Fremantle,"Walters, Michael",17,8,3,9,1,0,0,1
Fremantle,"Weller, Lachie",15,7,2,8,1,0,0,3
Fremantle,"Blakely, Connor",18,8,4,10,0,1,3,4
Fremantle,"Clarke, Zac",12,1,3,11,0,0,23,4
Fremantle,"Collins, Sam",20,10,6,10,0,0,4,1
Fremantle,"Crozier, Hayden",16,9,3,7,0,0,0,2
Fremantle,"Dawson, Zac",5,2,1,3,0,0,3,3
Fremantle,"Griffin, Jonathon",6,2,0,4,1,0,14,5
Fremantle,"Hill, Stephen",21,15,0,6,0,0,1,4
Fremantle,"Ibbotson, Garrick",15,10,3,5,0,1,0,0
Fremantle,"Langdon, Ed",23,14,5,9,2,2,0,1
Fremantle,"Mayne, Chris",13,1,2,12,0,0,0,3
Fremantle,"Mundy, David",22,11,8,11,0,0,0,4
Fremantle,"Mzungu, Tendai",24,9,5,15,0,0,0,4
Fremantle,"Neale, Lachie",42,17,5,25,1,0,0,1
Fremantle,"Pearce, Danyle",25,18,8,7,1,0,0,2
Fremantle,"Sheridan, Tom",22,10,6,12,0,0,0,5
Fremantle,"Spurr, Lee",19,11,6,8,0,0,0,2
Fremantle,"Suban, Nick",6,2,0,4,0,0,0,2
Fremantle,"Sutcliffe, Cam",9,4,1,5,0,0,0,4
Fremantle,"Taberner, Matthew",9,7,5,2,1,0,0,3
Fremantle,"Walters, Michael",24,13,7,11,4,0,0,5
Fremantle,"Weller, Lachie",16,7,2,9,0,0,0,3
Fremantle,"Yarran, Shane",10,5,4,5,2,0,0,2
Fremantle,"Clarke, Zac",17,7,8,10,0,0,37,2
Fremantle,"Collins, Sam",9,4,3,5,0,0,3,6
Fremantle,"Crozier, Hayden",24,17,10,7,1,0,0,3
Fremantle,"Dawson, Zac",7,1,1,6,0,0,0,4
Fremantle,"Hill, Stephen",24,9,1,15,0,0,1,5
Fremantle,"Ibbotson, Garrick",16,12,6,4,0,0,1,4
Fremantle,"Langdon, Ed",29,19,4,10,0,1,0,4
Fremantle,"Mayne, Chris",21,10,7,11,0,0,0,10
Fremantle,"Mundy, David",44,19,4,25,1,0,6,4
Fremantle,"Neale, Lachie",41,16,4,25,0,0,0,5
Fremantle,"Pavlich, Matthew",15,9,8,6,2,0,0,2
Fremantle,"Pearce, Danyle",22,13,6,9,0,0,0,1
Fremantle,"Sheridan, Tom",22,12,4,10,0,0,0,1
Fremantle,"Silvagni, Alex",10,8,6,2,0,0,0,1
Fremantle,"Spurr, Lee",16,11,8,5,0,0,0,2
Fremantle,"Sutcliffe, Cam",19,12,7,7,0,0,0,4
Fremantle,"Taberner, Matthew",7,5,2,2,1,0,0,3
Fremantle,"Tucker, Darcy",17,10,1,7,0,0,0,10
Fremantle,"Walters, Michael",12,7,1,5,0,0,0,1
Fremantle,"Weller, Lachie",17,5,0,12,1,0,0,6
Fremantle,"Yarran, Shane",8,6,5,2,1,1,0,3
Fremantle,"de Boer, Matt",16,3,3,13,0,0,0,9
Fremantle,"Apeness, Michael",7,3,4,4,1,0,0,1
Fremantle,"Ballantyne, Hayden",8,6,1,2,1,0,0,5
Fremantle,"Clarke, Zac",10,1,4,9,0,0,11,1
Fremantle,"Collins, Sam",10,7,5,3,0,0,0,1
Fremantle,"Crozier, Hayden",14,11,6,3,0,0,0,2
Fremantle,"Hill, Stephen",30,20,2,10,0,0,0,4
Fremantle,"Hughes, Ethan",16,10,7,6,0,0,0,2
Fremantle,"Ibbotson, Garrick",14,11,5,3,0,0,0,1
Fremantle,"Langdon, Ed",20,8,5,12,0,0,0,3
Fremantle,"Mayne, Chris",22,12,6,10,0,2,0,4
Fremantle,"Mundy, David",23,15,2,8,0,0,2,7
Fremantle,"Neale, Lachie",29,11,3,18,0,0,0,4
Fremantle,"Pavlich, Matthew",11,8,6,3,2,1,0,4
Fremantle,"Pearce, Danyle",25,16,2,9,0,0,0,1
Fremantle,"Sandilands, Aaron",12,2,4,10,0,0,23,2
Fremantle,"Sheridan, Tom",16,8,1,8,2,0,0,3
Fremantle,"Silvagni, Alex",16,12,6,4,0,0,0,3
Fremantle,"Spurr, Lee",22,12,10,10,0,0,0,3
Fremantle,"Tucker, Darcy",17,12,5,5,0,1,0,1
Fremantle,"Walters, Michael",14,6,5,8,1,1,0,0
Fremantle,"Weller, Lachie",15,6,3,9,0,1,0,0
Fremantle,"Yarran, Shane",18,12,5,6,2,2,0,0
Fremantle,"Apeness, Michael",4,0,0,4,0,0,2,2
Fremantle,"Ballantyne, Hayden",13,10,4,3,1,0,0,4
Fremantle,"Blakely, Connor",24,6,4,18,0,0,2,8
Fremantle,"Clarke, Zac",9,2,1,7,0,0,15,1
Fremantle,"Collins, Sam",15,9,5,6,0,0,0,0
Fremantle,"Hill, Stephen",32,18,5,14,0,0,0,2
Fremantle,"Hughes, Ethan",20,11,4,9,0,0,0,2
Fremantle,"Ibbotson, Garrick",16,11,6,5,0,0,0,2
Fremantle,"Langdon, Ed",25,9,3,16,1,0,0,2
Fremantle,"Mayne, Chris",20,10,5,10,0,0,0,5
Fremantle,"Mundy, David",25,10,0,15,0,0,0,4
Fremantle,"Neale, Lachie",31,8,2,23,0,0,0,7
Fremantle,"Pavlich, Matthew",15,9,4,6,2,0,0,4
Fremantle,"Pearce, Danyle",18,10,2,8,0,0,0,4
Fremantle,"Sandilands, Aaron",5,1,1,4,0,0,28,1
Fremantle,"Sheridan, Tom",18,11,0,7,1,0,0,3
Fremantle,"Silvagni, Alex",14,9,5,5,0,0,0,0
Fremantle,"Spurr, Lee",17,9,3,8,0,0,0,1
Fremantle,"Tucker, Darcy",19,12,4,7,0,1,0,6
Fremantle,"Walters, Michael",17,10,5,7,5,1,0,2
Fremantle,"Weller, Lachie",19,11,2,8,0,0,0,2
Fremantle,"Yarran, Shane",12,8,3,4,1,1,0,3
Fremantle,"Apeness, Michael",6,3,5,3,1,0,0,3
Fremantle,"Ballantyne, Hayden",11,7,3,4,0,1,0,3
Fremantle,"Blakely, Connor",18,8,3,10,0,0,3,2
Fremantle,"Clarke, Zac",11,3,6,8,0,1,14,2
Fremantle,"Collins, Sam",13,7,6,6,0,0,0,1
Fremantle,"Griffin, Jonathon",8,6,3,2,0,0,15,4
Fremantle,"Hill, Stephen",31,18,4,13,0,0,3,3
Fremantle,"Ibbotson, Garrick",16,10,5,6,0,0,0,2
Fremantle,"Langdon, Ed",16,9,3,7,0,0,0,2
Fremantle,"Mayne, Chris",21,8,7,13,0,0,0,2
Fremantle,"Mundy, David",15,5,2,10,0,0,2,5
Fremantle,"Neale, Lachie",40,19,6,21,1,0,0,12
Fremantle,"Pearce, Danyle",23,12,1,11,0,1,0,2
Fremantle,"Sheridan, Tom",22,13,5,9,0,0,0,5
Fremantle,"Silvagni, Alex",17,8,6,9,0,0,0,1
Fremantle,"Spurr, Lee",22,12,11,10,0,0,0,4
Fremantle,"Sutcliffe, Cam",17,10,6,7,0,0,0,3
Fremantle,"Taberner, Matthew",10,5,3,5,0,0,0,4
Fremantle,"Tucker, Darcy",14,7,2,7,0,1,0,4
Fremantle,"Walters, Michael",20,7,0,13,0,2,0,3
Fremantle,"Weller, Lachie",28,15,4,13,0,0,0,3
Fremantle,"Yarran, Shane",11,8,3,3,3,1,0,2
Fremantle,"Apeness, Michael",5,2,2,3,1,0,6,5
Fremantle,"Ballantyne, Hayden",9,7,5,2,0,2,0,1
Fremantle,"Blakely, Connor",18,5,3,13,0,0,2,2
Fremantle,"Dawson, Zac",2,1,0,1,0,0,0,4
Fremantle,"Hill, Stephen",30,19,9,11,1,0,0,4
Fremantle,"Ibbotson, Garrick",29,22,14,7,0,0,0,2
Fremantle,"Langdon, Ed",11,4,2,7,0,0,0,1
Fremantle,"Mayne, Chris",17,6,9,11,0,0,0,5
Fremantle,"Mundy, David",28,20,6,8,1,0,1,6
Fremantle,"Neale, Lachie",36,15,5,21,1,0,0,1
Fremantle,"Pavlich, Matthew",20,14,10,6,1,3,0,2
Fremantle,"Pearce, Danyle",31,24,12,7,1,0,0,1
Fremantle,"Sandilands, Aaron",15,5,3,10,0,1,35,3
Fremantle,"Sheridan, Tom",17,12,3,5,0,0,0,3
Fremantle,"Silvagni, Alex",14,7,6,7,0,0,0,1
Fremantle,"Spurr, Lee",21,13,7,8,0,0,0,5
Fremantle,"Sutcliffe, Cam",24,15,9,9,0,0,0,5
Fremantle,"Tucker, Darcy",22,14,6,8,0,0,0,4
Fremantle,"Walters, Michael",14,9,5,5,2,1,0,1
Fremantle,"Weller, Lachie",26,15,8,11,0,0,0,2
Fremantle,"Yarran, Shane",9,6,4,3,1,0,0,5
Fremantle,"de Boer, Matt",20,8,5,12,1,0,0,6
Gold Coast,"Ablett, Gary",34,20,4,14,1,3,0,7
Gold Coast,"Ah Chee, Callum",8,4,1,4,1,1,0,5
Gold Coast,"Cameron, Clay",15,7,7,8,0,0,0,3
Gold Coast,"Davis, Ryan",17,8,1,9,0,2,0,4
Gold Coast,"Day, Sam",15,7,4,8,2,0,2,2
Gold Coast,"Hall, Aaron",36,19,4,17,2,1,0,3
Gold Coast,"Harbrow, Jarrod",20,10,3,10,0,1,0,2
Gold Coast,"Lemmens, Sean",10,4,0,6,0,0,0,2
Gold Coast,"Lonergan, Jesse",20,9,3,11,1,0,0,6
Gold Coast,"Lynch, Tom",18,8,7,10,4,1,0,4
Gold Coast,"Malceski, Nick",19,12,4,7,1,2,0,3
Gold Coast,"Martin, Jack",13,8,4,5,2,0,0,8
Gold Coast,"May, Steven",16,12,6,4,0,0,0,2
Gold Coast,"McKenzie, Trent",17,13,7,4,0,0,0,5
Gold Coast,"Miller, Touk",20,9,2,11,1,2,0,2
Gold Coast,"Nicholls, Tom",10,5,3,5,0,0,24,4
Gold Coast,"Prestia, Dion",29,13,3,16,1,0,0,9
Gold Coast,"Rischitelli, Michael",27,7,3,20,0,0,0,7
Gold Coast,"Rosa, Matt",32,16,9,16,0,0,0,1
Gold Coast,"Saad, Adam",15,7,6,8,0,1,0,3
Gold Coast,"Sexton, Alex",23,15,6,8,1,2,0,3
Gold Coast,"Thompson, Rory",14,10,4,4,0,0,1,2
Gold Coast,"Ablett, Gary",23,12,1,11,1,1,0,8
Gold Coast,"Ah Chee, Callum",9,5,4,4,2,1,0,3
Gold Coast,"Cameron, Clay",9,6,5,3,1,0,0,4
Gold Coast,"Davis, Ryan",8,6,3,2,2,0,0,2
Gold Coast,"Day, Sam",12,3,2,9,0,1,4,2
Gold Coast,"Hall, Aaron",32,17,11,15,0,0,0,4
Gold Coast,"Harbrow, Jarrod",21,13,6,8,0,0,0,5
Gold Coast,"Kolodjashnij, Kade",16,13,5,3,0,0,0,7
Gold Coast,"Lemmens, Sean",16,7,5,9,0,1,0,2
Gold Coast,"Lonergan, Jesse",16,7,1,9,0,1,1,7
Gold Coast,"Lynch, Tom",15,10,7,5,5,1,0,1
Gold Coast,"Malceski, Nick",14,8,3,6,0,1,0,2
Gold Coast,"Martin, Jack",16,12,11,4,4,1,0,2
Gold Coast,"Matera, Brandon",11,8,4,3,2,2,0,2
Gold Coast,"May, Steven",11,8,1,3,0,0,0,4
Gold Coast,"McKenzie, Trent",15,10,3,5,0,0,0,3
Gold Coast,"Nicholls, Tom",7,3,2,4,0,0,16,4
Gold Coast,"Prestia, Dion",24,10,0,14,1,2,0,5
Gold Coast,"Rischitelli, Michael",3,1,0,2,0,0,0,3
Gold Coast,"Saad, Adam",15,4,1,11,0,0,0,1
Gold Coast,"Sexton, Alex",25,14,4,11,1,0,0,2
Gold Coast,"Thompson, Rory",9,4,1,5,0,0,0,2
Gold Coast,"Ablett, Gary",35,14,3,21,0,1,0,8
Gold Coast,"Cameron, Clay",18,8,7,10,1,0,0,5
Gold Coast,"Davis, Ryan",14,9,5,5,0,2,0,4
Gold Coast,"Day, Sam",12,7,5,5,1,2,2,5
Gold Coast,"Hall, Aaron",40,27,6,13,1,2,0,4
Gold Coast,"Harbrow, Jarrod",22,12,3,10,0,0,0,5
Gold Coast,"Kolodjashnij, Kade",26,15,12,11,0,0,0,1
Gold Coast,"Lemmens, Sean",11,5,1,6,0,0,0,4
Gold Coast,"Lonergan, Jesse",21,7,1,14,0,1,0,4
Gold Coast,"Lynch, Tom",23,14,10,9,4,3,0,2
Gold Coast,"Malceski, Nick",24,12,6,12,1,0,0,3
Gold Coast,"Martin, Jack",19,11,10,8,3,0,0,0
Gold Coast,"Matera, Brandon",16,14,5,2,1,2,0,0
Gold Coast,"May, Steven",15,10,4,5,0,0,0,2
Gold Coast,"McKenzie, Trent",0,0,0,0,0,0,0,1
Gold Coast,"Nicholls, Tom",14,5,2,9,0,0,17,2
Gold Coast,"Prestia, Dion",24,9,4,15,0,0,0,3
Gold Coast,"Rischitelli, Michael",21,7,5,14,0,0,0,3
Gold Coast,"Rosa, Matt",24,12,6,12,0,0,0,3
Gold Coast,"Saad, Adam",19,10,7,9,0,0,0,4
Gold Coast,"Sexton, Alex",16,11,5,5,1,0,0,2
Gold Coast,"Thompson, Rory",6,3,2,3,0,0,0,0
Gold Coast,"Ablett, Gary",24,15,3,9,0,1,0,4
Gold Coast,"Ah Chee, Callum",7,2,1,5,0,0,0,3
Gold Coast,"Brooksby, Keegan",3,2,1,1,0,0,0,0
Gold Coast,"Cameron, Clay",8,5,2,3,1,0,0,1
Gold Coast,"Davis, Ryan",8,5,2,3,0,0,0,1
Gold Coast,"Day, Sam",12,3,6,9,1,0,5,2
Gold Coast,"Hall, Aaron",26,15,4,11,1,3,0,7
Gold Coast,"Harbrow, Jarrod",13,8,0,5,0,0,0,2
Gold Coast,"Kolodjashnij, Kade",15,7,6,8,0,0,0,8
Gold Coast,"Lemmens, Sean",10,6,3,4,0,0,0,3
Gold Coast,"Lonergan, Jesse",14,6,2,8,0,0,0,5
Gold Coast,"Lynch, Tom",15,11,8,4,5,2,0,2
Gold Coast,"Malceski, Nick",21,15,4,6,1,2,3,2
Gold Coast,"Martin, Jack",9,6,2,3,1,0,0,3
Gold Coast,"May, Steven",12,11,6,1,0,0,0,1
Gold Coast,"Miller, Touk",18,9,3,9,0,0,0,4
Gold Coast,"Nicholls, Tom",16,2,2,14,0,0,37,10
Gold Coast,"Prestia, Dion",19,6,0,13,0,0,0,1
Gold Coast,"Rischitelli, Michael",16,5,2,11,1,0,1,8
Gold Coast,"Rosa, Matt",15,8,1,7,1,0,1,3
Gold Coast,"Saad, Adam",15,5,3,10,0,0,0,5
Gold Coast,"Sexton, Alex",11,9,1,2,2,1,0,3
Gold Coast,"Ablett, Gary",28,12,1,16,1,1,0,3
Gold Coast,"Ah Chee, Callum",8,7,2,1,1,0,0,4
Gold Coast,"Cameron, Clay",14,4,3,10,0,0,0,3
Gold Coast,"Currie, Daniel",8,3,2,5,0,1,21,3
Gold Coast,"Day, Sam",10,3,4,7,0,0,0,3
Gold Coast,"Grant, Jarrad",11,6,5,5,1,0,0,1
Gold Coast,"Hall, Aaron",32,16,3,16,0,0,0,1
Gold Coast,"Harbrow, Jarrod",19,9,3,10,0,0,0,3
Gold Coast,"Kolodjashnij, Kade",21,13,7,8,0,1,0,2
Gold Coast,"Lemmens, Sean",17,7,4,10,0,0,0,0
Gold Coast,"Lonergan, Jesse",18,5,5,13,0,1,0,4
Gold Coast,"Lynch, Tom",12,10,8,2,4,1,0,0
Gold Coast,"Malceski, Nick",23,14,4,9,0,0,0,3
Gold Coast,"Martin, Jack",18,6,5,12,0,1,0,5
Gold Coast,"McKenzie, Trent",12,9,0,3,0,0,0,1
Gold Coast,"Miller, Touk",14,5,2,9,0,1,0,1
Gold Coast,"Rischitelli, Michael",25,10,4,15,1,0,0,4
Gold Coast,"Rosa, Matt",29,12,7,17,0,0,5,2
Gold Coast,"Russell, Luke",3,1,0,2,0,0,0,3
Gold Coast,"Saad, Adam",15,7,3,8,0,0,0,2
Gold Coast,"Sexton, Alex",12,8,4,4,0,1,0,3
Gold Coast,"Wright, Peter",17,12,8,5,3,1,4,2
Gold Coast,"Ablett, Gary",26,13,3,13,0,0,0,5
Gold Coast,"Cameron, Clay",8,4,4,4,1,0,0,3
Gold Coast,"Currie, Daniel",9,3,5,6,0,0,34,4
Gold Coast,"Davis, Ryan",10,7,2,3,0,0,0,2
Gold Coast,"Day, Sam",9,4,3,5,0,0,0,3
Gold Coast,"Grant, Jarrad",9,3,1,6,0,0,0,2
Gold Coast,"Hall, Aaron",28,18,5,10,0,1,0,4
Gold Coast,"Harbrow, Jarrod",15,7,3,8,1,0,0,2
Gold Coast,"Kolodjashnij, Kade",19,11,3,8,0,0,0,0
Gold Coast,"Lemmens, Sean",18,11,4,7,1,1,0,2
Gold Coast,"Lonergan, Jesse",13,6,2,7,0,0,0,3
Gold Coast,"Lynch, Tom",11,7,4,4,2,0,0,3
Gold Coast,"Malceski, Nick",20,9,4,11,0,1,0,6
Gold Coast,"Martin, Jack",9,3,1,6,0,0,0,3
Gold Coast,"McKenzie, Trent",1,1,0,0,0,0,0,1
Gold Coast,"Miller, Touk",8,4,1,4,0,0,0,3
Gold Coast,"Prestia, Dion",24,11,3,13,0,0,0,9
Gold Coast,"Rosa, Matt",21,7,3,14,0,1,2,2
Gold Coast,"Schade, Henry",12,6,5,6,0,0,0,3
Gold Coast,"Sexton, Alex",20,8,3,12,2,1,0,1
Gold Coast,"Willis, Mackenzie",11,4,1,7,0,0,0,2
Gold Coast,"Wright, Peter",5,3,2,2,0,0,3,0
Gold Coast,"Ablett, Gary",22,11,4,11,2,0,0,4
Gold Coast,"Cameron, Clay",14,5,3,9,0,0,0,5
Gold Coast,"Currie, Daniel",14,7,5,7,1,0,32,3
Gold Coast,"Day, Sam",11,7,5,4,0,0,0,2
Gold Coast,"Garlett, Jarrod",12,9,4,3,2,0,0,2
Gold Coast,"Grant, Jarrad",15,12,8,3,1,0,0,3
Gold Coast,"Hall, Aaron",21,11,4,10,1,0,0,7
Gold Coast,"Harbrow, Jarrod",14,7,3,7,0,0,0,5
Gold Coast,"Kolodjashnij, Kade",16,11,3,5,0,0,0,0
Gold Coast,"Lemmens, Sean",14,10,7,4,0,0,0,4
Gold Coast,"Lonergan, Jesse",20,9,5,11,0,0,0,7
Gold Coast,"Lynch, Tom",16,8,4,8,4,0,3,1
Gold Coast,"Macpherson, Darcy",10,5,3,5,1,0,0,9
Gold Coast,"Malceski, Nick",16,10,3,6,0,0,0,4
Gold Coast,"Martin, Jack",11,4,3,7,0,0,0,2
Gold Coast,"Miller, Touk",22,10,3,12,0,1,0,10
Gold Coast,"Prestia, Dion",20,11,2,9,0,0,0,6
Gold Coast,"Rosa, Matt",4,3,1,1,0,0,4,0
Gold Coast,"Saad, Adam",15,8,3,7,0,1,0,2
Gold Coast,"Schade, Henry",17,11,8,6,0,0,0,0
Gold Coast,"Sexton, Alex",4,2,1,2,0,0,0,0
Gold Coast,"Wright, Peter",9,3,3,6,2,0,7,3
Gold Coast,"Ablett, Gary",21,13,1,8,1,0,0,5
Gold Coast,"Ah Chee, Callum",15,4,4,11,0,0,0,0
Gold Coast,"Brooksby, Keegan",10,4,1,6,0,0,6,1
Gold Coast,"Day, Sam",10,5,1,5,0,0,0,1
Gold Coast,"Grant, Jarrad",12,4,2,8,3,0,0,2
Gold Coast,"Hall, Aaron",32,19,4,13,0,0,0,1
Gold Coast,"Harbrow, Jarrod",16,2,1,14,0,0,0,6
Gold Coast,"Kolodjashnij, Kade",13,11,4,2,0,0,0,3
Gold Coast,"Lemmens, Sean",13,7,4,6,0,0,0,2
Gold Coast,"Leslie, Jack",15,7,4,8,0,0,0,1
Gold Coast,"Lonergan, Jesse",19,8,2,11,0,0,0,11
Gold Coast,"Lynch, Tom",7,6,2,1,2,1,0,0
Gold Coast,"Macpherson, Darcy",18,10,2,8,0,0,0,6
Gold Coast,"Malceski, Nick",16,6,1,10,0,0,0,1
Gold Coast,"Martin, Jack",11,7,6,4,0,0,0,4
Gold Coast,"Matera, Brandon",15,8,4,7,3,1,0,0
Gold Coast,"Miller, Touk",10,3,3,7,0,0,0,6
Gold Coast,"Nicholls, Tom",10,4,1,6,0,0,32,2
Gold Coast,"Prestia, Dion",28,11,3,17,0,0,0,3
Gold Coast,"Saad, Adam",9,6,1,3,0,0,0,1
Gold Coast,"Schade, Henry",12,7,5,5,0,0,0,1
Gold Coast,"Shaw, Matt",18,7,3,11,0,0,1,6
Gold Coast,"Ah Chee, Callum",7,2,0,5,0,0,0,2
Gold Coast,"Brooksby, Keegan",18,10,6,8,0,0,0,2
Gold Coast,"Currie, Daniel",9,5,4,4,1,2,36,4
Gold Coast,"Davis, Ryan",18,12,4,6,1,1,0,5
Gold Coast,"Day, Sam",14,10,8,4,0,0,0,0
Gold Coast,"Grant, Jarrad",12,9,8,3,2,1,0,2
Gold Coast,"Harbrow, Jarrod",13,8,5,5,0,0,0,1
Gold Coast,"Kolodjashnij, Kade",20,12,6,8,0,0,0,5
Gold Coast,"Lemmens, Sean",18,12,6,6,0,0,0,3
Gold Coast,"Lonergan, Jesse",27,10,1,17,0,0,0,5
Gold Coast,"Lynch, Tom",13,8,3,5,2,0,1,3
Gold Coast,"Macpherson, Darcy",9,4,1,5,0,1,0,4
Gold Coast,"Malceski, Nick",25,16,6,9,0,0,0,3
Gold Coast,"Martin, Jack",21,10,7,11,0,0,0,1
Gold Coast,"Matera, Brandon",13,7,2,6,2,0,0,1
Gold Coast,"Prestia, Dion",31,11,2,20,0,0,0,3
Gold Coast,"Rischitelli, Michael",24,11,2,13,0,0,0,3
Gold Coast,"Russell, Luke",18,5,1,13,0,0,0,3
Gold Coast,"Schade, Henry",12,9,7,3,0,0,0,1
Gold Coast,"Shaw, Matt",18,9,3,9,0,0,0,2
Gold Coast,"Tape, Seb",13,2,0,11,0,0,0,7
Gold Coast,"Wright, Peter",15,7,9,8,3,2,5,0
Gold Coast,"Ablett, Gary",32,19,1,13,0,1,0,8
Gold Coast,"Brooksby, Keegan",13,8,8,5,0,0,0,1
Gold Coast,"Cameron, Clay",9,3,5,6,0,0,0,2
Gold Coast,"Davis, Ryan",12,8,3,4,1,0,0,6
Gold Coast,"Hall, Aaron",20,14,7,6,1,1,4,3
Gold Coast,"Harbrow, Jarrod",14,12,5,2,0,0,0,1
Gold Coast,"Lemmens, Sean",15,8,4,7,0,0,0,3
Gold Coast,"Lonergan, Jesse",17,10,4,7,0,0,0,3
Gold Coast,"Lynch, Tom",10,9,7,1,2,1,0,2
Gold Coast,"Malceski, Nick",24,16,12,8,0,0,0,2
Gold Coast,"Martin, Jack",14,12,8,2,2,1,0,4
Gold Coast,"Matera, Brandon",12,12,5,0,0,3,0,1
Gold Coast,"May, Steven",16,11,7,5,1,0,0,3
Gold Coast,"Nicholls, Tom",12,3,5,9,0,1,16,10
Gold Coast,"Prestia, Dion",27,19,5,8,0,0,0,8
Gold Coast,"Rischitelli, Michael",19,11,2,8,0,2,0,5
Gold Coast,"Russell, Luke",12,8,6,4,0,2,0,1
Gold Coast,"Schade, Henry",12,4,4,8,0,0,0,2
Gold Coast,"Shaw, Matt",17,9,7,8,0,0,2,3
Gold Coast,"Tape, Seb",11,3,3,8,0,0,0,4
Gold Coast,"Willis, Mackenzie",10,7,3,3,0,0,0,3
Gold Coast,"Wright, Peter",9,2,2,7,0,1,4,1
Gold Coast,"Ablett, Gary",26,17,1,9,0,1,0,13
Gold Coast,"Ah Chee, Callum",20,6,3,14,0,0,0,8
Gold Coast,"Brooksby, Keegan",11,5,1,6,0,0,0,6
Gold Coast,"Davis, Ryan",16,12,2,4,1,0,0,12
Gold Coast,"Hall, Aaron",19,12,0,7,0,1,0,2
Gold Coast,"Harbrow, Jarrod",24,19,5,5,0,0,0,3
Gold Coast,"Joyce, Jesse",10,6,1,4,0,0,0,2
Gold Coast,"Kolodjashnij, Kade",13,8,5,5,0,0,0,4
Gold Coast,"Lonergan, Jesse",13,8,1,5,1,0,0,5
Gold Coast,"Lynch, Tom",9,6,3,3,1,0,4,2
Gold Coast,"Malceski, Nick",16,15,5,1,0,0,0,4
Gold Coast,"Martin, Jack",15,9,3,6,0,0,0,3
Gold Coast,"Matera, Brandon",13,11,3,2,1,0,0,6
Gold Coast,"May, Steven",10,7,1,3,0,0,0,3
Gold Coast,"Miller, Touk",32,13,4,19,0,1,0,5
Gold Coast,"Nicholls, Tom",17,6,0,11,0,0,21,11
Gold Coast,"Prestia, Dion",39,26,1,13,0,0,0,11
Gold Coast,"Rischitelli, Michael",30,19,2,11,0,0,0,5
Gold Coast,"Rosa, Matt",33,17,3,16,1,1,0,5
Gold Coast,"Sexton, Alex",12,8,3,4,1,0,0,3
Gold Coast,"Willis, Mackenzie",11,4,2,7,0,0,0,2
Gold Coast,"Wright, Peter",10,5,2,5,0,0,5,4
Gold Coast,"Ablett, Gary",24,14,1,10,1,0,0,12
Gold Coast,"Davis, Ryan",11,8,4,3,2,0,0,4
Gold Coast,"Day, Sam",12,8,5,4,1,1,0,6
Gold Coast,"Harbrow, Jarrod",14,8,5,6,1,0,0,4
Gold Coast,"Joyce, Jesse",6,3,0,3,0,0,0,2
Gold Coast,"Kolodjashnij, Kade",12,6,5,6,0,0,0,0
Gold Coast,"Lemmens, Sean",9,7,1,2,0,0,0,3
Gold Coast,"Lonergan, Jesse",8,2,0,6,0,0,0,5
Gold Coast,"Lynch, Tom",19,11,10,8,4,2,1,2
Gold Coast,"Malceski, Nick",11,10,2,1,0,0,1,1
Gold Coast,"Martin, Jack",10,7,4,3,0,0,0,5
Gold Coast,"Matera, Brandon",13,9,1,4,0,0,0,2
Gold Coast,"May, Steven",12,3,1,9,1,0,0,3
Gold Coast,"McKenzie, Trent",16,16,4,0,0,0,0,0
Gold Coast,"Miller, Touk",10,2,1,8,0,0,0,1
Gold Coast,"Nicholls, Tom",14,4,2,10,1,0,23,6
Gold Coast,"Prestia, Dion",22,11,1,11,0,0,0,5
Gold Coast,"Rischitelli, Michael",21,10,2,11,0,0,1,9
Gold Coast,"Rosa, Matt",23,9,3,14,1,0,0,3
Gold Coast,"Sexton, Alex",9,6,3,3,1,0,2,0
Gold Coast,"Thompson, Rory",4,0,0,4,0,0,1,2
Gold Coast,"Wright, Peter",10,4,5,6,2,1,2,0
Gold Coast,"Ablett, Gary",40,21,2,19,1,1,0,3
Gold Coast,"Davis, Ryan",12,9,4,3,0,1,0,4
Gold Coast,"Day, Sam",11,5,2,6,1,1,2,5
Gold Coast,"Grant, Jarrad",8,4,1,4,0,1,0,5
Gold Coast,"Hall, Aaron",20,13,6,7,0,1,0,3
Gold Coast,"Hallahan, Mitch",14,8,1,6,0,0,0,4
Gold Coast,"Harbrow, Jarrod",25,19,4,6,1,1,0,1
Gold Coast,"Joyce, Jesse",10,6,1,4,0,0,0,4
Gold Coast,"Lynch, Tom",17,11,10,6,3,2,0,1
Gold Coast,"Malceski, Nick",14,9,3,5,0,1,0,6
Gold Coast,"Matera, Brandon",8,6,1,2,1,0,0,2
Gold Coast,"May, Steven",11,6,4,5,0,0,0,2
Gold Coast,"McKenzie, Trent",9,6,2,3,0,0,0,1
Gold Coast,"Miller, Touk",11,7,4,4,0,0,0,5
Gold Coast,"Nicholls, Tom",17,5,2,12,0,0,27,2
Gold Coast,"Prestia, Dion",19,11,1,8,0,0,0,2
Gold Coast,"Rischitelli, Michael",15,8,0,7,0,1,0,4
Gold Coast,"Rosa, Matt",19,10,4,9,0,0,0,2
Gold Coast,"Sexton, Alex",22,13,2,9,0,0,0,3
Gold Coast,"Shaw, Matt",15,9,6,6,0,0,0,1
Gold Coast,"Thompson, Rory",4,0,0,4,0,0,0,3
Gold Coast,"Wright, Peter",9,6,4,3,1,0,5,1
Gold Coast,"Ablett, Gary",25,12,3,13,1,2,0,2
Gold Coast,"Ah Chee, Callum",12,10,4,2,1,3,0,0
Gold Coast,"Davis, Ryan",14,10,3,4,1,0,0,2
Gold Coast,"Day, Sam",6,3,2,3,0,0,0,0
Gold Coast,"Hall, Aaron",27,18,6,9,2,2,0,3
Gold Coast,"Harbrow, Jarrod",21,13,7,8,0,0,0,4
Gold Coast,"Joyce, Jesse",15,10,5,5,0,0,0,1
Gold Coast,"Kolodjashnij, Kade",23,17,10,6,0,0,0,3
Gold Coast,"Lynch, Tom",20,15,14,5,1,4,0,0
Gold Coast,"Malceski, Nick",30,21,10,9,1,0,0,1
Gold Coast,"Martin, Jack",19,11,8,8,0,0,0,4
Gold Coast,"Matera, Brandon",20,14,9,6,2,2,0,3
Gold Coast,"May, Steven",23,14,11,9,0,0,0,0
Gold Coast,"Miller, Touk",17,11,5,6,1,0,0,1
Gold Coast,"Nicholls, Tom",13,4,2,9,0,1,17,1
Gold Coast,"Prestia, Dion",26,9,4,17,2,0,0,2
Gold Coast,"Rischitelli, Michael",33,14,8,19,0,1,0,6
Gold Coast,"Rosa, Matt",1,0,0,1,0,0,0,0
Gold Coast,"Sexton, Alex",19,12,9,7,0,1,0,2
Gold Coast,"Shaw, Matt",19,14,8,5,0,0,0,1
Gold Coast,"Thompson, Rory",16,10,11,6,0,0,0,3
Gold Coast,"Wright, Peter",14,9,10,5,3,1,2,0
Gold Coast,"Ablett, Gary",18,10,0,8,1,0,0,3
Gold Coast,"Ah Chee, Callum",14,8,3,6,2,1,0,2
Gold Coast,"Davis, Ryan",12,10,1,2,2,2,0,5
Gold Coast,"Day, Sam",14,8,5,6,0,0,3,1
Gold Coast,"Garlett, Jarrod",10,7,5,3,1,1,0,8
Gold Coast,"Hall, Aaron",29,20,3,9,0,1,0,6
Gold Coast,"Harbrow, Jarrod",27,16,12,11,0,0,0,4
Gold Coast,"Joyce, Jesse",6,6,2,0,0,0,0,0
Gold Coast,"Kolodjashnij, Kade",16,4,3,12,0,0,0,2
Gold Coast,"Lynch, Tom",12,8,7,4,5,0,0,2
Gold Coast,"Malceski, Nick",19,11,6,8,0,0,0,4
Gold Coast,"Martin, Jack",29,14,9,15,0,0,0,4
Gold Coast,"Matera, Brandon",17,11,5,6,3,0,0,1
Gold Coast,"May, Steven",18,11,9,7,0,0,1,1
Gold Coast,"Miller, Touk",27,12,6,15,1,0,0,11
Gold Coast,"Nicholls, Tom",16,5,2,11,0,0,31,7
Gold Coast,"Prestia, Dion",31,14,5,17,0,0,0,8
Gold Coast,"Rischitelli, Michael",0,0,0,0,0,0,0,0
Gold Coast,"Sexton, Alex",17,10,2,7,2,0,0,1
Gold Coast,"Shaw, Matt",20,11,3,9,0,0,0,2
Gold Coast,"Thompson, Rory",12,8,8,4,0,0,0,1
Gold Coast,"Wright, Peter",20,13,12,7,5,1,6,1
Gold Coast,"Ah Chee, Callum",17,5,4,12,2,0,0,4
Gold Coast,"Davis, Ryan",13,11,6,2,1,1,0,1
Gold Coast,"Day, Sam",7,4,3,3,0,0,0,2
Gold Coast,"Garlett, Jarrod",12,8,4,4,0,0,0,3
Gold Coast,"Grant, Jarrad",10,3,3,7,0,1,0,0
Gold Coast,"Hall, Aaron",29,19,6,10,0,3,1,1
Gold Coast,"Hallahan, Mitch",16,9,2,7,0,1,0,2
Gold Coast,"Harbrow, Jarrod",14,12,4,2,0,0,0,3
Gold Coast,"Joyce, Jesse",14,10,6,4,0,0,0,1
Gold Coast,"Kolodjashnij, Kade",23,16,10,7,0,0,0,1
Gold Coast,"Lonergan, Jesse",12,6,4,6,0,1,0,5
Gold Coast,"Lynch, Tom",14,11,11,3,3,2,0,2
Gold Coast,"Malceski, Nick",18,10,9,8,0,0,0,0
Gold Coast,"Martin, Jack",18,11,7,7,0,0,2,3
Gold Coast,"Matera, Brandon",17,8,3,9,2,0,0,1
Gold Coast,"May, Steven",15,11,6,4,0,0,0,2
Gold Coast,"Miller, Touk",24,12,2,12,0,0,0,5
Gold Coast,"Nicholls, Tom",10,2,2,8,0,0,25,4
Gold Coast,"Sexton, Alex",18,7,1,11,0,1,0,2
Gold Coast,"Shaw, Matt",25,18,8,7,0,0,0,1
Gold Coast,"Thompson, Rory",9,3,4,6,0,0,0,1
Gold Coast,"Wright, Peter",6,1,0,5,0,0,7,3
Gold Coast,"Ah Chee, Callum",13,6,5,7,0,1,0,5
Gold Coast,"Davis, Ryan",15,7,4,8,0,0,0,8
Gold Coast,"Day, Sam",15,13,9,2,4,0,0,4
Gold Coast,"Garlett, Jarrod",11,9,1,2,0,0,0,6
Gold Coast,"Grant, Jarrad",15,8,3,7,2,1,0,3
Gold Coast,"Harbrow, Jarrod",22,13,4,9,0,0,0,3
Gold Coast,"Joyce, Jesse",12,3,0,9,0,0,0,1
Gold Coast,"Kolodjashnij, Kade",17,12,7,5,0,0,0,2
Gold Coast,"Lonergan, Jesse",19,9,5,10,0,0,0,4
Gold Coast,"Lynch, Tom",17,12,8,5,4,1,0,3
Gold Coast,"Malceski, Nick",24,19,8,5,0,0,0,2
Gold Coast,"Martin, Jack",17,10,5,7,1,0,2,6
Gold Coast,"Matera, Brandon",12,9,5,3,1,2,0,4
Gold Coast,"May, Steven",24,16,13,8,0,0,0,3
Gold Coast,"Miller, Touk",28,16,3,12,0,0,0,7
Gold Coast,"Nicholls, Tom",13,6,4,7,0,0,24,5
Gold Coast,"Schoenfeld, Josh",19,10,8,9,0,0,0,4
Gold Coast,"Sexton, Alex",26,22,4,4,1,0,0,8
Gold Coast,"Shaw, Matt",22,10,5,12,0,0,0,1
Gold Coast,"Tape, Seb",17,7,4,10,0,0,0,4
Gold Coast,"Thompson, Rory",9,6,2,3,0,0,0,3
Gold Coast,"Wright, Peter",17,12,8,5,3,1,4,3
Gold Coast,"Ah Chee, Callum",13,5,0,8,0,0,0,4
Gold Coast,"Davis, Ryan",13,8,0,5,0,4,0,4
Gold Coast,"Day, Sam",16,11,9,5,0,2,5,4
Gold Coast,"Garlett, Jarrod",12,8,1,4,2,0,0,5
Gold Coast,"Grant, Jarrad",14,9,3,5,1,0,0,0
Gold Coast,"Harbrow, Jarrod",19,10,4,9,0,0,0,2
Gold Coast,"Joyce, Jesse",8,3,2,5,0,0,0,5
Gold Coast,"Kolodjashnij, Kade",17,12,3,5,0,0,0,2
Gold Coast,"Lonergan, Jesse",6,4,1,2,0,0,0,8
Gold Coast,"Lynch, Tom",20,10,7,10,2,2,1,0
Gold Coast,"Malceski, Nick",10,6,3,4,1,0,0,1
Gold Coast,"Martin, Jack",14,9,3,5,0,0,0,5
Gold Coast,"Matera, Brandon",16,10,1,6,2,0,0,2
Gold Coast,"May, Steven",10,6,4,4,0,0,0,1
Gold Coast,"Miller, Touk",21,7,0,14,0,0,0,9
Gold Coast,"Nicholls, Tom",13,2,2,11,0,0,9,7
Gold Coast,"Rosa, Matt",23,12,2,11,0,0,0,7
Gold Coast,"Schoenfeld, Josh",12,6,1,6,0,0,0,6
Gold Coast,"Sexton, Alex",18,11,2,7,0,1,0,5
Gold Coast,"Shaw, Matt",18,10,5,8,1,0,0,1
Gold Coast,"Thompson, Rory",8,5,6,3,0,0,0,4
Gold Coast,"Wright, Peter",9,5,4,4,0,0,6,3
Gold Coast,"Ah Chee, Callum",17,5,3,12,0,0,0,2
Gold Coast,"Davis, Ryan",18,10,2,8,2,0,0,3
Gold Coast,"Day, Sam",6,4,3,2,0,1,0,2
Gold Coast,"Garlett, Jarrod",19,14,5,5,1,0,0,9
Gold Coast,"Grant, Jarrad",17,7,4,10,0,0,0,1
Gold Coast,"Hallahan, Mitch",19,10,2,9,1,0,0,5
Gold Coast,"Harbrow, Jarrod",24,15,3,9,0,0,0,2
Gold Coast,"Joyce, Jesse",15,10,6,5,0,0,0,2
Gold Coast,"Kolodjashnij, Kade",20,13,10,7,0,0,0,1
Gold Coast,"Lemmens, Sean",14,6,4,8,0,0,0,0
Gold Coast,"Lynch, Tom",19,11,9,8,4,1,0,0
Gold Coast,"Martin, Jack",22,13,7,9,0,0,1,2
Gold Coast,"Matera, Brandon",20,15,6,5,2,1,0,1
Gold Coast,"May, Steven",27,17,14,10,0,0,0,0
Gold Coast,"Miller, Touk",24,5,0,19,0,0,1,5
Gold Coast,"Nicholls, Tom",10,3,2,7,1,0,18,5
Gold Coast,"Rosa, Matt",21,9,5,12,0,0,0,7
Gold Coast,"Schoenfeld, Josh",12,6,3,6,0,0,0,1
Gold Coast,"Sexton, Alex",5,4,2,1,0,0,0,1
Gold Coast,"Shaw, Matt",20,12,3,8,0,0,0,1
Gold Coast,"Thompson, Rory",15,10,12,5,0,0,0,3
Gold Coast,"Wright, Peter",16,10,4,6,2,0,8,0
Gold Coast,"Ah Chee, Callum",19,9,4,10,0,1,0,4
Gold Coast,"Brooksby, Keegan",12,6,1,6,0,0,20,3
Gold Coast,"Davis, Ryan",14,8,1,6,0,1,0,3
Gold Coast,"Day, Sam",14,7,6,7,2,1,1,5
Gold Coast,"Garlett, Jarrod",12,6,4,6,0,0,0,4
Gold Coast,"Grant, Jarrad",13,7,6,6,1,0,0,0
Gold Coast,"Hall, Aaron",29,20,4,9,0,0,2,4
Gold Coast,"Hallahan, Mitch",18,10,1,8,0,0,0,1
Gold Coast,"Harbrow, Jarrod",16,14,4,2,0,0,0,4
Gold Coast,"Joyce, Jesse",10,5,3,5,0,0,0,2
Gold Coast,"Kolodjashnij, Kade",16,13,9,3,0,0,0,1
Gold Coast,"Lynch, Tom",18,11,3,7,2,3,1,1
Gold Coast,"Martin, Jack",16,10,6,6,0,0,1,4
Gold Coast,"Matera, Brandon",12,7,1,5,1,0,0,3
Gold Coast,"May, Steven",20,10,9,10,0,0,0,3
Gold Coast,"Miller, Touk",39,20,7,19,1,0,0,4
Gold Coast,"Rosa, Matt",27,14,3,13,0,1,0,1
Gold Coast,"Saad, Adam",12,7,3,5,0,0,0,1
Gold Coast,"Schoenfeld, Josh",13,7,7,6,0,0,0,3
Gold Coast,"Shaw, Matt",18,10,6,8,0,0,0,1
Gold Coast,"Thompson, Rory",11,5,5,6,0,0,0,1
Gold Coast,"Wright, Peter",14,9,7,5,2,2,4,2
Gold Coast,"Ah Chee, Callum",12,3,3,9,0,1,0,0
Gold Coast,"Brooksby, Keegan",16,9,3,7,0,0,15,7
Gold Coast,"Davis, Ryan",14,9,2,5,2,1,0,7
Gold Coast,"Day, Sam",12,8,3,4,0,0,0,3
Gold Coast,"Fiorini, Brayden",17,7,4,10,0,0,0,1
Gold Coast,"Garlett, Jarrod",7,3,1,4,0,0,0,2
Gold Coast,"Grant, Jarrad",10,5,5,5,0,1,0,4
Gold Coast,"Hall, Aaron",26,15,3,11,0,1,0,5
Gold Coast,"Harbrow, Jarrod",18,12,4,6,0,0,0,0
Gold Coast,"Kolodjashnij, Kade",11,5,0,6,0,0,0,1
Gold Coast,"Lemmens, Sean",4,3,0,1,0,0,0,2
Gold Coast,"Lynch, Tom",15,10,4,5,2,3,0,4
Gold Coast,"Martin, Jack",18,9,5,9,1,0,0,3
Gold Coast,"Matera, Brandon",14,6,3,8,0,1,0,0
Gold Coast,"May, Steven",19,9,5,10,0,0,0,1
Gold Coast,"Miller, Touk",32,15,3,17,0,1,0,4
Gold Coast,"Rosa, Matt",16,8,4,8,0,0,2,3
Gold Coast,"Saad, Adam",16,9,2,7,0,0,0,3
Gold Coast,"Sexton, Alex",10,8,1,2,0,0,0,5
Gold Coast,"Shaw, Matt",15,6,5,9,0,0,0,2
Gold Coast,"Thompson, Rory",11,6,7,5,0,2,0,0
Gold Coast,"Wright, Peter",9,3,2,6,1,0,1,3
Gold Coast,"Ah Chee, Callum",18,4,5,14,0,0,0,3
Gold Coast,"Brooksby, Keegan",17,7,3,10,0,0,29,6
Gold Coast,"Davis, Ryan",6,3,0,3,0,0,0,0
Gold Coast,"Day, Sam",12,7,3,5,2,3,2,3
Gold Coast,"Fiorini, Brayden",32,19,7,13,2,1,0,12
Gold Coast,"Grant, Jarrad",16,7,4,9,0,1,0,3
Gold Coast,"Hall, Aaron",27,20,3,7,0,0,0,5
Gold Coast,"Hallahan, Mitch",22,8,0,14,0,0,0,4
Gold Coast,"Joyce, Jesse",12,4,3,8,0,0,0,0
Gold Coast,"Kolodjashnij, Kade",19,11,6,8,0,0,0,2
Gold Coast,"Lynch, Tom",19,12,7,7,1,4,1,2
Gold Coast,"Macpherson, Darcy",10,5,2,5,1,1,0,3
Gold Coast,"Martin, Jack",23,12,6,11,0,0,1,4
Gold Coast,"Matera, Brandon",15,11,2,4,1,1,0,5
Gold Coast,"May, Steven",22,15,9,7,0,0,1,1
Gold Coast,"Miller, Touk",28,14,2,14,0,0,1,5
Gold Coast,"Rosa, Matt",28,12,7,16,1,0,0,4
Gold Coast,"Saad, Adam",20,12,7,8,0,0,0,3
Gold Coast,"Sexton, Alex",17,11,5,6,1,0,0,3
Gold Coast,"Shaw, Matt",14,9,4,5,0,0,0,1
Gold Coast,"Thompson, Rory",12,5,6,7,0,0,0,2
Gold Coast,"Wright, Peter",6,2,1,4,0,0,0,1
Geelong,"Bartel, Jimmy",17,12,5,5,0,0,0,2
Geelong,"Blicavs, Mark",21,9,3,12,1,0,9,5
Geelong,"Caddy, Josh",21,11,3,10,3,0,0,4
Geelong,"Dangerfield, Patrick",43,18,5,25,0,3,1,5
Geelong,"Duncan, Mitch",26,11,6,15,0,1,1,6
Geelong,"Enright, Corey",21,11,4,10,0,0,0,6
Geelong,"Gregson, Cory",12,8,3,4,0,1,0,5
Geelong,"Guthrie, Cameron",19,11,2,8,1,0,0,2
Geelong,"Hawkins, Tom",10,7,2,3,2,0,0,3
Geelong,"Henderson, Lachie",5,4,2,1,1,0,0,4
Geelong,"Kersten, Shane",6,4,3,2,0,0,0,3
Geelong,"Kolodjashnij, Jake",11,7,2,4,0,0,0,2
Geelong,"Lang, Darcy",14,7,2,7,3,0,0,4
Geelong,"Lonergan, Tom",4,4,4,0,0,0,0,5
Geelong,"Mackie, Andrew",17,12,4,5,0,1,0,4
Geelong,"McCarthy, Lincoln",11,8,2,3,2,0,0,4
Geelong,"Motlop, Steven",16,9,1,7,1,0,0,1
Geelong,"Murdoch, Jordan",14,8,4,6,1,0,0,5
Geelong,"Selwood, Joel",23,12,2,11,0,1,0,5
Geelong,"Smith, Zac",14,8,1,6,3,0,16,3
Geelong,"Stanley, Rhys",9,7,5,2,0,0,29,2
Geelong,"Taylor, Harry",15,8,6,7,0,0,0,1
Geelong,"Bartel, Jimmy",18,8,1,10,0,1,0,1
Geelong,"Blicavs, Mark",17,9,3,8,2,1,5,7
Geelong,"Caddy, Josh",17,6,3,11,1,0,1,6
Geelong,"Dangerfield, Patrick",23,13,3,10,0,0,1,3
Geelong,"Duncan, Mitch",7,1,1,6,0,0,0,1
Geelong,"Enright, Corey",24,15,3,9,0,0,0,4
Geelong,"Gregson, Cory",11,7,0,4,1,1,0,2
Geelong,"Guthrie, Cameron",23,12,2,11,0,1,0,1
Geelong,"Hawkins, Tom",18,14,10,4,3,1,0,1
Geelong,"Henderson, Lachie",14,9,4,5,0,0,0,2
Geelong,"Kersten, Shane",7,4,3,3,0,1,0,1
Geelong,"Kolodjashnij, Jake",15,6,4,9,0,0,0,1
Geelong,"Lang, Darcy",20,12,7,8,1,0,0,2
Geelong,"Lonergan, Tom",13,7,5,6,0,0,0,1
Geelong,"Mackie, Andrew",22,15,9,7,0,0,0,2
Geelong,"McCarthy, Lincoln",13,8,3,5,1,1,0,2
Geelong,"Motlop, Steven",18,13,9,5,0,0,0,4
Geelong,"Murdoch, Jordan",12,5,5,7,0,0,0,2
Geelong,"Selwood, Joel",22,11,4,11,0,0,0,3
Geelong,"Smith, Zac",11,2,2,9,0,0,9,1
Geelong,"Stanley, Rhys",8,7,3,1,2,0,12,2
Geelong,"Taylor, Harry",12,4,4,8,0,0,0,1
Geelong,"Bartel, Jimmy",22,9,3,13,1,0,0,8
Geelong,"Blicavs, Mark",20,12,6,8,1,0,5,6
Geelong,"Caddy, Josh",15,11,4,4,0,2,0,5
Geelong,"Cockatoo, Nakia",8,3,1,5,0,0,0,2
Geelong,"Dangerfield, Patrick",26,13,3,13,3,1,1,4
Geelong,"Duncan, Mitch",29,20,8,9,1,0,0,5
Geelong,"Enright, Corey",33,14,6,19,0,0,0,4
Geelong,"Guthrie, Cameron",23,12,4,11,0,0,0,3
Geelong,"Hawkins, Tom",13,10,6,3,4,4,0,2
Geelong,"Henderson, Lachie",12,7,7,5,0,0,0,2
Geelong,"Kersten, Shane",16,13,5,3,3,1,0,5
Geelong,"Kolodjashnij, Jake",12,7,6,5,0,0,0,1
Geelong,"Lang, Darcy",9,3,1,6,0,1,0,6
Geelong,"Mackie, Andrew",15,9,5,6,0,0,0,2
Geelong,"McCarthy, Lincoln",13,6,3,7,2,0,0,4
Geelong,"Menzel, Daniel",15,9,7,6,1,2,0,1
Geelong,"Motlop, Steven",28,21,5,7,2,1,0,2
Geelong,"Ruggles, Tom",17,14,9,3,0,0,0,0
Geelong,"Selwood, Joel",34,12,3,22,0,0,1,7
Geelong,"Smith, Zac",14,6,1,8,0,1,18,3
Geelong,"Stanley, Rhys",9,4,1,5,0,0,13,0
Geelong,"Taylor, Harry",13,6,7,7,0,1,0,1
Geelong,"Bartel, Jimmy",12,7,4,5,1,0,0,6
Geelong,"Blicavs, Mark",14,4,5,10,0,0,5,2
Geelong,"Caddy, Josh",23,6,4,17,1,0,0,6
Geelong,"Cockatoo, Nakia",13,9,4,4,1,2,0,7
Geelong,"Dangerfield, Patrick",27,14,5,13,0,0,0,2
Geelong,"Duncan, Mitch",27,12,4,15,0,0,0,4
Geelong,"Gregson, Cory",10,5,1,5,1,1,0,4
Geelong,"Guthrie, Cameron",18,6,1,12,0,0,1,6
Geelong,"Hawkins, Tom",12,8,5,4,0,0,0,2
Geelong,"Henderson, Lachie",17,13,10,4,0,0,0,1
Geelong,"Kolodjashnij, Jake",12,6,3,6,0,0,0,2
Geelong,"Lang, Darcy",11,6,3,5,1,1,0,2
Geelong,"Lonergan, Tom",12,8,6,4,0,0,0,2
Geelong,"Mackie, Andrew",22,16,8,6,0,0,0,4
Geelong,"Menzel, Daniel",18,10,8,8,0,5,0,3
Geelong,"Motlop, Steven",24,19,4,5,2,1,0,0
Geelong,"Murdoch, Jordan",10,5,4,5,0,0,0,3
Geelong,"Ruggles, Tom",17,9,2,8,0,0,0,1
Geelong,"Selwood, Joel",26,14,5,12,0,0,0,5
Geelong,"Smith, Zac",6,3,2,3,1,2,10,4
Geelong,"Stanley, Rhys",8,5,1,3,1,2,10,3
Geelong,"Taylor, Harry",20,12,8,8,0,0,0,2
Geelong,"Bartel, Jimmy",20,15,5,5,0,0,0,2
Geelong,"Blicavs, Mark",19,6,2,13,0,1,7,12
Geelong,"Caddy, Josh",22,9,1,13,1,0,4,4
Geelong,"Cockatoo, Nakia",9,3,2,6,1,0,0,4
Geelong,"Dangerfield, Patrick",29,16,3,13,2,1,2,7
Geelong,"Duncan, Mitch",29,14,4,15,0,0,0,7
Geelong,"Enright, Corey",24,13,8,11,0,0,0,1
Geelong,"Gregson, Cory",10,4,2,6,0,0,0,6
Geelong,"Guthrie, Cameron",25,8,2,17,1,0,0,4
Geelong,"Hawkins, Tom",12,11,9,1,1,2,0,0
Geelong,"Kersten, Shane",8,6,3,2,2,0,0,2
Geelong,"Kolodjashnij, Jake",9,6,6,3,0,0,0,3
Geelong,"Lonergan, Tom",13,8,6,5,0,0,0,2
Geelong,"Mackie, Andrew",10,6,4,4,0,0,0,2
Geelong,"McCarthy, Lincoln",14,9,4,5,2,0,0,2
Geelong,"Menzel, Daniel",18,11,3,7,3,1,0,4
Geelong,"Motlop, Steven",19,12,5,7,1,0,0,1
Geelong,"Ruggles, Tom",10,8,1,2,0,0,0,3
Geelong,"Selwood, Joel",28,20,8,8,1,1,0,6
Geelong,"Smith, Zac",10,6,6,4,0,1,22,1
Geelong,"Stanley, Rhys",13,7,5,6,1,1,25,4
Geelong,"Taylor, Harry",21,14,10,7,0,0,0,2
Geelong,"Bartel, Jimmy",30,18,14,12,0,1,0,0
Geelong,"Bews, Jed",13,8,5,5,0,0,0,4
Geelong,"Blicavs, Mark",21,13,6,8,0,0,7,7
Geelong,"Caddy, Josh",31,11,5,20,2,1,2,4
Geelong,"Cockatoo, Nakia",12,5,1,7,3,0,0,4
Geelong,"Dangerfield, Patrick",30,17,6,13,2,3,0,5
Geelong,"Duncan, Mitch",27,13,10,14,1,0,0,5
Geelong,"Enright, Corey",21,11,1,10,0,0,0,2
Geelong,"Guthrie, Cameron",29,12,8,17,0,0,0,2
Geelong,"Hawkins, Tom",24,19,11,5,4,2,0,5
Geelong,"Henderson, Lachie",21,15,11,6,0,0,0,4
Geelong,"Kersten, Shane",16,10,7,6,4,2,0,4
Geelong,"Kolodjashnij, Jake",11,6,6,5,0,0,0,1
Geelong,"Lang, Darcy",22,14,8,8,2,0,0,6
Geelong,"Lonergan, Tom",10,9,7,1,0,0,0,1
Geelong,"McCarthy, Lincoln",9,5,1,4,0,1,0,3
Geelong,"Menzel, Daniel",25,13,9,12,1,2,0,6
Geelong,"Motlop, Steven",26,19,6,7,3,1,0,1
Geelong,"Selwood, Joel",32,14,8,18,1,2,0,5
Geelong,"Smith, Zac",15,7,3,8,1,1,12,1
Geelong,"Taylor, Harry",14,11,7,3,0,0,0,1
Geelong,"Vardy, Nathan",6,2,2,4,1,0,11,5
Geelong,"Bartel, Jimmy",28,15,7,13,1,1,2,3
Geelong,"Blicavs, Mark",20,6,5,14,0,2,5,10
Geelong,"Caddy, Josh",26,12,5,14,1,1,3,4
Geelong,"Cockatoo, Nakia",11,8,4,3,1,0,0,4
Geelong,"Dangerfield, Patrick",26,14,9,12,0,1,1,4
Geelong,"Duncan, Mitch",24,15,9,9,0,2,0,3
Geelong,"Enright, Corey",14,9,5,5,0,0,0,7
Geelong,"Guthrie, Cameron",24,10,0,14,2,0,0,1
Geelong,"Hawkins, Tom",12,11,4,1,3,2,0,6
Geelong,"Henderson, Lachie",12,7,6,5,0,0,0,0
Geelong,"Kersten, Shane",18,13,9,5,3,1,0,2
Geelong,"Lang, Darcy",17,7,5,10,0,0,0,3
Geelong,"Lonergan, Tom",15,10,7,5,0,0,0,1
Geelong,"Mackie, Andrew",17,13,4,4,1,0,0,5
Geelong,"McCarthy, Lincoln",3,1,0,2,0,1,0,1
Geelong,"Menzel, Daniel",13,7,4,6,1,2,0,3
Geelong,"Motlop, Steven",25,17,4,8,4,0,0,3
Geelong,"Ruggles, Tom",17,14,4,3,0,0,0,3
Geelong,"Selwood, Joel",35,17,1,18,0,0,0,3
Geelong,"Smith, Zac",9,3,0,6,0,1,14,0
Geelong,"Stanley, Rhys",9,6,4,3,1,1,12,3
Geelong,"Taylor, Harry",7,5,2,2,0,0,0,8
Geelong,"Bartel, Jimmy",25,12,8,13,0,0,0,2
Geelong,"Bews, Jed",17,7,4,10,0,0,0,5
Geelong,"Blicavs, Mark",15,7,5,8,0,0,8,8
Geelong,"Caddy, Josh",21,12,3,9,1,2,2,7
Geelong,"Dangerfield, Patrick",33,13,3,20,0,1,0,11
Geelong,"Duncan, Mitch",22,11,2,11,1,0,0,2
Geelong,"Enright, Corey",23,18,9,5,1,0,0,0
Geelong,"Gregson, Cory",8,4,2,4,0,0,0,6
Geelong,"Guthrie, Cameron",36,13,4,23,0,2,0,10
Geelong,"Hawkins, Tom",8,5,4,3,0,3,0,3
Geelong,"Henderson, Lachie",16,13,9,3,0,0,0,4
Geelong,"Kersten, Shane",13,8,6,5,3,2,0,4
Geelong,"Lang, Darcy",13,5,3,8,1,1,0,1
Geelong,"Lonergan, Tom",0,0,0,0,0,0,0,0
Geelong,"Mackie, Andrew",13,10,6,3,0,0,0,0
Geelong,"Menzel, Daniel",18,12,8,6,1,2,0,2
Geelong,"Motlop, Steven",24,19,1,5,4,0,0,3
Geelong,"Ruggles, Tom",13,9,5,4,0,0,0,2
Geelong,"Selwood, Joel",24,11,2,13,0,2,0,4
Geelong,"Smith, Zac",15,5,3,10,0,1,31,1
Geelong,"Stanley, Rhys",13,8,3,5,1,1,7,4
Geelong,"Taylor, Harry",12,11,7,1,0,0,0,2
Geelong,"Bartel, Jimmy",23,17,7,6,0,1,0,4
Geelong,"Bews, Jed",12,7,6,5,0,0,0,3
Geelong,"Blicavs, Mark",17,7,4,10,0,0,11,7
Geelong,"Caddy, Josh",21,10,5,11,1,1,2,6
Geelong,"Dangerfield, Patrick",21,11,9,10,0,2,0,7
Geelong,"Duncan, Mitch",25,15,6,10,1,1,0,8
Geelong,"Enright, Corey",19,11,5,8,0,0,0,1
Geelong,"Gregson, Cory",13,5,2,8,0,0,0,7
Geelong,"Guthrie, Cameron",19,5,3,14,0,0,0,7
Geelong,"Hawkins, Tom",12,9,5,3,4,1,0,4
Geelong,"Henderson, Lachie",14,9,6,5,0,0,0,4
Geelong,"Horlin-Smith, George",9,5,1,4,0,0,0,2
Geelong,"Kersten, Shane",6,4,4,2,0,1,0,3
Geelong,"Lang, Darcy",23,14,6,9,1,0,0,3
Geelong,"Mackie, Andrew",18,8,3,10,0,0,0,3
Geelong,"Menzel, Daniel",15,8,6,7,1,1,0,1
Geelong,"Motlop, Steven",12,7,3,5,1,2,0,2
Geelong,"Ruggles, Tom",16,10,6,6,0,1,0,0
Geelong,"Selwood, Joel",18,13,1,5,0,0,1,6
Geelong,"Smith, Zac",10,4,0,6,1,0,12,4
Geelong,"Stanley, Rhys",8,5,3,3,1,0,12,2
Geelong,"Taylor, Harry",10,8,5,2,0,0,0,1
Geelong,"Bartel, Jimmy",24,15,6,9,1,0,0,7
Geelong,"Blicavs, Mark",9,3,2,6,0,0,9,5
Geelong,"Caddy, Josh",20,8,5,12,0,1,0,2
Geelong,"Dangerfield, Patrick",31,13,7,18,0,0,1,6
Geelong,"Duncan, Mitch",32,12,5,20,0,0,0,6
Geelong,"Enright, Corey",26,13,6,13,1,0,0,4
Geelong,"Gregson, Cory",17,7,3,10,2,2,0,3
Geelong,"Guthrie, Cameron",27,11,5,16,2,1,1,1
Geelong,"Hawkins, Tom",13,7,8,6,1,2,0,5
Geelong,"Henderson, Lachie",18,15,8,3,0,0,0,2
Geelong,"Kersten, Shane",11,8,5,3,0,1,0,3
Geelong,"Kolodjashnij, Jake",14,7,2,7,0,0,0,2
Geelong,"Lang, Darcy",8,5,1,3,0,1,0,4
Geelong,"Lonergan, Tom",12,5,3,7,0,0,0,2
Geelong,"Mackie, Andrew",18,12,5,6,0,2,0,3
Geelong,"Motlop, Steven",15,12,1,3,2,0,0,0
Geelong,"Murdoch, Jordan",18,7,1,11,0,0,0,1
Geelong,"Selwood, Joel",26,13,2,13,0,0,0,4
Geelong,"Smedts, Billie",16,5,3,11,1,0,0,1
Geelong,"Smith, Zac",10,3,0,7,1,1,20,5
Geelong,"Stanley, Rhys",19,10,5,9,1,0,14,1
Geelong,"Taylor, Harry",15,5,5,10,0,0,0,2
Geelong,"Bartel, Jimmy",25,17,4,8,0,0,0,5
Geelong,"Blicavs, Mark",18,4,1,14,0,0,11,4
Geelong,"Caddy, Josh",27,16,1,11,0,1,1,3
Geelong,"Dangerfield, Patrick",32,17,2,15,0,1,1,5
Geelong,"Duncan, Mitch",23,11,1,12,0,1,0,2
Geelong,"Enright, Corey",25,14,4,11,0,0,0,4
Geelong,"Guthrie, Cameron",27,10,1,17,2,0,0,3
Geelong,"Hawkins, Tom",14,10,7,4,2,3,0,4
Geelong,"Henderson, Lachie",14,12,6,2,1,1,0,0
Geelong,"Kersten, Shane",17,8,4,9,2,2,0,2
Geelong,"Kolodjashnij, Jake",7,5,1,2,0,0,0,3
Geelong,"Lang, Darcy",10,6,2,4,0,1,0,1
Geelong,"Lonergan, Tom",12,8,4,4,0,0,0,4
Geelong,"Mackie, Andrew",16,14,3,2,0,0,0,4
Geelong,"McCarthy, Lincoln",11,8,0,3,1,1,0,0
Geelong,"Menzel, Daniel",14,10,4,4,3,1,0,1
Geelong,"Motlop, Steven",14,12,4,2,0,0,0,0
Geelong,"Murdoch, Jordan",12,7,5,5,1,1,0,1
Geelong,"Ruggles, Tom",7,6,1,1,0,0,0,3
Geelong,"Selwood, Joel",29,16,2,13,1,0,1,7
Geelong,"Smith, Zac",19,7,0,12,1,0,31,4
Geelong,"Taylor, Harry",14,4,4,10,0,0,0,1
Geelong,"Bartel, Jimmy",25,8,2,17,2,0,0,4
Geelong,"Blicavs, Mark",23,9,8,14,0,1,7,3
Geelong,"Caddy, Josh",19,7,3,12,1,1,0,1
Geelong,"Dangerfield, Patrick",48,27,13,21,2,1,0,3
Geelong,"Duncan, Mitch",23,11,8,12,1,2,0,5
Geelong,"Enright, Corey",18,13,5,5,0,0,0,0
Geelong,"Guthrie, Cameron",15,6,1,9,0,0,0,2
Geelong,"Henderson, Lachie",8,5,2,3,0,0,0,1
Geelong,"Kersten, Shane",14,8,5,6,3,1,0,2
Geelong,"Kolodjashnij, Jake",4,2,0,2,0,0,1,3
Geelong,"Lang, Darcy",11,6,2,5,1,0,1,0
Geelong,"Lonergan, Tom",9,4,2,5,0,0,0,0
Geelong,"Mackie, Andrew",18,12,6,6,0,0,0,1
Geelong,"McCarthy, Lincoln",8,2,1,6,0,1,0,4
Geelong,"Menzel, Daniel",14,13,6,1,4,1,0,0
Geelong,"Motlop, Steven",15,13,4,2,1,1,0,1
Geelong,"Murdoch, Jordan",8,6,2,2,0,1,0,2
Geelong,"Ruggles, Tom",18,10,3,8,0,0,0,2
Geelong,"Selwood, Joel",38,17,8,21,0,1,0,5
Geelong,"Smith, Zac",17,11,2,6,0,1,17,3
Geelong,"Stanley, Rhys",6,3,0,3,0,0,9,1
Geelong,"Taylor, Harry",21,14,11,7,0,0,0,3
Geelong,"Bartel, Jimmy",27,16,7,11,0,0,0,7
Geelong,"Blicavs, Mark",16,4,8,12,0,1,10,11
Geelong,"Caddy, Josh",16,6,3,10,1,0,1,5
Geelong,"Dangerfield, Patrick",37,17,4,20,2,0,0,7
Geelong,"Duncan, Mitch",20,12,9,8,0,0,1,7
Geelong,"Enright, Corey",27,18,6,9,0,0,0,2
Geelong,"Gregson, Cory",14,7,6,7,0,1,0,5
Geelong,"Hawkins, Tom",10,7,5,3,4,0,0,1
Geelong,"Henderson, Lachie",19,10,9,9,0,0,0,4
Geelong,"Kersten, Shane",8,3,2,5,0,0,0,0
Geelong,"Kolodjashnij, Jake",14,8,6,6,0,0,0,3
Geelong,"Lonergan, Tom",14,9,6,5,0,0,0,3
Geelong,"Mackie, Andrew",15,11,6,4,0,0,0,2
Geelong,"McCarthy, Lincoln",10,5,5,5,0,0,0,1
Geelong,"Menzel, Daniel",10,7,6,3,4,0,0,3
Geelong,"Motlop, Steven",27,21,5,6,2,1,0,2
Geelong,"Murdoch, Jordan",21,15,11,6,1,0,0,3
Geelong,"Ruggles, Tom",18,15,10,3,0,0,0,1
Geelong,"Selwood, Joel",28,14,1,14,2,0,0,4
Geelong,"Smith, Zac",11,3,1,8,0,0,14,5
Geelong,"Stanley, Rhys",9,4,2,5,0,1,13,1
Geelong,"Taylor, Harry",14,6,7,8,0,0,0,1
Geelong,"Bartel, Jimmy",12,6,3,6,0,0,0,3
Geelong,"Blicavs, Mark",19,11,8,8,1,0,5,2
Geelong,"Dangerfield, Patrick",29,12,3,17,1,0,0,2
Geelong,"Duncan, Mitch",22,13,8,9,0,0,0,5
Geelong,"Enright, Corey",25,14,6,11,0,0,0,1
Geelong,"Gregson, Cory",13,7,4,6,0,1,0,2
Geelong,"Guthrie, Cameron",25,6,3,19,0,0,0,1
Geelong,"Hawkins, Tom",8,5,2,3,3,0,0,0
Geelong,"Henderson, Lachie",20,14,10,6,0,0,0,1
Geelong,"Kersten, Shane",8,5,4,3,1,1,0,1
Geelong,"Kolodjashnij, Jake",16,7,8,9,0,0,0,3
Geelong,"Lonergan, Tom",13,10,5,3,1,0,0,0
Geelong,"Mackie, Andrew",16,11,4,5,0,1,0,4
Geelong,"McCarthy, Lincoln",18,10,5,8,3,1,0,2
Geelong,"Menzel, Daniel",15,7,3,8,1,2,0,3
Geelong,"Motlop, Steven",15,12,5,3,1,1,0,2
Geelong,"Murdoch, Jordan",13,9,6,4,1,1,0,3
Geelong,"Ruggles, Tom",21,14,9,7,0,1,0,3
Geelong,"Selwood, Joel",29,15,4,14,0,0,0,7
Geelong,"Smith, Zac",15,9,5,6,0,1,16,2
Geelong,"Stanley, Rhys",19,10,7,9,0,0,13,2
Geelong,"Taylor, Harry",15,9,5,6,0,0,0,3
Geelong,"Bartel, Jimmy",16,10,3,6,0,1,0,5
Geelong,"Blicavs, Mark",15,6,1,9,0,0,11,4
Geelong,"Clark, Mitch",10,3,3,7,0,0,5,3
Geelong,"Cockatoo, Nakia",14,9,4,5,1,0,0,5
Geelong,"Dangerfield, Patrick",34,22,6,12,1,1,0,4
Geelong,"Duncan, Mitch",24,13,3,11,0,0,0,7
Geelong,"Enright, Corey",19,11,5,8,1,1,0,2
Geelong,"Guthrie, Cameron",15,7,3,8,0,0,1,1
Geelong,"Hawkins, Tom",8,5,2,3,2,0,0,3
Geelong,"Henderson, Lachie",10,5,4,5,0,0,0,3
Geelong,"Kolodjashnij, Jake",9,4,1,5,0,0,0,5
Geelong,"Lang, Darcy",8,5,2,3,0,0,0,1
Geelong,"Lonergan, Tom",13,6,2,7,0,0,0,0
Geelong,"Mackie, Andrew",28,19,5,9,0,0,0,6
Geelong,"McCarthy, Lincoln",7,3,2,4,0,0,0,5
Geelong,"Menzel, Daniel",11,5,3,6,2,0,0,1
Geelong,"Motlop, Steven",17,10,3,7,0,0,0,4
Geelong,"Murdoch, Jordan",13,9,6,4,1,0,0,1
Geelong,"Ruggles, Tom",14,8,2,6,0,0,0,3
Geelong,"Selwood, Joel",23,16,4,7,0,1,0,6
Geelong,"Smith, Zac",14,8,3,6,1,0,16,4
Geelong,"Taylor, Harry",15,9,6,6,0,0,0,2
Geelong,"Blicavs, Mark",13,5,4,8,0,0,4,6
Geelong,"Cockatoo, Nakia",12,9,2,3,1,1,0,3
Geelong,"Cowan, Josh",11,6,4,5,0,0,0,5
Geelong,"Dangerfield, Patrick",31,15,5,16,4,1,0,3
Geelong,"Duncan, Mitch",25,11,5,14,0,1,1,7
Geelong,"Enright, Corey",30,17,12,13,0,0,1,2
Geelong,"Guthrie, Cameron",25,8,2,17,0,1,0,1
Geelong,"Hawkins, Tom",8,6,3,2,1,0,0,5
Geelong,"Henderson, Lachie",13,8,5,5,0,0,0,3
Geelong,"Kersten, Shane",14,9,7,5,0,2,0,4
Geelong,"Kolodjashnij, Jake",21,14,8,7,0,0,0,3
Geelong,"Lonergan, Tom",17,8,6,9,0,0,0,3
Geelong,"Mackie, Andrew",26,19,8,7,0,1,0,5
Geelong,"McCarthy, Lincoln",10,4,1,6,0,0,0,7
Geelong,"Menzel, Daniel",12,6,4,6,1,1,0,1
Geelong,"Motlop, Steven",26,13,5,13,0,1,0,4
Geelong,"Murdoch, Jordan",14,5,2,9,1,0,0,3
Geelong,"Ruggles, Tom",22,13,6,9,0,0,2,4
Geelong,"Selwood, Joel",31,16,4,15,0,0,0,9
Geelong,"Smith, Zac",13,7,6,6,2,0,16,2
Geelong,"Stanley, Rhys",10,5,3,5,1,0,12,2
Geelong,"Taylor, Harry",19,9,5,10,0,0,0,2
Geelong,"Bartel, Jimmy",34,15,3,19,0,0,0,5
Geelong,"Bews, Jed",14,7,5,7,0,0,0,2
Geelong,"Blicavs, Mark",21,7,5,14,0,0,12,4
Geelong,"Cockatoo, Nakia",11,6,2,5,1,1,0,3
Geelong,"Cowan, Josh",12,6,4,6,0,0,0,6
Geelong,"Dangerfield, Patrick",36,16,3,20,0,1,0,6
Geelong,"Duncan, Mitch",21,12,3,9,0,0,1,5
Geelong,"Enright, Corey",31,21,6,10,0,0,0,2
Geelong,"Guthrie, Cameron",25,9,1,16,1,1,0,7
Geelong,"Hawkins, Tom",12,9,5,3,4,1,0,6
Geelong,"Kersten, Shane",14,5,3,9,0,0,0,3
Geelong,"Kolodjashnij, Jake",11,7,4,4,0,0,0,3
Geelong,"Lonergan, Tom",8,5,2,3,0,0,0,4
Geelong,"Mackie, Andrew",16,10,2,6,0,0,0,3
Geelong,"McCarthy, Lincoln",10,8,2,2,1,0,0,3
Geelong,"Menegola, Sam",26,12,5,14,0,0,0,5
Geelong,"Menzel, Daniel",17,10,5,7,4,1,0,3
Geelong,"Motlop, Steven",24,17,2,7,0,2,0,7
Geelong,"Ruggles, Tom",15,10,5,5,0,0,0,1
Geelong,"Selwood, Joel",34,19,3,15,0,0,0,4
Geelong,"Stanley, Rhys",13,7,6,6,1,2,26,2
Geelong,"Taylor, Harry",9,5,6,4,0,0,0,0
Geelong,"Bartel, Jimmy",25,12,7,13,1,1,0,2
Geelong,"Bews, Jed",12,7,6,5,0,0,0,2
Geelong,"Blicavs, Mark",17,5,4,12,0,0,10,8
Geelong,"Cockatoo, Nakia",11,8,2,3,0,1,0,5
Geelong,"Cowan, Josh",15,10,5,5,0,0,0,4
Geelong,"Dangerfield, Patrick",33,21,5,12,3,0,0,4
Geelong,"Duncan, Mitch",25,10,4,15,1,0,1,5
Geelong,"Enright, Corey",27,19,2,8,0,0,0,4
Geelong,"Guthrie, Cameron",15,9,3,6,0,0,0,9
Geelong,"Hawkins, Tom",15,6,2,9,2,0,0,2
Geelong,"Kolodjashnij, Jake",15,9,3,6,0,0,0,2
Geelong,"Lonergan, Tom",15,8,5,7,0,0,1,2
Geelong,"Mackie, Andrew",26,16,7,10,0,0,0,4
Geelong,"McCarthy, Lincoln",11,6,3,5,0,0,0,1
Geelong,"Menegola, Sam",19,11,3,8,0,1,1,6
Geelong,"Menzel, Daniel",15,7,1,8,1,3,0,1
Geelong,"Motlop, Steven",21,16,2,5,3,0,0,5
Geelong,"Ruggles, Tom",17,9,4,8,0,0,0,2
Geelong,"Selwood, Joel",22,6,1,16,0,0,0,10
Geelong,"Smith, Zac",15,5,5,10,0,1,31,2
Geelong,"Stanley, Rhys",16,9,7,7,5,0,11,2
Geelong,"Taylor, Harry",9,6,3,3,0,0,0,1
Geelong,"Bartel, Jimmy",20,9,4,11,0,0,0,1
Geelong,"Bews, Jed",8,3,2,5,0,0,0,2
Geelong,"Blicavs, Mark",21,7,4,14,0,1,7,2
Geelong,"Caddy, Josh",19,7,4,12,2,1,0,1
Geelong,"Cockatoo, Nakia",15,14,6,1,2,0,0,2
Geelong,"Cowan, Josh",20,7,4,13,2,0,0,1
Geelong,"Dangerfield, Patrick",29,14,7,15,1,0,0,1
Geelong,"Duncan, Mitch",24,10,11,14,1,1,0,1
Geelong,"Enright, Corey",29,23,10,6,0,0,0,3
Geelong,"Guthrie, Cameron",29,16,7,13,1,1,0,1
Geelong,"Hawkins, Tom",15,11,10,4,3,4,0,1
Geelong,"Henderson, Lachie",22,13,8,9,0,0,0,3
Geelong,"Lonergan, Tom",11,8,3,3,0,0,0,1
Geelong,"Mackie, Andrew",16,8,2,8,0,0,0,1
Geelong,"Menegola, Sam",26,12,3,14,1,0,0,3
Geelong,"Menzel, Daniel",5,2,2,3,0,0,0,0
Geelong,"Motlop, Steven",20,6,7,14,1,0,0,0
Geelong,"Selwood, Joel",22,11,3,11,0,0,0,4
Geelong,"Selwood, Scott",16,9,2,7,0,0,0,2
Geelong,"Smith, Zac",6,1,0,5,0,0,22,3
Geelong,"Stanley, Rhys",8,3,3,5,1,1,13,2
Geelong,"Taylor, Harry",23,14,13,9,0,0,0,2
Geelong,"Bartel, Jimmy",15,7,4,8,0,1,0,3
Geelong,"Blicavs, Mark",17,9,3,8,0,0,5,5
Geelong,"Caddy, Josh",19,9,4,10,1,1,0,2
Geelong,"Cowan, Josh",20,14,5,6,0,0,0,1
Geelong,"Dangerfield, Patrick",30,14,4,16,0,1,0,3
Geelong,"Duncan, Mitch",17,12,4,5,0,2,0,2
Geelong,"Enright, Corey",26,11,10,15,0,0,0,2
Geelong,"Guthrie, Cameron",23,14,9,9,0,0,0,2
Geelong,"Hawkins, Tom",14,8,4,6,1,2,0,3
Geelong,"Henderson, Lachie",20,13,8,7,0,0,0,1
Geelong,"Kersten, Shane",11,7,5,4,0,0,0,2
Geelong,"Kolodjashnij, Jake",11,8,6,3,0,0,0,2
Geelong,"Lonergan, Tom",12,7,4,5,0,0,0,2
Geelong,"McCarthy, Lincoln",13,11,7,2,2,0,0,0
Geelong,"Menegola, Sam",21,9,5,12,2,1,0,1
Geelong,"Motlop, Steven",17,14,5,3,1,4,0,4
Geelong,"Ruggles, Tom",14,9,5,5,0,0,0,5
Geelong,"Selwood, Joel",30,15,3,15,1,0,0,5
Geelong,"Selwood, Scott",25,12,8,13,0,1,0,4
Geelong,"Smith, Zac",11,4,3,7,1,0,13,2
Geelong,"Stanley, Rhys",19,8,7,11,0,0,8,1
Geelong,"Taylor, Harry",15,9,7,6,1,0,0,0
Geelong,"Blicavs, Mark",17,7,3,10,1,0,6,3
Geelong,"Cowan, Josh",18,11,5,7,1,0,0,4
Geelong,"Dangerfield, Patrick",28,14,4,14,2,4,0,5
Geelong,"Duncan, Mitch",25,12,8,13,1,0,0,5
Geelong,"Enright, Corey",24,17,8,7,1,0,0,2
Geelong,"Guthrie, Cameron",21,10,4,11,1,0,0,5
Geelong,"Hawkins, Tom",13,10,5,3,2,2,0,3
Geelong,"Henderson, Lachie",11,7,5,4,2,1,0,4
Geelong,"Kersten, Shane",12,8,5,4,1,0,0,2
Geelong,"Kolodjashnij, Jake",16,7,4,9,0,0,0,0
Geelong,"Lang, Darcy",18,12,4,6,0,1,0,3
Geelong,"Lonergan, Tom",13,9,4,4,0,0,0,0
Geelong,"Mackie, Andrew",21,11,4,10,0,0,0,3
Geelong,"McCarthy, Lincoln",9,7,6,2,2,0,0,2
Geelong,"Menegola, Sam",33,12,6,21,0,0,0,4
Geelong,"Motlop, Steven",23,17,6,6,5,0,0,3
Geelong,"Ruggles, Tom",15,10,4,5,0,0,0,0
Geelong,"Selwood, Joel",23,9,3,14,0,1,1,9
Geelong,"Selwood, Scott",22,11,6,11,0,0,0,3
Geelong,"Smith, Zac",11,2,1,9,0,2,14,1
Geelong,"Stanley, Rhys",11,6,2,5,0,1,15,2
Geelong,"Taylor, Harry",18,10,8,8,0,0,0,1
Geelong,"Bartel, Jimmy",16,10,9,6,3,0,0,4
Geelong,"Bews, Jed",10,4,2,6,0,0,0,2
Geelong,"Blicavs, Mark",24,6,6,18,0,0,7,4
Geelong,"Caddy, Josh",24,6,2,18,2,1,3,6
Geelong,"Cowan, Josh",15,5,3,10,0,0,0,10
Geelong,"Dangerfield, Patrick",32,20,3,12,0,1,1,4
Geelong,"Duncan, Mitch",15,9,2,6,1,0,0,6
Geelong,"Enright, Corey",14,6,2,8,0,0,0,5
Geelong,"Guthrie, Cameron",22,10,4,12,0,0,0,5
Geelong,"Hawkins, Tom",13,10,9,3,6,1,0,0
Geelong,"Kolodjashnij, Jake",3,2,2,1,0,0,0,2
Geelong,"Lonergan, Tom",10,9,5,1,0,0,0,2
Geelong,"Mackie, Andrew",16,13,7,3,0,0,0,2
Geelong,"McCarthy, Lincoln",18,13,4,5,1,0,0,4
Geelong,"Menegola, Sam",27,15,7,12,3,0,1,1
Geelong,"Menzel, Daniel",22,15,7,7,4,0,0,1
Geelong,"Motlop, Steven",12,10,3,2,2,0,0,7
Geelong,"Ruggles, Tom",22,14,4,8,0,0,0,1
Geelong,"Selwood, Joel",36,17,4,19,1,2,0,4
Geelong,"Smith, Zac",8,3,0,5,0,1,22,3
Geelong,"Stanley, Rhys",19,10,5,9,0,2,8,0
Geelong,"Taylor, Harry",20,12,9,8,1,0,0,1
Geelong,"Bartel, Jimmy",16,9,3,7,0,0,0,6
Geelong,"Blicavs, Mark",20,8,1,12,1,0,12,6
Geelong,"Caddy, Josh",11,7,4,4,2,0,0,2
Geelong,"Cowan, Josh",13,9,1,4,0,1,0,6
Geelong,"Dangerfield, Patrick",35,17,5,18,0,1,0,3
Geelong,"Duncan, Mitch",17,11,3,6,0,0,0,1
Geelong,"Enright, Corey",16,13,5,3,0,1,0,3
Geelong,"Guthrie, Cameron",22,13,3,9,1,0,0,2
Geelong,"Hawkins, Tom",14,5,4,9,2,0,0,2
Geelong,"Kolodjashnij, Jake",11,3,2,8,0,0,0,3
Geelong,"Lonergan, Tom",14,11,7,3,0,0,0,1
Geelong,"Mackie, Andrew",15,11,3,4,0,0,0,0
Geelong,"McCarthy, Lincoln",12,5,0,7,2,0,0,3
Geelong,"Menegola, Sam",23,12,3,11,0,0,0,4
Geelong,"Menzel, Daniel",11,5,3,6,1,0,0,0
Geelong,"Motlop, Steven",16,11,2,5,2,3,0,2
Geelong,"Ruggles, Tom",10,6,4,4,0,0,0,1
Geelong,"Selwood, Joel",27,16,5,11,1,0,0,4
Geelong,"Selwood, Scott",20,9,1,11,0,0,0,8
Geelong,"Smith, Zac",8,3,1,5,0,0,15,2
Geelong,"Stanley, Rhys",11,8,3,3,0,1,11,3
Geelong,"Taylor, Harry",11,5,2,6,0,0,0,1
Geelong,"Bartel, Jimmy",26,14,2,12,1,1,0,2
Geelong,"Bews, Jed",13,8,5,5,0,2,0,1
Geelong,"Blicavs, Mark",13,6,3,7,0,0,17,8
Geelong,"Caddy, Josh",12,7,2,5,1,1,0,3
Geelong,"Cowan, Josh",14,7,1,7,0,0,0,5
Geelong,"Dangerfield, Patrick",39,19,5,20,1,0,0,5
Geelong,"Duncan, Mitch",20,14,6,6,0,2,0,5
Geelong,"Enright, Corey",26,10,2,16,0,0,0,5
Geelong,"Guthrie, Cameron",20,8,3,12,0,0,0,1
Geelong,"Hawkins, Tom",10,5,4,5,1,1,0,0
Geelong,"Henderson, Lachie",8,3,2,5,0,0,0,4
Geelong,"Kolodjashnij, Jake",10,5,1,5,0,0,0,4
Geelong,"Lonergan, Tom",16,9,5,7,0,0,0,0
Geelong,"Mackie, Andrew",15,6,4,9,0,0,0,4
Geelong,"McCarthy, Lincoln",9,3,0,6,0,1,0,1
Geelong,"Menegola, Sam",17,6,1,11,0,0,2,6
Geelong,"Motlop, Steven",13,6,1,7,0,1,0,1
Geelong,"Selwood, Joel",39,17,2,22,1,1,0,13
Geelong,"Selwood, Scott",18,4,2,14,0,0,0,6
Geelong,"Smith, Zac",5,4,0,1,0,0,18,3
Geelong,"Stanley, Rhys",11,5,2,6,1,0,11,2
Geelong,"Taylor, Harry",9,7,5,2,2,0,0,2
Greater Western Sydney,"Buntine, Matt",10,6,3,4,0,0,0,1
Greater Western Sydney,"Corr, Aidan",8,4,4,4,0,0,0,2
Greater Western Sydney,"Davis, Phil",15,4,6,11,0,0,0,3
Greater Western Sydney,"Greene, Toby",12,9,3,3,1,1,0,3
Greater Western Sydney,"Griffen, Ryan",15,4,2,11,0,1,0,5
Greater Western Sydney,"Johnson, Steve",23,11,4,12,2,2,0,3
Greater Western Sydney,"Kelly, Josh",18,10,3,8,0,0,0,4
Greater Western Sydney,"Kennedy, Adam",16,11,5,5,0,0,0,3
Greater Western Sydney,"Lobb, Rory",15,8,7,7,2,3,0,2
Greater Western Sydney,"Marchbank, Caleb",15,8,4,7,0,1,0,4
Greater Western Sydney,"Mumford, Shane",11,1,3,10,0,0,25,3
Greater Western Sydney,"Palmer, Rhys",15,8,3,7,0,0,0,1
Greater Western Sydney,"Scully, Tom",27,19,6,8,1,1,0,1
Greater Western Sydney,"Shaw, Heath",30,25,7,5,0,0,0,2
Greater Western Sydney,"Shiel, Dylan",29,13,4,16,0,0,0,2
Greater Western Sydney,"Smith, Devon",16,9,5,7,1,2,0,2
Greater Western Sydney,"Steele, Jack",11,6,3,5,1,0,0,2
Greater Western Sydney,"Stewart, James",4,2,2,2,0,1,0,0
Greater Western Sydney,"Tomlinson, Adam",9,6,4,3,0,1,0,2
Greater Western Sydney,"Ward, Callan",28,14,6,14,2,2,2,1
Greater Western Sydney,"Whitfield, Lachie",22,12,5,10,0,1,0,3
Greater Western Sydney,"Wilson, Nathan",22,19,6,3,0,0,0,1
Greater Western Sydney,"Buntine, Matt",12,8,1,4,0,0,0,1
Greater Western Sydney,"Coniglio, Stephen",22,6,2,16,1,0,1,1
Greater Western Sydney,"Corr, Aidan",12,6,3,6,0,0,0,5
Greater Western Sydney,"Davis, Phil",14,10,3,4,0,0,0,0
Greater Western Sydney,"Greene, Toby",34,16,4,18,0,1,0,4
Greater Western Sydney,"Griffen, Ryan",32,12,2,20,2,0,1,4
Greater Western Sydney,"Hoskin-Elliott, Will",12,11,5,1,1,0,0,2
Greater Western Sydney,"Johnson, Steve",23,15,7,8,2,1,1,3
Greater Western Sydney,"Kelly, Josh",23,11,5,12,0,0,0,5
Greater Western Sydney,"Kennedy, Adam",13,5,5,8,0,0,0,1
Greater Western Sydney,"Lobb, Rory",11,7,7,4,1,2,3,1
Greater Western Sydney,"Marchbank, Caleb",6,4,1,2,0,0,0,1
Greater Western Sydney,"Mumford, Shane",11,2,4,9,1,0,33,5
Greater Western Sydney,"Palmer, Rhys",9,5,5,4,0,0,0,4
Greater Western Sydney,"Patton, Jonathon",8,7,6,1,0,3,0,0
Greater Western Sydney,"Scully, Tom",32,21,9,11,1,0,0,5
Greater Western Sydney,"Shaw, Heath",15,13,5,2,0,0,0,3
Greater Western Sydney,"Shiel, Dylan",27,14,4,13,1,0,0,2
Greater Western Sydney,"Smith, Devon",16,11,1,5,2,0,0,3
Greater Western Sydney,"Ward, Callan",23,6,2,17,0,0,2,3
Greater Western Sydney,"Whitfield, Lachie",21,11,8,10,0,0,0,3
Greater Western Sydney,"Wilson, Nathan",17,10,3,7,1,0,0,1
Greater Western Sydney,"Coniglio, Stephen",22,10,3,12,2,0,1,2
Greater Western Sydney,"Corr, Aidan",5,4,3,1,0,0,0,1
Greater Western Sydney,"Davis, Phil",18,14,5,4,0,0,0,4
Greater Western Sydney,"Greene, Toby",22,10,1,12,0,1,1,1
Greater Western Sydney,"Griffen, Ryan",21,8,4,13,0,2,1,7
Greater Western Sydney,"Hoskin-Elliott, Will",8,3,2,5,0,0,0,4
Greater Western Sydney,"Johnson, Steve",18,9,3,9,1,0,0,3
Greater Western Sydney,"Kelly, Josh",21,14,2,7,1,0,0,3
Greater Western Sydney,"Kennedy, Adam",14,8,4,6,0,0,0,3
Greater Western Sydney,"Lobb, Rory",7,2,1,5,0,0,1,2
Greater Western Sydney,"Mumford, Shane",11,4,3,7,1,0,30,10
Greater Western Sydney,"Palmer, Rhys",11,8,5,3,2,1,0,2
Greater Western Sydney,"Patfull, Joel",10,6,2,4,0,0,0,2
Greater Western Sydney,"Patton, Jonathon",7,4,4,3,2,0,0,1
Greater Western Sydney,"Scully, Tom",29,16,7,13,0,2,0,6
Greater Western Sydney,"Shaw, Heath",27,22,9,5,0,0,0,4
Greater Western Sydney,"Shiel, Dylan",28,11,2,17,0,0,0,6
Greater Western Sydney,"Smith, Devon",20,7,1,13,0,0,0,2
Greater Western Sydney,"Ward, Callan",18,5,4,13,1,0,4,7
Greater Western Sydney,"Whitfield, Lachie",28,12,4,16,0,0,0,5
Greater Western Sydney,"Williams, Zac",18,11,5,7,0,0,0,2
Greater Western Sydney,"Wilson, Nathan",21,12,4,9,0,0,0,0
Greater Western Sydney,"Buntine, Matt",7,6,5,1,0,0,0,0
Greater Western Sydney,"Coniglio, Stephen",34,13,3,21,1,2,0,3
Greater Western Sydney,"Davis, Phil",10,6,6,4,0,0,0,0
Greater Western Sydney,"Greene, Toby",27,15,6,12,1,3,0,6
Greater Western Sydney,"Griffen, Ryan",16,9,0,7,2,0,3,5
Greater Western Sydney,"Johnson, Steve",22,13,3,9,2,1,0,2
Greater Western Sydney,"Kelly, Josh",17,14,5,3,1,1,0,5
Greater Western Sydney,"Kennedy, Adam",17,8,4,9,0,0,0,0
Greater Western Sydney,"Lobb, Rory",10,7,4,3,4,1,6,4
Greater Western Sydney,"Mumford, Shane",11,1,2,10,1,0,28,3
Greater Western Sydney,"Palmer, Rhys",14,9,6,5,3,1,0,1
Greater Western Sydney,"Patfull, Joel",11,7,4,4,0,0,0,1
Greater Western Sydney,"Patton, Jonathon",12,10,9,2,1,1,0,1
Greater Western Sydney,"Scully, Tom",21,7,3,14,1,0,0,1
Greater Western Sydney,"Shaw, Heath",18,16,10,2,0,0,0,3
Greater Western Sydney,"Shiel, Dylan",31,19,2,12,1,2,0,3
Greater Western Sydney,"Steele, Jack",17,10,5,7,1,1,0,5
Greater Western Sydney,"Tomlinson, Adam",9,5,4,4,0,0,1,4
Greater Western Sydney,"Ward, Callan",24,11,2,13,2,0,4,1
Greater Western Sydney,"Whitfield, Lachie",23,11,9,12,0,2,0,3
Greater Western Sydney,"Williams, Zac",16,13,4,3,0,0,0,2
Greater Western Sydney,"Wilson, Nathan",16,10,4,6,1,0,0,1
Greater Western Sydney,"Buntine, Matt",14,8,5,6,0,0,0,0
Greater Western Sydney,"Cameron, Jeremy",10,7,4,3,5,0,0,2
Greater Western Sydney,"Coniglio, Stephen",32,18,7,14,0,0,0,6
Greater Western Sydney,"Davis, Phil",14,8,7,6,0,0,0,1
Greater Western Sydney,"Greene, Toby",31,23,9,8,4,3,0,1
Greater Western Sydney,"Griffen, Ryan",29,9,7,20,0,2,0,1
Greater Western Sydney,"Johnson, Steve",19,12,5,7,4,1,0,0
Greater Western Sydney,"Kelly, Josh",27,13,8,14,0,0,0,1
Greater Western Sydney,"Kennedy, Adam",8,5,3,3,0,0,0,1
Greater Western Sydney,"Lobb, Rory",10,5,2,5,0,0,8,2
Greater Western Sydney,"Mumford, Shane",11,1,2,10,0,0,31,4
Greater Western Sydney,"Patfull, Joel",12,11,7,1,0,0,0,4
Greater Western Sydney,"Patton, Jonathon",7,4,3,3,1,2,0,0
Greater Western Sydney,"Scully, Tom",31,13,7,18,0,1,0,5
Greater Western Sydney,"Shaw, Heath",27,22,14,5,0,0,0,3
Greater Western Sydney,"Shiel, Dylan",22,11,1,11,0,0,0,3
Greater Western Sydney,"Smith, Devon",16,8,5,8,1,2,0,3
Greater Western Sydney,"Steele, Jack",20,7,5,13,1,0,0,4
Greater Western Sydney,"Ward, Callan",21,13,4,8,1,0,0,5
Greater Western Sydney,"Whitfield, Lachie",11,7,3,4,1,0,0,3
Greater Western Sydney,"Williams, Zac",26,13,3,13,1,0,0,4
Greater Western Sydney,"Wilson, Nathan",21,12,3,9,0,0,0,6
Greater Western Sydney,"Buntine, Matt",7,5,3,2,0,0,0,1
Greater Western Sydney,"Cameron, Jeremy",5,4,0,1,3,0,0,1
Greater Western Sydney,"Coniglio, Stephen",30,12,3,18,0,1,0,9
Greater Western Sydney,"Davis, Phil",5,3,3,2,0,0,0,0
Greater Western Sydney,"Greene, Toby",22,13,4,9,3,0,0,3
Greater Western Sydney,"Haynes, Nick",15,9,5,6,0,0,0,1
Greater Western Sydney,"Johnson, Steve",25,16,4,9,5,0,0,4
Greater Western Sydney,"Kelly, Josh",26,17,4,9,0,2,0,3
Greater Western Sydney,"Kennedy, Adam",16,9,4,7,0,0,0,1
Greater Western Sydney,"Lobb, Rory",16,9,10,7,4,2,7,2
Greater Western Sydney,"Mumford, Shane",12,3,4,9,0,0,33,2
Greater Western Sydney,"Palmer, Rhys",15,12,7,3,3,1,0,3
Greater Western Sydney,"Patfull, Joel",9,4,5,5,0,0,0,2
Greater Western Sydney,"Patton, Jonathon",7,4,4,3,0,0,0,1
Greater Western Sydney,"Scully, Tom",23,10,5,13,3,1,0,1
Greater Western Sydney,"Shaw, Heath",32,29,11,3,0,0,0,2
Greater Western Sydney,"Shiel, Dylan",34,19,3,15,0,1,0,5
Greater Western Sydney,"Steele, Jack",21,9,6,12,0,0,0,7
Greater Western Sydney,"Ward, Callan",29,9,5,20,1,2,3,4
Greater Western Sydney,"Whitfield, Lachie",28,16,9,12,2,0,0,4
Greater Western Sydney,"Williams, Zac",20,8,4,12,0,1,0,5
Greater Western Sydney,"Wilson, Nathan",16,13,4,3,0,0,0,2
Greater Western Sydney,"Buntine, Matt",14,10,4,4,0,0,0,2
Greater Western Sydney,"Cameron, Jeremy",10,7,1,3,1,1,0,2
Greater Western Sydney,"Coniglio, Stephen",32,17,5,15,2,0,0,6
Greater Western Sydney,"Davis, Phil",7,7,3,0,0,0,0,4
Greater Western Sydney,"Greene, Toby",15,8,2,7,1,1,0,6
Greater Western Sydney,"Haynes, Nick",16,11,7,5,0,0,0,3
Greater Western Sydney,"Johnson, Steve",17,12,3,5,2,3,0,2
Greater Western Sydney,"Kelly, Josh",26,12,0,14,1,1,0,2
Greater Western Sydney,"Kennedy, Adam",15,8,5,7,0,0,0,3
Greater Western Sydney,"Lobb, Rory",10,5,3,5,1,0,11,3
Greater Western Sydney,"Mumford, Shane",8,3,1,5,0,0,41,6
Greater Western Sydney,"Palmer, Rhys",16,7,2,9,1,0,0,4
Greater Western Sydney,"Patfull, Joel",12,6,4,6,0,0,0,2
Greater Western Sydney,"Patton, Jonathon",5,4,3,1,2,1,0,2
Greater Western Sydney,"Scully, Tom",24,14,1,10,1,0,0,8
Greater Western Sydney,"Shaw, Heath",26,24,10,2,0,0,0,2
Greater Western Sydney,"Shiel, Dylan",25,10,8,15,0,1,0,3
Greater Western Sydney,"Steele, Jack",17,9,3,8,2,1,0,4
Greater Western Sydney,"Ward, Callan",31,12,2,19,0,1,3,7
Greater Western Sydney,"Whitfield, Lachie",13,2,4,11,0,0,0,4
Greater Western Sydney,"Williams, Zac",10,7,0,3,0,0,0,4
Greater Western Sydney,"Wilson, Nathan",13,11,6,2,0,0,0,0
Greater Western Sydney,"Buntine, Matt",16,9,8,7,0,0,0,0
Greater Western Sydney,"Cameron, Jeremy",19,13,5,6,7,2,0,0
Greater Western Sydney,"Coniglio, Stephen",25,11,1,14,0,0,1,8
Greater Western Sydney,"Haynes, Nick",20,13,8,7,0,0,0,0
Greater Western Sydney,"Hopper, Jacob",32,13,5,19,0,1,0,2
Greater Western Sydney,"Johnson, Steve",13,8,3,5,1,2,0,2
Greater Western Sydney,"Kelly, Josh",29,13,2,16,2,2,0,5
Greater Western Sydney,"Kennedy, Adam",19,10,9,9,0,0,0,0
Greater Western Sydney,"Lobb, Rory",9,6,3,3,3,0,1,0
Greater Western Sydney,"Mohr, Tim",10,8,5,2,0,0,0,3
Greater Western Sydney,"Mumford, Shane",9,3,4,6,0,1,41,8
Greater Western Sydney,"Palmer, Rhys",16,10,3,6,3,1,0,3
Greater Western Sydney,"Patfull, Joel",8,3,2,5,0,0,0,2
Greater Western Sydney,"Patton, Jonathon",16,7,5,9,2,0,0,3
Greater Western Sydney,"Scully, Tom",20,8,3,12,2,0,0,6
Greater Western Sydney,"Shaw, Heath",28,25,12,3,0,0,1,4
Greater Western Sydney,"Shiel, Dylan",35,15,4,20,0,2,0,1
Greater Western Sydney,"Steele, Jack",15,8,6,7,1,0,0,3
Greater Western Sydney,"Ward, Callan",25,14,4,11,0,1,0,3
Greater Western Sydney,"Whitfield, Lachie",21,13,5,8,0,0,0,1
Greater Western Sydney,"Williams, Zac",31,20,8,11,0,2,0,2
Greater Western Sydney,"Wilson, Nathan",22,15,6,7,1,0,0,1
Greater Western Sydney,"Buntine, Matt",1,0,0,1,0,0,0,0
Greater Western Sydney,"Cameron, Jeremy",12,10,7,2,5,2,0,1
Greater Western Sydney,"Coniglio, Stephen",32,16,6,16,1,2,1,8
Greater Western Sydney,"Greene, Toby",22,14,9,8,3,1,0,3
Greater Western Sydney,"Haynes, Nick",15,12,6,3,0,0,0,3
Greater Western Sydney,"Hopper, Jacob",18,8,6,10,0,0,0,3
Greater Western Sydney,"Johnson, Steve",14,10,3,4,2,0,0,5
Greater Western Sydney,"Kelly, Josh",17,11,6,6,0,0,0,3
Greater Western Sydney,"Kennedy, Adam",19,14,9,5,0,0,0,0
Greater Western Sydney,"Lobb, Rory",11,5,7,6,0,0,3,3
Greater Western Sydney,"Mohr, Tim",3,3,0,0,0,0,0,0
Greater Western Sydney,"Mumford, Shane",13,3,6,10,0,0,42,5
Greater Western Sydney,"Palmer, Rhys",15,7,5,8,1,0,0,2
Greater Western Sydney,"Patfull, Joel",9,5,5,4,0,0,0,0
Greater Western Sydney,"Patton, Jonathon",13,10,9,3,0,0,0,3
Greater Western Sydney,"Scully, Tom",21,11,7,10,1,0,0,2
Greater Western Sydney,"Shaw, Heath",38,36,14,2,0,0,0,6
Greater Western Sydney,"Shiel, Dylan",27,16,7,11,1,0,0,6
Greater Western Sydney,"Ward, Callan",30,16,8,14,0,0,0,11
Greater Western Sydney,"Whitfield, Lachie",18,13,9,5,1,0,0,8
Greater Western Sydney,"Williams, Zac",27,12,6,15,0,0,0,8
Greater Western Sydney,"Wilson, Nathan",21,18,8,3,0,0,0,3
Greater Western Sydney,"Cameron, Jeremy",14,10,7,4,1,0,0,0
Greater Western Sydney,"Coniglio, Stephen",30,12,3,18,0,0,0,3
Greater Western Sydney,"Greene, Toby",19,7,1,12,3,0,0,9
Greater Western Sydney,"Haynes, Nick",22,13,6,9,0,0,0,2
Greater Western Sydney,"Hopper, Jacob",16,7,3,9,1,0,0,1
Greater Western Sydney,"Johnson, Steve",15,8,4,7,0,1,0,0
Greater Western Sydney,"Kelly, Josh",28,12,8,16,1,0,0,6
Greater Western Sydney,"Kennedy, Adam",11,4,5,7,0,0,0,1
Greater Western Sydney,"Lobb, Rory",13,8,6,5,1,1,3,0
Greater Western Sydney,"Mumford, Shane",9,2,3,7,0,1,33,7
Greater Western Sydney,"Palmer, Rhys",12,5,1,7,0,0,0,0
Greater Western Sydney,"Patfull, Joel",7,2,3,5,0,0,0,1
Greater Western Sydney,"Patton, Jonathon",14,7,7,7,0,0,0,0
Greater Western Sydney,"Scully, Tom",25,16,9,9,2,1,0,1
Greater Western Sydney,"Shaw, Heath",24,22,4,2,0,0,0,1
Greater Western Sydney,"Shiel, Dylan",29,18,7,11,2,1,1,2
Greater Western Sydney,"Steele, Jack",11,6,3,5,1,0,0,2
Greater Western Sydney,"Tomlinson, Adam",18,12,4,6,1,0,0,0
Greater Western Sydney,"Ward, Callan",17,8,1,9,0,0,0,4
Greater Western Sydney,"Whitfield, Lachie",17,12,4,5,0,0,0,3
Greater Western Sydney,"Williams, Zac",21,13,5,8,0,0,0,1
Greater Western Sydney,"Wilson, Nathan",17,12,3,5,0,0,0,0
Greater Western Sydney,"Buntine, Matt",9,7,2,2,0,0,0,3
Greater Western Sydney,"Cameron, Jeremy",9,3,1,6,0,0,0,1
Greater Western Sydney,"Coniglio, Stephen",27,12,0,15,0,0,0,2
Greater Western Sydney,"Davis, Phil",11,8,4,3,0,0,0,4
Greater Western Sydney,"Greene, Toby",18,11,3,7,3,0,0,7
Greater Western Sydney,"Haynes, Nick",17,13,4,4,0,0,0,2
Greater Western Sydney,"Hopper, Jacob",11,6,4,5,1,1,0,8
Greater Western Sydney,"Johnson, Steve",19,11,4,8,1,0,0,0
Greater Western Sydney,"Kelly, Josh",19,8,2,11,0,0,0,5
Greater Western Sydney,"Lobb, Rory",7,4,1,3,0,0,17,5
Greater Western Sydney,"Mumford, Shane",10,1,1,9,0,0,34,6
Greater Western Sydney,"Patfull, Joel",7,5,4,2,0,0,0,3
Greater Western Sydney,"Patton, Jonathon",10,7,5,3,1,0,0,2
Greater Western Sydney,"Scully, Tom",15,9,4,6,2,0,0,6
Greater Western Sydney,"Shaw, Heath",22,19,8,3,0,0,0,2
Greater Western Sydney,"Shiel, Dylan",32,19,5,13,1,0,0,2
Greater Western Sydney,"Steele, Jack",10,7,3,3,1,0,0,5
Greater Western Sydney,"Tomlinson, Adam",16,10,8,6,0,1,0,1
Greater Western Sydney,"Ward, Callan",22,15,6,7,1,0,0,9
Greater Western Sydney,"Whitfield, Lachie",28,20,9,8,3,0,0,1
Greater Western Sydney,"Williams, Zac",25,20,8,5,0,0,0,3
Greater Western Sydney,"Wilson, Nathan",14,9,4,5,0,0,0,2
Greater Western Sydney,"Buntine, Matt",14,8,5,6,0,0,0,3
Greater Western Sydney,"Cameron, Jeremy",6,3,1,3,1,1,0,2
Greater Western Sydney,"Coniglio, Stephen",22,11,2,11,1,0,2,7
Greater Western Sydney,"Davis, Phil",14,8,6,6,0,0,0,0
Greater Western Sydney,"Greene, Toby",21,15,8,6,4,2,0,2
Greater Western Sydney,"Griffen, Ryan",20,11,2,9,1,2,3,8
Greater Western Sydney,"Haynes, Nick",17,11,6,6,0,0,0,4
Greater Western Sydney,"Hopper, Jacob",16,8,2,8,0,1,0,5
Greater Western Sydney,"Johnson, Steve",27,16,4,11,2,3,0,2
Greater Western Sydney,"Kelly, Josh",27,17,7,10,0,1,0,3
Greater Western Sydney,"Lobb, Rory",13,10,6,3,1,0,9,2
Greater Western Sydney,"Mumford, Shane",8,2,2,6,0,0,33,4
Greater Western Sydney,"Patfull, Joel",8,5,3,3,0,0,0,2
Greater Western Sydney,"Patton, Jonathon",9,6,6,3,2,0,0,1
Greater Western Sydney,"Reid, Sam",12,5,2,7,1,1,0,4
Greater Western Sydney,"Scully, Tom",19,11,4,8,1,1,0,6
Greater Western Sydney,"Shaw, Heath",25,21,10,4,0,0,0,2
Greater Western Sydney,"Shiel, Dylan",24,15,7,9,0,0,0,5
Greater Western Sydney,"Ward, Callan",25,14,5,11,0,1,3,7
Greater Western Sydney,"Whitfield, Lachie",20,11,5,9,1,1,0,5
Greater Western Sydney,"Williams, Zac",23,17,10,6,0,0,0,1
Greater Western Sydney,"Wilson, Nathan",18,13,8,5,0,0,0,0
Greater Western Sydney,"Buntine, Matt",10,8,6,2,0,0,0,1
Greater Western Sydney,"Cameron, Jeremy",9,7,3,2,2,2,0,2
Greater Western Sydney,"Coniglio, Stephen",29,17,4,12,1,1,0,7
Greater Western Sydney,"Davis, Phil",9,5,5,4,0,0,0,1
Greater Western Sydney,"Downie, Tom",5,2,2,3,0,0,20,2
Greater Western Sydney,"Greene, Toby",22,16,5,6,4,2,2,3
Greater Western Sydney,"Griffen, Ryan",18,8,5,10,1,0,2,4
Greater Western Sydney,"Haynes, Nick",15,12,8,3,0,0,0,2
Greater Western Sydney,"Hopper, Jacob",18,6,2,12,1,0,0,3
Greater Western Sydney,"Kelly, Josh",23,11,4,12,1,1,0,3
Greater Western Sydney,"Kennedy, Matthew",11,6,1,5,3,0,0,0
Greater Western Sydney,"Lobb, Rory",14,6,4,8,0,0,13,4
Greater Western Sydney,"Patfull, Joel",12,7,5,5,0,0,0,3
Greater Western Sydney,"Patton, Jonathon",14,8,8,6,1,1,0,1
Greater Western Sydney,"Reid, Sam",13,8,3,5,1,2,0,2
Greater Western Sydney,"Scully, Tom",21,9,7,12,0,0,0,7
Greater Western Sydney,"Shaw, Heath",31,27,7,4,0,0,0,3
Greater Western Sydney,"Shiel, Dylan",21,8,0,13,0,1,0,4
Greater Western Sydney,"Ward, Callan",25,12,1,13,0,0,3,3
Greater Western Sydney,"Whitfield, Lachie",13,9,3,4,0,0,0,4
Greater Western Sydney,"Williams, Zac",23,12,5,11,2,0,0,0
Greater Western Sydney,"Wilson, Nathan",19,10,3,9,0,0,0,0
Greater Western Sydney,"Buntine, Matt",9,5,4,4,0,0,0,4
Greater Western Sydney,"Cameron, Jeremy",13,7,2,6,3,1,0,5
Greater Western Sydney,"Coniglio, Stephen",31,14,2,17,1,0,0,6
Greater Western Sydney,"Davis, Phil",5,5,2,0,0,1,0,0
Greater Western Sydney,"Greene, Toby",21,11,5,10,1,2,0,4
Greater Western Sydney,"Griffen, Ryan",23,13,3,10,0,1,1,5
Greater Western Sydney,"Haynes, Nick",15,11,8,4,0,0,1,1
Greater Western Sydney,"Johnson, Steve",22,14,6,8,4,2,0,3
Greater Western Sydney,"Kelly, Josh",22,11,2,11,2,1,0,7
Greater Western Sydney,"Kennedy, Matthew",6,2,3,4,0,1,0,4
Greater Western Sydney,"Lobb, Rory",12,5,4,7,1,1,13,1
Greater Western Sydney,"Mumford, Shane",12,2,2,10,0,0,35,5
Greater Western Sydney,"Palmer, Rhys",18,8,5,10,0,3,0,3
Greater Western Sydney,"Patfull, Joel",7,4,2,3,0,0,0,0
Greater Western Sydney,"Patton, Jonathon",11,7,6,4,1,1,0,0
Greater Western Sydney,"Scully, Tom",27,12,1,15,1,1,0,3
Greater Western Sydney,"Shaw, Heath",12,10,1,2,0,0,0,2
Greater Western Sydney,"Shiel, Dylan",34,12,1,22,2,0,0,4
Greater Western Sydney,"Ward, Callan",33,18,4,15,0,1,1,2
Greater Western Sydney,"Whitfield, Lachie",12,8,4,4,1,1,0,2
Greater Western Sydney,"Williams, Zac",24,19,4,5,1,0,0,4
Greater Western Sydney,"Wilson, Nathan",11,7,3,4,0,0,0,2
Greater Western Sydney,"Cameron, Jeremy",14,7,4,7,5,1,0,1
Greater Western Sydney,"Coniglio, Stephen",30,13,3,17,0,0,0,4
Greater Western Sydney,"Davis, Phil",13,10,7,3,0,0,0,1
Greater Western Sydney,"Greene, Toby",16,6,4,10,0,0,0,3
Greater Western Sydney,"Haynes, Nick",19,13,7,6,0,0,0,4
Greater Western Sydney,"Johnson, Steve",9,4,2,5,1,1,0,2
Greater Western Sydney,"Kelly, Josh",23,11,3,12,2,3,0,4
Greater Western Sydney,"Kennedy, Adam",6,2,0,4,0,0,0,0
Greater Western Sydney,"Lobb, Rory",14,8,7,6,1,0,8,2
Greater Western Sydney,"Mumford, Shane",17,5,4,12,0,0,28,8
Greater Western Sydney,"Palmer, Rhys",12,9,5,3,0,0,0,3
Greater Western Sydney,"Patfull, Joel",12,6,7,6,0,0,0,3
Greater Western Sydney,"Patton, Jonathon",8,7,6,1,3,1,0,0
Greater Western Sydney,"Scully, Tom",20,7,2,13,0,1,0,4
Greater Western Sydney,"Shaw, Heath",20,17,3,3,0,0,0,1
Greater Western Sydney,"Shiel, Dylan",22,12,4,10,1,1,0,2
Greater Western Sydney,"Smith, Devon",15,7,2,8,0,0,0,5
Greater Western Sydney,"Steele, Jack",15,7,3,8,0,0,0,3
Greater Western Sydney,"Tomlinson, Adam",11,5,3,6,0,0,0,0
Greater Western Sydney,"Ward, Callan",17,8,2,9,1,0,2,2
Greater Western Sydney,"Whitfield, Lachie",22,13,5,9,0,0,0,1
Greater Western Sydney,"Williams, Zac",16,8,3,8,0,0,0,7
Greater Western Sydney,"Cameron, Jeremy",19,11,9,8,3,1,1,6
Greater Western Sydney,"Coniglio, Stephen",32,20,4,12,0,0,0,9
Greater Western Sydney,"Davis, Phil",13,7,0,6,0,0,0,5
Greater Western Sydney,"Greene, Toby",29,15,6,14,2,1,1,4
Greater Western Sydney,"Haynes, Nick",19,9,5,10,2,0,0,3
Greater Western Sydney,"Himmelberg, Harry",15,7,2,8,0,0,0,1
Greater Western Sydney,"Johnson, Steve",23,14,5,9,1,1,0,3
Greater Western Sydney,"Kelly, Josh",26,16,5,10,3,0,0,6
Greater Western Sydney,"Kennedy, Adam",20,12,8,8,1,0,0,2
Greater Western Sydney,"Lobb, Rory",14,10,5,4,1,2,5,5
Greater Western Sydney,"Mumford, Shane",11,1,1,10,0,0,35,2
Greater Western Sydney,"Patfull, Joel",6,3,1,3,1,0,0,4
Greater Western Sydney,"Patton, Jonathon",14,8,6,6,2,0,0,2
Greater Western Sydney,"Reid, Sam",13,4,2,9,0,2,0,6
Greater Western Sydney,"Scully, Tom",28,11,4,17,0,0,0,2
Greater Western Sydney,"Shaw, Heath",17,12,3,5,0,0,0,5
Greater Western Sydney,"Shiel, Dylan",34,19,0,15,1,1,0,1
Greater Western Sydney,"Smith, Devon",26,16,5,10,2,2,0,5
Greater Western Sydney,"Steele, Jack",18,12,4,6,0,0,0,6
Greater Western Sydney,"Tomlinson, Adam",13,7,1,6,0,0,0,2
Greater Western Sydney,"Ward, Callan",31,19,3,12,3,1,5,4
Greater Western Sydney,"Williams, Zac",24,18,3,6,0,0,0,3
Greater Western Sydney,"Cameron, Jeremy",11,9,3,2,2,1,0,1
Greater Western Sydney,"Coniglio, Stephen",28,14,2,14,1,1,0,5
Greater Western Sydney,"Davis, Phil",14,4,3,10,0,0,0,1
Greater Western Sydney,"Greene, Toby",25,12,3,13,1,0,1,3
Greater Western Sydney,"Haynes, Nick",25,18,5,7,0,0,0,0
Greater Western Sydney,"Himmelberg, Harry",12,10,3,2,0,0,0,2
Greater Western Sydney,"Johnson, Steve",18,11,1,7,0,1,1,9
Greater Western Sydney,"Kelly, Josh",30,18,5,12,0,0,0,5
Greater Western Sydney,"Kennedy, Adam",8,5,2,3,0,1,0,2
Greater Western Sydney,"Lobb, Rory",6,2,1,4,0,0,12,8
Greater Western Sydney,"Mumford, Shane",11,2,3,9,0,0,49,10
Greater Western Sydney,"Patfull, Joel",11,11,2,0,0,0,1,3
Greater Western Sydney,"Patton, Jonathon",6,4,2,2,1,0,0,4
Greater Western Sydney,"Reid, Sam",9,6,0,3,1,1,0,5
Greater Western Sydney,"Scully, Tom",29,17,3,12,1,1,0,8
Greater Western Sydney,"Shaw, Heath",30,29,6,1,0,0,0,2
Greater Western Sydney,"Shiel, Dylan",28,20,1,8,2,1,0,5
Greater Western Sydney,"Smith, Devon",23,10,2,13,2,2,0,4
Greater Western Sydney,"Tomlinson, Adam",12,6,3,6,0,1,0,0
Greater Western Sydney,"Ward, Callan",23,13,1,10,0,1,1,7
Greater Western Sydney,"Williams, Zac",19,12,0,7,0,0,0,4
Greater Western Sydney,"Wilson, Nathan",10,7,1,3,0,0,0,2
Greater Western Sydney,"Cameron, Jeremy",10,7,5,3,2,0,0,1
Greater Western Sydney,"Coniglio, Stephen",33,11,2,22,0,0,0,7
Greater Western Sydney,"Davis, Phil",14,8,7,6,0,0,0,1
Greater Western Sydney,"Greene, Toby",15,8,2,7,3,1,0,5
Greater Western Sydney,"Griffen, Ryan",14,6,3,8,0,1,2,4
Greater Western Sydney,"Himmelberg, Harry",16,10,7,6,0,1,0,0
Greater Western Sydney,"Johnson, Steve",18,13,7,5,3,0,0,4
Greater Western Sydney,"Kelly, Josh",21,10,3,11,0,1,0,1
Greater Western Sydney,"Kennedy, Adam",18,10,6,8,1,0,0,2
Greater Western Sydney,"Lobb, Rory",11,7,4,4,0,1,4,3
Greater Western Sydney,"Mumford, Shane",16,0,3,16,0,0,28,4
Greater Western Sydney,"Patfull, Joel",15,5,6,10,0,0,0,3
Greater Western Sydney,"Patton, Jonathon",8,6,6,2,0,1,0,3
Greater Western Sydney,"Reid, Sam",11,8,4,3,3,0,0,3
Greater Western Sydney,"Scully, Tom",30,12,5,18,2,0,0,1
Greater Western Sydney,"Shaw, Heath",29,26,11,3,0,0,0,2
Greater Western Sydney,"Shiel, Dylan",25,11,3,14,1,0,0,1
Greater Western Sydney,"Smith, Devon",17,8,1,9,1,0,0,14
Greater Western Sydney,"Tomlinson, Adam",13,9,5,4,0,0,0,0
Greater Western Sydney,"Ward, Callan",18,9,3,9,1,0,2,6
Greater Western Sydney,"Williams, Zac",24,15,9,9,0,0,0,3
Greater Western Sydney,"Wilson, Nathan",17,14,6,3,0,1,0,1
Greater Western Sydney,"Cameron, Jeremy",15,10,5,5,4,1,0,2
Greater Western Sydney,"Coniglio, Stephen",33,11,4,22,0,1,0,4
Greater Western Sydney,"Davis, Phil",16,13,7,3,0,0,0,1
Greater Western Sydney,"Greene, Toby",22,15,5,7,2,2,0,3
Greater Western Sydney,"Griffen, Ryan",22,7,2,15,0,0,2,4
Greater Western Sydney,"Haynes, Nick",18,12,7,6,0,0,0,1
Greater Western Sydney,"Himmelberg, Harry",10,7,2,3,0,0,0,2
Greater Western Sydney,"Johnson, Steve",17,13,4,4,2,0,0,4
Greater Western Sydney,"Kelly, Josh",27,10,2,17,0,0,0,5
Greater Western Sydney,"Lobb, Rory",13,7,5,6,1,0,3,5
Greater Western Sydney,"Mumford, Shane",11,1,1,10,0,0,51,8
Greater Western Sydney,"Patfull, Joel",18,7,5,11,0,0,0,4
Greater Western Sydney,"Patton, Jonathon",12,11,8,1,2,0,0,2
Greater Western Sydney,"Reid, Sam",10,6,2,4,1,0,0,3
Greater Western Sydney,"Scully, Tom",28,7,5,21,0,0,0,8
Greater Western Sydney,"Shaw, Heath",17,13,7,4,0,0,0,0
Greater Western Sydney,"Smith, Devon",19,14,4,5,1,3,0,5
Greater Western Sydney,"Tomlinson, Adam",9,8,5,1,0,0,0,1
Greater Western Sydney,"Ward, Callan",26,11,3,15,1,0,3,4
Greater Western Sydney,"Whitfield, Lachie",22,13,8,9,0,0,0,4
Greater Western Sydney,"Williams, Zac",24,16,5,8,0,1,0,3
Greater Western Sydney,"Wilson, Nathan",12,12,4,0,0,0,0,1
Greater Western Sydney,"Cameron, Jeremy",12,7,4,5,1,4,0,2
Greater Western Sydney,"Coniglio, Stephen",28,14,6,14,0,1,0,8
Greater Western Sydney,"Davis, Phil",13,5,5,8,0,0,0,1
Greater Western Sydney,"Greene, Toby",23,13,11,10,1,1,0,1
Greater Western Sydney,"Griffen, Ryan",23,13,2,10,2,0,2,7
Greater Western Sydney,"Haynes, Nick",18,13,6,5,0,0,0,0
Greater Western Sydney,"Johnson, Steve",13,9,4,4,1,1,0,4
Greater Western Sydney,"Kelly, Josh",23,15,2,8,0,1,0,5
Greater Western Sydney,"Kennedy, Adam",15,9,1,6,0,0,0,1
Greater Western Sydney,"Kennedy, Matthew",12,4,2,8,0,0,0,1
Greater Western Sydney,"Lobb, Rory",15,13,5,2,4,2,7,4
Greater Western Sydney,"Mumford, Shane",11,0,1,11,0,0,37,11
Greater Western Sydney,"Patfull, Joel",13,8,4,5,0,0,0,5
Greater Western Sydney,"Patton, Jonathon",9,5,3,4,2,1,0,1
Greater Western Sydney,"Scully, Tom",21,8,3,13,1,0,0,3
Greater Western Sydney,"Shaw, Heath",21,18,4,3,0,0,0,1
Greater Western Sydney,"Shiel, Dylan",30,14,3,16,0,0,0,4
Greater Western Sydney,"Smith, Devon",16,8,3,8,2,0,0,3
Greater Western Sydney,"Tomlinson, Adam",12,3,2,9,0,0,0,3
Greater Western Sydney,"Ward, Callan",25,12,2,13,0,1,1,3
Greater Western Sydney,"Whitfield, Lachie",19,9,3,10,0,0,0,3
Greater Western Sydney,"Williams, Zac",20,13,5,7,0,0,0,2
Greater Western Sydney,"Cameron, Jeremy",12,7,2,5,3,2,0,4
Greater Western Sydney,"Coniglio, Stephen",23,10,1,13,0,1,0,5
Greater Western Sydney,"Davis, Phil",11,8,4,3,0,0,0,0
Greater Western Sydney,"Greene, Toby",15,11,6,4,2,1,0,4
Greater Western Sydney,"Griffen, Ryan",30,16,3,14,1,0,3,10
Greater Western Sydney,"Haynes, Nick",21,14,13,7,0,1,0,0
Greater Western Sydney,"Hopper, Jacob",15,3,1,12,1,0,0,3
Greater Western Sydney,"Johnson, Steve",14,11,5,3,3,1,0,2
Greater Western Sydney,"Kelly, Josh",20,11,2,9,0,1,0,2
Greater Western Sydney,"Lobb, Rory",13,8,1,5,1,1,5,5
Greater Western Sydney,"Mumford, Shane",10,2,0,8,0,0,31,7
Greater Western Sydney,"Patfull, Joel",13,7,5,6,0,0,0,4
Greater Western Sydney,"Patton, Jonathon",14,12,8,2,6,1,0,1
Greater Western Sydney,"Scully, Tom",21,10,5,11,1,1,0,4
Greater Western Sydney,"Shaw, Heath",25,20,11,5,0,0,0,5
Greater Western Sydney,"Shiel, Dylan",25,7,3,18,0,1,0,5
Greater Western Sydney,"Smith, Devon",16,5,2,11,0,1,0,3
Greater Western Sydney,"Tomlinson, Adam",20,16,12,4,0,0,0,1
Greater Western Sydney,"Ward, Callan",23,8,4,15,0,0,1,5
Greater Western Sydney,"Whitfield, Lachie",26,16,9,10,1,0,0,4
Greater Western Sydney,"Williams, Zac",21,12,3,9,0,0,0,1
Greater Western Sydney,"Wilson, Nathan",21,16,4,5,0,0,0,1
Greater Western Sydney,"Cameron, Jeremy",7,3,2,4,1,1,0,2
Greater Western Sydney,"Coniglio, Stephen",16,10,2,6,0,0,0,6
Greater Western Sydney,"Davis, Phil",11,5,8,6,0,0,0,2
Greater Western Sydney,"Greene, Toby",20,11,5,9,0,2,0,3
Greater Western Sydney,"Griffen, Ryan",16,7,1,9,0,2,3,3
Greater Western Sydney,"Haynes, Nick",15,9,4,6,0,0,0,1
Greater Western Sydney,"Hopper, Jacob",20,6,5,14,1,0,0,1
Greater Western Sydney,"Johnson, Steve",16,10,5,6,4,0,0,3
Greater Western Sydney,"Kelly, Josh",20,10,5,10,0,1,0,1
Greater Western Sydney,"Lobb, Rory",9,6,3,3,0,0,5,0
Greater Western Sydney,"Mumford, Shane",12,3,1,9,0,0,31,4
Greater Western Sydney,"Patfull, Joel",8,7,4,1,0,0,0,4
Greater Western Sydney,"Patton, Jonathon",17,13,9,4,5,2,0,1
Greater Western Sydney,"Scully, Tom",29,13,7,16,0,0,0,5
Greater Western Sydney,"Shaw, Heath",25,22,5,3,0,0,0,3
Greater Western Sydney,"Shiel, Dylan",29,17,7,12,0,1,0,3
Greater Western Sydney,"Smith, Devon",23,13,7,10,2,1,0,2
Greater Western Sydney,"Tomlinson, Adam",10,4,0,6,0,0,0,1
Greater Western Sydney,"Ward, Callan",21,10,5,11,1,1,5,6
Greater Western Sydney,"Whitfield, Lachie",20,11,4,9,0,0,0,1
Greater Western Sydney,"Williams, Zac",15,12,2,3,0,0,0,0
Greater Western Sydney,"Wilson, Nathan",12,12,4,0,0,1,0,0
Greater Western Sydney,"Cameron, Jeremy",13,9,6,4,4,4,0,3
Greater Western Sydney,"Coniglio, Stephen",26,11,4,15,1,0,0,9
Greater Western Sydney,"Davis, Phil",8,4,1,4,0,0,0,5
Greater Western Sydney,"Greene, Toby",20,14,7,6,2,1,0,4
Greater Western Sydney,"Griffen, Ryan",19,10,4,9,0,2,2,9
Greater Western Sydney,"Haynes, Nick",14,7,6,7,0,0,0,0
Greater Western Sydney,"Hopper, Jacob",14,7,3,7,0,0,0,3
Greater Western Sydney,"Johnson, Steve",22,15,7,7,0,5,0,3
Greater Western Sydney,"Kelly, Josh",24,12,2,12,0,0,0,5
Greater Western Sydney,"Lobb, Rory",16,10,8,6,0,0,7,0
Greater Western Sydney,"Mumford, Shane",10,1,0,9,0,0,24,5
Greater Western Sydney,"Patfull, Joel",11,3,4,8,0,0,0,2
Greater Western Sydney,"Patton, Jonathon",5,3,3,2,0,0,0,2
Greater Western Sydney,"Scully, Tom",19,9,2,10,2,1,0,5
Greater Western Sydney,"Shaw, Heath",26,20,6,6,0,0,0,1
Greater Western Sydney,"Shiel, Dylan",20,7,3,13,0,0,0,10
Greater Western Sydney,"Smith, Devon",23,10,1,13,1,3,0,10
Greater Western Sydney,"Tomlinson, Adam",17,12,10,5,0,0,0,2
Greater Western Sydney,"Ward, Callan",15,8,2,7,1,0,3,4
Greater Western Sydney,"Whitfield, Lachie",27,14,6,13,1,0,0,6
Greater Western Sydney,"Williams, Zac",14,9,2,5,0,0,0,6
Greater Western Sydney,"Wilson, Nathan",14,11,5,3,0,0,0,2
Greater Western Sydney,"Cameron, Jeremy",5,2,1,3,0,1,0,1
Greater Western Sydney,"Coniglio, Stephen",27,8,1,19,0,0,1,4
Greater Western Sydney,"Davis, Phil",13,9,3,4,0,0,0,3
Greater Western Sydney,"Greene, Toby",18,12,3,6,3,1,0,2
Greater Western Sydney,"Griffen, Ryan",18,4,1,14,0,0,2,3
Greater Western Sydney,"Haynes, Nick",17,14,11,3,0,0,0,3
Greater Western Sydney,"Hopper, Jacob",12,1,1,11,0,0,0,4
Greater Western Sydney,"Kelly, Josh",29,14,3,15,0,0,0,5
Greater Western Sydney,"Lobb, Rory",15,12,7,3,3,0,7,2
Greater Western Sydney,"Mumford, Shane",10,4,3,6,0,0,46,6
Greater Western Sydney,"Palmer, Rhys",14,6,6,8,0,0,0,2
Greater Western Sydney,"Patfull, Joel",6,3,0,3,0,0,0,5
Greater Western Sydney,"Patton, Jonathon",9,6,5,3,4,1,0,2
Greater Western Sydney,"Scully, Tom",30,12,3,18,0,1,0,5
Greater Western Sydney,"Shaw, Heath",15,15,5,0,1,0,1,2
Greater Western Sydney,"Shiel, Dylan",28,12,3,16,0,2,0,5
Greater Western Sydney,"Smith, Devon",16,6,1,10,1,2,0,5
Greater Western Sydney,"Tomlinson, Adam",11,7,5,4,0,0,0,4
Greater Western Sydney,"Ward, Callan",9,7,3,2,0,0,1,1
Greater Western Sydney,"Whitfield, Lachie",22,13,7,9,0,0,0,5
Greater Western Sydney,"Williams, Zac",15,9,2,6,0,0,0,2
Greater Western Sydney,"Wilson, Nathan",20,14,6,6,0,1,0,3
Hawthorn,"Birchall, Grant",26,11,5,15,0,0,0,1
Hawthorn,"Breust, Luke",13,5,2,8,2,1,0,2
Hawthorn,"Burgoyne, Shaun",21,13,5,8,1,1,0,5
Hawthorn,"Duryea, Taylor",20,12,4,8,0,0,0,3
Hawthorn,"Frawley, James",18,12,4,6,0,0,0,2
Hawthorn,"Gibson, Josh",24,8,4,16,0,0,0,4
Hawthorn,"Gunston, Jack",15,11,7,4,3,1,0,6
Hawthorn,"Hartung, Billy",24,13,1,11,1,2,0,3
Hawthorn,"Hodge, Luke",18,8,4,10,0,0,0,5
Hawthorn,"Langford, Will",20,13,2,7,2,0,1,8
Hawthorn,"Lewis, Jordan",30,12,7,18,0,1,9,8
Hawthorn,"Litherland, Angus",12,6,1,6,0,0,0,5
Hawthorn,"McEvoy, Ben",10,4,4,6,0,1,31,3
Hawthorn,"Mitchell, Sam",36,19,5,17,0,0,0,5
Hawthorn,"ORourke, Jonathan",16,6,1,10,0,0,0,2
Hawthorn,"Pittonet, Marc",6,1,0,5,0,0,7,1
Hawthorn,"Puopolo, Paul",11,8,3,3,3,0,0,3
Hawthorn,"Rioli, Cyril",9,8,2,1,0,0,0,5
Hawthorn,"Schoenmakers, Ryan",2,0,1,2,0,0,0,1
Hawthorn,"Sicily, James",5,3,1,2,0,1,0,4
Hawthorn,"Smith, Isaac",15,9,5,6,0,1,0,3
Hawthorn,"Stratton, Ben",9,4,2,5,0,0,0,2
Hawthorn,"Birchall, Grant",26,11,8,15,0,0,0,4
Hawthorn,"Breust, Luke",18,11,5,7,1,2,0,5
Hawthorn,"Burgoyne, Shaun",24,16,5,8,0,0,0,2
Hawthorn,"Ceglar, Jonathon",10,3,2,7,0,1,15,3
Hawthorn,"Duryea, Taylor",22,15,4,7,0,0,0,3
Hawthorn,"Frawley, James",17,10,7,7,0,0,0,6
Hawthorn,"Gibson, Josh",44,19,9,25,1,0,0,4
Hawthorn,"Gunston, Jack",21,14,9,7,1,2,0,3
Hawthorn,"Hartung, Billy",32,14,2,18,0,0,0,2
Hawthorn,"Howe, Daniel",10,5,2,5,0,0,0,5
Hawthorn,"Langford, Will",23,13,4,10,0,1,1,11
Hawthorn,"Lewis, Jordan",28,10,4,18,1,0,4,6
Hawthorn,"Litherland, Angus",13,5,2,8,0,0,0,3
Hawthorn,"McEvoy, Ben",8,2,1,6,1,0,15,3
Hawthorn,"Mitchell, Sam",37,22,8,15,0,0,0,6
Hawthorn,"ORourke, Jonathan",18,8,1,10,1,0,0,1
Hawthorn,"Puopolo, Paul",11,4,2,7,0,1,0,3
Hawthorn,"Rioli, Cyril",20,12,4,8,4,0,0,7
Hawthorn,"Schoenmakers, Ryan",14,6,2,8,0,2,1,2
Hawthorn,"Sicily, James",15,6,6,9,4,2,0,1
Hawthorn,"Smith, Isaac",33,12,8,21,0,0,0,4
Hawthorn,"Stratton, Ben",14,8,6,6,0,0,0,5
Hawthorn,"Birchall, Grant",23,12,7,11,0,0,0,1
Hawthorn,"Breust, Luke",15,9,2,6,2,1,0,3
Hawthorn,"Burgoyne, Shaun",18,11,5,7,0,0,0,10
Hawthorn,"Ceglar, Jonathon",7,5,3,2,1,1,18,4
Hawthorn,"Duryea, Taylor",12,8,3,4,0,0,0,1
Hawthorn,"Frawley, James",14,7,7,7,0,0,0,1
Hawthorn,"Gibson, Josh",20,16,8,4,0,0,0,4
Hawthorn,"Gunston, Jack",10,8,4,2,2,0,0,2
Hawthorn,"Hartung, Billy",19,10,5,9,0,1,0,2
Hawthorn,"Langford, Will",14,6,2,8,0,0,2,8
Hawthorn,"Lewis, Jordan",19,8,4,11,0,0,4,2
Hawthorn,"Litherland, Angus",11,8,5,3,0,0,0,2
Hawthorn,"McEvoy, Ben",12,5,4,7,2,0,25,5
Hawthorn,"Mitchell, Sam",29,17,4,12,0,0,0,8
Hawthorn,"ORourke, Jonathan",13,8,3,5,0,0,0,3
Hawthorn,"Puopolo, Paul",13,3,2,10,0,0,0,5
Hawthorn,"Rioli, Cyril",11,9,3,2,3,2,0,6
Hawthorn,"Schoenmakers, Ryan",6,6,2,0,1,1,0,1
Hawthorn,"Shiels, Liam",18,10,4,8,0,2,0,4
Hawthorn,"Sicily, James",12,10,7,2,3,0,0,1
Hawthorn,"Smith, Isaac",24,17,9,7,0,0,1,1
Hawthorn,"Stratton, Ben",11,7,5,4,0,0,0,3
Hawthorn,"Birchall, Grant",25,9,1,16,0,0,1,2
Hawthorn,"Breust, Luke",16,10,2,6,2,3,1,3
Hawthorn,"Burgoyne, Shaun",16,5,3,11,0,0,0,3
Hawthorn,"Ceglar, Jonathon",11,3,3,8,2,0,23,3
Hawthorn,"Duryea, Taylor",18,13,5,5,0,0,0,1
Hawthorn,"Frawley, James",12,8,4,4,0,0,0,3
Hawthorn,"Gunston, Jack",19,13,11,6,0,1,0,5
Hawthorn,"Hartung, Billy",21,11,1,10,0,1,0,4
Hawthorn,"Hodge, Luke",23,14,6,9,0,1,1,2
Hawthorn,"Howe, Daniel",8,6,1,2,0,0,1,5
Hawthorn,"Langford, Will",19,5,2,14,0,0,1,3
Hawthorn,"Lewis, Jordan",27,9,4,18,1,0,4,6
Hawthorn,"Litherland, Angus",7,3,1,4,0,0,0,1
Hawthorn,"McEvoy, Ben",12,0,2,12,0,0,18,5
Hawthorn,"Mitchell, Sam",44,13,4,31,0,0,0,3
Hawthorn,"OBrien, Tim",11,7,2,4,2,0,0,5
Hawthorn,"Puopolo, Paul",12,7,1,5,2,0,0,7
Hawthorn,"Rioli, Cyril",9,6,5,3,1,0,0,5
Hawthorn,"Shiels, Liam",15,13,3,2,0,0,0,6
Hawthorn,"Sicily, James",10,8,5,2,2,1,0,1
Hawthorn,"Smith, Isaac",22,11,4,11,1,1,0,4
Hawthorn,"Stratton, Ben",13,7,5,6,0,0,0,1
Hawthorn,"Birchall, Grant",12,9,5,3,0,0,0,3
Hawthorn,"Breust, Luke",20,11,5,9,1,0,1,5
Hawthorn,"Burgoyne, Shaun",17,7,1,10,0,1,0,11
Hawthorn,"Ceglar, Jonathon",15,5,4,10,1,0,16,2
Hawthorn,"Duryea, Taylor",14,8,6,6,0,0,0,0
Hawthorn,"Frawley, James",14,9,6,5,0,0,0,3
Hawthorn,"Gibson, Josh",15,7,4,8,0,0,0,2
Hawthorn,"Gunston, Jack",8,5,2,3,1,2,0,3
Hawthorn,"Hartung, Billy",15,6,1,9,0,0,0,4
Hawthorn,"Hill, Bradley",17,9,2,8,0,0,0,2
Hawthorn,"Hodge, Luke",23,18,4,5,0,0,1,5
Hawthorn,"Langford, Will",19,10,0,9,0,0,0,2
Hawthorn,"Lewis, Jordan",20,9,0,11,0,0,3,2
Hawthorn,"McEvoy, Ben",10,4,3,6,1,1,24,4
Hawthorn,"Mitchell, Sam",31,19,2,12,0,0,0,4
Hawthorn,"OBrien, Tim",7,3,3,4,1,0,0,4
Hawthorn,"Puopolo, Paul",23,8,2,15,5,0,0,6
Hawthorn,"Rioli, Cyril",14,8,1,6,4,1,0,10
Hawthorn,"Shiels, Liam",19,10,0,9,0,1,0,12
Hawthorn,"Sicily, James",8,3,2,5,2,0,0,3
Hawthorn,"Smith, Isaac",20,10,6,10,1,2,0,9
Hawthorn,"Stratton, Ben",12,9,4,3,0,0,0,1
Hawthorn,"Birchall, Grant",20,10,7,10,0,0,0,2
Hawthorn,"Breust, Luke",13,8,3,5,3,2,0,1
Hawthorn,"Burgoyne, Shaun",18,9,2,9,0,0,0,3
Hawthorn,"Ceglar, Jonathon",14,4,6,10,0,1,22,3
Hawthorn,"Duryea, Taylor",14,11,2,3,0,0,0,2
Hawthorn,"Frawley, James",8,5,0,3,0,0,0,0
Hawthorn,"Gibson, Josh",19,9,4,10,0,0,0,1
Hawthorn,"Gunston, Jack",15,12,4,3,5,0,0,2
Hawthorn,"Hill, Bradley",14,8,1,6,0,0,0,0
Hawthorn,"Hodge, Luke",20,10,3,10,0,0,1,2
Hawthorn,"Howe, Daniel",14,7,5,7,1,0,0,3
Hawthorn,"Lewis, Jordan",15,6,1,9,0,1,4,4
Hawthorn,"Lovell, Kieran",11,6,1,5,0,0,0,1
Hawthorn,"McEvoy, Ben",16,5,5,11,0,0,24,1
Hawthorn,"Mitchell, Sam",26,11,1,15,0,1,1,0
Hawthorn,"OBrien, Tim",10,5,2,5,0,0,0,1
Hawthorn,"Puopolo, Paul",6,5,1,1,2,1,0,3
Hawthorn,"Rioli, Cyril",12,5,2,7,1,0,0,5
Hawthorn,"Shiels, Liam",18,6,1,12,0,0,0,5
Hawthorn,"Sicily, James",9,7,3,2,0,1,0,1
Hawthorn,"Smith, Isaac",11,6,4,5,0,2,0,0
Hawthorn,"Stratton, Ben",11,6,3,5,0,0,0,1
Hawthorn,"Birchall, Grant",23,12,6,11,0,0,0,1
Hawthorn,"Brand, Kaiden",14,9,4,5,0,0,0,2
Hawthorn,"Breust, Luke",14,12,4,2,6,0,0,4
Hawthorn,"Burgoyne, Shaun",19,10,2,9,0,0,0,2
Hawthorn,"Ceglar, Jonathon",15,9,5,6,1,0,20,2
Hawthorn,"Duryea, Taylor",17,11,3,6,0,0,0,3
Hawthorn,"Gibson, Josh",19,10,6,9,0,0,0,4
Hawthorn,"Gunston, Jack",15,11,9,4,4,1,0,4
Hawthorn,"Hartung, Billy",28,13,8,15,1,0,0,2
Hawthorn,"Hill, Bradley",15,12,3,3,1,0,0,3
Hawthorn,"Howe, Daniel",16,8,5,8,0,0,0,2
Hawthorn,"Langford, Will",14,8,1,6,0,1,3,5
Hawthorn,"Lewis, Jordan",28,18,5,10,1,0,0,7
Hawthorn,"Lovell, Kieran",18,10,3,8,0,0,0,0
Hawthorn,"McEvoy, Ben",13,3,5,10,0,0,19,1
Hawthorn,"OBrien, Tim",11,5,3,6,0,0,0,2
Hawthorn,"Puopolo, Paul",15,8,3,7,3,3,0,4
Hawthorn,"Rioli, Cyril",17,11,5,6,1,0,0,8
Hawthorn,"Shiels, Liam",16,11,1,5,1,0,1,16
Hawthorn,"Sicily, James",11,9,9,2,1,0,0,0
Hawthorn,"Smith, Isaac",25,17,5,8,1,1,2,1
Hawthorn,"Stratton, Ben",16,6,5,10,0,0,0,3
Hawthorn,"Birchall, Grant",18,9,2,9,1,0,0,4
Hawthorn,"Brand, Kaiden",12,6,1,6,0,0,0,2
Hawthorn,"Breust, Luke",12,6,2,6,3,1,1,4
Hawthorn,"Burgoyne, Shaun",16,7,4,9,0,1,0,2
Hawthorn,"Ceglar, Jonathon",5,4,1,1,0,1,26,5
Hawthorn,"Duryea, Taylor",20,14,8,6,0,0,0,2
Hawthorn,"Frawley, James",18,7,4,11,0,0,0,3
Hawthorn,"Gibson, Josh",21,8,8,13,1,0,0,6
Hawthorn,"Gunston, Jack",17,11,6,6,3,1,0,1
Hawthorn,"Hartung, Billy",20,13,4,7,0,0,0,2
Hawthorn,"Hill, Bradley",18,13,2,5,1,1,0,2
Hawthorn,"Howe, Daniel",19,11,2,8,0,0,0,5
Hawthorn,"Langford, Will",16,8,1,8,0,0,0,6
Hawthorn,"Lewis, Jordan",25,15,3,10,1,0,0,8
Hawthorn,"McEvoy, Ben",12,4,3,8,2,0,16,7
Hawthorn,"Mitchell, Sam",26,10,4,16,0,0,2,3
Hawthorn,"OBrien, Tim",9,6,4,3,2,1,0,3
Hawthorn,"Puopolo, Paul",15,3,0,12,1,0,0,4
Hawthorn,"Shiels, Liam",15,6,2,9,0,1,0,15
Hawthorn,"Sicily, James",17,13,10,4,1,3,0,0
Hawthorn,"Smith, Isaac",27,18,4,9,1,0,2,1
Hawthorn,"Stratton, Ben",19,11,4,8,0,0,0,3
Hawthorn,"Birchall, Grant",19,10,4,9,0,0,0,0
Hawthorn,"Brand, Kaiden",8,4,3,4,0,0,0,2
Hawthorn,"Breust, Luke",20,8,2,12,1,0,0,4
Hawthorn,"Burgoyne, Shaun",20,5,2,15,0,0,0,5
Hawthorn,"Ceglar, Jonathon",16,7,4,9,0,0,14,1
Hawthorn,"Duryea, Taylor",22,20,11,2,0,1,0,1
Hawthorn,"Frawley, James",17,7,5,10,0,0,0,3
Hawthorn,"Gibson, Josh",14,7,6,7,0,0,0,2
Hawthorn,"Gunston, Jack",18,15,11,3,4,2,0,1
Hawthorn,"Hartung, Billy",21,17,3,4,0,0,0,2
Hawthorn,"Hill, Bradley",16,12,4,4,0,0,0,2
Hawthorn,"Langford, Will",19,10,0,9,0,0,1,4
Hawthorn,"Lewis, Jordan",20,14,2,6,0,1,4,3
Hawthorn,"McEvoy, Ben",14,5,3,9,0,0,17,5
Hawthorn,"Mitchell, Sam",15,5,2,10,0,0,0,3
Hawthorn,"OBrien, Tim",10,2,3,8,0,2,0,1
Hawthorn,"Puopolo, Paul",17,10,5,7,1,2,0,1
Hawthorn,"Rioli, Cyril",11,6,4,5,1,0,0,2
Hawthorn,"Shiels, Liam",26,20,3,6,0,0,0,7
Hawthorn,"Sicily, James",10,8,4,2,0,2,0,3
Hawthorn,"Smith, Isaac",26,15,3,11,0,0,1,1
Hawthorn,"Stratton, Ben",9,5,6,4,0,0,0,1
Hawthorn,"Birchall, Grant",26,13,7,13,0,0,0,1
Hawthorn,"Breust, Luke",21,13,7,8,2,1,0,5
Hawthorn,"Burgoyne, Shaun",22,13,4,9,1,0,0,7
Hawthorn,"Ceglar, Jonathon",15,6,2,9,0,0,32,0
Hawthorn,"Duryea, Taylor",13,8,1,5,0,0,0,2
Hawthorn,"Frawley, James",15,11,6,4,0,0,0,0
Hawthorn,"Gibson, Josh",26,14,7,12,0,0,0,7
Hawthorn,"Gunston, Jack",24,11,7,13,2,1,0,2
Hawthorn,"Hartung, Billy",14,8,0,6,0,0,0,4
Hawthorn,"Hill, Bradley",17,10,2,7,2,2,0,4
Hawthorn,"Langford, Will",15,8,3,7,0,0,1,6
Hawthorn,"Lewis, Jordan",42,25,6,17,1,1,2,2
Hawthorn,"McEvoy, Ben",14,5,7,9,3,0,14,0
Hawthorn,"Mitchell, Sam",24,14,1,10,0,0,0,5
Hawthorn,"OBrien, Tim",7,5,3,2,1,0,0,0
Hawthorn,"Puopolo, Paul",15,7,2,8,2,0,0,2
Hawthorn,"Rioli, Cyril",19,13,1,6,5,1,0,8
Hawthorn,"Shiels, Liam",16,9,4,7,0,0,0,9
Hawthorn,"Sicily, James",10,5,4,5,1,0,0,3
Hawthorn,"Smith, Isaac",21,16,5,5,1,0,5,2
Hawthorn,"Spangher, Matthew",1,1,0,0,0,0,0,0
Hawthorn,"Stratton, Ben",17,10,5,7,0,0,0,3
Hawthorn,"Birchall, Grant",22,19,6,3,0,0,0,1
Hawthorn,"Breust, Luke",19,13,3,6,2,3,0,5
Hawthorn,"Burgoyne, Shaun",16,9,2,7,0,2,0,10
Hawthorn,"Ceglar, Jonathon",8,3,2,5,0,0,35,4
Hawthorn,"Duryea, Taylor",20,13,5,7,0,0,0,2
Hawthorn,"Frawley, James",16,12,7,4,0,0,0,0
Hawthorn,"Gibson, Josh",18,11,6,7,0,0,0,3
Hawthorn,"Gunston, Jack",15,10,3,5,3,1,0,5
Hawthorn,"Hartung, Billy",18,12,3,6,0,0,0,3
Hawthorn,"Hill, Bradley",15,11,1,4,1,1,0,5
Hawthorn,"Howe, Daniel",13,9,3,4,0,0,0,9
Hawthorn,"Lewis, Jordan",29,18,6,11,0,0,1,3
Hawthorn,"McEvoy, Ben",6,2,3,4,0,1,11,1
Hawthorn,"Mitchell, Sam",27,18,4,9,0,0,0,7
Hawthorn,"OBrien, Tim",10,6,3,4,2,1,0,3
Hawthorn,"Puopolo, Paul",19,11,0,8,1,1,0,10
Hawthorn,"Rioli, Cyril",11,10,4,1,1,0,0,11
Hawthorn,"Shiels, Liam",16,11,1,5,0,0,0,11
Hawthorn,"Sicily, James",8,6,3,2,0,1,0,2
Hawthorn,"Smith, Isaac",29,24,7,5,0,0,0,1
Hawthorn,"Stewart, Kade",16,8,2,8,1,1,0,9
Hawthorn,"Stratton, Ben",13,9,6,4,0,0,0,4
Hawthorn,"Birchall, Grant",30,18,10,12,0,0,0,1
Hawthorn,"Breust, Luke",14,10,4,4,4,1,0,7
Hawthorn,"Burgoyne, Shaun",17,11,3,6,1,1,0,5
Hawthorn,"Frawley, James",15,13,8,2,0,0,0,5
Hawthorn,"Gibson, Josh",25,17,12,8,0,0,0,0
Hawthorn,"Gunston, Jack",21,14,9,7,4,1,0,2
Hawthorn,"Hartung, Billy",21,15,10,6,0,0,0,0
Hawthorn,"Hill, Bradley",24,16,5,8,0,0,0,3
Hawthorn,"Howe, Daniel",26,16,4,10,0,1,0,4
Hawthorn,"Langford, Will",19,13,4,6,1,1,0,3
Hawthorn,"Lewis, Jordan",35,16,9,19,0,0,0,3
Hawthorn,"Litherland, Angus",16,6,5,10,0,0,0,1
Hawthorn,"McEvoy, Ben",10,3,2,7,0,0,14,0
Hawthorn,"OBrien, Tim",11,6,4,5,2,1,0,3
Hawthorn,"Pittonet, Marc",6,0,1,6,0,0,11,7
Hawthorn,"Puopolo, Paul",14,6,0,8,4,1,0,5
Hawthorn,"Rioli, Cyril",20,15,9,5,3,2,0,2
Hawthorn,"Shiels, Liam",25,13,7,12,1,1,0,6
Hawthorn,"Sicily, James",25,12,6,13,0,0,0,1
Hawthorn,"Smith, Isaac",23,14,8,9,1,1,0,1
Hawthorn,"Stewart, Kade",13,8,6,5,2,0,0,0
Hawthorn,"Stratton, Ben",13,9,7,4,0,0,0,0
Hawthorn,"Birchall, Grant",20,10,5,10,0,0,0,0
Hawthorn,"Breust, Luke",12,6,1,6,1,1,0,3
Hawthorn,"Burgoyne, Shaun",17,7,1,10,0,1,0,4
Hawthorn,"Ceglar, Jonathon",5,2,2,3,0,0,32,3
Hawthorn,"Duryea, Taylor",17,16,6,1,0,0,0,3
Hawthorn,"Frawley, James",4,4,3,0,0,0,0,1
Hawthorn,"Gibson, Josh",4,2,1,2,0,0,0,1
Hawthorn,"Gunston, Jack",6,2,2,4,0,1,1,7
Hawthorn,"Hartung, Billy",14,11,3,3,2,0,0,2
Hawthorn,"Hill, Bradley",7,7,4,0,0,0,0,2
Hawthorn,"Howe, Daniel",10,7,4,3,0,0,0,3
Hawthorn,"Lewis, Jordan",31,15,4,16,1,2,3,2
Hawthorn,"McEvoy, Ben",6,3,3,3,0,0,9,0
Hawthorn,"Mitchell, Sam",26,16,5,10,0,0,0,6
Hawthorn,"OBrien, Tim",10,7,2,3,1,1,0,2
Hawthorn,"Puopolo, Paul",13,7,2,6,1,0,0,4
Hawthorn,"Rioli, Cyril",15,12,2,3,2,1,0,6
Hawthorn,"Shiels, Liam",12,11,0,1,0,0,0,11
Hawthorn,"Sicily, James",13,9,5,4,5,0,0,1
Hawthorn,"Smith, Isaac",13,7,4,6,1,0,0,3
Hawthorn,"Stewart, Kade",7,6,1,1,0,0,0,3
Hawthorn,"Stratton, Ben",8,6,5,2,0,0,0,1
Hawthorn,"Birchall, Grant",28,21,12,7,0,0,0,1
Hawthorn,"Brand, Kaiden",13,11,7,2,0,0,0,0
Hawthorn,"Breust, Luke",20,12,5,8,1,1,0,2
Hawthorn,"Burgoyne, Shaun",17,8,6,9,1,0,0,4
Hawthorn,"Ceglar, Jonathon",13,6,4,7,1,2,19,2
Hawthorn,"Duryea, Taylor",14,10,8,4,1,1,0,1
Hawthorn,"Frawley, James",12,9,6,3,0,0,0,1
Hawthorn,"Gibson, Josh",25,14,15,11,0,0,0,2
Hawthorn,"Gunston, Jack",22,13,8,9,1,2,0,2
Hawthorn,"Hartung, Billy",19,12,5,7,2,1,0,1
Hawthorn,"Hill, Bradley",19,11,5,8,1,0,0,4
Hawthorn,"Hodge, Luke",28,22,9,6,0,0,0,2
Hawthorn,"Howe, Daniel",16,9,2,7,0,0,0,4
Hawthorn,"Lewis, Jordan",27,12,6,15,1,0,2,6
Hawthorn,"McEvoy, Ben",9,2,3,7,0,0,22,1
Hawthorn,"Mitchell, Sam",35,22,6,13,0,0,0,5
Hawthorn,"OBrien, Tim",10,5,4,5,0,0,0,1
Hawthorn,"Puopolo, Paul",10,4,2,6,0,1,0,2
Hawthorn,"Shiels, Liam",18,10,2,8,0,0,1,8
Hawthorn,"Sicily, James",13,10,5,3,3,1,0,4
Hawthorn,"Smith, Isaac",23,15,7,8,0,1,1,2
Hawthorn,"Stratton, Ben",18,12,8,6,0,0,0,2
Hawthorn,"Birchall, Grant",19,12,6,7,0,0,0,0
Hawthorn,"Brand, Kaiden",18,13,10,5,0,0,0,0
Hawthorn,"Breust, Luke",15,8,4,7,2,1,0,6
Hawthorn,"Burgoyne, Shaun",17,10,0,7,1,0,0,10
Hawthorn,"Ceglar, Jonathon",13,6,2,7,2,0,24,2
Hawthorn,"Duryea, Taylor",20,17,7,3,0,0,0,1
Hawthorn,"Frawley, James",16,12,7,4,0,0,0,1
Hawthorn,"Gibson, Josh",16,8,8,8,0,0,0,2
Hawthorn,"Gunston, Jack",14,9,3,5,3,1,0,2
Hawthorn,"Hartung, Billy",14,7,4,7,0,0,0,1
Hawthorn,"Hill, Bradley",9,6,2,3,1,1,0,1
Hawthorn,"Hodge, Luke",29,22,10,7,0,0,0,2
Hawthorn,"Howe, Daniel",17,14,7,3,0,1,0,5
Hawthorn,"Lewis, Jordan",25,16,9,9,0,0,1,2
Hawthorn,"McEvoy, Ben",14,6,4,8,0,1,29,1
Hawthorn,"Mitchell, Sam",28,18,3,10,0,0,0,1
Hawthorn,"Puopolo, Paul",14,10,1,4,2,0,0,7
Hawthorn,"Rioli, Cyril",18,15,5,3,3,2,1,4
Hawthorn,"Shiels, Liam",12,6,2,6,0,0,0,2
Hawthorn,"Sicily, James",6,6,3,0,1,0,0,3
Hawthorn,"Smith, Isaac",22,13,6,9,0,1,0,0
Hawthorn,"Stratton, Ben",9,7,4,2,0,0,0,1
Hawthorn,"Birchall, Grant",25,13,6,12,0,0,0,0
Hawthorn,"Brand, Kaiden",11,4,3,7,0,0,0,1
Hawthorn,"Breust, Luke",11,6,2,5,0,1,1,6
Hawthorn,"Burgoyne, Shaun",26,15,3,11,2,1,0,11
Hawthorn,"Ceglar, Jonathon",10,5,3,5,1,0,28,5
Hawthorn,"Duryea, Taylor",15,11,6,4,0,0,0,1
Hawthorn,"Frawley, James",7,5,2,2,0,0,0,2
Hawthorn,"Gibson, Josh",24,12,8,12,0,0,0,0
Hawthorn,"Gunston, Jack",20,15,8,5,2,2,0,6
Hawthorn,"Hill, Bradley",25,12,7,13,1,1,0,3
Hawthorn,"Hodge, Luke",18,11,6,7,0,0,2,4
Hawthorn,"Lewis, Jordan",26,14,5,12,1,1,4,4
Hawthorn,"Litherland, Angus",3,2,1,1,0,0,0,3
Hawthorn,"McEvoy, Ben",7,2,0,5,0,0,9,2
Hawthorn,"Mitchell, Sam",37,25,4,12,0,0,0,3
Hawthorn,"ORourke, Jonathan",12,6,2,6,1,0,0,3
Hawthorn,"Puopolo, Paul",18,10,3,8,1,0,0,8
Hawthorn,"Rioli, Cyril",17,9,4,8,2,0,0,7
Hawthorn,"Sicily, James",9,7,2,2,0,1,0,1
Hawthorn,"Smith, Isaac",21,13,5,8,0,0,1,5
Hawthorn,"Stratton, Ben",11,6,3,5,0,0,0,4
Hawthorn,"Whitecross, Brendan",15,6,6,9,0,1,0,2
Hawthorn,"Birchall, Grant",27,22,10,5,0,1,0,1
Hawthorn,"Brand, Kaiden",18,12,5,6,0,0,0,0
Hawthorn,"Breust, Luke",23,8,5,15,2,2,0,3
Hawthorn,"Burgoyne, Shaun",21,7,2,14,0,0,0,6
Hawthorn,"Ceglar, Jonathon",17,11,7,6,0,2,22,3
Hawthorn,"Duryea, Taylor",20,10,5,10,0,0,0,3
Hawthorn,"Frawley, James",17,10,9,7,0,0,0,1
Hawthorn,"Gibson, Josh",31,15,12,16,1,0,0,3
Hawthorn,"Gunston, Jack",22,18,10,4,3,3,0,2
Hawthorn,"Hill, Bradley",31,18,5,13,0,2,0,5
Hawthorn,"Hodge, Luke",15,12,2,3,0,0,0,1
Hawthorn,"Lewis, Jordan",33,16,5,17,0,0,0,4
Hawthorn,"McEvoy, Ben",11,6,7,5,1,1,11,2
Hawthorn,"Mitchell, Sam",38,18,9,20,0,1,0,0
Hawthorn,"OBrien, Tim",5,3,1,2,0,0,0,3
Hawthorn,"ORourke, Jonathan",18,8,3,10,1,1,0,5
Hawthorn,"Puopolo, Paul",14,10,2,4,1,1,0,1
Hawthorn,"Rioli, Cyril",11,7,2,4,3,0,0,5
Hawthorn,"Sicily, James",12,7,4,5,3,1,0,1
Hawthorn,"Smith, Isaac",20,10,7,10,0,1,0,4
Hawthorn,"Stratton, Ben",11,6,4,5,0,0,0,2
Hawthorn,"Whitecross, Brendan",18,8,9,10,1,0,0,3
Hawthorn,"Birchall, Grant",25,14,4,11,0,0,0,2
Hawthorn,"Brand, Kaiden",11,4,1,7,0,0,0,0
Hawthorn,"Breust, Luke",16,7,7,9,2,1,0,1
Hawthorn,"Burgoyne, Shaun",25,16,8,9,1,0,0,5
Hawthorn,"Ceglar, Jonathon",9,7,2,2,2,0,13,2
Hawthorn,"Duryea, Taylor",12,11,4,1,1,1,0,0
Hawthorn,"Frawley, James",18,12,5,6,0,0,0,3
Hawthorn,"Gibson, Josh",14,6,5,8,0,0,0,2
Hawthorn,"Gunston, Jack",17,14,6,3,1,4,0,2
Hawthorn,"Hardwick, Blake",8,5,1,3,0,1,0,3
Hawthorn,"Hill, Bradley",20,8,1,12,0,0,0,2
Hawthorn,"Hodge, Luke",18,12,2,6,1,0,1,3
Hawthorn,"Langford, Will",16,10,6,6,0,1,1,2
Hawthorn,"Lewis, Jordan",27,12,9,15,1,0,1,1
Hawthorn,"McEvoy, Ben",7,5,5,2,1,1,16,2
Hawthorn,"Mitchell, Sam",22,10,2,12,0,0,0,2
Hawthorn,"OBrien, Tim",7,5,3,2,0,1,0,2
Hawthorn,"ORourke, Jonathan",12,6,3,6,0,0,0,1
Hawthorn,"Sicily, James",13,9,7,4,0,0,0,2
Hawthorn,"Smith, Isaac",22,15,5,7,0,0,1,2
Hawthorn,"Stratton, Ben",15,6,4,9,0,1,0,2
Hawthorn,"Whitecross, Brendan",19,5,7,14,0,0,0,1
Hawthorn,"Birchall, Grant",19,12,4,7,0,0,0,1
Hawthorn,"Brand, Kaiden",12,7,1,5,0,0,0,3
Hawthorn,"Breust, Luke",13,7,1,6,0,0,0,3
Hawthorn,"Burgoyne, Shaun",19,13,4,6,0,1,0,6
Hawthorn,"Ceglar, Jonathon",6,4,2,2,2,0,18,1
Hawthorn,"Duryea, Taylor",11,6,1,5,0,0,0,3
Hawthorn,"Gibson, Josh",16,5,4,11,0,0,0,3
Hawthorn,"Gunston, Jack",16,12,6,4,2,4,0,3
Hawthorn,"Heatherley, Kurt",11,6,6,5,0,0,0,2
Hawthorn,"Hill, Bradley",13,9,4,4,0,2,0,5
Hawthorn,"Hodge, Luke",27,13,5,14,0,1,0,3
Hawthorn,"Langford, Will",12,5,2,7,0,0,1,4
Hawthorn,"Lewis, Jordan",24,10,5,14,0,1,4,5
Hawthorn,"McEvoy, Ben",6,4,2,2,0,0,15,4
Hawthorn,"Mitchell, Sam",27,8,1,19,0,0,0,3
Hawthorn,"OBrien, Tim",5,4,2,1,1,1,0,1
Hawthorn,"ORourke, Jonathan",14,7,3,7,0,0,0,4
Hawthorn,"Rioli, Cyril",15,9,5,6,4,1,0,12
Hawthorn,"Sicily, James",12,7,3,5,0,1,0,2
Hawthorn,"Smith, Isaac",26,18,4,8,2,0,0,1
Hawthorn,"Stratton, Ben",4,3,3,1,0,0,0,1
Hawthorn,"Whitecross, Brendan",16,11,7,5,0,0,0,4
Hawthorn,"Birchall, Grant",24,16,6,8,1,0,0,0
Hawthorn,"Brand, Kaiden",13,6,5,7,0,0,0,2
Hawthorn,"Breust, Luke",14,7,2,7,2,0,0,10
Hawthorn,"Burgoyne, Shaun",25,14,6,11,0,0,0,1
Hawthorn,"Burton, Ryan",10,6,5,4,1,2,0,3
Hawthorn,"Ceglar, Jonathon",6,2,1,4,1,0,15,3
Hawthorn,"Duryea, Taylor",16,9,9,7,0,0,0,3
Hawthorn,"Frawley, James",9,5,3,4,0,0,0,3
Hawthorn,"Gibson, Josh",22,14,9,8,0,0,0,3
Hawthorn,"Gunston, Jack",11,7,5,4,1,1,0,1
Hawthorn,"Hartung, Billy",19,9,3,10,0,0,0,2
Hawthorn,"Hill, Bradley",28,21,3,7,1,2,0,1
Hawthorn,"Hodge, Luke",27,18,8,9,0,0,0,4
Hawthorn,"Langford, Will",18,9,4,9,1,0,0,3
Hawthorn,"Lewis, Jordan",27,15,10,12,1,0,3,5
Hawthorn,"McEvoy, Ben",10,3,4,7,0,0,21,3
Hawthorn,"Mitchell, Sam",37,23,8,14,0,0,0,1
Hawthorn,"Puopolo, Paul",14,6,4,8,2,0,0,7
Hawthorn,"Rioli, Cyril",13,10,4,3,3,0,0,2
Hawthorn,"Shiels, Liam",21,14,2,7,0,1,0,6
Hawthorn,"Smith, Isaac",33,21,11,12,0,1,1,7
Hawthorn,"Whitecross, Brendan",23,7,4,16,0,0,0,2
Hawthorn,"Birchall, Grant",25,15,4,10,0,0,0,0
Hawthorn,"Brand, Kaiden",12,10,7,2,0,0,0,2
Hawthorn,"Breust, Luke",16,9,3,7,1,1,0,5
Hawthorn,"Burgoyne, Shaun",25,17,3,8,2,2,0,8
Hawthorn,"Burton, Ryan",10,8,3,2,0,0,0,2
Hawthorn,"Ceglar, Jonathon",4,2,2,2,0,0,14,2
Hawthorn,"Duryea, Taylor",13,9,7,4,0,0,0,2
Hawthorn,"Frawley, James",15,7,5,8,0,0,0,0
Hawthorn,"Gibson, Josh",13,5,3,8,0,0,0,2
Hawthorn,"Gunston, Jack",13,10,8,3,2,0,0,3
Hawthorn,"Hartung, Billy",23,15,6,8,0,0,0,2
Hawthorn,"Hill, Bradley",14,9,3,5,0,0,0,4
Hawthorn,"Hodge, Luke",28,21,7,7,0,0,0,1
Hawthorn,"Lewis, Jordan",27,12,7,15,1,0,5,2
Hawthorn,"McEvoy, Ben",7,3,2,4,0,0,15,3
Hawthorn,"Mitchell, Sam",22,10,3,12,0,0,0,2
Hawthorn,"Puopolo, Paul",10,5,3,5,1,0,0,5
Hawthorn,"Rioli, Cyril",13,7,1,6,0,0,0,8
Hawthorn,"Shiels, Liam",13,7,1,6,0,0,0,7
Hawthorn,"Sicily, James",10,7,2,3,2,1,0,2
Hawthorn,"Smith, Isaac",21,15,7,6,0,1,0,2
Hawthorn,"Whitecross, Brendan",16,10,6,6,1,0,0,3
Hawthorn,"Birchall, Grant",22,11,6,11,0,1,0,0
Hawthorn,"Breust, Luke",16,11,6,5,3,1,0,2
Hawthorn,"Burgoyne, Shaun",19,11,9,8,2,0,0,7
Hawthorn,"Burton, Ryan",15,11,5,4,0,0,0,1
Hawthorn,"Duryea, Taylor",22,15,8,7,0,1,0,2
Hawthorn,"Fitzpatrick, Jack",9,9,4,0,2,1,13,0
Hawthorn,"Frawley, James",15,11,7,4,0,0,0,3
Hawthorn,"Gibson, Josh",16,7,4,9,0,0,0,1
Hawthorn,"Gunston, Jack",11,7,4,4,1,0,4,1
Hawthorn,"Hartung, Billy",11,5,4,6,2,0,0,0
Hawthorn,"Hill, Bradley",14,9,4,5,0,1,0,3
Hawthorn,"Hodge, Luke",20,17,6,3,1,1,3,4
Hawthorn,"Lewis, Jordan",22,13,9,9,1,0,0,4
Hawthorn,"Mitchell, Sam",31,16,2,15,0,0,0,3
Hawthorn,"Pittonet, Marc",8,2,1,6,0,0,15,2
Hawthorn,"Puopolo, Paul",18,8,5,10,1,2,0,2
Hawthorn,"Rioli, Cyril",11,9,5,2,3,1,0,7
Hawthorn,"Schoenmakers, Ryan",7,5,4,2,0,0,3,0
Hawthorn,"Shiels, Liam",18,10,2,8,0,0,0,5
Hawthorn,"Sicily, James",13,10,3,3,1,0,1,1
Hawthorn,"Smith, Isaac",20,7,3,13,0,0,1,4
Hawthorn,"Whitecross, Brendan",15,8,6,7,0,0,0,2
Hawthorn,"Birchall, Grant",28,18,12,10,0,0,0,0
Hawthorn,"Breust, Luke",16,11,4,5,3,1,0,3
Hawthorn,"Burgoyne, Shaun",21,15,8,6,2,1,0,4
Hawthorn,"Burton, Ryan",6,5,2,1,0,0,0,1
Hawthorn,"Duryea, Taylor",21,11,9,10,0,0,0,1
Hawthorn,"Fitzpatrick, Jack",11,8,1,3,0,2,8,3
Hawthorn,"Frawley, James",17,10,6,7,0,0,0,1
Hawthorn,"Gibson, Josh",17,6,3,11,0,0,0,5
Hawthorn,"Gunston, Jack",20,11,6,9,2,1,0,3
Hawthorn,"Hill, Bradley",17,10,0,7,1,0,0,3
Hawthorn,"Hodge, Luke",29,16,5,13,0,0,2,4
Hawthorn,"Howe, Daniel",7,4,5,3,0,0,0,5
Hawthorn,"Lewis, Jordan",36,26,11,10,0,0,0,5
Hawthorn,"McEvoy, Ben",8,4,4,4,0,0,30,3
Hawthorn,"Mitchell, Sam",30,16,2,14,0,1,0,4
Hawthorn,"Puopolo, Paul",10,5,2,5,0,0,0,1
Hawthorn,"Rioli, Cyril",9,6,4,3,2,1,0,3
Hawthorn,"Schoenmakers, Ryan",16,10,5,6,2,0,0,0
Hawthorn,"Shiels, Liam",17,12,4,5,0,1,0,11
Hawthorn,"Smith, Isaac",23,17,9,6,0,1,0,2
Hawthorn,"Stratton, Ben",10,7,3,3,0,0,0,2
Hawthorn,"Whitecross, Brendan",22,12,8,10,0,0,0,1
Hawthorn,"Birchall, Grant",18,11,4,7,0,0,0,3
Hawthorn,"Breust, Luke",10,7,4,3,1,2,0,2
Hawthorn,"Burgoyne, Shaun",22,13,5,9,1,0,0,3
Hawthorn,"Duryea, Taylor",13,9,5,4,0,0,0,4
Hawthorn,"Fitzpatrick, Jack",14,6,3,8,1,0,8,5
Hawthorn,"Frawley, James",9,5,3,4,0,0,0,6
Hawthorn,"Gibson, Josh",20,7,4,13,0,0,0,4
Hawthorn,"Gunston, Jack",15,7,6,8,1,1,0,3
Hawthorn,"Hartung, Billy",17,8,3,9,0,0,0,3
Hawthorn,"Hill, Bradley",15,9,3,6,1,0,0,3
Hawthorn,"Hodge, Luke",20,12,8,8,2,0,2,6
Hawthorn,"Lewis, Jordan",10,3,2,7,0,0,3,6
Hawthorn,"McEvoy, Ben",11,6,3,5,0,0,38,5
Hawthorn,"Mitchell, Sam",24,13,0,11,0,0,0,5
Hawthorn,"Puopolo, Paul",17,9,3,8,1,2,0,10
Hawthorn,"Rioli, Cyril",13,9,5,4,1,1,0,5
Hawthorn,"Schoenmakers, Ryan",5,3,0,2,0,0,0,2
Hawthorn,"Shiels, Liam",20,12,2,8,2,1,0,12
Hawthorn,"Sicily, James",11,6,6,5,1,2,0,6
Hawthorn,"Smith, Isaac",21,15,3,6,0,2,1,6
Hawthorn,"Stratton, Ben",10,2,4,8,0,0,0,5
Hawthorn,"Whitecross, Brendan",12,6,5,6,0,0,0,1
Melbourne,"Bugg, Tomas",13,5,0,8,0,0,0,3
Melbourne,"Frost, Sam",7,4,4,3,0,1,0,0
Melbourne,"Garland, Colin",11,8,8,3,0,0,0,3
Melbourne,"Garlett, Jeff",12,9,3,3,2,0,0,5
Melbourne,"Gawn, Max",14,6,4,8,0,1,26,2
Melbourne,"Harmes, James",8,4,2,4,1,0,0,1
Melbourne,"Hogan, Jesse",17,14,6,3,3,0,0,3
Melbourne,"Jetta, Neville",15,7,4,8,0,0,0,5
Melbourne,"Jones, Matt",21,7,6,14,0,0,0,3
Melbourne,"Jones, Nathan",27,14,3,13,0,1,0,4
Melbourne,"Kennedy, Ben",21,12,4,9,1,1,0,1
Melbourne,"Kent, Dean",13,11,5,2,1,0,0,3
Melbourne,"McDonald, Oscar",11,3,3,8,0,0,0,0
Melbourne,"McDonald, Tom",22,17,8,5,0,0,0,0
Melbourne,"Oliver, Clayton",22,5,2,17,0,0,0,2
Melbourne,"Pedersen, Cameron",12,8,4,4,0,0,1,4
Melbourne,"Salem, Christian",15,13,5,2,0,0,0,2
Melbourne,"Tyson, Dom",17,8,5,9,0,0,0,2
Melbourne,"Vandenberg, Aaron",17,8,3,9,2,0,0,1
Melbourne,"Vince, Bernie",21,17,3,4,1,0,0,3
Melbourne,"Viney, Jack",32,14,5,18,0,0,0,6
Melbourne,"Watts, Jack",18,14,10,4,1,1,0,1
Melbourne,"Brayshaw, Angus",9,7,1,2,1,1,0,1
Melbourne,"Bugg, Tomas",16,9,4,7,0,0,0,4
Melbourne,"Garland, Colin",7,4,1,3,0,0,0,3
Melbourne,"Garlett, Jeff",6,6,2,0,2,1,0,3
Melbourne,"Gawn, Max",10,3,3,7,0,0,31,0
Melbourne,"Harmes, James",15,8,1,7,1,0,0,3
Melbourne,"Hogan, Jesse",8,5,4,3,1,1,0,1
Melbourne,"Jetta, Neville",12,5,2,7,0,0,0,3
Melbourne,"Jones, Matt",19,13,5,6,0,0,0,3
Melbourne,"Jones, Nathan",29,17,6,12,0,0,0,3
Melbourne,"Kennedy, Ben",21,13,1,8,3,0,0,3
Melbourne,"Kent, Dean",5,2,1,3,0,0,0,1
Melbourne,"Lumumba, Heritier",18,8,2,10,0,0,1,0
Melbourne,"McDonald, Tom",12,8,6,4,0,0,0,1
Melbourne,"Oliver, Clayton",14,4,2,10,1,0,0,2
Melbourne,"Pedersen, Cameron",10,7,5,3,0,0,7,2
Melbourne,"Salem, Christian",13,7,3,6,0,0,0,3
Melbourne,"Tyson, Dom",23,12,5,11,0,3,0,4
Melbourne,"Vandenberg, Aaron",15,5,2,10,0,0,0,1
Melbourne,"Vince, Bernie",28,20,7,8,0,0,2,4
Melbourne,"Viney, Jack",17,7,1,10,0,0,0,5
Melbourne,"Watts, Jack",9,4,4,5,1,0,0,0
Melbourne,"Bugg, Tomas",17,7,0,10,0,0,0,5
Melbourne,"Dunn, Lynden",13,10,1,3,1,0,0,3
Melbourne,"Frost, Sam",6,3,2,3,0,0,1,1
Melbourne,"Gawn, Max",18,7,5,11,2,1,63,0
Melbourne,"Harmes, James",14,9,1,5,1,0,0,10
Melbourne,"Hogan, Jesse",19,10,7,9,3,2,0,2
Melbourne,"Jetta, Neville",16,9,5,7,0,0,0,6
Melbourne,"Jones, Matt",22,11,4,11,0,0,0,4
Melbourne,"Jones, Nathan",18,8,0,10,1,1,0,5
Melbourne,"Kennedy, Ben",15,8,2,7,0,1,0,3
Melbourne,"Kent, Dean",14,10,2,4,4,2,0,2
Melbourne,"Lumumba, Heritier",17,9,3,8,0,0,0,1
Melbourne,"McDonald, Tom",10,4,3,6,0,0,0,2
Melbourne,"Oliver, Clayton",26,7,1,19,2,0,0,4
Melbourne,"Salem, Christian",17,12,2,5,0,0,0,1
Melbourne,"Stretch, Billy",15,9,1,6,0,0,0,3
Melbourne,"Tyson, Dom",20,4,1,16,1,0,1,1
Melbourne,"Vandenberg, Aaron",8,4,2,4,1,1,0,4
Melbourne,"Vince, Bernie",32,22,2,10,0,0,0,3
Melbourne,"Viney, Jack",28,16,1,12,1,0,0,2
Melbourne,"Wagner, Josh",8,3,0,5,0,0,0,4
Melbourne,"Watts, Jack",13,8,4,5,3,0,0,1
Melbourne,"Brayshaw, Angus",15,7,3,8,1,0,0,2
Melbourne,"Bugg, Tomas",29,12,5,17,0,0,0,9
Melbourne,"Dunn, Lynden",13,12,4,1,0,0,0,2
Melbourne,"Frost, Sam",19,8,5,11,1,2,0,4
Melbourne,"Gawn, Max",15,7,6,8,1,0,37,5
Melbourne,"Harmes, James",18,8,2,10,0,0,0,6
Melbourne,"Hogan, Jesse",18,12,9,6,2,2,0,0
Melbourne,"Hunt, Jayden",13,7,5,6,0,0,0,2
Melbourne,"Jetta, Neville",19,8,2,11,0,0,0,7
Melbourne,"Jones, Matt",18,8,2,10,0,0,0,2
Melbourne,"Jones, Nathan",29,9,2,20,0,1,0,4
Melbourne,"Kennedy, Ben",22,9,4,13,1,0,0,1
Melbourne,"Kent, Dean",21,12,4,9,1,0,0,6
Melbourne,"Lumumba, Heritier",20,9,7,11,0,0,0,0
Melbourne,"McDonald, Tom",17,11,8,6,0,0,0,0
Melbourne,"Oliver, Clayton",11,3,2,8,0,0,0,8
Melbourne,"Pedersen, Cameron",20,11,5,9,2,0,3,3
Melbourne,"Salem, Christian",20,12,1,8,0,0,0,5
Melbourne,"Tyson, Dom",24,8,5,16,2,0,0,6
Melbourne,"Viney, Jack",31,10,3,21,1,0,0,6
Melbourne,"Wagner, Josh",24,13,6,11,0,0,0,5
Melbourne,"Watts, Jack",17,14,8,3,4,1,0,1
Melbourne,"Brayshaw, Angus",9,3,0,6,1,0,0,5
Melbourne,"Bugg, Tomas",15,8,3,7,1,0,0,8
Melbourne,"Dunn, Lynden",18,11,6,7,0,0,1,2
Melbourne,"Frost, Sam",10,6,4,4,1,1,0,2
Melbourne,"Garlett, Jeff",17,10,2,7,4,1,0,3
Melbourne,"Gawn, Max",18,12,7,6,2,0,47,4
Melbourne,"Harmes, James",11,6,0,5,1,0,0,4
Melbourne,"Hogan, Jesse",16,13,10,3,0,2,0,0
Melbourne,"Hunt, Jayden",14,8,3,6,0,0,0,1
Melbourne,"Jetta, Neville",15,9,5,6,0,0,0,3
Melbourne,"Jones, Nathan",26,9,1,17,0,0,0,2
Melbourne,"Kennedy, Ben",14,4,3,10,0,0,0,2
Melbourne,"Kent, Dean",25,15,5,10,1,1,0,4
Melbourne,"Lumumba, Heritier",17,11,7,6,0,0,0,3
Melbourne,"McDonald, Tom",23,15,8,8,0,0,0,2
Melbourne,"Pedersen, Cameron",13,7,3,6,0,1,4,1
Melbourne,"Salem, Christian",23,14,2,9,1,0,0,4
Melbourne,"Tyson, Dom",31,13,4,18,2,0,0,4
Melbourne,"Vince, Bernie",24,16,3,8,3,1,0,3
Melbourne,"Viney, Jack",37,14,3,23,0,0,0,9
Melbourne,"Wagner, Josh",19,11,4,8,0,0,0,5
Melbourne,"Watts, Jack",17,7,4,10,3,0,0,3
Melbourne,"Bugg, Tomas",21,9,1,12,1,0,0,1
Melbourne,"Dunn, Lynden",11,9,4,2,0,0,0,3
Melbourne,"Frost, Sam",5,3,1,2,2,0,2,2
Melbourne,"Garlett, Jeff",10,7,3,3,0,1,0,2
Melbourne,"Gawn, Max",13,3,3,10,0,0,38,3
Melbourne,"Harmes, James",16,7,2,9,0,1,0,1
Melbourne,"Hogan, Jesse",16,11,8,5,7,1,0,2
Melbourne,"Hunt, Jayden",10,2,2,8,0,0,0,1
Melbourne,"Jetta, Neville",11,3,2,8,0,0,0,2
Melbourne,"Jones, Nathan",31,14,0,17,1,0,0,1
Melbourne,"Kennedy, Ben",18,12,4,6,0,0,0,2
Melbourne,"Kent, Dean",10,3,1,7,1,0,0,3
Melbourne,"Lumumba, Heritier",14,4,2,10,0,0,0,4
Melbourne,"McDonald, Tom",14,9,7,5,0,0,0,1
Melbourne,"Pedersen, Cameron",19,4,2,15,0,0,5,2
Melbourne,"Petracca, Christian",16,8,1,8,0,0,0,5
Melbourne,"Salem, Christian",15,8,1,7,0,0,0,1
Melbourne,"Tyson, Dom",21,8,4,13,1,0,0,4
Melbourne,"Vince, Bernie",22,15,5,7,0,0,0,6
Melbourne,"Viney, Jack",30,16,6,14,0,0,0,7
Melbourne,"Wagner, Josh",17,6,1,11,0,0,0,4
Melbourne,"Watts, Jack",13,6,4,7,2,1,0,2
Melbourne,"Bugg, Tomas",25,14,3,11,0,1,0,7
Melbourne,"Garland, Colin",15,6,0,9,0,0,0,3
Melbourne,"Garlett, Jeff",12,9,2,3,3,1,0,4
Melbourne,"Gawn, Max",17,11,4,6,2,3,46,5
Melbourne,"Harmes, James",26,11,1,15,3,0,0,5
Melbourne,"Hogan, Jesse",9,8,5,1,1,3,0,4
Melbourne,"Hunt, Jayden",19,10,6,9,0,0,0,4
Melbourne,"Jetta, Neville",17,6,6,11,0,0,0,1
Melbourne,"Jones, Nathan",33,20,2,13,2,1,0,6
Melbourne,"Kennedy, Ben",16,10,2,6,2,0,0,9
Melbourne,"Kent, Dean",14,5,3,9,1,1,0,2
Melbourne,"McDonald, Tom",10,3,1,7,0,0,0,1
Melbourne,"Michie, Viv",13,5,1,8,0,0,0,1
Melbourne,"Oliver, Clayton",23,4,3,19,0,0,0,6
Melbourne,"Pedersen, Cameron",14,7,5,7,3,2,4,3
Melbourne,"Petracca, Christian",24,5,2,19,2,1,0,4
Melbourne,"Stretch, Billy",16,9,2,7,1,0,0,3
Melbourne,"Tyson, Dom",21,10,4,11,1,0,2,3
Melbourne,"Vince, Bernie",28,18,1,10,1,0,0,1
Melbourne,"Viney, Jack",24,8,3,16,2,0,0,7
Melbourne,"Wagner, Josh",25,12,4,13,0,0,0,5
Melbourne,"Watts, Jack",11,9,3,2,0,1,0,3
Melbourne,"Bugg, Tomas",13,8,1,5,0,0,0,9
Melbourne,"Garland, Colin",9,6,3,3,0,0,0,5
Melbourne,"Garlett, Jeff",9,5,1,4,2,1,0,3
Melbourne,"Gawn, Max",6,3,2,3,0,1,42,1
Melbourne,"Harmes, James",15,6,2,9,0,0,0,5
Melbourne,"Hogan, Jesse",17,10,9,7,1,3,0,0
Melbourne,"Hunt, Jayden",9,5,1,4,0,0,0,3
Melbourne,"Jetta, Neville",18,8,4,10,0,0,0,3
Melbourne,"Jones, Nathan",21,9,2,12,0,0,0,8
Melbourne,"Kennedy, Ben",18,8,5,10,2,1,0,4
Melbourne,"McDonald, Tom",25,13,11,12,1,0,1,2
Melbourne,"Michie, Viv",13,6,6,7,0,0,0,0
Melbourne,"Oliver, Clayton",15,3,2,12,1,0,0,5
Melbourne,"Pedersen, Cameron",15,6,6,9,0,2,6,1
Melbourne,"Petracca, Christian",20,10,4,10,1,0,0,2
Melbourne,"Salem, Christian",16,11,2,5,0,0,0,6
Melbourne,"Stretch, Billy",25,10,6,15,0,0,0,2
Melbourne,"Tyson, Dom",32,8,3,24,0,0,1,4
Melbourne,"Vince, Bernie",24,18,5,6,0,0,0,7
Melbourne,"Viney, Jack",25,10,4,15,1,0,0,16
Melbourne,"Wagner, Josh",14,11,3,3,0,0,0,1
Melbourne,"Watts, Jack",14,12,11,2,3,0,0,0
Melbourne,"Bugg, Tomas",31,8,4,23,0,0,0,6
Melbourne,"Garland, Colin",14,7,4,7,0,0,0,3
Melbourne,"Garlett, Jeff",12,10,3,2,2,2,0,1
Melbourne,"Gawn, Max",7,2,1,5,0,0,29,1
Melbourne,"Harmes, James",21,12,3,9,4,2,0,4
Melbourne,"Hogan, Jesse",20,13,7,7,5,1,0,0
Melbourne,"Hunt, Jayden",12,7,1,5,0,0,0,1
Melbourne,"Jones, Nathan",27,10,2,17,1,0,0,4
Melbourne,"Kennedy, Ben",17,9,2,8,1,1,0,3
Melbourne,"Kent, Dean",14,9,3,5,1,1,0,1
Melbourne,"McDonald, Oscar",18,6,2,12,0,0,0,0
Melbourne,"McDonald, Tom",18,8,5,10,0,0,0,1
Melbourne,"Michie, Viv",13,6,3,7,1,0,0,2
Melbourne,"Neal-Bullen, Alex",18,4,2,14,0,0,0,3
Melbourne,"Newton, Ben",20,8,4,12,1,0,0,3
Melbourne,"Oliver, Clayton",21,12,3,9,0,2,1,5
Melbourne,"Petracca, Christian",21,10,6,11,0,4,3,7
Melbourne,"Stretch, Billy",31,11,5,20,1,0,0,3
Melbourne,"Vince, Bernie",24,16,5,8,0,0,1,2
Melbourne,"Viney, Jack",19,7,1,12,1,0,0,8
Melbourne,"Wagner, Josh",17,6,4,11,0,0,0,5
Melbourne,"Watts, Jack",19,15,10,4,1,1,8,3
Melbourne,"Bugg, Tomas",21,12,2,9,0,0,0,1
Melbourne,"Garland, Colin",11,5,3,6,0,0,0,2
Melbourne,"Garlett, Jeff",9,6,2,3,1,1,0,4
Melbourne,"Gawn, Max",18,5,8,13,2,0,48,4
Melbourne,"Harmes, James",14,7,5,7,0,0,1,2
Melbourne,"Hogan, Jesse",16,13,11,3,3,4,0,1
Melbourne,"Hunt, Jayden",16,8,5,8,0,0,0,1
Melbourne,"Jetta, Neville",18,8,2,10,0,0,0,3
Melbourne,"Jones, Nathan",28,19,5,9,0,1,0,3
Melbourne,"Kennedy, Ben",7,5,2,2,0,0,0,1
Melbourne,"Kent, Dean",14,12,6,2,1,1,0,3
Melbourne,"McDonald, Oscar",15,4,4,11,0,0,0,2
Melbourne,"McDonald, Tom",21,16,8,5,0,0,0,1
Melbourne,"Neal-Bullen, Alex",14,4,4,10,1,0,0,1
Melbourne,"Newton, Ben",14,6,2,8,0,0,0,2
Melbourne,"Petracca, Christian",14,6,2,8,0,1,0,1
Melbourne,"Stretch, Billy",21,10,5,11,0,0,0,0
Melbourne,"Tyson, Dom",15,7,2,8,0,2,0,2
Melbourne,"Vince, Bernie",21,12,4,9,0,1,0,5
Melbourne,"Viney, Jack",18,8,3,10,0,0,0,6
Melbourne,"Wagner, Josh",21,13,4,8,0,0,0,1
Melbourne,"Watts, Jack",13,10,8,3,2,1,6,0
Melbourne,"Bugg, Tomas",14,5,2,9,0,0,0,3
Melbourne,"Dawes, Chris",10,5,1,5,1,0,1,1
Melbourne,"Frost, Sam",18,8,3,10,0,0,0,2
Melbourne,"Garlett, Jeff",5,3,0,2,0,0,0,3
Melbourne,"Gawn, Max",8,2,1,6,0,0,50,3
Melbourne,"Harmes, James",10,8,2,2,0,1,0,3
Melbourne,"Hogan, Jesse",8,5,5,3,1,0,0,0
Melbourne,"Hunt, Jayden",10,4,1,6,0,0,0,6
Melbourne,"Jetta, Neville",13,7,2,6,0,0,0,3
Melbourne,"Jones, Nathan",31,16,1,15,1,0,0,6
Melbourne,"Kent, Dean",13,6,0,7,2,0,0,3
Melbourne,"McDonald, Oscar",22,11,1,11,0,0,0,2
Melbourne,"McDonald, Tom",18,10,2,8,0,0,0,3
Melbourne,"Oliver, Clayton",18,6,1,12,0,0,0,3
Melbourne,"Petracca, Christian",17,7,4,10,1,0,0,6
Melbourne,"Stretch, Billy",17,6,1,11,0,0,0,3
Melbourne,"Trengove, Jack",19,10,2,9,0,0,0,2
Melbourne,"Tyson, Dom",32,16,3,16,1,0,0,6
Melbourne,"Vandenberg, Aaron",10,5,2,5,1,1,0,3
Melbourne,"Vince, Bernie",36,29,2,7,0,0,1,4
Melbourne,"Wagner, Josh",21,12,1,9,0,0,0,3
Melbourne,"Watts, Jack",17,7,3,10,2,0,3,0
Melbourne,"Bugg, Tomas",21,7,3,14,0,0,0,8
Melbourne,"Dawes, Chris",18,8,5,10,0,1,2,2
Melbourne,"Frost, Sam",21,11,7,10,0,0,0,1
Melbourne,"Gawn, Max",27,14,6,13,3,1,31,3
Melbourne,"Hogan, Jesse",19,7,6,12,3,0,1,3
Melbourne,"Hunt, Jayden",13,4,3,9,0,0,0,1
Melbourne,"Jetta, Neville",10,4,2,6,0,0,0,0
Melbourne,"Jones, Nathan",32,17,5,15,1,1,0,8
Melbourne,"Kennedy, Ben",29,11,10,18,1,0,0,2
Melbourne,"Kent, Dean",23,14,7,9,3,1,0,4
Melbourne,"McDonald, Oscar",18,8,4,10,0,0,0,2
Melbourne,"McDonald, Tom",19,15,9,4,0,0,1,4
Melbourne,"Oliver, Clayton",16,3,0,13,0,0,1,8
Melbourne,"Petracca, Christian",20,10,3,10,1,1,0,1
Melbourne,"Stretch, Billy",18,2,2,16,0,0,0,1
Melbourne,"Trengove, Jack",13,5,4,8,1,0,1,9
Melbourne,"Tyson, Dom",29,13,7,16,0,0,3,9
Melbourne,"Vandenberg, Aaron",18,5,6,13,0,0,0,5
Melbourne,"Vince, Bernie",42,25,7,17,0,1,0,1
Melbourne,"Viney, Jack",30,14,6,16,1,0,0,4
Melbourne,"Wagner, Josh",16,8,6,8,0,0,0,4
Melbourne,"Watts, Jack",18,14,9,4,2,1,1,2
Melbourne,"Bugg, Tomas",23,13,0,10,0,0,0,5
Melbourne,"Dawes, Chris",15,5,2,10,0,0,2,3
Melbourne,"Frost, Sam",11,8,1,3,0,1,0,2
Melbourne,"Gawn, Max",14,9,1,5,0,0,58,8
Melbourne,"Hogan, Jesse",18,11,5,7,1,0,2,2
Melbourne,"Hunt, Jayden",18,9,1,9,0,0,0,3
Melbourne,"Jetta, Neville",7,2,0,5,0,0,0,4
Melbourne,"Jones, Nathan",25,15,0,10,0,0,0,8
Melbourne,"Kennedy, Ben",12,6,0,6,0,0,0,3
Melbourne,"Kent, Dean",12,5,1,7,1,0,0,4
Melbourne,"McDonald, Oscar",15,10,4,5,0,0,0,6
Melbourne,"McDonald, Tom",18,11,2,7,0,0,0,1
Melbourne,"Oliver, Clayton",15,4,1,11,0,0,0,2
Melbourne,"Petracca, Christian",14,10,2,4,2,0,0,4
Melbourne,"Stretch, Billy",8,5,0,3,0,0,0,4
Melbourne,"Trengove, Jack",19,6,0,13,0,0,0,5
Melbourne,"Tyson, Dom",17,10,0,7,0,0,0,3
Melbourne,"Vandenberg, Aaron",13,6,1,7,0,0,0,3
Melbourne,"Vince, Bernie",28,21,3,7,0,2,2,4
Melbourne,"Viney, Jack",26,13,2,13,0,0,0,6
Melbourne,"Wagner, Josh",19,15,2,4,0,0,0,4
Melbourne,"Watts, Jack",18,11,4,7,0,1,2,5
Melbourne,"Bugg, Tomas",16,5,1,11,0,0,0,2
Melbourne,"Dawes, Chris",9,4,2,5,0,0,2,4
Melbourne,"Frost, Sam",10,6,3,4,0,0,0,1
Melbourne,"Garlett, Jeff",16,13,3,3,4,2,0,5
Melbourne,"Gawn, Max",16,6,2,10,0,0,40,4
Melbourne,"Harmes, James",24,16,5,8,1,0,0,1
Melbourne,"Hogan, Jesse",18,11,3,7,3,1,0,2
Melbourne,"Hunt, Jayden",14,9,3,5,1,0,0,3
Melbourne,"Jetta, Neville",18,8,4,10,0,0,0,1
Melbourne,"Jones, Matt",20,7,4,13,0,0,0,0
Melbourne,"Jones, Nathan",33,14,3,19,1,1,0,9
Melbourne,"Kennedy, Ben",17,10,3,7,1,1,0,1
Melbourne,"Kent, Dean",18,9,4,9,1,0,0,5
Melbourne,"McDonald, Oscar",15,5,2,10,0,0,0,3
Melbourne,"McDonald, Tom",23,16,11,7,0,0,0,1
Melbourne,"Petracca, Christian",17,7,1,10,0,0,0,3
Melbourne,"Stretch, Billy",18,8,1,10,0,1,0,5
Melbourne,"Tyson, Dom",24,6,4,18,0,0,1,4
Melbourne,"Vandenberg, Aaron",17,4,2,13,0,0,0,8
Melbourne,"Vince, Bernie",17,11,4,6,0,0,0,1
Melbourne,"Viney, Jack",21,8,4,13,0,0,0,8
Melbourne,"Watts, Jack",23,16,8,7,3,0,3,3
Melbourne,"Frost, Sam",9,5,3,4,0,0,0,2
Melbourne,"Garlett, Jeff",7,3,1,4,0,0,0,2
Melbourne,"Gawn, Max",17,6,3,11,0,0,43,5
Melbourne,"Grimes, Jack",32,17,9,15,0,0,0,8
Melbourne,"Harmes, James",23,9,6,14,0,0,0,2
Melbourne,"Hogan, Jesse",20,14,12,6,4,2,1,5
Melbourne,"Hunt, Jayden",29,17,4,12,0,0,0,3
Melbourne,"Jetta, Neville",26,13,5,13,0,2,0,3
Melbourne,"Jones, Matt",30,18,7,12,0,0,0,4
Melbourne,"Jones, Nathan",35,14,2,21,1,0,0,4
Melbourne,"Kennedy, Ben",13,4,1,9,0,1,0,3
Melbourne,"Kent, Dean",19,11,5,8,3,1,0,4
Melbourne,"McDonald, Oscar",8,5,4,3,0,0,0,2
Melbourne,"McDonald, Tom",31,19,10,12,0,0,0,1
Melbourne,"Petracca, Christian",18,9,2,9,0,0,1,4
Melbourne,"Stretch, Billy",12,5,2,7,0,0,0,8
Melbourne,"Tyson, Dom",31,16,1,15,0,1,0,5
Melbourne,"Vandenberg, Aaron",22,8,3,14,1,2,0,5
Melbourne,"Vince, Bernie",15,11,4,4,0,1,0,5
Melbourne,"Viney, Jack",29,15,4,14,0,1,0,7
Melbourne,"Watts, Jack",19,15,10,4,3,2,2,2
Melbourne,"White, Mitch",20,7,6,13,0,0,0,5
Melbourne,"Brayshaw, Angus",23,7,3,16,0,0,0,4
Melbourne,"Garlett, Jeff",7,6,1,1,2,1,0,6
Melbourne,"Gawn, Max",11,5,3,6,2,0,36,5
Melbourne,"Grimes, Jack",15,5,4,10,0,0,0,2
Melbourne,"Harmes, James",23,8,3,15,0,0,0,3
Melbourne,"Hogan, Jesse",10,7,5,3,1,2,0,0
Melbourne,"Hunt, Jayden",14,7,5,7,0,0,0,2
Melbourne,"Jetta, Neville",22,12,5,10,0,0,0,2
Melbourne,"Jones, Matt",19,9,4,10,0,0,0,3
Melbourne,"Jones, Nathan",22,8,2,14,0,0,0,3
Melbourne,"Kennedy, Ben",19,7,4,12,1,0,0,1
Melbourne,"Kent, Dean",18,10,1,8,0,1,0,4
Melbourne,"McDonald, Oscar",11,6,6,5,0,0,0,0
Melbourne,"McDonald, Tom",24,15,10,9,0,0,0,2
Melbourne,"Petracca, Christian",19,12,3,7,2,1,0,1
Melbourne,"Tyson, Dom",20,10,4,10,0,1,0,1
Melbourne,"Vandenberg, Aaron",12,4,0,8,1,0,1,1
Melbourne,"Vince, Bernie",34,19,4,15,0,1,0,2
Melbourne,"Viney, Jack",33,9,5,24,1,0,0,6
Melbourne,"Wagner, Josh",18,9,5,9,0,0,0,3
Melbourne,"Watts, Jack",18,7,6,11,1,0,2,0
Melbourne,"White, Mitch",8,2,1,6,0,0,0,1
Melbourne,"Brayshaw, Angus",20,11,4,9,0,0,0,9
Melbourne,"Dawes, Chris",12,9,2,3,2,0,1,5
Melbourne,"Frost, Sam",15,9,3,6,0,0,0,4
Melbourne,"Garlett, Jeff",9,7,3,2,3,1,0,3
Melbourne,"Gawn, Max",17,9,5,8,0,0,41,8
Melbourne,"Harmes, James",13,6,1,7,0,0,0,4
Melbourne,"Hogan, Jesse",13,7,5,6,0,1,0,1
Melbourne,"Hunt, Jayden",18,10,1,8,0,0,0,3
Melbourne,"Jetta, Neville",13,3,1,10,0,0,0,4
Melbourne,"Jones, Matt",21,8,3,13,1,0,0,8
Melbourne,"Jones, Nathan",34,13,1,21,0,0,0,8
Melbourne,"Kent, Dean",25,16,5,9,1,1,0,2
Melbourne,"McDonald, Oscar",14,7,2,7,0,0,0,0
Melbourne,"McDonald, Tom",13,10,6,3,0,0,0,2
Melbourne,"Neal-Bullen, Alex",16,6,2,10,0,0,0,3
Melbourne,"Petracca, Christian",19,7,1,12,1,0,0,4
Melbourne,"Stretch, Billy",22,7,3,15,0,1,0,5
Melbourne,"Tyson, Dom",29,15,6,14,0,1,1,10
Melbourne,"Vince, Bernie",23,15,4,8,0,1,0,2
Melbourne,"Viney, Jack",26,9,4,17,0,0,0,7
Melbourne,"Wagner, Josh",15,8,2,7,0,0,0,5
Melbourne,"Watts, Jack",16,9,2,7,0,3,3,2
Melbourne,"Brayshaw, Angus",22,11,5,11,0,0,0,8
Melbourne,"Dawes, Chris",8,5,5,3,1,1,5,4
Melbourne,"Frost, Sam",21,15,6,6,0,0,0,3
Melbourne,"Garlett, Jeff",6,4,2,2,0,1,0,3
Melbourne,"Gawn, Max",9,4,2,5,0,0,60,4
Melbourne,"Harmes, James",23,14,4,9,0,0,0,0
Melbourne,"Hogan, Jesse",12,10,9,2,0,2,0,1
Melbourne,"Hunt, Jayden",19,10,5,9,0,0,0,3
Melbourne,"Jetta, Neville",18,11,7,7,0,0,0,4
Melbourne,"Jones, Matt",21,11,6,10,0,0,0,5
Melbourne,"Jones, Nathan",23,9,3,14,0,0,0,8
Melbourne,"Kent, Dean",16,12,6,4,1,0,0,2
Melbourne,"McDonald, Oscar",19,9,7,10,0,0,0,1
Melbourne,"McDonald, Tom",17,12,7,5,0,0,0,2
Melbourne,"Petracca, Christian",14,7,1,7,1,0,0,2
Melbourne,"Stretch, Billy",19,13,7,6,0,0,0,7
Melbourne,"Tyson, Dom",31,12,6,19,0,0,0,5
Melbourne,"Vandenberg, Aaron",18,8,6,10,3,2,0,5
Melbourne,"Vince, Bernie",21,10,4,11,0,1,0,3
Melbourne,"Viney, Jack",19,7,0,12,0,0,0,8
Melbourne,"Wagner, Josh",13,8,5,5,0,0,0,2
Melbourne,"Watts, Jack",18,12,10,6,3,2,2,3
Melbourne,"Brayshaw, Angus",16,8,3,8,1,1,0,1
Melbourne,"Bugg, Tomas",19,9,4,10,2,0,0,1
Melbourne,"Frost, Sam",16,9,5,7,0,0,0,4
Melbourne,"Garlett, Jeff",13,8,3,5,0,0,0,1
Melbourne,"Gawn, Max",16,11,11,5,1,2,41,5
Melbourne,"Harmes, James",22,9,2,13,0,0,0,3
Melbourne,"Hunt, Jayden",13,8,2,5,1,0,0,0
Melbourne,"Jetta, Neville",16,10,3,6,0,0,0,2
Melbourne,"Jones, Nathan",30,16,3,14,0,1,0,11
Melbourne,"Kent, Dean",19,9,5,10,1,0,0,1
Melbourne,"McDonald, Oscar",23,8,6,15,0,0,0,3
Melbourne,"McDonald, Tom",20,13,6,7,0,0,0,4
Melbourne,"Oliver, Clayton",23,7,0,16,0,0,1,11
Melbourne,"Pedersen, Cameron",11,5,5,6,1,1,1,0
Melbourne,"Petracca, Christian",12,5,3,7,1,0,0,3
Melbourne,"Stretch, Billy",22,7,3,15,1,0,0,2
Melbourne,"Tyson, Dom",30,18,7,12,2,0,0,3
Melbourne,"Vandenberg, Aaron",14,5,6,9,1,0,0,2
Melbourne,"Vince, Bernie",27,17,2,10,0,0,0,1
Melbourne,"Viney, Jack",39,11,5,28,0,0,0,8
Melbourne,"Watts, Jack",17,11,6,6,3,1,1,2
Melbourne,"Weideman, Sam",13,2,3,11,2,0,0,0
Melbourne,"Brayshaw, Angus",18,8,4,10,2,0,0,3
Melbourne,"Bugg, Tomas",19,9,5,10,2,1,0,5
Melbourne,"Frost, Sam",12,8,5,4,1,1,0,0
Melbourne,"Garlett, Jeff",17,12,1,5,2,1,0,1
Melbourne,"Gawn, Max",16,9,6,7,0,2,47,4
Melbourne,"Harmes, James",12,5,3,7,0,0,0,3
Melbourne,"Hogan, Jesse",9,7,6,2,0,2,0,0
Melbourne,"Hunt, Jayden",20,13,4,7,0,0,0,3
Melbourne,"Jetta, Neville",20,11,9,9,0,0,0,3
Melbourne,"Jones, Nathan",29,15,3,14,1,1,0,5
Melbourne,"Kent, Dean",22,13,7,9,1,0,0,1
Melbourne,"McDonald, Oscar",23,15,9,8,0,0,0,2
Melbourne,"McDonald, Tom",18,15,10,3,0,0,0,4
Melbourne,"Oliver, Clayton",22,13,2,9,1,0,0,2
Melbourne,"Pedersen, Cameron",13,6,3,7,0,1,2,0
Melbourne,"Petracca, Christian",14,11,3,3,0,0,0,2
Melbourne,"Stretch, Billy",17,8,4,9,0,1,0,7
Melbourne,"Tyson, Dom",29,9,6,20,1,1,0,8
Melbourne,"Vandenberg, Aaron",10,6,3,4,0,1,0,6
Melbourne,"Vince, Bernie",31,22,5,9,1,0,0,2
Melbourne,"Viney, Jack",17,6,3,11,0,1,0,5
Melbourne,"Watts, Jack",14,11,9,3,1,0,4,4
Melbourne,"Brayshaw, Angus",18,6,3,12,0,0,0,4
Melbourne,"Bugg, Tomas",14,7,2,7,1,0,0,2
Melbourne,"Frost, Sam",14,5,3,9,0,0,0,3
Melbourne,"Gawn, Max",16,10,6,6,1,0,33,3
Melbourne,"Hogan, Jesse",18,11,14,7,1,3,0,0
Melbourne,"Hunt, Jayden",16,12,3,4,1,0,0,1
Melbourne,"Jetta, Neville",18,12,6,6,0,1,0,3
Melbourne,"Jones, Nathan",29,12,5,17,0,1,0,5
Melbourne,"Kent, Dean",9,5,0,4,0,0,0,3
Melbourne,"McDonald, Oscar",20,10,3,10,0,0,0,4
Melbourne,"McDonald, Tom",19,10,5,9,0,0,0,1
Melbourne,"Michie, Viv",20,7,4,13,0,0,0,2
Melbourne,"Neal-Bullen, Alex",8,5,1,3,1,0,0,4
Melbourne,"Oliver, Clayton",24,5,6,19,1,0,0,4
Melbourne,"Petracca, Christian",21,13,2,8,0,2,0,4
Melbourne,"Stretch, Billy",14,4,3,10,0,1,0,3
Melbourne,"Tyson, Dom",30,16,8,14,0,2,0,4
Melbourne,"Vandenberg, Aaron",15,7,3,8,1,2,0,3
Melbourne,"Vince, Bernie",22,13,4,9,0,1,0,1
Melbourne,"Viney, Jack",27,13,6,14,0,0,0,11
Melbourne,"Watts, Jack",14,6,3,8,0,1,2,2
Melbourne,"Weideman, Sam",7,2,3,5,0,0,0,0
Melbourne,"Brayshaw, Angus",26,15,4,11,1,0,0,5
Melbourne,"Bugg, Tomas",8,2,2,6,0,0,0,5
Melbourne,"Frost, Sam",12,5,2,7,0,0,0,4
Melbourne,"Garlett, Jeff",10,6,2,4,2,0,0,5
Melbourne,"Gawn, Max",15,10,2,5,0,0,41,3
Melbourne,"Harmes, James",21,9,1,12,0,0,0,5
Melbourne,"Hogan, Jesse",9,7,3,2,1,1,0,2
Melbourne,"Hunt, Jayden",19,9,4,10,0,1,0,0
Melbourne,"Jetta, Neville",13,7,2,6,0,0,0,1
Melbourne,"Jones, Matt",14,7,4,7,0,0,0,3
Melbourne,"Jones, Nathan",25,10,5,15,0,1,0,3
Melbourne,"McDonald, Oscar",12,10,6,2,0,0,0,0
Melbourne,"McDonald, Tom",21,8,5,13,0,0,0,0
Melbourne,"Petracca, Christian",16,7,2,9,0,1,0,3
Melbourne,"Salem, Christian",27,10,1,17,0,0,0,7
Melbourne,"Stretch, Billy",17,8,4,9,0,0,0,3
Melbourne,"Tyson, Dom",23,11,2,12,0,0,0,2
Melbourne,"Vandenberg, Aaron",16,5,4,11,1,0,0,3
Melbourne,"Vince, Bernie",14,10,3,4,0,0,1,5
Melbourne,"Viney, Jack",20,9,3,11,0,0,0,6
Melbourne,"Watts, Jack",15,8,3,7,0,1,3,0
Melbourne,"Weideman, Sam",5,4,3,1,1,0,0,0
North Melbourne,"Anderson, Jed",5,4,1,1,0,0,0,0
North Melbourne,"Atley, Shaun",17,10,5,7,0,0,0,1
North Melbourne,"Brown, Ben",11,9,6,2,2,0,2,2
North Melbourne,"Cunnington, Ben",27,7,1,20,0,1,1,7
North Melbourne,"Dal Santo, Nick",21,12,2,9,1,1,0,2
North Melbourne,"Firrito, Michael",17,10,9,7,0,0,0,1
North Melbourne,"Garner, Taylor",11,5,5,6,2,0,0,5
North Melbourne,"Gibson, Sam",25,11,3,14,0,0,0,6
North Melbourne,"Goldstein, Todd",13,8,4,5,1,0,44,7
North Melbourne,"Harvey, Brent",16,12,5,4,3,0,0,2
North Melbourne,"Higgins, Shaun",18,8,5,10,1,0,0,9
North Melbourne,"Macmillan, Jamie",15,11,4,4,0,0,0,1
North Melbourne,"McDonald, Luke",12,8,4,4,0,1,0,2
North Melbourne,"Petrie, Drew",6,5,3,1,2,1,0,4
North Melbourne,"Swallow, Andrew",17,9,1,8,0,0,0,10
North Melbourne,"Tarrant, Robbie",24,16,8,8,0,1,0,2
North Melbourne,"Thomas, Lindsay",14,10,4,4,1,2,0,3
North Melbourne,"Thompson, Scott",13,7,5,6,0,0,0,1
North Melbourne,"Waite, Jarrad",20,14,7,6,3,1,0,6
North Melbourne,"Wells, Daniel",18,14,5,4,0,0,0,7
North Melbourne,"Wright, Sam",15,8,2,7,0,0,0,0
North Melbourne,"Ziebell, Jack",26,16,2,10,0,0,0,4
North Melbourne,"Atley, Shaun",13,6,2,7,0,0,0,0
North Melbourne,"Brown, Ben",15,8,6,7,3,1,6,1
North Melbourne,"Cunnington, Ben",18,7,3,11,0,0,0,6
North Melbourne,"Dal Santo, Nick",20,11,3,9,2,0,0,1
North Melbourne,"Firrito, Michael",14,7,2,7,0,0,0,0
North Melbourne,"Garner, Taylor",13,6,2,7,0,2,1,3
North Melbourne,"Gibson, Sam",19,9,4,10,2,0,0,2
North Melbourne,"Goldstein, Todd",11,5,0,6,1,1,29,0
North Melbourne,"Hansen, Lachlan",5,0,0,5,0,0,0,0
North Melbourne,"Harvey, Brent",24,17,4,7,2,3,0,1
North Melbourne,"Higgins, Shaun",19,7,3,12,0,0,0,2
North Melbourne,"Jacobs, Ben",6,1,0,5,0,0,0,3
North Melbourne,"Macmillan, Jamie",16,12,2,4,0,0,0,1
North Melbourne,"McDonald, Luke",12,7,1,5,0,0,0,3
North Melbourne,"Petrie, Drew",16,11,9,5,1,2,0,1
North Melbourne,"Swallow, Andrew",22,10,2,12,0,1,0,3
North Melbourne,"Tarrant, Robbie",11,8,4,3,0,0,0,0
North Melbourne,"Thomas, Lindsay",16,10,4,6,0,2,0,4
North Melbourne,"Waite, Jarrad",23,12,6,11,5,1,0,5
North Melbourne,"Wells, Daniel",23,13,5,10,0,1,0,4
North Melbourne,"Wright, Sam",16,10,3,6,0,0,0,3
North Melbourne,"Ziebell, Jack",22,10,2,12,1,1,0,3
North Melbourne,"Atley, Shaun",17,6,2,11,0,0,0,3
North Melbourne,"Brown, Ben",10,6,4,4,0,1,0,1
North Melbourne,"Cunnington, Ben",20,6,1,14,0,0,2,2
North Melbourne,"Dal Santo, Nick",21,8,1,13,0,0,1,2
North Melbourne,"Firrito, Michael",19,14,5,5,0,0,0,3
North Melbourne,"Garner, Taylor",8,2,1,6,0,1,0,6
North Melbourne,"Gibson, Sam",18,10,1,8,2,0,0,3
North Melbourne,"Goldstein, Todd",19,11,3,8,5,2,38,5
North Melbourne,"Harvey, Brent",22,11,2,11,6,0,0,5
North Melbourne,"Higgins, Shaun",17,5,2,12,0,1,0,2
North Melbourne,"Jacobs, Ben",6,2,1,4,0,0,0,3
North Melbourne,"Macmillan, Jamie",14,11,3,3,1,0,0,1
North Melbourne,"McDonald, Luke",10,7,3,3,0,0,0,5
North Melbourne,"Petrie, Drew",9,5,1,4,2,1,0,3
North Melbourne,"Swallow, Andrew",13,6,0,7,0,0,0,11
North Melbourne,"Tarrant, Robbie",12,7,3,5,0,0,1,3
North Melbourne,"Thomas, Lindsay",13,5,3,8,0,2,0,3
North Melbourne,"Thompson, Scott",9,1,1,8,0,0,0,2
North Melbourne,"Waite, Jarrad",15,9,5,6,4,0,0,5
North Melbourne,"Wells, Daniel",17,10,1,7,0,0,1,7
North Melbourne,"Wright, Sam",14,9,4,5,0,0,0,3
North Melbourne,"Ziebell, Jack",19,14,1,5,1,1,0,19
North Melbourne,"Atley, Shaun",21,10,5,11,0,2,0,1
North Melbourne,"Brown, Ben",15,11,8,4,3,0,1,0
North Melbourne,"Cunnington, Ben",23,8,3,15,1,0,1,5
North Melbourne,"Dal Santo, Nick",25,16,8,9,0,0,0,4
North Melbourne,"Firrito, Michael",15,10,3,5,0,0,0,1
North Melbourne,"Gibson, Sam",26,19,5,7,3,1,0,1
North Melbourne,"Goldstein, Todd",17,5,2,12,0,0,45,1
North Melbourne,"Harvey, Brent",19,8,3,11,1,1,0,5
North Melbourne,"Higgins, Shaun",22,7,2,15,2,0,0,3
North Melbourne,"Jacobs, Ben",20,7,2,13,0,0,0,4
North Melbourne,"Macmillan, Jamie",26,19,6,7,1,0,0,1
North Melbourne,"McDonald, Luke",18,12,9,6,0,0,0,1
North Melbourne,"Petrie, Drew",13,8,5,5,0,0,2,2
North Melbourne,"Swallow, Andrew",16,8,3,8,0,1,0,11
North Melbourne,"Tarrant, Robbie",12,10,5,2,0,0,0,2
North Melbourne,"Thomas, Lindsay",9,4,3,5,1,1,0,3
North Melbourne,"Thompson, Scott",16,9,5,7,0,0,0,3
North Melbourne,"Waite, Jarrad",16,11,9,5,4,1,0,6
North Melbourne,"Wells, Daniel",25,10,4,15,0,0,0,8
North Melbourne,"Wood, Mason",15,10,5,5,1,1,0,3
North Melbourne,"Wright, Sam",25,17,12,8,0,0,0,2
North Melbourne,"Ziebell, Jack",26,19,7,7,3,0,0,4
North Melbourne,"Atley, Shaun",23,12,5,11,0,0,0,1
North Melbourne,"Brown, Ben",14,12,5,2,4,1,1,3
North Melbourne,"Cunnington, Ben",20,7,3,13,0,0,0,3
North Melbourne,"Dal Santo, Nick",28,16,6,12,0,1,0,5
North Melbourne,"Firrito, Michael",9,5,3,4,0,0,0,0
North Melbourne,"Gibson, Sam",15,10,5,5,1,0,0,2
North Melbourne,"Goldstein, Todd",18,8,3,10,2,0,24,3
North Melbourne,"Harvey, Brent",22,16,5,6,0,2,0,2
North Melbourne,"Higgins, Shaun",18,13,5,5,3,1,1,3
North Melbourne,"Jacobs, Ben",10,2,1,8,0,0,0,3
North Melbourne,"Macmillan, Jamie",16,10,4,6,1,0,0,3
North Melbourne,"McDonald, Luke",14,8,4,6,0,0,0,2
North Melbourne,"Petrie, Drew",15,10,6,5,2,1,0,3
North Melbourne,"Swallow, Andrew",23,10,1,13,0,0,0,3
North Melbourne,"Tarrant, Robbie",14,12,9,2,0,0,0,1
North Melbourne,"Thomas, Lindsay",9,7,2,2,2,1,0,2
North Melbourne,"Thompson, Scott",14,11,7,3,0,0,0,0
North Melbourne,"Turner, Kayne",13,3,4,10,0,0,0,4
North Melbourne,"Waite, Jarrad",18,14,10,4,2,2,0,1
North Melbourne,"Wells, Daniel",16,6,1,10,0,0,0,6
North Melbourne,"Wright, Sam",11,10,4,1,0,0,0,1
North Melbourne,"Ziebell, Jack",22,16,4,6,1,1,0,6
North Melbourne,"Atley, Shaun",14,3,4,11,0,0,0,5
North Melbourne,"Brown, Ben",10,7,3,3,1,1,2,2
North Melbourne,"Cunnington, Ben",20,9,2,11,0,0,0,14
North Melbourne,"Dal Santo, Nick",14,7,2,7,0,0,4,3
North Melbourne,"Firrito, Michael",15,7,3,8,0,0,0,1
North Melbourne,"Gibson, Sam",15,9,1,6,0,1,0,4
North Melbourne,"Goldstein, Todd",8,4,2,4,0,0,40,1
North Melbourne,"Harvey, Brent",20,9,4,11,0,1,0,2
North Melbourne,"Higgins, Shaun",16,9,3,7,1,0,0,6
North Melbourne,"Jacobs, Ben",17,7,4,10,0,0,0,1
North Melbourne,"Macmillan, Jamie",21,10,2,11,0,0,0,2
North Melbourne,"McDonald, Luke",17,10,3,7,0,0,0,2
North Melbourne,"Petrie, Drew",17,10,6,7,1,1,1,2
North Melbourne,"Swallow, Andrew",23,7,1,16,0,0,0,14
North Melbourne,"Tarrant, Robbie",16,11,5,5,0,0,1,1
North Melbourne,"Thomas, Lindsay",11,9,5,2,1,0,0,7
North Melbourne,"Thompson, Scott",26,16,9,10,0,0,0,5
North Melbourne,"Turner, Kayne",2,0,0,2,0,0,0,0
North Melbourne,"Waite, Jarrad",13,11,7,2,4,1,0,4
North Melbourne,"Wells, Daniel",27,12,3,15,0,2,0,6
North Melbourne,"Wright, Sam",15,8,2,7,0,0,0,5
North Melbourne,"Ziebell, Jack",18,14,4,4,1,0,1,5
North Melbourne,"Atley, Shaun",21,12,7,9,0,0,0,0
North Melbourne,"Brown, Ben",11,10,5,1,2,0,2,2
North Melbourne,"Cunnington, Ben",26,11,5,15,1,0,0,2
North Melbourne,"Dal Santo, Nick",19,11,3,8,0,1,0,5
North Melbourne,"Firrito, Michael",13,9,8,4,0,0,0,3
North Melbourne,"Gibson, Sam",21,11,5,10,0,1,0,0
North Melbourne,"Goldstein, Todd",17,9,5,8,0,1,35,4
North Melbourne,"Harvey, Brent",21,11,3,10,1,2,0,2
North Melbourne,"Higgins, Shaun",11,5,3,6,2,3,0,0
North Melbourne,"Jacobs, Ben",14,7,2,7,0,1,0,6
North Melbourne,"Macmillan, Jamie",13,9,5,4,0,0,0,6
North Melbourne,"McDonald, Luke",13,10,5,3,0,0,0,3
North Melbourne,"Mullett, Aaron",16,14,6,2,0,0,0,1
North Melbourne,"Nahas, Robin",11,7,2,4,0,2,0,2
North Melbourne,"Petrie, Drew",11,8,4,3,2,0,0,1
North Melbourne,"Swallow, Andrew",19,12,3,7,0,0,0,10
North Melbourne,"Tarrant, Robbie",11,7,5,4,0,0,0,0
North Melbourne,"Thompson, Scott",18,11,6,7,0,0,0,2
North Melbourne,"Waite, Jarrad",12,8,4,4,1,2,0,3
North Melbourne,"Wells, Daniel",11,5,1,6,0,0,1,3
North Melbourne,"Wood, Mason",11,6,4,5,2,2,0,4
North Melbourne,"Ziebell, Jack",28,19,5,9,0,1,1,2
North Melbourne,"Atley, Shaun",15,5,2,10,0,0,0,2
North Melbourne,"Brown, Ben",5,4,1,1,1,1,3,1
North Melbourne,"Cunnington, Ben",19,7,5,12,0,1,0,6
North Melbourne,"Dal Santo, Nick",28,11,3,17,0,1,0,0
North Melbourne,"Daw, Majak",14,7,5,7,2,2,4,5
North Melbourne,"Gibson, Sam",36,20,15,16,0,1,0,3
North Melbourne,"Goldstein, Todd",22,8,5,14,0,0,35,2
North Melbourne,"Harvey, Brent",31,14,8,17,0,0,0,0
North Melbourne,"Jacobs, Ben",14,5,2,9,1,0,0,5
North Melbourne,"Macmillan, Jamie",14,7,4,7,0,0,0,2
North Melbourne,"McDonald, Luke",14,9,6,5,0,0,0,1
North Melbourne,"McKenzie, Brad",19,15,5,4,0,0,0,1
North Melbourne,"Mullett, Aaron",19,12,2,7,0,1,0,1
North Melbourne,"Nahas, Robin",8,4,2,4,0,1,0,7
North Melbourne,"Petrie, Drew",11,9,2,2,2,0,0,1
North Melbourne,"Swallow, Andrew",27,13,4,14,0,0,0,6
North Melbourne,"Tarrant, Robbie",20,13,7,7,0,0,0,1
North Melbourne,"Thomas, Lindsay",13,9,5,4,1,1,0,3
North Melbourne,"Thompson, Scott",19,14,6,5,0,0,0,1
North Melbourne,"Waite, Jarrad",18,9,5,9,2,3,0,6
North Melbourne,"Wood, Mason",13,8,6,5,1,0,0,2
North Melbourne,"Ziebell, Jack",23,12,1,11,0,1,0,2
North Melbourne,"Atley, Shaun",15,8,5,7,0,0,0,2
North Melbourne,"Brown, Ben",10,7,5,3,2,1,4,1
North Melbourne,"Cunnington, Ben",17,10,4,7,0,0,0,3
North Melbourne,"Dal Santo, Nick",28,18,7,10,0,0,0,4
North Melbourne,"Dumont, Trent",15,9,1,6,0,1,0,9
North Melbourne,"Firrito, Michael",12,4,2,8,0,0,0,3
North Melbourne,"Gibson, Sam",15,9,4,6,0,1,0,4
North Melbourne,"Goldstein, Todd",19,12,5,7,3,0,45,2
North Melbourne,"Harvey, Brent",21,12,4,9,2,1,0,1
North Melbourne,"Macmillan, Jamie",21,14,10,7,0,1,0,0
North Melbourne,"McDonald, Luke",21,15,8,6,0,0,0,1
North Melbourne,"McKenzie, Brad",11,8,4,3,0,0,0,6
North Melbourne,"Mullett, Aaron",20,15,4,5,0,0,0,2
North Melbourne,"Nahas, Robin",8,5,6,3,2,1,0,1
North Melbourne,"Petrie, Drew",9,6,3,3,0,0,0,4
North Melbourne,"Ray, Farren",18,10,4,8,1,0,0,1
North Melbourne,"Swallow, Andrew",16,2,1,14,0,0,0,7
North Melbourne,"Tarrant, Robbie",22,12,9,10,0,0,3,3
North Melbourne,"Thomas, Lindsay",11,7,4,4,3,3,0,1
North Melbourne,"Thompson, Scott",16,9,7,7,0,0,0,0
North Melbourne,"Waite, Jarrad",16,9,6,7,2,0,0,0
North Melbourne,"Ziebell, Jack",22,16,5,6,2,1,1,4
North Melbourne,"Atley, Shaun",13,8,3,5,0,0,0,1
North Melbourne,"Brown, Ben",11,7,4,4,1,2,4,1
North Melbourne,"Cunnington, Ben",32,14,3,18,0,0,0,2
North Melbourne,"Dal Santo, Nick",21,7,3,14,0,0,1,7
North Melbourne,"Dumont, Trent",13,4,3,9,1,0,1,5
North Melbourne,"Firrito, Michael",14,10,0,4,0,0,0,1
North Melbourne,"Gibson, Sam",17,9,2,8,0,1,0,1
North Melbourne,"Goldstein, Todd",9,5,2,4,1,0,43,6
North Melbourne,"Harvey, Brent",13,4,3,9,0,1,0,2
North Melbourne,"Macmillan, Jamie",17,13,4,4,1,1,0,2
North Melbourne,"McDonald, Luke",8,5,2,3,0,0,0,2
North Melbourne,"McKenzie, Brad",11,7,0,4,0,0,0,2
North Melbourne,"Nahas, Robin",9,5,0,4,1,2,0,7
North Melbourne,"Petrie, Drew",6,4,3,2,0,0,1,2
North Melbourne,"Swallow, Andrew",17,9,3,8,0,0,0,12
North Melbourne,"Tarrant, Robbie",13,8,5,5,0,0,0,0
North Melbourne,"Thomas, Lindsay",9,7,1,2,3,1,0,4
North Melbourne,"Thompson, Scott",15,9,6,6,0,1,0,3
North Melbourne,"Waite, Jarrad",14,9,6,5,0,0,0,6
North Melbourne,"Wells, Daniel",19,13,5,6,1,0,0,7
North Melbourne,"Wright, Sam",15,7,3,8,0,0,0,3
North Melbourne,"Ziebell, Jack",22,20,3,2,0,0,1,5
North Melbourne,"Atley, Shaun",18,6,0,12,1,0,0,5
North Melbourne,"Brown, Ben",9,7,6,2,1,1,4,1
North Melbourne,"Cunnington, Ben",25,10,1,15,1,0,0,4
North Melbourne,"Dal Santo, Nick",33,12,2,21,1,0,2,8
North Melbourne,"Daw, Majak",10,8,3,2,1,1,19,5
North Melbourne,"Firrito, Michael",6,4,2,2,0,0,0,3
North Melbourne,"Gibson, Sam",20,9,4,11,0,1,0,6
North Melbourne,"Harvey, Brent",19,11,2,8,4,0,0,5
North Melbourne,"Macmillan, Jamie",16,9,2,7,1,0,0,4
North Melbourne,"McDonald, Luke",18,10,3,8,0,1,0,4
North Melbourne,"McKenzie, Brad",13,9,2,4,0,0,0,4
North Melbourne,"Nahas, Robin",11,9,4,2,0,3,0,4
North Melbourne,"Petrie, Drew",15,10,9,5,1,0,1,2
North Melbourne,"Swallow, Andrew",28,12,2,16,0,0,0,11
North Melbourne,"Tarrant, Robbie",11,5,4,6,0,0,2,2
North Melbourne,"Thomas, Lindsay",11,9,5,2,2,2,0,2
North Melbourne,"Thompson, Scott",18,6,3,12,0,0,0,2
North Melbourne,"Waite, Jarrad",12,8,3,4,0,2,0,6
North Melbourne,"Wells, Daniel",29,13,4,16,3,0,0,7
North Melbourne,"Wood, Mason",17,11,4,6,2,0,0,3
North Melbourne,"Wright, Sam",11,9,3,2,0,0,0,2
North Melbourne,"Ziebell, Jack",30,19,4,11,0,1,0,4
North Melbourne,"Atley, Shaun",14,8,4,6,0,0,0,1
North Melbourne,"Brown, Ben",10,8,8,2,0,0,5,1
North Melbourne,"Cunnington, Ben",9,3,0,6,0,0,0,2
North Melbourne,"Dal Santo, Nick",21,8,4,13,0,0,0,2
North Melbourne,"Firrito, Michael",9,8,1,1,0,0,0,0
North Melbourne,"Gibson, Sam",34,19,9,15,0,0,0,4
North Melbourne,"Goldstein, Todd",13,4,4,9,0,0,38,4
North Melbourne,"Harvey, Brent",16,10,5,6,4,0,0,2
North Melbourne,"Macmillan, Jamie",22,9,7,13,0,0,0,1
North Melbourne,"McDonald, Luke",11,6,3,5,1,0,0,2
North Melbourne,"McKenzie, Brad",9,7,2,2,0,0,0,1
North Melbourne,"Mullett, Aaron",13,12,4,1,0,1,0,0
North Melbourne,"Nahas, Robin",3,2,0,1,0,0,0,2
North Melbourne,"Petrie, Drew",9,5,6,4,2,0,0,2
North Melbourne,"Swallow, Andrew",4,1,0,3,0,0,0,2
North Melbourne,"Tarrant, Robbie",19,12,11,7,0,0,0,1
North Melbourne,"Thomas, Lindsay",13,10,4,3,1,1,1,3
North Melbourne,"Thompson, Scott",16,9,5,7,0,0,0,0
North Melbourne,"Waite, Jarrad",11,7,6,4,0,0,0,1
North Melbourne,"Wells, Daniel",31,17,5,14,0,0,0,4
North Melbourne,"Wood, Mason",12,7,6,5,2,0,0,1
North Melbourne,"Ziebell, Jack",22,17,2,5,2,0,0,5
North Melbourne,"Atley, Shaun",20,10,3,10,0,0,0,1
North Melbourne,"Brown, Ben",11,11,8,0,1,3,0,1
North Melbourne,"Dal Santo, Nick",24,12,5,12,0,0,1,5
North Melbourne,"Daw, Majak",8,5,1,3,0,1,12,5
North Melbourne,"Dumont, Trent",24,14,4,10,0,1,1,7
North Melbourne,"Firrito, Michael",7,4,2,3,0,0,0,2
North Melbourne,"Gibson, Sam",18,13,4,5,0,0,0,7
North Melbourne,"Goldstein, Todd",8,1,3,7,0,0,39,4
North Melbourne,"Harvey, Brent",13,11,4,2,1,1,0,3
North Melbourne,"Macmillan, Jamie",15,10,7,5,0,0,0,1
North Melbourne,"McDonald, Luke",3,2,2,1,0,0,0,1
North Melbourne,"McKenzie, Brad",14,7,3,7,0,0,0,3
North Melbourne,"Mullett, Aaron",21,17,2,4,0,2,0,1
North Melbourne,"Petrie, Drew",8,7,4,1,3,0,0,1
North Melbourne,"Ray, Farren",17,10,1,7,0,1,0,3
North Melbourne,"Tarrant, Robbie",26,13,6,13,0,0,1,4
North Melbourne,"Thomas, Lindsay",12,7,2,5,3,1,0,4
North Melbourne,"Thompson, Scott",15,10,5,5,0,0,0,0
North Melbourne,"Wagner, Corey",7,3,1,4,0,1,0,1
North Melbourne,"Wells, Daniel",30,16,3,14,0,0,0,3
North Melbourne,"Wood, Mason",20,14,5,6,2,3,0,4
North Melbourne,"Ziebell, Jack",19,15,5,4,1,0,0,3
North Melbourne,"Atley, Shaun",10,4,2,6,0,0,0,0
North Melbourne,"Brown, Ben",12,8,6,4,2,1,11,1
North Melbourne,"Cunnington, Ben",26,9,2,17,0,0,0,4
North Melbourne,"Dal Santo, Nick",22,12,3,10,0,0,0,6
North Melbourne,"Dumont, Trent",19,9,2,10,0,0,1,3
North Melbourne,"Firrito, Michael",10,9,3,1,0,0,0,0
North Melbourne,"Gibson, Sam",18,10,4,8,1,0,0,4
North Melbourne,"Goldstein, Todd",12,4,4,8,0,1,42,6
North Melbourne,"Harvey, Brent",18,15,5,3,1,2,0,5
North Melbourne,"Macmillan, Jamie",12,7,4,5,0,0,0,6
North Melbourne,"McKenzie, Brad",24,22,5,2,0,1,0,2
North Melbourne,"Mullett, Aaron",18,14,4,4,0,0,0,2
North Melbourne,"Nahas, Robin",9,5,1,4,0,0,0,2
North Melbourne,"Petrie, Drew",6,4,3,2,1,0,0,5
North Melbourne,"Ray, Farren",2,0,0,2,0,0,0,1
North Melbourne,"Swallow, Andrew",20,10,2,10,0,0,0,7
North Melbourne,"Tarrant, Robbie",11,7,3,4,0,0,0,0
North Melbourne,"Thomas, Lindsay",11,7,1,4,3,0,0,1
North Melbourne,"Thompson, Scott",15,10,4,5,0,0,0,3
North Melbourne,"Wagner, Corey",9,6,1,3,0,0,0,9
North Melbourne,"Wood, Mason",19,6,4,13,1,1,0,6
North Melbourne,"Ziebell, Jack",24,19,1,5,1,0,0,9
North Melbourne,"Anderson, Jed",11,7,4,4,1,0,0,2
North Melbourne,"Atley, Shaun",18,12,6,6,0,0,0,1
North Melbourne,"Brown, Ben",14,8,5,6,4,0,3,3
North Melbourne,"Clarke, Ryan",21,11,2,10,0,0,0,0
North Melbourne,"Cunnington, Ben",19,7,1,12,0,0,0,5
North Melbourne,"Dumont, Trent",21,11,3,10,1,0,1,4
North Melbourne,"Firrito, Michael",12,5,2,7,0,0,0,2
North Melbourne,"Gibson, Sam",29,16,7,13,1,1,0,2
North Melbourne,"Goldstein, Todd",11,3,1,8,1,0,65,2
North Melbourne,"Harvey, Brent",20,15,3,5,0,2,0,1
North Melbourne,"Macmillan, Jamie",23,16,3,7,0,0,0,4
North Melbourne,"McKenzie, Brad",8,6,2,2,0,0,0,0
North Melbourne,"Mullett, Aaron",12,8,1,4,0,0,0,2
North Melbourne,"Petrie, Drew",12,8,5,4,0,2,0,0
North Melbourne,"Ray, Farren",6,4,2,2,0,0,0,1
North Melbourne,"Swallow, Andrew",25,7,5,18,0,0,0,6
North Melbourne,"Tarrant, Robbie",14,11,7,3,0,0,0,2
North Melbourne,"Thomas, Lindsay",9,7,1,2,2,0,0,4
North Melbourne,"Thompson, Scott",14,12,7,2,0,0,0,1
North Melbourne,"Wagner, Corey",7,2,2,5,0,0,0,3
North Melbourne,"Wood, Mason",7,6,4,1,1,1,0,3
North Melbourne,"Ziebell, Jack",21,15,3,6,0,0,0,12
North Melbourne,"Anderson, Jed",13,9,1,4,1,1,0,4
North Melbourne,"Atley, Shaun",19,12,3,7,0,0,0,0
North Melbourne,"Brown, Ben",16,11,10,5,3,1,3,2
North Melbourne,"Clarke, Ryan",22,7,1,15,0,2,0,3
North Melbourne,"Cunnington, Ben",20,5,2,15,0,0,0,2
North Melbourne,"Dal Santo, Nick",28,7,0,21,0,0,0,3
North Melbourne,"Firrito, Michael",13,8,7,5,0,0,0,2
North Melbourne,"Gibson, Sam",19,8,4,11,0,1,0,1
North Melbourne,"Goldstein, Todd",12,2,2,10,0,0,30,4
North Melbourne,"Harvey, Brent",29,14,3,15,2,0,0,1
North Melbourne,"Macmillan, Jamie",18,5,2,13,1,0,0,1
North Melbourne,"McKenzie, Brad",17,13,2,4,0,0,0,1
North Melbourne,"Mullett, Aaron",13,10,1,3,0,0,0,0
North Melbourne,"Petrie, Drew",11,7,5,4,0,2,2,2
North Melbourne,"Swallow, Andrew",24,5,1,19,0,1,0,4
North Melbourne,"Tarrant, Robbie",17,11,6,6,0,0,0,4
North Melbourne,"Thomas, Lindsay",14,9,5,5,3,3,0,2
North Melbourne,"Thompson, Scott",8,3,2,5,0,0,0,3
North Melbourne,"Wagner, Corey",5,3,2,2,0,0,0,3
North Melbourne,"Waite, Jarrad",11,8,3,3,0,2,0,4
North Melbourne,"Wells, Daniel",22,7,4,15,0,1,0,1
North Melbourne,"Ziebell, Jack",23,13,4,10,0,0,0,2
North Melbourne,"Anderson, Jed",12,7,2,5,0,1,0,1
North Melbourne,"Atley, Shaun",16,8,2,8,0,0,0,2
North Melbourne,"Brown, Ben",11,7,2,4,2,0,0,3
North Melbourne,"Clarke, Ryan",27,8,4,19,0,1,0,2
North Melbourne,"Cunnington, Ben",21,6,5,15,0,0,0,3
North Melbourne,"Dal Santo, Nick",29,10,3,19,0,1,0,5
North Melbourne,"Daw, Majak",7,5,3,2,0,1,11,5
North Melbourne,"Dumont, Trent",15,6,3,9,2,0,1,6
North Melbourne,"Firrito, Michael",11,9,2,2,0,0,0,1
North Melbourne,"Gibson, Sam",33,16,7,17,1,1,0,2
North Melbourne,"Goldstein, Todd",13,3,1,10,1,0,21,2
North Melbourne,"Harvey, Brent",25,15,2,10,2,2,0,3
North Melbourne,"Macmillan, Jamie",19,13,8,6,1,0,0,3
North Melbourne,"McKenzie, Brad",19,11,5,8,0,0,0,3
North Melbourne,"Mullett, Aaron",10,6,0,4,0,0,0,4
North Melbourne,"Petrie, Drew",14,10,7,4,2,2,0,7
North Melbourne,"Swallow, Andrew",19,5,2,14,0,0,0,2
North Melbourne,"Tarrant, Robbie",19,13,9,6,0,0,0,2
North Melbourne,"Thomas, Lindsay",15,11,2,4,5,2,0,3
North Melbourne,"Thompson, Scott",15,7,5,8,0,0,0,3
North Melbourne,"Wells, Daniel",29,18,7,11,0,0,0,2
North Melbourne,"Ziebell, Jack",20,12,7,8,2,2,1,1
North Melbourne,"Anderson, Jed",7,4,1,3,0,1,0,6
North Melbourne,"Atley, Shaun",15,8,3,7,0,0,0,2
North Melbourne,"Brown, Ben",11,9,4,2,3,1,0,0
North Melbourne,"Clarke, Ryan",11,2,2,9,0,0,0,0
North Melbourne,"Cunnington, Ben",26,9,2,17,0,0,0,4
North Melbourne,"Dal Santo, Nick",26,16,6,10,0,0,0,3
North Melbourne,"Dumont, Trent",16,9,2,7,1,0,0,6
North Melbourne,"Firrito, Michael",10,5,4,5,0,0,0,1
North Melbourne,"Gibson, Sam",28,14,6,14,0,0,0,3
North Melbourne,"Goldstein, Todd",14,6,4,8,0,1,36,3
North Melbourne,"Harvey, Brent",24,13,5,11,1,1,0,2
North Melbourne,"Macmillan, Jamie",31,16,8,15,1,1,0,2
North Melbourne,"McKenzie, Brad",23,15,9,8,0,0,0,0
North Melbourne,"Mullett, Aaron",13,5,3,8,1,1,0,4
North Melbourne,"Petrie, Drew",18,11,12,7,2,1,3,0
North Melbourne,"Swallow, Andrew",18,5,4,13,0,1,0,6
North Melbourne,"Tarrant, Robbie",15,10,6,5,0,0,0,4
North Melbourne,"Thomas, Lindsay",8,7,2,1,1,2,0,3
North Melbourne,"Thompson, Scott",10,8,6,2,0,0,0,2
North Melbourne,"Waite, Jarrad",10,6,2,4,2,0,0,3
North Melbourne,"Wells, Daniel",24,12,3,12,0,0,0,3
North Melbourne,"Ziebell, Jack",13,8,2,5,0,1,0,5
North Melbourne,"Anderson, Jed",16,7,5,9,0,1,0,3
North Melbourne,"Atley, Shaun",21,11,7,10,0,0,0,3
North Melbourne,"Brown, Ben",6,5,3,1,1,0,1,0
North Melbourne,"Clarke, Ryan",17,7,3,10,0,1,0,6
North Melbourne,"Cunnington, Ben",27,10,5,17,0,0,0,5
North Melbourne,"Dal Santo, Nick",29,13,6,16,0,0,0,0
North Melbourne,"Daw, Majak",10,5,3,5,1,0,6,1
North Melbourne,"Dumont, Trent",19,9,7,10,0,0,0,8
North Melbourne,"Firrito, Michael",14,4,6,10,0,0,0,1
North Melbourne,"Gibson, Sam",28,15,5,13,0,0,0,0
North Melbourne,"Goldstein, Todd",19,8,5,11,1,0,35,3
North Melbourne,"Harvey, Brent",20,12,5,8,1,0,0,3
North Melbourne,"Macmillan, Jamie",30,16,8,14,0,0,0,0
North Melbourne,"McKenzie, Brad",19,15,6,4,0,0,0,4
North Melbourne,"Mullett, Aaron",17,12,7,5,0,1,0,1
North Melbourne,"Petrie, Drew",10,6,2,4,0,2,1,2
North Melbourne,"Swallow, Andrew",25,9,3,16,0,0,0,5
North Melbourne,"Tarrant, Robbie",18,12,7,6,0,0,0,3
North Melbourne,"Thomas, Lindsay",11,7,5,4,1,0,0,3
North Melbourne,"Thompson, Scott",17,12,5,5,0,0,0,1
North Melbourne,"Wells, Daniel",26,15,5,11,1,0,0,3
North Melbourne,"Ziebell, Jack",22,15,3,7,1,0,1,3
North Melbourne,"Anderson, Jed",12,5,2,7,0,0,0,6
North Melbourne,"Atley, Shaun",17,10,4,7,0,0,0,0
North Melbourne,"Clarke, Ryan",7,0,0,7,0,0,0,2
North Melbourne,"Cunnington, Ben",18,8,4,10,0,0,0,3
North Melbourne,"Dal Santo, Nick",23,9,1,14,0,0,0,2
North Melbourne,"Daw, Majak",11,6,7,5,0,3,5,4
North Melbourne,"Dumont, Trent",18,8,0,10,0,0,0,1
North Melbourne,"Firrito, Michael",11,8,4,3,0,0,0,0
North Melbourne,"Gibson, Sam",21,14,6,7,2,0,0,4
North Melbourne,"Goldstein, Todd",7,4,3,3,1,0,38,2
North Melbourne,"Hansen, Lachlan",15,10,6,5,0,0,0,6
North Melbourne,"Harvey, Brent",20,12,5,8,0,0,0,3
North Melbourne,"Macmillan, Jamie",13,10,5,3,0,0,0,2
North Melbourne,"McKenzie, Brad",7,5,4,2,0,0,0,3
North Melbourne,"Mullett, Aaron",9,5,2,4,0,0,0,3
North Melbourne,"Nahas, Robin",14,6,4,8,1,0,0,2
North Melbourne,"Petrie, Drew",13,10,6,3,3,1,0,2
North Melbourne,"Swallow, Andrew",29,17,7,12,0,1,0,7
North Melbourne,"Tarrant, Robbie",19,16,10,3,0,0,0,6
North Melbourne,"Thomas, Lindsay",16,8,1,8,1,0,0,2
North Melbourne,"Wells, Daniel",14,8,3,6,0,0,0,2
North Melbourne,"Ziebell, Jack",22,16,4,6,0,1,2,2
North Melbourne,"Anderson, Jed",8,2,0,6,0,0,0,2
North Melbourne,"Atley, Shaun",19,12,5,7,0,0,0,1
North Melbourne,"Brown, Ben",11,8,7,3,2,1,0,1
North Melbourne,"Cunnington, Ben",22,9,4,13,0,1,0,8
North Melbourne,"Dal Santo, Nick",31,17,7,14,2,0,0,2
North Melbourne,"Daw, Majak",9,3,1,6,0,2,3,0
North Melbourne,"Dumont, Trent",18,7,5,11,0,0,0,3
North Melbourne,"Firrito, Michael",12,7,4,5,0,0,0,1
North Melbourne,"Gibson, Sam",24,11,6,13,0,0,0,2
North Melbourne,"Goldstein, Todd",13,6,3,7,1,1,25,0
North Melbourne,"Hansen, Lachlan",15,6,3,9,0,1,0,6
North Melbourne,"Harvey, Brent",32,16,6,16,3,2,0,5
North Melbourne,"Macmillan, Jamie",31,21,11,10,0,0,0,2
North Melbourne,"McKenzie, Brad",18,12,3,6,1,0,0,3
North Melbourne,"Mullett, Aaron",14,8,4,6,0,0,0,4
North Melbourne,"Petrie, Drew",14,9,4,5,1,2,0,2
North Melbourne,"Swallow, Andrew",27,9,2,18,0,0,0,14
North Melbourne,"Tarrant, Robbie",18,10,7,8,0,0,0,1
North Melbourne,"Thomas, Lindsay",15,12,1,3,0,2,0,4
North Melbourne,"Thompson, Scott",1,0,0,1,0,0,0,0
North Melbourne,"Wells, Daniel",31,17,6,14,0,0,0,4
North Melbourne,"Ziebell, Jack",25,18,5,7,0,2,0,6
North Melbourne,"Anderson, Jed",11,6,1,5,0,0,0,5
North Melbourne,"Atley, Shaun",25,7,2,18,0,0,0,2
North Melbourne,"Brown, Ben",11,7,6,4,3,2,0,0
North Melbourne,"Cunnington, Ben",14,3,0,11,1,0,1,2
North Melbourne,"Dal Santo, Nick",25,8,3,17,0,0,0,2
North Melbourne,"Daw, Majak",10,8,7,2,1,1,8,1
North Melbourne,"Dumont, Trent",13,7,7,6,0,0,0,2
North Melbourne,"Firrito, Michael",20,10,6,10,0,0,0,0
North Melbourne,"Gibson, Sam",29,13,10,16,0,1,0,3
North Melbourne,"Goldstein, Todd",13,5,5,8,0,0,24,4
North Melbourne,"Hansen, Lachlan",17,11,7,6,0,0,0,0
North Melbourne,"Harvey, Brent",26,15,6,11,2,1,0,1
North Melbourne,"Higgins, Shaun",14,6,6,8,0,0,0,3
North Melbourne,"Macmillan, Jamie",5,4,0,1,0,0,0,1
North Melbourne,"McDonald, Luke",21,13,6,8,1,0,0,1
North Melbourne,"Mullett, Aaron",28,19,6,9,0,0,0,2
North Melbourne,"Petrie, Drew",4,3,2,1,0,0,1,1
North Melbourne,"Swallow, Andrew",16,5,3,11,0,0,0,7
North Melbourne,"Tarrant, Robbie",18,14,6,4,0,0,0,1
North Melbourne,"Thomas, Lindsay",10,6,2,4,0,1,0,4
North Melbourne,"Wells, Daniel",22,9,2,13,0,1,0,3
North Melbourne,"Ziebell, Jack",24,15,6,9,1,0,1,4
North Melbourne,"Anderson, Jed",12,9,4,3,0,0,0,3
North Melbourne,"Atley, Shaun",15,3,0,12,0,0,0,0
North Melbourne,"Brown, Ben",5,4,3,1,0,0,0,1
North Melbourne,"Cunnington, Ben",21,8,2,13,0,0,0,6
North Melbourne,"Dal Santo, Nick",29,8,1,21,0,0,0,1
North Melbourne,"Daw, Majak",7,5,4,2,4,1,4,2
North Melbourne,"Dumont, Trent",12,9,4,3,0,1,0,1
North Melbourne,"Firrito, Michael",19,8,5,11,0,0,0,0
North Melbourne,"Gibson, Sam",17,11,3,6,0,0,0,1
North Melbourne,"Goldstein, Todd",15,7,3,8,2,0,33,4
North Melbourne,"Hansen, Lachlan",10,3,3,7,0,0,0,3
North Melbourne,"Harvey, Brent",25,17,6,8,0,2,0,0
North Melbourne,"Higgins, Shaun",15,7,5,8,2,0,0,3
North Melbourne,"Macmillan, Jamie",15,9,4,6,0,0,0,0
North Melbourne,"McDonald, Luke",16,7,3,9,0,0,0,2
North Melbourne,"Mullett, Aaron",17,9,1,8,0,0,0,1
North Melbourne,"Petrie, Drew",6,2,3,4,0,1,1,3
North Melbourne,"Swallow, Andrew",19,4,3,15,0,0,0,7
North Melbourne,"Tarrant, Robbie",14,8,3,6,0,0,0,0
North Melbourne,"Thomas, Lindsay",14,10,3,4,3,1,0,1
North Melbourne,"Wells, Daniel",25,9,0,16,0,0,0,2
North Melbourne,"Ziebell, Jack",22,14,4,8,1,0,3,2
Port Adelaide,"Ah Chee, Brendon",12,4,2,8,1,0,0,5
Port Adelaide,"Boak, Travis",17,8,2,9,1,0,0,3
Port Adelaide,"Broadbent, Matthew",26,14,1,12,1,0,0,4
Port Adelaide,"Carlile, Alipate",10,5,2,5,0,0,0,3
Port Adelaide,"Dixon, Charlie",11,8,3,3,3,3,0,5
Port Adelaide,"Ebert, Brad",25,17,4,8,3,0,0,8
Port Adelaide,"Gray, Robbie",26,14,4,12,4,2,0,5
Port Adelaide,"Gray, Sam",37,18,5,19,0,1,0,3
Port Adelaide,"Hartlett, Hamish",24,16,5,8,0,2,0,9
Port Adelaide,"Hombsch, Jack",8,5,2,3,0,0,0,3
Port Adelaide,"Impey, Jarman",5,4,0,1,0,0,0,8
Port Adelaide,"Jonas, Tom",16,10,3,6,0,0,0,5
Port Adelaide,"Lobbe, Matthew",9,2,2,7,0,0,42,7
Port Adelaide,"Neade, Jake",9,2,0,7,0,0,0,8
Port Adelaide,"Pittard, Jasper",27,19,6,8,0,0,0,1
Port Adelaide,"Polec, Jared",19,13,2,6,0,1,0,3
Port Adelaide,"Schulz, Jay",17,8,6,9,1,1,0,2
Port Adelaide,"Trengove, Jackson",19,12,6,7,0,0,4,2
Port Adelaide,"Westhoff, Justin",17,11,6,6,2,2,3,6
Port Adelaide,"White, Matt",2,2,0,0,0,0,0,2
Port Adelaide,"Wines, Ollie",24,12,1,12,1,0,0,5
Port Adelaide,"Wingard, Chad",21,13,2,8,3,0,0,9
Port Adelaide,"Ah Chee, Brendon",15,5,1,10,0,1,3,9
Port Adelaide,"Boak, Travis",23,14,2,9,2,3,0,4
Port Adelaide,"Broadbent, Matthew",12,8,1,4,0,1,0,4
Port Adelaide,"Carlile, Alipate",12,5,1,7,0,1,0,2
Port Adelaide,"Dixon, Charlie",8,2,3,6,0,1,0,1
Port Adelaide,"Ebert, Brad",17,12,3,5,0,0,3,5
Port Adelaide,"Gray, Robbie",37,20,4,17,1,3,0,5
Port Adelaide,"Gray, Sam",20,13,1,7,0,1,0,3
Port Adelaide,"Hombsch, Jack",9,4,2,5,0,0,0,4
Port Adelaide,"Howard, Dougal",9,4,0,5,1,1,4,4
Port Adelaide,"Impey, Jarman",9,3,4,6,0,0,0,2
Port Adelaide,"Jonas, Tom",11,6,2,5,0,1,0,3
Port Adelaide,"Lobbe, Matthew",8,6,1,2,0,1,38,2
Port Adelaide,"Neade, Jake",16,5,0,11,0,1,0,2
Port Adelaide,"Pittard, Jasper",20,14,4,6,0,0,0,2
Port Adelaide,"Polec, Jared",5,4,0,1,0,0,0,0
Port Adelaide,"Toumpas, Jimmy",17,4,2,13,0,0,0,4
Port Adelaide,"Trengove, Jackson",9,4,3,5,0,1,0,2
Port Adelaide,"Westhoff, Justin",9,5,5,4,0,1,0,3
Port Adelaide,"Wines, Ollie",27,19,3,8,2,0,4,7
Port Adelaide,"Wingard, Chad",10,6,0,4,1,0,0,0
Port Adelaide,"Young, Aaron",21,12,2,9,4,2,2,2
Port Adelaide,"Ah Chee, Brendon",20,5,3,15,0,0,2,4
Port Adelaide,"Amon, Karl",13,11,5,2,2,0,0,2
Port Adelaide,"Boak, Travis",22,9,2,13,1,1,0,4
Port Adelaide,"Broadbent, Matthew",27,14,8,13,0,0,0,1
Port Adelaide,"Byrne-Jones, Darcy",14,7,1,7,1,0,0,1
Port Adelaide,"Dixon, Charlie",12,10,5,2,3,2,0,0
Port Adelaide,"Ebert, Brad",18,9,4,9,1,2,7,6
Port Adelaide,"Gray, Robbie",30,11,1,19,2,1,0,2
Port Adelaide,"Gray, Sam",20,12,6,8,0,0,0,5
Port Adelaide,"Hombsch, Jack",11,8,6,3,0,0,0,0
Port Adelaide,"Impey, Jarman",14,5,3,9,0,0,0,1
Port Adelaide,"Jonas, Tom",16,8,5,8,0,0,0,5
Port Adelaide,"Lobbe, Matthew",7,5,2,2,0,0,27,4
Port Adelaide,"Neade, Jake",15,5,2,10,0,1,0,3
Port Adelaide,"Pittard, Jasper",29,20,9,9,0,0,0,2
Port Adelaide,"Polec, Jared",23,13,4,10,1,0,0,6
Port Adelaide,"Stewart, Paul",10,3,2,7,0,0,0,4
Port Adelaide,"Toumpas, Jimmy",28,12,5,16,0,1,0,1
Port Adelaide,"Trengove, Jackson",7,3,2,4,0,0,0,0
Port Adelaide,"Westhoff, Justin",14,9,7,5,2,1,4,2
Port Adelaide,"Wines, Ollie",25,4,1,21,1,0,3,9
Port Adelaide,"Young, Aaron",18,9,4,9,3,1,0,2
Port Adelaide,"Ah Chee, Brendon",20,7,5,13,0,0,0,3
Port Adelaide,"Amon, Karl",11,9,2,2,0,2,0,1
Port Adelaide,"Boak, Travis",23,11,6,12,0,0,0,6
Port Adelaide,"Broadbent, Matthew",14,8,7,6,0,0,0,2
Port Adelaide,"Byrne-Jones, Darcy",21,10,5,11,1,0,0,3
Port Adelaide,"Dixon, Charlie",8,5,7,3,1,2,4,0
Port Adelaide,"Ebert, Brad",18,9,5,9,0,0,0,4
Port Adelaide,"Gray, Robbie",24,10,1,14,0,2,0,3
Port Adelaide,"Gray, Sam",16,8,1,8,0,0,0,3
Port Adelaide,"Hartlett, Hamish",15,10,3,5,0,0,0,6
Port Adelaide,"Hombsch, Jack",21,14,14,7,0,0,0,1
Port Adelaide,"Jonas, Tom",11,5,4,6,0,0,0,0
Port Adelaide,"Lobbe, Matthew",8,2,3,6,0,0,23,4
Port Adelaide,"Neade, Jake",7,4,3,3,2,0,0,2
Port Adelaide,"Pittard, Jasper",32,18,4,14,0,0,0,0
Port Adelaide,"Polec, Jared",19,11,2,8,0,0,0,1
Port Adelaide,"Toumpas, Jimmy",10,5,3,5,0,0,0,2
Port Adelaide,"Trengove, Jackson",9,4,2,5,0,0,0,3
Port Adelaide,"Westhoff, Justin",21,12,9,9,1,0,3,0
Port Adelaide,"Wines, Ollie",25,11,4,14,0,0,8,5
Port Adelaide,"Wingard, Chad",14,10,1,4,2,2,0,1
Port Adelaide,"Young, Aaron",9,4,1,5,2,0,0,1
Port Adelaide,"Amon, Karl",5,3,1,2,1,0,0,6
Port Adelaide,"Boak, Travis",26,12,1,14,0,0,0,5
Port Adelaide,"Broadbent, Matthew",22,10,4,12,1,0,0,3
Port Adelaide,"Byrne-Jones, Darcy",26,16,2,10,0,0,0,2
Port Adelaide,"Dixon, Charlie",9,5,3,4,3,0,0,0
Port Adelaide,"Ebert, Brad",16,11,2,5,1,1,0,4
Port Adelaide,"Gray, Robbie",11,7,2,4,0,0,0,7
Port Adelaide,"Gray, Sam",16,6,2,10,0,0,0,7
Port Adelaide,"Hartlett, Hamish",11,2,1,9,0,0,0,6
Port Adelaide,"Hombsch, Jack",6,3,0,3,0,0,0,3
Port Adelaide,"Jonas, Tom",11,7,6,4,0,0,0,0
Port Adelaide,"Lobbe, Matthew",8,3,0,5,0,0,27,6
Port Adelaide,"Neade, Jake",11,6,2,5,0,1,0,5
Port Adelaide,"OShea, Cameron",10,4,1,6,0,0,0,2
Port Adelaide,"Pittard, Jasper",25,18,2,7,0,0,0,3
Port Adelaide,"Stewart, Paul",11,7,5,4,0,0,0,0
Port Adelaide,"Toumpas, Jimmy",21,10,2,11,0,0,0,4
Port Adelaide,"Trengove, Jackson",12,4,2,8,0,0,1,0
Port Adelaide,"Westhoff, Justin",8,3,2,5,0,1,0,3
Port Adelaide,"Wines, Ollie",24,10,0,14,2,2,0,10
Port Adelaide,"Wingard, Chad",7,2,2,5,0,0,0,3
Port Adelaide,"Young, Aaron",13,4,3,9,0,1,0,2
Port Adelaide,"Ah Chee, Brendon",15,9,4,6,0,1,0,7
Port Adelaide,"Boak, Travis",22,14,3,8,1,0,1,4
Port Adelaide,"Broadbent, Matthew",25,15,3,10,1,2,0,2
Port Adelaide,"Byrne-Jones, Darcy",16,10,4,6,0,0,0,3
Port Adelaide,"Dixon, Charlie",14,5,5,9,2,1,7,3
Port Adelaide,"Ebert, Brad",16,9,3,7,0,2,1,7
Port Adelaide,"Gray, Sam",16,9,3,7,0,3,0,7
Port Adelaide,"Hartlett, Hamish",22,11,4,11,0,1,1,4
Port Adelaide,"Hombsch, Jack",12,8,4,4,0,0,0,5
Port Adelaide,"Howard, Dougal",8,6,2,2,0,0,8,4
Port Adelaide,"Impey, Jarman",13,8,6,5,3,0,0,4
Port Adelaide,"Jonas, Tom",13,6,2,7,0,0,0,3
Port Adelaide,"Krakouer, Nathan",14,9,5,5,1,0,0,5
Port Adelaide,"Neade, Jake",6,5,1,1,2,0,0,4
Port Adelaide,"OShea, Cameron",20,12,5,8,0,0,0,3
Port Adelaide,"Pittard, Jasper",20,13,6,7,0,0,0,4
Port Adelaide,"Polec, Jared",23,15,6,8,0,0,0,4
Port Adelaide,"Stewart, Paul",14,8,3,6,0,0,0,3
Port Adelaide,"Toumpas, Jimmy",14,8,5,6,0,0,0,8
Port Adelaide,"Westhoff, Justin",21,14,8,7,1,2,5,3
Port Adelaide,"Wines, Ollie",20,8,4,12,0,1,1,7
Port Adelaide,"Young, Aaron",11,4,5,7,2,0,0,5
Port Adelaide,"Ah Chee, Brendon",18,7,4,11,0,1,0,5
Port Adelaide,"Boak, Travis",31,11,2,20,0,0,0,7
Port Adelaide,"Broadbent, Matthew",19,13,3,6,1,1,0,7
Port Adelaide,"Byrne-Jones, Darcy",22,9,3,13,0,0,0,2
Port Adelaide,"Dixon, Charlie",16,7,4,9,5,0,2,0
Port Adelaide,"Ebert, Brad",19,9,4,10,1,0,2,9
Port Adelaide,"Hartlett, Hamish",24,13,5,11,0,1,0,6
Port Adelaide,"Hombsch, Jack",10,7,1,3,0,0,0,4
Port Adelaide,"Impey, Jarman",10,4,2,6,1,1,0,7
Port Adelaide,"Jonas, Tom",16,7,3,9,0,0,0,2
Port Adelaide,"Krakouer, Nathan",12,7,2,5,0,0,0,1
Port Adelaide,"Neade, Jake",13,8,1,5,1,0,0,4
Port Adelaide,"OShea, Cameron",9,8,3,1,0,0,0,2
Port Adelaide,"Pittard, Jasper",30,17,6,13,1,0,0,2
Port Adelaide,"Polec, Jared",24,18,4,6,1,0,0,5
Port Adelaide,"Stewart, Paul",12,11,4,1,0,0,0,1
Port Adelaide,"Toumpas, Jimmy",22,13,2,9,0,0,0,5
Port Adelaide,"Trengove, Jackson",25,10,2,15,0,0,14,6
Port Adelaide,"Westhoff, Justin",19,12,6,7,3,0,5,2
Port Adelaide,"Wines, Ollie",30,17,2,13,1,2,1,6
Port Adelaide,"Wingard, Chad",16,11,3,5,3,2,0,0
Port Adelaide,"Young, Aaron",18,8,0,10,3,0,0,3
Port Adelaide,"Ah Chee, Brendon",8,2,2,6,0,0,0,2
Port Adelaide,"Amon, Karl",22,12,2,10,1,0,0,1
Port Adelaide,"Boak, Travis",12,4,0,8,1,1,0,5
Port Adelaide,"Broadbent, Matthew",15,10,5,5,1,1,0,4
Port Adelaide,"Byrne-Jones, Darcy",8,6,0,2,0,0,0,3
Port Adelaide,"Dixon, Charlie",13,5,3,8,2,1,3,1
Port Adelaide,"Ebert, Brad",14,6,2,8,1,0,0,9
Port Adelaide,"Hartlett, Hamish",26,15,7,11,1,0,0,7
Port Adelaide,"Hombsch, Jack",10,9,5,1,0,0,0,1
Port Adelaide,"Impey, Jarman",9,4,3,5,0,0,0,1
Port Adelaide,"Jonas, Tom",7,4,1,3,0,0,0,2
Port Adelaide,"Krakouer, Nathan",8,7,4,1,0,0,0,1
Port Adelaide,"Neade, Jake",11,7,3,4,0,1,0,3
Port Adelaide,"OShea, Cameron",8,4,0,4,0,0,0,2
Port Adelaide,"Pittard, Jasper",15,10,2,5,0,2,0,1
Port Adelaide,"Polec, Jared",18,13,2,5,0,1,0,2
Port Adelaide,"Stewart, Paul",11,7,5,4,0,0,0,2
Port Adelaide,"Trengove, Jackson",20,12,3,8,1,0,16,6
Port Adelaide,"Westhoff, Justin",14,11,3,3,2,2,3,5
Port Adelaide,"Wines, Ollie",29,9,4,20,0,1,5,3
Port Adelaide,"Wingard, Chad",11,7,1,4,2,1,0,2
Port Adelaide,"Young, Aaron",17,7,1,10,1,2,0,3
Port Adelaide,"Amon, Karl",13,6,3,7,0,0,0,9
Port Adelaide,"Boak, Travis",26,10,1,16,0,0,0,2
Port Adelaide,"Broadbent, Matthew",20,12,2,8,0,0,0,7
Port Adelaide,"Byrne-Jones, Darcy",12,7,2,5,0,0,0,3
Port Adelaide,"Dixon, Charlie",20,11,9,9,2,1,0,0
Port Adelaide,"Ebert, Brad",22,7,4,15,1,0,0,7
Port Adelaide,"Gray, Robbie",28,11,1,17,0,1,0,10
Port Adelaide,"Hartlett, Hamish",15,9,4,6,1,0,0,3
Port Adelaide,"Hombsch, Jack",12,6,4,6,0,0,0,0
Port Adelaide,"Impey, Jarman",8,8,2,0,0,2,0,1
Port Adelaide,"Jonas, Tom",13,10,6,3,0,0,0,0
Port Adelaide,"Krakouer, Nathan",21,17,2,4,0,0,0,2
Port Adelaide,"Neade, Jake",13,7,5,6,0,0,0,3
Port Adelaide,"OShea, Cameron",14,8,8,6,0,0,0,3
Port Adelaide,"Pittard, Jasper",21,18,4,3,0,0,0,5
Port Adelaide,"Polec, Jared",24,9,4,15,1,0,0,8
Port Adelaide,"Stewart, Paul",15,9,5,6,0,0,0,3
Port Adelaide,"Trengove, Jackson",15,6,0,9,0,0,13,11
Port Adelaide,"Westhoff, Justin",15,9,5,6,1,0,1,8
Port Adelaide,"Wines, Ollie",24,9,4,15,0,1,1,4
Port Adelaide,"Wingard, Chad",20,12,5,8,3,1,0,3
Port Adelaide,"Young, Aaron",21,13,6,8,4,1,0,6
Port Adelaide,"Amon, Karl",14,10,3,4,0,0,0,1
Port Adelaide,"Boak, Travis",24,10,5,14,1,0,0,4
Port Adelaide,"Byrne-Jones, Darcy",23,18,8,5,1,0,0,1
Port Adelaide,"Dixon, Charlie",12,5,5,7,5,0,1,1
Port Adelaide,"Ebert, Brad",20,10,5,10,0,1,0,8
Port Adelaide,"Gray, Robbie",28,11,6,17,1,0,0,5
Port Adelaide,"Gray, Sam",20,11,6,9,0,0,0,9
Port Adelaide,"Hartlett, Hamish",19,10,6,9,1,0,0,2
Port Adelaide,"Hombsch, Jack",13,9,7,4,0,0,0,0
Port Adelaide,"Howard, Dougal",13,7,3,6,1,2,3,3
Port Adelaide,"Impey, Jarman",11,7,3,4,2,0,0,3
Port Adelaide,"Krakouer, Nathan",12,10,4,2,1,0,0,2
Port Adelaide,"Neade, Jake",13,7,1,6,1,0,0,4
Port Adelaide,"OShea, Cameron",11,7,2,4,0,0,0,1
Port Adelaide,"Pittard, Jasper",22,15,6,7,0,0,0,1
Port Adelaide,"Polec, Jared",12,5,2,7,0,1,0,2
Port Adelaide,"Stewart, Paul",10,1,0,9,0,0,0,2
Port Adelaide,"Trengove, Jackson",12,7,1,5,0,0,10,2
Port Adelaide,"Westhoff, Justin",23,11,8,12,0,0,4,0
Port Adelaide,"Wines, Ollie",22,5,4,17,0,0,2,2
Port Adelaide,"Wingard, Chad",26,17,4,9,2,4,0,5
Port Adelaide,"Young, Aaron",17,11,3,6,2,2,0,3
Port Adelaide,"Austin, Logan",10,7,5,3,0,0,0,0
Port Adelaide,"Boak, Travis",25,14,4,11,1,1,0,4
Port Adelaide,"Broadbent, Matthew",16,14,6,2,0,0,0,3
Port Adelaide,"Byrne-Jones, Darcy",20,11,5,9,0,1,0,4
Port Adelaide,"Dixon, Charlie",14,6,3,8,0,2,1,4
Port Adelaide,"Ebert, Brad",17,11,5,6,0,2,0,7
Port Adelaide,"Gray, Robbie",26,8,3,18,1,0,0,3
Port Adelaide,"Gray, Sam",18,11,7,7,1,0,0,4
Port Adelaide,"Hartlett, Hamish",18,9,1,9,1,1,0,2
Port Adelaide,"Howard, Dougal",6,4,3,2,0,0,2,2
Port Adelaide,"Impey, Jarman",22,18,8,4,1,0,0,1
Port Adelaide,"Krakouer, Nathan",11,10,3,1,0,0,0,0
Port Adelaide,"Neade, Jake",15,9,3,6,4,0,0,4
Port Adelaide,"OShea, Cameron",14,9,2,5,0,0,0,1
Port Adelaide,"Pittard, Jasper",23,20,6,3,0,1,0,3
Port Adelaide,"Polec, Jared",20,9,2,11,1,0,0,5
Port Adelaide,"Stewart, Paul",10,6,3,4,0,0,0,2
Port Adelaide,"Trengove, Jackson",12,3,0,9,1,0,6,3
Port Adelaide,"Westhoff, Justin",27,13,4,14,1,0,1,2
Port Adelaide,"Wines, Ollie",24,13,0,11,0,1,1,6
Port Adelaide,"Wingard, Chad",19,12,3,7,3,1,0,3
Port Adelaide,"Young, Aaron",24,13,5,11,4,1,0,2
Port Adelaide,"Austin, Logan",13,12,7,1,0,0,0,4
Port Adelaide,"Boak, Travis",24,15,1,9,1,1,0,3
Port Adelaide,"Broadbent, Matthew",20,15,5,5,0,1,0,2
Port Adelaide,"Byrne-Jones, Darcy",14,6,5,8,0,0,0,6
Port Adelaide,"Dixon, Charlie",14,4,3,10,2,0,0,1
Port Adelaide,"Ebert, Brad",23,10,6,13,1,0,0,5
Port Adelaide,"Gray, Robbie",32,19,3,13,1,1,0,4
Port Adelaide,"Gray, Sam",14,9,2,5,0,0,0,11
Port Adelaide,"Hartlett, Hamish",15,5,4,10,0,0,0,3
Port Adelaide,"Howard, Dougal",9,6,6,3,1,1,7,1
Port Adelaide,"Impey, Jarman",8,5,2,3,1,0,0,8
Port Adelaide,"Krakouer, Nathan",13,12,4,1,0,1,0,8
Port Adelaide,"Neade, Jake",17,10,4,7,2,0,0,3
Port Adelaide,"OShea, Cameron",15,8,3,7,0,0,0,3
Port Adelaide,"Pittard, Jasper",28,22,9,6,0,1,0,1
Port Adelaide,"Polec, Jared",20,11,4,9,0,0,0,3
Port Adelaide,"Stewart, Paul",10,6,3,4,0,0,0,3
Port Adelaide,"Trengove, Jackson",16,6,2,10,0,1,22,10
Port Adelaide,"Westhoff, Justin",17,8,3,9,0,1,0,4
Port Adelaide,"Wines, Ollie",26,7,4,19,1,0,6,8
Port Adelaide,"Wingard, Chad",15,11,3,4,2,0,0,0
Port Adelaide,"Young, Aaron",22,10,3,12,2,1,0,4
Port Adelaide,"Amon, Karl",15,11,4,4,0,0,0,4
Port Adelaide,"Austin, Logan",5,2,1,3,0,0,0,1
Port Adelaide,"Boak, Travis",20,11,4,9,0,1,0,4
Port Adelaide,"Broadbent, Matthew",17,8,3,9,0,0,0,2
Port Adelaide,"Byrne-Jones, Darcy",14,6,2,8,0,0,0,3
Port Adelaide,"Dixon, Charlie",8,5,3,3,1,2,1,5
Port Adelaide,"Ebert, Brad",28,12,5,16,1,0,0,7
Port Adelaide,"Gray, Robbie",18,9,1,9,0,1,0,7
Port Adelaide,"Gray, Sam",17,7,1,10,0,1,0,8
Port Adelaide,"Hartlett, Hamish",12,7,6,5,0,0,0,1
Port Adelaide,"Howard, Dougal",5,3,0,2,0,0,3,3
Port Adelaide,"Impey, Jarman",10,6,0,4,2,1,0,2
Port Adelaide,"Krakouer, Nathan",16,9,5,7,0,0,0,1
Port Adelaide,"Neade, Jake",13,6,3,7,0,0,0,4
Port Adelaide,"OShea, Cameron",8,6,0,2,0,0,0,6
Port Adelaide,"Pittard, Jasper",23,17,6,6,0,0,0,5
Port Adelaide,"Stewart, Paul",7,4,2,3,0,0,0,1
Port Adelaide,"Trengove, Jackson",15,8,2,7,0,1,28,8
Port Adelaide,"Westhoff, Justin",10,9,4,1,2,0,3,2
Port Adelaide,"Wines, Ollie",19,6,2,13,0,1,3,6
Port Adelaide,"Wingard, Chad",16,12,4,4,3,3,0,1
Port Adelaide,"Young, Aaron",14,5,2,9,0,2,0,2
Port Adelaide,"Amon, Karl",16,12,3,4,1,0,0,2
Port Adelaide,"Austin, Logan",5,3,0,2,0,0,0,1
Port Adelaide,"Boak, Travis",26,17,3,9,2,0,0,11
Port Adelaide,"Broadbent, Matthew",14,9,4,5,2,0,0,6
Port Adelaide,"Byrne-Jones, Darcy",15,13,1,2,0,0,0,2
Port Adelaide,"Clurey, Tom",12,9,2,3,0,0,0,0
Port Adelaide,"Dixon, Charlie",10,5,3,5,1,1,2,4
Port Adelaide,"Ebert, Brad",17,10,0,7,0,0,0,8
Port Adelaide,"Gray, Robbie",24,16,2,8,1,0,0,8
Port Adelaide,"Hartlett, Hamish",14,9,3,5,0,0,0,6
Port Adelaide,"Impey, Jarman",13,8,2,5,1,1,0,2
Port Adelaide,"Krakouer, Nathan",15,13,3,2,0,0,0,1
Port Adelaide,"Mitchell, Kane",24,17,4,7,1,1,0,8
Port Adelaide,"Neade, Jake",9,1,0,8,0,0,0,4
Port Adelaide,"OShea, Cameron",15,10,2,5,0,0,0,3
Port Adelaide,"Pittard, Jasper",13,10,2,3,0,0,0,4
Port Adelaide,"Schulz, Jay",7,4,1,3,0,0,0,5
Port Adelaide,"Trengove, Jackson",20,15,4,5,1,0,13,3
Port Adelaide,"Westhoff, Justin",19,14,6,5,1,1,8,7
Port Adelaide,"Wines, Ollie",27,16,2,11,0,0,2,9
Port Adelaide,"Wingard, Chad",18,14,4,4,2,2,0,2
Port Adelaide,"Young, Aaron",14,8,5,6,1,1,0,10
Port Adelaide,"Amon, Karl",16,9,3,7,2,1,0,2
Port Adelaide,"Austin, Logan",8,5,3,3,0,0,0,1
Port Adelaide,"Boak, Travis",23,11,4,12,0,0,0,6
Port Adelaide,"Broadbent, Matthew",28,14,8,14,0,1,0,5
Port Adelaide,"Byrne-Jones, Darcy",15,9,3,6,0,0,0,1
Port Adelaide,"Clurey, Tom",9,8,4,1,0,0,0,3
Port Adelaide,"Dixon, Charlie",14,9,3,5,0,0,0,1
Port Adelaide,"Ebert, Brad",2,2,1,0,0,0,0,2
Port Adelaide,"Gray, Robbie",29,12,3,17,2,0,0,6
Port Adelaide,"Hartlett, Hamish",22,15,4,7,0,0,0,4
Port Adelaide,"Impey, Jarman",17,8,3,9,0,0,0,3
Port Adelaide,"Krakouer, Nathan",19,16,6,3,0,0,0,3
Port Adelaide,"Mitchell, Kane",17,5,3,12,0,0,0,0
Port Adelaide,"Neade, Jake",8,3,2,5,0,0,0,1
Port Adelaide,"OShea, Cameron",12,7,2,5,0,0,0,2
Port Adelaide,"Pittard, Jasper",20,15,3,5,0,1,0,1
Port Adelaide,"Schulz, Jay",7,3,3,4,2,0,0,0
Port Adelaide,"Trengove, Jackson",14,6,2,8,0,0,15,4
Port Adelaide,"Westhoff, Justin",17,11,4,6,1,0,3,3
Port Adelaide,"Wines, Ollie",25,10,2,15,2,0,6,3
Port Adelaide,"Wingard, Chad",14,6,1,8,3,1,0,0
Port Adelaide,"Young, Aaron",14,7,2,7,0,0,0,4
Port Adelaide,"Ah Chee, Brendon",19,6,4,13,1,0,2,2
Port Adelaide,"Amon, Karl",16,9,3,7,0,0,0,2
Port Adelaide,"Austin, Logan",5,3,0,2,0,0,0,2
Port Adelaide,"Boak, Travis",32,8,4,24,1,0,0,7
Port Adelaide,"Broadbent, Matthew",15,11,3,4,0,0,0,1
Port Adelaide,"Byrne-Jones, Darcy",13,10,3,3,0,0,0,2
Port Adelaide,"Clurey, Tom",10,7,6,3,0,0,0,1
Port Adelaide,"Dixon, Charlie",5,4,2,1,0,0,0,2
Port Adelaide,"Gray, Robbie",35,14,6,21,2,1,0,2
Port Adelaide,"Gray, Sam",14,5,3,9,1,0,0,5
Port Adelaide,"Hartlett, Hamish",21,13,6,8,0,0,0,3
Port Adelaide,"Impey, Jarman",12,5,2,7,0,1,0,2
Port Adelaide,"Mitchell, Kane",16,7,2,9,0,0,0,5
Port Adelaide,"Neade, Jake",7,3,0,4,1,0,0,4
Port Adelaide,"Pittard, Jasper",20,13,4,7,0,0,0,1
Port Adelaide,"Schulz, Jay",10,7,5,3,3,1,0,3
Port Adelaide,"Stewart, Paul",12,7,3,5,0,0,0,2
Port Adelaide,"Trengove, Jackson",22,7,4,15,0,0,15,6
Port Adelaide,"Westhoff, Justin",20,12,5,8,3,1,3,2
Port Adelaide,"Wines, Ollie",23,13,5,10,0,0,4,6
Port Adelaide,"Wingard, Chad",20,13,6,7,2,2,0,3
Port Adelaide,"Young, Aaron",21,11,6,10,2,2,0,3
Port Adelaide,"Ah Chee, Brendon",11,3,3,8,0,0,0,3
Port Adelaide,"Austin, Logan",14,10,3,4,0,0,0,0
Port Adelaide,"Boak, Travis",34,19,2,15,0,0,0,6
Port Adelaide,"Broadbent, Matthew",22,11,4,11,0,0,0,2
Port Adelaide,"Butcher, John",7,2,2,5,0,1,1,1
Port Adelaide,"Byrne-Jones, Darcy",14,9,3,5,0,0,0,1
Port Adelaide,"Clurey, Tom",10,7,4,3,0,0,0,1
Port Adelaide,"Ebert, Brad",19,13,3,6,4,0,0,4
Port Adelaide,"Gray, Robbie",25,18,5,7,3,1,0,2
Port Adelaide,"Gray, Sam",24,8,1,16,0,0,0,13
Port Adelaide,"Hartlett, Hamish",15,11,3,4,0,1,0,5
Port Adelaide,"Impey, Jarman",12,3,1,9,0,0,0,5
Port Adelaide,"Mitchell, Kane",20,15,0,5,0,0,0,2
Port Adelaide,"Pittard, Jasper",28,18,7,10,0,0,0,2
Port Adelaide,"Polec, Jared",18,10,3,8,0,0,0,5
Port Adelaide,"Schulz, Jay",4,2,2,2,1,0,0,2
Port Adelaide,"Stewart, Paul",11,8,2,3,0,0,0,1
Port Adelaide,"Trengove, Jackson",21,8,2,13,0,0,23,4
Port Adelaide,"Westhoff, Justin",12,6,2,6,0,0,4,4
Port Adelaide,"Wines, Ollie",30,17,3,13,0,1,3,4
Port Adelaide,"Wingard, Chad",11,7,2,4,1,1,0,4
Port Adelaide,"Young, Aaron",14,10,3,4,0,0,0,7
Port Adelaide,"Ah Chee, Brendon",14,8,6,6,2,1,0,5
Port Adelaide,"Amon, Karl",15,10,5,5,2,1,0,3
Port Adelaide,"Austin, Logan",9,5,2,4,0,1,0,3
Port Adelaide,"Boak, Travis",24,13,6,11,3,2,0,1
Port Adelaide,"Broadbent, Matthew",16,13,5,3,0,0,0,2
Port Adelaide,"Butcher, John",20,11,11,9,4,2,1,3
Port Adelaide,"Byrne-Jones, Darcy",13,9,5,4,0,0,0,3
Port Adelaide,"Clurey, Tom",10,6,2,4,0,0,0,1
Port Adelaide,"Ebert, Brad",27,15,4,12,2,0,0,4
Port Adelaide,"Gray, Robbie",32,14,2,18,0,1,0,3
Port Adelaide,"Gray, Sam",28,8,3,20,0,0,0,2
Port Adelaide,"Impey, Jarman",11,7,1,4,2,2,0,4
Port Adelaide,"Krakouer, Nathan",19,11,3,8,0,0,0,3
Port Adelaide,"Pittard, Jasper",9,4,1,5,0,0,0,1
Port Adelaide,"Polec, Jared",25,12,2,13,0,1,0,3
Port Adelaide,"Stewart, Paul",16,9,5,7,0,0,0,1
Port Adelaide,"Toumpas, Jimmy",12,6,2,6,0,1,0,1
Port Adelaide,"Trengove, Jackson",25,12,4,13,2,1,18,4
Port Adelaide,"Westhoff, Justin",13,10,10,3,2,1,0,2
Port Adelaide,"Wines, Ollie",32,18,4,14,0,2,4,3
Port Adelaide,"Wingard, Chad",16,9,5,7,5,0,0,1
Port Adelaide,"Young, Aaron",22,12,9,10,1,5,0,6
Port Adelaide,"Ah Chee, Brendon",13,9,5,4,0,2,0,3
Port Adelaide,"Amon, Karl",9,5,2,4,0,0,0,2
Port Adelaide,"Austin, Logan",8,7,5,1,0,0,0,3
Port Adelaide,"Boak, Travis",22,11,5,11,0,0,0,5
Port Adelaide,"Broadbent, Matthew",18,13,7,5,0,0,0,4
Port Adelaide,"Butcher, John",7,4,1,3,1,1,0,1
Port Adelaide,"Byrne-Jones, Darcy",9,8,2,1,0,0,1,3
Port Adelaide,"Clurey, Tom",11,6,5,5,0,0,0,2
Port Adelaide,"Dixon, Charlie",6,1,1,5,0,0,0,2
Port Adelaide,"Ebert, Brad",9,7,3,2,0,0,1,7
Port Adelaide,"Gray, Robbie",7,4,1,3,1,0,0,4
Port Adelaide,"Gray, Sam",22,15,3,7,0,0,0,7
Port Adelaide,"Impey, Jarman",12,9,4,3,1,1,0,6
Port Adelaide,"Krakouer, Nathan",19,14,5,5,1,0,0,2
Port Adelaide,"Pittard, Jasper",29,21,4,8,0,0,0,2
Port Adelaide,"Polec, Jared",20,12,5,8,0,0,0,6
Port Adelaide,"Stewart, Paul",13,10,4,3,0,0,0,4
Port Adelaide,"Trengove, Jackson",10,3,3,7,0,0,13,1
Port Adelaide,"Westhoff, Justin",17,9,8,8,0,0,7,2
Port Adelaide,"Wines, Ollie",32,17,2,15,0,0,4,5
Port Adelaide,"Wingard, Chad",19,14,3,5,0,4,0,2
Port Adelaide,"Young, Aaron",22,9,5,13,0,1,0,4
Port Adelaide,"Amon, Karl",20,13,4,7,0,0,0,0
Port Adelaide,"Austin, Logan",6,4,1,2,0,0,0,2
Port Adelaide,"Boak, Travis",22,10,5,12,0,0,0,3
Port Adelaide,"Broadbent, Matthew",23,13,6,10,0,0,0,0
Port Adelaide,"Byrne-Jones, Darcy",17,12,6,5,0,0,0,0
Port Adelaide,"Clurey, Tom",10,6,2,4,0,0,0,3
Port Adelaide,"Dixon, Charlie",11,5,5,6,0,0,0,1
Port Adelaide,"Ebert, Brad",18,11,7,7,0,0,1,6
Port Adelaide,"Gray, Robbie",26,10,1,16,0,1,0,6
Port Adelaide,"Gray, Sam",25,10,3,15,1,0,0,9
Port Adelaide,"Impey, Jarman",16,9,5,7,0,0,0,2
Port Adelaide,"Krakouer, Nathan",9,6,2,3,1,0,0,2
Port Adelaide,"Lobbe, Matthew",6,1,3,5,0,0,14,9
Port Adelaide,"OShea, Cameron",9,9,3,0,0,0,0,2
Port Adelaide,"Palmer, Jesse",12,6,4,6,0,1,0,2
Port Adelaide,"Pittard, Jasper",28,16,3,12,0,0,0,2
Port Adelaide,"Polec, Jared",24,14,3,10,2,0,0,4
Port Adelaide,"Trengove, Jackson",15,4,3,11,0,1,9,6
Port Adelaide,"Westhoff, Justin",20,13,7,7,0,1,1,5
Port Adelaide,"Wines, Ollie",30,12,3,18,1,0,1,6
Port Adelaide,"Wingard, Chad",5,5,3,0,1,0,0,0
Port Adelaide,"Young, Aaron",8,5,2,3,2,0,0,3
Port Adelaide,"Amon, Karl",13,8,3,5,1,2,0,2
Port Adelaide,"Boak, Travis",26,11,1,15,1,0,0,4
Port Adelaide,"Broadbent, Matthew",18,12,5,6,1,1,0,1
Port Adelaide,"Byrne-Jones, Darcy",13,7,1,6,0,0,0,1
Port Adelaide,"Clurey, Tom",10,7,6,3,0,0,0,2
Port Adelaide,"Ebert, Brad",19,11,6,8,0,0,0,6
Port Adelaide,"Gray, Robbie",27,13,1,14,2,1,0,7
Port Adelaide,"Gray, Sam",24,7,3,17,0,0,0,5
Port Adelaide,"Impey, Jarman",14,8,4,6,0,0,0,7
Port Adelaide,"Krakouer, Nathan",9,7,3,2,0,0,0,2
Port Adelaide,"Lobbe, Matthew",5,3,1,2,0,0,22,3
Port Adelaide,"Neade, Jake",5,5,1,0,2,1,0,5
Port Adelaide,"OShea, Cameron",21,13,1,8,0,0,0,3
Port Adelaide,"Palmer, Jesse",8,5,5,3,1,1,0,3
Port Adelaide,"Pittard, Jasper",19,10,6,9,0,0,0,3
Port Adelaide,"Polec, Jared",18,12,2,6,1,0,0,1
Port Adelaide,"Schulz, Jay",8,3,2,5,0,2,0,1
Port Adelaide,"Toumpas, Jimmy",9,6,1,3,1,0,0,1
Port Adelaide,"Trengove, Jackson",6,6,3,0,0,0,7,3
Port Adelaide,"Westhoff, Justin",16,11,6,5,1,2,0,1
Port Adelaide,"Wines, Ollie",28,16,4,12,0,0,6,6
Port Adelaide,"Young, Aaron",8,4,5,4,3,0,0,1
Port Adelaide,"Amon, Karl",13,6,2,7,0,0,0,1
Port Adelaide,"Austin, Logan",4,3,2,1,0,0,0,1
Port Adelaide,"Boak, Travis",22,9,5,13,1,0,0,5
Port Adelaide,"Bonner, Riley",22,17,4,5,0,0,0,2
Port Adelaide,"Broadbent, Matthew",27,16,6,11,0,1,0,2
Port Adelaide,"Byrne-Jones, Darcy",13,9,2,4,0,0,0,3
Port Adelaide,"Clurey, Tom",9,5,4,4,0,0,0,1
Port Adelaide,"Ebert, Brad",22,11,6,11,1,0,0,2
Port Adelaide,"Gray, Robbie",34,16,4,18,4,0,0,2
Port Adelaide,"Gray, Sam",32,10,0,22,1,2,0,5
Port Adelaide,"Impey, Jarman",16,8,3,8,1,1,0,8
Port Adelaide,"Krakouer, Nathan",11,10,3,1,0,0,0,3
Port Adelaide,"Lobbe, Matthew",10,6,1,4,0,0,40,2
Port Adelaide,"Palmer, Jesse",14,8,5,6,0,2,0,2
Port Adelaide,"Pittard, Jasper",17,11,2,6,0,0,0,2
Port Adelaide,"Polec, Jared",18,10,4,8,0,0,0,4
Port Adelaide,"Schulz, Jay",13,6,3,7,3,0,0,0
Port Adelaide,"Snelling, Will",15,6,1,9,1,0,0,6
Port Adelaide,"Trengove, Jackson",14,6,4,8,0,0,3,0
Port Adelaide,"Westhoff, Justin",14,5,7,9,0,0,2,5
Port Adelaide,"Wines, Ollie",30,13,5,17,0,1,4,8
Port Adelaide,"Young, Aaron",8,7,3,1,1,3,0,3
Richmond,"Astbury, David",16,10,7,6,0,0,0,0
Richmond,"Cotchin, Trent",21,14,0,7,0,0,0,6
Richmond,"Edwards, Shane",12,7,1,5,1,0,0,3
Richmond,"Ellis, Brandon",21,11,3,10,0,0,0,2
Richmond,"Ellis, Corey",11,8,3,3,1,0,0,4
Richmond,"Griffiths, Ben",10,6,4,4,0,0,7,1
Richmond,"Grimes, Dylan",6,4,3,2,0,0,0,2
Richmond,"Hampson, Shaun",8,2,1,6,0,1,24,0
Richmond,"Houli, Bachar",24,15,6,9,0,0,0,0
Richmond,"Lambert, Kane",28,16,8,12,1,0,0,7
Richmond,"Lloyd, Sam",14,10,3,4,2,0,0,3
Richmond,"Martin, Dustin",24,15,2,9,0,0,0,3
Richmond,"McIntosh, Kamdyn",14,8,4,6,0,0,0,2
Richmond,"Menadue, Connor",13,7,4,6,2,0,0,4
Richmond,"Miles, Anthony",19,6,1,13,1,0,0,4
Richmond,"Morris, Steven",4,2,0,2,0,0,0,2
Richmond,"Rance, Alex",20,9,7,11,0,0,0,4
Richmond,"Riewoldt, Jack",18,10,6,8,2,1,0,3
Richmond,"Rioli, Daniel",7,6,2,1,0,2,0,6
Richmond,"Townsend, Jacob",16,9,4,7,0,0,1,3
Richmond,"Vickery, Ty",8,6,4,2,3,2,1,0
Richmond,"Vlastuin, Nick",18,10,6,8,1,0,0,1
Richmond,"Astbury, David",10,7,5,3,0,0,0,0
Richmond,"Cotchin, Trent",38,18,4,20,0,2,2,0
Richmond,"Ellis, Brandon",30,19,7,11,0,0,0,1
Richmond,"Ellis, Corey",6,3,0,3,0,0,0,6
Richmond,"Griffiths, Ben",6,2,1,4,0,0,7,3
Richmond,"Grigg, Shaun",30,15,5,15,0,1,2,2
Richmond,"Grimes, Dylan",3,1,0,2,0,0,0,0
Richmond,"Hampson, Shaun",13,4,3,9,0,2,28,2
Richmond,"Houli, Bachar",35,17,8,18,0,2,0,2
Richmond,"Hunt, Taylor",10,6,3,4,0,0,0,3
Richmond,"Lambert, Kane",17,10,4,7,2,1,0,5
Richmond,"Lloyd, Sam",17,6,3,11,1,0,0,4
Richmond,"Martin, Dustin",30,15,6,15,1,2,0,4
Richmond,"McIntosh, Kamdyn",28,17,9,11,0,0,0,1
Richmond,"Menadue, Connor",17,8,4,9,0,0,0,3
Richmond,"Miles, Anthony",19,8,4,11,0,0,0,5
Richmond,"Rance, Alex",17,10,6,7,0,0,0,0
Richmond,"Riewoldt, Jack",16,12,8,4,3,1,2,4
Richmond,"Short, Jayden",6,6,1,0,3,1,0,2
Richmond,"Townsend, Jacob",18,9,8,9,0,0,2,6
Richmond,"Vickery, Ty",10,6,7,4,2,1,2,2
Richmond,"Vlastuin, Nick",17,10,8,7,0,0,0,2
Richmond,"Astbury, David",11,3,5,8,0,0,0,2
Richmond,"Chaplin, Troy",15,7,5,8,0,1,0,2
Richmond,"Cotchin, Trent",32,15,7,17,1,0,0,6
Richmond,"Edwards, Shane",22,8,4,14,1,0,0,1
Richmond,"Ellis, Brandon",39,22,11,17,0,1,0,2
Richmond,"Ellis, Corey",16,5,3,11,0,1,0,1
Richmond,"Grigg, Shaun",25,9,8,16,1,0,3,4
Richmond,"Hampson, Shaun",11,8,5,3,1,0,34,2
Richmond,"Houli, Bachar",36,21,10,15,0,0,0,5
Richmond,"Lambert, Kane",18,10,3,8,1,0,0,3
Richmond,"Lennon, Ben",11,11,8,0,0,1,0,3
Richmond,"Lloyd, Sam",16,12,6,4,3,0,0,2
Richmond,"Martin, Dustin",25,14,8,11,0,0,0,3
Richmond,"McIntosh, Kamdyn",19,14,4,5,0,1,0,2
Richmond,"Menadue, Connor",18,6,4,12,0,1,0,1
Richmond,"Miles, Anthony",21,9,4,12,0,0,0,4
Richmond,"Rance, Alex",21,11,9,10,0,0,0,4
Richmond,"Riewoldt, Jack",13,9,7,4,1,2,0,0
Richmond,"Rioli, Daniel",12,5,0,7,2,1,0,1
Richmond,"Short, Jayden",11,8,5,3,0,1,0,3
Richmond,"Vickery, Ty",13,7,4,6,2,2,5,2
Richmond,"Vlastuin, Nick",5,3,3,2,0,0,0,3
Richmond,"Astbury, David",10,7,7,3,0,0,0,1
Richmond,"Chaplin, Troy",12,5,2,7,0,1,1,2
Richmond,"Cotchin, Trent",29,15,3,14,0,1,1,4
Richmond,"Edwards, Shane",14,7,0,7,0,0,0,4
Richmond,"Ellis, Brandon",19,11,7,8,0,0,0,2
Richmond,"Ellis, Corey",20,9,2,11,0,0,0,4
Richmond,"Grigg, Shaun",22,7,2,15,0,0,2,5
Richmond,"Hampson, Shaun",1,1,0,0,0,0,7,1
Richmond,"Houli, Bachar",16,11,7,5,0,0,0,1
Richmond,"Hunt, Taylor",19,8,6,11,0,0,0,2
Richmond,"Lambert, Kane",18,8,2,10,1,0,0,1
Richmond,"Lennon, Ben",11,9,7,2,0,1,0,2
Richmond,"Lloyd, Sam",10,8,4,2,2,0,0,3
Richmond,"Martin, Dustin",23,9,2,14,0,0,0,3
Richmond,"McIntosh, Kamdyn",24,16,6,8,0,0,0,1
Richmond,"Menadue, Connor",15,3,2,12,0,0,0,4
Richmond,"Moore, Andrew",9,6,2,3,0,0,0,4
Richmond,"Rance, Alex",26,12,11,14,0,0,0,3
Richmond,"Riewoldt, Jack",14,11,9,3,4,0,0,3
Richmond,"Rioli, Daniel",9,3,0,6,2,0,0,2
Richmond,"Vickery, Ty",5,4,1,1,0,0,10,4
Richmond,"Vlastuin, Nick",14,8,7,6,0,0,0,1
Richmond,"Astbury, David",12,9,5,3,0,1,0,1
Richmond,"Batchelor, Jake",6,4,1,2,0,0,0,1
Richmond,"Chaplin, Troy",8,7,3,1,1,0,3,2
Richmond,"Cotchin, Trent",32,17,1,15,0,1,1,6
Richmond,"Edwards, Shane",23,13,3,10,1,1,0,3
Richmond,"Ellis, Brandon",19,11,2,8,1,0,0,4
Richmond,"Ellis, Corey",11,4,0,7,0,0,0,1
Richmond,"Grigg, Shaun",22,9,4,13,0,0,3,2
Richmond,"Houli, Bachar",14,12,3,2,0,0,0,3
Richmond,"Lambert, Kane",12,8,3,4,0,1,0,4
Richmond,"Lloyd, Sam",14,8,1,6,3,1,0,7
Richmond,"Maric, Ivan",13,6,3,7,0,0,26,2
Richmond,"Martin, Dustin",18,11,3,7,1,0,0,5
Richmond,"McIntosh, Kamdyn",13,9,3,4,0,0,0,4
Richmond,"Menadue, Connor",11,4,0,7,0,0,0,2
Richmond,"Miles, Anthony",25,13,3,12,1,0,0,7
Richmond,"Morris, Steven",6,2,0,4,0,0,0,4
Richmond,"Rance, Alex",16,11,3,5,0,0,0,1
Richmond,"Riewoldt, Jack",24,16,7,8,3,2,0,0
Richmond,"Rioli, Daniel",10,2,0,8,0,0,0,3
Richmond,"Townsend, Jacob",12,4,2,8,0,0,0,8
Richmond,"Vickery, Ty",7,5,3,2,3,1,7,2
Richmond,"Astbury, David",16,7,4,9,0,0,0,0
Richmond,"Batchelor, Jake",13,9,4,4,0,0,0,2
Richmond,"Castagna, Jason",11,6,2,5,0,0,0,2
Richmond,"Chaplin, Troy",15,10,6,5,0,0,0,4
Richmond,"Cotchin, Trent",19,10,0,9,0,0,0,2
Richmond,"Deledio, Brett",22,10,2,12,1,1,0,6
Richmond,"Edwards, Shane",27,10,3,17,0,0,0,3
Richmond,"Ellis, Brandon",26,17,9,9,0,2,0,5
Richmond,"Ellis, Corey",23,12,3,11,0,0,0,4
Richmond,"Grigg, Shaun",32,17,4,15,2,2,1,6
Richmond,"Hampson, Shaun",7,1,1,6,0,0,39,2
Richmond,"Houli, Bachar",34,19,7,15,0,0,0,3
Richmond,"Lambert, Kane",4,2,0,2,0,0,0,1
Richmond,"Lloyd, Sam",14,9,2,5,0,2,0,3
Richmond,"Maric, Ivan",4,3,1,1,0,0,22,1
Richmond,"Martin, Dustin",31,19,5,12,1,0,0,4
Richmond,"Menadue, Connor",13,4,2,9,0,0,0,3
Richmond,"Miles, Anthony",22,8,4,14,0,0,0,3
Richmond,"Morris, Steven",12,4,2,8,0,0,0,4
Richmond,"Riewoldt, Jack",13,8,5,5,3,0,2,1
Richmond,"Rioli, Daniel",7,3,2,4,0,0,0,7
Richmond,"Vickery, Ty",12,4,4,8,1,1,0,5
Richmond,"Batchelor, Jake",5,4,0,1,0,0,0,2
Richmond,"Castagna, Jason",12,7,2,5,0,0,0,1
Richmond,"Chaplin, Troy",15,8,5,7,0,0,0,1
Richmond,"Deledio, Brett",18,8,4,10,0,1,1,5
Richmond,"Edwards, Shane",12,4,0,8,0,0,0,4
Richmond,"Ellis, Brandon",27,13,2,14,0,0,0,4
Richmond,"Ellis, Corey",16,9,4,7,0,0,0,3
Richmond,"Griffiths, Ben",8,5,4,3,1,1,7,3
Richmond,"Grigg, Shaun",24,14,3,10,0,0,2,4
Richmond,"Hampson, Shaun",6,1,3,5,0,0,37,3
Richmond,"Houli, Bachar",12,7,1,5,0,0,0,5
Richmond,"Lloyd, Sam",12,8,6,4,1,0,0,3
Richmond,"Martin, Dustin",28,15,2,13,0,0,0,5
Richmond,"McIntosh, Kamdyn",10,9,4,1,0,0,0,4
Richmond,"Menadue, Connor",11,5,2,6,0,0,0,3
Richmond,"Miles, Anthony",24,12,2,12,2,1,0,7
Richmond,"Morris, Steven",10,2,1,8,0,0,0,4
Richmond,"Riewoldt, Jack",14,11,6,3,3,1,0,0
Richmond,"Rioli, Daniel",11,6,2,5,0,1,0,4
Richmond,"Short, Jayden",9,6,3,3,2,0,0,3
Richmond,"Vickery, Ty",7,6,5,1,3,2,0,0
Richmond,"Vlastuin, Nick",16,10,3,6,1,1,0,6
Richmond,"Batchelor, Jake",9,6,3,3,0,0,0,1
Richmond,"Chaplin, Troy",12,9,5,3,0,0,0,1
Richmond,"Deledio, Brett",34,17,8,17,0,1,0,1
Richmond,"Edwards, Shane",25,12,4,13,0,0,0,6
Richmond,"Ellis, Brandon",26,17,7,9,1,0,0,3
Richmond,"Ellis, Corey",16,11,6,5,0,1,0,4
Richmond,"Griffiths, Ben",20,12,7,8,5,1,1,3
Richmond,"Grigg, Shaun",25,14,4,11,0,0,3,3
Richmond,"Grimes, Dylan",14,9,4,5,0,0,0,6
Richmond,"Hampson, Shaun",5,1,1,4,0,0,27,1
Richmond,"Hunt, Taylor",13,6,2,7,0,0,0,2
Richmond,"Lloyd, Sam",15,10,7,5,3,2,0,3
Richmond,"Martin, Dustin",28,23,4,5,1,2,0,8
Richmond,"Menadue, Connor",13,5,2,8,0,0,0,3
Richmond,"Miles, Anthony",31,11,4,20,1,0,0,5
Richmond,"Morris, Steven",15,8,4,7,0,0,0,5
Richmond,"Rance, Alex",14,9,5,5,0,0,0,3
Richmond,"Riewoldt, Jack",19,16,9,3,1,3,1,3
Richmond,"Rioli, Daniel",11,5,3,6,2,1,0,2
Richmond,"Short, Jayden",8,7,4,1,0,1,0,2
Richmond,"Vickery, Ty",8,3,2,5,0,2,0,1
Richmond,"Vlastuin, Nick",18,12,5,6,0,0,1,8
Richmond,"Batchelor, Jake",8,5,2,3,0,0,0,1
Richmond,"Chaplin, Troy",13,9,6,4,0,0,0,1
Richmond,"Cotchin, Trent",39,18,2,21,0,1,0,7
Richmond,"Deledio, Brett",20,12,4,8,0,2,0,6
Richmond,"Edwards, Shane",22,13,3,9,2,1,0,2
Richmond,"Ellis, Brandon",18,16,6,2,0,2,0,4
Richmond,"Griffiths, Ben",7,4,3,3,1,1,15,2
Richmond,"Grigg, Shaun",24,17,4,7,1,0,0,8
Richmond,"Grimes, Dylan",9,5,1,4,0,0,0,3
Richmond,"Hampson, Shaun",8,6,3,2,0,0,32,2
Richmond,"Hunt, Taylor",22,12,7,10,0,0,0,1
Richmond,"Lambert, Kane",15,8,2,7,0,0,0,3
Richmond,"Lloyd, Sam",14,8,6,6,1,0,0,3
Richmond,"Martin, Dustin",30,17,4,13,0,1,0,5
Richmond,"Menadue, Connor",8,5,3,3,1,1,0,2
Richmond,"Miles, Anthony",22,15,4,7,2,0,0,6
Richmond,"Morris, Steven",19,11,4,8,1,0,0,1
Richmond,"Rance, Alex",15,7,3,8,0,0,0,0
Richmond,"Riewoldt, Jack",9,8,5,1,2,1,0,5
Richmond,"Short, Jayden",5,5,3,0,0,0,0,2
Richmond,"Vickery, Ty",2,1,0,1,0,1,1,2
Richmond,"Vlastuin, Nick",18,15,11,3,0,0,0,1
Richmond,"Astbury, David",15,10,11,5,0,0,0,3
Richmond,"Batchelor, Jake",20,13,4,7,0,0,0,0
Richmond,"Cotchin, Trent",29,18,5,11,2,0,0,5
Richmond,"Deledio, Brett",23,9,7,14,3,1,0,4
Richmond,"Edwards, Shane",26,15,4,11,1,0,0,3
Richmond,"Ellis, Brandon",30,14,5,16,0,0,0,2
Richmond,"Ellis, Corey",14,13,4,1,0,0,0,2
Richmond,"Griffiths, Ben",10,6,5,4,1,2,8,0
Richmond,"Grigg, Shaun",23,15,4,8,2,0,0,2
Richmond,"Grimes, Dylan",17,10,6,7,0,0,0,2
Richmond,"Hampson, Shaun",8,3,0,5,0,0,33,1
Richmond,"Hunt, Taylor",18,11,6,7,0,0,0,2
Richmond,"Lambert, Kane",17,9,2,8,0,1,0,5
Richmond,"Lloyd, Sam",13,11,6,2,2,0,0,0
Richmond,"Martin, Dustin",38,22,10,16,0,0,0,1
Richmond,"Miles, Anthony",22,13,9,9,0,0,0,2
Richmond,"Morris, Steven",14,8,2,6,0,0,0,4
Richmond,"Rance, Alex",18,9,9,9,0,0,0,2
Richmond,"Riewoldt, Jack",13,10,6,3,2,3,1,2
Richmond,"Rioli, Daniel",6,4,1,2,0,0,0,2
Richmond,"Vickery, Ty",13,10,8,3,3,0,1,0
Richmond,"Vlastuin, Nick",21,11,7,10,0,0,0,2
Richmond,"Astbury, David",9,5,4,4,0,0,0,3
Richmond,"Batchelor, Jake",9,5,2,4,0,0,0,0
Richmond,"Chaplin, Troy",9,7,4,2,0,0,0,2
Richmond,"Cotchin, Trent",34,20,3,14,0,0,0,5
Richmond,"Deledio, Brett",24,11,7,13,1,0,0,4
Richmond,"Edwards, Shane",18,9,0,9,0,1,0,3
Richmond,"Ellis, Brandon",7,5,0,2,0,0,0,2
Richmond,"Ellis, Corey",20,14,4,6,0,1,0,1
Richmond,"Griffiths, Ben",12,5,2,7,0,0,6,1
Richmond,"Grigg, Shaun",38,12,3,26,0,0,3,4
Richmond,"Hampson, Shaun",8,3,2,5,0,0,51,2
Richmond,"Hunt, Taylor",19,12,5,7,0,0,0,2
Richmond,"Lambert, Kane",11,7,3,4,0,2,0,4
Richmond,"Lloyd, Sam",9,7,4,2,1,1,0,4
Richmond,"Martin, Dustin",22,13,2,9,0,0,0,3
Richmond,"Miles, Anthony",31,16,3,15,1,0,0,4
Richmond,"Morris, Steven",1,0,0,1,0,0,0,0
Richmond,"Rance, Alex",17,11,8,6,0,0,0,6
Richmond,"Riewoldt, Jack",14,11,6,3,2,0,1,3
Richmond,"Rioli, Daniel",11,6,3,5,0,0,0,2
Richmond,"Vickery, Ty",8,6,4,2,2,1,1,3
Richmond,"Vlastuin, Nick",5,3,2,2,0,0,0,0
Richmond,"Astbury, David",9,4,3,5,0,0,0,3
Richmond,"Batchelor, Jake",16,12,5,4,0,1,0,0
Richmond,"Conca, Reece",22,12,3,10,0,1,0,6
Richmond,"Cotchin, Trent",28,20,3,8,1,0,0,7
Richmond,"Deledio, Brett",22,12,5,10,3,0,0,1
Richmond,"Edwards, Shane",22,11,4,11,3,1,0,5
Richmond,"Ellis, Brandon",24,11,6,13,0,0,0,3
Richmond,"Ellis, Corey",15,9,4,6,0,0,0,3
Richmond,"Griffiths, Ben",16,9,8,7,2,1,5,4
Richmond,"Grigg, Shaun",28,16,10,12,0,1,0,4
Richmond,"Grimes, Dylan",23,9,3,14,0,0,0,2
Richmond,"Hampson, Shaun",9,2,5,7,1,0,42,0
Richmond,"Hunt, Taylor",19,8,7,11,0,0,0,3
Richmond,"Lambert, Kane",14,8,5,6,1,1,0,2
Richmond,"Lloyd, Sam",13,9,3,4,2,1,0,4
Richmond,"Martin, Dustin",38,20,4,18,2,0,0,4
Richmond,"Miles, Anthony",21,8,1,13,0,0,0,2
Richmond,"Rance, Alex",21,14,13,7,0,0,0,4
Richmond,"Riewoldt, Jack",15,8,5,7,1,2,0,4
Richmond,"Rioli, Daniel",7,3,2,4,0,0,0,1
Richmond,"Short, Jayden",18,14,6,4,0,0,0,3
Richmond,"Vickery, Ty",3,3,3,0,1,0,2,1
Richmond,"Astbury, David",10,6,4,4,0,0,0,1
Richmond,"Broad, Nathan",14,8,4,6,0,0,0,2
Richmond,"Conca, Reece",10,6,0,4,0,1,0,6
Richmond,"Cotchin, Trent",23,11,2,12,1,1,0,6
Richmond,"Deledio, Brett",20,9,7,11,1,1,0,3
Richmond,"Edwards, Shane",17,9,4,8,2,0,0,1
Richmond,"Ellis, Brandon",28,10,6,18,1,2,0,3
Richmond,"Grigg, Shaun",27,12,5,15,0,0,2,1
Richmond,"Grimes, Dylan",13,7,6,6,0,0,0,0
Richmond,"Hampson, Shaun",6,3,4,3,0,0,27,1
Richmond,"Hunt, Taylor",18,10,5,8,0,0,0,2
Richmond,"Lambert, Kane",10,7,1,3,0,0,0,3
Richmond,"Lloyd, Sam",12,9,8,3,2,0,0,0
Richmond,"Martin, Dustin",35,29,7,6,0,2,0,2
Richmond,"Menadue, Connor",19,7,7,12,2,0,0,6
Richmond,"Miles, Anthony",25,13,5,12,1,0,0,5
Richmond,"Rance, Alex",13,8,6,5,0,0,0,1
Richmond,"Riewoldt, Jack",21,16,10,5,4,3,0,2
Richmond,"Short, Jayden",12,11,4,1,0,0,0,0
Richmond,"Townsend, Jacob",9,3,3,6,0,0,1,2
Richmond,"Vickery, Ty",10,8,4,2,1,1,2,0
Richmond,"Vlastuin, Nick",22,16,4,6,2,0,0,1
Richmond,"Astbury, David",23,15,4,8,0,0,0,3
Richmond,"Broad, Nathan",12,7,3,5,0,0,0,1
Richmond,"Conca, Reece",22,15,6,7,0,0,0,3
Richmond,"Cotchin, Trent",14,8,0,6,0,0,0,7
Richmond,"Deledio, Brett",30,17,5,13,0,0,0,1
Richmond,"Edwards, Shane",17,9,2,8,0,1,0,1
Richmond,"Ellis, Brandon",34,21,10,13,0,0,1,1
Richmond,"Griffiths, Ben",5,2,0,3,0,0,12,8
Richmond,"Grigg, Shaun",18,9,3,9,0,0,0,6
Richmond,"Grimes, Dylan",11,5,4,6,0,0,0,3
Richmond,"Hunt, Taylor",15,7,4,8,0,0,0,1
Richmond,"Lambert, Kane",10,4,3,6,0,0,0,5
Richmond,"Lloyd, Sam",17,10,6,7,2,1,0,1
Richmond,"Maric, Ivan",2,1,0,1,0,0,39,3
Richmond,"Martin, Dustin",32,20,4,12,0,0,0,2
Richmond,"Menadue, Connor",13,8,4,5,0,0,0,2
Richmond,"Miles, Anthony",28,17,3,11,0,0,0,8
Richmond,"Rance, Alex",16,10,7,6,0,0,0,3
Richmond,"Riewoldt, Jack",14,12,7,2,4,1,0,2
Richmond,"Short, Jayden",15,15,4,0,1,0,0,2
Richmond,"Vickery, Ty",6,5,3,1,1,1,0,2
Richmond,"Vlastuin, Nick",16,10,5,6,0,0,0,0
Richmond,"Astbury, David",21,13,12,8,0,0,0,0
Richmond,"Castagna, Jason",19,13,7,6,2,0,0,3
Richmond,"Conca, Reece",21,9,5,12,0,0,0,2
Richmond,"Cotchin, Trent",28,14,2,14,1,0,0,5
Richmond,"Deledio, Brett",22,10,7,12,0,0,0,5
Richmond,"Edwards, Shane",18,12,4,6,2,2,0,5
Richmond,"Ellis, Brandon",17,9,4,8,1,0,0,6
Richmond,"Griffiths, Ben",10,7,7,3,1,1,10,2
Richmond,"Grimes, Dylan",11,8,6,3,0,0,0,8
Richmond,"Hampson, Shaun",8,2,2,6,0,0,45,3
Richmond,"Hunt, Taylor",15,8,6,7,0,0,0,1
Richmond,"Lloyd, Sam",15,11,5,4,1,1,0,3
Richmond,"Markov, Oleg",18,15,9,3,0,0,0,4
Richmond,"Martin, Dustin",38,21,1,17,0,0,0,5
Richmond,"McBean, Liam",6,3,2,3,1,1,1,2
Richmond,"Menadue, Connor",12,5,5,7,0,0,0,8
Richmond,"Miles, Anthony",22,9,4,13,0,0,0,2
Richmond,"Rance, Alex",16,11,11,5,0,0,0,1
Richmond,"Riewoldt, Jack",12,11,7,1,2,3,0,1
Richmond,"Rioli, Daniel",9,2,2,7,0,0,0,2
Richmond,"Short, Jayden",18,15,4,3,0,0,0,4
Richmond,"Vlastuin, Nick",16,12,9,4,0,0,0,4
Richmond,"Astbury, David",13,9,10,4,0,0,1,0
Richmond,"Castagna, Jason",23,11,8,12,0,0,0,2
Richmond,"Cotchin, Trent",35,19,3,16,0,0,0,5
Richmond,"Deledio, Brett",19,9,2,10,0,0,0,3
Richmond,"Edwards, Shane",18,4,1,14,0,0,0,2
Richmond,"Ellis, Brandon",31,12,9,19,0,0,0,2
Richmond,"Griffiths, Ben",18,14,12,4,3,2,7,4
Richmond,"Grigg, Shaun",19,15,4,4,2,1,0,4
Richmond,"Grimes, Dylan",11,3,2,8,0,0,0,3
Richmond,"Hampson, Shaun",11,6,3,5,1,0,40,4
Richmond,"Hunt, Taylor",21,11,7,10,1,0,0,4
Richmond,"Lloyd, Sam",15,11,2,4,3,1,0,3
Richmond,"Markov, Oleg",12,6,2,6,1,0,0,2
Richmond,"Martin, Dustin",43,35,6,8,2,0,0,4
Richmond,"McBean, Liam",12,8,6,4,0,0,0,0
Richmond,"Menadue, Connor",8,4,4,4,1,0,0,2
Richmond,"Miles, Anthony",26,14,5,12,1,0,0,4
Richmond,"Rance, Alex",18,8,9,10,0,0,1,2
Richmond,"Riewoldt, Jack",15,11,8,4,0,1,0,4
Richmond,"Rioli, Daniel",11,7,4,4,1,0,0,5
Richmond,"Short, Jayden",25,16,2,9,0,0,0,0
Richmond,"Vlastuin, Nick",15,9,6,6,0,0,0,4
Richmond,"Astbury, David",13,11,6,2,0,0,0,1
Richmond,"Castagna, Jason",9,3,1,6,0,0,0,0
Richmond,"Conca, Reece",15,4,1,11,0,0,0,1
Richmond,"Cotchin, Trent",21,11,4,10,1,0,0,6
Richmond,"Drummond, Nathan",10,6,5,4,1,1,0,3
Richmond,"Edwards, Shane",13,5,1,8,0,3,0,2
Richmond,"Ellis, Brandon",18,8,4,10,0,0,0,2
Richmond,"Griffiths, Ben",11,8,5,3,0,1,3,3
Richmond,"Grigg, Shaun",27,15,4,12,0,0,3,1
Richmond,"Grimes, Dylan",11,6,5,5,0,0,0,3
Richmond,"Hampson, Shaun",9,3,1,6,0,0,36,3
Richmond,"Hunt, Taylor",21,7,5,14,0,0,0,3
Richmond,"Lloyd, Sam",8,6,3,2,0,1,0,3
Richmond,"Markov, Oleg",12,6,5,6,0,0,0,1
Richmond,"Martin, Dustin",39,24,3,15,0,1,0,0
Richmond,"McBean, Liam",7,4,4,3,0,2,0,4
Richmond,"Miles, Anthony",26,12,0,14,0,0,0,3
Richmond,"Rance, Alex",16,7,9,9,0,0,0,3
Richmond,"Riewoldt, Jack",10,6,4,4,2,1,0,2
Richmond,"Rioli, Daniel",9,3,2,6,1,0,0,3
Richmond,"Short, Jayden",18,13,2,5,0,0,0,1
Richmond,"Vlastuin, Nick",11,9,3,2,0,0,0,3
Richmond,"Astbury, David",10,4,5,6,0,0,0,4
Richmond,"Conca, Reece",11,6,4,5,0,0,0,7
Richmond,"Cotchin, Trent",21,11,3,10,0,0,0,0
Richmond,"Drummond, Nathan",8,3,3,5,0,0,0,6
Richmond,"Ellis, Brandon",24,14,9,10,0,0,0,2
Richmond,"Grigg, Shaun",16,9,3,7,0,0,1,5
Richmond,"Grimes, Dylan",14,7,4,7,0,0,0,2
Richmond,"Hampson, Shaun",10,5,5,5,0,1,37,3
Richmond,"Houli, Bachar",21,12,11,9,0,0,0,4
Richmond,"Hunt, Taylor",23,17,7,6,0,0,0,0
Richmond,"Lambert, Kane",11,5,2,6,0,1,0,4
Richmond,"Lloyd, Sam",8,7,6,1,1,1,0,4
Richmond,"Marcon, Adam",16,9,4,7,0,0,0,5
Richmond,"Markov, Oleg",9,8,2,1,0,0,0,3
Richmond,"Martin, Dustin",28,16,9,12,0,0,0,6
Richmond,"Miles, Anthony",11,5,2,6,0,0,0,5
Richmond,"Rance, Alex",26,16,9,10,0,0,0,0
Richmond,"Riewoldt, Jack",17,12,5,5,2,1,0,1
Richmond,"Rioli, Daniel",10,6,7,4,0,0,0,1
Richmond,"Short, Jayden",23,20,5,3,0,0,0,1
Richmond,"Vickery, Ty",8,2,4,6,0,0,5,5
Richmond,"Vlastuin, Nick",14,11,5,3,0,0,0,1
Richmond,"Astbury, David",17,14,14,3,0,0,0,1
Richmond,"Cotchin, Trent",28,14,4,14,0,0,0,5
Richmond,"Drummond, Nathan",15,2,4,13,1,0,0,1
Richmond,"Ellis, Brandon",18,11,9,7,1,1,0,1
Richmond,"Griffiths, Ben",6,3,3,3,0,0,10,2
Richmond,"Grigg, Shaun",26,18,14,8,1,0,0,6
Richmond,"Grimes, Dylan",14,4,6,10,0,0,0,4
Richmond,"Hampson, Shaun",7,3,3,4,0,0,33,0
Richmond,"Houli, Bachar",30,17,7,13,0,0,0,3
Richmond,"Hunt, Taylor",16,7,5,9,0,0,0,2
Richmond,"Lloyd, Sam",15,9,4,6,1,0,0,2
Richmond,"Marcon, Adam",22,14,9,8,1,0,0,0
Richmond,"Markov, Oleg",26,21,12,5,0,1,0,0
Richmond,"Martin, Dustin",34,18,4,16,1,1,0,3
Richmond,"Miles, Anthony",24,9,3,15,0,0,0,3
Richmond,"Moore, Andrew",20,9,5,11,1,0,0,8
Richmond,"Rance, Alex",26,15,8,11,0,0,0,1
Richmond,"Riewoldt, Jack",12,9,6,3,4,2,0,1
Richmond,"Rioli, Daniel",14,9,6,5,1,1,0,4
Richmond,"Short, Jayden",22,18,2,4,0,0,0,1
Richmond,"Vickery, Ty",11,7,9,4,2,0,0,3
Richmond,"Vlastuin, Nick",22,12,8,10,0,0,0,2
Richmond,"Astbury, David",19,12,11,7,0,0,0,0
Richmond,"Cotchin, Trent",17,11,4,6,0,0,0,5
Richmond,"Drummond, Nathan",6,2,2,4,0,0,0,8
Richmond,"Edwards, Shane",13,6,1,7,1,0,0,0
Richmond,"Ellis, Brandon",24,14,10,10,0,0,0,2
Richmond,"Grigg, Shaun",22,13,5,9,1,1,1,2
Richmond,"Grimes, Dylan",15,9,6,6,0,0,0,1
Richmond,"Hampson, Shaun",10,5,4,5,1,0,29,2
Richmond,"Houli, Bachar",32,21,11,11,0,0,0,0
Richmond,"Hunt, Taylor",20,11,11,9,0,0,0,2
Richmond,"Lennon, Ben",13,7,4,6,1,0,0,3
Richmond,"Lloyd, Sam",9,6,2,3,3,0,0,2
Richmond,"Markov, Oleg",17,14,11,3,0,0,0,2
Richmond,"Martin, Dustin",36,31,5,5,0,0,0,4
Richmond,"Miles, Anthony",13,8,2,5,0,0,0,6
Richmond,"Moore, Andrew",19,8,3,11,0,0,0,2
Richmond,"Rance, Alex",20,11,9,9,0,0,0,2
Richmond,"Riewoldt, Jack",12,6,4,6,1,3,0,0
Richmond,"Rioli, Daniel",13,4,3,9,2,0,0,3
Richmond,"Short, Jayden",21,18,5,3,0,0,0,1
Richmond,"Vickery, Ty",10,7,3,3,2,0,0,2
Richmond,"Vlastuin, Nick",17,12,6,5,0,0,0,1
Richmond,"Astbury, David",14,6,5,8,0,0,0,1
Richmond,"Cotchin, Trent",28,13,3,15,0,0,0,2
Richmond,"Edwards, Shane",18,5,2,13,0,0,0,4
Richmond,"Ellis, Brandon",20,10,2,10,0,1,0,2
Richmond,"Elton, Todd",10,7,7,3,1,1,1,0
Richmond,"Grigg, Shaun",19,9,8,10,0,1,0,2
Richmond,"Grimes, Dylan",14,4,5,10,0,0,0,1
Richmond,"Hampson, Shaun",8,4,3,4,0,0,22,2
Richmond,"Houli, Bachar",22,11,7,11,0,1,0,0
Richmond,"Hunt, Taylor",17,7,5,10,0,0,0,3
Richmond,"Lambert, Kane",19,10,6,9,1,1,0,5
Richmond,"Lloyd, Sam",11,9,4,2,0,1,0,2
Richmond,"Markov, Oleg",14,10,6,4,0,0,0,0
Richmond,"Martin, Dustin",31,20,3,11,0,0,0,1
Richmond,"Menadue, Connor",14,9,7,5,0,1,0,0
Richmond,"Moore, Andrew",18,8,1,10,0,0,0,6
Richmond,"Moore, Callum",5,4,3,1,1,0,0,3
Richmond,"Rance, Alex",15,9,4,6,0,0,0,1
Richmond,"Riewoldt, Jack",9,7,5,2,1,1,1,1
Richmond,"Rioli, Daniel",16,8,4,8,2,0,0,4
Richmond,"Short, Jayden",12,11,2,1,0,0,0,2
Richmond,"Vlastuin, Nick",18,11,8,7,0,0,0,2
Richmond,"Astbury, David",9,4,5,5,0,0,0,1
Richmond,"Chol, Mabior",2,2,1,0,0,1,0,1
Richmond,"Cotchin, Trent",23,14,3,9,3,0,0,3
Richmond,"Edwards, Shane",18,7,2,11,1,2,0,3
Richmond,"Ellis, Brandon",20,14,6,6,0,0,0,1
Richmond,"Elton, Todd",11,2,2,9,0,0,2,1
Richmond,"Grigg, Shaun",19,12,9,7,0,0,0,1
Richmond,"Grimes, Dylan",15,6,3,9,0,0,0,1
Richmond,"Hampson, Shaun",5,2,1,3,1,0,29,2
Richmond,"Houli, Bachar",23,12,2,11,0,0,0,3
Richmond,"Hunt, Taylor",28,15,8,13,0,0,0,1
Richmond,"Lambert, Kane",17,10,4,7,0,2,0,2
Richmond,"Lloyd, Sam",13,11,4,2,1,0,0,4
Richmond,"Markov, Oleg",15,11,3,4,0,0,0,1
Richmond,"Martin, Dustin",33,20,5,13,0,0,0,5
Richmond,"Moore, Andrew",23,9,2,14,0,0,0,0
Richmond,"Moore, Callum",7,5,3,2,0,0,0,3
Richmond,"Rance, Alex",22,14,9,8,0,0,0,2
Richmond,"Riewoldt, Jack",12,7,6,5,1,2,1,0
Richmond,"Rioli, Daniel",10,4,2,6,0,0,0,5
Richmond,"Short, Jayden",15,6,2,9,0,0,0,3
Richmond,"Vlastuin, Nick",16,3,1,13,0,0,1,3
St Kilda,"Acres, Blake",22,14,3,8,1,0,0,2
St Kilda,"Armitage, David",28,12,1,16,1,0,0,7
St Kilda,"Billings, Jack",22,10,4,12,0,0,0,2
St Kilda,"Bruce, Josh",11,6,5,5,2,0,0,1
St Kilda,"Dempster, Sean",8,6,4,2,0,0,0,2
St Kilda,"Dunstan, Luke",10,2,1,8,0,0,0,9
St Kilda,"Fisher, Sam",18,14,5,4,0,0,1,2
St Kilda,"Geary, Jarryn",19,11,3,8,0,0,0,1
St Kilda,"Gilbert, Sam",27,10,3,17,1,1,4,5
St Kilda,"Gresham, Jade",9,3,1,6,1,0,0,4
St Kilda,"Hickey, Tom",20,9,2,11,0,0,56,3
St Kilda,"Lonie, Jack",9,5,4,4,3,1,0,1
St Kilda,"Montagna, Leigh",29,17,7,12,0,0,0,4
St Kilda,"Newnes, Jack",26,14,3,12,1,1,0,3
St Kilda,"Riewoldt, Nick",10,4,5,6,2,0,0,1
St Kilda,"Roberton, Dylan",20,11,2,9,0,0,0,2
St Kilda,"Ross, Sebastian",30,16,5,14,0,0,4,6
St Kilda,"Savage, Shane",25,16,3,9,0,0,0,2
St Kilda,"Steven, Jack",36,19,2,17,1,0,0,5
St Kilda,"Templeton, Eli",10,4,2,6,0,0,0,3
St Kilda,"Webster, Jimmy",18,11,3,7,0,0,0,1
St Kilda,"Weller, Maverick",21,9,2,12,2,2,1,6
St Kilda,"Armitage, David",23,11,5,12,0,0,0,5
St Kilda,"Billings, Jack",19,12,3,7,0,0,0,0
St Kilda,"Bruce, Josh",12,9,4,3,1,4,1,6
St Kilda,"Dempster, Sean",13,5,5,8,0,0,0,1
St Kilda,"Dunstan, Luke",16,6,2,10,0,0,0,6
St Kilda,"Fisher, Sam",12,7,5,5,0,0,0,1
St Kilda,"Geary, Jarryn",8,4,1,4,0,0,0,3
St Kilda,"Gilbert, Sam",7,4,1,3,0,0,4,6
St Kilda,"Gresham, Jade",13,5,3,8,0,0,0,4
St Kilda,"Hickey, Tom",9,4,1,5,0,0,22,2
St Kilda,"Lonie, Jack",10,7,3,3,1,0,0,2
St Kilda,"McCartin, Paddy",9,6,6,3,0,0,0,1
St Kilda,"Montagna, Leigh",31,16,7,15,0,0,0,2
St Kilda,"Newnes, Jack",23,11,7,12,1,0,0,5
St Kilda,"Riewoldt, Nick",23,14,14,9,2,2,1,1
St Kilda,"Roberton, Dylan",19,10,8,9,0,0,0,2
St Kilda,"Ross, Sebastian",18,9,2,9,0,0,0,6
St Kilda,"Savage, Shane",22,13,3,9,0,0,0,0
St Kilda,"Sinclair, Jack",12,4,3,8,0,0,0,2
St Kilda,"Steven, Jack",29,15,3,14,0,0,0,5
St Kilda,"Webster, Jimmy",13,10,6,3,0,0,0,2
St Kilda,"Weller, Maverick",15,5,4,10,0,0,0,5
St Kilda,"Armitage, David",19,7,4,12,1,1,0,5
St Kilda,"Billings, Jack",30,18,5,12,2,0,0,5
St Kilda,"Bruce, Josh",12,6,7,6,2,2,1,2
St Kilda,"Dempster, Sean",16,10,6,6,0,0,0,1
St Kilda,"Dunstan, Luke",25,6,5,19,0,0,0,7
St Kilda,"Fisher, Sam",18,14,7,4,0,0,0,2
St Kilda,"Geary, Jarryn",20,10,5,10,0,0,0,1
St Kilda,"Gilbert, Sam",19,12,7,7,2,1,1,1
St Kilda,"Hickey, Tom",10,5,2,5,0,0,30,5
St Kilda,"Lonie, Jack",10,6,6,4,1,3,0,3
St Kilda,"McCartin, Paddy",5,5,3,0,1,2,0,0
St Kilda,"Minchington, Darren",15,8,3,7,0,1,0,3
St Kilda,"Montagna, Leigh",40,25,14,15,0,1,0,3
St Kilda,"Newnes, Jack",34,21,6,13,0,0,0,4
St Kilda,"Riewoldt, Nick",11,9,7,2,2,0,1,1
St Kilda,"Roberton, Dylan",14,7,2,7,0,0,0,3
St Kilda,"Ross, Sebastian",31,21,3,10,0,0,3,1
St Kilda,"Savage, Shane",28,15,6,13,0,0,0,1
St Kilda,"Sinclair, Jack",16,9,10,7,1,0,0,0
St Kilda,"Steven, Jack",30,16,5,14,3,0,0,6
St Kilda,"Webster, Jimmy",24,9,7,15,0,0,0,5
St Kilda,"Weller, Maverick",19,11,6,8,3,0,0,2
St Kilda,"Acres, Blake",13,7,2,6,0,0,0,1
St Kilda,"Armitage, David",35,15,3,20,1,0,0,6
St Kilda,"Billings, Jack",27,13,7,14,0,0,0,6
St Kilda,"Bruce, Josh",10,6,3,4,2,0,2,1
St Kilda,"Dempster, Sean",18,14,9,4,0,0,0,2
St Kilda,"Fisher, Sam",13,6,2,7,0,0,1,2
St Kilda,"Geary, Jarryn",16,6,5,10,0,0,0,3
St Kilda,"Gilbert, Sam",17,5,2,12,1,0,2,10
St Kilda,"Hickey, Tom",10,4,1,6,0,0,31,3
St Kilda,"Lee, Tom",19,14,9,5,0,0,0,2
St Kilda,"Lonie, Jack",11,6,2,5,1,1,0,2
St Kilda,"McCartin, Paddy",9,6,5,3,2,1,0,3
St Kilda,"Minchington, Darren",14,6,3,8,2,0,0,3
St Kilda,"Montagna, Leigh",27,18,5,9,0,0,0,3
St Kilda,"Newnes, Jack",25,12,4,13,0,0,0,3
St Kilda,"Riewoldt, Nick",23,13,12,10,2,1,6,3
St Kilda,"Ross, Sebastian",28,14,3,14,0,0,0,4
St Kilda,"Savage, Shane",30,13,6,17,0,1,0,1
St Kilda,"Sinclair, Jack",15,6,5,9,0,1,0,2
St Kilda,"Steven, Jack",23,11,2,12,0,0,0,8
St Kilda,"Templeton, Eli",9,5,1,4,1,1,0,3
St Kilda,"Weller, Maverick",18,6,2,12,1,0,0,7
St Kilda,"Armitage, David",28,12,4,16,0,0,0,3
St Kilda,"Billings, Jack",15,9,2,6,0,1,0,1
St Kilda,"Bruce, Josh",13,7,5,6,2,1,2,1
St Kilda,"Dempster, Sean",14,6,3,8,0,0,0,0
St Kilda,"Dunstan, Luke",17,8,2,9,1,1,0,2
St Kilda,"Fisher, Sam",9,8,6,1,0,0,1,4
St Kilda,"Geary, Jarryn",12,6,2,6,0,0,0,2
St Kilda,"Gilbert, Sam",20,10,7,10,0,0,2,3
St Kilda,"Hickey, Tom",16,7,3,9,0,1,25,3
St Kilda,"Lee, Tom",14,10,4,4,0,1,1,0
St Kilda,"Lonie, Jack",10,3,1,7,0,1,0,0
St Kilda,"McCartin, Paddy",7,4,3,3,1,0,0,0
St Kilda,"Minchington, Darren",6,1,1,5,0,0,0,7
St Kilda,"Montagna, Leigh",21,14,4,7,0,0,0,0
St Kilda,"Newnes, Jack",24,15,6,9,1,0,1,4
St Kilda,"Riewoldt, Nick",25,15,11,10,4,0,3,3
St Kilda,"Ross, Sebastian",29,18,5,11,0,0,1,9
St Kilda,"Savage, Shane",25,17,7,8,2,0,0,0
St Kilda,"Sinclair, Jack",17,8,6,9,1,0,0,2
St Kilda,"Steven, Jack",30,12,2,18,0,0,0,7
St Kilda,"Webster, Jimmy",7,7,1,0,0,0,0,5
St Kilda,"Weller, Maverick",11,6,3,5,0,0,0,2
St Kilda,"Acres, Blake",28,16,7,12,2,1,0,5
St Kilda,"Armitage, David",21,8,4,13,1,0,0,3
St Kilda,"Billings, Jack",23,12,4,11,0,0,0,4
St Kilda,"Bruce, Josh",9,5,5,4,3,0,3,3
St Kilda,"Dempster, Sean",9,3,4,6,0,0,0,3
St Kilda,"Dunstan, Luke",23,8,2,15,1,1,0,7
St Kilda,"Fisher, Sam",18,12,3,6,0,1,3,1
St Kilda,"Geary, Jarryn",15,5,4,10,0,1,0,3
St Kilda,"Gilbert, Sam",17,8,2,9,0,0,1,1
St Kilda,"Gresham, Jade",8,5,2,3,1,1,0,4
St Kilda,"Hickey, Tom",13,1,1,12,0,0,36,3
St Kilda,"Membrey, Tim",16,13,8,3,5,1,0,2
St Kilda,"Minchington, Darren",11,6,2,5,0,1,0,5
St Kilda,"Montagna, Leigh",22,10,5,12,0,0,0,3
St Kilda,"Newnes, Jack",23,15,3,8,1,0,0,2
St Kilda,"Riewoldt, Nick",24,15,14,9,3,2,0,1
St Kilda,"Ross, Sebastian",26,15,5,11,0,2,2,4
St Kilda,"Savage, Shane",18,12,3,6,0,0,0,0
St Kilda,"Sinclair, Jack",19,11,1,8,2,1,0,5
St Kilda,"Steven, Jack",25,11,3,14,0,1,0,11
St Kilda,"Webster, Jimmy",13,9,2,4,0,0,0,3
St Kilda,"Weller, Maverick",16,9,4,7,1,2,0,1
St Kilda,"Acres, Blake",12,8,3,4,0,0,0,2
St Kilda,"Armitage, David",16,5,1,11,0,0,0,4
St Kilda,"Billings, Jack",15,11,7,4,1,1,0,3
St Kilda,"Bruce, Josh",8,8,5,0,2,1,0,0
St Kilda,"Dempster, Sean",12,7,7,5,0,0,0,4
St Kilda,"Dunstan, Luke",19,9,4,10,0,1,0,4
St Kilda,"Fisher, Sam",15,10,7,5,0,0,2,3
St Kilda,"Geary, Jarryn",19,8,5,11,0,1,0,2
St Kilda,"Gilbert, Sam",24,15,7,9,0,0,0,5
St Kilda,"Gresham, Jade",13,7,3,6,0,0,0,1
St Kilda,"Hickey, Tom",14,6,7,8,0,1,22,2
St Kilda,"Lonie, Jack",8,1,0,7,0,0,0,3
St Kilda,"Membrey, Tim",12,8,4,4,3,0,0,1
St Kilda,"Minchington, Darren",9,4,1,5,0,0,0,2
St Kilda,"Montagna, Leigh",34,19,6,15,0,0,0,2
St Kilda,"Newnes, Jack",27,16,6,11,0,0,0,0
St Kilda,"Riewoldt, Nick",24,18,16,6,3,0,3,2
St Kilda,"Ross, Sebastian",16,9,4,7,0,0,1,7
St Kilda,"Savage, Shane",22,14,7,8,1,1,0,2
St Kilda,"Steven, Jack",15,6,1,9,0,0,0,6
St Kilda,"Webster, Jimmy",15,10,4,5,0,0,0,3
St Kilda,"Weller, Maverick",17,5,2,12,1,1,0,3
St Kilda,"Acres, Blake",8,2,1,6,0,0,1,4
St Kilda,"Armitage, David",20,8,1,12,0,0,0,5
St Kilda,"Billings, Jack",20,9,2,11,0,1,0,5
St Kilda,"Bruce, Josh",9,5,4,4,1,1,1,2
St Kilda,"Dempster, Sean",17,6,4,11,0,0,0,2
St Kilda,"Dunstan, Luke",14,4,1,10,0,0,0,4
St Kilda,"Geary, Jarryn",14,9,1,5,0,0,0,3
St Kilda,"Gilbert, Sam",6,4,1,2,0,0,0,4
St Kilda,"Gresham, Jade",16,10,4,6,0,0,0,4
St Kilda,"Hickey, Tom",11,3,3,8,0,0,26,7
St Kilda,"Lonie, Jack",8,4,1,4,0,1,0,6
St Kilda,"Membrey, Tim",5,3,2,2,0,2,0,2
St Kilda,"Montagna, Leigh",33,19,8,14,0,0,0,5
St Kilda,"Newnes, Jack",20,12,5,8,0,0,0,1
St Kilda,"Riewoldt, Nick",22,16,10,6,0,2,3,1
St Kilda,"Roberton, Dylan",24,13,5,11,0,0,1,3
St Kilda,"Ross, Sebastian",31,19,4,12,0,0,3,8
St Kilda,"Savage, Shane",25,16,8,9,0,0,0,3
St Kilda,"Sinclair, Jack",8,3,2,5,0,0,0,3
St Kilda,"Steven, Jack",29,8,2,21,1,0,0,1
St Kilda,"Webster, Jimmy",20,8,1,12,0,0,0,4
St Kilda,"Weller, Maverick",16,6,3,10,1,0,1,6
St Kilda,"Armitage, David",18,13,6,5,1,1,0,7
St Kilda,"Billings, Jack",18,13,2,5,0,2,0,5
St Kilda,"Bruce, Josh",16,9,5,7,5,1,3,6
St Kilda,"Dempster, Sean",14,8,4,6,0,0,0,1
St Kilda,"Dunstan, Luke",26,9,5,17,0,0,0,2
St Kilda,"Fisher, Sam",14,7,7,7,0,0,0,4
St Kilda,"Geary, Jarryn",16,10,7,6,0,0,0,0
St Kilda,"Gilbert, Sam",7,4,2,3,0,0,0,4
St Kilda,"Gresham, Jade",12,7,2,5,0,0,0,2
St Kilda,"Hickey, Tom",11,4,3,7,1,0,17,2
St Kilda,"McCartin, Paddy",11,9,10,2,2,1,0,0
St Kilda,"McKenzie, Daniel",12,5,2,7,0,1,0,4
St Kilda,"Membrey, Tim",14,12,9,2,3,3,0,0
St Kilda,"Montagna, Leigh",26,20,5,6,0,2,0,3
St Kilda,"Newnes, Jack",21,12,2,9,1,0,1,2
St Kilda,"Riewoldt, Nick",24,13,9,11,0,0,3,5
St Kilda,"Roberton, Dylan",9,5,1,4,0,0,0,0
St Kilda,"Ross, Sebastian",37,16,11,21,1,0,0,2
St Kilda,"Savage, Shane",17,11,6,6,0,0,0,3
St Kilda,"Steven, Jack",40,20,5,20,1,0,0,4
St Kilda,"Webster, Jimmy",10,7,2,3,0,0,0,2
St Kilda,"Weller, Maverick",13,5,4,8,1,2,0,5
St Kilda,"Armitage, David",28,16,3,12,1,0,0,17
St Kilda,"Bruce, Josh",10,8,4,2,2,2,1,2
St Kilda,"Dempster, Sean",14,9,7,5,0,0,0,1
St Kilda,"Dunstan, Luke",15,9,5,6,0,1,0,6
St Kilda,"Fisher, Sam",14,10,6,4,0,0,0,0
St Kilda,"Geary, Jarryn",18,10,3,8,0,0,0,3
St Kilda,"Gilbert, Sam",16,5,4,11,0,0,2,6
St Kilda,"Gresham, Jade",13,6,4,7,1,0,0,7
St Kilda,"Hickey, Tom",12,5,3,7,0,0,41,3
St Kilda,"McCartin, Paddy",9,7,5,2,2,0,0,0
St Kilda,"McKenzie, Daniel",11,4,3,7,0,0,0,4
St Kilda,"Membrey, Tim",15,9,6,6,3,2,0,4
St Kilda,"Montagna, Leigh",25,15,11,10,0,0,0,7
St Kilda,"Murdoch, Brodie",13,9,5,4,1,0,0,3
St Kilda,"Newnes, Jack",19,13,9,6,1,0,1,6
St Kilda,"Riewoldt, Nick",24,17,11,7,2,2,1,6
St Kilda,"Roberton, Dylan",29,12,6,17,0,0,0,1
St Kilda,"Ross, Sebastian",24,12,1,12,0,0,1,5
St Kilda,"Savage, Shane",22,12,5,10,0,0,0,4
St Kilda,"Sinclair, Jack",9,2,3,7,0,0,0,4
St Kilda,"Steven, Jack",32,15,5,17,1,0,0,9
St Kilda,"Weller, Maverick",15,5,2,10,1,0,0,3
St Kilda,"Armitage, David",25,14,4,11,0,0,0,3
St Kilda,"Billings, Jack",17,8,5,9,0,2,0,1
St Kilda,"Bruce, Josh",11,5,4,6,2,0,0,2
St Kilda,"Dempster, Sean",7,4,3,3,0,0,0,0
St Kilda,"Dunstan, Luke",13,6,3,7,0,2,0,3
St Kilda,"Geary, Jarryn",7,3,1,4,0,0,0,3
St Kilda,"Gilbert, Sam",10,6,2,4,0,0,2,4
St Kilda,"Goddard, Hugh",2,0,0,2,0,0,0,0
St Kilda,"Gresham, Jade",16,7,4,9,1,0,0,3
St Kilda,"Hickey, Tom",12,4,2,8,0,0,19,4
St Kilda,"McCartin, Paddy",9,5,4,4,1,1,0,0
St Kilda,"Membrey, Tim",11,7,7,4,1,1,0,2
St Kilda,"Montagna, Leigh",12,6,4,6,0,0,0,0
St Kilda,"Murdoch, Brodie",8,4,5,4,0,0,0,0
St Kilda,"Newnes, Jack",15,8,4,7,0,1,0,2
St Kilda,"Riewoldt, Nick",13,11,5,2,1,0,2,1
St Kilda,"Roberton, Dylan",13,7,2,6,0,0,0,2
St Kilda,"Ross, Sebastian",16,9,0,7,0,0,1,3
St Kilda,"Savage, Shane",25,11,6,14,0,1,2,2
St Kilda,"Steven, Jack",31,16,3,15,0,0,0,4
St Kilda,"Webster, Jimmy",10,8,1,2,0,0,0,4
St Kilda,"Weller, Maverick",15,7,1,8,0,0,0,2
St Kilda,"Acres, Blake",15,8,3,7,1,0,2,4
St Kilda,"Armitage, David",18,6,4,12,0,0,0,7
St Kilda,"Bruce, Josh",11,7,7,4,0,1,0,4
St Kilda,"Delaney, Luke",4,0,3,4,0,0,0,0
St Kilda,"Dunstan, Luke",18,4,2,14,0,2,0,5
St Kilda,"Geary, Jarryn",14,11,4,3,0,0,0,5
St Kilda,"Gilbert, Sam",17,6,1,11,0,0,0,2
St Kilda,"Gresham, Jade",12,8,3,4,2,0,0,2
St Kilda,"Hickey, Tom",16,9,3,7,1,0,32,4
St Kilda,"Lee, Tom",2,2,1,0,0,0,0,1
St Kilda,"Membrey, Tim",17,11,10,6,5,1,0,2
St Kilda,"Minchington, Darren",16,8,4,8,0,0,0,2
St Kilda,"Montagna, Leigh",26,19,4,7,1,0,0,4
St Kilda,"Newnes, Jack",25,15,5,10,1,0,1,4
St Kilda,"Pierce, Lewis",6,2,1,4,1,0,10,1
St Kilda,"Roberton, Dylan",17,13,8,4,0,0,0,2
St Kilda,"Ross, Sebastian",33,16,4,17,1,0,2,0
St Kilda,"Savage, Shane",19,12,5,7,0,0,0,2
St Kilda,"Steven, Jack",25,19,3,6,3,1,0,9
St Kilda,"Webster, Jimmy",23,13,4,10,0,0,0,2
St Kilda,"Weller, Maverick",14,8,3,6,1,2,0,4
St Kilda,"Wright, Nathan",5,1,0,4,0,0,0,4
St Kilda,"Acres, Blake",21,15,3,6,0,0,0,2
St Kilda,"Armitage, David",15,6,3,9,0,0,0,5
St Kilda,"Bruce, Josh",10,4,3,6,1,0,1,2
St Kilda,"Delaney, Luke",8,5,4,3,0,0,0,4
St Kilda,"Dunstan, Luke",20,11,3,9,0,0,0,5
St Kilda,"Geary, Jarryn",14,8,4,6,0,0,0,5
St Kilda,"Gilbert, Sam",11,8,3,3,0,0,0,2
St Kilda,"Gresham, Jade",16,11,3,5,1,0,0,2
St Kilda,"Hickey, Tom",12,4,0,8,0,0,25,2
St Kilda,"McCartin, Paddy",9,6,6,3,1,1,0,0
St Kilda,"Membrey, Tim",13,7,4,6,1,1,0,1
St Kilda,"Minchington, Darren",13,7,4,6,3,1,0,6
St Kilda,"Montagna, Leigh",24,17,7,7,0,0,0,3
St Kilda,"Newnes, Jack",18,9,4,9,2,0,0,1
St Kilda,"Riewoldt, Nick",26,18,10,8,0,0,3,4
St Kilda,"Roberton, Dylan",15,9,6,6,0,0,0,2
St Kilda,"Ross, Sebastian",33,16,6,17,0,1,1,3
St Kilda,"Savage, Shane",15,9,3,6,0,2,0,2
St Kilda,"Steven, Jack",25,15,3,10,1,0,0,3
St Kilda,"Webster, Jimmy",9,5,3,4,0,0,0,0
St Kilda,"Weller, Maverick",19,9,7,10,2,0,0,6
St Kilda,"Wright, Nathan",9,5,3,4,2,0,0,3
St Kilda,"Acres, Blake",17,8,3,9,0,0,0,3
St Kilda,"Armitage, David",17,8,1,9,0,0,0,5
St Kilda,"Bruce, Josh",12,4,1,8,1,0,2,1
St Kilda,"Delaney, Luke",9,0,4,9,0,0,0,1
St Kilda,"Dunstan, Luke",15,7,0,8,0,0,0,5
St Kilda,"Geary, Jarryn",17,6,1,11,0,0,0,1
St Kilda,"Gilbert, Sam",17,8,5,9,0,1,2,2
St Kilda,"Gresham, Jade",16,5,0,11,1,2,0,3
St Kilda,"Hickey, Tom",13,6,5,7,0,2,18,1
St Kilda,"Lee, Tom",8,7,4,1,0,0,1,0
St Kilda,"Lonie, Jack",14,7,1,7,1,1,0,1
St Kilda,"McCartin, Paddy",2,2,1,0,0,0,0,0
St Kilda,"Membrey, Tim",18,9,4,9,2,1,0,2
St Kilda,"Minchington, Darren",13,5,1,8,0,0,0,3
St Kilda,"Montagna, Leigh",25,12,5,13,0,1,0,1
St Kilda,"Newnes, Jack",20,16,3,4,2,0,0,3
St Kilda,"Riewoldt, Nick",21,14,10,7,0,5,6,0
St Kilda,"Roberton, Dylan",15,9,4,6,0,0,0,1
St Kilda,"Ross, Sebastian",19,11,1,8,0,0,3,3
St Kilda,"Savage, Shane",19,12,4,7,0,0,0,1
St Kilda,"Steven, Jack",21,10,0,11,0,0,0,4
St Kilda,"Weller, Maverick",15,9,3,6,1,4,0,4
St Kilda,"Acres, Blake",12,3,1,9,0,0,1,1
St Kilda,"Armitage, David",23,11,4,12,1,0,0,5
St Kilda,"Bruce, Josh",12,3,3,9,1,1,2,6
St Kilda,"Delaney, Luke",11,4,4,7,0,0,0,2
St Kilda,"Dempster, Sean",8,2,1,6,0,0,0,0
St Kilda,"Dunstan, Luke",24,7,2,17,1,1,0,2
St Kilda,"Geary, Jarryn",16,7,3,9,0,0,0,2
St Kilda,"Gilbert, Sam",14,7,3,7,0,0,4,3
St Kilda,"Gresham, Jade",19,10,4,9,1,1,0,3
St Kilda,"Hickey, Tom",13,6,1,7,0,0,46,8
St Kilda,"McKenzie, Daniel",12,3,4,9,0,0,0,7
St Kilda,"Membrey, Tim",11,7,4,4,5,0,0,0
St Kilda,"Minchington, Darren",12,4,2,8,1,1,0,5
St Kilda,"Montagna, Leigh",28,15,3,13,0,0,0,1
St Kilda,"Newnes, Jack",27,17,3,10,1,0,0,3
St Kilda,"Riewoldt, Nick",21,15,7,6,1,1,5,2
St Kilda,"Roberton, Dylan",20,9,5,11,1,0,0,0
St Kilda,"Ross, Sebastian",32,11,2,21,1,0,2,6
St Kilda,"Savage, Shane",8,4,3,4,0,0,0,4
St Kilda,"Steven, Jack",41,21,0,20,1,0,0,12
St Kilda,"Weller, Maverick",13,10,2,3,2,1,0,2
St Kilda,"Wright, Nathan",9,5,2,4,0,0,0,6
St Kilda,"Acres, Blake",12,6,3,6,0,2,3,5
St Kilda,"Armitage, David",14,5,0,9,0,0,0,6
St Kilda,"Billings, Jack",18,8,6,10,0,3,0,3
St Kilda,"Bruce, Josh",10,3,6,7,2,0,0,3
St Kilda,"Dempster, Sean",14,11,6,3,0,0,0,0
St Kilda,"Dunstan, Luke",17,8,2,9,1,1,0,5
St Kilda,"Geary, Jarryn",15,7,4,8,2,0,0,0
St Kilda,"Gilbert, Sam",16,10,2,6,0,0,0,3
St Kilda,"Gresham, Jade",19,8,1,11,0,0,0,2
St Kilda,"Hickey, Tom",21,8,4,13,0,1,27,2
St Kilda,"McKenzie, Daniel",11,8,3,3,0,1,0,4
St Kilda,"Membrey, Tim",16,12,10,4,4,2,0,2
St Kilda,"Minchington, Darren",6,4,2,2,0,0,0,1
St Kilda,"Montagna, Leigh",26,16,5,10,1,0,0,5
St Kilda,"Newnes, Jack",21,10,1,11,0,0,0,4
St Kilda,"Riewoldt, Nick",18,13,10,5,1,2,4,2
St Kilda,"Roberton, Dylan",16,11,4,5,1,0,0,1
St Kilda,"Ross, Sebastian",24,11,6,13,0,0,4,2
St Kilda,"Sinclair, Jack",14,7,1,7,0,2,0,4
St Kilda,"Steven, Jack",25,10,4,15,0,1,0,6
St Kilda,"Weller, Maverick",16,9,6,7,3,2,0,3
St Kilda,"Wright, Nathan",13,7,2,6,0,2,0,4
St Kilda,"Acres, Blake",12,6,5,6,0,0,3,1
St Kilda,"Armitage, David",18,10,3,8,1,0,0,6
St Kilda,"Billings, Jack",17,9,2,8,0,1,1,3
St Kilda,"Bruce, Josh",8,2,2,6,0,2,1,1
St Kilda,"Dempster, Sean",23,12,10,11,0,0,0,2
St Kilda,"Dunstan, Luke",17,11,3,6,0,0,0,6
St Kilda,"Geary, Jarryn",20,11,6,9,0,0,0,2
St Kilda,"Gilbert, Sam",12,7,2,5,0,0,1,4
St Kilda,"Gresham, Jade",19,12,4,7,1,0,0,2
St Kilda,"Hickey, Tom",18,6,6,12,0,1,34,3
St Kilda,"McKenzie, Daniel",12,5,3,7,0,0,0,1
St Kilda,"Membrey, Tim",14,9,6,5,2,1,0,1
St Kilda,"Montagna, Leigh",23,14,7,9,0,0,0,2
St Kilda,"Newnes, Jack",26,15,5,11,0,0,0,5
St Kilda,"Riewoldt, Nick",19,14,10,5,4,0,4,0
St Kilda,"Roberton, Dylan",23,13,9,10,0,1,0,1
St Kilda,"Ross, Sebastian",15,10,4,5,0,0,1,4
St Kilda,"Savage, Shane",22,15,5,7,0,1,0,3
St Kilda,"Sinclair, Jack",3,1,0,2,0,0,0,2
St Kilda,"Steven, Jack",39,17,6,22,1,0,0,7
St Kilda,"Weller, Maverick",22,13,8,9,1,1,0,3
St Kilda,"Wright, Nathan",9,5,2,4,1,1,0,4
St Kilda,"Acres, Blake",22,11,4,11,1,0,0,4
St Kilda,"Armitage, David",15,4,1,11,0,0,0,6
St Kilda,"Billings, Jack",22,11,6,11,0,0,0,3
St Kilda,"Bruce, Josh",7,5,3,2,2,2,5,4
St Kilda,"Dempster, Sean",10,6,4,4,0,0,0,1
St Kilda,"Dunstan, Luke",12,7,0,5,1,0,0,3
St Kilda,"Geary, Jarryn",13,9,3,4,0,0,0,0
St Kilda,"Gilbert, Sam",7,3,1,4,0,0,0,1
St Kilda,"Gresham, Jade",17,8,2,9,0,1,0,4
St Kilda,"Hickey, Tom",8,5,4,3,0,1,21,2
St Kilda,"McKenzie, Daniel",9,4,2,5,0,0,0,1
St Kilda,"Membrey, Tim",12,8,7,4,0,1,0,2
St Kilda,"Minchington, Darren",15,5,0,10,0,1,0,4
St Kilda,"Montagna, Leigh",22,7,2,15,1,0,0,1
St Kilda,"Newnes, Jack",13,5,1,8,0,0,2,4
St Kilda,"Riewoldt, Nick",16,13,8,3,2,2,3,0
St Kilda,"Roberton, Dylan",15,11,5,4,0,2,0,2
St Kilda,"Ross, Sebastian",25,10,5,15,0,0,1,7
St Kilda,"Savage, Shane",12,7,2,5,0,0,0,0
St Kilda,"Steven, Jack",21,13,1,8,0,0,0,4
St Kilda,"Weller, Maverick",16,10,5,6,1,1,0,2
St Kilda,"Wright, Nathan",15,5,5,10,0,1,0,1
St Kilda,"Acres, Blake",23,10,3,13,1,0,2,3
St Kilda,"Armitage, David",18,10,4,8,1,0,1,7
St Kilda,"Billings, Jack",19,7,9,12,2,1,0,4
St Kilda,"Bruce, Josh",14,10,9,4,4,1,0,4
St Kilda,"Dempster, Sean",15,10,12,5,0,0,0,1
St Kilda,"Dunstan, Luke",12,9,2,3,0,1,0,5
St Kilda,"Fisher, Sam",12,9,7,3,0,0,0,2
St Kilda,"Geary, Jarryn",21,9,3,12,0,0,0,2
St Kilda,"Gilbert, Sam",14,7,5,7,0,0,0,2
St Kilda,"Gresham, Jade",25,15,3,10,0,1,0,2
St Kilda,"Hickey, Tom",16,5,7,11,1,0,22,3
St Kilda,"Membrey, Tim",11,9,7,2,5,2,0,0
St Kilda,"Minchington, Darren",8,2,1,6,0,0,0,10
St Kilda,"Montagna, Leigh",32,16,5,16,0,0,0,1
St Kilda,"Newnes, Jack",32,24,9,8,1,0,2,0
St Kilda,"Riewoldt, Nick",21,16,16,5,1,1,0,1
St Kilda,"Roberton, Dylan",28,17,6,11,1,0,0,1
St Kilda,"Ross, Sebastian",27,14,8,13,0,0,1,3
St Kilda,"Savage, Shane",15,12,2,3,0,0,0,5
St Kilda,"Steven, Jack",19,11,3,8,0,0,0,1
St Kilda,"Weller, Maverick",17,14,8,3,1,0,0,4
St Kilda,"Wright, Nathan",5,2,3,3,1,0,0,1
St Kilda,"Acres, Blake",23,16,4,7,1,3,0,5
St Kilda,"Armitage, David",29,8,6,21,1,0,0,6
St Kilda,"Billings, Jack",13,7,3,6,0,0,0,3
St Kilda,"Bruce, Josh",11,5,5,6,0,1,0,3
St Kilda,"Dempster, Sean",14,10,8,4,1,0,0,1
St Kilda,"Fisher, Sam",11,3,2,8,0,0,0,0
St Kilda,"Gilbert, Sam",11,3,1,8,0,0,0,2
St Kilda,"Gresham, Jade",16,9,2,7,0,0,0,3
St Kilda,"Hickey, Tom",10,2,2,8,0,0,24,3
St Kilda,"McCartin, Paddy",5,4,4,1,2,0,0,0
St Kilda,"McKenzie, Daniel",15,9,4,6,0,0,0,3
St Kilda,"Membrey, Tim",9,7,5,2,1,0,0,2
St Kilda,"Minchington, Darren",8,3,2,5,0,0,0,3
St Kilda,"Montagna, Leigh",27,12,6,15,1,0,0,6
St Kilda,"Newnes, Jack",20,14,2,6,1,1,2,8
St Kilda,"Riewoldt, Nick",24,13,6,11,1,1,7,4
St Kilda,"Roberton, Dylan",16,8,4,8,0,0,0,2
St Kilda,"Ross, Sebastian",28,13,2,15,0,0,1,4
St Kilda,"Savage, Shane",21,12,4,9,0,0,0,6
St Kilda,"Steven, Jack",25,13,0,12,0,1,0,3
St Kilda,"Weller, Maverick",18,6,2,12,1,1,0,4
St Kilda,"Wright, Nathan",8,6,1,2,1,0,0,8
St Kilda,"Acres, Blake",26,15,8,11,0,0,1,7
St Kilda,"Armitage, David",20,10,6,10,0,0,0,4
St Kilda,"Billings, Jack",25,15,4,10,1,0,1,5
St Kilda,"Bruce, Josh",9,5,4,4,0,2,2,2
St Kilda,"Dempster, Sean",18,14,7,4,0,0,0,3
St Kilda,"Geary, Jarryn",15,5,4,10,0,0,0,2
St Kilda,"Gilbert, Sam",21,11,7,10,0,1,0,2
St Kilda,"Gresham, Jade",16,10,3,6,1,0,0,2
St Kilda,"Holmes, Jason",5,1,0,4,0,0,25,3
St Kilda,"Lonie, Jack",11,6,2,5,0,0,0,1
St Kilda,"McCartin, Paddy",2,2,1,0,2,0,0,0
St Kilda,"McKenzie, Daniel",14,8,6,6,0,0,0,3
St Kilda,"Membrey, Tim",18,11,6,7,2,0,0,2
St Kilda,"Montagna, Leigh",33,20,9,13,0,0,0,3
St Kilda,"Newnes, Jack",28,13,4,15,0,0,1,2
St Kilda,"Riewoldt, Nick",21,15,10,6,1,2,2,1
St Kilda,"Roberton, Dylan",24,19,8,5,0,0,0,1
St Kilda,"Ross, Sebastian",34,17,7,17,0,2,2,6
St Kilda,"Savage, Shane",22,9,7,13,0,1,0,3
St Kilda,"Steven, Jack",23,16,5,7,0,1,0,6
St Kilda,"Weller, Maverick",17,6,3,11,0,0,0,5
St Kilda,"Wright, Nathan",8,5,2,3,0,1,0,2
St Kilda,"Acres, Blake",18,15,4,3,0,0,1,1
St Kilda,"Armitage, David",30,15,10,15,1,0,0,3
St Kilda,"Billings, Jack",23,9,1,14,0,0,1,3
St Kilda,"Bruce, Josh",8,5,6,3,3,0,0,3
St Kilda,"Dempster, Sean",13,5,5,8,0,0,0,2
St Kilda,"Fisher, Sam",17,8,7,9,0,1,0,0
St Kilda,"Geary, Jarryn",11,9,2,2,1,0,0,5
St Kilda,"Gilbert, Sam",20,10,8,10,1,0,1,1
St Kilda,"Holmes, Jason",2,1,0,1,0,0,34,4
St Kilda,"Lonie, Jack",14,8,3,6,3,0,0,3
St Kilda,"McKenzie, Daniel",18,4,6,14,0,0,0,2
St Kilda,"Membrey, Tim",8,7,4,1,2,0,0,2
St Kilda,"Montagna, Leigh",22,12,6,10,0,0,0,1
St Kilda,"Newnes, Jack",25,20,6,5,1,0,0,0
St Kilda,"Riewoldt, Nick",26,24,21,2,9,1,1,1
St Kilda,"Roberton, Dylan",23,18,2,5,0,0,2,0
St Kilda,"Ross, Sebastian",26,12,7,14,0,0,0,3
St Kilda,"Savage, Shane",13,7,4,6,0,1,0,2
St Kilda,"Steven, Jack",31,16,4,15,1,1,0,2
St Kilda,"Weller, Maverick",17,11,5,6,0,0,1,5
St Kilda,"White, Brandon",13,7,1,6,1,0,0,0
St Kilda,"Wright, Nathan",8,4,1,4,2,0,0,3
Sydney,"Cunningham, Harry",12,9,3,3,2,1,0,4
Sydney,"Franklin, Lance",18,14,5,4,4,1,0,0
Sydney,"Grundy, Heath",19,9,4,10,0,0,0,0
Sydney,"Hannebery, Dan",21,7,2,14,1,1,0,3
Sydney,"Heeney, Isaac",23,14,8,9,1,3,0,2
Sydney,"Hewett, George",15,10,7,5,1,2,0,7
Sydney,"Jack, Kieren",35,17,4,18,0,1,0,4
Sydney,"Jones, Zak",17,10,3,7,1,0,0,1
Sydney,"Kennedy, Josh",23,10,0,13,0,1,0,2
Sydney,"Laidler, Jeremy",17,5,1,12,0,0,0,2
Sydney,"Lloyd, Jake",35,17,3,18,0,0,0,3
Sydney,"Mills, Callum",18,9,2,9,0,2,0,2
Sydney,"Mitchell, Tom",30,12,2,18,3,2,0,9
Sydney,"Papley, Tom",11,8,5,3,3,1,0,5
Sydney,"Parker, Luke",40,13,8,27,1,1,0,3
Sydney,"Rampe, Dane",17,11,3,6,0,0,0,3
Sydney,"Robinson, Dan",17,9,2,8,0,0,0,4
Sydney,"Sinclair, Callum",12,8,4,4,0,2,11,3
Sydney,"Smith, Nick",12,8,4,4,0,0,0,3
Sydney,"Talia, Michael",10,7,3,3,0,0,0,1
Sydney,"Tippett, Kurt",8,4,4,4,0,1,32,5
Sydney,"Towers, Dean",19,8,4,11,1,0,1,1
Sydney,"Cunningham, Harry",17,7,7,10,1,0,0,5
Sydney,"Franklin, Lance",18,10,4,8,4,3,0,0
Sydney,"Grundy, Heath",13,6,5,7,0,0,0,1
Sydney,"Hannebery, Dan",29,13,3,16,0,0,0,5
Sydney,"Heeney, Isaac",14,7,4,7,1,2,0,1
Sydney,"Hewett, George",15,12,3,3,1,1,0,3
Sydney,"Jack, Kieren",26,13,6,13,0,0,0,5
Sydney,"Jones, Zak",10,8,2,2,0,0,0,3
Sydney,"Kennedy, Josh",27,13,2,14,2,0,0,5
Sydney,"Laidler, Jeremy",12,8,5,4,0,0,0,2
Sydney,"Lloyd, Jake",19,13,5,6,0,0,0,1
Sydney,"Mills, Callum",19,11,5,8,0,0,0,1
Sydney,"Mitchell, Tom",34,15,8,19,0,0,0,9
Sydney,"Papley, Tom",17,8,3,9,2,2,0,3
Sydney,"Parker, Luke",29,16,6,13,1,1,1,2
Sydney,"Rampe, Dane",17,11,3,6,0,0,0,1
Sydney,"Richards, Ted",5,3,2,2,0,0,0,0
Sydney,"Robinson, Dan",18,8,6,10,1,0,0,3
Sydney,"Sinclair, Callum",17,10,7,7,3,0,6,1
Sydney,"Smith, Nick",16,9,3,7,0,0,0,2
Sydney,"Tippett, Kurt",16,7,7,9,4,0,21,4
Sydney,"Towers, Dean",13,6,4,7,0,1,0,2
Sydney,"Cunningham, Harry",9,6,4,3,0,0,0,3
Sydney,"Franklin, Lance",18,15,6,3,4,1,0,4
Sydney,"Grundy, Heath",19,10,3,9,0,0,0,0
Sydney,"Hannebery, Dan",31,16,2,15,2,2,0,2
Sydney,"Heeney, Isaac",11,4,2,7,1,1,0,2
Sydney,"Hewett, George",3,1,0,2,0,0,0,4
Sydney,"Jack, Kieren",22,15,0,7,0,1,0,6
Sydney,"Jones, Zak",9,7,2,2,0,0,0,0
Sydney,"Kennedy, Josh",29,8,0,21,0,0,0,13
Sydney,"Laidler, Jeremy",14,9,4,5,0,0,0,0
Sydney,"Lloyd, Jake",25,11,5,14,0,0,0,1
Sydney,"McGlynn, Ben",17,9,2,8,1,1,0,4
Sydney,"Mills, Callum",9,3,3,6,0,0,0,1
Sydney,"Mitchell, Tom",25,16,3,9,1,2,0,7
Sydney,"Papley, Tom",14,9,1,5,1,0,0,3
Sydney,"Parker, Luke",30,10,7,20,1,0,0,6
Sydney,"Rampe, Dane",19,15,10,4,0,0,0,0
Sydney,"Richards, Ted",13,8,4,5,0,0,0,0
Sydney,"Robinson, Dan",10,8,4,2,0,1,1,5
Sydney,"Sinclair, Callum",8,4,3,4,1,0,16,0
Sydney,"Smith, Nick",17,10,5,7,0,0,0,1
Sydney,"Tippett, Kurt",9,8,4,1,2,0,32,2
Sydney,"Cunningham, Harry",15,9,4,6,1,1,0,8
Sydney,"Franklin, Lance",16,10,7,6,4,1,0,2
Sydney,"Grundy, Heath",17,10,3,7,0,0,0,0
Sydney,"Hannebery, Dan",38,18,3,20,1,2,0,5
Sydney,"Heeney, Isaac",18,11,4,7,4,0,0,1
Sydney,"Jack, Kieren",16,7,3,9,0,0,0,4
Sydney,"Kennedy, Josh",28,11,1,17,0,0,0,3
Sydney,"Laidler, Jeremy",15,8,3,7,0,0,0,5
Sydney,"Lloyd, Jake",18,10,4,8,0,0,0,3
Sydney,"McGlynn, Ben",9,4,1,5,2,0,0,6
Sydney,"McVeigh, Jarrad",13,9,3,4,0,0,0,8
Sydney,"Mills, Callum",23,12,8,11,0,0,0,3
Sydney,"Mitchell, Tom",22,9,1,13,0,0,0,4
Sydney,"Nankervis, Toby",11,3,2,8,0,0,8,9
Sydney,"Papley, Tom",5,2,0,3,0,2,0,2
Sydney,"Parker, Luke",26,11,1,15,1,1,1,6
Sydney,"Rampe, Dane",23,11,3,12,0,1,0,2
Sydney,"Richards, Ted",10,4,2,6,0,0,0,0
Sydney,"Robinson, Dan",9,5,2,4,0,1,0,7
Sydney,"Smith, Nick",15,9,1,6,0,0,0,4
Sydney,"Tippett, Kurt",13,7,2,6,2,0,35,3
Sydney,"Towers, Dean",12,6,3,6,0,0,0,1
Sydney,"Cunningham, Harry",10,2,2,8,0,0,0,2
Sydney,"Franklin, Lance",20,14,5,6,2,5,0,3
Sydney,"Grundy, Heath",15,10,7,5,0,0,0,5
Sydney,"Hannebery, Dan",28,12,3,16,0,1,0,6
Sydney,"Heeney, Isaac",10,5,5,5,1,0,0,5
Sydney,"Hewett, George",13,9,6,4,1,0,0,4
Sydney,"Jack, Kieren",23,14,2,9,0,0,0,6
Sydney,"Kennedy, Josh",31,15,4,16,0,0,0,3
Sydney,"Laidler, Jeremy",1,0,0,1,0,0,0,0
Sydney,"Lloyd, Jake",22,15,4,7,1,1,0,2
Sydney,"McGlynn, Ben",21,12,3,9,1,2,0,5
Sydney,"McVeigh, Jarrad",13,11,2,2,2,0,0,1
Sydney,"Mills, Callum",16,12,4,4,0,0,0,7
Sydney,"Mitchell, Tom",24,12,2,12,0,1,0,7
Sydney,"Papley, Tom",20,13,8,7,2,1,0,4
Sydney,"Parker, Luke",25,17,2,8,0,0,1,9
Sydney,"Rampe, Dane",14,9,3,5,0,0,0,2
Sydney,"Richards, Ted",22,15,10,7,1,0,0,2
Sydney,"Robinson, Dan",10,2,2,8,0,0,0,5
Sydney,"Sinclair, Callum",5,4,2,1,1,0,14,2
Sydney,"Smith, Nick",14,10,4,4,0,0,0,3
Sydney,"Tippett, Kurt",16,7,1,9,0,0,25,1
Sydney,"Aliir, Aliir",6,2,0,4,0,0,0,3
Sydney,"Cunningham, Harry",13,4,2,9,0,0,0,7
Sydney,"Franklin, Lance",19,15,4,4,5,3,0,3
Sydney,"Grundy, Heath",14,10,2,4,0,0,0,3
Sydney,"Hannebery, Dan",33,16,2,17,0,0,0,13
Sydney,"Heeney, Isaac",17,8,3,9,1,0,0,2
Sydney,"Hewett, George",10,7,1,3,3,0,0,2
Sydney,"Jack, Kieren",22,5,1,17,0,0,0,7
Sydney,"Jones, Zak",13,8,2,5,0,0,0,1
Sydney,"Kennedy, Josh",30,15,1,15,0,0,0,4
Sydney,"Laidler, Jeremy",16,7,4,9,0,0,0,5
Sydney,"Lloyd, Jake",20,10,1,10,0,0,0,3
Sydney,"McGlynn, Ben",14,10,3,4,2,1,0,5
Sydney,"McVeigh, Jarrad",16,11,3,5,0,0,0,7
Sydney,"Mills, Callum",17,11,1,6,0,0,0,3
Sydney,"Mitchell, Tom",28,13,5,15,0,0,0,6
Sydney,"Papley, Tom",13,8,3,5,0,1,0,4
Sydney,"Parker, Luke",29,19,4,10,3,0,1,9
Sydney,"Rampe, Dane",23,15,5,8,0,0,0,2
Sydney,"Robinson, Dan",15,6,3,9,0,0,0,6
Sydney,"Sinclair, Callum",9,4,1,5,0,0,16,1
Sydney,"Tippett, Kurt",25,15,4,10,1,1,36,3
Sydney,"Cunningham, Harry",13,4,3,9,0,0,0,1
Sydney,"Franklin, Lance",21,16,4,5,6,3,0,1
Sydney,"Grundy, Heath",22,15,9,7,0,0,0,2
Sydney,"Hannebery, Dan",31,15,5,16,0,0,0,4
Sydney,"Heeney, Isaac",22,13,9,9,5,0,0,1
Sydney,"Hewett, George",14,8,2,6,1,0,0,3
Sydney,"Jack, Kieren",20,12,7,8,2,0,0,4
Sydney,"Jones, Zak",15,9,2,6,0,0,0,5
Sydney,"Kennedy, Josh",40,14,3,26,0,0,0,3
Sydney,"Laidler, Jeremy",17,5,3,12,0,0,0,2
Sydney,"Lloyd, Jake",24,12,6,12,0,0,0,0
Sydney,"McGlynn, Ben",14,7,4,7,1,2,0,0
Sydney,"McVeigh, Jarrad",28,19,10,9,0,0,0,2
Sydney,"Mills, Callum",16,7,4,9,0,0,0,1
Sydney,"Mitchell, Tom",37,21,10,16,0,0,0,1
Sydney,"Papley, Tom",14,8,3,6,2,1,0,7
Sydney,"Parker, Luke",29,11,6,18,0,1,1,3
Sydney,"Rampe, Dane",11,6,3,5,0,0,0,4
Sydney,"Robinson, Dan",7,1,0,6,0,0,0,5
Sydney,"Sinclair, Callum",16,11,6,5,1,4,10,3
Sydney,"Smith, Nick",14,8,6,6,0,0,0,2
Sydney,"Tippett, Kurt",14,9,2,5,2,1,14,5
Sydney,"Cunningham, Harry",11,7,1,4,0,0,0,6
Sydney,"Franklin, Lance",18,14,7,4,5,0,0,0
Sydney,"Grundy, Heath",8,6,2,2,0,0,0,0
Sydney,"Hannebery, Dan",34,18,3,16,2,0,0,3
Sydney,"Heeney, Isaac",18,8,1,10,1,1,0,5
Sydney,"Hewett, George",13,6,2,7,1,0,0,3
Sydney,"Hiscox, Jack",7,5,4,2,0,1,0,1
Sydney,"Jack, Kieren",23,10,1,13,1,1,0,7
Sydney,"Jones, Zak",9,3,1,6,0,0,0,1
Sydney,"Laidler, Jeremy",10,3,0,7,0,0,0,0
Sydney,"Lloyd, Jake",23,11,2,12,1,0,0,3
Sydney,"McVeigh, Jarrad",20,12,0,8,0,1,0,2
Sydney,"Mills, Callum",17,10,3,7,0,1,0,1
Sydney,"Mitchell, Tom",16,6,4,10,0,2,0,3
Sydney,"Papley, Tom",5,4,0,1,1,0,0,5
Sydney,"Parker, Luke",20,9,1,11,0,2,0,5
Sydney,"Rampe, Dane",15,9,3,6,0,0,0,1
Sydney,"Richards, Ted",6,5,4,1,0,0,0,1
Sydney,"Sinclair, Callum",9,6,4,3,0,0,7,1
Sydney,"Smith, Nick",9,3,2,6,0,0,0,2
Sydney,"Tippett, Kurt",15,6,4,9,2,0,23,4
Sydney,"Towers, Dean",14,5,3,9,1,0,0,1
Sydney,"Cunningham, Harry",19,7,2,12,0,0,0,5
Sydney,"Franklin, Lance",16,12,4,4,3,2,0,4
Sydney,"Grundy, Heath",25,14,7,11,0,0,0,1
Sydney,"Hannebery, Dan",33,15,1,18,0,0,0,5
Sydney,"Heeney, Isaac",14,6,5,8,0,1,0,6
Sydney,"Hewett, George",18,11,4,7,0,0,0,5
Sydney,"Jack, Kieren",20,11,2,9,0,0,0,3
Sydney,"Jones, Zak",12,8,2,4,0,0,0,4
Sydney,"Kennedy, Josh",26,9,0,17,0,0,0,7
Sydney,"Laidler, Jeremy",13,7,4,6,0,0,0,1
Sydney,"Lloyd, Jake",25,16,6,9,0,0,0,3
Sydney,"McGlynn, Ben",12,7,6,5,2,0,0,3
Sydney,"McVeigh, Jarrad",17,10,3,7,0,0,0,2
Sydney,"Mills, Callum",15,7,6,8,0,0,0,1
Sydney,"Mitchell, Tom",21,8,6,13,0,1,0,5
Sydney,"Parker, Luke",30,13,1,17,0,1,0,7
Sydney,"Rampe, Dane",24,16,8,8,0,0,0,5
Sydney,"Richards, Ted",5,2,2,3,0,0,0,0
Sydney,"Rohan, Gary",10,8,5,2,3,0,0,2
Sydney,"Sinclair, Callum",9,3,4,6,0,0,12,5
Sydney,"Smith, Nick",10,8,4,2,0,0,0,2
Sydney,"Tippett, Kurt",19,12,6,7,2,1,35,4
Sydney,"Cunningham, Harry",11,2,0,9,1,0,0,5
Sydney,"Franklin, Lance",15,11,7,4,3,4,0,6
Sydney,"Grundy, Heath",12,6,7,6,0,0,0,2
Sydney,"Hannebery, Dan",34,13,6,21,1,0,0,5
Sydney,"Heeney, Isaac",13,8,5,5,1,0,0,1
Sydney,"Hewett, George",13,6,3,7,1,1,0,4
Sydney,"Jack, Kieren",26,15,3,11,0,0,0,13
Sydney,"Jones, Zak",21,16,2,5,1,0,0,3
Sydney,"Kennedy, Josh",35,9,1,26,1,0,0,12
Sydney,"Laidler, Jeremy",14,8,3,6,0,0,0,2
Sydney,"Lloyd, Jake",29,13,5,16,0,1,0,3
Sydney,"Marsh, Harrison",13,5,1,8,0,0,0,2
Sydney,"McGlynn, Ben",13,9,3,4,1,0,0,4
Sydney,"McVeigh, Jarrad",25,13,3,12,2,0,0,4
Sydney,"Mills, Callum",18,10,4,8,0,0,0,4
Sydney,"Mitchell, Tom",41,11,8,30,1,1,0,10
Sydney,"Parker, Luke",22,8,1,14,0,0,1,2
Sydney,"Rampe, Dane",12,9,5,3,0,0,0,1
Sydney,"Rohan, Gary",8,5,3,3,1,0,0,0
Sydney,"Sinclair, Callum",7,3,2,4,0,0,13,7
Sydney,"Smith, Nick",11,4,3,7,0,0,0,0
Sydney,"Tippett, Kurt",14,5,1,9,0,0,37,0
Sydney,"Cunningham, Harry",12,6,1,6,0,0,0,6
Sydney,"Franklin, Lance",18,11,3,7,1,3,0,2
Sydney,"Grundy, Heath",10,7,4,3,0,0,0,3
Sydney,"Hannebery, Dan",36,11,4,25,0,1,0,6
Sydney,"Heeney, Isaac",13,6,1,7,1,0,0,12
Sydney,"Hewett, George",2,1,0,1,0,0,0,1
Sydney,"Jack, Kieren",26,21,4,5,1,0,0,4
Sydney,"Jones, Zak",11,8,0,3,0,0,0,7
Sydney,"Kennedy, Josh",33,21,1,12,0,0,0,10
Sydney,"Laidler, Jeremy",12,8,2,4,0,0,0,4
Sydney,"Lloyd, Jake",19,14,2,5,1,0,0,6
Sydney,"Marsh, Harrison",8,6,2,2,0,0,0,2
Sydney,"McGlynn, Ben",12,5,2,7,0,1,0,6
Sydney,"McVeigh, Jarrad",25,13,1,12,0,1,0,5
Sydney,"Mitchell, Tom",33,9,0,24,1,0,0,14
Sydney,"Parker, Luke",26,11,2,15,2,0,0,10
Sydney,"Rampe, Dane",23,14,5,9,0,0,0,5
Sydney,"Rohan, Gary",19,13,5,6,2,1,0,7
Sydney,"Rose, James",16,7,4,9,1,1,0,6
Sydney,"Sinclair, Callum",12,5,0,7,1,0,23,9
Sydney,"Smith, Nick",11,10,1,1,0,0,0,7
Sydney,"Tippett, Kurt",16,14,2,2,0,0,50,3
Sydney,"Cunningham, Harry",11,6,3,5,0,0,0,4
Sydney,"Franklin, Lance",18,16,7,2,2,2,0,0
Sydney,"Grundy, Heath",17,12,3,5,0,0,0,1
Sydney,"Hannebery, Dan",28,10,2,18,0,0,0,4
Sydney,"Heeney, Isaac",12,4,1,8,0,0,0,4
Sydney,"Jack, Kieren",13,5,1,8,1,0,0,8
Sydney,"Jones, Zak",17,12,2,5,0,0,0,5
Sydney,"Kennedy, Josh",25,9,2,16,1,0,0,8
Sydney,"Laidler, Jeremy",7,2,1,5,0,0,0,2
Sydney,"Lloyd, Jake",23,12,4,11,0,1,0,2
Sydney,"Marsh, Harrison",6,3,2,3,0,0,0,2
Sydney,"McGlynn, Ben",7,4,1,3,1,0,0,3
Sydney,"McVeigh, Jarrad",22,10,5,12,0,1,0,2
Sydney,"Mills, Callum",20,8,4,12,0,0,0,0
Sydney,"Mitchell, Tom",26,11,4,15,1,0,0,4
Sydney,"Parker, Luke",13,6,3,7,0,1,1,7
Sydney,"Rampe, Dane",18,9,5,9,0,0,0,2
Sydney,"Rohan, Gary",6,4,2,2,1,0,0,2
Sydney,"Rose, James",13,10,8,3,1,3,0,7
Sydney,"Sinclair, Callum",13,8,5,5,1,0,25,3
Sydney,"Smith, Nick",16,7,2,9,0,0,0,6
Sydney,"Tippett, Kurt",8,5,2,3,0,1,11,1
Sydney,"Aliir, Aliir",10,7,2,3,0,0,0,5
Sydney,"Franklin, Lance",14,7,4,7,4,2,0,7
Sydney,"Grundy, Heath",16,13,2,3,0,0,0,8
Sydney,"Hannebery, Dan",28,10,1,18,0,0,0,7
Sydney,"Heeney, Isaac",6,3,2,3,0,1,0,13
Sydney,"Hewett, George",9,5,2,4,1,0,0,9
Sydney,"Jack, Kieren",20,12,2,8,0,3,0,8
Sydney,"Jones, Zak",25,14,4,11,0,1,0,8
Sydney,"Kennedy, Josh",28,15,0,13,1,0,0,4
Sydney,"Lloyd, Jake",21,14,2,7,1,0,0,2
Sydney,"McGlynn, Ben",16,14,4,2,2,1,0,6
Sydney,"McVeigh, Jarrad",25,14,2,11,0,0,0,9
Sydney,"Mills, Callum",23,16,2,7,0,0,0,5
Sydney,"Mitchell, Tom",25,14,4,11,0,1,0,9
Sydney,"Nankervis, Toby",7,4,2,3,1,0,9,8
Sydney,"Parker, Luke",23,16,2,7,0,0,1,17
Sydney,"Rampe, Dane",12,5,3,7,0,0,0,6
Sydney,"Rohan, Gary",13,9,1,4,0,0,0,4
Sydney,"Rose, James",16,13,6,3,0,0,0,8
Sydney,"Sinclair, Callum",11,4,1,7,0,0,14,4
Sydney,"Smith, Nick",12,11,2,1,0,0,0,3
Sydney,"Towers, Dean",27,14,6,13,2,2,5,5
Sydney,"Franklin, Lance",21,14,10,7,5,4,0,1
Sydney,"Grundy, Heath",13,7,4,6,0,0,0,2
Sydney,"Hannebery, Dan",33,17,6,16,0,1,0,7
Sydney,"Heeney, Isaac",4,3,2,1,0,0,0,5
Sydney,"Hewett, George",15,5,5,10,1,0,0,5
Sydney,"Jack, Kieren",26,14,3,12,0,0,0,1
Sydney,"Jones, Zak",13,6,2,7,0,0,0,4
Sydney,"Kennedy, Josh",34,11,3,23,0,0,0,5
Sydney,"Laidler, Jeremy",12,7,1,5,0,0,0,1
Sydney,"Lloyd, Jake",25,12,4,13,0,0,0,4
Sydney,"McGlynn, Ben",9,7,2,2,0,0,0,3
Sydney,"McVeigh, Jarrad",23,13,4,10,1,1,0,5
Sydney,"Mills, Callum",18,10,8,8,0,0,0,1
Sydney,"Mitchell, Tom",23,8,2,15,0,0,0,2
Sydney,"Nankervis, Toby",10,2,0,8,0,0,11,6
Sydney,"Parker, Luke",34,19,5,15,3,2,0,10
Sydney,"Rampe, Dane",18,14,9,4,0,0,0,2
Sydney,"Rohan, Gary",7,6,5,1,0,1,0,2
Sydney,"Rose, James",13,8,4,5,0,0,0,4
Sydney,"Sinclair, Callum",7,5,1,2,1,0,19,3
Sydney,"Smith, Nick",12,6,2,6,0,0,0,6
Sydney,"Towers, Dean",21,12,6,9,0,1,3,2
Sydney,"Aliir, Aliir",15,6,5,9,0,0,0,1
Sydney,"Franklin, Lance",15,6,7,9,1,1,0,4
Sydney,"Grundy, Heath",16,8,2,8,0,0,0,1
Sydney,"Hannebery, Dan",31,13,3,18,0,0,0,5
Sydney,"Hewett, George",13,5,3,8,1,0,0,3
Sydney,"Jack, Kieren",24,16,4,8,3,0,0,10
Sydney,"Jones, Zak",16,9,3,7,1,0,0,2
Sydney,"Kennedy, Josh",24,14,3,10,1,1,0,9
Sydney,"Lloyd, Jake",20,16,2,4,1,0,0,3
Sydney,"McVeigh, Jarrad",15,7,0,8,0,0,0,3
Sydney,"Mills, Callum",23,17,6,6,1,0,0,2
Sydney,"Mitchell, Tom",33,9,0,24,0,1,0,6
Sydney,"Naismith, Sam",4,1,0,3,0,0,25,4
Sydney,"Papley, Tom",10,5,3,5,2,0,0,4
Sydney,"Parker, Luke",27,15,5,12,1,0,0,3
Sydney,"Rampe, Dane",23,14,6,9,0,0,0,1
Sydney,"Richards, Ted",9,4,3,5,1,2,0,1
Sydney,"Rohan, Gary",10,9,6,1,0,1,0,2
Sydney,"Rose, James",6,3,2,3,0,1,0,2
Sydney,"Sinclair, Callum",5,3,0,2,0,0,8,3
Sydney,"Smith, Nick",11,9,2,2,0,0,0,4
Sydney,"Towers, Dean",23,12,5,11,2,0,2,3
Sydney,"Aliir, Aliir",16,11,6,5,0,0,0,0
Sydney,"Franklin, Lance",19,12,6,7,0,2,0,3
Sydney,"Grundy, Heath",15,12,7,3,0,0,0,2
Sydney,"Hannebery, Dan",21,10,6,11,0,2,0,3
Sydney,"Hewett, George",12,5,3,7,0,0,0,2
Sydney,"Jack, Kieren",20,15,3,5,0,1,0,5
Sydney,"Jones, Zak",7,7,1,0,0,0,0,1
Sydney,"Kennedy, Josh",33,15,6,18,1,1,0,6
Sydney,"Lloyd, Jake",12,9,3,3,0,0,0,4
Sydney,"McGlynn, Ben",12,8,2,4,0,0,0,2
Sydney,"McVeigh, Jarrad",23,9,0,14,0,0,0,3
Sydney,"Mills, Callum",17,10,7,7,0,0,0,2
Sydney,"Mitchell, Tom",34,8,4,26,0,0,0,6
Sydney,"Naismith, Sam",12,6,3,6,0,0,30,1
Sydney,"Papley, Tom",15,8,1,7,2,1,0,1
Sydney,"Parker, Luke",35,17,1,18,1,1,0,4
Sydney,"Rampe, Dane",16,14,7,2,0,0,0,1
Sydney,"Richards, Ted",8,5,4,3,0,0,0,1
Sydney,"Rohan, Gary",12,9,5,3,4,1,0,3
Sydney,"Sinclair, Callum",11,5,3,6,1,0,13,2
Sydney,"Smith, Nick",12,7,3,5,0,0,0,0
Sydney,"Towers, Dean",12,9,4,3,1,1,3,2
Sydney,"Aliir, Aliir",18,6,6,12,0,0,0,1
Sydney,"Cunningham, Harry",16,7,2,9,0,0,0,1
Sydney,"Foote, Jordan",10,3,2,7,0,0,0,4
Sydney,"Franklin, Lance",17,14,5,3,4,2,0,3
Sydney,"Grundy, Heath",14,9,5,5,0,0,0,0
Sydney,"Hannebery, Dan",22,14,3,8,0,1,0,6
Sydney,"Heeney, Isaac",16,10,1,6,0,1,0,5
Sydney,"Hewett, George",13,3,0,10,0,0,0,3
Sydney,"Jack, Kieren",22,14,3,8,1,2,0,3
Sydney,"Kennedy, Josh",35,12,1,23,1,0,0,6
Sydney,"Lloyd, Jake",28,21,3,7,0,0,0,0
Sydney,"Mills, Callum",24,11,8,13,0,0,0,0
Sydney,"Mitchell, Tom",23,2,0,21,0,0,0,4
Sydney,"Naismith, Sam",12,4,3,8,0,0,31,7
Sydney,"Papley, Tom",9,4,3,5,0,0,0,4
Sydney,"Parker, Luke",24,10,4,14,2,1,4,8
Sydney,"Rampe, Dane",17,9,2,8,0,0,0,3
Sydney,"Richards, Xavier",13,5,5,8,2,1,0,5
Sydney,"Rohan, Gary",8,6,3,2,0,1,0,8
Sydney,"Sinclair, Callum",6,4,2,2,0,0,14,2
Sydney,"Smith, Nick",13,8,3,5,0,0,0,4
Sydney,"Towers, Dean",18,7,3,11,0,1,2,3
Sydney,"Aliir, Aliir",18,9,4,9,0,0,0,4
Sydney,"Cunningham, Harry",22,16,5,6,0,0,0,4
Sydney,"Franklin, Lance",20,15,7,5,2,3,0,3
Sydney,"Grundy, Heath",22,12,4,10,0,0,0,2
Sydney,"Hannebery, Dan",41,24,8,17,1,2,0,3
Sydney,"Heeney, Isaac",22,10,6,12,4,0,0,3
Sydney,"Hewett, George",20,4,3,16,0,1,0,2
Sydney,"Jack, Kieren",20,9,3,11,0,0,0,7
Sydney,"Kennedy, Josh",45,16,8,29,3,0,0,2
Sydney,"Lloyd, Jake",24,14,2,10,0,0,0,2
Sydney,"McVeigh, Jarrad",16,10,5,6,0,1,0,4
Sydney,"Mills, Callum",24,12,4,12,0,0,0,4
Sydney,"Mitchell, Tom",26,9,3,17,3,0,0,5
Sydney,"Naismith, Sam",12,5,4,7,1,0,25,5
Sydney,"Nankervis, Toby",9,2,3,7,0,1,12,6
Sydney,"Papley, Tom",7,2,3,5,0,0,0,6
Sydney,"Parker, Luke",28,8,4,20,1,1,3,9
Sydney,"Rampe, Dane",16,8,1,8,0,0,0,2
Sydney,"Richards, Xavier",12,9,5,3,2,0,1,2
Sydney,"Rohan, Gary",11,8,4,3,2,1,0,1
Sydney,"Smith, Nick",16,6,2,10,0,0,0,2
Sydney,"Towers, Dean",26,14,7,12,2,0,2,0
Sydney,"Aliir, Aliir",18,10,3,8,0,0,0,2
Sydney,"Cunningham, Harry",21,16,5,5,0,0,0,2
Sydney,"Franklin, Lance",13,9,4,4,2,1,0,3
Sydney,"Grundy, Heath",22,13,3,9,0,0,0,1
Sydney,"Hannebery, Dan",36,15,5,21,1,2,0,4
Sydney,"Heeney, Isaac",25,16,8,9,2,2,0,5
Sydney,"Hewett, George",18,8,3,10,0,0,0,1
Sydney,"Jack, Kieren",20,12,2,8,0,0,0,6
Sydney,"Kennedy, Josh",30,15,4,15,1,0,0,3
Sydney,"Lloyd, Jake",32,25,3,7,0,0,0,2
Sydney,"McVeigh, Jarrad",27,20,7,7,0,1,0,2
Sydney,"Mills, Callum",18,9,5,9,0,0,0,3
Sydney,"Mitchell, Tom",32,14,9,18,1,0,0,7
Sydney,"Naismith, Sam",9,6,2,3,0,0,27,0
Sydney,"Nankervis, Toby",14,2,2,12,0,0,19,3
Sydney,"Papley, Tom",12,9,4,3,1,2,0,4
Sydney,"Parker, Luke",39,19,4,20,0,1,2,5
Sydney,"Rampe, Dane",18,13,3,5,1,0,0,5
Sydney,"Richards, Xavier",10,8,4,2,2,1,0,2
Sydney,"Rohan, Gary",7,6,2,1,2,1,0,0
Sydney,"Smith, Nick",11,7,5,4,0,0,0,5
Sydney,"Towers, Dean",23,13,6,10,1,2,0,0
Sydney,"Aliir, Aliir",17,8,9,9,0,0,0,1
Sydney,"Cunningham, Harry",19,12,9,7,0,0,0,0
Sydney,"Franklin, Lance",28,18,9,10,6,1,0,4
Sydney,"Grundy, Heath",15,9,5,6,0,0,0,1
Sydney,"Hannebery, Dan",37,20,7,17,1,0,0,2
Sydney,"Heeney, Isaac",13,8,5,5,1,1,0,2
Sydney,"Hewett, George",20,6,3,14,1,0,0,1
Sydney,"Jack, Kieren",20,11,3,9,1,0,0,2
Sydney,"Kennedy, Josh",35,9,5,26,1,0,0,4
Sydney,"Lloyd, Jake",35,21,7,14,0,0,0,1
Sydney,"McVeigh, Jarrad",26,13,4,13,1,0,0,3
Sydney,"Mills, Callum",27,17,8,10,0,0,0,1
Sydney,"Mitchell, Tom",19,8,4,11,0,0,0,8
Sydney,"Naismith, Sam",12,4,2,8,1,0,18,2
Sydney,"Nankervis, Toby",15,6,2,9,1,1,24,3
Sydney,"Papley, Tom",16,9,4,7,3,1,0,3
Sydney,"Parker, Luke",33,17,9,16,3,1,2,5
Sydney,"Rampe, Dane",14,6,2,8,0,0,0,1
Sydney,"Richards, Xavier",12,8,7,4,3,0,0,3
Sydney,"Rohan, Gary",8,8,2,0,0,3,0,1
Sydney,"Smith, Nick",20,12,8,8,0,0,0,4
Sydney,"Towers, Dean",18,6,2,12,0,0,1,1
Sydney,"Aliir, Aliir",13,10,4,3,0,0,0,6
Sydney,"Cunningham, Harry",10,6,1,4,0,0,0,3
Sydney,"Franklin, Lance",9,6,2,3,0,1,0,1
Sydney,"Grundy, Heath",12,8,5,4,0,0,0,2
Sydney,"Hannebery, Dan",33,14,4,19,2,0,0,1
Sydney,"Heeney, Isaac",12,5,2,7,1,1,0,0
Sydney,"Hewett, George",9,4,2,5,1,0,0,4
Sydney,"Kennedy, Josh",28,14,2,14,1,1,0,7
Sydney,"Lloyd, Jake",24,17,3,7,1,0,0,2
Sydney,"McGlynn, Ben",11,8,4,3,1,0,0,8
Sydney,"McVeigh, Jarrad",16,11,4,5,2,0,0,7
Sydney,"Mills, Callum",25,17,9,8,0,0,0,2
Sydney,"Mitchell, Tom",30,11,4,19,0,1,0,4
Sydney,"Naismith, Sam",5,3,1,2,0,0,25,3
Sydney,"Papley, Tom",9,5,1,4,1,0,0,2
Sydney,"Parker, Luke",31,15,3,16,0,2,1,3
Sydney,"Rampe, Dane",18,11,9,7,0,1,0,2
Sydney,"Richards, Xavier",14,8,7,6,0,1,0,2
Sydney,"Rohan, Gary",15,13,7,2,2,1,0,4
Sydney,"Smith, Nick",8,7,4,1,0,0,0,3
Sydney,"Tippett, Kurt",11,2,3,9,0,2,17,1
Sydney,"Towers, Dean",14,9,1,5,0,0,2,3
Sydney,"Aliir, Aliir",16,11,8,5,0,0,0,1
Sydney,"Cunningham, Harry",8,5,1,3,0,0,0,3
Sydney,"Franklin, Lance",17,17,11,0,7,4,0,2
Sydney,"Grundy, Heath",25,20,9,5,0,0,0,2
Sydney,"Hannebery, Dan",31,17,5,14,0,0,0,1
Sydney,"Heeney, Isaac",18,10,10,8,1,1,0,3
Sydney,"Hewett, George",15,7,5,8,2,1,0,2
Sydney,"Jack, Kieren",31,18,7,13,1,0,0,3
Sydney,"Kennedy, Josh",37,12,5,25,2,1,0,4
Sydney,"Lloyd, Jake",31,23,12,8,0,0,0,2
Sydney,"Marsh, Harrison",17,6,5,11,0,0,0,3
Sydney,"McGlynn, Ben",20,13,10,7,5,0,0,3
Sydney,"McVeigh, Jarrad",31,19,7,12,0,0,0,1
Sydney,"Mitchell, Tom",34,14,9,20,1,1,0,7
Sydney,"Naismith, Sam",8,2,3,6,0,0,16,2
Sydney,"Papley, Tom",13,6,3,7,0,1,0,4
Sydney,"Parker, Luke",24,11,3,13,1,0,1,4
Sydney,"Rampe, Dane",23,18,8,5,0,0,0,1
Sydney,"Richards, Xavier",13,9,8,4,1,1,1,0
Sydney,"Rohan, Gary",12,10,5,2,4,2,0,2
Sydney,"Smith, Nick",14,10,7,4,0,0,0,2
Sydney,"Tippett, Kurt",9,5,1,4,0,0,15,3
Sydney,"Aliir, Aliir",16,9,3,7,0,0,1,3
Sydney,"Franklin, Lance",20,16,8,4,0,2,1,1
Sydney,"Grundy, Heath",13,6,3,7,0,0,0,3
Sydney,"Hannebery, Dan",31,12,2,19,0,2,0,7
Sydney,"Heeney, Isaac",15,11,8,4,0,0,0,2
Sydney,"Hewett, George",15,7,6,8,1,2,0,2
Sydney,"Jack, Kieren",22,10,5,12,2,1,0,7
Sydney,"Kennedy, Josh",30,8,0,22,1,0,0,1
Sydney,"Lloyd, Jake",26,15,5,11,0,0,0,2
Sydney,"Marsh, Harrison",11,7,4,4,0,0,0,1
Sydney,"McGlynn, Ben",15,11,6,4,1,0,0,4
Sydney,"McVeigh, Jarrad",23,13,5,10,0,0,0,3
Sydney,"Mills, Callum",6,6,1,0,0,0,0,1
Sydney,"Mitchell, Tom",24,8,2,16,0,0,0,3
Sydney,"Naismith, Sam",7,2,0,5,0,0,19,2
Sydney,"Papley, Tom",16,11,5,5,2,1,0,0
Sydney,"Parker, Luke",22,11,4,11,0,1,6,6
Sydney,"Rampe, Dane",21,13,7,8,0,0,0,2
Sydney,"Richards, Xavier",13,5,6,8,0,1,1,2
Sydney,"Rohan, Gary",12,8,3,4,0,1,0,4
Sydney,"Smith, Nick",19,14,3,5,0,1,0,7
Sydney,"Tippett, Kurt",8,2,1,6,0,0,14,1
Sydney,"Aliir, Aliir",21,12,5,9,0,0,0,3
Sydney,"Franklin, Lance",14,10,3,4,4,2,0,3
Sydney,"Grundy, Heath",13,7,6,6,0,0,0,0
Sydney,"Hannebery, Dan",31,18,2,13,1,1,0,6
Sydney,"Heeney, Isaac",32,15,9,17,1,0,0,1
Sydney,"Hewett, George",15,5,2,10,0,0,3,1
Sydney,"Jack, Kieren",25,11,5,14,0,0,0,6
Sydney,"Kennedy, Josh",42,16,8,26,0,3,1,4
Sydney,"Laidler, Jeremy",21,8,7,13,0,0,0,1
Sydney,"Lloyd, Jake",28,19,2,9,0,0,0,2
Sydney,"Marsh, Harrison",11,4,0,7,0,0,0,1
Sydney,"McGlynn, Ben",19,11,5,8,3,1,0,5
Sydney,"McVeigh, Jarrad",9,4,0,5,0,0,0,2
Sydney,"Mitchell, Tom",32,13,2,19,1,0,0,1
Sydney,"Naismith, Sam",12,1,2,11,0,0,22,2
Sydney,"Nankervis, Toby",15,7,1,8,0,0,16,1
Sydney,"Papley, Tom",14,9,3,5,4,0,0,1
Sydney,"Parker, Luke",24,12,1,12,1,0,5,12
Sydney,"Rampe, Dane",16,8,6,8,0,0,0,1
Sydney,"Richards, Xavier",20,13,5,7,2,1,0,1
Sydney,"Rohan, Gary",6,3,2,3,1,1,0,3
Sydney,"Smith, Nick",25,15,7,10,0,0,0,2
Sydney,"Aliir, Aliir",3,2,1,1,0,0,0,1
Sydney,"Franklin, Lance",19,7,8,12,2,0,0,1
Sydney,"Grundy, Heath",17,10,6,7,0,0,0,3
Sydney,"Hannebery, Dan",29,10,4,19,0,0,0,8
Sydney,"Heeney, Isaac",28,20,6,8,1,0,0,7
Sydney,"Hewett, George",10,6,3,4,0,0,0,9
Sydney,"Jack, Kieren",20,13,4,7,0,1,0,13
Sydney,"Jones, Zak",22,17,1,5,0,0,0,4
Sydney,"Kennedy, Josh",25,10,2,15,0,1,0,8
Sydney,"Laidler, Jeremy",13,8,3,5,0,0,0,2
Sydney,"Lloyd, Jake",25,18,5,7,0,0,0,1
Sydney,"Marsh, Harrison",8,3,1,5,0,0,0,2
Sydney,"McGlynn, Ben",15,11,3,4,1,1,0,7
Sydney,"Mitchell, Tom",27,8,1,19,0,0,0,6
Sydney,"Naismith, Sam",4,3,2,1,1,1,18,9
Sydney,"Papley, Tom",8,5,2,3,3,0,0,5
Sydney,"Parker, Luke",17,7,2,10,2,0,1,6
Sydney,"Rampe, Dane",26,18,11,8,0,0,0,4
Sydney,"Richards, Xavier",13,8,4,5,1,1,0,1
Sydney,"Rohan, Gary",18,12,6,6,2,1,0,1
Sydney,"Smith, Nick",16,10,6,6,0,0,0,3
Sydney,"Tippett, Kurt",13,8,2,5,2,0,5,1
Sydney,"Franklin, Lance",16,12,8,4,1,1,0,7
Sydney,"Grundy, Heath",21,15,9,6,0,0,0,4
Sydney,"Hannebery, Dan",22,7,2,15,0,0,0,6
Sydney,"Heeney, Isaac",22,13,6,9,0,0,0,4
Sydney,"Hewett, George",11,7,0,4,1,0,0,4
Sydney,"Jack, Kieren",22,10,5,12,0,2,0,3
Sydney,"Jones, Zak",21,11,4,10,0,0,0,3
Sydney,"Kennedy, Josh",34,14,5,20,3,0,0,6
Sydney,"Laidler, Jeremy",9,4,3,5,0,0,0,6
Sydney,"Lloyd, Jake",21,12,5,9,0,0,0,2
Sydney,"McGlynn, Ben",9,7,5,2,0,1,0,5
Sydney,"McVeigh, Jarrad",14,8,2,6,0,0,0,3
Sydney,"Mills, Callum",15,6,3,9,0,0,0,5
Sydney,"Mitchell, Tom",26,13,4,13,2,0,0,13
Sydney,"Naismith, Sam",13,5,3,8,0,0,21,2
Sydney,"Papley, Tom",15,8,2,7,0,1,0,5
Sydney,"Parker, Luke",19,9,1,10,1,0,4,9
Sydney,"Rampe, Dane",24,17,11,7,0,0,0,4
Sydney,"Richards, Xavier",10,6,4,4,0,0,0,0
Sydney,"Rohan, Gary",5,3,2,2,1,0,0,6
Sydney,"Smith, Nick",13,10,4,3,1,0,0,2
Sydney,"Tippett, Kurt",10,4,3,6,0,1,17,2
West Coast,"Bennell, Jamie",17,11,6,6,2,1,0,2
West Coast,"Butler, Sam",17,8,6,9,0,0,0,1
West Coast,"Cripps, Jamie",16,12,5,4,3,1,0,4
West Coast,"Darling, Jack",17,11,8,6,2,0,0,1
West Coast,"Duggan, Liam",16,13,7,3,0,0,0,1
West Coast,"Ellis, Xavier",10,4,3,6,1,0,0,2
West Coast,"Gaff, Andrew",33,15,1,18,0,1,0,1
West Coast,"Hill, Josh",19,10,6,9,3,1,0,3
West Coast,"Hurn, Shannon",10,9,5,1,0,0,0,3
West Coast,"Kennedy, Josh",25,21,16,4,8,2,0,4
West Coast,"LeCras, Mark",25,19,9,6,2,0,0,1
West Coast,"Lycett, Scott",11,4,3,7,0,0,13,3
West Coast,"Mackenzie, Eric",24,12,7,12,0,0,0,2
West Coast,"McGovern, Jeremy",9,7,6,2,1,0,0,1
West Coast,"Naitanui, Nic",22,7,6,15,2,0,46,2
West Coast,"Nelson, Jackson",15,9,3,6,0,0,0,3
West Coast,"Priddis, Matt",43,16,4,27,0,0,0,5
West Coast,"Redden, Jack",25,7,4,18,1,0,0,3
West Coast,"Schofield, Will",13,6,2,7,0,0,0,1
West Coast,"Sheppard, Brad",21,9,7,12,0,0,0,3
West Coast,"Shuey, Luke",30,17,3,13,0,0,0,4
West Coast,"Yeo, Elliot",20,13,4,7,1,1,2,9
West Coast,"Bennell, Jamie",5,3,0,2,0,0,0,4
West Coast,"Butler, Sam",12,7,3,5,0,0,0,3
West Coast,"Cripps, Jamie",11,9,3,2,1,2,0,5
West Coast,"Darling, Jack",12,7,3,5,3,0,0,6
West Coast,"Duggan, Liam",7,5,0,2,0,1,0,2
West Coast,"Gaff, Andrew",30,19,4,11,0,0,0,5
West Coast,"Hill, Josh",14,7,3,7,0,1,0,1
West Coast,"Hurn, Shannon",15,7,2,8,0,0,1,3
West Coast,"Jetta, Lewis",8,6,1,2,0,0,0,3
West Coast,"Kennedy, Josh",18,14,4,4,1,1,0,6
West Coast,"LeCras, Mark",16,11,4,5,0,1,0,4
West Coast,"Lycett, Scott",9,6,2,3,0,1,16,3
West Coast,"Mackenzie, Eric",14,6,6,8,0,0,0,2
West Coast,"McGovern, Jeremy",14,13,7,1,1,1,0,3
West Coast,"Naitanui, Nic",9,4,1,5,0,0,42,3
West Coast,"Nelson, Jackson",9,6,1,3,0,0,0,4
West Coast,"Priddis, Matt",19,4,1,15,0,0,0,6
West Coast,"Redden, Jack",19,8,3,11,1,0,1,6
West Coast,"Schofield, Will",5,3,2,2,0,0,0,1
West Coast,"Sheppard, Brad",9,6,2,3,0,0,0,2
West Coast,"Shuey, Luke",25,10,4,15,0,0,0,7
West Coast,"Yeo, Elliot",13,5,3,8,0,1,0,2
West Coast,"Butler, Sam",14,8,4,6,0,0,0,2
West Coast,"Cripps, Jamie",9,7,0,2,1,0,0,4
West Coast,"Darling, Jack",15,7,8,8,3,1,0,3
West Coast,"Duggan, Liam",8,5,2,3,0,0,0,3
West Coast,"Gaff, Andrew",32,23,6,9,0,3,0,1
West Coast,"Hill, Josh",14,10,4,4,1,0,0,1
West Coast,"Hurn, Shannon",17,11,5,6,0,0,0,2
West Coast,"Jetta, Lewis",17,12,5,5,2,1,0,2
West Coast,"Kennedy, Josh",17,11,9,6,1,4,0,3
West Coast,"LeCras, Mark",22,12,3,10,0,3,1,8
West Coast,"Lycett, Scott",14,10,7,4,2,1,15,4
West Coast,"Mackenzie, Eric",15,10,6,5,1,0,0,2
West Coast,"Masten, Chris",18,7,2,11,0,1,0,2
West Coast,"McGovern, Jeremy",12,9,4,3,0,0,0,1
West Coast,"Naitanui, Nic",15,7,3,8,0,1,31,3
West Coast,"Nelson, Jackson",11,6,2,5,0,0,0,2
West Coast,"Priddis, Matt",31,12,1,19,0,0,0,8
West Coast,"Redden, Jack",10,6,2,4,0,0,0,5
West Coast,"Schofield, Will",5,4,3,1,0,0,0,5
West Coast,"Sheppard, Brad",16,9,5,7,0,0,0,2
West Coast,"Shuey, Luke",31,16,3,15,1,1,0,6
West Coast,"Yeo, Elliot",21,13,6,8,0,0,0,8
West Coast,"Butler, Sam",18,9,8,9,0,0,0,3
West Coast,"Cripps, Jamie",8,5,2,3,0,0,0,2
West Coast,"Darling, Jack",12,11,8,1,4,2,0,1
West Coast,"Duggan, Liam",13,7,3,6,0,1,0,4
West Coast,"Gaff, Andrew",33,23,7,10,0,0,0,0
West Coast,"Hill, Josh",8,7,2,1,1,0,0,2
West Coast,"Hurn, Shannon",17,12,5,5,0,0,0,0
West Coast,"Hutchings, Mark",9,7,2,2,2,0,0,6
West Coast,"Jetta, Lewis",16,9,4,7,1,0,0,0
West Coast,"Kennedy, Josh",11,7,5,4,2,3,0,7
West Coast,"LeCras, Mark",16,11,6,5,2,0,0,4
West Coast,"Lycett, Scott",14,10,6,4,1,1,18,5
West Coast,"Mackenzie, Eric",14,6,7,8,0,0,0,0
West Coast,"Masten, Chris",15,7,3,8,0,0,0,1
West Coast,"McGovern, Jeremy",15,11,8,4,0,2,0,1
West Coast,"Naitanui, Nic",16,7,3,9,0,0,36,2
West Coast,"Nelson, Jackson",11,8,1,3,0,0,0,2
West Coast,"Redden, Jack",14,6,4,8,1,0,0,5
West Coast,"Schofield, Will",15,10,8,5,0,0,0,1
West Coast,"Sheppard, Brad",20,9,9,11,0,0,0,1
West Coast,"Shuey, Luke",22,12,3,10,2,0,0,9
West Coast,"Yeo, Elliot",25,19,9,6,2,4,0,3
West Coast,"Butler, Sam",15,8,7,7,0,0,0,4
West Coast,"Cripps, Jamie",12,9,5,3,0,0,0,6
West Coast,"Darling, Jack",11,4,4,7,0,0,0,3
West Coast,"Duggan, Liam",14,5,0,9,0,0,0,8
West Coast,"Gaff, Andrew",32,15,6,17,0,1,0,1
West Coast,"Hill, Josh",12,8,2,4,1,0,0,4
West Coast,"Hurn, Shannon",23,20,6,3,0,0,0,3
West Coast,"Jetta, Lewis",13,9,5,4,0,1,0,2
West Coast,"Kennedy, Josh",18,12,10,6,2,0,0,1
West Coast,"LeCras, Mark",13,9,3,4,0,0,0,5
West Coast,"Mackenzie, Eric",13,6,3,7,0,0,0,0
West Coast,"Masten, Chris",28,14,4,14,0,0,0,4
West Coast,"McGovern, Jeremy",23,14,5,9,0,0,0,1
West Coast,"McInnes, Fraser",5,1,1,4,0,0,8,3
West Coast,"Naitanui, Nic",13,7,5,6,1,0,32,3
West Coast,"Priddis, Matt",28,14,0,14,0,1,0,6
West Coast,"Redden, Jack",14,9,1,5,1,0,0,7
West Coast,"Schofield, Will",10,8,5,2,0,0,0,0
West Coast,"Sheppard, Brad",16,9,2,7,0,0,0,7
West Coast,"Shuey, Luke",24,13,1,11,1,0,0,6
West Coast,"Wellingham, Sharrod",22,11,2,11,0,0,0,4
West Coast,"Yeo, Elliot",17,12,4,5,1,0,1,5
West Coast,"Butler, Sam",12,7,4,5,0,0,0,3
West Coast,"Cripps, Jamie",11,6,5,5,3,0,0,2
West Coast,"Darling, Jack",16,7,6,9,1,0,0,2
West Coast,"Duggan, Liam",15,8,4,7,0,1,0,1
West Coast,"Gaff, Andrew",21,13,5,8,1,0,0,0
West Coast,"Hill, Josh",15,9,1,6,1,0,0,5
West Coast,"Hurn, Shannon",17,13,4,4,0,0,0,3
West Coast,"Hutchings, Mark",19,11,2,8,1,0,0,5
West Coast,"Jetta, Lewis",10,6,4,4,0,0,0,3
West Coast,"Kennedy, Josh",16,13,8,3,3,6,0,2
West Coast,"LeCras, Mark",27,20,9,7,3,3,0,1
West Coast,"Lycett, Scott",14,8,2,6,2,1,17,6
West Coast,"Mackenzie, Eric",9,8,8,1,0,0,0,1
West Coast,"Masten, Chris",14,5,1,9,0,0,0,0
West Coast,"McGovern, Jeremy",17,13,9,4,0,1,0,2
West Coast,"Naitanui, Nic",14,8,1,6,1,0,30,3
West Coast,"Priddis, Matt",23,8,2,15,0,1,0,8
West Coast,"Redden, Jack",22,9,3,13,1,0,0,2
West Coast,"Schofield, Will",5,4,2,1,0,0,0,1
West Coast,"Sheppard, Brad",21,12,7,9,0,0,0,1
West Coast,"Shuey, Luke",25,12,4,13,0,1,0,3
West Coast,"Wellingham, Sharrod",5,5,1,0,1,0,0,2
West Coast,"Cripps, Jamie",9,3,1,6,1,0,0,4
West Coast,"Darling, Jack",14,9,5,5,3,1,0,2
West Coast,"Duggan, Liam",15,9,2,6,0,0,0,2
West Coast,"Gaff, Andrew",36,17,5,19,0,0,0,0
West Coast,"Hill, Josh",12,8,5,4,1,2,0,3
West Coast,"Hurn, Shannon",15,11,2,4,0,0,0,0
West Coast,"Hutchings, Mark",18,6,3,12,0,0,0,2
West Coast,"Jetta, Lewis",9,8,1,1,1,0,0,0
West Coast,"Kennedy, Josh",10,8,4,2,3,1,0,1
West Coast,"LeCras, Mark",11,6,4,5,1,0,0,3
West Coast,"Lycett, Scott",12,6,3,6,2,0,15,5
West Coast,"Mackenzie, Eric",10,3,4,7,0,0,0,2
West Coast,"Masten, Chris",22,13,5,9,0,0,0,1
West Coast,"McGovern, Jeremy",21,14,8,7,0,0,0,2
West Coast,"Naitanui, Nic",16,7,2,9,0,0,23,3
West Coast,"Priddis, Matt",28,9,1,19,0,0,0,6
West Coast,"Redden, Jack",13,8,2,5,0,1,0,7
West Coast,"Schofield, Will",7,1,3,6,0,0,0,1
West Coast,"Sheppard, Brad",24,10,6,14,0,0,0,1
West Coast,"Shuey, Luke",19,6,1,13,0,0,1,6
West Coast,"Wellingham, Sharrod",23,11,3,12,0,0,0,2
West Coast,"Yeo, Elliot",13,7,2,6,0,0,0,2
West Coast,"Butler, Sam",25,14,6,11,0,0,0,2
West Coast,"Cripps, Jamie",7,5,2,2,1,2,0,7
West Coast,"Darling, Jack",7,6,6,1,2,0,0,3
West Coast,"Duggan, Liam",21,14,1,7,0,2,0,1
West Coast,"Gaff, Andrew",36,19,2,17,0,0,0,1
West Coast,"Hill, Josh",12,8,6,4,1,0,0,0
West Coast,"Hurn, Shannon",17,14,6,3,0,0,0,1
West Coast,"Hutchings, Mark",21,9,4,12,2,0,0,2
West Coast,"Kennedy, Josh",13,10,6,3,5,1,0,4
West Coast,"LeCras, Mark",13,11,4,2,6,0,0,3
West Coast,"Lycett, Scott",14,8,5,6,1,0,19,4
West Coast,"Mackenzie, Eric",19,10,5,9,0,0,0,1
West Coast,"Masten, Chris",30,17,5,13,0,2,0,3
West Coast,"McGovern, Jeremy",18,12,5,6,1,0,0,1
West Coast,"Naitanui, Nic",12,5,2,7,0,0,33,3
West Coast,"Priddis, Matt",28,7,1,21,0,0,0,9
West Coast,"Redden, Jack",11,5,5,6,0,0,0,9
West Coast,"Schofield, Will",12,9,7,3,0,0,0,1
West Coast,"Sheppard, Brad",15,10,5,5,0,0,0,1
West Coast,"Shuey, Luke",31,10,2,21,0,1,0,6
West Coast,"Wellingham, Sharrod",22,17,4,5,0,0,0,5
West Coast,"Yeo, Elliot",20,11,4,9,1,0,1,6
West Coast,"Butler, Sam",14,7,1,7,0,0,0,3
West Coast,"Cripps, Jamie",11,11,3,0,2,0,0,5
West Coast,"Darling, Jack",9,5,4,4,0,0,0,5
West Coast,"Duggan, Liam",12,6,1,6,0,0,0,4
West Coast,"Gaff, Andrew",17,10,1,7,0,0,0,0
West Coast,"Hill, Josh",15,7,4,8,1,0,0,2
West Coast,"Hurn, Shannon",13,8,2,5,0,0,0,4
West Coast,"Hutchings, Mark",20,12,4,8,0,0,0,5
West Coast,"Kennedy, Josh",15,10,4,5,7,0,0,4
West Coast,"LeCras, Mark",12,8,5,4,0,0,0,3
West Coast,"Lycett, Scott",13,10,5,3,2,2,23,11
West Coast,"Mackenzie, Eric",15,3,3,12,0,0,0,1
West Coast,"Masten, Chris",19,11,3,8,0,0,0,0
West Coast,"McGovern, Jeremy",9,6,5,3,0,0,0,0
West Coast,"Naitanui, Nic",13,7,3,6,0,0,48,5
West Coast,"Priddis, Matt",27,13,1,14,0,0,0,10
West Coast,"Redden, Jack",22,9,3,13,0,1,0,0
West Coast,"Schofield, Will",8,6,1,2,0,0,0,3
West Coast,"Sheppard, Brad",13,8,4,5,0,1,0,0
West Coast,"Shuey, Luke",23,13,1,10,1,0,0,7
West Coast,"Wellingham, Sharrod",24,15,7,9,0,1,0,0
West Coast,"Yeo, Elliot",19,10,3,9,1,1,0,3
West Coast,"Butler, Sam",16,8,3,8,0,0,0,1
West Coast,"Cole, Tom",14,7,4,7,0,0,0,2
West Coast,"Cripps, Jamie",18,12,7,6,2,1,0,6
West Coast,"Darling, Jack",14,6,4,8,3,1,0,1
West Coast,"Duggan, Liam",15,12,4,3,0,1,0,2
West Coast,"Hill, Josh",15,10,2,5,1,1,0,1
West Coast,"Hurn, Shannon",19,18,6,1,1,0,0,1
West Coast,"Hutchings, Mark",8,5,1,3,1,0,0,4
West Coast,"Jetta, Lewis",17,8,5,9,0,0,0,3
West Coast,"Kennedy, Josh",14,10,10,4,5,2,0,3
West Coast,"LeCras, Mark",12,10,7,2,3,1,0,3
West Coast,"Lycett, Scott",15,9,5,6,2,0,22,6
West Coast,"Mackenzie, Eric",14,6,5,8,0,0,0,0
West Coast,"Masten, Chris",21,8,3,13,0,0,0,3
West Coast,"McGovern, Jeremy",10,9,4,1,0,0,0,0
West Coast,"Naitanui, Nic",8,4,2,4,1,1,37,4
West Coast,"Priddis, Matt",24,7,3,17,0,0,0,6
West Coast,"Redden, Jack",22,10,8,12,0,1,1,1
West Coast,"Schofield, Will",10,4,2,6,0,0,0,2
West Coast,"Sheppard, Brad",21,15,12,6,0,0,0,2
West Coast,"Shuey, Luke",26,12,1,14,1,0,0,4
West Coast,"Wellingham, Sharrod",16,11,2,5,0,1,0,1
West Coast,"Butler, Sam",16,11,7,5,0,0,0,6
West Coast,"Cole, Tom",12,6,4,6,0,0,0,0
West Coast,"Cripps, Jamie",15,11,5,4,0,1,0,4
West Coast,"Darling, Jack",14,5,3,9,2,0,0,0
West Coast,"Duggan, Liam",11,6,4,5,0,1,0,3
West Coast,"Gaff, Andrew",23,17,4,6,0,0,0,1
West Coast,"Hill, Josh",17,9,5,8,2,0,0,2
West Coast,"Hurn, Shannon",21,21,3,0,0,0,0,1
West Coast,"Hutchings, Mark",16,11,4,5,1,0,0,0
West Coast,"Kennedy, Josh",5,3,3,2,1,0,0,6
West Coast,"LeCras, Mark",13,10,6,3,2,1,0,3
West Coast,"Lycett, Scott",9,6,4,3,0,0,13,6
West Coast,"Mackenzie, Eric",13,9,9,4,0,0,0,1
West Coast,"Masten, Chris",21,15,6,6,1,0,0,3
West Coast,"Naitanui, Nic",6,2,1,4,0,1,30,4
West Coast,"Priddis, Matt",27,6,2,21,0,0,0,12
West Coast,"Redden, Jack",15,6,1,9,0,1,0,8
West Coast,"Schofield, Will",11,6,5,5,0,0,0,3
West Coast,"Sheppard, Brad",15,9,5,6,0,0,0,2
West Coast,"Shuey, Luke",21,14,2,7,0,2,0,9
West Coast,"Wellingham, Sharrod",9,7,3,2,0,0,0,2
West Coast,"Yeo, Elliot",12,9,4,3,2,1,0,5
West Coast,"Barrass, Tom",9,7,3,2,0,0,0,0
West Coast,"Cripps, Jamie",10,7,2,3,0,2,0,2
West Coast,"Darling, Jack",9,6,3,3,2,1,0,3
West Coast,"Duggan, Liam",9,5,2,4,1,0,0,3
West Coast,"Ellis, Xavier",12,7,3,5,0,0,0,2
West Coast,"Gaff, Andrew",22,13,2,9,1,0,0,0
West Coast,"Hill, Josh",19,13,4,6,1,0,0,3
West Coast,"Hurn, Shannon",16,12,5,4,0,0,0,1
West Coast,"Hutchings, Mark",19,9,1,10,1,0,0,6
West Coast,"Kennedy, Josh",13,11,5,2,3,1,0,5
West Coast,"LeCras, Mark",12,10,2,2,0,0,0,1
West Coast,"Lycett, Scott",8,5,0,3,0,0,17,1
West Coast,"Masten, Chris",21,9,1,12,0,0,0,3
West Coast,"McGovern, Jeremy",16,11,6,5,0,0,0,1
West Coast,"Naitanui, Nic",8,6,3,2,0,0,40,1
West Coast,"Priddis, Matt",29,11,2,18,0,0,0,12
West Coast,"Redden, Jack",15,5,2,10,0,0,1,4
West Coast,"Schofield, Will",9,4,4,5,0,0,0,2
West Coast,"Sheppard, Brad",18,8,4,10,0,0,0,0
West Coast,"Shuey, Luke",22,9,1,13,0,0,0,5
West Coast,"Wellingham, Sharrod",11,4,2,7,0,0,0,3
West Coast,"Yeo, Elliot",18,11,2,7,2,1,0,6
West Coast,"Barrass, Tom",11,7,6,4,0,0,0,0
West Coast,"Butler, Sam",13,6,4,7,0,0,0,3
West Coast,"Cripps, Jamie",14,9,7,5,2,3,0,1
West Coast,"Darling, Jack",12,6,5,6,4,2,0,2
West Coast,"Gaff, Andrew",28,15,3,13,0,0,0,0
West Coast,"Giles, Jonathan",6,3,2,3,1,0,18,4
West Coast,"Hill, Josh",11,8,4,3,1,0,0,1
West Coast,"Hurn, Shannon",16,12,5,4,0,0,0,1
West Coast,"Hutchings, Mark",13,8,4,5,0,1,0,7
West Coast,"Jetta, Lewis",15,7,2,8,0,0,0,0
West Coast,"Kennedy, Josh",10,6,1,4,5,0,1,3
West Coast,"LeCras, Mark",15,13,5,2,4,1,0,5
West Coast,"Masten, Chris",21,10,5,11,1,0,0,2
West Coast,"McGovern, Jeremy",16,9,5,7,0,0,0,2
West Coast,"McInnes, Fraser",9,2,0,7,0,0,6,1
West Coast,"Priddis, Matt",16,4,3,12,0,0,0,9
West Coast,"Redden, Jack",16,6,1,10,0,0,0,7
West Coast,"Schofield, Will",9,4,3,5,0,0,0,1
West Coast,"Sheppard, Brad",18,11,5,7,0,1,0,2
West Coast,"Shuey, Luke",25,14,4,11,1,0,0,7
West Coast,"Wellingham, Sharrod",20,11,4,9,0,0,0,3
West Coast,"Yeo, Elliot",21,16,2,5,1,1,0,11
West Coast,"Barrass, Tom",14,11,5,3,0,0,0,0
West Coast,"Brown, Mitch",13,5,4,8,0,1,6,1
West Coast,"Butler, Sam",13,9,5,4,0,0,0,1
West Coast,"Cripps, Jamie",14,8,5,6,2,0,0,6
West Coast,"Darling, Jack",11,7,6,4,2,1,0,3
West Coast,"Gaff, Andrew",35,23,6,12,2,1,0,2
West Coast,"Hurn, Shannon",25,15,5,10,0,0,0,2
West Coast,"Hutchings, Mark",18,11,6,7,3,0,0,8
West Coast,"Jetta, Lewis",15,11,3,4,0,1,0,1
West Coast,"Kennedy, Josh",9,6,3,3,3,1,0,0
West Coast,"LeCras, Mark",17,10,8,7,1,1,0,5
West Coast,"Lycett, Scott",18,9,3,9,0,1,28,1
West Coast,"Masten, Chris",33,13,8,20,0,0,0,2
West Coast,"McGinnity, Patrick",14,9,4,5,4,1,0,4
West Coast,"McGovern, Jeremy",19,11,8,8,0,1,3,0
West Coast,"Nelson, Jackson",14,7,3,7,0,0,0,4
West Coast,"Priddis, Matt",24,6,2,18,1,0,0,10
West Coast,"Schofield, Will",15,10,9,5,0,1,1,1
West Coast,"Sheppard, Brad",13,8,9,5,0,0,0,3
West Coast,"Shuey, Luke",27,11,4,16,1,0,1,4
West Coast,"Wellingham, Sharrod",21,14,5,7,0,0,0,0
West Coast,"Yeo, Elliot",20,10,5,10,1,0,3,4
West Coast,"Barrass, Tom",8,5,3,3,0,0,0,4
West Coast,"Brown, Mitch",9,2,2,7,0,0,2,3
West Coast,"Butler, Sam",15,10,5,5,0,0,0,1
West Coast,"Cripps, Jamie",13,10,8,3,3,0,0,1
West Coast,"Darling, Jack",7,4,4,3,1,1,0,1
West Coast,"Gaff, Andrew",26,18,5,8,1,0,0,3
West Coast,"Hill, Josh",9,6,2,3,0,0,0,7
West Coast,"Hurn, Shannon",19,16,9,3,1,0,0,2
West Coast,"Hutchings, Mark",11,5,1,6,0,0,0,2
West Coast,"Jetta, Lewis",9,7,4,2,0,0,0,4
West Coast,"Kennedy, Josh",15,12,8,3,4,4,0,2
West Coast,"LeCras, Mark",20,15,6,5,2,1,0,3
West Coast,"Lycett, Scott",12,8,4,4,1,0,28,5
West Coast,"Masten, Chris",23,13,9,10,1,0,0,1
West Coast,"McGinnity, Patrick",10,6,2,4,1,0,0,2
West Coast,"McGovern, Jeremy",14,10,6,4,0,0,0,1
West Coast,"Priddis, Matt",25,13,0,12,0,0,0,12
West Coast,"Schofield, Will",14,10,4,4,0,0,0,3
West Coast,"Sheppard, Brad",13,10,6,3,0,0,0,6
West Coast,"Shuey, Luke",29,15,3,14,0,0,1,5
West Coast,"Wellingham, Sharrod",15,8,5,7,0,0,0,4
West Coast,"Yeo, Elliot",17,12,6,5,1,2,1,5
West Coast,"Barrass, Tom",17,10,6,7,0,0,0,1
West Coast,"Brown, Mitch",6,3,0,3,0,0,4,7
West Coast,"Butler, Sam",15,10,3,5,0,0,0,2
West Coast,"Cripps, Jamie",16,10,6,6,3,0,0,7
West Coast,"Darling, Jack",11,7,5,4,0,5,0,3
West Coast,"Gaff, Andrew",30,18,6,12,0,0,0,1
West Coast,"Hill, Josh",13,7,5,6,1,0,0,3
West Coast,"Hurn, Shannon",16,8,6,8,0,0,0,2
West Coast,"Hutchings, Mark",12,8,1,4,0,0,0,3
West Coast,"Kennedy, Josh",8,7,5,1,2,1,0,0
West Coast,"LeCras, Mark",18,14,6,4,2,1,0,7
West Coast,"Lycett, Scott",12,7,1,5,0,1,36,4
West Coast,"Masten, Chris",18,12,4,6,0,0,0,0
West Coast,"McGinnity, Patrick",12,2,1,10,0,0,0,3
West Coast,"McGovern, Jeremy",18,12,8,6,0,0,0,3
West Coast,"Priddis, Matt",24,12,1,12,0,0,0,8
West Coast,"Redden, Jack",8,4,2,4,0,0,0,2
West Coast,"Schofield, Will",8,4,2,4,1,0,0,5
West Coast,"Sheppard, Brad",12,6,4,6,0,0,0,0
West Coast,"Shuey, Luke",23,9,5,14,1,1,0,8
West Coast,"Wellingham, Sharrod",17,9,6,8,0,0,0,3
West Coast,"Yeo, Elliot",16,11,4,5,2,0,1,5
West Coast,"Barrass, Tom",11,5,4,6,0,0,0,2
West Coast,"Butler, Sam",13,4,2,9,0,0,0,3
West Coast,"Cripps, Jamie",15,9,5,6,1,2,0,4
West Coast,"Darling, Jack",16,8,6,8,1,0,0,2
West Coast,"Duggan, Liam",8,6,2,2,1,0,0,3
West Coast,"Gaff, Andrew",26,10,1,16,1,0,0,1
West Coast,"Giles, Jonathan",6,5,0,1,0,0,17,2
West Coast,"Hill, Josh",11,7,2,4,1,0,0,0
West Coast,"Hurn, Shannon",19,14,7,5,0,0,0,1
West Coast,"Kennedy, Josh",7,5,2,2,3,1,0,4
West Coast,"LeCras, Mark",16,9,3,7,0,1,0,3
West Coast,"Lycett, Scott",18,9,2,9,1,0,21,6
West Coast,"Mackenzie, Eric",7,5,3,2,0,0,0,2
West Coast,"Masten, Chris",12,7,1,5,0,0,0,3
West Coast,"McGovern, Jeremy",15,13,4,2,0,0,0,3
West Coast,"Nelson, Jackson",10,7,1,3,0,0,0,7
West Coast,"Priddis, Matt",24,16,2,8,1,0,0,15
West Coast,"Redden, Jack",15,4,1,11,0,0,1,6
West Coast,"Sheppard, Brad",15,8,2,7,0,0,0,3
West Coast,"Shuey, Luke",24,15,0,9,0,0,0,10
West Coast,"Wellingham, Sharrod",13,9,5,4,0,0,0,0
West Coast,"Yeo, Elliot",11,9,2,2,0,1,5,5
West Coast,"Butler, Sam",9,7,2,2,0,0,0,4
West Coast,"Cripps, Jamie",15,5,6,10,2,0,0,5
West Coast,"Darling, Jack",8,8,6,0,4,1,0,2
West Coast,"Duggan, Liam",11,4,2,7,0,0,0,9
West Coast,"Gaff, Andrew",35,20,5,15,0,0,0,3
West Coast,"Hill, Josh",14,8,4,6,2,2,0,3
West Coast,"Hurn, Shannon",16,10,3,6,0,0,0,2
West Coast,"Hutchings, Mark",21,9,2,12,0,0,0,8
West Coast,"Karpany, Malcolm",8,3,1,5,0,0,0,4
West Coast,"Kennedy, Josh",12,11,7,1,2,2,0,4
West Coast,"LeCras, Mark",9,6,1,3,0,0,0,3
West Coast,"Lycett, Scott",17,3,4,14,0,0,22,6
West Coast,"Mackenzie, Eric",13,8,4,5,0,0,0,5
West Coast,"Masten, Chris",15,4,2,11,1,0,0,2
West Coast,"McGovern, Jeremy",12,8,6,4,0,0,3,5
West Coast,"Priddis, Matt",31,13,3,18,0,0,0,6
West Coast,"Schofield, Will",9,6,5,3,0,0,0,1
West Coast,"Sheed, Dom",8,4,2,4,0,0,1,3
West Coast,"Sheppard, Brad",12,4,0,8,0,0,0,2
West Coast,"Shuey, Luke",28,10,5,18,0,0,1,6
West Coast,"Tunbridge, Simon",8,4,1,4,0,0,2,5
West Coast,"Wellingham, Sharrod",11,7,3,4,0,0,0,1
West Coast,"Barrass, Tom",11,7,6,4,0,0,0,1
West Coast,"Cripps, Jamie",20,14,6,6,0,1,0,3
West Coast,"Darling, Jack",18,6,8,12,0,1,0,4
West Coast,"Gaff, Andrew",19,12,1,7,1,0,0,0
West Coast,"Hill, Josh",9,6,2,3,3,0,0,5
West Coast,"Hurn, Shannon",23,16,6,7,1,0,0,3
West Coast,"Hutchings, Mark",13,8,2,5,0,1,0,7
West Coast,"Kennedy, Josh",13,11,8,2,7,2,0,3
West Coast,"LeCras, Mark",18,16,9,2,3,2,0,2
West Coast,"Lycett, Scott",10,5,6,5,0,0,13,3
West Coast,"Masten, Chris",33,20,8,13,0,0,0,2
West Coast,"McGovern, Jeremy",20,18,7,2,0,0,0,1
West Coast,"Naitanui, Nic",7,3,0,4,1,0,26,2
West Coast,"Nelson, Jackson",16,9,5,7,0,0,0,4
West Coast,"Priddis, Matt",33,11,4,22,0,0,0,4
West Coast,"Schofield, Will",14,9,6,5,0,0,0,2
West Coast,"Sheed, Dom",12,5,2,7,0,0,0,0
West Coast,"Sheppard, Brad",18,11,7,7,0,0,0,0
West Coast,"Shuey, Luke",23,8,2,15,0,0,0,10
West Coast,"Tunbridge, Simon",10,7,3,3,1,0,0,3
West Coast,"Wellingham, Sharrod",24,14,6,10,0,0,0,1
West Coast,"Yeo, Elliot",14,6,4,8,0,0,0,6
West Coast,"Barrass, Tom",6,2,0,4,0,0,0,3
West Coast,"Butler, Sam",10,4,3,6,0,0,0,6
West Coast,"Cripps, Jamie",13,9,3,4,0,1,0,4
West Coast,"Darling, Jack",12,4,5,8,0,0,0,4
West Coast,"Gaff, Andrew",29,14,3,15,0,0,0,1
West Coast,"Hill, Josh",7,6,0,1,0,1,0,2
West Coast,"Hurn, Shannon",13,6,5,7,0,0,0,3
West Coast,"Hutchings, Mark",18,10,5,8,1,0,0,6
West Coast,"Kennedy, Josh",13,11,7,2,3,3,0,3
West Coast,"LeCras, Mark",13,10,7,3,2,4,0,3
West Coast,"Lycett, Scott",2,0,0,2,0,0,9,1
West Coast,"Masten, Chris",20,8,3,12,0,1,0,1
West Coast,"McGovern, Jeremy",16,8,4,8,0,0,0,0
West Coast,"Naitanui, Nic",16,6,2,10,2,0,45,2
West Coast,"Priddis, Matt",26,10,0,16,2,1,0,8
West Coast,"Schofield, Will",7,5,3,2,0,0,0,0
West Coast,"Sheed, Dom",15,12,1,3,1,0,0,5
West Coast,"Sheppard, Brad",12,7,1,5,1,0,0,1
West Coast,"Shuey, Luke",38,18,3,20,2,0,0,6
West Coast,"Tunbridge, Simon",11,8,3,3,0,0,0,5
West Coast,"Wellingham, Sharrod",7,6,1,1,0,0,0,2
West Coast,"Yeo, Elliot",21,10,5,11,0,0,1,1
West Coast,"Butler, Sam",13,7,5,6,0,0,0,2
West Coast,"Cripps, Jamie",17,11,3,6,0,2,0,3
West Coast,"Darling, Jack",12,9,6,3,3,0,4,3
West Coast,"Gaff, Andrew",38,18,4,20,0,0,0,3
West Coast,"Hill, Josh",4,2,2,2,0,0,0,3
West Coast,"Hurn, Shannon",15,12,6,3,0,1,0,0
West Coast,"Hutchings, Mark",10,5,2,5,0,0,0,4
West Coast,"Jetta, Lewis",13,8,1,5,1,0,0,4
West Coast,"Kennedy, Josh",9,8,7,1,5,0,0,1
West Coast,"LeCras, Mark",24,14,8,10,2,2,0,0
West Coast,"Lycett, Scott",16,5,3,11,0,0,22,3
West Coast,"Masten, Chris",30,16,6,14,0,0,0,2
West Coast,"McGovern, Jeremy",17,14,9,3,0,0,0,1
West Coast,"Naitanui, Nic",12,1,1,11,0,0,18,2
West Coast,"Nelson, Jackson",11,9,2,2,0,1,0,1
West Coast,"Priddis, Matt",29,10,5,19,0,0,0,9
West Coast,"Schofield, Will",7,3,3,4,0,0,0,2
West Coast,"Sheed, Dom",20,10,3,10,0,0,0,1
West Coast,"Sheppard, Brad",14,9,3,5,0,0,0,4
West Coast,"Shuey, Luke",21,9,0,12,1,1,0,7
West Coast,"Wellingham, Sharrod",17,9,2,8,0,0,0,4
West Coast,"Yeo, Elliot",14,11,8,3,1,2,0,3
West Coast,"Barrass, Tom",17,9,10,8,0,0,0,1
West Coast,"Butler, Sam",14,6,3,8,0,0,0,1
West Coast,"Cripps, Jamie",12,7,3,5,1,0,0,3
West Coast,"Darling, Jack",13,7,4,6,2,4,1,4
West Coast,"Gaff, Andrew",41,20,2,21,0,0,0,2
West Coast,"Giles, Jonathan",15,8,4,7,1,1,29,1
West Coast,"Hill, Josh",8,4,1,4,1,0,0,0
West Coast,"Hurn, Shannon",26,16,5,10,0,0,0,0
West Coast,"Hutchings, Mark",17,11,0,6,1,1,0,6
West Coast,"Jetta, Lewis",10,7,4,3,1,1,0,2
West Coast,"Kennedy, Josh",13,10,8,3,5,1,0,1
West Coast,"LeCras, Mark",17,12,5,5,2,3,0,2
West Coast,"Lycett, Scott",11,1,3,10,0,0,13,1
West Coast,"Masten, Chris",27,11,2,16,0,0,0,1
West Coast,"McGovern, Jeremy",15,7,6,8,0,0,0,2
West Coast,"Priddis, Matt",33,7,2,26,0,0,0,11
West Coast,"Schofield, Will",7,6,5,1,0,0,0,1
West Coast,"Sheed, Dom",30,15,7,15,0,2,0,1
West Coast,"Sheppard, Brad",18,11,3,7,0,0,0,1
West Coast,"Shuey, Luke",31,13,3,18,0,1,2,8
West Coast,"Wellingham, Sharrod",25,13,4,12,0,0,0,0
West Coast,"Yeo, Elliot",8,4,1,4,0,0,1,3
West Coast,"Barrass, Tom",11,6,6,5,0,0,1,1
West Coast,"Brown, Mitch",5,3,0,2,1,0,0,3
West Coast,"Butler, Sam",24,12,5,12,0,0,0,3
West Coast,"Cripps, Jamie",6,4,0,2,0,0,0,6
West Coast,"Darling, Jack",11,6,6,5,2,0,0,3
West Coast,"Gaff, Andrew",35,20,2,15,0,0,0,1
West Coast,"Giles, Jonathan",8,5,4,3,0,0,28,3
West Coast,"Hill, Josh",11,6,4,5,1,1,0,2
West Coast,"Hurn, Shannon",25,19,3,6,0,0,0,2
West Coast,"Hutchings, Mark",25,10,5,15,0,0,0,5
West Coast,"Kennedy, Josh",16,12,8,4,2,1,0,2
West Coast,"LeCras, Mark",17,13,7,4,1,2,0,3
West Coast,"Lycett, Scott",9,4,2,5,0,0,16,6
West Coast,"Masten, Chris",27,11,2,16,0,0,0,2
West Coast,"McGovern, Jeremy",13,10,7,3,0,0,6,1
West Coast,"Priddis, Matt",25,5,0,20,0,1,0,8
West Coast,"Schofield, Will",10,5,4,5,0,0,0,6
West Coast,"Sheed, Dom",9,5,2,4,0,0,0,1
West Coast,"Sheppard, Brad",20,8,2,12,0,0,0,4
West Coast,"Shuey, Luke",28,6,1,22,0,0,1,6
West Coast,"Wellingham, Sharrod",15,11,4,4,0,0,0,4
West Coast,"Yeo, Elliot",13,8,5,5,0,2,0,7
Western Bulldogs,"Adams, Marcus",15,8,8,7,0,0,0,1
Western Bulldogs,"Biggs, Shane",35,22,6,13,0,1,0,2
Western Bulldogs,"Bontempelli, Marcus",20,11,1,9,1,1,0,6
Western Bulldogs,"Boyd, Matthew",26,13,8,13,0,0,0,2
Western Bulldogs,"Boyd, Tom",10,7,6,3,1,0,5,3
Western Bulldogs,"Dahlhaus, Luke",25,7,2,18,0,1,0,6
Western Bulldogs,"Daniel, Caleb",20,12,6,8,1,0,0,3
Western Bulldogs,"Dunkley, Josh",15,8,4,7,1,1,1,4
Western Bulldogs,"Hunter, Lachie",31,16,10,15,0,0,0,0
Western Bulldogs,"Johannisen, Jason",35,20,9,15,1,1,0,0
Western Bulldogs,"Liberatore, Tom",25,11,2,14,1,1,0,2
Western Bulldogs,"Macrae, Jack",30,12,5,18,1,0,0,4
Western Bulldogs,"McLean, Toby",22,13,7,9,1,1,0,3
Western Bulldogs,"Morris, Dale",10,5,5,5,0,1,0,1
Western Bulldogs,"Murphy, Robert",31,20,9,11,0,1,0,1
Western Bulldogs,"Picken, Liam",23,11,5,12,0,1,0,3
Western Bulldogs,"Roughead, Jordan",11,5,3,6,1,0,21,5
Western Bulldogs,"Stevens, Koby",27,8,1,19,0,0,0,8
Western Bulldogs,"Stringer, Jake",18,12,6,6,5,1,0,2
Western Bulldogs,"Suckling, Matt",22,12,8,10,1,1,0,2
Western Bulldogs,"Wallis, Mitch",24,7,0,17,0,1,1,3
Western Bulldogs,"Wood, Easton",23,10,5,13,0,0,0,1
Western Bulldogs,"Adams, Marcus",24,14,5,10,0,1,0,5
Western Bulldogs,"Biggs, Shane",24,15,10,9,0,0,0,1
Western Bulldogs,"Bontempelli, Marcus",23,13,1,10,0,0,0,1
Western Bulldogs,"Boyd, Matthew",25,14,9,11,0,0,0,1
Western Bulldogs,"Boyd, Tom",11,7,3,4,3,1,4,0
Western Bulldogs,"Dahlhaus, Luke",16,4,0,12,0,1,0,13
Western Bulldogs,"Daniel, Caleb",19,14,6,5,1,0,0,1
Western Bulldogs,"Dunkley, Josh",12,3,5,9,0,0,0,2
Western Bulldogs,"Hunter, Lachie",35,19,10,16,1,0,0,1
Western Bulldogs,"Johannisen, Jason",27,17,8,10,1,0,0,3
Western Bulldogs,"Liberatore, Tom",26,7,4,19,1,0,0,2
Western Bulldogs,"Macrae, Jack",30,12,4,18,0,0,0,1
Western Bulldogs,"McLean, Toby",22,13,6,9,1,0,0,1
Western Bulldogs,"Morris, Dale",16,7,7,9,0,0,0,2
Western Bulldogs,"Murphy, Robert",28,16,6,12,0,0,0,2
Western Bulldogs,"Picken, Liam",26,17,5,9,2,1,0,3
Western Bulldogs,"Roughead, Jordan",10,4,3,6,0,0,26,4
Western Bulldogs,"Stevens, Koby",23,9,3,14,0,0,0,4
Western Bulldogs,"Stringer, Jake",18,11,8,7,2,2,0,1
Western Bulldogs,"Suckling, Matt",22,13,10,9,0,2,0,2
Western Bulldogs,"Wallis, Mitch",26,9,3,17,1,0,0,2
Western Bulldogs,"Wood, Easton",19,5,6,14,0,0,0,3
Western Bulldogs,"Adams, Marcus",23,16,15,7,0,0,0,1
Western Bulldogs,"Biggs, Shane",18,13,5,5,2,0,0,0
Western Bulldogs,"Bontempelli, Marcus",17,7,1,10,1,0,3,1
Western Bulldogs,"Boyd, Matthew",20,16,9,4,0,0,0,3
Western Bulldogs,"Boyd, Tom",14,8,4,6,1,2,5,1
Western Bulldogs,"Dahlhaus, Luke",33,18,3,15,2,1,0,5
Western Bulldogs,"Daniel, Caleb",29,15,8,14,1,2,0,6
Western Bulldogs,"Hamling, Joel",15,7,4,8,0,0,0,2
Western Bulldogs,"Hunter, Lachie",23,14,7,9,0,2,0,1
Western Bulldogs,"Johannisen, Jason",17,9,6,8,0,0,0,2
Western Bulldogs,"Jong, Lin",13,3,2,10,0,1,3,1
Western Bulldogs,"Liberatore, Tom",19,5,2,14,0,0,0,5
Western Bulldogs,"Macrae, Jack",22,8,3,14,0,0,0,4
Western Bulldogs,"McLean, Toby",12,10,3,2,2,0,0,3
Western Bulldogs,"Morris, Dale",15,7,6,8,0,0,0,1
Western Bulldogs,"Murphy, Robert",25,19,4,6,0,0,0,3
Western Bulldogs,"Picken, Liam",18,9,1,9,0,0,0,6
Western Bulldogs,"Roughead, Jordan",14,5,4,9,1,0,22,4
Western Bulldogs,"Stevens, Koby",17,2,1,15,0,0,2,6
Western Bulldogs,"Stringer, Jake",13,9,1,4,1,2,1,1
Western Bulldogs,"Suckling, Matt",20,14,5,6,1,0,0,4
Western Bulldogs,"Wallis, Mitch",21,11,2,10,1,0,0,5
Western Bulldogs,"Adams, Marcus",12,5,5,7,0,1,0,3
Western Bulldogs,"Adcock, Jed",13,7,3,6,1,1,0,2
Western Bulldogs,"Biggs, Shane",32,22,7,10,0,0,0,1
Western Bulldogs,"Bontempelli, Marcus",13,6,1,7,3,0,2,1
Western Bulldogs,"Boyd, Matthew",26,12,8,14,0,0,0,1
Western Bulldogs,"Boyd, Tom",7,5,1,2,0,1,4,5
Western Bulldogs,"Dahlhaus, Luke",22,11,3,11,0,1,0,4
Western Bulldogs,"Daniel, Caleb",23,15,7,8,0,0,0,3
Western Bulldogs,"Hamling, Joel",13,5,3,8,0,0,0,2
Western Bulldogs,"Hunter, Lachie",33,18,4,15,1,0,0,3
Western Bulldogs,"Johannisen, Jason",19,13,4,6,1,0,0,0
Western Bulldogs,"Jong, Lin",14,4,1,10,1,0,3,6
Western Bulldogs,"Liberatore, Tom",22,7,2,15,1,0,0,2
Western Bulldogs,"Macrae, Jack",26,12,5,14,0,0,0,6
Western Bulldogs,"McLean, Toby",12,5,4,7,1,0,0,3
Western Bulldogs,"Morris, Dale",22,6,8,16,0,1,0,4
Western Bulldogs,"Picken, Liam",18,12,7,6,0,0,0,2
Western Bulldogs,"Roughead, Jordan",12,6,3,6,0,0,16,4
Western Bulldogs,"Stevens, Koby",25,17,5,8,2,0,1,3
Western Bulldogs,"Stringer, Jake",17,7,3,10,0,0,0,4
Western Bulldogs,"Suckling, Matt",27,18,5,9,1,0,0,1
Western Bulldogs,"Wallis, Mitch",18,4,2,14,1,0,0,1
Western Bulldogs,"Adams, Marcus",13,5,3,8,0,0,0,4
Western Bulldogs,"Adcock, Jed",16,4,4,12,0,0,0,4
Western Bulldogs,"Biggs, Shane",19,10,4,9,0,0,0,3
Western Bulldogs,"Bontempelli, Marcus",20,7,3,13,2,1,2,2
Western Bulldogs,"Boyd, Matthew",31,18,6,13,0,0,0,2
Western Bulldogs,"Campbell, Tom",16,10,7,6,1,2,22,2
Western Bulldogs,"Dahlhaus, Luke",23,16,3,7,2,2,0,4
Western Bulldogs,"Dale, Bailey",16,8,3,8,0,2,0,3
Western Bulldogs,"Dickson, Tory",18,11,4,7,2,1,0,5
Western Bulldogs,"Hunter, Lachie",32,14,3,18,0,0,0,2
Western Bulldogs,"Jong, Lin",15,10,1,5,1,1,3,4
Western Bulldogs,"Liberatore, Tom",19,10,4,9,2,0,0,4
Western Bulldogs,"Macrae, Jack",25,9,2,16,0,1,0,4
Western Bulldogs,"McLean, Toby",25,14,5,11,2,1,0,0
Western Bulldogs,"Morris, Dale",16,11,8,5,0,0,0,0
Western Bulldogs,"Picken, Liam",22,12,5,10,0,0,0,3
Western Bulldogs,"Roughead, Jordan",13,6,4,7,1,0,11,5
Western Bulldogs,"Stevens, Koby",34,11,5,23,0,1,0,6
Western Bulldogs,"Stringer, Jake",17,10,2,7,3,3,1,2
Western Bulldogs,"Suckling, Matt",5,2,1,3,0,0,0,0
Western Bulldogs,"Wallis, Mitch",33,15,6,18,1,0,0,1
Western Bulldogs,"Wood, Easton",19,8,2,11,0,0,0,0
Western Bulldogs,"Adams, Marcus",12,6,5,6,0,0,0,2
Western Bulldogs,"Adcock, Jed",9,1,2,8,0,0,0,2
Western Bulldogs,"Biggs, Shane",27,18,4,9,0,0,0,6
Western Bulldogs,"Bontempelli, Marcus",21,9,2,12,1,0,2,4
Western Bulldogs,"Boyd, Matthew",33,21,8,12,0,1,0,1
Western Bulldogs,"Campbell, Tom",14,5,3,9,0,1,18,3
Western Bulldogs,"Dahlhaus, Luke",28,10,2,18,1,0,0,6
Western Bulldogs,"Dale, Bailey",10,2,1,8,0,0,0,1
Western Bulldogs,"Dickson, Tory",18,6,3,12,1,0,0,1
Western Bulldogs,"Hunter, Lachie",44,23,6,21,0,0,0,1
Western Bulldogs,"Jong, Lin",17,14,5,3,1,1,1,1
Western Bulldogs,"Liberatore, Tom",13,4,0,9,0,0,0,7
Western Bulldogs,"Macrae, Jack",33,17,7,16,0,0,0,3
Western Bulldogs,"McLean, Toby",20,11,4,9,1,0,0,2
Western Bulldogs,"Morris, Dale",15,5,3,10,0,0,0,2
Western Bulldogs,"Picken, Liam",25,17,3,8,0,0,0,4
Western Bulldogs,"Roberts, Fletcher",9,4,3,5,0,0,0,3
Western Bulldogs,"Roughead, Jordan",3,1,2,2,0,1,11,3
Western Bulldogs,"Stevens, Koby",28,14,4,14,1,1,0,5
Western Bulldogs,"Stringer, Jake",17,9,2,8,0,2,0,2
Western Bulldogs,"Wallis, Mitch",26,10,1,16,0,1,1,5
Western Bulldogs,"Wood, Easton",12,8,4,4,0,0,0,2
Western Bulldogs,"Adams, Marcus",20,9,3,11,0,0,0,1
Western Bulldogs,"Adcock, Jed",12,6,1,6,0,0,0,0
Western Bulldogs,"Biggs, Shane",13,7,1,6,0,0,0,2
Western Bulldogs,"Bontempelli, Marcus",30,13,5,17,2,1,1,5
Western Bulldogs,"Boyd, Matthew",27,18,4,9,0,0,0,4
Western Bulldogs,"Campbell, Tom",14,8,5,6,0,3,23,2
Western Bulldogs,"Dahlhaus, Luke",31,14,2,17,0,0,0,5
Western Bulldogs,"Dale, Bailey",12,7,4,5,2,2,0,2
Western Bulldogs,"Daniel, Caleb",20,8,1,12,2,1,0,3
Western Bulldogs,"Dickson, Tory",11,7,4,4,3,1,0,2
Western Bulldogs,"Hunter, Lachie",25,11,4,14,0,0,0,2
Western Bulldogs,"Liberatore, Tom",25,8,2,17,1,1,0,7
Western Bulldogs,"Macrae, Jack",27,12,5,15,0,0,0,3
Western Bulldogs,"McLean, Toby",13,9,6,4,0,2,0,2
Western Bulldogs,"Morris, Dale",17,4,2,13,0,0,0,3
Western Bulldogs,"Picken, Liam",22,7,4,15,0,1,0,1
Western Bulldogs,"Redpath, Jack",11,8,6,3,3,1,0,4
Western Bulldogs,"Roberts, Fletcher",12,6,3,6,0,0,0,2
Western Bulldogs,"Roughead, Jordan",17,7,5,10,0,0,13,4
Western Bulldogs,"Stringer, Jake",16,7,5,9,4,0,0,1
Western Bulldogs,"Wallis, Mitch",26,11,2,15,1,1,1,3
Western Bulldogs,"Wood, Easton",21,11,11,10,0,0,0,1
Western Bulldogs,"Adcock, Jed",17,8,2,9,0,0,0,3
Western Bulldogs,"Biggs, Shane",19,8,2,11,0,0,0,3
Western Bulldogs,"Bontempelli, Marcus",33,13,5,20,0,0,5,2
Western Bulldogs,"Boyd, Matthew",31,23,8,8,0,0,0,1
Western Bulldogs,"Campbell, Tom",7,2,3,5,0,0,34,5
Western Bulldogs,"Dahlhaus, Luke",29,11,4,18,0,0,0,7
Western Bulldogs,"Dale, Bailey",15,6,6,9,1,0,0,1
Western Bulldogs,"Daniel, Caleb",20,11,4,9,0,1,0,1
Western Bulldogs,"Dickson, Tory",10,5,1,5,2,0,0,4
Western Bulldogs,"Hunter, Lachie",34,14,4,20,1,0,0,3
Western Bulldogs,"Liberatore, Tom",25,12,2,13,1,0,0,19
Western Bulldogs,"Macrae, Jack",27,15,5,12,0,0,0,5
Western Bulldogs,"McLean, Toby",18,11,5,7,1,2,0,1
Western Bulldogs,"Morris, Dale",13,5,4,8,0,0,0,2
Western Bulldogs,"Picken, Liam",30,19,5,11,2,1,0,5
Western Bulldogs,"Redpath, Jack",14,11,11,3,3,1,0,2
Western Bulldogs,"Roberts, Fletcher",7,3,0,4,0,0,0,1
Western Bulldogs,"Roughead, Jordan",9,6,1,3,0,1,2,3
Western Bulldogs,"Stringer, Jake",16,13,7,3,5,0,0,1
Western Bulldogs,"Wallis, Mitch",25,11,3,14,1,0,1,6
Western Bulldogs,"Williams, Bailey",14,7,2,7,0,1,0,4
Western Bulldogs,"Wood, Easton",13,8,3,5,0,0,0,5
Western Bulldogs,"Adcock, Jed",16,8,6,8,0,0,0,1
Western Bulldogs,"Biggs, Shane",17,9,3,8,0,0,0,3
Western Bulldogs,"Bontempelli, Marcus",32,11,4,21,0,1,1,4
Western Bulldogs,"Campbell, Tom",9,7,3,2,1,1,23,3
Western Bulldogs,"Collins, Kieran",4,4,2,0,0,0,0,1
Western Bulldogs,"Dahlhaus, Luke",28,10,3,18,0,0,0,5
Western Bulldogs,"Daniel, Caleb",21,9,2,12,0,0,0,0
Western Bulldogs,"Dickson, Tory",12,9,5,3,2,1,0,1
Western Bulldogs,"Hunter, Lachie",24,17,6,7,1,1,0,1
Western Bulldogs,"Jong, Lin",13,7,5,6,2,1,0,0
Western Bulldogs,"Liberatore, Tom",20,8,3,12,0,0,0,2
Western Bulldogs,"Macrae, Jack",26,15,4,11,0,0,0,3
Western Bulldogs,"McLean, Toby",10,5,2,5,2,0,0,1
Western Bulldogs,"Morris, Dale",14,9,5,5,0,0,0,1
Western Bulldogs,"Picken, Liam",22,12,5,10,0,0,1,9
Western Bulldogs,"Roberts, Fletcher",10,6,2,4,0,0,0,2
Western Bulldogs,"Roughead, Jordan",11,6,4,5,0,1,12,5
Western Bulldogs,"Stevens, Koby",14,6,4,8,0,0,0,4
Western Bulldogs,"Stringer, Jake",11,6,2,5,1,1,0,1
Western Bulldogs,"Wallis, Mitch",24,9,1,15,1,0,1,3
Western Bulldogs,"Williams, Bailey",16,9,4,7,0,0,0,0
Western Bulldogs,"Wood, Easton",15,9,5,6,0,0,0,4
Western Bulldogs,"Adams, Marcus",18,10,9,8,0,0,0,2
Western Bulldogs,"Biggs, Shane",26,11,5,15,0,0,0,0
Western Bulldogs,"Bontempelli, Marcus",20,11,6,9,1,0,2,3
Western Bulldogs,"Boyd, Matthew",24,15,10,9,0,0,0,1
Western Bulldogs,"Campbell, Tom",10,5,4,5,1,0,13,2
Western Bulldogs,"Dahlhaus, Luke",37,10,6,27,1,0,0,6
Western Bulldogs,"Daniel, Caleb",22,10,4,12,0,0,0,4
Western Bulldogs,"Dickson, Tory",19,8,3,11,2,0,0,1
Western Bulldogs,"Dunkley, Josh",18,14,10,4,2,1,1,5
Western Bulldogs,"Hunter, Lachie",29,19,9,10,0,0,0,5
Western Bulldogs,"Liberatore, Tom",31,16,4,15,0,0,0,6
Western Bulldogs,"Macrae, Jack",32,17,6,15,0,0,0,10
Western Bulldogs,"McLean, Toby",14,5,4,9,0,0,0,2
Western Bulldogs,"Morris, Dale",19,6,4,13,0,0,0,6
Western Bulldogs,"Picken, Liam",19,10,6,9,0,1,0,2
Western Bulldogs,"Redpath, Jack",17,12,9,5,2,0,0,2
Western Bulldogs,"Roberts, Fletcher",12,6,5,6,0,0,1,1
Western Bulldogs,"Roughead, Jordan",12,9,2,3,0,0,15,3
Western Bulldogs,"Stringer, Jake",11,5,5,6,0,0,0,0
Western Bulldogs,"Suckling, Matt",22,17,7,5,1,0,0,1
Western Bulldogs,"Wallis, Mitch",19,7,3,12,0,1,0,3
Western Bulldogs,"Wood, Easton",21,14,13,7,1,0,0,0
Western Bulldogs,"Adams, Marcus",18,9,5,9,0,0,0,2
Western Bulldogs,"Biggs, Shane",23,11,7,12,0,0,0,2
Western Bulldogs,"Bontempelli, Marcus",30,11,4,19,0,1,1,9
Western Bulldogs,"Boyd, Matthew",34,27,9,7,0,0,0,0
Western Bulldogs,"Campbell, Tom",14,7,4,7,2,0,14,1
Western Bulldogs,"Dahlhaus, Luke",20,11,6,9,0,0,0,3
Western Bulldogs,"Daniel, Caleb",24,11,5,13,0,0,0,2
Western Bulldogs,"Dickson, Tory",17,7,5,10,0,1,0,2
Western Bulldogs,"Dunkley, Josh",12,7,4,5,1,1,2,3
Western Bulldogs,"Hunter, Lachie",38,20,11,18,1,1,0,6
Western Bulldogs,"Liberatore, Tom",20,9,4,11,3,0,0,4
Western Bulldogs,"Macrae, Jack",33,18,6,15,0,0,0,7
Western Bulldogs,"McLean, Toby",14,5,1,9,0,1,0,2
Western Bulldogs,"Morris, Dale",14,8,7,6,0,0,0,4
Western Bulldogs,"Picken, Liam",23,12,9,11,1,0,0,2
Western Bulldogs,"Redpath, Jack",11,9,7,2,2,2,0,1
Western Bulldogs,"Roberts, Fletcher",6,1,1,5,0,0,0,1
Western Bulldogs,"Roughead, Jordan",10,4,4,6,0,1,11,2
Western Bulldogs,"Stringer, Jake",18,7,2,11,2,0,1,2
Western Bulldogs,"Suckling, Matt",28,20,7,8,0,1,0,1
Western Bulldogs,"Wallis, Mitch",26,10,5,16,0,0,0,5
Western Bulldogs,"Williams, Bailey",13,4,2,9,0,0,0,1
Western Bulldogs,"Biggs, Shane",17,13,4,4,1,0,0,2
Western Bulldogs,"Bontempelli, Marcus",29,9,2,20,2,1,2,4
Western Bulldogs,"Boyd, Matthew",28,18,2,10,0,0,0,2
Western Bulldogs,"Campbell, Tom",13,7,2,6,0,0,24,2
Western Bulldogs,"Dahlhaus, Luke",8,4,0,4,1,0,0,2
Western Bulldogs,"Daniel, Caleb",20,12,2,8,0,0,0,5
Western Bulldogs,"Dickson, Tory",11,7,4,4,2,1,0,3
Western Bulldogs,"Dunkley, Josh",14,4,1,10,0,1,0,6
Western Bulldogs,"Hamling, Joel",6,0,2,6,0,0,0,5
Western Bulldogs,"Honeychurch, Mitch",22,12,5,10,1,1,0,6
Western Bulldogs,"Hunter, Lachie",25,16,6,9,0,0,0,1
Western Bulldogs,"Liberatore, Tom",24,8,2,16,1,0,0,8
Western Bulldogs,"Macrae, Jack",21,8,2,13,0,0,0,10
Western Bulldogs,"Morris, Dale",10,4,0,6,0,0,0,5
Western Bulldogs,"Picken, Liam",25,9,1,16,0,0,0,5
Western Bulldogs,"Redpath, Jack",9,7,7,2,4,0,0,2
Western Bulldogs,"Roberts, Fletcher",7,2,1,5,0,0,0,0
Western Bulldogs,"Roughead, Jordan",12,6,4,6,0,0,29,4
Western Bulldogs,"Stringer, Jake",16,8,1,8,3,1,0,1
Western Bulldogs,"Suckling, Matt",17,11,0,6,0,1,0,2
Western Bulldogs,"Wallis, Mitch",28,13,2,15,0,1,0,4
Western Bulldogs,"Williams, Bailey",14,6,5,8,0,0,0,1
Western Bulldogs,"Adams, Marcus",11,5,3,6,0,0,0,1
Western Bulldogs,"Biggs, Shane",22,12,6,10,0,1,0,2
Western Bulldogs,"Bontempelli, Marcus",22,10,4,12,0,0,8,8
Western Bulldogs,"Boyd, Matthew",28,19,9,9,0,0,0,1
Western Bulldogs,"Campbell, Tom",9,4,2,5,0,1,15,4
Western Bulldogs,"Daniel, Caleb",20,10,6,10,0,0,0,3
Western Bulldogs,"Dickson, Tory",9,5,1,4,0,1,0,2
Western Bulldogs,"Dunkley, Josh",9,4,1,5,0,1,1,2
Western Bulldogs,"Honeychurch, Mitch",16,8,3,8,0,0,0,2
Western Bulldogs,"Hunter, Lachie",25,13,6,12,0,2,0,2
Western Bulldogs,"Jong, Lin",20,8,7,12,1,0,2,6
Western Bulldogs,"Liberatore, Tom",22,8,2,14,0,0,0,4
Western Bulldogs,"Macrae, Jack",31,12,4,19,0,1,1,7
Western Bulldogs,"Morris, Dale",13,9,3,4,0,0,0,0
Western Bulldogs,"Picken, Liam",18,8,4,10,1,1,0,3
Western Bulldogs,"Redpath, Jack",6,4,2,2,1,0,0,1
Western Bulldogs,"Roberts, Fletcher",10,3,3,7,0,0,0,2
Western Bulldogs,"Roughead, Jordan",7,7,3,0,0,1,8,0
Western Bulldogs,"Stringer, Jake",16,8,3,8,0,3,0,4
Western Bulldogs,"Suckling, Matt",26,15,9,11,1,0,0,1
Western Bulldogs,"Wallis, Mitch",15,7,3,8,1,0,0,3
Western Bulldogs,"Williams, Bailey",20,7,3,13,0,0,0,1
Western Bulldogs,"Adams, Marcus",13,8,2,5,0,0,0,3
Western Bulldogs,"Biggs, Shane",19,14,2,5,1,0,0,3
Western Bulldogs,"Bontempelli, Marcus",29,14,6,15,1,0,2,8
Western Bulldogs,"Boyd, Matthew",32,20,7,12,0,0,0,6
Western Bulldogs,"Daniel, Caleb",21,11,5,10,0,1,0,7
Western Bulldogs,"Dickson, Tory",11,4,3,7,0,1,0,3
Western Bulldogs,"Hunter, Lachie",31,23,8,8,1,0,0,4
Western Bulldogs,"Johannisen, Jason",20,12,4,8,1,0,0,4
Western Bulldogs,"Jong, Lin",20,8,2,12,1,1,1,3
Western Bulldogs,"Liberatore, Tom",15,11,2,4,2,1,0,9
Western Bulldogs,"Macrae, Jack",23,9,3,14,0,0,0,2
Western Bulldogs,"Minson, Will",6,4,1,2,1,0,24,3
Western Bulldogs,"Morris, Dale",12,4,5,8,0,0,0,2
Western Bulldogs,"Picken, Liam",28,13,7,15,0,0,0,5
Western Bulldogs,"Redpath, Jack",7,6,3,1,1,1,1,0
Western Bulldogs,"Roughead, Jordan",11,8,4,3,1,0,20,5
Western Bulldogs,"Smith, Clay",16,6,2,10,0,0,1,6
Western Bulldogs,"Stringer, Jake",9,5,2,4,3,0,0,2
Western Bulldogs,"Suckling, Matt",14,11,1,3,0,0,0,1
Western Bulldogs,"Wallis, Mitch",25,8,4,17,0,0,0,2
Western Bulldogs,"Webb, Lukas",14,4,1,10,0,0,0,0
Western Bulldogs,"Wood, Easton",16,11,7,5,0,0,0,2
Western Bulldogs,"Biggs, Shane",20,14,6,6,0,0,0,3
Western Bulldogs,"Bontempelli, Marcus",25,11,4,14,2,2,2,8
Western Bulldogs,"Boyd, Matthew",28,17,7,11,0,0,0,3
Western Bulldogs,"Daniel, Caleb",25,14,5,11,0,0,0,1
Western Bulldogs,"Dickson, Tory",20,9,8,11,1,1,0,4
Western Bulldogs,"Hunter, Lachie",24,13,6,11,0,1,0,4
Western Bulldogs,"Johannisen, Jason",22,13,10,9,1,0,0,0
Western Bulldogs,"Jong, Lin",13,5,2,8,0,1,5,7
Western Bulldogs,"Liberatore, Tom",13,8,2,5,0,0,0,6
Western Bulldogs,"Macrae, Jack",24,13,4,11,0,0,0,9
Western Bulldogs,"Morris, Dale",15,6,7,9,0,0,0,3
Western Bulldogs,"Picken, Liam",16,8,4,8,0,0,0,5
Western Bulldogs,"Redpath, Jack",14,10,5,4,2,1,4,2
Western Bulldogs,"Roberts, Fletcher",10,4,4,6,0,0,0,0
Western Bulldogs,"Roughead, Jordan",11,5,4,6,0,0,13,2
Western Bulldogs,"Smith, Clay",18,10,4,8,1,1,0,8
Western Bulldogs,"Stevens, Koby",17,5,3,12,0,0,2,7
Western Bulldogs,"Stringer, Jake",15,10,6,5,4,0,0,3
Western Bulldogs,"Suckling, Matt",22,15,7,7,1,1,0,2
Western Bulldogs,"Wallis, Mitch",17,2,0,15,0,0,0,2
Western Bulldogs,"Webb, Lukas",7,2,1,5,0,0,0,3
Western Bulldogs,"Wood, Easton",20,14,8,6,0,0,0,1
Western Bulldogs,"Biggs, Shane",24,13,4,11,0,0,0,1
Western Bulldogs,"Bontempelli, Marcus",29,15,3,14,0,2,0,5
Western Bulldogs,"Boyd, Matthew",29,17,8,12,0,0,0,2
Western Bulldogs,"Boyd, Tom",11,5,3,6,1,1,8,4
Western Bulldogs,"Daniel, Caleb",20,7,2,13,0,0,0,1
Western Bulldogs,"Dickson, Tory",17,10,7,7,1,2,0,2
Western Bulldogs,"Dunkley, Josh",27,15,7,12,0,0,0,4
Western Bulldogs,"Hunter, Lachie",27,15,9,12,0,0,0,4
Western Bulldogs,"Johannisen, Jason",23,15,8,8,0,0,0,1
Western Bulldogs,"Jong, Lin",19,4,2,15,1,0,1,9
Western Bulldogs,"Macrae, Jack",29,14,8,15,0,0,0,2
Western Bulldogs,"Morris, Dale",13,6,6,7,0,0,0,0
Western Bulldogs,"Picken, Liam",21,11,5,10,2,2,0,2
Western Bulldogs,"Redpath, Jack",13,11,8,2,1,4,0,0
Western Bulldogs,"Roberts, Fletcher",11,4,6,7,0,0,0,3
Western Bulldogs,"Roughead, Jordan",17,8,4,9,0,0,14,2
Western Bulldogs,"Smith, Clay",17,11,6,6,3,4,0,3
Western Bulldogs,"Stevens, Koby",34,14,5,20,2,0,1,2
Western Bulldogs,"Stringer, Jake",13,7,3,6,1,1,0,3
Western Bulldogs,"Suckling, Matt",28,15,6,13,0,0,0,0
Western Bulldogs,"Wallis, Mitch",25,17,5,8,3,1,0,4
Western Bulldogs,"Wood, Easton",20,16,9,4,0,0,0,2
Western Bulldogs,"Biggs, Shane",19,11,2,8,0,0,0,0
Western Bulldogs,"Bontempelli, Marcus",25,12,7,13,3,3,0,3
Western Bulldogs,"Boyd, Matthew",24,15,7,9,0,0,0,3
Western Bulldogs,"Boyd, Tom",8,4,1,4,0,1,13,1
Western Bulldogs,"Daniel, Caleb",18,10,0,8,0,0,0,3
Western Bulldogs,"Dickson, Tory",13,6,3,7,2,0,0,2
Western Bulldogs,"Dunkley, Josh",20,8,5,12,0,0,0,6
Western Bulldogs,"Hunter, Lachie",28,18,3,10,0,0,0,4
Western Bulldogs,"Johannisen, Jason",23,12,3,11,0,0,0,3
Western Bulldogs,"Jong, Lin",19,8,3,11,1,0,0,8
Western Bulldogs,"Liberatore, Tom",14,3,1,11,0,0,0,3
Western Bulldogs,"Macrae, Jack",27,12,8,15,0,0,0,2
Western Bulldogs,"Morris, Dale",5,3,4,2,0,0,0,2
Western Bulldogs,"Picken, Liam",20,10,5,10,0,1,0,1
Western Bulldogs,"Redpath, Jack",4,1,0,3,1,0,2,2
Western Bulldogs,"Roberts, Fletcher",11,4,3,7,0,0,0,1
Western Bulldogs,"Roughead, Jordan",16,12,7,4,0,0,15,5
Western Bulldogs,"Smith, Clay",15,8,4,7,1,1,0,7
Western Bulldogs,"Stevens, Koby",16,6,1,10,0,0,0,5
Western Bulldogs,"Suckling, Matt",21,14,4,7,1,0,0,3
Western Bulldogs,"Wallis, Mitch",10,4,3,6,0,0,0,5
Western Bulldogs,"Wood, Easton",16,10,8,6,0,0,0,0
Western Bulldogs,"Adcock, Jed",18,16,6,2,0,0,0,2
Western Bulldogs,"Biggs, Shane",24,18,7,6,0,0,0,4
Western Bulldogs,"Bontempelli, Marcus",23,11,2,12,0,1,1,6
Western Bulldogs,"Boyd, Tom",18,10,4,8,3,0,6,1
Western Bulldogs,"Cordy, Zaine",11,7,3,4,1,0,0,2
Western Bulldogs,"Dahlhaus, Luke",26,12,2,14,0,0,0,5
Western Bulldogs,"Daniel, Caleb",20,7,1,13,0,1,0,5
Western Bulldogs,"Dickson, Tory",10,5,1,5,3,0,0,4
Western Bulldogs,"Dunkley, Josh",15,8,6,7,1,1,0,5
Western Bulldogs,"Hamling, Joel",7,3,2,4,0,0,0,4
Western Bulldogs,"Hunter, Lachie",25,14,4,11,0,0,0,2
Western Bulldogs,"Johannisen, Jason",26,16,4,10,0,0,0,2
Western Bulldogs,"Jong, Lin",15,8,1,7,1,1,1,5
Western Bulldogs,"Liberatore, Tom",17,5,3,12,0,0,0,2
Western Bulldogs,"Macrae, Jack",20,7,3,13,0,0,0,4
Western Bulldogs,"Picken, Liam",26,4,2,22,0,0,0,4
Western Bulldogs,"Roberts, Fletcher",9,3,2,6,0,0,1,3
Western Bulldogs,"Roughead, Jordan",9,4,3,5,0,0,19,7
Western Bulldogs,"Smith, Clay",11,7,3,4,1,1,0,6
Western Bulldogs,"Stevens, Koby",14,6,3,8,0,1,0,5
Western Bulldogs,"Stringer, Jake",12,8,3,4,1,3,0,2
Western Bulldogs,"Wood, Easton",11,8,4,3,0,0,0,1
Western Bulldogs,"Biggs, Shane",20,14,4,6,0,0,0,2
Western Bulldogs,"Bontempelli, Marcus",19,15,8,4,1,0,0,9
Western Bulldogs,"Boyd, Matthew",22,13,6,9,0,0,0,3
Western Bulldogs,"Boyd, Tom",4,2,1,2,0,0,5,4
Western Bulldogs,"Cordy, Zaine",7,5,2,2,1,1,0,2
Western Bulldogs,"Dahlhaus, Luke",28,13,1,15,0,0,0,2
Western Bulldogs,"Daniel, Caleb",17,9,4,8,1,0,0,6
Western Bulldogs,"Dickson, Tory",18,13,7,5,1,0,0,2
Western Bulldogs,"Dunkley, Josh",19,9,4,10,0,1,1,4
Western Bulldogs,"Hamling, Joel",9,7,7,2,0,0,0,0
Western Bulldogs,"Hrovat, Nathan",14,7,5,7,1,0,0,4
Western Bulldogs,"Hunter, Lachie",21,11,5,10,1,1,0,1
Western Bulldogs,"Johannisen, Jason",22,15,6,7,1,0,0,2
Western Bulldogs,"Jong, Lin",18,7,4,11,0,0,1,3
Western Bulldogs,"Morris, Dale",9,7,6,2,0,0,0,2
Western Bulldogs,"Picken, Liam",18,10,1,8,0,0,0,7
Western Bulldogs,"Roberts, Fletcher",10,7,2,3,0,0,0,2
Western Bulldogs,"Roughead, Jordan",13,9,3,4,1,1,11,2
Western Bulldogs,"Smith, Clay",2,1,0,1,0,0,0,0
Western Bulldogs,"Stringer, Jake",12,7,6,5,1,1,0,1
Western Bulldogs,"Webb, Lukas",15,8,3,7,0,1,0,3
Western Bulldogs,"Wood, Easton",20,10,10,10,0,0,0,0
Western Bulldogs,"Biggs, Shane",16,9,2,7,0,0,0,3
Western Bulldogs,"Bontempelli, Marcus",26,13,8,13,2,0,4,8
Western Bulldogs,"Boyd, Matthew",24,14,5,10,0,0,0,2
Western Bulldogs,"Boyd, Tom",13,3,2,10,0,0,9,5
Western Bulldogs,"Cordy, Zaine",8,5,5,3,2,0,0,1
Western Bulldogs,"Dahlhaus, Luke",31,16,4,15,0,0,0,5
Western Bulldogs,"Daniel, Caleb",23,15,2,8,0,1,0,2
Western Bulldogs,"Dickson, Tory",8,6,4,2,2,0,0,1
Western Bulldogs,"Dunkley, Josh",18,9,5,9,1,2,2,10
Western Bulldogs,"Hamling, Joel",11,7,4,4,0,0,0,1
Western Bulldogs,"Hrovat, Nathan",18,14,5,4,2,1,0,0
Western Bulldogs,"Hunter, Lachie",27,13,4,14,1,0,0,4
Western Bulldogs,"Johannisen, Jason",22,15,7,7,0,0,0,0
Western Bulldogs,"Jong, Lin",18,8,3,10,2,0,0,5
Western Bulldogs,"Picken, Liam",20,15,6,5,0,1,0,9
Western Bulldogs,"Roberts, Fletcher",8,3,2,5,0,0,0,1
Western Bulldogs,"Roughead, Jordan",12,8,4,4,0,2,22,5
Western Bulldogs,"Smith, Clay",11,6,3,5,1,1,0,4
Western Bulldogs,"Stringer, Jake",11,4,1,7,1,0,0,2
Western Bulldogs,"Suckling, Matt",15,8,2,7,0,2,0,2
Western Bulldogs,"Webb, Lukas",13,3,1,10,0,0,0,4
Western Bulldogs,"Wood, Easton",15,7,4,8,0,0,0,2
Western Bulldogs,"Biggs, Shane",22,12,4,10,0,0,0,3
Western Bulldogs,"Bontempelli, Marcus",27,12,5,15,0,0,5,6
Western Bulldogs,"Boyd, Matthew",30,21,9,9,0,0,0,3
Western Bulldogs,"Boyd, Tom",13,6,6,7,1,1,13,2
Western Bulldogs,"Cordy, Zaine",8,5,3,3,1,0,5,6
Western Bulldogs,"Dahlhaus, Luke",23,8,3,15,0,0,0,4
Western Bulldogs,"Daniel, Caleb",23,15,5,8,2,0,0,3
Western Bulldogs,"Dickson, Tory",12,7,4,5,3,1,0,1
Western Bulldogs,"Dunkley, Josh",14,8,6,6,0,0,0,8
Western Bulldogs,"Hamling, Joel",10,7,3,3,0,0,0,1
Western Bulldogs,"Hrovat, Nathan",28,10,6,18,0,1,0,2
Western Bulldogs,"Hunter, Lachie",30,15,7,15,1,1,0,2
Western Bulldogs,"Johannisen, Jason",31,27,12,4,0,2,0,4
Western Bulldogs,"Jong, Lin",20,8,4,12,1,0,1,7
Western Bulldogs,"McLean, Toby",19,9,4,10,1,2,0,7
Western Bulldogs,"Picken, Liam",33,15,7,18,1,0,1,8
Western Bulldogs,"Roberts, Fletcher",8,4,4,4,0,0,0,1
Western Bulldogs,"Roughead, Jordan",4,1,2,3,1,0,9,1
Western Bulldogs,"Smith, Clay",15,7,6,8,1,1,0,2
Western Bulldogs,"Smith, Roarke",12,8,5,4,0,0,0,1
Western Bulldogs,"Webb, Lukas",14,6,1,8,0,0,1,3
Western Bulldogs,"Wood, Easton",10,4,5,6,1,0,0,1
Western Bulldogs,"Biggs, Shane",22,9,4,13,0,0,0,1
Western Bulldogs,"Bontempelli, Marcus",27,10,4,17,0,0,1,4
Western Bulldogs,"Boyd, Matthew",35,16,7,19,0,0,0,1
Western Bulldogs,"Boyd, Tom",11,4,0,7,0,0,5,1
Western Bulldogs,"Cordy, Zaine",9,3,3,6,0,0,0,1
Western Bulldogs,"Dahlhaus, Luke",31,7,4,24,1,1,0,4
Western Bulldogs,"Daniel, Caleb",23,10,0,13,0,1,0,4
Western Bulldogs,"Dickson, Tory",13,9,4,4,3,0,0,4
Western Bulldogs,"Dunkley, Josh",18,10,4,8,0,0,3,13
Western Bulldogs,"Hamling, Joel",16,8,6,8,0,0,0,0
Western Bulldogs,"Hrovat, Nathan",17,9,3,8,0,0,0,4
Western Bulldogs,"Hunter, Lachie",23,11,2,12,0,1,0,3
Western Bulldogs,"Johannisen, Jason",27,20,3,7,0,0,0,4
Western Bulldogs,"Jong, Lin",28,9,6,19,0,0,2,4
Western Bulldogs,"Minson, Will",8,5,0,3,0,0,8,3
Western Bulldogs,"Morris, Dale",18,5,4,13,0,0,0,3
Western Bulldogs,"Picken, Liam",28,7,0,21,0,1,0,4
Western Bulldogs,"Roberts, Fletcher",10,6,3,4,0,0,0,1
Western Bulldogs,"Smith, Clay",15,9,4,6,2,1,0,3
Western Bulldogs,"Stevens, Koby",19,9,5,10,0,2,0,5
Western Bulldogs,"Suckling, Matt",20,10,2,10,0,0,0,2
Western Bulldogs,"Williams, Bailey",16,6,2,10,0,0,0,3
Western Bulldogs,"Biggs, Shane",19,14,7,5,0,0,0,2
Western Bulldogs,"Bontempelli, Marcus",21,13,4,8,1,2,1,4
Western Bulldogs,"Boyd, Matthew",26,14,4,12,0,0,0,2
Western Bulldogs,"Boyd, Tom",14,6,5,8,0,2,8,5
Western Bulldogs,"Cordy, Zaine",8,6,5,2,0,0,0,1
Western Bulldogs,"Dahlhaus, Luke",29,12,6,17,1,1,0,9
Western Bulldogs,"Daniel, Caleb",33,17,1,16,1,0,0,4
Western Bulldogs,"Dickson, Tory",18,13,7,5,2,2,0,5
Western Bulldogs,"Dunkley, Josh",15,6,2,9,2,0,3,4
Western Bulldogs,"Hamling, Joel",13,7,3,6,0,0,0,0
Western Bulldogs,"Hunter, Lachie",26,16,5,10,1,2,0,3
Western Bulldogs,"Johannisen, Jason",25,21,8,4,0,0,0,6
Western Bulldogs,"Jong, Lin",6,2,0,4,0,0,0,2
Western Bulldogs,"Liberatore, Tom",22,13,3,9,1,0,0,3
Western Bulldogs,"Macrae, Jack",24,9,3,15,0,0,0,4
Western Bulldogs,"Morris, Dale",6,2,2,4,0,0,0,2
Western Bulldogs,"Picken, Liam",23,14,9,9,2,0,0,3
Western Bulldogs,"Roughead, Jordan",12,6,4,6,1,1,17,3
Western Bulldogs,"Smith, Clay",19,3,2,16,1,0,0,9
Western Bulldogs,"Stringer, Jake",10,4,2,6,1,1,1,2
Western Bulldogs,"Suckling, Matt",19,12,1,7,0,1,0,4
Western Bulldogs,"Wood, Easton",12,3,4,9,0,0,0,0
Western Bulldogs,"Biggs, Shane",15,10,2,5,0,0,0,2
Western Bulldogs,"Bontempelli, Marcus",27,16,5,11,2,0,7,1
Western Bulldogs,"Boyd, Matthew",19,10,3,9,0,0,0,0
Western Bulldogs,"Boyd, Tom",18,3,4,15,0,1,7,5
Western Bulldogs,"Cordy, Zaine",11,8,2,3,0,0,0,4
Western Bulldogs,"Dahlhaus, Luke",23,7,1,16,0,0,0,7
Western Bulldogs,"Daniel, Caleb",19,12,6,7,1,0,0,3
Western Bulldogs,"Dickson, Tory",12,6,5,6,1,3,0,0
Western Bulldogs,"Dunkley, Josh",23,17,6,6,1,2,1,6
Western Bulldogs,"Hamling, Joel",10,6,2,4,0,0,0,0
Western Bulldogs,"Hunter, Lachie",21,12,2,9,0,1,0,1
Western Bulldogs,"Johannisen, Jason",15,9,6,6,0,1,0,2
Western Bulldogs,"Liberatore, Tom",20,6,0,14,0,0,0,4
Western Bulldogs,"Macrae, Jack",39,16,8,23,0,0,0,2
Western Bulldogs,"McLean, Toby",21,9,2,12,1,1,0,1
Western Bulldogs,"Morris, Dale",10,2,2,8,0,0,0,3
Western Bulldogs,"Picken, Liam",24,14,8,10,3,0,0,1
Western Bulldogs,"Roughead, Jordan",11,5,2,6,1,1,20,4
Western Bulldogs,"Smith, Clay",16,8,3,8,2,0,0,10
Western Bulldogs,"Stringer, Jake",14,10,4,4,3,0,0,3
Western Bulldogs,"Suckling, Matt",18,11,4,7,0,0,0,2
Western Bulldogs,"Wood, Easton",11,6,4,5,1,0,0,1
Western Bulldogs,"Biggs, Shane",19,13,4,6,0,0,0,0
Western Bulldogs,"Bontempelli, Marcus",23,14,3,9,1,1,5,4
Western Bulldogs,"Boyd, Matthew",24,20,4,4,0,0,0,1
Western Bulldogs,"Boyd, Tom",14,2,1,12,0,0,21,2
Western Bulldogs,"Cordy, Zaine",10,5,1,5,2,0,3,1
Western Bulldogs,"Dahlhaus, Luke",32,17,9,15,0,0,0,3
Western Bulldogs,"Daniel, Caleb",24,14,4,10,1,0,0,4
Western Bulldogs,"Dickson, Tory",10,6,6,4,4,1,0,3
Western Bulldogs,"Dunkley, Josh",24,13,3,11,0,1,3,9
Western Bulldogs,"Hamling, Joel",7,5,3,2,0,0,0,0
Western Bulldogs,"Hunter, Lachie",19,8,4,11,0,0,0,2
Western Bulldogs,"Johannisen, Jason",26,24,7,2,0,3,0,3
Western Bulldogs,"Liberatore, Tom",15,5,0,10,0,0,0,7
Western Bulldogs,"Macrae, Jack",25,11,4,14,1,1,0,1
Western Bulldogs,"McLean, Toby",20,8,5,12,0,0,0,5
Western Bulldogs,"Morris, Dale",10,6,3,4,0,0,0,2
Western Bulldogs,"Picken, Liam",21,12,4,9,0,0,0,6
Western Bulldogs,"Roberts, Fletcher",9,4,1,5,0,0,0,1
Western Bulldogs,"Roughead, Jordan",4,2,2,2,0,0,8,1
Western Bulldogs,"Smith, Clay",26,16,5,10,4,1,0,8
Western Bulldogs,"Stringer, Jake",11,7,2,4,0,1,0,6
Western Bulldogs,"Wood, Easton",19,11,8,8,0,0,0,1
Western Bulldogs,"Biggs, Shane",15,12,4,3,0,0,0,3
Western Bulldogs,"Bontempelli, Marcus",22,14,1,8,0,0,9,7
Western Bulldogs,"Boyd, Matthew",27,16,4,11,0,0,0,4
Western Bulldogs,"Boyd, Tom",14,10,8,4,3,2,14,0
Western Bulldogs,"Cordy, Zaine",11,7,1,4,1,0,0,4
Western Bulldogs,"Dahlhaus, Luke",23,10,3,13,0,0,0,8
Western Bulldogs,"Daniel, Caleb",14,11,3,3,0,1,0,5
Western Bulldogs,"Dickson, Tory",11,7,3,4,3,0,0,5
Western Bulldogs,"Dunkley, Josh",15,9,3,6,0,0,0,7
Western Bulldogs,"Hamling, Joel",9,5,4,4,0,0,0,1
Western Bulldogs,"Hunter, Lachie",19,8,1,11,0,1,0,4
Western Bulldogs,"Johannisen, Jason",33,25,7,8,0,1,0,1
Western Bulldogs,"Liberatore, Tom",22,8,2,14,0,0,0,8
Western Bulldogs,"Macrae, Jack",33,13,5,20,0,1,0,3
Western Bulldogs,"McLean, Toby",18,8,2,10,1,1,0,5
Western Bulldogs,"Morris, Dale",15,2,3,13,0,0,0,4
Western Bulldogs,"Picken, Liam",25,12,3,13,3,0,0,4
Western Bulldogs,"Roberts, Fletcher",5,2,2,3,0,0,0,0
Western Bulldogs,"Roughead, Jordan",13,8,5,5,0,0,17,4
Western Bulldogs,"Smith, Clay",13,8,1,5,1,0,0,11
Western Bulldogs,"Stringer, Jake",12,8,1,4,1,1,0,2
Western Bulldogs,"Wood, Easton",13,7,7,6,0,0,0,2
Adelaide,"Betts, Eddie",21,15,8,6,4,0,0,7
Adelaide,"Brown, Luke",8,5,3,3,0,0,0,2
Adelaide,"Cameron, Charlie",11,11,5,0,1,3,0,1
Adelaide,"Cheney, Kyle",14,11,7,3,0,0,0,3
Adelaide,"Dangerfield, Patrick",25,15,2,10,2,0,0,4
Adelaide,"Douglas, Richard",31,22,5,9,0,0,0,3
Adelaide,"Ellis-Yolmen, Cam",15,8,2,7,0,0,2,2
Adelaide,"Hartigan, Kyle",16,6,5,10,0,0,0,0
Adelaide,"Henderson, Ricky",12,10,1,2,0,0,0,2
Adelaide,"Jacobs, Sam",13,10,7,3,0,0,26,1
Adelaide,"Jaensch, Matthew",14,12,6,2,0,0,0,1
Adelaide,"Jenkins, Josh",14,7,7,7,3,1,3,2
Adelaide,"Laird, Rory",24,14,7,10,1,0,0,2
Adelaide,"Lynch, Tom",10,8,5,2,1,0,0,2
Adelaide,"Lyons, Jarryd",10,6,3,4,0,0,0,4
Adelaide,"Mackay, David",15,7,4,8,0,0,0,3
Adelaide,"Sloane, Rory",26,14,6,12,2,0,1,5
Adelaide,"Smith, Brodie",22,14,5,8,1,0,0,3
Adelaide,"Talia, Daniel",17,7,4,10,0,0,0,2
Adelaide,"Walker, Taylor",22,21,15,1,6,5,0,0
Adelaide,"Wright, Matthew",9,8,3,1,0,0,0,4
Adelaide,"van Berlo, Nathan",17,10,4,7,0,0,0,4
Adelaide,"Betts, Eddie",14,8,2,6,1,1,0,6
Adelaide,"Brown, Luke",13,7,2,6,0,0,0,2
Adelaide,"Cameron, Charlie",11,5,3,6,1,0,0,4
Adelaide,"Cheney, Kyle",15,11,6,4,0,0,0,2
Adelaide,"Dangerfield, Patrick",29,19,4,10,2,3,0,4
Adelaide,"Douglas, Richard",26,17,5,9,1,0,0,7
Adelaide,"Ellis-Yolmen, Cam",24,12,4,12,0,0,0,6
Adelaide,"Grigg, Mitch",10,6,2,4,0,0,0,1
Adelaide,"Hartigan, Kyle",21,11,8,10,0,0,0,2
Adelaide,"Henderson, Ricky",25,16,6,9,0,0,0,2
Adelaide,"Jacobs, Sam",24,10,9,14,0,0,32,0
Adelaide,"Jaensch, Matthew",26,20,13,6,0,0,0,1
Adelaide,"Jenkins, Josh",12,7,4,5,1,1,6,1
Adelaide,"Laird, Rory",21,12,9,9,0,1,0,4
Adelaide,"Lynch, Tom",22,11,6,11,2,1,0,2
Adelaide,"Mackay, David",9,5,5,4,0,0,0,3
Adelaide,"Sloane, Rory",30,17,8,13,0,1,0,4
Adelaide,"Smith, Brodie",29,21,7,8,1,2,0,2
Adelaide,"Talia, Daniel",24,13,5,11,0,0,0,2
Adelaide,"Walker, Taylor",19,16,11,3,2,3,0,2
Adelaide,"Wright, Matthew",7,3,1,4,0,0,0,3
Adelaide,"van Berlo, Nathan",15,11,6,4,1,0,0,8
Adelaide,"Betts, Eddie",14,10,2,4,1,1,0,2
Adelaide,"Brown, Luke",12,9,5,3,1,0,0,3
Adelaide,"Cameron, Charlie",3,3,0,0,1,1,0,4
Adelaide,"Dangerfield, Patrick",16,8,1,8,0,1,2,8
Adelaide,"Douglas, Richard",22,15,1,7,0,0,1,6
Adelaide,"Ellis-Yolmen, Cam",20,10,1,10,2,0,1,7
Adelaide,"Hartigan, Kyle",13,10,6,3,0,0,0,2
Adelaide,"Henderson, Ricky",16,14,4,2,0,0,0,1
Adelaide,"Jacobs, Sam",6,3,2,3,0,0,55,4
Adelaide,"Jaensch, Matthew",19,17,7,2,0,0,0,2
Adelaide,"Jenkins, Josh",7,4,2,3,1,1,6,2
Adelaide,"Kelly, Jake",7,4,3,3,0,0,0,10
Adelaide,"Laird, Rory",11,4,1,7,0,0,0,3
Adelaide,"Lynch, Tom",20,17,9,3,1,2,0,2
Adelaide,"Mackay, David",23,17,3,6,1,0,0,13
Adelaide,"Sloane, Rory",31,15,4,16,0,0,0,10
Adelaide,"Smith, Brodie",18,11,1,7,1,0,0,5
Adelaide,"Talia, Daniel",12,9,4,3,0,0,0,2
Adelaide,"Thompson, Scott",30,14,0,16,0,0,0,11
Adelaide,"Walker, Taylor",9,4,1,5,3,0,0,2
Adelaide,"Wright, Matthew",7,5,0,2,0,0,0,1
Adelaide,"van Berlo, Nathan",9,5,2,4,0,0,1,8
Adelaide,"Betts, Eddie",13,9,4,4,4,1,0,1
Adelaide,"Brown, Luke",11,8,5,3,0,0,0,4
Adelaide,"Dangerfield, Patrick",19,13,5,6,2,2,0,7
Adelaide,"Douglas, Richard",17,11,2,6,0,0,0,7
Adelaide,"Ellis-Yolmen, Cam",23,11,6,12,0,1,2,1
Adelaide,"Hartigan, Kyle",10,5,4,5,0,0,0,1
Adelaide,"Henderson, Ricky",18,11,5,7,1,0,0,0
Adelaide,"Jacobs, Sam",18,10,6,8,0,0,43,2
Adelaide,"Jaensch, Matthew",24,20,9,4,0,0,0,5
Adelaide,"Jenkins, Josh",14,11,5,3,1,1,3,2
Adelaide,"Kelly, Jake",14,6,4,8,0,0,0,2
Adelaide,"Laird, Rory",15,8,3,7,0,0,0,0
Adelaide,"Lynch, Tom",20,11,8,9,0,0,0,4
Adelaide,"Lyons, Jarryd",8,3,2,5,0,0,0,0
Adelaide,"Mackay, David",14,8,3,6,0,1,0,0
Adelaide,"Sloane, Rory",21,11,3,10,0,1,0,1
Adelaide,"Smith, Brodie",20,17,6,3,0,1,0,0
Adelaide,"Talia, Daniel",9,5,3,4,0,0,0,4
Adelaide,"Thompson, Scott",38,20,5,18,1,0,0,3
Adelaide,"Walker, Taylor",9,7,5,2,1,0,0,0
Adelaide,"Wright, Matthew",19,9,6,10,0,0,0,4
Adelaide,"van Berlo, Nathan",11,8,4,3,0,0,0,4
Adelaide,"Betts, Eddie",19,14,7,5,5,3,0,2
Adelaide,"Brown, Luke",10,6,2,4,0,0,0,1
Adelaide,"Cameron, Charlie",6,3,1,3,0,0,0,3
Adelaide,"Cheney, Kyle",11,7,4,4,0,0,0,2
Adelaide,"Dangerfield, Patrick",36,19,1,17,0,1,1,7
Adelaide,"Douglas, Richard",16,10,2,6,0,0,0,5
Adelaide,"Ellis-Yolmen, Cam",18,11,4,7,0,0,1,10
Adelaide,"Henderson, Ricky",21,13,4,8,0,0,0,1
Adelaide,"Jacobs, Sam",7,5,2,2,0,0,29,2
Adelaide,"Jaensch, Matthew",15,10,4,5,0,1,0,4
Adelaide,"Jenkins, Josh",7,3,1,4,2,0,8,1
Adelaide,"Kelly, Jake",12,7,3,5,0,0,0,1
Adelaide,"Laird, Rory",26,13,2,13,0,0,0,2
Adelaide,"Lynch, Tom",24,13,6,11,2,1,0,1
Adelaide,"Mackay, David",20,13,5,7,0,1,0,3
Adelaide,"Sloane, Rory",12,6,4,6,0,0,0,6
Adelaide,"Smith, Brodie",16,12,4,4,0,2,0,2
Adelaide,"Talia, Daniel",6,4,1,2,0,0,0,2
Adelaide,"Thompson, Scott",27,11,2,16,2,0,0,6
Adelaide,"Walker, Taylor",13,9,4,4,2,2,0,3
Adelaide,"Wright, Matthew",6,1,0,5,0,0,0,2
Adelaide,"van Berlo, Nathan",14,10,3,4,0,1,0,4
Adelaide,"Betts, Eddie",12,9,4,3,5,0,0,2
Adelaide,"Brown, Luke",16,10,4,6,0,0,0,1
Adelaide,"Cameron, Charlie",15,10,7,5,1,0,0,4
Adelaide,"Cheney, Kyle",19,15,9,4,0,0,0,6
Adelaide,"Crouch, Matt",13,8,5,5,0,1,0,2
Adelaide,"Dangerfield, Patrick",17,10,4,7,2,1,1,5
Adelaide,"Grigg, Mitch",14,9,8,5,1,0,0,4
Adelaide,"Jacobs, Sam",21,10,6,11,1,0,28,1
Adelaide,"Jaensch, Matthew",26,20,12,6,0,1,0,4
Adelaide,"Kelly, Jake",19,15,12,4,0,1,0,4
Adelaide,"Laird, Rory",29,13,9,16,0,0,0,2
Adelaide,"Lever, Jake",17,12,10,5,0,0,0,3
Adelaide,"Lynch, Tom",16,13,9,3,2,2,1,5
Adelaide,"Lyons, Jarryd",11,5,1,6,0,0,0,2
Adelaide,"Mackay, David",16,9,3,7,0,0,0,5
Adelaide,"Sloane, Rory",17,8,6,9,1,0,0,1
Adelaide,"Smith, Brodie",13,9,6,4,0,0,0,1
Adelaide,"Talia, Daniel",14,11,7,3,0,0,0,1
Adelaide,"Thompson, Scott",16,8,1,8,1,0,0,4
Adelaide,"Walker, Taylor",17,14,12,3,4,2,0,1
Adelaide,"Wright, Matthew",28,16,4,12,0,0,0,2
Adelaide,"van Berlo, Nathan",16,12,7,4,0,1,0,2
Adelaide,"Betts, Eddie",17,13,6,4,6,2,0,5
Adelaide,"Brown, Luke",14,11,6,3,0,0,0,1
Adelaide,"Cameron, Charlie",16,12,5,4,3,4,0,1
Adelaide,"Cheney, Kyle",11,7,5,4,0,0,0,2
Adelaide,"Crouch, Matt",27,7,3,20,0,0,0,4
Adelaide,"Dangerfield, Patrick",24,15,3,9,1,0,5,10
Adelaide,"Grigg, Mitch",19,12,3,7,2,1,0,4
Adelaide,"Henderson, Ricky",23,15,5,8,0,0,0,2
Adelaide,"Jacobs, Sam",23,10,4,13,0,0,40,2
Adelaide,"Jaensch, Matthew",18,11,6,7,0,0,0,0
Adelaide,"Kelly, Jake",22,13,8,9,0,0,0,4
Adelaide,"Laird, Rory",26,10,10,16,0,0,0,3
Adelaide,"Lever, Jake",15,9,4,6,0,0,0,1
Adelaide,"Lynch, Tom",18,13,9,5,3,1,1,0
Adelaide,"Lyons, Jarryd",15,10,4,5,0,0,0,2
Adelaide,"Mackay, David",24,11,2,13,0,0,0,3
Adelaide,"Smith, Brodie",4,0,0,4,0,0,0,0
Adelaide,"Talia, Daniel",18,12,6,6,0,0,0,4
Adelaide,"Thompson, Scott",35,11,7,24,0,0,0,5
Adelaide,"Walker, Taylor",18,9,7,9,3,0,0,0
Adelaide,"Wright, Matthew",15,7,3,8,0,0,0,2
Adelaide,"van Berlo, Nathan",16,7,2,9,0,1,0,6
Adelaide,"Betts, Eddie",12,12,3,0,3,1,0,2
Adelaide,"Brown, Luke",11,7,2,4,0,0,0,1
Adelaide,"Cameron, Charlie",6,3,3,3,0,1,0,2
Adelaide,"Cheney, Kyle",13,9,4,4,0,0,0,2
Adelaide,"Crouch, Matt",24,6,3,18,0,1,0,6
Adelaide,"Dangerfield, Patrick",27,11,6,16,1,0,0,5
Adelaide,"Ellis-Yolmen, Cam",14,7,0,7,0,2,2,4
Adelaide,"Grigg, Mitch",21,13,8,8,0,0,0,2
Adelaide,"Jacobs, Sam",22,14,9,8,1,1,25,3
Adelaide,"Jenkins, Josh",10,9,5,1,2,0,4,0
Adelaide,"Kelly, Jake",12,6,5,6,0,0,0,2
Adelaide,"Kerridge, Sam",8,2,0,6,0,0,0,1
Adelaide,"Laird, Rory",19,6,2,13,0,0,0,1
Adelaide,"Lever, Jake",14,8,6,6,0,0,0,1
Adelaide,"Lynch, Tom",14,11,4,3,1,1,0,1
Adelaide,"Lyons, Jarryd",8,5,0,3,0,0,0,3
Adelaide,"Mackay, David",24,13,4,11,0,0,0,2
Adelaide,"Talia, Daniel",6,3,2,3,0,0,0,0
Adelaide,"Thompson, Scott",21,11,1,10,0,0,0,1
Adelaide,"Walker, Taylor",18,17,11,1,4,0,0,1
Adelaide,"Wright, Matthew",14,6,1,8,0,1,0,1
Adelaide,"van Berlo, Nathan",19,5,3,14,0,0,0,0
Adelaide,"Betts, Eddie",13,10,3,3,2,1,0,2
Adelaide,"Brown, Luke",16,11,3,5,0,0,0,0
Adelaide,"Cameron, Charlie",11,7,1,4,1,3,0,3
Adelaide,"Cheney, Kyle",15,14,3,1,0,0,0,1
Adelaide,"Crouch, Matt",23,10,4,13,0,0,0,5
Adelaide,"Dangerfield, Patrick",38,20,4,18,1,1,1,8
Adelaide,"Ellis-Yolmen, Cam",20,10,0,10,1,0,1,9
Adelaide,"Grigg, Mitch",20,15,4,5,0,0,0,6
Adelaide,"Jacobs, Sam",11,8,2,3,0,0,22,2
Adelaide,"Jenkins, Josh",12,10,6,2,1,1,3,5
Adelaide,"Kelly, Jake",8,2,0,6,0,0,0,3
Adelaide,"Laird, Rory",27,16,3,11,0,0,0,8
Adelaide,"Lever, Jake",17,10,5,7,0,0,0,0
Adelaide,"Lynch, Tom",18,13,4,5,1,0,0,2
Adelaide,"Lyons, Jarryd",6,4,2,2,0,0,0,0
Adelaide,"Mackay, David",13,5,1,8,0,0,0,5
Adelaide,"Martin, Brodie",13,9,5,4,0,2,0,3
Adelaide,"Talia, Daniel",8,6,1,2,0,0,0,1
Adelaide,"Thompson, Scott",20,13,3,7,0,0,0,14
Adelaide,"Walker, Taylor",15,12,6,3,0,3,0,4
Adelaide,"Wright, Matthew",17,14,2,3,0,0,0,4
Adelaide,"van Berlo, Nathan",25,19,5,6,0,2,0,3
Adelaide,"Betts, Eddie",8,3,2,5,1,0,0,2
Adelaide,"Brown, Luke",8,6,3,2,0,0,0,4
Adelaide,"Cameron, Charlie",6,3,1,3,1,1,0,1
Adelaide,"Cheney, Kyle",14,8,6,6,0,0,0,2
Adelaide,"Crouch, Matt",9,4,1,5,0,0,0,4
Adelaide,"Dangerfield, Patrick",26,11,4,15,1,0,1,7
Adelaide,"Ellis-Yolmen, Cam",9,6,0,3,0,1,0,5
Adelaide,"Grigg, Mitch",19,14,5,5,0,3,0,3
Adelaide,"Hartigan, Kyle",9,6,3,3,0,0,0,1
Adelaide,"Jacobs, Sam",18,9,3,9,1,0,39,0
Adelaide,"Jenkins, Josh",18,16,8,2,5,1,4,0
Adelaide,"Kelly, Jake",4,2,1,2,0,0,0,2
Adelaide,"Laird, Rory",26,17,7,9,0,1,0,5
Adelaide,"Lynch, Tom",22,16,6,6,2,0,0,1
Adelaide,"Mackay, David",12,6,2,6,0,0,0,4
Adelaide,"Sloane, Rory",21,7,2,14,0,0,0,8
Adelaide,"Smith, Brodie",20,13,5,7,0,0,0,1
Adelaide,"Talia, Daniel",6,4,2,2,0,0,0,0
Adelaide,"Thompson, Scott",22,13,5,9,0,0,0,10
Adelaide,"Walker, Taylor",13,10,7,3,1,3,0,2
Adelaide,"Wright, Matthew",17,10,4,7,1,2,0,2
Adelaide,"van Berlo, Nathan",15,11,5,4,1,1,0,3
Adelaide,"Betts, Eddie",9,3,0,6,1,0,0,3
Adelaide,"Brown, Luke",13,7,5,6,0,0,0,0
Adelaide,"Cameron, Charlie",12,7,1,5,2,1,0,2
Adelaide,"Cheney, Kyle",19,12,7,7,0,0,0,1
Adelaide,"Crouch, Matt",13,4,1,9,0,1,0,2
Adelaide,"Dangerfield, Patrick",31,20,2,11,1,2,0,3
Adelaide,"Douglas, Richard",14,7,4,7,2,0,0,2
Adelaide,"Ellis-Yolmen, Cam",19,7,2,12,0,1,0,4
Adelaide,"Hartigan, Kyle",10,6,7,4,0,0,0,2
Adelaide,"Jacobs, Sam",15,10,3,5,0,2,40,4
Adelaide,"Jenkins, Josh",8,6,3,2,1,1,5,0
Adelaide,"Kelly, Jake",8,6,1,2,0,0,0,3
Adelaide,"Laird, Rory",25,8,6,17,1,1,0,5
Adelaide,"Lynch, Tom",24,19,9,5,1,0,0,0
Adelaide,"Mackay, David",9,4,1,5,0,0,0,5
Adelaide,"Sloane, Rory",29,13,3,16,0,0,1,6
Adelaide,"Smith, Brodie",22,18,6,4,0,0,0,0
Adelaide,"Talia, Daniel",14,11,5,3,1,0,0,4
Adelaide,"Thompson, Scott",32,12,3,20,0,0,0,4
Adelaide,"Walker, Taylor",5,3,3,2,1,0,0,0
Adelaide,"Wright, Matthew",17,14,7,3,1,0,0,2
Adelaide,"van Berlo, Nathan",17,11,4,6,0,0,0,4
Adelaide,"Betts, Eddie",12,7,1,5,2,1,0,4
Adelaide,"Brown, Luke",19,10,3,9,0,0,0,1
Adelaide,"Cameron, Charlie",13,9,4,4,1,1,0,5
Adelaide,"Cheney, Kyle",13,8,2,5,0,0,0,1
Adelaide,"Crouch, Matt",26,12,2,14,0,1,0,3
Adelaide,"Dangerfield, Patrick",23,13,2,10,0,0,3,5
Adelaide,"Douglas, Richard",18,9,2,9,0,0,0,6
Adelaide,"Ellis-Yolmen, Cam",11,8,4,3,0,0,2,3
Adelaide,"Hartigan, Kyle",7,3,2,4,0,0,1,1
Adelaide,"Jacobs, Sam",13,9,2,4,0,0,38,4
Adelaide,"Jenkins, Josh",14,9,6,5,2,2,2,2
Adelaide,"Kelly, Jake",3,1,0,2,0,0,0,0
Adelaide,"Laird, Rory",25,11,3,14,0,0,0,2
Adelaide,"Lynch, Tom",16,11,7,5,0,1,0,3
Adelaide,"Mackay, David",14,11,3,3,0,0,0,3
Adelaide,"Sloane, Rory",15,9,2,6,0,0,2,6
Adelaide,"Smith, Brodie",18,14,5,4,1,0,0,0
Adelaide,"Talia, Daniel",11,5,3,6,0,0,0,4
Adelaide,"Thompson, Scott",28,14,4,14,1,2,0,6
Adelaide,"Walker, Taylor",14,11,8,3,2,5,1,2
Adelaide,"Wright, Matthew",15,12,2,3,1,0,0,3
Adelaide,"van Berlo, Nathan",10,4,3,6,1,0,0,6
Adelaide,"Betts, Eddie",13,8,5,5,2,2,0,2
Adelaide,"Brown, Luke",12,5,4,7,0,0,0,4
Adelaide,"Cameron, Charlie",9,7,2,2,2,0,0,2
Adelaide,"Crouch, Matt",28,12,2,16,0,0,0,5
Adelaide,"Dangerfield, Patrick",36,18,6,18,0,0,1,8
Adelaide,"Douglas, Richard",19,10,1,9,0,1,0,5
Adelaide,"Ellis-Yolmen, Cam",3,1,0,2,0,0,2,2
Adelaide,"Hartigan, Kyle",9,4,2,5,0,0,0,0
Adelaide,"Henderson, Ricky",18,13,7,5,0,0,0,1
Adelaide,"Jacobs, Sam",6,2,1,4,0,0,33,2
Adelaide,"Jenkins, Josh",10,9,6,1,2,1,1,0
Adelaide,"Knight, Riley",13,7,5,6,2,0,0,3
Adelaide,"Laird, Rory",31,15,7,16,0,0,0,2
Adelaide,"Lever, Jake",17,16,8,1,0,0,0,3
Adelaide,"Lynch, Tom",14,11,6,3,1,0,0,0
Adelaide,"Mackay, David",14,8,1,6,0,1,0,2
Adelaide,"Smith, Brodie",20,12,4,8,1,0,0,2
Adelaide,"Talia, Daniel",8,8,6,0,0,0,0,1
Adelaide,"Thompson, Scott",18,5,3,13,0,0,1,4
Adelaide,"Walker, Taylor",11,10,3,1,3,0,0,1
Adelaide,"Wright, Matthew",16,9,2,7,1,1,0,4
Adelaide,"van Berlo, Nathan",6,4,2,2,0,0,0,4
Adelaide,"Atkins, Rory",6,4,1,2,0,0,0,1
Adelaide,"Betts, Eddie",14,9,3,5,1,3,0,2
Adelaide,"Brown, Luke",11,10,4,1,0,0,0,1
Adelaide,"Cameron, Charlie",10,8,6,2,2,0,0,2
Adelaide,"Crouch, Matt",24,12,1,12,1,0,0,3
Adelaide,"Dangerfield, Patrick",27,14,1,13,0,0,4,4
Adelaide,"Douglas, Richard",26,19,2,7,1,1,1,5
Adelaide,"Hartigan, Kyle",9,2,4,7,0,0,0,2
Adelaide,"Henderson, Ricky",18,11,7,7,1,0,0,0
Adelaide,"Jacobs, Sam",17,8,3,9,0,0,51,4
Adelaide,"Jenkins, Josh",10,6,5,4,3,0,0,3
Adelaide,"Knight, Riley",10,3,4,7,1,0,0,3
Adelaide,"Laird, Rory",19,12,4,7,0,0,0,3
Adelaide,"Lever, Jake",9,4,1,5,0,0,0,2
Adelaide,"Lynch, Tom",17,12,8,5,2,1,0,1
Adelaide,"Mackay, David",11,6,0,5,0,0,0,5
Adelaide,"Martin, Brodie",13,11,4,2,1,0,1,7
Adelaide,"Smith, Brodie",11,8,4,3,0,0,0,1
Adelaide,"Talia, Daniel",1,1,0,0,0,0,0,0
Adelaide,"Thompson, Scott",36,15,1,21,1,0,0,8
Adelaide,"Walker, Taylor",18,12,6,6,3,2,0,2
Adelaide,"Wright, Matthew",18,12,2,6,1,0,0,1
Adelaide,"Atkins, Rory",5,3,1,2,0,0,0,1
Adelaide,"Betts, Eddie",16,14,2,2,3,1,0,0
Adelaide,"Brown, Luke",18,10,2,8,0,0,0,1
Adelaide,"Cameron, Charlie",13,9,3,4,4,1,0,2
Adelaide,"Dangerfield, Patrick",36,18,3,18,1,0,1,8
Adelaide,"Douglas, Richard",25,15,6,10,2,0,0,3
Adelaide,"Hartigan, Kyle",13,6,3,7,0,0,0,0
Adelaide,"Henderson, Ricky",13,7,4,6,0,0,0,0
Adelaide,"Jacobs, Sam",21,9,2,12,0,0,39,0
Adelaide,"Jenkins, Josh",10,8,5,2,3,4,5,0
Adelaide,"Knight, Riley",11,4,0,7,1,0,0,4
Adelaide,"Laird, Rory",32,18,7,14,0,0,0,0
Adelaide,"Lever, Jake",24,15,10,9,0,0,0,0
Adelaide,"Lynch, Tom",17,10,6,7,0,1,0,3
Adelaide,"Mackay, David",13,9,3,4,0,0,0,2
Adelaide,"Martin, Brodie",15,10,5,5,1,0,0,2
Adelaide,"Shaw, Sam",14,7,4,7,0,0,0,2
Adelaide,"Sloane, Rory",19,10,3,9,2,0,0,7
Adelaide,"Smith, Brodie",18,10,5,8,0,0,0,5
Adelaide,"Thompson, Scott",34,14,4,20,0,0,0,6
Adelaide,"Walker, Taylor",11,8,6,3,2,1,0,2
Adelaide,"Wright, Matthew",8,4,3,4,0,0,0,2
Adelaide,"Betts, Eddie",11,6,2,5,1,0,0,2
Adelaide,"Brown, Luke",9,3,3,6,0,0,0,0
Adelaide,"Cameron, Charlie",10,5,2,5,0,1,0,2
Adelaide,"Crouch, Matt",11,3,2,8,0,0,0,0
Adelaide,"Dangerfield, Patrick",27,10,5,17,0,0,2,2
Adelaide,"Douglas, Richard",22,10,2,12,0,0,0,1
Adelaide,"Hartigan, Kyle",7,2,2,5,0,0,0,4
Adelaide,"Henderson, Ricky",18,9,5,9,0,0,0,0
Adelaide,"Jacobs, Sam",12,6,4,6,0,0,32,0
Adelaide,"Jenkins, Josh",14,9,4,5,2,1,2,2
Adelaide,"Knight, Riley",10,6,3,4,0,1,0,1
Adelaide,"Laird, Rory",21,11,5,10,0,1,0,0
Adelaide,"Lever, Jake",15,9,3,6,0,0,0,1
Adelaide,"Lynch, Tom",21,12,10,9,3,0,0,1
Adelaide,"Lyons, Jarryd",16,8,2,8,1,1,0,3
Adelaide,"Mackay, David",16,9,2,7,0,0,0,7
Adelaide,"Sloane, Rory",13,4,5,9,0,0,0,5
Adelaide,"Smith, Brodie",22,13,2,9,0,0,0,1
Adelaide,"Talia, Daniel",9,6,2,3,0,0,0,0
Adelaide,"Thompson, Scott",25,14,3,11,0,0,0,5
Adelaide,"Walker, Taylor",9,7,5,2,2,3,0,0
Adelaide,"Wright, Matthew",16,13,3,3,0,0,0,1
Adelaide,"Atkins, Rory",24,12,6,12,0,0,0,0
Adelaide,"Betts, Eddie",16,12,5,4,2,3,0,6
Adelaide,"Brown, Luke",8,7,3,1,0,0,0,0
Adelaide,"Cameron, Charlie",9,8,3,1,2,1,0,3
Adelaide,"Crouch, Matt",25,11,2,14,0,0,0,7
Adelaide,"Dangerfield, Patrick",29,16,5,13,1,2,2,5
Adelaide,"Hartigan, Kyle",8,4,3,4,0,0,0,1
Adelaide,"Henderson, Ricky",23,16,9,7,0,0,0,3
Adelaide,"Jacobs, Sam",14,12,3,2,0,0,38,4
Adelaide,"Jenkins, Josh",10,8,6,2,2,0,1,1
Adelaide,"Knight, Riley",11,5,2,6,0,0,0,2
Adelaide,"Laird, Rory",23,13,7,10,0,0,0,3
Adelaide,"Lever, Jake",7,4,3,3,0,0,0,0
Adelaide,"Lynch, Tom",14,10,5,4,1,2,0,4
Adelaide,"Lyons, Jarryd",23,15,2,8,0,0,0,5
Adelaide,"Mackay, David",6,4,0,2,1,0,0,3
Adelaide,"Sloane, Rory",27,10,4,17,0,0,0,5
Adelaide,"Smith, Brodie",17,13,3,4,0,1,0,6
Adelaide,"Talia, Daniel",6,5,4,1,0,0,0,1
Adelaide,"Thompson, Scott",30,11,1,19,0,1,0,10
Adelaide,"Walker, Taylor",21,15,10,6,2,5,0,3
Adelaide,"van Berlo, Nathan",17,11,2,6,0,0,0,4
Adelaide,"Atkins, Rory",18,14,5,4,1,0,0,0
Adelaide,"Betts, Eddie",14,10,6,4,5,0,0,2
Adelaide,"Brown, Luke",19,12,4,7,0,0,0,2
Adelaide,"Cameron, Charlie",14,9,5,5,2,0,0,5
Adelaide,"Crouch, Matt",26,11,6,15,0,0,0,1
Adelaide,"Dangerfield, Patrick",27,13,4,14,3,1,0,6
Adelaide,"Hartigan, Kyle",8,4,3,4,0,0,1,0
Adelaide,"Henderson, Ricky",14,10,6,4,0,0,0,1
Adelaide,"Jacobs, Sam",18,10,9,8,1,0,38,1
Adelaide,"Jenkins, Josh",13,11,6,2,3,3,10,1
Adelaide,"Knight, Riley",13,8,3,5,1,0,0,2
Adelaide,"Laird, Rory",31,21,9,10,0,0,0,3
Adelaide,"Lever, Jake",11,8,2,3,0,0,0,1
Adelaide,"Lynch, Tom",26,18,10,8,2,1,0,0
Adelaide,"Lyons, Jarryd",18,9,1,9,1,0,0,2
Adelaide,"Mackay, David",8,4,1,4,1,0,0,1
Adelaide,"Sloane, Rory",24,12,7,12,2,0,0,11
Adelaide,"Smith, Brodie",20,14,5,6,1,0,0,0
Adelaide,"Talia, Daniel",11,7,5,4,0,0,0,2
Adelaide,"Thompson, Scott",21,6,5,15,0,0,0,3
Adelaide,"Walker, Taylor",15,11,9,4,3,1,0,1
Adelaide,"van Berlo, Nathan",17,11,4,6,1,0,0,4
Adelaide,"Atkins, Rory",18,11,7,7,2,0,0,4
Adelaide,"Betts, Eddie",14,10,5,4,3,0,0,1
Adelaide,"Brown, Luke",9,7,2,2,0,0,0,3
Adelaide,"Cameron, Charlie",14,10,3,4,1,1,0,2
Adelaide,"Crouch, Matt",24,9,5,15,1,1,0,4
Adelaide,"Dangerfield, Patrick",16,11,5,5,1,0,1,7
Adelaide,"Douglas, Richard",18,14,4,4,1,0,0,3
Adelaide,"Hartigan, Kyle",10,4,3,6,0,0,0,2
Adelaide,"Henderson, Ricky",26,16,7,10,0,0,0,1
Adelaide,"Jacobs, Sam",21,13,4,8,0,0,47,0
Adelaide,"Jenkins, Josh",15,9,5,6,1,0,7,0
Adelaide,"Knight, Riley",17,6,6,11,0,1,0,4
Adelaide,"Laird, Rory",26,13,9,13,0,0,0,2
Adelaide,"Lynch, Tom",32,14,9,18,0,0,0,5
Adelaide,"Lyons, Jarryd",9,6,2,3,2,1,0,0
Adelaide,"Shaw, Sam",7,5,3,2,0,0,0,0
Adelaide,"Sloane, Rory",26,17,7,9,1,1,1,4
Adelaide,"Smith, Brodie",23,17,4,6,0,0,0,2
Adelaide,"Talia, Daniel",8,5,4,3,0,0,0,2
Adelaide,"Thompson, Scott",22,11,4,11,0,0,0,2
Adelaide,"Walker, Taylor",13,13,7,0,7,3,0,2
Adelaide,"van Berlo, Nathan",11,8,4,3,0,0,0,2
Adelaide,"Atkins, Rory",13,9,3,4,1,0,0,1
Adelaide,"Betts, Eddie",17,10,6,7,2,2,0,4
Adelaide,"Brown, Luke",9,9,2,0,0,0,0,1
Adelaide,"Cameron, Charlie",8,4,0,4,2,0,0,1
Adelaide,"Crouch, Matt",17,8,4,9,0,0,0,1
Adelaide,"Dangerfield, Patrick",28,9,5,19,1,0,1,1
Adelaide,"Douglas, Richard",25,13,5,12,0,1,0,5
Adelaide,"Hartigan, Kyle",8,3,4,5,0,0,0,0
Adelaide,"Henderson, Ricky",19,11,7,8,0,2,0,1
Adelaide,"Jacobs, Sam",14,9,5,5,0,1,32,1
Adelaide,"Jenkins, Josh",11,9,7,2,6,1,3,0
Adelaide,"Knight, Riley",16,8,6,8,1,1,0,1
Adelaide,"Laird, Rory",27,12,5,15,0,0,0,3
Adelaide,"Lever, Jake",12,9,4,3,0,0,1,0
Adelaide,"Lynch, Tom",22,18,5,4,2,0,0,2
Adelaide,"Lyons, Jarryd",7,6,2,1,0,0,0,0
Adelaide,"Sloane, Rory",25,10,6,15,1,0,0,7
Adelaide,"Smith, Brodie",29,23,4,6,0,0,0,2
Adelaide,"Talia, Daniel",13,11,5,2,0,0,0,0
Adelaide,"Thompson, Scott",29,14,6,15,0,0,0,7
Adelaide,"Walker, Taylor",17,14,12,3,3,1,0,2
Adelaide,"van Berlo, Nathan",17,9,5,8,0,0,0,1
Adelaide,"Atkins, Rory",12,6,2,6,0,0,0,1
Adelaide,"Betts, Eddie",12,8,4,4,4,2,0,3
Adelaide,"Brown, Luke",9,7,3,2,0,0,0,4
Adelaide,"Cameron, Charlie",11,5,2,6,0,2,0,3
Adelaide,"Crouch, Matt",25,10,0,15,0,0,0,6
Adelaide,"Dangerfield, Patrick",25,12,1,13,0,0,1,3
Adelaide,"Douglas, Richard",24,13,1,11,0,1,0,2
Adelaide,"Hartigan, Kyle",4,4,0,0,0,0,0,0
Adelaide,"Henderson, Ricky",30,11,9,19,0,0,0,2
Adelaide,"Jacobs, Sam",10,6,2,4,0,0,52,1
Adelaide,"Jenkins, Josh",13,9,9,4,1,1,3,1
Adelaide,"Knight, Riley",7,3,4,4,0,0,0,3
Adelaide,"Laird, Rory",26,12,7,14,0,0,0,1
Adelaide,"Lever, Jake",6,4,4,2,0,0,0,2
Adelaide,"Lynch, Tom",17,14,7,3,2,1,0,1
Adelaide,"Lyons, Jarryd",11,3,0,8,0,0,0,2
Adelaide,"Sloane, Rory",20,11,5,9,1,0,1,7
Adelaide,"Smith, Brodie",9,9,2,0,1,0,0,0
Adelaide,"Talia, Daniel",10,7,4,3,0,0,0,0
Adelaide,"Thompson, Scott",23,8,3,15,1,0,0,6
Adelaide,"Walker, Taylor",13,10,7,3,1,1,0,0
Adelaide,"van Berlo, Nathan",19,13,7,6,0,0,0,4
Adelaide,"Atkins, Rory",7,3,1,4,0,0,0,1
Adelaide,"Betts, Eddie",12,9,4,3,5,1,0,0
Adelaide,"Brown, Luke",14,9,2,5,0,1,0,3
Adelaide,"Cameron, Charlie",12,11,3,1,2,2,0,4
Adelaide,"Cheney, Kyle",7,4,1,3,0,0,0,0
Adelaide,"Crouch, Matt",18,9,3,9,0,1,0,2
Adelaide,"Dangerfield, Patrick",26,17,6,9,0,0,1,5
Adelaide,"Douglas, Richard",20,11,3,9,0,0,0,3
Adelaide,"Hartigan, Kyle",8,5,4,3,0,0,0,1
Adelaide,"Henderson, Ricky",29,13,4,16,1,0,0,3
Adelaide,"Jacobs, Sam",15,10,3,5,0,1,39,4
Adelaide,"Jenkins, Josh",9,4,3,5,0,0,1,1
Adelaide,"Knight, Riley",15,8,2,7,2,0,0,1
Adelaide,"Laird, Rory",22,14,3,8,0,0,0,4
Adelaide,"Lynch, Tom",15,7,3,8,1,1,0,3
Adelaide,"Mackay, David",6,2,0,4,0,0,0,1
Adelaide,"Sloane, Rory",20,9,2,11,1,0,1,5
Adelaide,"Smith, Brodie",18,13,2,5,0,0,0,4
Adelaide,"Talia, Daniel",10,7,4,3,0,0,0,1
Adelaide,"Thompson, Scott",26,12,2,14,1,0,0,4
Adelaide,"Walker, Taylor",16,11,10,5,3,2,0,1
Adelaide,"van Berlo, Nathan",18,9,3,9,0,0,0,2
Adelaide,"Betts, Eddie",9,4,0,5,0,0,0,5
Adelaide,"Brown, Luke",18,9,3,9,0,0,0,2
Adelaide,"Cameron, Charlie",5,2,1,3,0,1,0,6
Adelaide,"Cheney, Kyle",11,10,3,1,0,0,0,1
Adelaide,"Crouch, Matt",24,9,1,15,0,0,0,2
Adelaide,"Dangerfield, Patrick",29,10,5,19,1,0,4,4
Adelaide,"Douglas, Richard",16,8,2,8,0,0,0,2
Adelaide,"Hartigan, Kyle",10,7,3,3,0,0,0,0
Adelaide,"Henderson, Ricky",9,5,0,4,0,0,0,3
Adelaide,"Jacobs, Sam",17,12,6,5,0,1,41,4
Adelaide,"Jenkins, Josh",10,9,5,1,4,1,2,4
Adelaide,"Knight, Riley",13,4,1,9,0,2,0,2
Adelaide,"Laird, Rory",30,16,8,14,0,0,0,0
Adelaide,"Lynch, Tom",16,10,7,6,2,0,0,0
Adelaide,"Lyons, Jarryd",8,6,1,2,0,0,0,2
Adelaide,"Mackay, David",9,3,0,6,0,0,0,2
Adelaide,"Sloane, Rory",24,9,1,15,0,0,0,2
Adelaide,"Smith, Brodie",13,5,2,8,0,0,0,2
Adelaide,"Talia, Daniel",12,5,4,7,0,0,0,4
Adelaide,"Thompson, Scott",28,11,6,17,0,1,0,8
Adelaide,"Walker, Taylor",10,9,6,1,1,3,0,0
Adelaide,"van Berlo, Nathan",17,9,4,8,0,0,0,1
Brisbane Lions,"Adcock, Jed",17,10,4,7,1,0,0,3
Brisbane Lions,"Aish, James",13,7,1,6,0,0,0,2
Brisbane Lions,"Beams, Claye",22,17,3,5,0,1,0,1
Brisbane Lions,"Beams, Dayne",33,7,2,26,0,0,0,2
Brisbane Lions,"Bewick, Rohan",13,9,3,4,0,0,0,2
Brisbane Lions,"Christensen, Allen",17,14,7,3,2,0,0,5
Brisbane Lions,"Clarke, Justin",13,7,4,6,0,0,0,1
Brisbane Lions,"Green, Josh",14,10,5,4,2,3,0,3
Brisbane Lions,"Lester, Ryan",11,7,5,4,0,0,0,0
Brisbane Lions,"Leuenberger, Matthew",10,6,2,4,1,0,25,3
Brisbane Lions,"Martin, Stefan",12,8,4,4,0,0,21,6
Brisbane Lions,"Mayes, Sam",4,4,3,0,0,0,0,3
Brisbane Lions,"McGrath, Jaden",14,7,5,7,0,0,0,2
Brisbane Lions,"McStay, Daniel",9,4,3,5,1,1,0,1
Brisbane Lions,"Merrett, Daniel",15,10,4,5,0,0,0,1
Brisbane Lions,"Paparone, Marco",17,12,6,5,0,0,0,4
Brisbane Lions,"Redden, Jack",20,11,4,9,0,0,1,5
Brisbane Lions,"Rich, Daniel",29,18,3,11,2,0,0,4
Brisbane Lions,"Robinson, Mitch",20,10,4,10,0,1,0,7
Brisbane Lions,"Rockliff, Tom",18,13,6,5,0,0,0,3
Brisbane Lions,"Taylor, Lewis",19,8,3,11,1,0,0,5
Brisbane Lions,"Zorko, Dayne",24,16,6,8,1,0,0,5
Brisbane Lions,"Adcock, Jed",16,12,6,4,2,0,0,3
Brisbane Lions,"Beams, Claye",5,3,1,2,0,0,0,3
Brisbane Lions,"Beams, Dayne",20,9,1,11,0,0,0,2
Brisbane Lions,"Bewick, Rohan",11,2,1,9,0,0,0,5
Brisbane Lions,"Christensen, Allen",22,12,3,10,1,0,0,1
Brisbane Lions,"Clarke, Justin",13,6,4,7,0,0,0,1
Brisbane Lions,"Close, Michael",2,2,0,0,0,0,0,1
Brisbane Lions,"Green, Josh",11,5,4,6,1,1,0,2
Brisbane Lions,"Lester, Ryan",11,5,6,6,0,0,0,1
Brisbane Lions,"Leuenberger, Matthew",6,5,2,1,0,0,8,1
Brisbane Lions,"Maguire, Matt",8,5,2,3,0,0,0,5
Brisbane Lions,"Martin, Stefan",19,11,6,8,1,0,22,2
Brisbane Lions,"Mayes, Sam",8,7,6,1,0,1,0,0
Brisbane Lions,"McGrath, Jaden",8,4,0,4,0,0,0,2
Brisbane Lions,"McStay, Daniel",10,5,3,5,1,0,0,1
Brisbane Lions,"OBrien, Zac",14,11,3,3,0,0,0,7
Brisbane Lions,"Paparone, Marco",16,8,2,8,0,0,0,3
Brisbane Lions,"Redden, Jack",28,14,8,14,0,0,2,2
Brisbane Lions,"Rich, Daniel",16,10,3,6,0,0,0,7
Brisbane Lions,"Robinson, Mitch",25,11,6,14,0,1,0,2
Brisbane Lions,"Taylor, Lewis",20,12,6,8,1,0,0,1
Brisbane Lions,"Zorko, Dayne",16,9,5,7,0,2,0,3
Brisbane Lions,"Adcock, Jed",15,6,3,9,0,0,0,1
Brisbane Lions,"Aish, James",21,10,3,11,1,0,0,5
Brisbane Lions,"Andrews, Harris",9,3,2,6,1,0,13,1
Brisbane Lions,"Beams, Claye",20,10,4,10,0,0,0,2
Brisbane Lions,"Beams, Dayne",35,20,2,15,0,0,0,7
Brisbane Lions,"Bewick, Rohan",21,12,5,9,0,0,0,5
Brisbane Lions,"Christensen, Allen",18,9,3,9,1,1,0,5
Brisbane Lions,"Clarke, Justin",9,3,4,6,0,1,0,1
Brisbane Lions,"Gardiner, Darcy",9,3,1,6,0,0,0,0
Brisbane Lions,"Green, Josh",12,5,2,7,1,0,0,4
Brisbane Lions,"Maguire, Matt",9,7,2,2,0,0,0,2
Brisbane Lions,"Martin, Stefan",20,13,5,7,0,1,34,2
Brisbane Lions,"Mayes, Sam",11,7,3,4,0,1,0,3
Brisbane Lions,"McGrath, Jaden",13,5,3,8,0,1,0,2
Brisbane Lions,"McStay, Daniel",6,2,1,4,1,0,0,0
Brisbane Lions,"Paparone, Marco",20,13,7,7,1,0,0,0
Brisbane Lions,"Redden, Jack",12,11,3,1,0,0,0,3
Brisbane Lions,"Rich, Daniel",23,11,4,12,0,0,0,3
Brisbane Lions,"Robinson, Mitch",14,7,1,7,0,0,1,4
Brisbane Lions,"Staker, Brent",4,3,1,1,0,2,0,4
Brisbane Lions,"Taylor, Lewis",7,2,1,5,0,1,0,1
Brisbane Lions,"Zorko, Dayne",27,11,6,16,2,0,0,3
Brisbane Lions,"Adcock, Jed",20,6,4,14,0,1,0,5
Brisbane Lions,"Aish, James",6,2,0,4,0,0,0,0
Brisbane Lions,"Andrews, Harris",5,2,1,3,1,0,3,2
Brisbane Lions,"Beams, Claye",16,9,5,7,0,1,0,3
Brisbane Lions,"Beams, Dayne",21,14,4,7,1,1,0,4
Brisbane Lions,"Bewick, Rohan",17,5,6,12,0,1,0,4
Brisbane Lions,"Christensen, Allen",14,9,1,5,1,0,0,2
Brisbane Lions,"Clarke, Justin",11,7,7,4,0,0,0,1
Brisbane Lions,"Cutler, Tom",32,20,5,12,0,0,0,2
Brisbane Lions,"Gardiner, Darcy",12,8,5,4,0,0,0,3
Brisbane Lions,"Golby, Mitch",25,10,4,15,0,0,0,3
Brisbane Lions,"Green, Josh",4,3,2,1,2,0,0,0
Brisbane Lions,"Martin, Stefan",20,10,5,10,1,0,36,4
Brisbane Lions,"McStay, Daniel",11,6,7,5,1,2,0,0
Brisbane Lions,"Paparone, Marco",21,16,6,5,0,0,0,2
Brisbane Lions,"Redden, Jack",19,11,3,8,0,0,0,6
Brisbane Lions,"Rich, Daniel",20,9,2,11,2,0,0,3
Brisbane Lions,"Robertson, Nick",19,11,6,8,0,0,0,2
Brisbane Lions,"Robinson, Mitch",11,6,3,5,0,0,0,10
Brisbane Lions,"Rockliff, Tom",16,5,4,11,0,0,0,5
Brisbane Lions,"Taylor, Lewis",20,11,8,9,0,2,0,2
Brisbane Lions,"Zorko, Dayne",20,9,3,11,0,2,0,4
Brisbane Lions,"Adcock, Jed",16,7,6,9,0,0,0,4
Brisbane Lions,"Andrews, Harris",8,4,3,4,1,1,4,1
Brisbane Lions,"Beams, Claye",18,9,4,9,0,0,0,1
Brisbane Lions,"Beams, Dayne",31,19,6,12,2,1,0,3
Brisbane Lions,"Bewick, Rohan",16,8,3,8,0,0,0,3
Brisbane Lions,"Christensen, Allen",25,15,5,10,0,1,0,1
Brisbane Lions,"Clarke, Justin",12,6,4,6,0,0,0,4
Brisbane Lions,"Cutler, Tom",12,8,4,4,0,0,0,5
Brisbane Lions,"Gardiner, Darcy",10,4,3,6,0,0,0,2
Brisbane Lions,"Golby, Mitch",22,12,2,10,0,0,0,6
Brisbane Lions,"Green, Josh",13,9,1,4,0,1,0,2
Brisbane Lions,"Martin, Stefan",24,10,4,14,0,0,42,2
Brisbane Lions,"McStay, Daniel",7,3,4,4,1,0,0,4
Brisbane Lions,"Paparone, Marco",22,13,8,9,0,0,0,1
Brisbane Lions,"Redden, Jack",33,17,9,16,0,0,1,5
Brisbane Lions,"Rich, Daniel",22,11,0,11,1,0,0,4
Brisbane Lions,"Robertson, Nick",24,13,10,11,0,1,0,2
Brisbane Lions,"Robinson, Mitch",28,18,6,10,0,1,3,2
Brisbane Lions,"Rockliff, Tom",0,0,0,0,0,0,0,0
Brisbane Lions,"Staker, Brent",3,0,1,3,0,0,0,2
Brisbane Lions,"Taylor, Lewis",16,10,3,6,0,1,0,1
Brisbane Lions,"Zorko, Dayne",22,15,7,7,2,0,0,7
Brisbane Lions,"Adcock, Jed",13,7,3,6,0,0,0,1
Brisbane Lions,"Andrews, Harris",10,7,7,3,0,0,0,2
Brisbane Lions,"Beams, Claye",18,11,4,7,0,0,0,1
Brisbane Lions,"Beams, Dayne",29,13,4,16,0,1,0,2
Brisbane Lions,"Christensen, Allen",22,12,3,10,1,1,0,4
Brisbane Lions,"Clarke, Justin",3,2,1,1,0,0,0,0
Brisbane Lions,"Cutler, Tom",3,3,2,0,0,1,0,0
Brisbane Lions,"Gardiner, Darcy",7,3,1,4,0,0,0,3
Brisbane Lions,"Golby, Mitch",12,9,3,3,0,0,0,3
Brisbane Lions,"Green, Josh",7,5,2,2,3,1,0,4
Brisbane Lions,"Lester, Ryan",13,8,3,5,1,1,0,4
Brisbane Lions,"Leuenberger, Matthew",4,3,2,1,1,0,9,1
Brisbane Lions,"Martin, Stefan",19,13,5,6,0,1,38,2
Brisbane Lions,"McStay, Daniel",13,8,6,5,4,1,0,2
Brisbane Lions,"Paparone, Marco",12,6,6,6,0,0,0,2
Brisbane Lions,"Redden, Jack",23,14,3,9,0,0,1,10
Brisbane Lions,"Rich, Daniel",8,6,2,2,0,0,0,4
Brisbane Lions,"Robertson, Nick",11,5,0,6,0,0,0,2
Brisbane Lions,"Robinson, Mitch",16,11,7,5,0,0,2,4
Brisbane Lions,"Rockliff, Tom",19,9,2,10,1,0,0,9
Brisbane Lions,"Taylor, Lewis",22,11,4,11,1,1,0,1
Brisbane Lions,"Zorko, Dayne",11,5,2,6,0,0,0,3
Brisbane Lions,"Adcock, Jed",11,7,1,4,1,0,0,2
Brisbane Lions,"Aish, James",18,14,5,4,0,0,0,3
Brisbane Lions,"Andrews, Harris",12,7,5,5,0,0,0,1
Brisbane Lions,"Beams, Dayne",32,16,6,16,1,1,0,4
Brisbane Lions,"Christensen, Allen",13,10,1,3,2,0,0,2
Brisbane Lions,"Clarke, Justin",7,4,2,3,0,0,0,0
Brisbane Lions,"Cutler, Tom",11,7,0,4,0,0,0,2
Brisbane Lions,"Gardiner, Darcy",8,4,1,4,0,0,0,2
Brisbane Lions,"Golby, Mitch",1,0,0,1,0,0,0,1
Brisbane Lions,"Green, Josh",15,9,3,6,3,1,0,3
Brisbane Lions,"Lester, Ryan",15,8,1,7,1,0,3,2
Brisbane Lions,"Leuenberger, Matthew",10,7,4,3,1,1,15,0
Brisbane Lions,"Martin, Stefan",24,17,2,7,0,1,27,0
Brisbane Lions,"McStay, Daniel",2,2,2,0,1,0,0,0
Brisbane Lions,"Paparone, Marco",17,11,6,6,0,0,0,2
Brisbane Lions,"Redden, Jack",16,5,2,11,0,0,4,8
Brisbane Lions,"Rich, Daniel",23,16,2,7,1,2,0,3
Brisbane Lions,"Robertson, Nick",21,11,3,10,0,1,0,2
Brisbane Lions,"Robinson, Mitch",16,9,2,7,3,0,2,3
Brisbane Lions,"Rockliff, Tom",19,11,2,8,0,1,0,9
Brisbane Lions,"Taylor, Lewis",28,14,4,14,1,0,0,1
Brisbane Lions,"Zorko, Dayne",17,12,3,5,0,2,0,6
Brisbane Lions,"Adcock, Jed",9,7,3,2,0,0,0,3
Brisbane Lions,"Aish, James",9,7,0,2,0,0,0,1
Brisbane Lions,"Andrews, Harris",5,4,2,1,0,0,1,3
Brisbane Lions,"Beams, Claye",17,8,3,9,0,0,0,2
Brisbane Lions,"Beams, Dayne",20,12,3,8,1,0,0,4
Brisbane Lions,"Christensen, Allen",15,6,3,9,0,1,0,3
Brisbane Lions,"Clarke, Justin",9,7,4,2,0,0,0,1
Brisbane Lions,"Dawson, Liam",3,3,3,0,1,0,0,1
Brisbane Lions,"Gardiner, Darcy",10,5,4,5,1,0,0,1
Brisbane Lions,"Golby, Mitch",4,4,1,0,0,0,0,3
Brisbane Lions,"Green, Josh",10,9,3,1,3,1,0,1
Brisbane Lions,"Lester, Ryan",16,9,4,7,2,0,0,1
Brisbane Lions,"Leuenberger, Matthew",4,1,0,3,0,0,5,2
Brisbane Lions,"Martin, Stefan",18,11,5,7,1,1,27,1
Brisbane Lions,"McStay, Daniel",8,6,4,2,0,0,0,1
Brisbane Lions,"Paparone, Marco",22,14,6,8,0,0,0,2
Brisbane Lions,"Rich, Daniel",16,7,2,9,1,0,0,5
Brisbane Lions,"Robertson, Nick",9,7,2,2,1,0,0,3
Brisbane Lions,"Robinson, Mitch",17,10,6,7,0,0,1,3
Brisbane Lions,"Rockliff, Tom",27,13,6,14,0,0,0,10
Brisbane Lions,"Taylor, Lewis",13,8,3,5,1,0,0,1
Brisbane Lions,"Zorko, Dayne",15,10,2,5,0,1,0,2
Brisbane Lions,"Adcock, Jed",13,7,6,6,0,0,0,0
Brisbane Lions,"Aish, James",19,9,3,10,0,0,0,1
Brisbane Lions,"Andrews, Harris",11,9,5,2,0,0,0,1
Brisbane Lions,"Beams, Claye",5,2,3,3,0,0,0,1
Brisbane Lions,"Beams, Dayne",38,19,10,19,0,2,0,7
Brisbane Lions,"Bewick, Rohan",16,10,7,6,1,0,0,0
Brisbane Lions,"Christensen, Allen",21,16,9,5,1,1,0,1
Brisbane Lions,"Clarke, Justin",13,5,2,8,0,0,0,2
Brisbane Lions,"Dawson, Liam",6,6,5,0,0,0,0,0
Brisbane Lions,"Green, Josh",8,3,1,5,1,0,0,7
Brisbane Lions,"Harwood, Ryan",6,2,1,4,0,0,0,0
Brisbane Lions,"Lester, Ryan",23,10,8,13,4,0,0,0
Brisbane Lions,"Leuenberger, Matthew",12,4,3,8,0,0,13,0
Brisbane Lions,"Martin, Stefan",25,14,4,11,0,1,31,1
Brisbane Lions,"OBrien, Zac",18,8,3,10,0,0,0,6
Brisbane Lions,"Paparone, Marco",18,10,5,8,0,0,0,0
Brisbane Lions,"Rich, Daniel",18,12,4,6,2,1,0,2
Brisbane Lions,"Robertson, Nick",22,8,5,14,1,0,0,1
Brisbane Lions,"Robinson, Mitch",8,7,2,1,1,0,0,2
Brisbane Lions,"Rockliff, Tom",26,8,4,18,1,0,0,3
Brisbane Lions,"Taylor, Lewis",32,17,8,15,0,1,0,1
Brisbane Lions,"Zorko, Dayne",20,16,6,4,1,1,0,4
Brisbane Lions,"Andrews, Harris",7,4,1,3,0,1,1,1
Brisbane Lions,"Beams, Dayne",29,14,9,15,3,2,0,3
Brisbane Lions,"Beasley, Hugh",9,2,2,7,0,0,0,1
Brisbane Lions,"Bewick, Rohan",9,5,4,4,3,0,0,2
Brisbane Lions,"Bourke, Jordon",15,11,5,4,0,0,0,1
Brisbane Lions,"Christensen, Allen",31,20,4,11,0,0,0,4
Brisbane Lions,"Clarke, Justin",7,4,5,3,0,0,0,1
Brisbane Lions,"Cutler, Tom",19,11,6,8,0,0,0,0
Brisbane Lions,"Dawson, Liam",3,1,0,2,0,0,0,0
Brisbane Lions,"Green, Josh",11,5,2,6,1,0,0,2
Brisbane Lions,"Hanley, Pearce",21,17,6,4,0,0,0,5
Brisbane Lions,"Lester, Ryan",9,4,3,5,0,1,4,6
Brisbane Lions,"Leuenberger, Matthew",5,1,1,4,0,1,6,1
Brisbane Lions,"Martin, Stefan",15,12,7,3,0,0,38,4
Brisbane Lions,"Mayes, Sam",13,5,5,8,0,0,0,4
Brisbane Lions,"OBrien, Zac",20,13,6,7,0,0,0,7
Brisbane Lions,"Paparone, Marco",25,18,11,7,0,0,0,1
Brisbane Lions,"Rich, Daniel",15,9,4,6,0,0,0,5
Brisbane Lions,"Robertson, Nick",15,10,5,5,1,0,0,1
Brisbane Lions,"Robinson, Mitch",21,10,5,11,0,1,0,4
Brisbane Lions,"Taylor, Lewis",31,16,6,15,0,0,0,0
Brisbane Lions,"Zorko, Dayne",18,11,5,7,2,0,0,2
Brisbane Lions,"Adcock, Jed",10,8,6,2,0,0,0,4
Brisbane Lions,"Beams, Dayne",28,13,7,15,0,0,0,3
Brisbane Lions,"Beasley, Hugh",10,4,3,6,0,0,0,3
Brisbane Lions,"Bewick, Rohan",9,8,6,1,2,1,0,2
Brisbane Lions,"Bourke, Jordon",16,10,8,6,0,0,0,4
Brisbane Lions,"Christensen, Allen",24,18,8,6,1,1,0,4
Brisbane Lions,"Clarke, Justin",12,8,10,4,0,0,0,3
Brisbane Lions,"Cutler, Tom",13,6,2,7,0,0,0,2
Brisbane Lions,"Green, Josh",14,7,1,7,1,1,0,5
Brisbane Lions,"Hanley, Pearce",22,15,8,7,1,2,0,1
Brisbane Lions,"Lester, Ryan",12,4,5,8,0,0,0,2
Brisbane Lions,"Leuenberger, Matthew",5,1,2,4,0,0,10,1
Brisbane Lions,"Martin, Stefan",16,9,6,7,0,0,39,0
Brisbane Lions,"McStay, Daniel",7,6,5,1,3,1,0,0
Brisbane Lions,"OBrien, Zac",12,9,3,3,0,0,0,10
Brisbane Lions,"Paparone, Marco",16,14,7,2,0,0,0,3
Brisbane Lions,"Redden, Jack",20,10,8,10,0,0,1,4
Brisbane Lions,"Rich, Daniel",12,6,1,6,0,0,0,6
Brisbane Lions,"Robertson, Nick",3,2,2,1,1,0,0,0
Brisbane Lions,"Robinson, Mitch",15,6,2,9,0,0,3,5
Brisbane Lions,"Taylor, Lewis",26,18,8,8,1,0,0,3
Brisbane Lions,"Zorko, Dayne",19,10,2,9,1,0,0,2
Brisbane Lions,"Adcock, Jed",11,5,5,6,0,1,0,4
Brisbane Lions,"Aish, James",13,5,3,8,0,0,0,1
Brisbane Lions,"Andrews, Harris",12,6,4,6,0,0,0,2
Brisbane Lions,"Beams, Dayne",31,17,4,14,0,0,0,4
Brisbane Lions,"Beasley, Hugh",13,8,4,5,0,0,0,3
Brisbane Lions,"Bewick, Rohan",8,3,1,5,0,0,0,3
Brisbane Lions,"Bourke, Jordon",7,4,3,3,2,0,0,0
Brisbane Lions,"Christensen, Allen",15,9,4,6,1,0,0,9
Brisbane Lions,"Clarke, Justin",16,9,5,7,0,0,0,1
Brisbane Lions,"Cutler, Tom",3,1,0,2,0,0,0,0
Brisbane Lions,"Green, Josh",18,11,3,7,0,0,0,6
Brisbane Lions,"Hanley, Pearce",13,10,2,3,1,0,0,3
Brisbane Lions,"Harwood, Ryan",15,9,3,6,0,1,0,3
Brisbane Lions,"Leuenberger, Matthew",11,4,6,7,2,1,26,1
Brisbane Lions,"Martin, Stefan",25,14,9,11,0,1,27,5
Brisbane Lions,"McStay, Daniel",4,4,3,0,0,1,0,3
Brisbane Lions,"Paparone, Marco",16,10,5,6,0,0,0,0
Brisbane Lions,"Redden, Jack",26,15,5,11,1,0,1,7
Brisbane Lions,"Rich, Daniel",23,15,3,8,0,1,0,0
Brisbane Lions,"Robinson, Mitch",25,12,4,13,1,1,1,3
Brisbane Lions,"Taylor, Lewis",27,15,5,12,1,1,0,1
Brisbane Lions,"Zorko, Dayne",27,14,7,13,1,0,0,1
Brisbane Lions,"Adcock, Jed",12,8,6,4,0,1,0,6
Brisbane Lions,"Aish, James",13,11,2,2,0,0,0,5
Brisbane Lions,"Andrews, Harris",9,5,6,4,0,0,1,2
Brisbane Lions,"Beams, Dayne",30,18,4,12,0,1,0,11
Brisbane Lions,"Beasley, Hugh",12,7,2,5,0,0,0,5
Brisbane Lions,"Bewick, Rohan",12,9,3,3,1,1,0,8
Brisbane Lions,"Bourke, Jordon",6,3,1,3,0,0,2,2
Brisbane Lions,"Christensen, Allen",18,12,3,6,0,0,0,5
Brisbane Lions,"Clarke, Justin",10,8,3,2,0,0,1,1
Brisbane Lions,"Gardiner, Darcy",14,9,3,5,0,0,0,3
Brisbane Lions,"Green, Josh",17,12,1,5,1,0,0,11
Brisbane Lions,"Lester, Ryan",10,5,3,5,0,0,1,5
Brisbane Lions,"Leuenberger, Matthew",7,4,1,3,2,0,51,9
Brisbane Lions,"Mayes, Sam",4,1,2,3,0,0,0,2
Brisbane Lions,"McStay, Daniel",8,3,3,5,1,1,0,1
Brisbane Lions,"Paparone, Marco",12,9,3,3,0,0,0,0
Brisbane Lions,"Redden, Jack",20,13,3,7,0,0,0,13
Brisbane Lions,"Rich, Daniel",20,16,2,4,0,0,0,3
Brisbane Lions,"Robinson, Mitch",16,13,1,3,1,0,0,14
Brisbane Lions,"Staker, Brent",7,4,2,3,0,0,0,2
Brisbane Lions,"Taylor, Lewis",17,6,3,11,1,0,0,4
Brisbane Lions,"Zorko, Dayne",22,17,4,5,0,0,0,9
Brisbane Lions,"Adcock, Jed",8,4,2,4,1,0,0,4
Brisbane Lions,"Aish, James",17,5,3,12,0,0,0,1
Brisbane Lions,"Andrews, Harris",9,3,3,6,0,0,0,2
Brisbane Lions,"Beams, Dayne",32,18,8,14,2,0,0,3
Brisbane Lions,"Bewick, Rohan",8,5,3,3,0,1,0,3
Brisbane Lions,"Bourke, Jordon",6,3,3,3,0,0,5,0
Brisbane Lions,"Christensen, Allen",19,8,5,11,0,1,0,0
Brisbane Lions,"Clarke, Justin",14,7,7,7,0,0,0,0
Brisbane Lions,"Gardiner, Darcy",6,6,4,0,0,0,0,2
Brisbane Lions,"Hanley, Pearce",33,19,6,14,1,0,2,3
Brisbane Lions,"Leuenberger, Matthew",11,5,1,6,0,0,42,4
Brisbane Lions,"Mayes, Sam",17,13,9,4,0,1,0,1
Brisbane Lions,"McStay, Daniel",6,4,2,2,0,0,0,1
Brisbane Lions,"Merrett, Daniel",13,7,5,6,0,0,0,0
Brisbane Lions,"Paparone, Marco",25,16,9,9,0,1,0,2
Brisbane Lions,"Redden, Jack",24,12,2,12,0,0,4,8
Brisbane Lions,"Rich, Daniel",18,11,3,7,0,0,0,1
Brisbane Lions,"Robertson, Nick",21,11,8,10,0,0,0,3
Brisbane Lions,"Rockliff, Tom",27,15,5,12,0,0,0,11
Brisbane Lions,"Staker, Brent",11,8,5,3,0,3,0,0
Brisbane Lions,"Taylor, Lewis",15,6,2,9,0,0,0,1
Brisbane Lions,"Zorko, Dayne",30,20,6,10,3,0,0,3
Brisbane Lions,"Adcock, Jed",12,8,7,4,0,1,0,5
Brisbane Lions,"Aish, James",12,6,2,6,0,1,0,4
Brisbane Lions,"Andrews, Harris",16,10,10,6,1,0,0,1
Brisbane Lions,"Beams, Dayne",25,13,0,12,0,1,0,4
Brisbane Lions,"Christensen, Allen",29,20,5,9,1,0,0,4
Brisbane Lions,"Clarke, Justin",10,5,9,5,0,1,0,3
Brisbane Lions,"Hanley, Pearce",6,3,1,3,0,1,0,3
Brisbane Lions,"Harwood, Ryan",13,11,4,2,0,0,0,4
Brisbane Lions,"Leuenberger, Matthew",6,2,3,4,0,1,26,2
Brisbane Lions,"Martin, Stefan",18,5,9,13,0,0,18,1
Brisbane Lions,"Mayes, Sam",14,11,8,3,0,0,0,1
Brisbane Lions,"McStay, Daniel",5,2,3,3,0,0,0,2
Brisbane Lions,"Merrett, Daniel",7,5,6,2,0,0,0,1
Brisbane Lions,"Paparone, Marco",24,19,11,5,0,0,0,2
Brisbane Lions,"Redden, Jack",25,13,7,12,0,0,0,6
Brisbane Lions,"Rich, Daniel",16,9,4,7,0,1,0,3
Brisbane Lions,"Robertson, Nick",17,12,7,5,0,0,0,0
Brisbane Lions,"Robinson, Mitch",13,6,3,7,1,1,0,12
Brisbane Lions,"Rockliff, Tom",14,9,2,5,0,0,0,17
Brisbane Lions,"Staker, Brent",9,8,3,1,0,1,0,4
Brisbane Lions,"Taylor, Lewis",32,14,5,18,0,1,0,3
Brisbane Lions,"Zorko, Dayne",30,19,4,11,1,1,0,6
Brisbane Lions,"Adcock, Jed",6,6,3,0,0,2,0,4
Brisbane Lions,"Aish, James",16,10,2,6,1,0,0,6
Brisbane Lions,"Andrews, Harris",15,6,6,9,0,0,1,3
Brisbane Lions,"Beasley, Hugh",6,2,3,4,0,0,0,2
Brisbane Lions,"Bewick, Rohan",12,8,6,4,2,1,0,1
Brisbane Lions,"Christensen, Allen",19,10,3,9,0,0,0,1
Brisbane Lions,"Clarke, Justin",11,7,4,4,0,0,0,2
Brisbane Lions,"Dawson, Liam",14,9,5,5,0,0,0,2
Brisbane Lions,"Leuenberger, Matthew",14,5,2,9,0,0,33,6
Brisbane Lions,"Martin, Stefan",23,12,8,11,1,0,23,0
Brisbane Lions,"Mayes, Sam",21,9,7,12,0,0,0,4
Brisbane Lions,"McStay, Daniel",2,2,2,0,0,0,0,0
Brisbane Lions,"Merrett, Daniel",13,9,6,4,0,0,0,0
Brisbane Lions,"Paparone, Marco",14,13,6,1,0,0,0,2
Brisbane Lions,"Redden, Jack",29,19,8,10,0,1,1,4
Brisbane Lions,"Rich, Daniel",15,10,3,5,0,0,0,2
Brisbane Lions,"Robertson, Nick",6,4,2,2,0,0,0,2
Brisbane Lions,"Robinson, Mitch",26,10,4,16,0,1,2,10
Brisbane Lions,"Rockliff, Tom",16,9,0,7,0,0,0,6
Brisbane Lions,"Staker, Brent",13,6,5,7,0,0,0,0
Brisbane Lions,"Taylor, Lewis",28,11,4,17,1,1,0,1
Brisbane Lions,"Zorko, Dayne",23,13,3,10,0,1,0,4
Brisbane Lions,"Adcock, Jed",14,10,9,4,4,1,0,4
Brisbane Lions,"Andrews, Harris",22,12,12,10,0,0,0,0
Brisbane Lions,"Beams, Dayne",17,10,2,7,0,1,0,4
Brisbane Lions,"Bewick, Rohan",13,8,5,5,1,1,0,1
Brisbane Lions,"Christensen, Allen",12,9,0,3,0,2,0,8
Brisbane Lions,"Clarke, Justin",14,7,6,7,0,0,0,1
Brisbane Lions,"Dawson, Liam",19,15,9,4,0,0,0,0
Brisbane Lions,"Freeman, Jonathan",6,4,5,2,1,1,0,0
Brisbane Lions,"Hanley, Pearce",17,9,6,8,0,0,0,5
Brisbane Lions,"Leuenberger, Matthew",1,1,0,0,0,0,6,0
Brisbane Lions,"Martin, Stefan",24,12,10,12,0,0,38,1
Brisbane Lions,"Mayes, Sam",15,6,5,9,0,0,0,2
Brisbane Lions,"McStay, Daniel",5,3,3,2,0,1,0,1
Brisbane Lions,"Merrett, Daniel",8,8,5,0,0,0,0,2
Brisbane Lions,"Paparone, Marco",17,10,7,7,0,0,0,2
Brisbane Lions,"Redden, Jack",22,13,5,9,0,0,2,3
Brisbane Lions,"Rich, Daniel",19,11,3,8,0,0,0,1
Brisbane Lions,"Robertson, Nick",5,1,0,4,0,0,0,1
Brisbane Lions,"Robinson, Mitch",31,15,9,16,0,0,0,5
Brisbane Lions,"Rockliff, Tom",30,15,4,15,0,0,0,9
Brisbane Lions,"Taylor, Lewis",15,9,4,6,2,0,0,1
Brisbane Lions,"Zorko, Dayne",16,8,1,8,0,1,0,5
Brisbane Lions,"Adcock, Jed",9,5,0,4,1,1,0,2
Brisbane Lions,"Andrews, Harris",19,9,7,10,0,0,0,1
Brisbane Lions,"Bewick, Rohan",13,6,4,7,0,1,0,3
Brisbane Lions,"Christensen, Allen",29,13,6,16,1,1,0,2
Brisbane Lions,"Clarke, Justin",15,6,5,9,0,0,0,1
Brisbane Lions,"Dawson, Liam",17,10,6,7,0,0,0,1
Brisbane Lions,"Evans, Billy",12,0,0,12,0,0,0,1
Brisbane Lions,"Freeman, Jonathan",4,1,1,3,0,0,0,0
Brisbane Lions,"Hanley, Pearce",31,20,6,11,1,2,0,2
Brisbane Lions,"Martin, Stefan",24,11,11,13,0,0,40,1
Brisbane Lions,"Mayes, Sam",22,13,4,9,0,0,0,3
Brisbane Lions,"McGuane, Luke",12,8,5,4,3,3,3,1
Brisbane Lions,"McStay, Daniel",21,10,5,11,2,0,0,2
Brisbane Lions,"Merrett, Daniel",16,9,8,7,0,0,0,0
Brisbane Lions,"OBrien, Zac",6,3,0,3,0,0,0,0
Brisbane Lions,"Paparone, Marco",20,10,7,10,0,1,0,1
Brisbane Lions,"Redden, Jack",26,14,5,12,0,0,1,5
Brisbane Lions,"Rich, Daniel",26,16,6,10,0,1,0,1
Brisbane Lions,"Robinson, Mitch",24,14,3,10,1,0,2,11
Brisbane Lions,"Rockliff, Tom",32,7,8,25,1,0,0,7
Brisbane Lions,"Taylor, Lewis",16,11,2,5,3,1,0,1
Brisbane Lions,"Zorko, Dayne",29,18,6,11,1,0,0,5
Brisbane Lions,"Adcock, Jed",13,5,4,8,1,0,0,1
Brisbane Lions,"Andrews, Harris",16,8,6,8,0,0,0,3
Brisbane Lions,"Christensen, Allen",20,11,2,9,3,1,0,1
Brisbane Lions,"Cutler, Tom",24,18,8,6,1,1,0,0
Brisbane Lions,"Dawson, Liam",18,11,5,7,0,0,0,2
Brisbane Lions,"Evans, Billy",7,2,1,5,0,0,0,0
Brisbane Lions,"Freeman, Jonathan",10,6,6,4,3,1,0,1
Brisbane Lions,"Hanley, Pearce",14,10,6,4,2,0,0,2
Brisbane Lions,"Martin, Stefan",23,12,7,11,0,1,31,4
Brisbane Lions,"Mayes, Sam",20,9,6,11,2,1,0,0
Brisbane Lions,"McGuane, Luke",11,6,3,5,2,0,2,2
Brisbane Lions,"McStay, Daniel",15,9,6,6,0,0,0,1
Brisbane Lions,"Merrett, Daniel",10,5,2,5,0,0,0,0
Brisbane Lions,"OBrien, Zac",21,6,1,15,0,0,0,3
Brisbane Lions,"Paparone, Marco",24,12,7,12,0,0,0,0
Brisbane Lions,"Redden, Jack",31,10,5,21,1,0,1,7
Brisbane Lions,"Rich, Daniel",26,13,3,13,0,1,0,0
Brisbane Lions,"Robinson, Mitch",33,13,6,20,1,0,2,15
Brisbane Lions,"Rockliff, Tom",36,20,7,16,1,1,0,7
Brisbane Lions,"Taylor, Lewis",14,5,4,9,0,0,0,0
Brisbane Lions,"West, Trent",3,3,2,0,1,0,11,2
Brisbane Lions,"Zorko, Dayne",23,14,5,9,2,0,0,4
Brisbane Lions,"Adcock, Jed",8,4,4,4,0,0,0,2
Brisbane Lions,"Andrews, Harris",15,12,10,3,0,0,0,0
Brisbane Lions,"Christensen, Allen",22,13,8,9,2,1,0,4
Brisbane Lions,"Cutler, Tom",16,13,3,3,0,0,0,1
Brisbane Lions,"Dawson, Liam",17,8,5,9,0,1,0,1
Brisbane Lions,"Evans, Billy",14,5,5,9,0,0,0,6
Brisbane Lions,"Freeman, Jonathan",5,2,1,3,2,0,0,0
Brisbane Lions,"Green, Josh",8,4,1,4,0,0,0,1
Brisbane Lions,"Hanley, Pearce",25,15,4,10,0,1,0,3
Brisbane Lions,"Martin, Stefan",29,15,10,14,1,2,28,2
Brisbane Lions,"Mayes, Sam",16,5,1,11,0,0,0,1
Brisbane Lions,"McGuane, Luke",8,4,4,4,0,1,1,1
Brisbane Lions,"McStay, Daniel",8,5,4,3,1,1,0,1
Brisbane Lions,"Merrett, Daniel",12,6,9,6,0,0,0,0
Brisbane Lions,"OBrien, Zac",9,3,4,6,0,0,0,2
Brisbane Lions,"Paparone, Marco",23,13,7,10,0,0,0,2
Brisbane Lions,"Redden, Jack",27,8,3,19,0,0,1,7
Brisbane Lions,"Robinson, Mitch",25,7,0,18,0,0,1,7
Brisbane Lions,"Rockliff, Tom",30,11,8,19,0,0,0,12
Brisbane Lions,"Taylor, Lewis",18,9,3,9,0,0,0,0
Brisbane Lions,"West, Trent",3,3,2,0,0,0,1,0
Brisbane Lions,"Zorko, Dayne",38,21,6,17,0,0,0,2
Brisbane Lions,"Adcock, Jed",4,4,1,0,2,0,0,4
Brisbane Lions,"Andrews, Harris",9,3,4,6,0,0,0,1
Brisbane Lions,"Beasley, Hugh",9,5,2,4,0,2,0,2
Brisbane Lions,"Christensen, Allen",20,10,4,10,0,0,0,5
Brisbane Lions,"Clarke, Justin",5,1,2,4,0,0,0,0
Brisbane Lions,"Cutler, Tom",18,6,2,12,0,0,0,1
Brisbane Lions,"Dawson, Liam",5,5,3,0,0,0,0,0
Brisbane Lions,"Evans, Billy",13,6,2,7,0,1,0,7
Brisbane Lions,"Freeman, Jonathan",10,4,4,6,0,0,0,0
Brisbane Lions,"Green, Josh",19,13,4,6,2,1,0,0
Brisbane Lions,"Hanley, Pearce",22,15,7,7,1,0,0,0
Brisbane Lions,"Martin, Stefan",23,12,4,11,0,0,40,1
Brisbane Lions,"Mayes, Sam",18,7,3,11,0,1,0,2
Brisbane Lions,"McGuane, Luke",14,7,2,7,2,0,1,3
Brisbane Lions,"McStay, Daniel",6,1,0,5,0,0,0,2
Brisbane Lions,"Merrett, Daniel",11,6,4,5,0,0,0,2
Brisbane Lions,"Paparone, Marco",19,10,3,9,0,0,0,2
Brisbane Lions,"Rich, Daniel",16,8,1,8,0,0,0,5
Brisbane Lions,"Robinson, Mitch",25,10,2,15,1,0,0,13
Brisbane Lions,"Rockliff, Tom",45,13,3,32,1,0,0,14
Brisbane Lions,"Taylor, Lewis",15,5,2,10,0,0,0,3
Brisbane Lions,"Zorko, Dayne",28,17,3,11,0,0,0,2
Brisbane Lions,"Adcock, Jed",21,12,9,9,4,2,0,5
Brisbane Lions,"Andrews, Harris",12,4,6,8,0,0,0,1
Brisbane Lions,"Bewick, Rohan",25,16,8,9,0,0,0,3
Brisbane Lions,"Christensen, Allen",20,11,4,9,1,0,0,4
Brisbane Lions,"Clarke, Justin",14,10,4,4,0,0,0,1
Brisbane Lions,"Cutler, Tom",28,13,6,15,0,0,0,1
Brisbane Lions,"Dawson, Liam",12,9,3,3,0,1,0,1
Brisbane Lions,"Evans, Billy",11,4,1,7,1,1,0,0
Brisbane Lions,"Freeman, Jonathan",9,5,3,4,1,1,2,1
Brisbane Lions,"Green, Josh",16,13,6,3,4,2,0,5
Brisbane Lions,"Hanley, Pearce",35,18,6,17,2,3,0,6
Brisbane Lions,"Martin, Stefan",32,17,7,15,0,0,50,1
Brisbane Lions,"Mayes, Sam",19,11,6,8,0,0,0,2
Brisbane Lions,"McStay, Daniel",10,6,6,4,2,1,0,3
Brisbane Lions,"Merrett, Daniel",6,4,3,2,0,0,0,3
Brisbane Lions,"OBrien, Zac",4,4,0,0,0,0,0,1
Brisbane Lions,"Paparone, Marco",15,7,5,8,0,0,0,0
Brisbane Lions,"Rich, Daniel",27,16,2,11,0,1,0,5
Brisbane Lions,"Robinson, Mitch",28,15,5,13,0,0,0,6
Brisbane Lions,"Rockliff, Tom",39,16,10,23,0,1,0,7
Brisbane Lions,"Taylor, Lewis",28,12,4,16,3,0,0,1
Brisbane Lions,"Zorko, Dayne",30,15,6,15,1,0,0,3
Carlton,"Bell, Tom",25,11,4,14,1,1,0,7
Carlton,"Carrazzo, Andrew",18,9,2,9,0,0,0,2
Carlton,"Cripps, Patrick",14,4,3,10,0,0,1,3
Carlton,"Curnow, Ed",19,6,4,13,0,0,0,5
Carlton,"Docherty, Sam",23,15,8,8,0,0,0,5
Carlton,"Everitt, Andrejs",18,14,8,4,0,1,0,2
Carlton,"Gibbs, Bryce",26,15,4,11,1,1,0,4
Carlton,"Henderson, Lachie",10,9,6,1,0,2,0,2
Carlton,"Jaksch, Kristian",5,5,5,0,1,0,0,1
Carlton,"Jamison, Michael",8,4,2,4,0,0,0,1
Carlton,"Jones, Liam",6,4,1,2,2,1,0,4
Carlton,"Judd, Chris",21,16,5,5,0,0,0,6
Carlton,"Menzel, Troy",17,12,3,5,2,1,0,3
Carlton,"Murphy, Marc",21,9,2,12,0,0,0,2
Carlton,"Rowe, Sam",9,6,3,3,2,0,5,2
Carlton,"Simpson, Kade",21,13,8,8,1,0,0,2
Carlton,"Smith, Clem",11,7,4,4,0,0,0,0
Carlton,"Thomas, Dale",1,1,0,0,0,0,0,0
Carlton,"Tuohy, Zach",9,6,5,3,1,0,0,0
Carlton,"White, Simon",14,8,2,6,0,1,0,3
Carlton,"Wood, Cameron",11,8,2,3,0,1,28,1
Carlton,"Yarran, Chris",18,14,3,4,0,0,0,2
Carlton,"Bell, Tom",18,9,4,9,1,1,1,2
Carlton,"Carrazzo, Andrew",18,4,2,14,0,0,0,5
Carlton,"Casboult, Levi",14,7,8,7,2,3,8,2
Carlton,"Curnow, Ed",18,9,1,9,0,0,0,4
Carlton,"Docherty, Sam",25,16,10,9,0,0,0,1
Carlton,"Ellard, David",10,5,2,5,1,0,0,2
Carlton,"Everitt, Andrejs",22,17,9,5,1,2,0,1
Carlton,"Gibbs, Bryce",26,17,5,9,0,0,0,12
Carlton,"Henderson, Lachie",12,10,10,2,1,1,0,1
Carlton,"Jamison, Michael",10,9,6,1,0,0,0,1
Carlton,"Jones, Liam",5,3,3,2,1,1,0,3
Carlton,"Judd, Chris",19,6,0,13,0,0,0,8
Carlton,"Menzel, Troy",7,6,4,1,0,0,0,1
Carlton,"Murphy, Marc",22,12,5,10,1,0,0,4
Carlton,"Rowe, Sam",8,2,2,6,0,0,1,1
Carlton,"Simpson, Kade",21,17,8,4,0,0,0,2
Carlton,"Smith, Clem",6,2,0,4,0,0,0,1
Carlton,"Tuohy, Zach",25,17,10,8,1,0,0,0
Carlton,"Tutt, Jason",8,5,2,3,0,0,0,1
Carlton,"White, Simon",0,0,0,0,0,0,0,0
Carlton,"Wood, Cameron",11,4,3,7,0,0,17,3
Carlton,"Yarran, Chris",15,15,8,0,0,0,0,3
Carlton,"Armfield, Dennis",12,9,2,3,1,0,0,3
Carlton,"Bell, Tom",18,9,4,9,1,0,0,1
Carlton,"Byrne, Ciaran",9,5,1,4,0,0,0,1
Carlton,"Carrazzo, Andrew",25,12,2,13,0,0,0,6
Carlton,"Casboult, Levi",11,6,6,5,0,1,9,1
Carlton,"Cripps, Patrick",22,10,2,12,0,2,2,4
Carlton,"Curnow, Ed",8,3,1,5,0,0,0,1
Carlton,"Docherty, Sam",16,12,4,4,0,1,0,4
Carlton,"Ellard, David",11,5,4,6,1,0,0,1
Carlton,"Everitt, Andrejs",18,13,5,5,2,2,2,1
Carlton,"Gibbs, Bryce",18,12,3,6,1,2,2,6
Carlton,"Henderson, Lachie",10,9,4,1,2,1,1,1
Carlton,"Jamison, Michael",5,4,2,1,0,0,0,0
Carlton,"Jones, Liam",8,8,4,0,1,1,0,2
Carlton,"Judd, Chris",20,11,2,9,1,1,0,1
Carlton,"Murphy, Marc",30,18,4,12,0,0,0,3
Carlton,"Rowe, Sam",13,6,2,7,0,0,1,3
Carlton,"Simpson, Kade",23,12,5,11,0,0,0,1
Carlton,"Tuohy, Zach",16,5,1,11,0,0,0,0
Carlton,"Walker, Andrew",20,14,6,6,1,1,0,0
Carlton,"Wood, Cameron",13,9,1,4,0,1,23,1
Carlton,"Yarran, Chris",10,8,2,2,0,1,0,1
Carlton,"Armfield, Dennis",15,10,2,5,1,2,0,7
Carlton,"Bell, Tom",16,12,2,4,4,0,0,6
Carlton,"Boekhorst, Blaine",13,10,5,3,0,2,0,2
Carlton,"Buckley, Dylan",16,6,2,10,0,0,0,2
Carlton,"Carrazzo, Andrew",19,8,4,11,0,0,0,7
Carlton,"Casboult, Levi",12,5,5,7,0,0,12,0
Carlton,"Cripps, Patrick",33,8,4,25,1,0,1,11
Carlton,"Curnow, Ed",16,4,0,12,0,0,0,10
Carlton,"Dick, Matthew",3,1,0,2,0,0,0,2
Carlton,"Docherty, Sam",18,13,3,5,0,0,0,2
Carlton,"Ellard, David",14,8,4,6,1,0,0,7
Carlton,"Everitt, Andrejs",19,12,10,7,2,2,4,4
Carlton,"Gibbs, Bryce",23,10,0,13,2,0,0,4
Carlton,"Henderson, Lachie",14,13,4,1,5,1,0,2
Carlton,"Jamison, Michael",4,2,1,2,0,0,0,1
Carlton,"Jones, Liam",9,7,5,2,1,3,0,3
Carlton,"Murphy, Marc",34,10,1,24,0,0,0,3
Carlton,"Rowe, Sam",11,4,3,7,0,0,0,3
Carlton,"Simpson, Kade",21,11,3,10,0,0,0,2
Carlton,"Tuohy, Zach",25,15,7,10,1,1,0,1
Carlton,"Walker, Andrew",24,13,4,11,0,0,1,3
Carlton,"Wood, Cameron",16,11,2,5,0,0,39,4
Carlton,"Armfield, Dennis",9,6,2,3,1,1,0,3
Carlton,"Bell, Tom",15,11,1,4,1,1,1,3
Carlton,"Boekhorst, Blaine",6,2,0,4,0,1,0,1
Carlton,"Buckley, Dylan",13,5,1,8,0,0,0,0
Carlton,"Cripps, Patrick",20,6,2,14,0,0,0,6
Carlton,"Curnow, Ed",20,7,2,13,0,0,0,5
Carlton,"Docherty, Sam",24,17,6,7,0,0,0,2
Carlton,"Ellard, David",12,6,2,6,1,1,0,5
Carlton,"Everitt, Andrejs",15,8,2,7,0,0,1,3
Carlton,"Gibbs, Bryce",17,7,2,10,0,0,0,0
Carlton,"Henderson, Lachie",0,0,0,0,0,0,0,1
Carlton,"Jaksch, Kristian",8,4,3,4,0,0,0,1
Carlton,"Jones, Liam",8,6,3,2,0,1,0,2
Carlton,"Judd, Chris",22,14,1,8,0,1,0,2
Carlton,"Murphy, Marc",26,18,3,8,0,0,0,2
Carlton,"Rowe, Sam",10,5,3,5,0,0,0,3
Carlton,"Simpson, Kade",24,14,4,10,1,1,0,0
Carlton,"Tuohy, Zach",15,8,2,7,0,0,0,2
Carlton,"Walker, Andrew",8,8,1,0,0,0,0,1
Carlton,"Warnock, Robert",8,5,0,3,0,0,29,0
Carlton,"Whiley, Mark",8,4,1,4,0,0,0,5
Carlton,"Wood, Cameron",10,5,3,5,2,0,18,0
Carlton,"Armfield, Dennis",8,6,2,2,0,1,0,4
Carlton,"Bell, Tom",27,17,3,10,2,1,2,6
Carlton,"Boekhorst, Blaine",13,7,5,6,0,1,0,5
Carlton,"Buckley, Dylan",10,7,2,3,0,0,0,1
Carlton,"Casboult, Levi",11,9,6,2,4,2,13,1
Carlton,"Cripps, Patrick",18,6,1,12,1,0,4,2
Carlton,"Curnow, Ed",23,9,3,14,0,0,0,5
Carlton,"Docherty, Sam",20,14,3,6,0,0,0,2
Carlton,"Everitt, Andrejs",15,9,2,6,0,0,0,1
Carlton,"Gibbs, Bryce",23,13,3,10,0,0,2,8
Carlton,"Graham, Nick",5,2,0,3,0,0,0,3
Carlton,"Jaksch, Kristian",18,9,7,9,0,0,0,1
Carlton,"Jones, Liam",9,7,6,2,1,2,0,1
Carlton,"Judd, Chris",22,10,4,12,1,0,0,3
Carlton,"Murphy, Marc",15,11,3,4,2,0,0,3
Carlton,"Rowe, Sam",14,9,3,5,0,0,0,1
Carlton,"Smith, Clem",12,6,2,6,0,0,0,1
Carlton,"Thomas, Dale",20,10,5,10,0,0,0,1
Carlton,"Tuohy, Zach",17,7,2,10,0,0,0,2
Carlton,"Walker, Andrew",13,6,3,7,0,0,0,2
Carlton,"Whiley, Mark",7,3,2,4,0,0,0,7
Carlton,"Wood, Cameron",12,7,1,5,0,0,32,3
Carlton,"Armfield, Dennis",8,5,4,3,0,0,0,1
Carlton,"Bell, Tom",19,12,5,7,0,1,2,4
Carlton,"Carrazzo, Andrew",16,5,2,11,0,0,0,2
Carlton,"Casboult, Levi",6,4,2,2,1,0,8,0
Carlton,"Curnow, Ed",31,17,5,14,0,0,0,4
Carlton,"Dick, Matthew",11,6,2,5,0,0,0,0
Carlton,"Docherty, Sam",27,17,4,10,0,0,0,0
Carlton,"Ellard, David",6,3,2,3,0,0,0,2
Carlton,"Everitt, Andrejs",19,13,11,6,1,0,3,2
Carlton,"Gibbs, Bryce",23,11,0,12,0,0,1,8
Carlton,"Jaksch, Kristian",7,4,2,3,0,0,0,2
Carlton,"Judd, Chris",26,10,4,16,2,0,0,0
Carlton,"Menzel, Troy",8,7,5,1,2,1,0,1
Carlton,"Murphy, Marc",24,14,8,10,0,0,0,3
Carlton,"Rowe, Sam",6,4,2,2,0,0,0,1
Carlton,"Thomas, Dale",16,9,7,7,0,0,0,2
Carlton,"Tuohy, Zach",18,12,5,6,1,0,0,1
Carlton,"Tutt, Jason",23,13,7,10,0,0,0,3
Carlton,"Watson, Matthew",3,1,0,2,0,0,0,2
Carlton,"White, Simon",15,8,5,7,0,0,0,1
Carlton,"Wood, Cameron",16,8,2,8,1,0,23,1
Carlton,"Yarran, Chris",17,15,5,2,1,0,0,1
Carlton,"Armfield, Dennis",14,7,2,7,1,0,0,2
Carlton,"Bell, Tom",17,10,4,7,0,0,0,1
Carlton,"Buckley, Dylan",6,5,3,1,0,0,0,0
Carlton,"Casboult, Levi",5,4,3,1,0,0,2,2
Carlton,"Cripps, Patrick",19,4,3,15,0,1,0,4
Carlton,"Curnow, Ed",16,8,1,8,0,1,0,6
Carlton,"Docherty, Sam",17,13,4,4,0,0,0,1
Carlton,"Everitt, Andrejs",16,7,5,9,0,0,3,1
Carlton,"Gibbs, Bryce",12,8,0,4,0,0,0,2
Carlton,"Jones, Liam",9,5,7,4,0,0,0,1
Carlton,"Judd, Chris",12,6,3,6,0,0,0,1
Carlton,"Menzel, Troy",15,13,6,2,4,2,0,2
Carlton,"Murphy, Marc",25,18,5,7,0,0,0,1
Carlton,"Rowe, Sam",4,2,3,2,0,0,0,0
Carlton,"Simpson, Kade",30,18,10,12,0,0,0,3
Carlton,"Thomas, Dale",14,11,4,3,2,2,0,1
Carlton,"Tuohy, Zach",18,9,4,9,0,0,0,0
Carlton,"Tutt, Jason",24,13,6,11,1,1,0,0
Carlton,"Warnock, Robert",10,3,1,7,0,0,27,3
Carlton,"White, Simon",12,6,4,6,0,0,0,2
Carlton,"Wood, Cameron",12,6,1,6,0,0,8,0
Carlton,"Yarran, Chris",22,20,6,2,1,0,0,2
Carlton,"Armfield, Dennis",17,8,3,9,1,1,0,3
Carlton,"Bell, Tom",28,21,8,7,0,3,2,2
Carlton,"Buckley, Dylan",6,4,1,2,1,0,0,1
Carlton,"Carrazzo, Andrew",29,11,4,18,0,1,0,7
Carlton,"Casboult, Levi",8,6,6,2,2,0,6,1
Carlton,"Cripps, Patrick",25,9,3,16,1,1,3,4
Carlton,"Curnow, Ed",23,9,2,14,0,0,0,6
Carlton,"Docherty, Sam",21,15,7,6,0,0,0,5
Carlton,"Everitt, Andrejs",26,17,8,9,2,0,2,2
Carlton,"Graham, Nick",14,5,3,9,0,0,0,7
Carlton,"Henderson, Lachie",10,9,5,1,0,0,0,1
Carlton,"Jones, Liam",5,3,1,2,0,0,0,2
Carlton,"Menzel, Troy",6,4,2,2,0,1,0,1
Carlton,"Rowe, Sam",10,6,5,4,0,0,0,1
Carlton,"Simpson, Kade",22,17,5,5,0,0,0,3
Carlton,"Thomas, Dale",19,11,4,8,0,0,0,2
Carlton,"Tuohy, Zach",17,9,6,8,1,0,0,2
Carlton,"Tutt, Jason",13,4,0,9,0,0,0,2
Carlton,"Walker, Andrew",13,8,3,5,0,0,0,6
Carlton,"White, Simon",8,7,2,1,0,0,0,1
Carlton,"Wood, Cameron",7,7,1,0,1,0,21,2
Carlton,"Yarran, Chris",9,6,2,3,0,0,0,4
Carlton,"Armfield, Dennis",12,7,0,5,2,0,0,2
Carlton,"Bell, Tom",22,16,4,6,1,0,0,4
Carlton,"Buckley, Dylan",19,13,4,6,0,0,0,1
Carlton,"Carrazzo, Andrew",29,9,2,20,0,0,0,1
Carlton,"Casboult, Levi",10,7,6,3,3,1,0,3
Carlton,"Cripps, Patrick",25,6,4,19,1,0,2,4
Carlton,"Curnow, Ed",31,14,2,17,0,1,0,2
Carlton,"Docherty, Sam",22,15,9,7,0,0,0,3
Carlton,"Everitt, Andrejs",18,13,7,5,1,2,0,0
Carlton,"Graham, Nick",17,8,2,9,1,0,0,5
Carlton,"Henderson, Lachie",17,12,12,5,1,0,0,2
Carlton,"Judd, Chris",6,3,1,3,0,0,0,0
Carlton,"Kreuzer, Matthew",11,8,3,3,2,0,11,4
Carlton,"Menzel, Troy",12,5,4,7,1,0,0,1
Carlton,"Murphy, Marc",36,20,5,16,0,0,0,5
Carlton,"Rowe, Sam",18,11,9,7,0,0,0,3
Carlton,"Simpson, Kade",29,17,9,12,0,0,0,2
Carlton,"Tuohy, Zach",20,9,5,11,1,0,0,1
Carlton,"Tutt, Jason",11,7,5,4,0,0,0,3
Carlton,"Walker, Andrew",26,13,6,13,0,0,0,3
Carlton,"White, Simon",10,4,2,6,0,0,1,2
Carlton,"Wood, Cameron",9,3,1,6,0,0,17,0
Carlton,"Armfield, Dennis",11,5,4,6,2,0,0,3
Carlton,"Bell, Tom",25,16,6,9,1,0,0,5
Carlton,"Buckley, Dylan",14,6,4,8,0,0,0,4
Carlton,"Carrazzo, Andrew",29,9,2,20,0,0,0,3
Carlton,"Casboult, Levi",8,6,6,2,2,0,4,3
Carlton,"Cripps, Patrick",31,9,3,22,0,0,5,12
Carlton,"Curnow, Ed",26,11,4,15,0,0,0,4
Carlton,"Docherty, Sam",22,14,2,8,0,0,0,2
Carlton,"Everitt, Andrejs",12,10,8,2,3,1,0,3
Carlton,"Gibbs, Bryce",20,9,2,11,0,0,1,3
Carlton,"Graham, Nick",18,13,4,5,2,1,0,7
Carlton,"Henderson, Lachie",15,11,4,4,3,1,0,1
Carlton,"Kreuzer, Matthew",8,4,2,4,0,0,17,1
Carlton,"Menzel, Troy",9,7,2,2,2,1,0,2
Carlton,"Murphy, Marc",29,22,3,7,1,0,0,6
Carlton,"Rowe, Sam",13,6,3,7,0,0,1,2
Carlton,"Simpson, Kade",21,11,8,10,0,0,0,0
Carlton,"Tuohy, Zach",16,12,4,4,0,1,0,1
Carlton,"Walker, Andrew",2,2,2,0,0,0,0,0
Carlton,"White, Simon",13,8,3,5,0,0,0,4
Carlton,"Wood, Cameron",3,3,1,0,1,0,12,3
Carlton,"Yarran, Chris",21,16,2,5,0,0,0,2
Carlton,"Armfield, Dennis",16,8,1,8,2,0,0,2
Carlton,"Bell, Tom",32,19,6,13,0,2,4,3
Carlton,"Buckley, Dylan",14,9,4,5,1,0,0,0
Carlton,"Carrazzo, Andrew",27,10,3,17,0,0,0,4
Carlton,"Casboult, Levi",10,8,5,2,3,3,1,0
Carlton,"Cripps, Patrick",20,9,3,11,0,3,1,6
Carlton,"Curnow, Ed",18,5,4,13,0,0,0,6
Carlton,"Docherty, Sam",23,10,6,13,0,0,0,1
Carlton,"Ellard, David",18,12,3,6,0,2,0,5
Carlton,"Everitt, Andrejs",14,13,7,1,3,3,0,1
Carlton,"Graham, Nick",24,12,3,12,0,0,0,2
Carlton,"Henderson, Lachie",12,10,7,2,2,1,0,2
Carlton,"Holman, Nick",8,3,2,5,0,0,0,3
Carlton,"Kreuzer, Matthew",19,7,8,12,0,1,22,4
Carlton,"Menzel, Troy",4,3,2,1,1,0,0,2
Carlton,"Murphy, Marc",32,19,5,13,0,1,0,2
Carlton,"Rowe, Sam",12,7,7,5,0,0,1,3
Carlton,"Simpson, Kade",25,14,8,11,0,0,0,2
Carlton,"Tuohy, Zach",27,13,7,14,1,0,0,2
Carlton,"White, Simon",13,10,6,3,0,0,0,1
Carlton,"Wood, Cameron",19,15,6,4,0,0,18,5
Carlton,"Yarran, Chris",25,17,9,8,1,0,0,1
Carlton,"Armfield, Dennis",17,12,2,5,2,4,0,3
Carlton,"Bell, Tom",19,13,3,6,0,1,3,5
Carlton,"Boekhorst, Blaine",11,4,2,7,0,0,0,1
Carlton,"Buckley, Dylan",16,10,4,6,1,0,0,4
Carlton,"Casboult, Levi",8,6,6,2,1,1,0,2
Carlton,"Cripps, Patrick",16,6,5,10,0,0,1,6
Carlton,"Curnow, Ed",28,15,3,13,0,1,0,3
Carlton,"Everitt, Andrejs",7,5,5,2,1,0,0,0
Carlton,"Graham, Nick",26,11,3,15,0,0,0,5
Carlton,"Henderson, Lachie",10,8,7,2,1,1,0,2
Carlton,"Holman, Nick",11,5,0,6,0,0,0,7
Carlton,"Jamison, Michael",17,6,8,11,0,0,1,0
Carlton,"Johnson, Blaine",10,4,3,6,0,0,0,3
Carlton,"Kreuzer, Matthew",7,3,2,4,0,0,29,9
Carlton,"Murphy, Marc",25,13,6,12,0,0,0,7
Carlton,"Simpson, Kade",28,16,8,12,0,0,0,0
Carlton,"Tuohy, Zach",25,17,14,8,0,0,0,2
Carlton,"Tutt, Jason",17,11,4,6,1,1,0,5
Carlton,"Whiley, Mark",4,1,1,3,0,0,0,2
Carlton,"White, Simon",10,9,5,1,0,0,0,3
Carlton,"Wood, Cameron",10,8,3,2,0,1,13,0
Carlton,"Yarran, Chris",19,17,4,2,0,0,0,2
Carlton,"Armfield, Dennis",6,5,1,1,0,1,0,3
Carlton,"Bell, Tom",14,9,2,5,0,0,0,3
Carlton,"Buckley, Dylan",14,9,4,5,0,0,0,4
Carlton,"Carrazzo, Andrew",23,10,3,13,0,2,0,1
Carlton,"Casboult, Levi",13,11,9,2,2,1,2,0
Carlton,"Cripps, Patrick",22,10,3,12,0,1,2,6
Carlton,"Curnow, Ed",20,5,5,15,0,0,0,4
Carlton,"Everitt, Andrejs",13,10,6,3,1,0,0,1
Carlton,"Fields, Tom",10,9,5,1,0,0,0,6
Carlton,"Gibbs, Bryce",21,10,2,11,0,2,1,7
Carlton,"Henderson, Lachie",13,7,7,6,1,0,0,1
Carlton,"Holman, Nick",9,2,4,7,0,0,0,3
Carlton,"Jamison, Michael",0,0,0,0,0,0,0,0
Carlton,"Kreuzer, Matthew",14,11,7,3,1,2,16,7
Carlton,"Menzel, Troy",6,1,1,5,0,0,0,2
Carlton,"Murphy, Marc",22,18,3,4,0,1,0,5
Carlton,"Simpson, Kade",22,14,7,8,0,0,0,2
Carlton,"Tuohy, Zach",20,10,4,10,0,0,0,3
Carlton,"Tutt, Jason",18,13,4,5,0,1,0,6
Carlton,"White, Simon",12,8,5,4,0,0,1,1
Carlton,"Wood, Cameron",11,6,2,5,0,0,12,6
Carlton,"Yarran, Chris",9,6,2,3,0,0,0,3
Carlton,"Bell, Tom",22,16,6,6,2,1,0,7
Carlton,"Buckley, Dylan",23,14,6,9,0,0,0,4
Carlton,"Carrazzo, Andrew",17,7,4,10,0,0,0,4
Carlton,"Casboult, Levi",7,3,2,4,0,0,7,0
Carlton,"Cripps, Patrick",17,5,1,12,0,0,1,6
Carlton,"Curnow, Ed",32,16,8,16,0,0,0,8
Carlton,"Docherty, Sam",27,14,7,13,1,0,0,2
Carlton,"Everitt, Andrejs",14,7,5,7,1,0,0,1
Carlton,"Fields, Tom",11,7,0,4,0,0,0,2
Carlton,"Henderson, Lachie",13,8,5,5,0,0,0,1
Carlton,"Holman, Nick",13,7,5,6,0,0,0,4
Carlton,"Jamison, Michael",10,7,7,3,0,0,0,3
Carlton,"Kreuzer, Matthew",15,6,4,9,0,1,19,3
Carlton,"Menzel, Troy",7,4,3,3,1,0,0,2
Carlton,"Murphy, Marc",29,18,4,11,0,1,0,4
Carlton,"Rowe, Sam",14,7,6,7,0,0,2,4
Carlton,"Simpson, Kade",20,14,5,6,0,0,0,2
Carlton,"Tuohy, Zach",20,14,7,6,1,0,0,0
Carlton,"Tutt, Jason",19,10,5,9,1,1,0,3
Carlton,"Walsh, Brad",4,2,0,2,0,0,0,1
Carlton,"White, Simon",13,9,3,4,1,0,0,6
Carlton,"Yarran, Chris",25,20,8,5,0,0,0,7
Carlton,"Bell, Tom",25,16,6,9,1,0,0,1
Carlton,"Boekhorst, Blaine",17,9,4,8,1,2,0,2
Carlton,"Buckley, Dylan",16,12,7,4,0,0,0,0
Carlton,"Casboult, Levi",11,5,2,6,0,0,10,0
Carlton,"Cripps, Patrick",27,8,3,19,0,1,2,3
Carlton,"Curnow, Ed",23,8,5,15,0,0,0,3
Carlton,"Docherty, Sam",14,8,5,6,0,0,0,2
Carlton,"Everitt, Andrejs",13,6,1,7,1,0,0,1
Carlton,"Henderson, Lachie",14,7,8,7,0,0,0,0
Carlton,"Holman, Nick",11,6,2,5,0,0,0,0
Carlton,"Jamison, Michael",8,2,3,6,0,0,0,1
Carlton,"Johnson, Blaine",5,1,0,4,0,1,0,2
Carlton,"Jones, Liam",6,3,1,3,1,0,0,0
Carlton,"Kreuzer, Matthew",14,10,1,4,0,0,19,4
Carlton,"Murphy, Marc",37,13,9,24,0,1,0,1
Carlton,"Rowe, Sam",6,3,2,3,0,0,2,1
Carlton,"Simpson, Kade",22,15,5,7,0,0,0,2
Carlton,"Tuohy, Zach",20,12,3,8,0,0,0,2
Carlton,"Tutt, Jason",14,4,4,10,0,0,0,1
Carlton,"Walsh, Brad",6,2,2,4,0,0,0,3
Carlton,"White, Simon",17,7,1,10,0,0,2,0
Carlton,"Yarran, Chris",13,12,7,1,0,1,0,3
Carlton,"Bell, Tom",12,8,3,4,0,0,0,1
Carlton,"Boekhorst, Blaine",15,9,3,6,1,0,0,3
Carlton,"Buckley, Dylan",15,9,5,6,0,1,0,1
Carlton,"Carrazzo, Andrew",24,6,3,18,0,0,0,4
Carlton,"Casboult, Levi",10,8,6,2,2,0,0,0
Carlton,"Cripps, Patrick",20,11,6,9,0,2,3,6
Carlton,"Curnow, Ed",12,7,1,5,0,0,0,5
Carlton,"Docherty, Sam",17,12,7,5,0,0,0,5
Carlton,"Everitt, Andrejs",11,6,6,5,3,1,0,2
Carlton,"Henderson, Lachie",11,7,5,4,0,0,0,4
Carlton,"Jamison, Michael",16,11,5,5,0,0,0,0
Carlton,"Kreuzer, Matthew",14,7,2,7,1,0,14,5
Carlton,"Menzel, Troy",13,9,3,4,0,0,0,2
Carlton,"Murphy, Marc",26,12,3,14,0,0,0,3
Carlton,"Rowe, Sam",7,6,5,1,0,0,2,0
Carlton,"Simpson, Kade",26,15,6,11,0,0,0,1
Carlton,"Smith, Clem",4,3,1,1,0,0,0,0
Carlton,"Tuohy, Zach",14,9,1,5,1,1,0,0
Carlton,"Tutt, Jason",7,4,2,3,0,0,0,1
Carlton,"White, Simon",7,2,2,5,0,0,0,1
Carlton,"Wood, Cameron",6,3,2,3,0,0,6,1
Carlton,"Yarran, Chris",15,12,8,3,0,0,0,0
Carlton,"Bell, Tom",24,16,2,8,1,1,0,4
Carlton,"Boekhorst, Blaine",18,8,1,10,1,2,0,2
Carlton,"Buckley, Dylan",15,6,3,9,1,1,0,2
Carlton,"Carrazzo, Andrew",24,6,1,18,1,0,0,3
Carlton,"Casboult, Levi",6,5,5,1,2,0,4,0
Carlton,"Cripps, Patrick",35,14,6,21,0,0,3,2
Carlton,"Curnow, Ed",22,9,4,13,0,0,0,2
Carlton,"Docherty, Sam",21,13,4,8,0,0,0,1
Carlton,"Everitt, Andrejs",14,9,3,5,4,1,0,0
Carlton,"Henderson, Lachie",16,7,8,9,0,0,0,3
Carlton,"Holman, Nick",9,2,1,7,0,0,0,4
Carlton,"Jamison, Michael",11,8,7,3,0,0,0,3
Carlton,"Kreuzer, Matthew",11,8,3,3,0,0,27,5
Carlton,"Murphy, Marc",36,20,5,16,2,0,0,4
Carlton,"Rowe, Sam",7,4,1,3,0,0,1,1
Carlton,"Simpson, Kade",31,12,1,19,0,0,0,1
Carlton,"Smith, Clem",12,3,2,9,0,0,0,4
Carlton,"Tuohy, Zach",15,7,5,8,0,0,0,0
Carlton,"Walker, Andrew",12,7,3,5,0,2,0,2
Carlton,"Whiley, Mark",13,7,4,6,1,1,4,3
Carlton,"White, Simon",12,7,2,5,0,0,3,1
Carlton,"Wood, Cameron",1,0,0,1,0,0,3,0
Carlton,"Bell, Tom",19,10,6,9,0,0,0,5
Carlton,"Boekhorst, Blaine",17,9,2,8,1,1,0,3
Carlton,"Buckley, Dylan",12,10,4,2,1,0,0,5
Carlton,"Carrazzo, Andrew",19,7,1,12,0,0,0,5
Carlton,"Cripps, Patrick",25,7,2,18,0,1,2,4
Carlton,"Curnow, Ed",10,7,2,3,0,0,0,2
Carlton,"Dick, Matthew",9,5,5,4,0,0,0,1
Carlton,"Docherty, Sam",16,11,7,5,1,0,1,0
Carlton,"Ellard, David",12,7,4,5,0,0,0,4
Carlton,"Everitt, Andrejs",10,9,4,1,0,1,1,2
Carlton,"Henderson, Lachie",12,7,4,5,0,2,1,0
Carlton,"Holman, Nick",2,1,0,1,0,0,0,0
Carlton,"Jaksch, Kristian",12,9,6,3,0,2,0,2
Carlton,"Jamison, Michael",8,5,5,3,0,0,2,1
Carlton,"Kreuzer, Matthew",13,7,3,6,1,0,31,4
Carlton,"Murphy, Marc",23,15,3,8,1,2,0,4
Carlton,"Rowe, Sam",8,6,2,2,0,0,7,5
Carlton,"Simpson, Kade",16,14,5,2,0,0,0,4
Carlton,"Smith, Clem",5,1,1,4,0,0,0,1
Carlton,"Tuohy, Zach",14,9,2,5,0,0,0,0
Carlton,"Walker, Andrew",12,9,4,3,4,0,0,3
Carlton,"Whiley, Mark",15,14,1,1,0,0,4,6
Carlton,"Bell, Tom",17,12,3,5,0,0,0,10
Carlton,"Boekhorst, Blaine",10,7,1,3,0,0,0,3
Carlton,"Buckley, Dylan",16,9,4,7,0,0,0,2
Carlton,"Carrazzo, Andrew",15,7,2,8,0,0,0,5
Carlton,"Cripps, Patrick",26,9,3,17,2,0,2,3
Carlton,"Curnow, Ed",25,14,7,11,0,0,0,7
Carlton,"Dick, Matthew",11,7,6,4,0,1,0,1
Carlton,"Docherty, Sam",25,19,11,6,0,1,0,2
Carlton,"Ellard, David",7,5,1,2,0,0,0,2
Carlton,"Everitt, Andrejs",10,9,6,1,2,1,0,1
Carlton,"Jaksch, Kristian",12,8,3,4,0,0,0,1
Carlton,"Jamison, Michael",9,5,3,4,0,0,0,0
Carlton,"Kreuzer, Matthew",17,9,3,8,3,0,22,5
Carlton,"Menzel, Troy",7,6,2,1,0,0,0,1
Carlton,"Murphy, Marc",18,11,2,7,0,0,1,3
Carlton,"Rowe, Sam",16,12,6,4,0,0,5,5
Carlton,"Simpson, Kade",15,12,3,3,0,0,1,3
Carlton,"Tuohy, Zach",23,13,7,10,0,0,0,1
Carlton,"Tutt, Jason",26,16,5,10,0,0,0,4
Carlton,"Walker, Andrew",12,11,5,1,4,1,0,1
Carlton,"Watson, Matthew",9,8,6,1,1,1,0,4
Carlton,"Whiley, Mark",15,6,3,9,0,1,3,4
Carlton,"Bell, Tom",24,14,6,10,1,1,1,6
Carlton,"Boekhorst, Blaine",9,6,0,3,1,0,0,2
Carlton,"Buckley, Dylan",16,8,1,8,0,2,0,3
Carlton,"Cripps, Patrick",30,9,2,21,0,1,1,3
Carlton,"Curnow, Ed",26,17,7,9,0,0,0,5
Carlton,"Dick, Matthew",19,11,3,8,0,1,0,5
Carlton,"Docherty, Sam",23,12,9,11,0,0,0,0
Carlton,"Ellard, David",3,1,0,2,0,0,0,0
Carlton,"Everitt, Andrejs",10,2,1,8,1,1,0,0
Carlton,"Jamison, Michael",12,7,3,5,0,0,0,3
Carlton,"Kreuzer, Matthew",12,5,1,7,0,0,25,2
Carlton,"Menzel, Troy",8,3,3,5,0,0,0,2
Carlton,"Rowe, Sam",10,6,4,4,0,0,0,2
Carlton,"Simpson, Kade",24,16,5,8,0,0,0,7
Carlton,"Tuohy, Zach",16,12,4,4,0,0,0,1
Carlton,"Tutt, Jason",17,12,3,5,1,1,0,3
Carlton,"Walker, Andrew",8,6,6,2,1,1,0,0
Carlton,"Walsh, Brad",9,2,0,7,1,0,0,1
Carlton,"Watson, Matthew",6,4,4,2,1,0,0,1
Carlton,"Whiley, Mark",19,6,3,13,0,0,5,4
Carlton,"Wood, Cameron",7,3,1,4,0,0,19,2
Carlton,"Yarran, Chris",5,4,2,1,0,0,0,2
Carlton,"Bell, Tom",27,18,9,9,0,0,0,1
Carlton,"Boekhorst, Blaine",9,5,1,4,0,0,0,2
Carlton,"Buckley, Dylan",17,10,6,7,0,1,0,4
Carlton,"Carrazzo, Andrew",33,8,3,25,0,0,0,4
Carlton,"Cripps, Patrick",26,8,5,18,0,0,3,3
Carlton,"Curnow, Ed",31,16,4,15,0,0,0,1
Carlton,"Dick, Matthew",17,10,4,7,0,0,0,3
Carlton,"Ellard, David",9,3,2,6,0,0,0,4
Carlton,"Everitt, Andrejs",20,16,13,4,2,2,0,1
Carlton,"Holman, Nick",12,5,1,7,0,0,0,0
Carlton,"Jamison, Michael",14,4,4,10,0,0,0,1
Carlton,"Kreuzer, Matthew",11,6,1,5,1,1,24,2
Carlton,"Menzel, Troy",11,7,6,4,0,1,0,2
Carlton,"Rowe, Sam",15,13,8,2,0,0,0,2
Carlton,"Simpson, Kade",19,13,5,6,1,0,0,3
Carlton,"Smith, Clem",5,2,1,3,0,0,0,2
Carlton,"Tuohy, Zach",24,14,2,10,0,0,0,3
Carlton,"Tutt, Jason",21,16,8,5,0,0,0,3
Carlton,"Walker, Andrew",13,9,5,4,2,1,0,1
Carlton,"Watson, Matthew",14,10,8,4,2,1,1,1
Carlton,"Whiley, Mark",14,5,2,9,0,0,3,2
Carlton,"Wood, Cameron",6,2,1,4,0,0,10,2
Collingwood,"Adams, Taylor",31,13,3,18,0,0,0,2
Collingwood,"Blair, Jarryd",21,14,1,7,2,0,0,7
Collingwood,"Brown, Nathan",10,2,0,8,0,0,1,3
Collingwood,"Cloke, Travis",17,13,3,4,2,2,0,0
Collingwood,"Crisp, Jack",12,7,1,5,1,1,0,5
Collingwood,"Elliott, Jamie",16,11,8,5,1,1,0,6
Collingwood,"Fasolo, Alex",11,7,4,4,1,1,0,3
Collingwood,"Frost, Jack",6,1,1,5,0,0,0,3
Collingwood,"Goldsack, Tyson",11,5,3,6,0,0,0,7
Collingwood,"Grundy, Brodie",13,6,0,7,0,0,31,3
Collingwood,"Langdon, Tom",19,12,2,7,0,1,0,3
Collingwood,"Oxley, Adam",8,5,1,3,0,0,0,1
Collingwood,"Pendlebury, Scott",25,16,4,9,0,0,2,5
Collingwood,"Ramsay, Jackson",15,4,1,11,0,0,0,2
Collingwood,"Sidebottom, Steele",19,12,2,7,2,0,0,5
Collingwood,"Sinclair, Ben",16,9,2,7,0,0,0,3
Collingwood,"Swan, Dane",31,22,0,9,0,1,0,5
Collingwood,"Toovey, Alan",14,12,4,2,0,0,0,6
Collingwood,"Varcoe, Travis",16,10,2,6,1,1,0,1
Collingwood,"White, Jesse",17,7,7,10,2,3,2,0
Collingwood,"Williams, Marley",13,7,2,6,0,0,0,6
Collingwood,"de Goey, Jordan",5,2,1,3,0,0,0,1
Collingwood,"Adams, Taylor",23,10,2,13,0,0,0,7
Collingwood,"Blair, Jarryd",14,5,4,9,3,0,0,6
Collingwood,"Broomhead, Tim",20,9,1,11,1,1,0,2
Collingwood,"Brown, Nathan",5,2,0,3,0,0,0,4
Collingwood,"Cloke, Travis",9,6,6,3,1,0,1,4
Collingwood,"Crisp, Jack",17,10,4,7,0,2,0,1
Collingwood,"Elliott, Jamie",14,12,5,2,0,0,0,6
Collingwood,"Fasolo, Alex",13,6,5,7,1,1,0,3
Collingwood,"Frost, Jack",7,2,1,5,0,0,0,1
Collingwood,"Goldsack, Tyson",8,3,1,5,0,0,0,3
Collingwood,"Grundy, Brodie",13,7,3,6,0,0,31,9
Collingwood,"Langdon, Tom",25,13,4,12,0,1,0,2
Collingwood,"Oxley, Adam",33,22,2,11,0,0,0,2
Collingwood,"Pendlebury, Scott",32,18,5,14,0,1,0,0
Collingwood,"Ramsay, Jackson",20,9,2,11,0,0,0,0
Collingwood,"Seedsman, Paul",14,11,3,3,0,0,0,0
Collingwood,"Sinclair, Ben",3,2,1,1,0,0,0,1
Collingwood,"Swan, Dane",25,13,2,12,1,1,0,2
Collingwood,"Toovey, Alan",10,6,1,4,0,0,0,4
Collingwood,"Varcoe, Travis",13,5,2,8,0,0,0,3
Collingwood,"White, Jesse",17,9,7,8,2,1,8,0
Collingwood,"Williams, Marley",17,9,0,8,0,0,0,4
Collingwood,"Blair, Jarryd",23,8,8,15,1,0,0,4
Collingwood,"Broomhead, Tim",22,14,2,8,1,0,0,5
Collingwood,"Brown, Nathan",7,4,3,3,0,0,0,0
Collingwood,"Cloke, Travis",15,14,7,1,5,4,0,1
Collingwood,"Crisp, Jack",23,13,5,10,1,0,0,9
Collingwood,"Dwyer, Sam",16,10,4,6,2,2,0,2
Collingwood,"Elliott, Jamie",15,8,7,7,4,0,1,2
Collingwood,"Frost, Jack",3,2,0,1,0,0,0,0
Collingwood,"Gault, Corey",7,4,1,3,1,0,1,2
Collingwood,"Goldsack, Tyson",11,6,3,5,0,0,0,1
Collingwood,"Grundy, Brodie",23,13,3,10,1,0,30,2
Collingwood,"Karnezis, Patrick",7,3,0,4,1,0,0,1
Collingwood,"Langdon, Tom",20,11,3,9,0,0,0,3
Collingwood,"Oxley, Adam",22,13,3,9,1,0,0,5
Collingwood,"Pendlebury, Scott",29,12,5,17,0,0,1,3
Collingwood,"Ramsay, Jackson",15,8,3,7,0,0,0,5
Collingwood,"Seedsman, Paul",17,12,6,5,0,0,0,4
Collingwood,"Swan, Dane",39,27,4,12,1,1,0,5
Collingwood,"Toovey, Alan",16,11,2,5,0,0,0,5
Collingwood,"Varcoe, Travis",16,10,5,6,1,1,0,9
Collingwood,"White, Jesse",10,7,3,3,1,1,7,3
Collingwood,"Williams, Marley",15,10,1,5,0,0,0,3
Collingwood,"Adams, Taylor",29,19,10,10,0,2,0,4
Collingwood,"Blair, Jarryd",16,9,2,7,0,0,0,5
Collingwood,"Broomhead, Tim",10,8,1,2,0,2,0,4
Collingwood,"Brown, Nathan",10,6,1,4,0,0,0,4
Collingwood,"Cloke, Travis",13,9,7,4,2,0,0,1
Collingwood,"Crisp, Jack",21,13,4,8,1,0,0,4
Collingwood,"Dwyer, Sam",5,5,0,0,1,0,0,2
Collingwood,"Elliott, Jamie",12,9,6,3,2,0,0,6
Collingwood,"Frost, Jack",8,4,1,4,0,0,0,2
Collingwood,"Gault, Corey",9,4,0,5,0,1,2,0
Collingwood,"Goldsack, Tyson",11,7,5,4,0,0,0,2
Collingwood,"Grundy, Brodie",17,14,6,3,0,0,26,1
Collingwood,"Langdon, Tom",16,11,6,5,0,1,0,3
Collingwood,"Oxley, Adam",8,3,0,5,0,0,0,4
Collingwood,"Pendlebury, Scott",30,17,5,13,1,0,0,5
Collingwood,"Ramsay, Jackson",12,4,0,8,0,0,0,4
Collingwood,"Seedsman, Paul",31,25,6,6,1,1,0,4
Collingwood,"Swan, Dane",21,15,4,6,1,0,0,2
Collingwood,"Toovey, Alan",7,3,1,4,0,0,0,7
Collingwood,"Varcoe, Travis",21,7,4,14,0,2,0,5
Collingwood,"White, Jesse",9,7,2,2,0,0,3,2
Collingwood,"Williams, Marley",22,11,2,11,0,0,0,3
Collingwood,"Adams, Taylor",27,14,4,13,1,0,0,2
Collingwood,"Blair, Jarryd",18,5,2,13,1,0,0,6
Collingwood,"Brown, Nathan",15,8,9,7,0,0,0,3
Collingwood,"Cloke, Travis",11,10,7,1,2,3,0,1
Collingwood,"Crisp, Jack",26,15,4,11,1,1,0,8
Collingwood,"Dwyer, Sam",12,8,6,4,1,0,0,0
Collingwood,"Elliott, Jamie",13,11,5,2,2,3,0,1
Collingwood,"Frost, Jack",9,6,6,3,0,0,0,3
Collingwood,"Gault, Corey",10,5,4,5,1,0,2,3
Collingwood,"Goldsack, Tyson",15,8,6,7,1,0,0,6
Collingwood,"Grundy, Brodie",17,10,5,7,1,0,22,9
Collingwood,"Karnezis, Patrick",9,7,4,2,1,0,0,3
Collingwood,"Langdon, Tom",23,17,7,6,0,0,0,5
Collingwood,"Oxley, Adam",26,21,11,5,1,3,0,5
Collingwood,"Pendlebury, Scott",32,17,9,15,2,1,0,3
Collingwood,"Ramsay, Jackson",16,11,2,5,0,0,0,7
Collingwood,"Seedsman, Paul",15,11,3,4,0,0,0,2
Collingwood,"Swan, Dane",25,14,6,11,1,0,0,4
Collingwood,"Toovey, Alan",12,6,1,6,0,0,0,2
Collingwood,"Varcoe, Travis",12,6,2,6,1,0,0,3
Collingwood,"White, Jesse",11,6,6,5,1,0,3,3
Collingwood,"Williams, Marley",22,14,2,8,0,0,0,3
Collingwood,"Adams, Taylor",23,12,1,11,0,0,0,0
Collingwood,"Armstrong, Tony",16,12,6,4,0,0,0,0
Collingwood,"Blair, Jarryd",13,7,3,6,0,1,0,5
Collingwood,"Broomhead, Tim",12,5,1,7,0,0,0,3
Collingwood,"Brown, Nathan",11,5,5,6,0,0,0,2
Collingwood,"Cloke, Travis",13,9,8,4,2,2,0,1
Collingwood,"Crisp, Jack",18,12,3,6,1,0,1,4
Collingwood,"Dwyer, Sam",5,1,0,4,0,0,0,1
Collingwood,"Elliott, Jamie",14,11,8,3,0,1,0,3
Collingwood,"Frost, Jack",4,3,2,1,0,0,0,1
Collingwood,"Goldsack, Tyson",7,4,2,3,0,0,0,2
Collingwood,"Grundy, Brodie",18,7,5,11,0,1,24,5
Collingwood,"Karnezis, Patrick",18,12,5,6,0,0,0,1
Collingwood,"Langdon, Tom",23,14,4,9,0,1,0,5
Collingwood,"Oxley, Adam",22,11,3,11,0,0,0,4
Collingwood,"Pendlebury, Scott",24,15,6,9,1,1,0,8
Collingwood,"Swan, Dane",22,14,3,8,2,0,0,3
Collingwood,"Toovey, Alan",16,5,3,11,0,0,0,7
Collingwood,"Varcoe, Travis",18,9,1,9,0,0,0,7
Collingwood,"White, Jesse",13,10,9,3,2,2,5,2
Collingwood,"Williams, Marley",14,8,4,6,0,0,0,1
Collingwood,"Witts, Jarrod",15,8,3,7,0,0,16,2
Collingwood,"Adams, Taylor",23,8,2,15,0,0,0,4
Collingwood,"Blair, Jarryd",19,6,3,13,1,0,0,3
Collingwood,"Broomhead, Tim",9,5,0,4,1,0,0,2
Collingwood,"Brown, Nathan",7,2,0,5,0,0,0,1
Collingwood,"Cloke, Travis",16,12,10,4,3,1,0,3
Collingwood,"Crisp, Jack",20,13,5,7,2,0,0,2
Collingwood,"Elliott, Jamie",10,5,5,5,2,1,0,2
Collingwood,"Frost, Jack",8,6,4,2,0,0,0,1
Collingwood,"Goldsack, Tyson",15,8,5,7,0,0,0,1
Collingwood,"Grundy, Brodie",16,11,4,5,0,1,18,2
Collingwood,"Karnezis, Patrick",7,5,1,2,0,0,0,2
Collingwood,"Langdon, Tom",17,9,3,8,0,0,0,2
Collingwood,"Oxley, Adam",15,8,3,7,0,1,0,0
Collingwood,"Pendlebury, Scott",19,8,1,11,0,0,0,7
Collingwood,"Seedsman, Paul",22,11,4,11,0,0,0,3
Collingwood,"Swan, Dane",32,14,5,18,2,0,0,3
Collingwood,"Toovey, Alan",1,0,0,1,0,0,0,0
Collingwood,"Varcoe, Travis",14,6,4,8,0,0,0,0
Collingwood,"White, Jesse",13,10,4,3,2,3,1,2
Collingwood,"Williams, Marley",19,11,3,8,0,0,0,4
Collingwood,"Witts, Jarrod",12,8,3,4,1,0,14,2
Collingwood,"de Goey, Jordan",14,6,1,8,1,1,0,9
Collingwood,"Adams, Taylor",22,6,3,16,0,0,0,4
Collingwood,"Blair, Jarryd",20,8,2,12,0,2,0,4
Collingwood,"Broomhead, Tim",8,5,1,3,0,0,0,1
Collingwood,"Brown, Nathan",15,7,3,8,0,0,0,1
Collingwood,"Cloke, Travis",13,11,7,2,1,2,0,1
Collingwood,"Crisp, Jack",27,11,5,16,0,1,0,3
Collingwood,"Elliott, Jamie",12,9,6,3,5,0,0,1
Collingwood,"Fasolo, Alex",13,10,7,3,3,0,0,2
Collingwood,"Frost, Jack",6,3,3,3,0,0,0,1
Collingwood,"Goldsack, Tyson",24,10,6,14,0,0,0,1
Collingwood,"Grundy, Brodie",8,4,1,4,1,0,18,3
Collingwood,"Langdon, Tom",23,7,4,16,0,0,0,2
Collingwood,"Oxley, Adam",27,15,4,12,1,0,0,1
Collingwood,"Pendlebury, Scott",35,19,7,16,3,0,1,3
Collingwood,"Seedsman, Paul",22,11,4,11,0,0,0,2
Collingwood,"Sidebottom, Steele",32,19,5,13,0,0,0,5
Collingwood,"Swan, Dane",36,17,5,19,0,2,0,4
Collingwood,"Varcoe, Travis",29,14,10,15,2,0,0,3
Collingwood,"White, Jesse",12,9,5,3,4,1,2,2
Collingwood,"Williams, Marley",33,19,12,14,0,0,0,3
Collingwood,"Witts, Jarrod",13,7,2,6,0,2,21,2
Collingwood,"de Goey, Jordan",16,12,2,4,0,0,0,1
Collingwood,"Adams, Taylor",25,14,2,11,0,0,0,8
Collingwood,"Blair, Jarryd",13,7,4,6,1,0,0,9
Collingwood,"Brown, Nathan",7,4,2,3,0,0,0,3
Collingwood,"Cloke, Travis",14,10,5,4,1,1,0,3
Collingwood,"Crisp, Jack",19,14,3,5,1,0,0,11
Collingwood,"Elliott, Jamie",18,16,7,2,5,2,0,4
Collingwood,"Fasolo, Alex",15,9,4,6,2,0,0,6
Collingwood,"Frost, Jack",9,4,0,5,0,0,0,2
Collingwood,"Goldsack, Tyson",12,8,4,4,0,0,0,1
Collingwood,"Grundy, Brodie",15,8,4,7,1,0,21,6
Collingwood,"Langdon, Tom",13,10,4,3,0,0,0,2
Collingwood,"Oxley, Adam",6,3,3,3,0,0,0,1
Collingwood,"Pendlebury, Scott",25,13,4,12,1,0,2,3
Collingwood,"Seedsman, Paul",15,7,3,8,0,0,0,3
Collingwood,"Sidebottom, Steele",31,22,9,9,1,1,0,3
Collingwood,"Swan, Dane",32,22,5,10,2,0,0,4
Collingwood,"Toovey, Alan",13,4,2,9,0,0,0,5
Collingwood,"Varcoe, Travis",17,9,4,8,0,1,0,4
Collingwood,"White, Jesse",12,7,6,5,1,0,0,1
Collingwood,"Williams, Marley",17,10,3,7,0,0,0,3
Collingwood,"Witts, Jarrod",11,6,3,5,1,0,21,5
Collingwood,"de Goey, Jordan",8,2,0,6,0,0,0,4
Collingwood,"Blair, Jarryd",16,7,1,9,3,0,0,7
Collingwood,"Broomhead, Tim",9,7,0,2,1,1,0,3
Collingwood,"Brown, Nathan",16,6,5,10,0,0,0,0
Collingwood,"Cloke, Travis",12,12,8,0,7,0,2,4
Collingwood,"Crisp, Jack",21,10,3,11,0,0,1,4
Collingwood,"Elliott, Jamie",13,12,9,1,3,0,0,3
Collingwood,"Fasolo, Alex",15,9,5,6,1,2,0,2
Collingwood,"Frost, Jack",7,4,3,3,0,0,0,2
Collingwood,"Goldsack, Tyson",14,8,5,6,0,0,0,2
Collingwood,"Grundy, Brodie",20,10,4,10,0,0,21,4
Collingwood,"Kennedy, Ben",9,4,0,5,0,1,0,0
Collingwood,"Langdon, Tom",25,18,9,7,0,0,0,1
Collingwood,"Oxley, Adam",30,24,14,6,0,0,0,0
Collingwood,"Pendlebury, Scott",27,16,5,11,0,0,0,8
Collingwood,"Seedsman, Paul",11,8,4,3,1,0,0,2
Collingwood,"Sidebottom, Steele",21,11,4,10,0,0,0,0
Collingwood,"Swan, Dane",26,18,4,8,1,1,0,4
Collingwood,"Toovey, Alan",17,7,4,10,0,0,0,1
Collingwood,"Varcoe, Travis",16,11,6,5,0,0,0,0
Collingwood,"White, Jesse",9,5,2,4,0,1,8,0
Collingwood,"Williams, Marley",24,11,7,13,0,0,0,1
Collingwood,"de Goey, Jordan",15,9,3,6,0,0,0,9
Collingwood,"Adams, Taylor",36,22,8,14,0,0,0,7
Collingwood,"Broomhead, Tim",25,10,4,15,1,0,0,3
Collingwood,"Brown, Nathan",14,9,7,5,0,0,0,0
Collingwood,"Cloke, Travis",12,10,9,2,5,2,0,2
Collingwood,"Crisp, Jack",28,15,3,13,2,1,0,5
Collingwood,"Elliott, Jamie",12,8,2,4,1,0,0,2
Collingwood,"Fasolo, Alex",13,7,5,6,1,0,0,1
Collingwood,"Frost, Jack",7,6,4,1,0,0,0,5
Collingwood,"Goldsack, Tyson",13,5,4,8,0,0,0,0
Collingwood,"Kennedy, Ben",4,3,1,1,0,0,0,0
Collingwood,"Langdon, Tom",20,10,3,10,0,0,0,4
Collingwood,"Oxley, Adam",23,11,4,12,1,0,0,4
Collingwood,"Pendlebury, Scott",29,14,1,15,1,0,0,4
Collingwood,"Seedsman, Paul",17,7,2,10,1,0,0,2
Collingwood,"Sidebottom, Steele",22,13,5,9,0,0,0,4
Collingwood,"Swan, Dane",30,15,8,15,0,1,0,4
Collingwood,"Toovey, Alan",10,3,4,7,0,0,0,1
Collingwood,"Varcoe, Travis",22,8,4,14,1,0,0,1
Collingwood,"White, Jesse",10,9,3,1,3,1,13,2
Collingwood,"Williams, Marley",27,16,4,11,0,1,0,1
Collingwood,"Witts, Jarrod",6,3,0,3,0,0,37,4
Collingwood,"de Goey, Jordan",9,5,0,4,1,0,0,4
Collingwood,"Adams, Taylor",29,16,6,13,1,0,0,7
Collingwood,"Blair, Jarryd",10,4,5,6,1,0,0,6
Collingwood,"Broomhead, Tim",18,9,3,9,1,0,0,9
Collingwood,"Brown, Nathan",7,6,5,1,0,0,0,3
Collingwood,"Cloke, Travis",14,12,6,2,0,0,1,1
Collingwood,"Crisp, Jack",20,18,3,2,1,0,0,7
Collingwood,"Elliott, Jamie",12,9,5,3,2,0,0,5
Collingwood,"Fasolo, Alex",19,10,4,9,2,0,0,4
Collingwood,"Frost, Jack",13,4,2,9,0,0,0,3
Collingwood,"Goldsack, Tyson",7,4,0,3,0,0,0,4
Collingwood,"Langdon, Tom",24,13,4,11,0,0,0,1
Collingwood,"Oxley, Adam",16,8,3,8,0,0,1,3
Collingwood,"Pendlebury, Scott",25,14,3,11,1,0,0,6
Collingwood,"Seedsman, Paul",6,3,1,3,1,0,0,1
Collingwood,"Sidebottom, Steele",20,13,5,7,0,0,0,1
Collingwood,"Swan, Dane",26,16,4,10,0,0,0,7
Collingwood,"Toovey, Alan",14,6,6,8,0,0,0,1
Collingwood,"Varcoe, Travis",15,9,2,6,0,1,0,8
Collingwood,"White, Jesse",9,7,2,2,0,1,7,5
Collingwood,"Williams, Marley",22,7,2,15,0,0,0,1
Collingwood,"Witts, Jarrod",7,5,2,2,0,0,22,7
Collingwood,"de Goey, Jordan",12,7,1,5,1,0,0,4
Collingwood,"Adams, Taylor",24,10,3,14,1,0,0,7
Collingwood,"Blair, Jarryd",8,2,0,6,1,0,0,1
Collingwood,"Broomhead, Tim",17,5,1,12,1,1,0,4
Collingwood,"Brown, Nathan",14,6,3,8,0,0,0,4
Collingwood,"Cloke, Travis",20,16,11,4,1,4,0,0
Collingwood,"Crisp, Jack",28,19,5,9,1,1,0,7
Collingwood,"Elliott, Jamie",10,5,2,5,0,0,0,3
Collingwood,"Fasolo, Alex",18,10,5,8,1,3,0,2
Collingwood,"Frost, Jack",6,2,1,4,0,0,0,4
Collingwood,"Langdon, Tom",20,10,5,10,0,0,0,3
Collingwood,"Maynard, Brayden",11,7,2,4,0,0,0,6
Collingwood,"Moore, Darcy",4,2,1,2,0,1,0,0
Collingwood,"Oxley, Adam",15,6,2,9,0,1,0,3
Collingwood,"Pendlebury, Scott",37,18,6,19,0,0,1,10
Collingwood,"Sidebottom, Steele",30,14,6,16,0,1,0,4
Collingwood,"Swan, Dane",19,11,5,8,2,1,0,2
Collingwood,"Toovey, Alan",6,3,1,3,0,0,0,4
Collingwood,"Varcoe, Travis",21,12,8,9,0,1,0,1
Collingwood,"White, Jesse",14,11,6,3,2,2,10,1
Collingwood,"Williams, Marley",27,16,5,11,1,0,0,2
Collingwood,"Witts, Jarrod",14,6,2,8,0,0,36,6
Collingwood,"de Goey, Jordan",18,5,3,13,1,1,0,5
Collingwood,"Adams, Taylor",38,24,5,14,1,0,0,6
Collingwood,"Blair, Jarryd",16,8,1,8,0,1,0,4
Collingwood,"Broomhead, Tim",10,4,2,6,0,0,0,3
Collingwood,"Brown, Nathan",9,2,2,7,0,0,2,2
Collingwood,"Cloke, Travis",13,5,4,8,0,0,0,0
Collingwood,"Crisp, Jack",22,15,3,7,1,0,1,8
Collingwood,"Elliott, Jamie",22,14,5,8,1,0,0,1
Collingwood,"Fasolo, Alex",12,7,1,5,1,1,0,7
Collingwood,"Frost, Jack",10,3,2,7,0,0,0,2
Collingwood,"Grundy, Brodie",13,6,2,7,0,0,30,4
Collingwood,"Langdon, Tom",23,15,7,8,0,0,0,7
Collingwood,"Maynard, Brayden",18,11,4,7,0,0,0,2
Collingwood,"Moore, Darcy",9,3,1,6,0,0,2,2
Collingwood,"Oxley, Adam",16,9,2,7,1,1,0,4
Collingwood,"Pendlebury, Scott",29,14,3,15,1,1,0,6
Collingwood,"Sidebottom, Steele",31,14,5,17,0,0,0,4
Collingwood,"Swan, Dane",33,19,4,14,0,1,0,8
Collingwood,"Toovey, Alan",11,6,2,5,0,0,0,5
Collingwood,"Varcoe, Travis",20,8,1,12,0,0,0,7
Collingwood,"White, Jesse",15,10,6,5,1,1,1,1
Collingwood,"Witts, Jarrod",7,4,2,3,1,0,32,2
Collingwood,"de Goey, Jordan",16,13,0,3,1,0,0,5
Collingwood,"Blair, Jarryd",12,6,4,6,1,0,0,1
Collingwood,"Brown, Nathan",11,6,3,5,0,0,0,3
Collingwood,"Cloke, Travis",0,0,0,0,0,0,0,0
Collingwood,"Crisp, Jack",31,12,6,19,0,0,0,5
Collingwood,"Fasolo, Alex",13,11,6,2,2,0,0,1
Collingwood,"Frost, Jack",10,7,6,3,0,0,0,3
Collingwood,"Greenwood, Levi",18,7,3,11,0,0,0,7
Collingwood,"Grundy, Brodie",17,10,5,7,1,0,9,4
Collingwood,"Kennedy, Ben",15,8,3,7,0,1,0,4
Collingwood,"Langdon, Tom",20,8,4,12,0,0,0,4
Collingwood,"Maynard, Brayden",8,5,2,3,0,0,0,4
Collingwood,"Oxley, Adam",23,18,11,5,0,0,0,3
Collingwood,"Pendlebury, Scott",29,12,2,17,0,0,0,7
Collingwood,"Seedsman, Paul",23,14,4,9,0,2,0,1
Collingwood,"Sidebottom, Steele",38,20,7,18,1,1,0,1
Collingwood,"Swan, Dane",21,7,6,14,1,2,0,4
Collingwood,"Toovey, Alan",12,6,4,6,0,0,0,4
Collingwood,"Varcoe, Travis",20,7,4,13,0,0,0,6
Collingwood,"White, Jesse",10,5,4,5,0,0,1,3
Collingwood,"Williams, Marley",33,20,8,13,0,0,0,2
Collingwood,"Witts, Jarrod",10,4,0,6,1,1,12,2
Collingwood,"de Goey, Jordan",14,8,6,6,0,1,0,3
Collingwood,"Blair, Jarryd",4,2,1,2,0,0,0,0
Collingwood,"Brown, Nathan",12,6,2,6,0,0,0,2
Collingwood,"Crisp, Jack",15,8,3,7,0,0,0,4
Collingwood,"Fasolo, Alex",9,1,1,8,0,0,0,3
Collingwood,"Frost, Jack",12,8,5,4,0,0,0,4
Collingwood,"Goldsack, Tyson",13,9,4,4,0,0,0,1
Collingwood,"Greenwood, Levi",18,14,4,4,1,0,0,1
Collingwood,"Grundy, Brodie",20,12,6,8,2,1,17,3
Collingwood,"Kennedy, Ben",12,6,3,6,0,0,0,5
Collingwood,"Langdon, Tom",22,9,8,13,0,0,0,2
Collingwood,"Maynard, Brayden",16,11,2,5,0,0,0,1
Collingwood,"Moore, Darcy",9,7,4,2,5,0,0,2
Collingwood,"Oxley, Adam",8,3,2,5,0,0,0,3
Collingwood,"Pendlebury, Scott",29,15,4,14,1,1,1,5
Collingwood,"Sidebottom, Steele",33,21,8,12,1,0,0,3
Collingwood,"Swan, Dane",33,13,6,20,0,1,0,3
Collingwood,"Toovey, Alan",16,8,2,8,0,0,0,5
Collingwood,"Varcoe, Travis",15,12,4,3,1,1,0,5
Collingwood,"White, Jesse",9,6,2,3,2,2,0,2
Collingwood,"Williams, Marley",24,11,5,13,0,0,0,1
Collingwood,"Witts, Jarrod",9,3,4,6,0,1,19,6
Collingwood,"de Goey, Jordan",18,7,1,11,0,0,0,5
Collingwood,"Adams, Taylor",26,13,6,13,1,1,0,7
Collingwood,"Brown, Nathan",15,5,4,10,0,0,0,2
Collingwood,"Crisp, Jack",25,14,3,11,0,0,0,3
Collingwood,"Dwyer, Sam",16,6,4,10,0,0,0,2
Collingwood,"Elliott, Jamie",8,5,1,3,0,1,0,2
Collingwood,"Fasolo, Alex",16,12,7,4,3,2,0,4
Collingwood,"Frost, Jack",11,1,1,10,0,0,0,2
Collingwood,"Greenwood, Levi",21,11,4,10,0,0,1,9
Collingwood,"Grundy, Brodie",10,3,1,7,0,0,20,4
Collingwood,"Langdon, Tom",15,5,3,10,0,0,0,6
Collingwood,"Maynard, Brayden",16,9,4,7,0,0,0,5
Collingwood,"Moore, Darcy",6,5,4,1,0,1,0,3
Collingwood,"Pendlebury, Scott",24,11,0,13,1,0,0,7
Collingwood,"Scharenberg, Matt",16,6,1,10,0,0,0,0
Collingwood,"Seedsman, Paul",9,5,1,4,0,0,0,2
Collingwood,"Sidebottom, Steele",26,10,3,16,0,1,0,2
Collingwood,"Swan, Dane",36,17,6,19,0,1,0,3
Collingwood,"Toovey, Alan",10,4,1,6,0,1,0,5
Collingwood,"Varcoe, Travis",15,8,4,7,1,1,0,7
Collingwood,"Williams, Marley",17,11,3,6,0,0,0,1
Collingwood,"Witts, Jarrod",11,4,2,7,1,0,15,3
Collingwood,"de Goey, Jordan",11,8,0,3,0,1,0,3
Collingwood,"Adams, Taylor",10,9,2,1,0,0,0,2
Collingwood,"Blair, Jarryd",22,13,5,9,1,2,0,2
Collingwood,"Brown, Nathan",9,3,4,6,0,0,0,2
Collingwood,"Crisp, Jack",23,14,4,9,1,0,1,4
Collingwood,"Elliott, Jamie",12,10,6,2,2,1,0,4
Collingwood,"Fasolo, Alex",15,13,8,2,4,1,0,2
Collingwood,"Frost, Jack",4,2,1,2,0,0,0,0
Collingwood,"Greenwood, Levi",20,9,7,11,0,1,0,6
Collingwood,"Grundy, Brodie",14,7,3,7,0,0,37,9
Collingwood,"Langdon, Tom",28,10,6,18,0,0,0,3
Collingwood,"Marsh, Jonathon",10,3,0,7,0,0,0,1
Collingwood,"Maynard, Brayden",18,10,3,8,1,0,0,4
Collingwood,"Moore, Darcy",6,4,3,2,0,0,2,2
Collingwood,"Pendlebury, Scott",37,14,3,23,0,0,0,7
Collingwood,"Reid, Ben",9,7,4,2,4,1,1,0
Collingwood,"Scharenberg, Matt",9,4,0,5,0,0,0,3
Collingwood,"Sidebottom, Steele",19,10,2,9,0,1,0,7
Collingwood,"Sinclair, Ben",20,14,4,6,0,1,0,3
Collingwood,"Swan, Dane",41,22,10,19,3,0,0,3
Collingwood,"Toovey, Alan",15,4,1,11,0,0,0,8
Collingwood,"Varcoe, Travis",15,3,3,12,0,0,0,0
Collingwood,"Williams, Marley",19,13,3,6,0,0,0,8
Collingwood,"Adams, Taylor",31,13,1,18,0,1,0,8
Collingwood,"Blair, Jarryd",21,9,1,12,0,1,0,5
Collingwood,"Brown, Nathan",15,7,5,8,0,0,0,2
Collingwood,"Cloke, Travis",11,8,7,3,1,1,0,0
Collingwood,"Crisp, Jack",24,14,5,10,1,1,0,0
Collingwood,"Elliott, Jamie",24,14,6,10,1,2,0,7
Collingwood,"Fasolo, Alex",13,7,2,6,0,1,0,5
Collingwood,"Frost, Jack",5,2,1,3,0,0,0,1
Collingwood,"Greenwood, Levi",6,3,1,3,0,0,0,3
Collingwood,"Grundy, Brodie",20,5,2,15,0,0,28,5
Collingwood,"Langdon, Tom",24,15,5,9,0,1,0,0
Collingwood,"Marsh, Jonathon",16,7,2,9,0,0,0,1
Collingwood,"Moore, Darcy",15,10,7,5,1,0,9,1
Collingwood,"Pendlebury, Scott",31,11,4,20,1,1,0,5
Collingwood,"Reid, Ben",14,8,2,6,1,1,0,1
Collingwood,"Sidebottom, Steele",31,18,5,13,0,2,0,4
Collingwood,"Sinclair, Ben",14,10,2,4,0,0,0,1
Collingwood,"Swan, Dane",39,21,6,18,1,0,0,5
Collingwood,"Toovey, Alan",11,6,2,5,0,0,0,1
Collingwood,"Varcoe, Travis",16,5,4,11,1,0,0,6
Collingwood,"Williams, Marley",23,18,2,5,1,0,0,2
Collingwood,"de Goey, Jordan",18,12,4,6,1,0,0,12
Collingwood,"Adams, Taylor",28,14,6,14,0,1,0,4
Collingwood,"Blair, Jarryd",9,4,3,5,1,2,0,2
Collingwood,"Cloke, Travis",12,10,7,2,1,1,0,1
Collingwood,"Crisp, Jack",18,10,4,8,0,2,0,2
Collingwood,"Elliott, Jamie",13,12,9,1,1,2,0,2
Collingwood,"Fasolo, Alex",4,2,0,2,0,0,0,1
Collingwood,"Frost, Jack",5,2,2,3,0,0,0,1
Collingwood,"Greenwood, Levi",24,13,4,11,1,0,0,10
Collingwood,"Grundy, Brodie",13,5,5,8,0,0,29,5
Collingwood,"Langdon, Tom",16,5,2,11,0,0,0,5
Collingwood,"Marsh, Jonathon",7,3,2,4,0,0,0,0
Collingwood,"Maynard, Brayden",10,6,0,4,0,0,0,1
Collingwood,"Moore, Darcy",15,7,5,8,0,0,5,1
Collingwood,"Pendlebury, Scott",33,15,3,18,1,0,1,0
Collingwood,"Reid, Ben",17,5,4,12,0,0,0,1
Collingwood,"Sidebottom, Steele",32,22,11,10,0,0,0,3
Collingwood,"Sinclair, Ben",20,10,3,10,0,0,0,2
Collingwood,"Swan, Dane",28,12,6,16,2,0,0,5
Collingwood,"Toovey, Alan",13,5,2,8,0,0,0,4
Collingwood,"Varcoe, Travis",14,8,3,6,0,0,0,5
Collingwood,"Williams, Marley",16,7,0,9,0,1,0,3
Collingwood,"de Goey, Jordan",11,7,2,4,0,0,0,4
Collingwood,"Adams, Taylor",36,17,8,19,1,1,0,5
Collingwood,"Blair, Jarryd",19,9,6,10,0,0,0,0
Collingwood,"Brown, Nathan",7,3,0,4,0,0,0,2
Collingwood,"Crisp, Jack",31,16,4,15,0,0,1,7
Collingwood,"Elliott, Jamie",17,9,6,8,2,0,0,1
Collingwood,"Fasolo, Alex",18,14,8,4,3,2,0,1
Collingwood,"Greenwood, Levi",21,13,4,8,1,0,0,10
Collingwood,"Grundy, Brodie",16,12,4,4,1,0,27,7
Collingwood,"Langdon, Tom",23,15,10,8,0,0,0,4
Collingwood,"Marsh, Jonathon",5,2,0,3,0,0,0,5
Collingwood,"Maynard, Brayden",16,12,6,4,1,0,0,3
Collingwood,"Moore, Darcy",7,3,2,4,2,0,4,2
Collingwood,"Pendlebury, Scott",32,21,11,11,0,0,0,6
Collingwood,"Reid, Ben",16,12,7,4,0,0,0,2
Collingwood,"Scharenberg, Matt",17,12,9,5,0,0,0,0
Collingwood,"Sidebottom, Steele",25,16,7,9,2,0,0,3
Collingwood,"Sinclair, Ben",15,8,5,7,0,0,0,2
Collingwood,"Swan, Dane",14,7,5,7,1,1,0,1
Collingwood,"Varcoe, Travis",16,10,7,6,1,1,0,3
Collingwood,"White, Jesse",13,8,4,5,2,0,0,0
Collingwood,"Williams, Marley",22,17,7,5,0,0,0,1
Collingwood,"de Goey, Jordan",25,16,3,9,0,0,0,7
Collingwood,"Adams, Taylor",33,20,7,13,1,0,0,6
Collingwood,"Blair, Jarryd",16,7,1,9,2,0,0,6
Collingwood,"Brown, Nathan",9,8,3,1,0,0,0,3
Collingwood,"Crisp, Jack",15,9,5,6,1,0,2,3
Collingwood,"Elliott, Jamie",22,12,3,10,1,0,0,2
Collingwood,"Fasolo, Alex",19,15,9,4,2,1,0,2
Collingwood,"Greenwood, Levi",16,11,5,5,1,0,0,2
Collingwood,"Grundy, Brodie",10,6,3,4,0,0,23,0
Collingwood,"Kennedy, Ben",15,11,2,4,2,0,0,2
Collingwood,"Langdon, Tom",22,11,7,11,0,0,0,3
Collingwood,"Marsh, Jonathon",13,11,6,2,0,0,0,2
Collingwood,"Maynard, Brayden",11,5,2,6,0,0,0,4
Collingwood,"Moore, Darcy",10,8,2,2,1,1,1,3
Collingwood,"Oxley, Adam",17,8,1,9,0,0,0,0
Collingwood,"Pendlebury, Scott",22,11,6,11,0,2,0,4
Collingwood,"Reid, Ben",14,10,7,4,1,0,1,3
Collingwood,"Scharenberg, Matt",18,11,8,7,0,1,0,2
Collingwood,"Sidebottom, Steele",27,16,1,11,0,1,0,4
Collingwood,"Toovey, Alan",6,4,4,2,0,0,0,1
Collingwood,"Varcoe, Travis",17,8,6,9,0,0,0,5
Collingwood,"White, Jesse",21,12,10,9,2,0,9,1
Collingwood,"de Goey, Jordan",12,6,4,6,0,0,0,2
Essendon,"Ambrose, Patrick",11,3,3,8,0,0,2,11
Essendon,"Baguley, Mark",11,9,4,2,0,0,0,5
Essendon,"Bellchambers, Tom",8,3,2,5,0,1,37,0
Essendon,"Carlisle, Jake",4,4,1,0,0,0,0,1
Essendon,"Chapman, Paul",18,12,4,6,0,0,0,3
Essendon,"Colyer, Travis",19,13,0,6,1,1,0,2
Essendon,"Cooney, Adam",13,9,1,4,3,1,0,2
Essendon,"Daniher, Joe",9,4,2,5,1,0,0,4
Essendon,"Fletcher, Dustin",19,15,3,4,0,0,0,0
Essendon,"Gleeson, Martin",14,9,2,5,0,0,0,2
Essendon,"Goddard, Brendon",21,10,2,11,1,1,0,1
Essendon,"Heppell, Dyson",26,19,5,7,1,0,4,3
Essendon,"Hibberd, Michael",18,13,3,5,0,0,0,1
Essendon,"Hooker, Cale",19,13,7,6,0,1,1,0
Essendon,"Howlett, Ben",19,10,1,9,0,0,0,12
Essendon,"Hurley, Michael",19,16,5,3,0,0,0,1
Essendon,"Melksham, Jake",20,16,4,4,1,1,0,9
Essendon,"Merrett, Zach",17,11,2,6,0,0,0,5
Essendon,"Myers, David",1,1,0,0,0,0,0,0
Essendon,"Stanton, Brent",12,10,3,2,0,0,0,5
Essendon,"Watson, Jobe",22,9,3,13,1,0,4,6
Essendon,"Zaharakis, David",19,8,3,11,0,0,0,4
Essendon,"Ambrose, Patrick",12,4,4,8,0,0,0,6
Essendon,"Ashby, Jason",9,5,2,4,0,0,0,1
Essendon,"Baguley, Mark",21,13,7,8,0,0,0,4
Essendon,"Bellchambers, Tom",12,3,6,9,1,0,27,2
Essendon,"Carlisle, Jake",13,9,8,4,2,1,0,3
Essendon,"Chapman, Paul",16,9,2,7,2,1,0,5
Essendon,"Colyer, Travis",21,9,7,12,2,0,0,0
Essendon,"Cooney, Adam",17,10,2,7,0,0,0,5
Essendon,"Daniher, Joe",14,9,8,5,3,1,0,2
Essendon,"Gleeson, Martin",17,8,3,9,0,0,0,2
Essendon,"Goddard, Brendon",27,13,9,14,0,0,2,1
Essendon,"Gwilt, James",13,5,3,8,0,0,0,2
Essendon,"Heppell, Dyson",34,16,8,18,0,0,3,4
Essendon,"Hibberd, Michael",21,15,6,6,0,0,0,3
Essendon,"Hooker, Cale",23,13,10,10,1,0,2,5
Essendon,"Howlett, Ben",8,3,1,5,0,0,0,3
Essendon,"Hurley, Michael",25,17,5,8,0,1,0,2
Essendon,"Melksham, Jake",26,17,7,9,0,1,0,4
Essendon,"Merrett, Zach",26,13,5,13,1,0,0,7
Essendon,"Stanton, Brent",24,16,5,8,0,0,0,3
Essendon,"Watson, Jobe",33,11,3,22,0,0,2,6
Essendon,"Zaharakis, David",23,9,3,14,0,0,0,4
Essendon,"Ambrose, Patrick",20,8,3,12,0,0,3,3
Essendon,"Ashby, Jason",3,3,1,0,0,0,0,3
Essendon,"Baguley, Mark",15,11,7,4,0,0,0,4
Essendon,"Bellchambers, Tom",10,3,5,7,0,1,28,1
Essendon,"Carlisle, Jake",11,10,9,1,1,2,0,1
Essendon,"Chapman, Paul",8,6,2,2,2,0,0,2
Essendon,"Colyer, Travis",13,11,4,2,1,0,0,5
Essendon,"Cooney, Adam",15,8,3,7,0,0,0,2
Essendon,"Daniher, Joe",9,6,5,3,3,1,3,1
Essendon,"Fletcher, Dustin",17,13,7,4,0,0,0,1
Essendon,"Gleeson, Martin",19,11,8,8,0,0,0,1
Essendon,"Goddard, Brendon",23,15,8,8,1,0,1,1
Essendon,"Heppell, Dyson",25,15,2,10,1,0,2,4
Essendon,"Hibberd, Michael",21,14,4,7,0,0,0,1
Essendon,"Hooker, Cale",21,11,12,10,0,0,1,0
Essendon,"Howlett, Ben",19,9,6,10,3,1,0,5
Essendon,"Hurley, Michael",23,18,11,5,0,0,0,0
Essendon,"Melksham, Jake",15,9,5,6,0,2,0,6
Essendon,"Merrett, Zach",17,11,6,6,0,0,0,4
Essendon,"Stanton, Brent",28,17,8,11,0,0,0,5
Essendon,"Watson, Jobe",36,18,8,18,1,1,2,5
Essendon,"Zaharakis, David",17,9,5,8,3,0,0,3
Essendon,"Ambrose, Patrick",17,7,2,10,0,0,3,3
Essendon,"Baguley, Mark",22,14,9,8,0,0,0,4
Essendon,"Bellchambers, Tom",15,8,6,7,0,0,24,4
Essendon,"Carlisle, Jake",6,3,4,3,0,1,0,3
Essendon,"Chapman, Paul",11,6,2,5,0,0,0,5
Essendon,"Colyer, Travis",14,9,2,5,0,1,0,4
Essendon,"Daniher, Joe",12,9,6,3,2,2,3,2
Essendon,"Dempsey, Courtenay",22,14,5,8,0,2,0,3
Essendon,"Fletcher, Dustin",21,15,7,6,1,0,0,2
Essendon,"Gleeson, Martin",20,7,3,13,0,0,0,3
Essendon,"Goddard, Brendon",28,15,9,13,0,0,0,4
Essendon,"Hams, Will",4,2,0,2,0,1,0,3
Essendon,"Heppell, Dyson",33,21,6,12,0,0,1,8
Essendon,"Hibberd, Michael",27,13,11,14,0,0,0,1
Essendon,"Hooker, Cale",21,15,10,6,0,0,0,4
Essendon,"Howlett, Ben",18,9,2,9,0,0,0,5
Essendon,"Hurley, Michael",21,17,7,4,0,1,0,1
Essendon,"Melksham, Jake",17,10,4,7,0,1,0,5
Essendon,"Merrett, Zach",20,8,5,12,0,0,0,6
Essendon,"Stanton, Brent",30,19,9,11,2,0,0,3
Essendon,"Watson, Jobe",23,10,3,13,0,0,1,5
Essendon,"Zaharakis, David",18,8,4,10,1,0,0,5
Essendon,"Ambrose, Patrick",19,8,5,11,2,3,0,8
Essendon,"Baguley, Mark",13,3,3,10,0,0,0,3
Essendon,"Bellchambers, Tom",14,10,6,4,0,0,23,1
Essendon,"Carlisle, Jake",11,7,4,4,4,1,3,2
Essendon,"Colyer, Travis",11,9,3,2,1,0,0,1
Essendon,"Daniher, Joe",3,0,0,3,0,0,2,0
Essendon,"Dempsey, Courtenay",15,10,3,5,0,0,0,3
Essendon,"Fletcher, Dustin",19,12,7,7,0,0,0,1
Essendon,"Gleeson, Martin",20,13,7,7,1,1,0,2
Essendon,"Goddard, Brendon",28,15,10,13,1,0,0,5
Essendon,"Hams, Will",8,3,0,5,0,0,0,1
Essendon,"Heppell, Dyson",23,9,2,14,0,0,1,6
Essendon,"Hibberd, Michael",16,9,3,7,0,1,0,1
Essendon,"Hooker, Cale",14,7,0,7,0,1,0,4
Essendon,"Howlett, Ben",23,15,5,8,0,2,0,7
Essendon,"Hurley, Michael",22,15,5,7,0,0,0,0
Essendon,"Langford, Kyle",12,4,4,8,0,2,0,4
Essendon,"Melksham, Jake",11,8,3,3,0,0,0,3
Essendon,"Merrett, Zach",21,10,4,11,0,0,0,3
Essendon,"Stanton, Brent",26,17,6,9,0,1,0,5
Essendon,"Watson, Jobe",30,12,3,18,0,0,1,3
Essendon,"Zaharakis, David",15,9,3,6,2,0,0,1
Essendon,"Ambrose, Patrick",10,3,2,7,0,0,0,3
Essendon,"Baguley, Mark",22,8,5,14,0,0,0,2
Essendon,"Bellchambers, Tom",9,6,2,3,0,0,21,3
Essendon,"Carlisle, Jake",11,7,4,4,0,0,4,4
Essendon,"Colyer, Travis",16,10,5,6,1,1,0,4
Essendon,"Daniher, Joe",12,7,6,5,1,1,1,3
Essendon,"Dempsey, Courtenay",14,11,4,3,0,0,0,2
Essendon,"Gleeson, Martin",10,4,2,6,1,0,0,0
Essendon,"Goddard, Brendon",35,16,4,19,0,0,0,6
Essendon,"Gwilt, James",17,11,3,6,0,0,0,3
Essendon,"Hams, Will",4,3,1,1,0,1,0,2
Essendon,"Heppell, Dyson",24,18,3,6,0,0,2,1
Essendon,"Hibberd, Michael",22,10,6,12,0,0,0,1
Essendon,"Hooker, Cale",11,8,4,3,0,0,0,1
Essendon,"Howlett, Ben",14,9,4,5,1,0,0,7
Essendon,"Hurley, Michael",16,11,3,5,0,0,0,5
Essendon,"Melksham, Jake",11,4,2,7,0,0,0,3
Essendon,"Merrett, Jackson",12,9,4,3,1,1,0,3
Essendon,"Merrett, Zach",23,10,5,13,1,0,0,3
Essendon,"Stanton, Brent",25,16,9,9,0,0,0,4
Essendon,"Watson, Jobe",28,16,8,12,1,2,2,2
Essendon,"Zaharakis, David",13,7,1,6,0,0,0,3
Essendon,"Ambrose, Patrick",15,6,4,9,2,0,1,6
Essendon,"Ashby, Jason",7,4,3,3,0,0,0,4
Essendon,"Baguley, Mark",12,6,3,6,0,0,0,4
Essendon,"Bellchambers, Tom",8,3,2,5,1,0,16,0
Essendon,"Colyer, Travis",15,9,4,6,2,0,0,4
Essendon,"Daniher, Joe",7,5,2,2,1,2,0,2
Essendon,"Dempsey, Courtenay",17,11,1,6,0,1,0,3
Essendon,"Fletcher, Dustin",16,11,7,5,0,1,0,1
Essendon,"Gleeson, Martin",12,7,5,5,0,1,0,2
Essendon,"Goddard, Brendon",27,19,2,8,1,1,1,4
Essendon,"Heppell, Dyson",29,21,6,8,1,3,1,5
Essendon,"Hibberd, Michael",17,10,2,7,0,0,0,1
Essendon,"Hooker, Cale",12,6,6,6,0,0,0,2
Essendon,"Howlett, Ben",7,5,1,2,0,0,1,6
Essendon,"Hurley, Michael",23,16,10,7,0,0,0,1
Essendon,"Langford, Kyle",1,0,0,1,0,0,0,0
Essendon,"McKernan, Shaun",12,6,5,6,0,0,10,1
Essendon,"Melksham, Jake",15,11,8,4,1,0,0,2
Essendon,"Merrett, Jackson",12,6,2,6,1,0,0,5
Essendon,"Merrett, Zach",16,5,3,11,0,1,0,6
Essendon,"Stanton, Brent",17,9,2,8,0,0,0,7
Essendon,"Watson, Jobe",19,12,5,7,2,0,5,5
Essendon,"Ambrose, Patrick",11,5,4,6,1,0,4,3
Essendon,"Baguley, Mark",17,9,9,8,0,0,0,0
Essendon,"Bellchambers, Tom",12,10,3,2,0,0,28,2
Essendon,"Carlisle, Jake",11,8,7,3,3,2,1,2
Essendon,"Chapman, Paul",17,11,6,6,1,1,0,2
Essendon,"Colyer, Travis",14,10,3,4,1,0,0,3
Essendon,"Cooney, Adam",19,15,2,4,3,1,1,1
Essendon,"Daniher, Joe",14,10,8,4,6,2,2,1
Essendon,"Dempsey, Courtenay",7,3,1,4,0,0,0,0
Essendon,"Fletcher, Dustin",14,6,2,8,0,0,0,0
Essendon,"Gleeson, Martin",17,7,4,10,0,0,0,3
Essendon,"Goddard, Brendon",21,12,4,9,2,0,1,5
Essendon,"Heppell, Dyson",20,11,5,9,0,1,5,5
Essendon,"Hibberd, Michael",26,12,5,14,1,1,0,4
Essendon,"Hooker, Cale",24,12,9,12,0,0,1,2
Essendon,"Howlett, Ben",25,10,5,15,0,0,0,11
Essendon,"Hurley, Michael",22,17,9,5,0,0,0,2
Essendon,"Melksham, Jake",21,10,4,11,1,0,0,4
Essendon,"Merrett, Jackson",5,4,4,1,1,0,0,5
Essendon,"Merrett, Zach",20,11,5,9,0,0,0,5
Essendon,"Stanton, Brent",25,17,6,8,1,0,0,5
Essendon,"Watson, Jobe",21,9,1,12,0,1,2,3
Essendon,"Ambrose, Patrick",11,4,3,7,0,0,4,6
Essendon,"Baguley, Mark",18,9,7,9,0,0,0,4
Essendon,"Bellchambers, Tom",7,3,2,4,0,0,27,1
Essendon,"Carlisle, Jake",15,8,9,7,1,3,0,1
Essendon,"Chapman, Paul",15,11,3,4,1,1,0,1
Essendon,"Colyer, Travis",19,14,4,5,2,1,0,4
Essendon,"Cooney, Adam",16,13,4,3,0,0,0,0
Essendon,"Daniher, Joe",8,7,7,1,2,0,0,0
Essendon,"Dempsey, Courtenay",15,9,5,6,0,0,0,0
Essendon,"Fletcher, Dustin",10,8,2,2,0,0,0,1
Essendon,"Gleeson, Martin",5,3,1,2,0,0,0,1
Essendon,"Goddard, Brendon",27,13,10,14,0,0,2,2
Essendon,"Heppell, Dyson",25,10,3,15,0,0,4,5
Essendon,"Hibberd, Michael",24,15,5,9,0,0,0,2
Essendon,"Hooker, Cale",16,6,8,10,0,0,0,1
Essendon,"Howlett, Ben",18,7,6,11,0,1,0,6
Essendon,"Hurley, Michael",16,11,6,5,0,0,0,0
Essendon,"Melksham, Jake",21,13,2,8,0,1,0,2
Essendon,"Merrett, Jackson",13,9,6,4,1,0,0,5
Essendon,"Merrett, Zach",20,11,2,9,0,0,0,6
Essendon,"Stanton, Brent",25,15,7,10,0,0,0,1
Essendon,"Watson, Jobe",17,9,1,8,1,0,3,2
Essendon,"Ambrose, Patrick",12,5,3,7,0,1,3,2
Essendon,"Baguley, Mark",18,7,5,11,0,0,0,4
Essendon,"Bellchambers, Tom",3,3,2,0,0,0,16,1
Essendon,"Carlisle, Jake",13,8,6,5,0,0,14,2
Essendon,"Chapman, Paul",14,8,2,6,1,1,0,1
Essendon,"Colyer, Travis",26,15,8,11,0,0,0,2
Essendon,"Cooney, Adam",18,12,3,6,2,1,0,1
Essendon,"Daniher, Joe",15,11,8,4,1,4,1,2
Essendon,"Dempsey, Courtenay",15,7,2,8,0,0,0,2
Essendon,"Fantasia, Orazio",14,7,3,7,0,0,1,6
Essendon,"Gleeson, Martin",9,4,3,5,0,0,0,3
Essendon,"Goddard, Brendon",31,16,5,15,0,0,1,4
Essendon,"Gwilt, James",21,13,5,8,0,0,0,1
Essendon,"Heppell, Dyson",25,17,5,8,2,0,3,4
Essendon,"Hibberd, Michael",26,8,5,18,0,0,0,2
Essendon,"Hooker, Cale",16,9,5,7,0,0,0,0
Essendon,"Howlett, Ben",21,4,1,17,0,0,1,4
Essendon,"Hurley, Michael",17,9,4,8,0,0,0,0
Essendon,"Kavanagh, Elliott",25,10,4,15,0,1,0,2
Essendon,"Melksham, Jake",16,10,2,6,0,0,0,4
Essendon,"Merrett, Zach",27,12,2,15,0,0,0,8
Essendon,"Stanton, Brent",24,16,8,8,1,1,1,3
Essendon,"Ambrose, Patrick",10,4,4,6,0,0,3,8
Essendon,"Baguley, Mark",24,11,10,13,0,0,0,5
Essendon,"Carlisle, Jake",10,4,3,6,0,0,16,1
Essendon,"Chapman, Paul",7,2,1,5,1,0,0,1
Essendon,"Colyer, Travis",10,4,1,6,0,0,0,1
Essendon,"Cooney, Adam",20,13,4,7,0,0,0,4
Essendon,"Daniher, Joe",12,6,6,6,0,1,2,4
Essendon,"Edwards, Shaun",17,12,5,5,2,1,0,1
Essendon,"Fantasia, Orazio",20,7,6,13,0,0,1,4
Essendon,"Gleeson, Martin",8,4,3,4,0,0,0,2
Essendon,"Goddard, Brendon",25,7,3,18,1,1,0,5
Essendon,"Gwilt, James",18,10,4,8,0,0,0,1
Essendon,"Heppell, Dyson",27,16,6,11,1,1,4,8
Essendon,"Hibberd, Michael",25,16,8,9,0,1,0,2
Essendon,"Hooker, Cale",21,12,9,9,0,0,0,4
Essendon,"Howlett, Ben",16,7,3,9,0,1,0,7
Essendon,"Hurley, Michael",22,17,14,5,0,0,0,1
Essendon,"Kavanagh, Elliott",14,7,2,7,0,0,0,6
Essendon,"Melksham, Jake",16,6,3,10,1,0,1,5
Essendon,"Merrett, Zach",29,16,7,13,0,1,0,11
Essendon,"Stanton, Brent",31,22,11,9,0,0,0,9
Essendon,"Watson, Jobe",31,11,7,20,0,1,1,7
Essendon,"Baguley, Mark",15,9,7,6,0,0,0,5
Essendon,"Carlisle, Jake",16,12,8,4,3,1,0,1
Essendon,"Cooney, Adam",17,11,3,6,1,0,0,2
Essendon,"Daniher, Joe",9,6,3,3,1,2,4,2
Essendon,"Dempsey, Courtenay",14,10,4,4,1,1,0,4
Essendon,"Edwards, Shaun",2,0,0,2,0,0,0,1
Essendon,"Gleeson, Martin",20,8,6,12,0,0,0,3
Essendon,"Goddard, Brendon",32,14,11,18,1,1,0,3
Essendon,"Gwilt, James",20,12,8,8,0,0,0,3
Essendon,"Heppell, Dyson",23,7,1,16,0,0,0,5
Essendon,"Hibberd, Michael",22,9,9,13,0,1,0,3
Essendon,"Hooker, Cale",18,9,6,9,0,0,0,3
Essendon,"Hurley, Michael",29,22,9,7,0,0,0,0
Essendon,"Kavanagh, Elliott",6,2,0,4,0,0,0,2
Essendon,"McKernan, Shaun",21,8,5,13,1,1,18,3
Essendon,"Melksham, Jake",16,8,2,8,1,0,0,3
Essendon,"Merrett, Jackson",15,10,5,5,2,1,0,5
Essendon,"Merrett, Zach",31,10,4,21,0,0,0,1
Essendon,"OBrien, Nick",15,5,1,10,0,0,1,1
Essendon,"Stanton, Brent",29,15,7,14,0,0,1,5
Essendon,"Watson, Jobe",18,6,2,12,0,1,0,2
Essendon,"Winderlich, Jason",6,2,1,4,0,0,0,3
Essendon,"Baguley, Mark",14,6,6,8,0,0,0,1
Essendon,"Cooney, Adam",13,8,1,5,1,0,0,4
Essendon,"Daniher, Joe",9,7,4,2,1,1,2,0
Essendon,"Dempsey, Courtenay",4,3,1,1,0,0,0,0
Essendon,"Gleeson, Martin",12,7,6,5,0,0,0,2
Essendon,"Goddard, Brendon",7,3,2,4,0,0,1,1
Essendon,"Gwilt, James",15,8,3,7,0,0,1,1
Essendon,"Heppell, Dyson",32,15,2,17,2,0,2,6
Essendon,"Hibberd, Michael",22,11,5,11,1,0,0,1
Essendon,"Hooker, Cale",15,9,8,6,3,1,2,4
Essendon,"Howlett, Ben",10,4,3,6,0,0,0,4
Essendon,"Hurley, Michael",15,11,4,4,0,0,0,0
Essendon,"Kavanagh, Elliott",9,7,2,2,0,1,0,2
Essendon,"McKernan, Shaun",19,7,3,12,0,0,26,1
Essendon,"Melksham, Jake",16,7,3,9,0,1,0,1
Essendon,"Merrett, Jackson",12,7,4,5,0,0,0,4
Essendon,"Merrett, Zach",16,9,1,7,0,0,0,5
Essendon,"OBrien, Nick",16,4,3,12,0,0,1,3
Essendon,"Stanton, Brent",13,9,3,4,0,0,0,4
Essendon,"Steinberg, Ariel",10,3,2,7,0,0,0,2
Essendon,"Watson, Jobe",9,1,1,8,0,0,2,7
Essendon,"Zaharakis, David",16,6,4,10,0,0,0,1
Essendon,"Ambrose, Patrick",9,3,1,6,0,0,2,8
Essendon,"Ashby, Jason",7,1,1,6,0,0,0,4
Essendon,"Baguley, Mark",18,13,5,5,0,0,0,5
Essendon,"Browne, Alex",6,2,4,4,0,0,0,1
Essendon,"Daniher, Joe",13,8,6,5,5,0,4,3
Essendon,"Edwards, Shaun",9,6,2,3,2,0,0,5
Essendon,"Gleeson, Martin",16,7,3,9,0,0,0,2
Essendon,"Goddard, Brendon",29,11,1,18,0,0,1,4
Essendon,"Gwilt, James",23,15,5,8,0,1,0,1
Essendon,"Heppell, Dyson",19,10,1,9,1,0,5,7
Essendon,"Hibberd, Michael",16,11,6,5,0,0,0,1
Essendon,"Hooker, Cale",18,13,6,5,0,3,1,1
Essendon,"Howlett, Ben",10,6,2,4,1,0,0,7
Essendon,"Hurley, Michael",24,21,9,3,0,1,0,2
Essendon,"Laverde, Jayden",6,2,2,4,0,0,0,4
Essendon,"McKernan, Shaun",18,11,3,7,0,0,20,0
Essendon,"Merrett, Jackson",19,12,4,7,0,0,0,6
Essendon,"Merrett, Zach",21,10,1,11,0,0,0,8
Essendon,"OBrien, Nick",19,7,3,12,0,1,0,5
Essendon,"Stanton, Brent",30,21,4,9,1,0,0,4
Essendon,"Steinberg, Ariel",12,6,3,6,0,0,0,1
Essendon,"Zaharakis, David",13,8,0,5,0,0,0,5
Essendon,"Ambrose, Patrick",9,2,3,7,1,0,0,3
Essendon,"Ashby, Jason",10,4,2,6,0,0,0,3
Essendon,"Baguley, Mark",18,9,5,9,0,0,0,7
Essendon,"Daniher, Joe",10,5,4,5,2,2,0,2
Essendon,"Edwards, Shaun",11,8,2,3,1,0,0,2
Essendon,"Gleeson, Martin",11,10,4,1,0,1,0,4
Essendon,"Goddard, Brendon",27,12,8,15,0,0,0,7
Essendon,"Gwilt, James",16,10,4,6,0,0,0,3
Essendon,"Heppell, Dyson",16,5,4,11,0,0,3,3
Essendon,"Hibberd, Michael",19,9,5,10,0,0,0,1
Essendon,"Hooker, Cale",16,14,13,2,1,4,0,2
Essendon,"Howlett, Ben",12,8,2,4,2,0,0,2
Essendon,"Hurley, Michael",24,18,7,6,1,0,0,1
Essendon,"Langford, Kyle",7,2,1,5,0,0,0,0
Essendon,"Laverde, Jayden",7,1,0,6,1,0,0,5
Essendon,"McKernan, Shaun",15,9,2,6,0,1,16,1
Essendon,"Merrett, Jackson",11,5,1,6,0,0,1,2
Essendon,"Merrett, Zach",26,12,4,14,0,0,0,2
Essendon,"OBrien, Nick",20,12,5,8,0,0,0,2
Essendon,"Stanton, Brent",30,18,4,12,0,1,0,8
Essendon,"Steinberg, Ariel",12,3,4,9,0,0,0,6
Essendon,"Zaharakis, David",22,11,4,11,0,0,0,7
Essendon,"Ambrose, Patrick",9,3,2,6,0,0,0,6
Essendon,"Baguley, Mark",18,5,5,13,0,0,0,1
Essendon,"Browne, Alex",17,10,4,7,1,0,0,3
Essendon,"Daniher, Joe",11,8,5,3,2,1,3,2
Essendon,"Edwards, Shaun",2,1,0,1,1,0,0,0
Essendon,"Gleeson, Martin",13,3,4,10,0,0,0,2
Essendon,"Goddard, Brendon",31,15,6,16,1,1,3,1
Essendon,"Gwilt, James",19,9,2,10,0,0,0,1
Essendon,"Heppell, Dyson",22,16,7,6,1,0,1,4
Essendon,"Hibberd, Michael",23,17,5,6,0,0,0,1
Essendon,"Hooker, Cale",20,14,8,6,3,2,0,4
Essendon,"Howlett, Ben",12,5,2,7,0,1,0,5
Essendon,"Hurley, Michael",19,17,9,2,1,0,0,0
Essendon,"Langford, Kyle",14,6,2,8,2,1,0,4
Essendon,"Laverde, Jayden",9,6,4,3,2,0,1,5
Essendon,"McKernan, Shaun",15,8,2,7,0,1,30,1
Essendon,"Merrett, Jackson",17,9,4,8,1,0,0,0
Essendon,"Merrett, Zach",21,16,2,5,1,2,0,12
Essendon,"OBrien, Nick",32,10,7,22,0,1,0,3
Essendon,"Stanton, Brent",32,26,6,6,0,1,0,3
Essendon,"Steinberg, Ariel",9,2,2,7,0,0,0,2
Essendon,"Zaharakis, David",22,8,3,14,1,2,0,7
Essendon,"Ambrose, Patrick",11,3,3,8,0,1,0,3
Essendon,"Baguley, Mark",18,14,9,4,0,0,0,3
Essendon,"Browne, Alex",4,3,1,1,0,0,1,0
Essendon,"Carlisle, Jake",21,13,12,8,0,0,0,0
Essendon,"Cooney, Adam",19,9,4,10,0,1,0,1
Essendon,"Daniher, Joe",11,9,6,2,1,1,2,1
Essendon,"Giles, Jonathan",11,9,3,2,0,0,25,2
Essendon,"Gleeson, Martin",15,11,7,4,0,0,0,3
Essendon,"Goddard, Brendon",24,14,7,10,0,0,0,2
Essendon,"Gwilt, James",21,15,11,6,0,0,0,0
Essendon,"Heppell, Dyson",34,11,5,23,0,0,3,4
Essendon,"Hibberd, Michael",29,15,6,14,0,1,0,2
Essendon,"Hooker, Cale",19,11,8,8,1,2,0,2
Essendon,"Langford, Kyle",7,4,3,3,1,0,0,5
Essendon,"Laverde, Jayden",16,10,5,6,0,0,0,1
Essendon,"Melksham, Jake",9,3,2,6,0,1,0,0
Essendon,"Merrett, Jackson",9,6,2,3,0,0,1,0
Essendon,"Merrett, Zach",30,11,2,19,1,0,0,6
Essendon,"OBrien, Nick",16,7,1,9,0,0,0,2
Essendon,"Stanton, Brent",32,21,9,11,1,0,0,6
Essendon,"Steinberg, Ariel",15,3,3,12,0,0,0,3
Essendon,"Zaharakis, David",15,8,4,7,0,0,0,4
Essendon,"Baguley, Mark",22,14,10,8,0,0,0,6
Essendon,"Carlisle, Jake",14,11,9,3,0,0,1,2
Essendon,"Cooney, Adam",20,15,6,5,0,0,0,3
Essendon,"Daniher, Joe",10,7,6,3,2,0,2,0
Essendon,"Dempsey, Courtenay",9,5,6,4,0,0,1,3
Essendon,"Edwards, Shaun",16,13,5,3,1,2,0,5
Essendon,"Giles, Jonathan",17,13,1,4,1,1,22,2
Essendon,"Gleeson, Martin",14,7,4,7,0,0,0,1
Essendon,"Goddard, Brendon",32,13,9,19,0,1,1,5
Essendon,"Gwilt, James",20,15,11,5,0,0,0,1
Essendon,"Heppell, Dyson",18,11,4,7,0,0,0,2
Essendon,"Hibberd, Michael",28,17,6,11,0,0,0,0
Essendon,"Hocking, Heath",15,6,5,9,0,1,2,4
Essendon,"Hooker, Cale",16,10,6,6,2,1,1,2
Essendon,"Howlett, Ben",20,10,6,10,2,0,0,8
Essendon,"Langford, Kyle",4,2,2,2,0,0,0,1
Essendon,"Laverde, Jayden",18,8,5,10,0,1,0,3
Essendon,"Merrett, Jackson",11,6,4,5,0,0,0,3
Essendon,"OBrien, Nick",21,13,4,8,0,1,0,0
Essendon,"Stanton, Brent",28,16,5,12,0,1,0,3
Essendon,"Steinberg, Ariel",11,6,5,5,0,0,0,1
Essendon,"Zaharakis, David",20,11,7,9,0,1,0,4
Essendon,"Baguley, Mark",14,6,4,8,0,0,0,1
Essendon,"Carlisle, Jake",18,7,7,11,0,0,0,2
Essendon,"Daniher, Joe",8,4,4,4,0,0,6,2
Essendon,"Dempsey, Courtenay",14,13,7,1,1,0,0,1
Essendon,"Edwards, Shaun",13,10,2,3,1,1,0,2
Essendon,"Giles, Jonathan",8,5,1,3,0,1,20,3
Essendon,"Gleeson, Martin",17,6,4,11,0,0,0,1
Essendon,"Goddard, Brendon",34,13,7,21,0,1,1,5
Essendon,"Heppell, Dyson",30,20,7,10,0,1,1,7
Essendon,"Hibberd, Michael",23,11,6,12,1,0,0,2
Essendon,"Hocking, Heath",15,9,1,6,0,0,0,6
Essendon,"Hooker, Cale",19,11,6,8,2,2,2,3
Essendon,"Howlett, Ben",13,8,3,5,0,0,0,5
Essendon,"Langford, Kyle",6,4,2,2,0,0,0,0
Essendon,"Laverde, Jayden",20,9,8,11,1,0,0,4
Essendon,"Melksham, Jake",9,7,3,2,1,0,0,0
Essendon,"Merrett, Jackson",21,11,9,10,0,1,1,2
Essendon,"Myers, David",22,14,5,8,0,0,0,0
Essendon,"Pears, Tayte",18,7,5,11,0,0,0,1
Essendon,"Stanton, Brent",30,21,7,9,0,0,0,4
Essendon,"Steinberg, Ariel",10,6,2,4,0,0,0,1
Essendon,"Zaharakis, David",22,13,4,9,1,0,0,5
Essendon,"Ambrose, Patrick",10,5,2,5,0,0,1,4
Essendon,"Baguley, Mark",15,8,4,7,0,0,0,5
Essendon,"Carlisle, Jake",15,12,7,3,0,1,1,1
Essendon,"Daniher, Joe",4,2,2,2,0,0,1,0
Essendon,"Dempsey, Courtenay",19,12,7,7,2,3,0,1
Essendon,"Edwards, Shaun",12,6,4,6,0,1,0,3
Essendon,"Fantasia, Orazio",11,7,1,4,2,0,0,2
Essendon,"Gleeson, Martin",13,7,4,6,0,0,0,3
Essendon,"Goddard, Brendon",25,12,8,13,0,0,3,2
Essendon,"Heppell, Dyson",25,15,2,10,3,1,0,5
Essendon,"Hibberd, Michael",20,14,5,6,0,0,0,1
Essendon,"Hocking, Heath",17,8,0,9,0,0,0,1
Essendon,"Hooker, Cale",20,10,6,10,3,1,0,1
Essendon,"Howlett, Ben",24,12,5,12,0,1,0,3
Essendon,"Hurley, Michael",26,17,6,9,0,1,0,0
Essendon,"Laverde, Jayden",12,5,2,7,1,0,0,3
Essendon,"McKernan, Shaun",24,13,9,11,3,0,26,1
Essendon,"Melksham, Jake",18,10,3,8,0,0,0,1
Essendon,"Merrett, Jackson",11,6,2,5,0,1,0,2
Essendon,"OBrien, Nick",31,12,4,19,0,0,0,2
Essendon,"Stanton, Brent",27,17,3,10,0,0,0,3
Essendon,"Zaharakis, David",25,14,6,11,0,0,0,6
Essendon,"Baguley, Mark",18,14,5,4,0,0,0,7
Essendon,"Carlisle, Jake",14,9,6,5,0,1,2,2
Essendon,"Chapman, Paul",19,9,1,10,0,0,0,11
Essendon,"Daniher, Joe",14,11,8,3,0,1,3,2
Essendon,"Dempsey, Courtenay",7,3,0,4,1,0,0,3
Essendon,"Fantasia, Orazio",9,6,1,3,0,0,0,4
Essendon,"Gleeson, Martin",11,7,0,4,0,0,0,1
Essendon,"Goddard, Brendon",27,14,4,13,0,0,1,4
Essendon,"Heppell, Dyson",28,13,0,15,0,1,2,5
Essendon,"Hibberd, Michael",21,13,2,8,0,0,0,0
Essendon,"Hocking, Heath",20,6,5,14,0,0,0,5
Essendon,"Hooker, Cale",16,10,6,6,3,1,0,3
Essendon,"Howlett, Ben",15,9,1,6,1,0,1,9
Essendon,"Hurley, Michael",22,18,4,4,0,0,0,2
Essendon,"Laverde, Jayden",13,5,1,8,0,0,0,6
Essendon,"McKenna, Conor",4,2,2,2,1,0,0,2
Essendon,"McKernan, Shaun",15,8,2,7,1,0,31,2
Essendon,"Melksham, Jake",20,12,4,8,0,0,0,2
Essendon,"Merrett, Jackson",9,4,3,5,0,0,0,1
Essendon,"OBrien, Nick",25,12,1,13,0,0,0,2
Essendon,"Stanton, Brent",29,20,7,9,0,0,0,1
Essendon,"Zaharakis, David",20,12,2,8,0,0,0,4
Essendon,"Baguley, Mark",20,14,6,6,0,0,0,4
Essendon,"Carlisle, Jake",16,11,5,5,0,0,0,3
Essendon,"Daniher, Joe",14,6,5,8,0,2,2,0
Essendon,"Edwards, Shaun",8,6,1,2,0,1,0,0
Essendon,"Fantasia, Orazio",27,14,5,13,0,0,0,2
Essendon,"Gleeson, Martin",13,2,1,11,0,0,0,2
Essendon,"Goddard, Brendon",20,6,2,14,1,0,0,6
Essendon,"Heppell, Dyson",28,8,3,20,0,0,0,4
Essendon,"Hocking, Heath",23,12,4,11,3,1,0,5
Essendon,"Hooker, Cale",14,12,4,2,2,2,0,1
Essendon,"Howlett, Ben",16,4,2,12,0,0,0,6
Essendon,"Hurley, Michael",20,13,4,7,0,0,0,2
Essendon,"Kavanagh, Elliott",10,7,1,3,0,0,0,4
Essendon,"Langford, Kyle",13,5,1,8,0,0,0,5
Essendon,"Laverde, Jayden",16,3,5,13,0,0,1,3
Essendon,"McKenna, Conor",18,11,5,7,1,3,0,1
Essendon,"McKernan, Shaun",26,16,3,10,1,0,29,4
Essendon,"Melksham, Jake",19,10,5,9,1,0,0,2
Essendon,"Merrett, Jackson",12,10,5,2,1,0,0,3
Essendon,"Pears, Tayte",14,6,4,8,0,0,0,1
Essendon,"Stanton, Brent",30,22,8,8,3,1,0,3
Essendon,"Zaharakis, David",20,8,6,12,1,0,0,0
Fremantle,"Ballantyne, Hayden",10,5,1,5,2,0,0,1
Fremantle,"Barlow, Michael",25,15,9,10,0,0,0,2
Fremantle,"Clarke, Zac",10,6,4,4,0,0,11,1
Fremantle,"Duffield, Paul",20,12,2,8,0,0,0,3
Fremantle,"Fyfe, Nat",31,15,4,16,1,1,2,2
Fremantle,"Hill, Stephen",17,10,1,7,0,0,0,2
Fremantle,"Ibbotson, Garrick",15,7,5,8,0,0,1,1
Fremantle,"Johnson, Michael",16,12,1,4,0,0,2,1
Fremantle,"Mayne, Chris",7,1,1,6,0,0,0,5
Fremantle,"McPharlin, Luke",12,8,5,4,0,0,0,1
Fremantle,"Mundy, David",29,15,5,14,0,1,0,4
Fremantle,"Neale, Lachie",22,5,2,17,1,0,0,0
Fremantle,"Pavlich, Matthew",19,14,5,5,4,0,0,2
Fremantle,"Pearce, Clancee",14,8,2,6,0,0,0,4
Fremantle,"Pearce, Danyle",28,17,4,11,2,0,0,3
Fremantle,"Sandilands, Aaron",11,3,4,8,0,0,35,0
Fremantle,"Sheridan, Tom",21,9,3,12,0,0,0,0
Fremantle,"Spurr, Lee",21,12,7,9,0,0,0,0
Fremantle,"Suban, Nick",12,11,3,1,0,2,0,1
Fremantle,"Sutcliffe, Cam",12,4,2,8,0,0,0,2
Fremantle,"Walters, Michael",9,9,1,0,1,2,0,1
Fremantle,"de Boer, Matt",5,2,2,3,0,0,0,5
Fremantle,"Ballantyne, Hayden",12,8,3,4,1,1,0,6
Fremantle,"Barlow, Michael",31,15,13,16,3,1,1,2
Fremantle,"Clarke, Zac",7,3,2,4,0,0,7,0
Fremantle,"Duffield, Paul",22,16,12,6,0,0,0,3
Fremantle,"Fyfe, Nat",36,17,3,19,3,1,1,2
Fremantle,"Hill, Stephen",29,22,6,7,2,1,0,3
Fremantle,"Ibbotson, Garrick",19,13,5,6,0,0,0,0
Fremantle,"Johnson, Michael",24,14,9,10,0,0,0,0
Fremantle,"Mayne, Chris",14,6,7,8,1,1,0,7
Fremantle,"McPharlin, Luke",17,13,8,4,0,0,1,1
Fremantle,"Mundy, David",39,20,6,19,0,0,0,9
Fremantle,"Neale, Lachie",24,10,4,14,0,0,0,6
Fremantle,"Pavlich, Matthew",18,12,7,6,2,1,0,3
Fremantle,"Pearce, Clancee",17,10,6,7,0,0,0,0
Fremantle,"Pearce, Danyle",18,11,4,7,1,0,0,3
Fremantle,"Sandilands, Aaron",11,3,4,8,0,0,51,0
Fremantle,"Spurr, Lee",17,10,3,7,0,0,0,2
Fremantle,"Suban, Nick",17,13,3,4,0,1,0,4
Fremantle,"Sutcliffe, Cam",11,7,4,4,0,0,0,3
Fremantle,"Taberner, Matthew",8,5,3,3,1,1,0,1
Fremantle,"Walters, Michael",15,7,5,8,1,2,0,3
Fremantle,"de Boer, Matt",3,2,0,1,0,0,0,3
Fremantle,"Barlow, Michael",18,7,1,11,0,0,0,2
Fremantle,"Clarke, Zac",15,8,10,7,2,0,8,0
Fremantle,"Crozier, Hayden",3,2,2,1,0,0,0,0
Fremantle,"Duffield, Paul",21,15,8,6,0,0,0,5
Fremantle,"Fyfe, Nat",31,12,4,19,0,1,1,4
Fremantle,"Hill, Stephen",30,21,8,9,3,0,0,7
Fremantle,"Ibbotson, Garrick",22,15,9,7,0,0,0,1
Fremantle,"Johnson, Michael",25,15,9,10,0,0,1,2
Fremantle,"Mayne, Chris",16,6,6,10,2,0,0,2
Fremantle,"McPharlin, Luke",17,13,9,4,0,0,0,0
Fremantle,"Mundy, David",21,15,5,6,0,0,4,6
Fremantle,"Neale, Lachie",42,20,10,22,3,0,0,3
Fremantle,"Pavlich, Matthew",18,10,5,8,0,3,0,2
Fremantle,"Pearce, Clancee",19,16,11,3,0,0,0,1
Fremantle,"Pearce, Danyle",27,21,5,6,1,0,0,4
Fremantle,"Sandilands, Aaron",11,4,4,7,0,0,33,1
Fremantle,"Spurr, Lee",11,5,3,6,0,0,0,1
Fremantle,"Suban, Nick",12,8,4,4,0,0,0,8
Fremantle,"Sutcliffe, Cam",17,10,7,7,0,0,0,0
Fremantle,"Taberner, Matthew",12,10,7,2,3,2,0,0
Fremantle,"Walters, Michael",16,14,6,2,3,2,0,1
Fremantle,"de Boer, Matt",12,3,3,9,0,0,0,6
Fremantle,"Barlow, Michael",10,3,5,7,0,0,0,2
Fremantle,"Clarke, Zac",14,9,5,5,1,0,7,4
Fremantle,"Duffield, Paul",13,9,3,4,0,0,0,1
Fremantle,"Fyfe, Nat",27,15,5,12,1,2,2,6
Fremantle,"Hill, Stephen",21,14,4,7,0,1,0,4
Fremantle,"Ibbotson, Garrick",18,13,9,5,0,0,0,2
Fremantle,"Johnson, Michael",18,14,6,4,0,0,0,0
Fremantle,"Mayne, Chris",12,6,3,6,2,2,0,3
Fremantle,"McPharlin, Luke",16,11,9,5,0,0,1,3
Fremantle,"Mundy, David",22,11,8,11,0,0,2,4
Fremantle,"Mzungu, Tendai",4,3,1,1,0,0,0,2
Fremantle,"Neale, Lachie",9,5,0,4,0,0,0,3
Fremantle,"Pavlich, Matthew",8,5,5,3,3,1,0,4
Fremantle,"Pearce, Clancee",20,15,6,5,1,0,0,0
Fremantle,"Pearce, Danyle",14,8,2,6,0,0,0,2
Fremantle,"Sandilands, Aaron",9,1,2,8,0,0,32,0
Fremantle,"Spurr, Lee",21,16,11,5,0,0,0,0
Fremantle,"Suban, Nick",14,10,1,4,1,1,0,4
Fremantle,"Sutcliffe, Cam",11,7,4,4,1,0,0,1
Fremantle,"Taberner, Matthew",5,3,2,2,1,0,0,1
Fremantle,"Walters, Michael",16,7,3,9,0,1,0,1
Fremantle,"de Boer, Matt",13,3,4,10,0,0,0,7
Fremantle,"Ballantyne, Hayden",9,7,3,2,0,1,0,3
Fremantle,"Barlow, Michael",32,13,6,19,0,1,1,3
Fremantle,"Clarke, Zac",15,7,4,8,0,1,16,1
Fremantle,"Duffield, Paul",18,13,5,5,0,0,0,3
Fremantle,"Fyfe, Nat",30,12,8,18,1,0,1,3
Fremantle,"Hill, Stephen",25,13,3,12,1,0,0,3
Fremantle,"Ibbotson, Garrick",19,10,6,9,0,0,0,1
Fremantle,"Johnson, Michael",19,12,10,7,0,0,0,1
Fremantle,"Mayne, Chris",18,11,9,7,4,1,0,12
Fremantle,"McPharlin, Luke",21,14,10,7,0,0,0,0
Fremantle,"Mundy, David",28,16,5,12,2,0,2,8
Fremantle,"Neale, Lachie",25,15,9,10,2,0,0,5
Fremantle,"Pavlich, Matthew",10,4,4,6,0,1,0,2
Fremantle,"Pearce, Clancee",31,20,10,11,0,0,0,3
Fremantle,"Pearce, Danyle",23,15,9,8,2,1,0,1
Fremantle,"Sandilands, Aaron",10,3,4,7,1,0,19,0
Fremantle,"Spurr, Lee",17,10,4,7,0,0,0,1
Fremantle,"Suban, Nick",22,14,8,8,2,1,1,0
Fremantle,"Sutcliffe, Cam",16,12,7,4,0,0,0,1
Fremantle,"Taberner, Matthew",9,6,6,3,2,0,0,1
Fremantle,"Walters, Michael",3,3,0,0,0,0,0,0
Fremantle,"de Boer, Matt",16,8,6,8,1,0,0,7
Fremantle,"Ballantyne, Hayden",10,9,2,1,2,0,0,3
Fremantle,"Barlow, Michael",23,13,8,10,0,0,0,2
Fremantle,"Clarke, Zac",17,11,9,6,1,1,8,5
Fremantle,"Duffield, Paul",11,5,2,6,0,0,0,5
Fremantle,"Fyfe, Nat",27,12,7,15,0,2,3,2
Fremantle,"Hill, Stephen",20,15,4,5,1,0,0,3
Fremantle,"Ibbotson, Garrick",17,10,5,7,0,0,0,2
Fremantle,"Johnson, Michael",14,10,8,4,0,0,0,1
Fremantle,"Mayne, Chris",12,5,3,7,1,0,0,8
Fremantle,"Mundy, David",28,15,7,13,0,0,3,4
Fremantle,"Neale, Lachie",33,23,7,10,1,0,0,3
Fremantle,"Pavlich, Matthew",16,9,7,7,4,2,0,1
Fremantle,"Pearce, Alex",10,3,6,7,0,0,0,2
Fremantle,"Pearce, Clancee",26,14,8,12,1,0,0,3
Fremantle,"Pearce, Danyle",24,18,3,6,0,0,0,2
Fremantle,"Sandilands, Aaron",12,3,3,9,0,0,33,0
Fremantle,"Spurr, Lee",29,17,8,12,0,0,0,3
Fremantle,"Suban, Nick",14,6,2,8,0,0,0,3
Fremantle,"Sutcliffe, Cam",21,11,4,10,0,0,0,2
Fremantle,"Taberner, Matthew",6,3,3,3,0,0,0,2
Fremantle,"Walters, Michael",16,9,0,7,1,1,0,3
Fremantle,"de Boer, Matt",4,2,1,2,0,0,0,0
Fremantle,"Ballantyne, Hayden",13,8,2,5,0,3,0,3
Fremantle,"Barlow, Michael",24,10,3,14,0,0,0,6
Fremantle,"Clarke, Zac",17,11,9,6,1,0,14,1
Fremantle,"Duffield, Paul",1,0,0,1,0,0,0,5
Fremantle,"Fyfe, Nat",30,12,7,18,3,1,0,3
Fremantle,"Hill, Stephen",20,12,2,8,0,1,0,1
Fremantle,"Ibbotson, Garrick",17,9,5,8,0,0,0,2
Fremantle,"Johnson, Michael",29,21,14,8,0,0,1,1
Fremantle,"Mayne, Chris",15,6,4,9,1,0,0,10
Fremantle,"Mundy, David",20,11,1,9,0,0,3,3
Fremantle,"Neale, Lachie",29,13,7,16,0,0,0,4
Fremantle,"Pavlich, Matthew",17,11,9,6,5,2,0,0
Fremantle,"Pearce, Alex",8,5,4,3,0,0,1,0
Fremantle,"Pearce, Clancee",25,19,10,6,1,0,0,0
Fremantle,"Pearce, Danyle",26,19,8,7,1,1,0,4
Fremantle,"Sandilands, Aaron",10,2,4,8,0,0,50,1
Fremantle,"Sheridan, Tom",14,9,3,5,0,0,0,1
Fremantle,"Spurr, Lee",17,12,5,5,0,0,0,3
Fremantle,"Suban, Nick",12,11,3,1,0,1,0,1
Fremantle,"Sutcliffe, Cam",20,7,4,13,0,0,0,2
Fremantle,"Taberner, Matthew",7,6,6,1,1,0,0,1
Fremantle,"Walters, Michael",16,12,5,4,2,0,0,3
Fremantle,"Ballantyne, Hayden",20,12,0,8,1,1,0,4
Fremantle,"Barlow, Michael",30,10,7,20,2,1,0,5
Fremantle,"Clarke, Zac",11,4,4,7,0,0,10,2
Fremantle,"Duffield, Paul",8,4,3,4,0,0,0,3
Fremantle,"Fyfe, Nat",37,13,5,24,0,1,3,3
Fremantle,"Hill, Stephen",26,12,4,14,0,2,0,0
Fremantle,"Ibbotson, Garrick",20,12,8,8,0,0,0,1
Fremantle,"Johnson, Michael",24,14,8,10,0,0,0,0
Fremantle,"Mayne, Chris",12,5,2,7,2,0,0,5
Fremantle,"McPharlin, Luke",16,11,8,5,0,0,0,0
Fremantle,"Mundy, David",27,14,8,13,2,1,4,3
Fremantle,"Neale, Lachie",34,23,7,11,1,0,0,8
Fremantle,"Pavlich, Matthew",7,5,0,2,1,1,0,0
Fremantle,"Pearce, Clancee",28,15,9,13,0,0,0,2
Fremantle,"Pearce, Danyle",25,17,5,8,0,1,0,4
Fremantle,"Sandilands, Aaron",13,2,4,11,1,1,30,1
Fremantle,"Sheridan, Tom",9,6,4,3,1,0,0,0
Fremantle,"Spurr, Lee",12,6,2,6,0,0,0,2
Fremantle,"Suban, Nick",21,15,2,6,0,1,0,5
Fremantle,"Sutcliffe, Cam",16,5,6,11,0,0,0,3
Fremantle,"Taberner, Matthew",13,6,4,7,2,1,0,0
Fremantle,"Walters, Michael",16,10,4,6,4,0,0,3
Fremantle,"Ballantyne, Hayden",10,8,3,2,1,1,0,7
Fremantle,"Barlow, Michael",23,12,2,11,1,0,0,5
Fremantle,"Clarke, Zac",1,1,0,0,0,0,12,4
Fremantle,"Duffield, Paul",13,7,3,6,0,0,0,4
Fremantle,"Fyfe, Nat",40,26,4,14,1,1,3,6
Fremantle,"Hill, Stephen",19,12,4,7,0,0,0,4
Fremantle,"Ibbotson, Garrick",14,10,6,4,0,0,1,6
Fremantle,"Johnson, Michael",16,11,3,5,0,0,0,1
Fremantle,"Mayne, Chris",14,4,2,10,0,0,0,2
Fremantle,"McPharlin, Luke",20,9,6,11,0,0,0,0
Fremantle,"Mundy, David",22,12,4,10,1,1,1,1
Fremantle,"Neale, Lachie",24,15,3,9,0,0,0,1
Fremantle,"Pavlich, Matthew",12,5,3,7,2,0,0,2
Fremantle,"Pearce, Clancee",15,9,5,6,0,0,0,3
Fremantle,"Pearce, Danyle",17,11,3,6,0,2,0,6
Fremantle,"Sandilands, Aaron",7,1,1,6,0,0,69,3
Fremantle,"Sheridan, Tom",14,7,2,7,0,0,0,1
Fremantle,"Spurr, Lee",12,11,4,1,0,0,0,0
Fremantle,"Suban, Nick",19,15,1,4,1,0,0,7
Fremantle,"Sutcliffe, Cam",12,7,2,5,0,0,0,3
Fremantle,"Taberner, Matthew",5,1,1,4,0,0,0,1
Fremantle,"Walters, Michael",12,10,2,2,3,0,0,5
Fremantle,"Ballantyne, Hayden",15,11,2,4,1,1,0,7
Fremantle,"Barlow, Michael",20,12,4,8,1,0,2,5
Fremantle,"Clarke, Zac",6,2,2,4,0,0,13,1
Fremantle,"Crozier, Hayden",10,7,1,3,2,0,0,5
Fremantle,"Duffield, Paul",9,6,2,3,0,0,0,3
Fremantle,"Fyfe, Nat",26,12,3,14,1,0,3,6
Fremantle,"Hill, Stephen",21,17,2,4,0,0,0,0
Fremantle,"Ibbotson, Garrick",15,8,2,7,0,0,0,0
Fremantle,"Johnson, Michael",1,1,0,0,0,0,0,0
Fremantle,"Mayne, Chris",14,4,3,10,0,0,0,0
Fremantle,"McPharlin, Luke",12,6,4,6,0,0,0,0
Fremantle,"Mundy, David",19,13,2,6,0,0,7,8
Fremantle,"Neale, Lachie",28,16,3,12,0,0,0,3
Fremantle,"Pavlich, Matthew",11,4,2,7,0,2,0,3
Fremantle,"Pearce, Clancee",13,7,3,6,0,0,0,2
Fremantle,"Pearce, Danyle",13,7,1,6,0,0,0,2
Fremantle,"Sandilands, Aaron",8,2,4,6,1,0,47,1
Fremantle,"Sheridan, Tom",12,6,2,6,0,0,0,3
Fremantle,"Suban, Nick",12,6,0,6,0,1,0,2
Fremantle,"Sutcliffe, Cam",13,8,3,5,0,0,0,1
Fremantle,"Taberner, Matthew",13,10,3,3,1,0,0,2
Fremantle,"Walters, Michael",13,7,3,6,3,3,0,3
Fremantle,"Ballantyne, Hayden",13,11,3,2,0,3,0,4
Fremantle,"Barlow, Michael",14,6,2,8,0,1,0,4
Fremantle,"Crozier, Hayden",10,4,1,6,1,2,0,5
Fremantle,"Fyfe, Nat",31,18,3,13,2,0,2,5
Fremantle,"Hannath, Jack",10,6,2,4,1,1,7,1
Fremantle,"Hill, Stephen",23,14,4,9,0,1,0,6
Fremantle,"Ibbotson, Garrick",23,16,11,7,0,0,1,2
Fremantle,"McPharlin, Luke",20,11,7,9,0,0,1,1
Fremantle,"Mundy, David",25,11,4,14,0,0,3,7
Fremantle,"Mzungu, Tendai",21,9,3,12,0,0,0,5
Fremantle,"Neale, Lachie",23,17,2,6,1,2,0,8
Fremantle,"Pavlich, Matthew",15,10,6,5,0,2,0,2
Fremantle,"Pearce, Alex",16,8,9,8,0,0,0,2
Fremantle,"Pearce, Clancee",20,14,8,6,0,0,0,6
Fremantle,"Pearce, Danyle",19,10,2,9,0,0,0,2
Fremantle,"Sandilands, Aaron",10,2,2,8,0,0,70,2
Fremantle,"Sheridan, Tom",20,13,3,7,0,0,0,3
Fremantle,"Spurr, Lee",24,18,11,6,0,0,0,0
Fremantle,"Suban, Nick",3,3,0,0,1,0,0,4
Fremantle,"Sutcliffe, Cam",25,14,6,11,0,0,0,6
Fremantle,"Taberner, Matthew",6,4,1,2,0,0,0,1
Fremantle,"Walters, Michael",17,8,4,9,0,1,0,5
Fremantle,"Ballantyne, Hayden",8,5,2,3,1,0,0,6
Fremantle,"Barlow, Michael",21,12,6,9,1,0,0,9
Fremantle,"Crozier, Hayden",6,5,2,1,0,0,0,2
Fremantle,"Fyfe, Nat",32,14,2,18,2,0,4,2
Fremantle,"Hannath, Jack",8,4,1,4,0,0,10,2
Fremantle,"Hill, Stephen",24,18,4,6,2,0,0,2
Fremantle,"Ibbotson, Garrick",23,17,9,6,0,0,0,1
Fremantle,"Mayne, Chris",22,8,3,14,0,1,0,6
Fremantle,"McPharlin, Luke",9,5,3,4,0,0,0,0
Fremantle,"Mundy, David",22,13,1,9,0,0,1,9
Fremantle,"Neale, Lachie",34,23,5,11,1,2,0,1
Fremantle,"Pavlich, Matthew",14,7,4,7,0,2,0,3
Fremantle,"Pearce, Alex",8,4,1,4,0,0,1,0
Fremantle,"Pearce, Clancee",22,14,6,8,1,1,0,2
Fremantle,"Pearce, Danyle",14,7,2,7,0,0,0,2
Fremantle,"Sandilands, Aaron",17,0,4,17,0,0,50,3
Fremantle,"Sheridan, Tom",14,8,1,6,0,0,0,1
Fremantle,"Spurr, Lee",18,7,3,11,0,0,0,2
Fremantle,"Suban, Nick",6,5,0,1,0,0,0,4
Fremantle,"Sutcliffe, Cam",15,13,5,2,0,0,0,1
Fremantle,"Walters, Michael",13,7,2,6,4,0,0,2
Fremantle,"de Boer, Matt",21,10,3,11,0,1,1,8
Fremantle,"Ballantyne, Hayden",9,6,1,3,1,1,0,7
Fremantle,"Barlow, Michael",23,8,2,15,1,0,0,6
Fremantle,"Clarke, Zac",14,5,5,9,1,0,19,3
Fremantle,"Duffield, Paul",19,12,4,7,0,0,0,9
Fremantle,"Fyfe, Nat",27,19,1,8,0,0,6,5
Fremantle,"Hill, Stephen",17,9,0,8,0,0,0,3
Fremantle,"Ibbotson, Garrick",20,14,5,6,0,0,0,0
Fremantle,"Mayne, Chris",10,7,6,3,0,2,0,14
Fremantle,"McPharlin, Luke",13,8,5,5,0,0,0,2
Fremantle,"Mundy, David",30,14,1,16,0,0,3,8
Fremantle,"Neale, Lachie",27,14,6,13,1,0,0,6
Fremantle,"Pavlich, Matthew",11,6,2,5,3,1,0,3
Fremantle,"Pearce, Alex",13,5,2,8,0,0,0,0
Fremantle,"Pearce, Clancee",23,13,6,10,0,0,0,4
Fremantle,"Pearce, Danyle",19,14,3,5,2,0,0,6
Fremantle,"Sandilands, Aaron",14,2,1,12,0,1,53,3
Fremantle,"Sheridan, Tom",16,9,1,7,0,0,0,5
Fremantle,"Spurr, Lee",24,15,6,9,0,0,0,6
Fremantle,"Suban, Nick",16,12,2,4,0,0,0,9
Fremantle,"Taberner, Matthew",3,1,2,2,0,0,0,2
Fremantle,"Walters, Michael",16,11,3,5,4,0,0,7
Fremantle,"de Boer, Matt",11,8,1,3,0,0,0,6
Fremantle,"Ballantyne, Hayden",9,6,2,3,0,1,0,2
Fremantle,"Barlow, Michael",26,13,7,13,1,1,1,4
Fremantle,"Clarke, Zac",9,2,0,7,0,0,10,3
Fremantle,"Duffield, Paul",14,9,4,5,0,0,0,7
Fremantle,"Fyfe, Nat",20,11,3,9,0,1,1,3
Fremantle,"Hill, Stephen",21,14,0,7,0,0,0,3
Fremantle,"Ibbotson, Garrick",10,7,3,3,0,0,0,0
Fremantle,"Mayne, Chris",9,4,7,5,1,0,0,6
Fremantle,"McPharlin, Luke",14,9,7,5,0,0,0,0
Fremantle,"Mundy, David",24,12,5,12,1,0,1,3
Fremantle,"Mzungu, Tendai",15,10,3,5,0,0,0,6
Fremantle,"Neale, Lachie",20,7,3,13,1,1,0,5
Fremantle,"Pavlich, Matthew",19,10,7,9,1,2,0,0
Fremantle,"Pearce, Alex",9,3,3,6,0,0,0,1
Fremantle,"Pearce, Clancee",7,5,2,2,0,0,0,1
Fremantle,"Pearce, Danyle",14,7,3,7,0,0,0,4
Fremantle,"Sandilands, Aaron",16,5,3,11,0,0,45,0
Fremantle,"Sheridan, Tom",14,7,2,7,0,0,0,2
Fremantle,"Spurr, Lee",9,6,3,3,0,0,0,4
Fremantle,"Suban, Nick",7,7,3,0,0,0,0,0
Fremantle,"Walters, Michael",10,7,3,3,1,0,0,0
Fremantle,"de Boer, Matt",12,4,3,8,0,0,0,4
Fremantle,"Ballantyne, Hayden",4,2,1,2,1,0,0,1
Fremantle,"Barlow, Michael",20,10,3,10,0,0,0,7
Fremantle,"Crozier, Hayden",7,4,1,3,0,0,0,1
Fremantle,"Fyfe, Nat",23,11,3,12,0,1,1,2
Fremantle,"Griffin, Jonathon",7,4,3,3,1,0,12,5
Fremantle,"Hill, Stephen",28,19,6,9,1,1,0,4
Fremantle,"Ibbotson, Garrick",24,12,5,12,0,0,0,0
Fremantle,"Mayne, Chris",18,12,6,6,4,1,0,9
Fremantle,"McPharlin, Luke",17,10,6,7,0,0,2,1
Fremantle,"Mundy, David",30,13,1,17,1,0,3,9
Fremantle,"Neale, Lachie",31,9,7,22,0,0,0,4
Fremantle,"Pavlich, Matthew",18,13,4,5,2,5,0,1
Fremantle,"Pearce, Alex",15,7,2,8,0,0,1,2
Fremantle,"Pearce, Danyle",24,16,3,8,1,0,0,2
Fremantle,"Sandilands, Aaron",12,1,5,11,1,0,46,3
Fremantle,"Sheridan, Tom",17,11,2,6,0,0,0,4
Fremantle,"Spurr, Lee",25,16,7,9,0,1,0,4
Fremantle,"Suban, Nick",14,8,2,6,0,1,1,7
Fremantle,"Sutcliffe, Cam",15,7,3,8,0,0,0,4
Fremantle,"Taberner, Matthew",8,7,4,1,0,1,0,5
Fremantle,"Walters, Michael",22,15,4,7,1,3,0,3
Fremantle,"de Boer, Matt",11,3,2,8,0,0,0,6
Fremantle,"Barlow, Michael",26,16,5,10,1,1,0,3
Fremantle,"Crozier, Hayden",12,7,4,5,2,0,0,5
Fremantle,"Fyfe, Nat",25,12,4,13,1,1,0,10
Fremantle,"Griffin, Jonathon",12,5,4,7,0,0,10,4
Fremantle,"Hill, Stephen",24,19,2,5,1,0,0,4
Fremantle,"Ibbotson, Garrick",18,10,4,8,0,0,1,3
Fremantle,"Mayne, Chris",13,7,9,6,1,2,0,3
Fremantle,"McPharlin, Luke",12,6,3,6,0,0,0,2
Fremantle,"Mundy, David",28,9,3,19,1,0,1,6
Fremantle,"Neale, Lachie",16,6,2,10,0,0,0,5
Fremantle,"Pavlich, Matthew",16,10,2,6,3,0,0,2
Fremantle,"Pearce, Alex",9,5,3,4,0,0,0,1
Fremantle,"Pearce, Clancee",8,1,1,7,0,0,0,5
Fremantle,"Pearce, Danyle",18,13,2,5,0,2,0,2
Fremantle,"Sandilands, Aaron",10,1,4,9,0,0,34,3
Fremantle,"Sheridan, Tom",21,11,6,10,1,1,1,2
Fremantle,"Spurr, Lee",8,3,2,5,0,0,0,3
Fremantle,"Suban, Nick",16,12,2,4,0,0,0,10
Fremantle,"Sutcliffe, Cam",10,4,4,6,0,0,0,3
Fremantle,"Taberner, Matthew",7,5,4,2,1,0,2,1
Fremantle,"Walters, Michael",12,8,2,4,0,0,0,1
Fremantle,"de Boer, Matt",4,0,1,4,0,0,0,0
Fremantle,"Barlow, Michael",30,9,6,21,0,1,1,6
Fremantle,"Crozier, Hayden",13,9,2,4,0,1,0,2
Fremantle,"Dawson, Zac",14,3,5,11,0,0,0,0
Fremantle,"Griffin, Jonathon",10,2,3,8,1,0,21,1
Fremantle,"Hill, Stephen",32,18,3,14,0,1,0,1
Fremantle,"Ibbotson, Garrick",18,11,5,7,0,0,0,0
Fremantle,"Mayne, Chris",12,6,6,6,2,1,1,4
Fremantle,"McPharlin, Luke",27,12,13,15,0,0,0,1
Fremantle,"Mundy, David",31,15,2,16,1,0,2,4
Fremantle,"Mzungu, Tendai",16,11,5,5,0,0,0,7
Fremantle,"Neale, Lachie",38,18,10,20,0,1,0,5
Fremantle,"Pavlich, Matthew",17,9,2,8,2,2,0,2
Fremantle,"Pearce, Alex",12,9,5,3,1,0,0,3
Fremantle,"Pearce, Danyle",26,19,5,7,1,1,0,2
Fremantle,"Sandilands, Aaron",21,5,6,16,0,0,43,2
Fremantle,"Sheridan, Tom",27,15,5,12,0,0,0,3
Fremantle,"Spurr, Lee",32,20,4,12,0,0,0,2
Fremantle,"Suban, Nick",19,12,2,7,0,1,0,3
Fremantle,"Sutcliffe, Cam",13,8,3,5,0,1,0,2
Fremantle,"Walters, Michael",14,13,5,1,4,0,0,2
Fremantle,"Weller, Lachie",8,4,3,4,0,0,0,2
Fremantle,"de Boer, Matt",25,5,4,20,0,0,0,7
Fremantle,"Barlow, Michael",26,9,4,17,0,0,0,1
Fremantle,"Crozier, Hayden",14,6,4,8,2,0,0,5
Fremantle,"Griffin, Jonathon",9,5,2,4,2,0,8,2
Fremantle,"Hill, Stephen",29,21,9,8,2,0,0,4
Fremantle,"Ibbotson, Garrick",28,21,11,7,0,0,0,3
Fremantle,"Mayne, Chris",14,7,6,7,2,0,0,2
Fremantle,"McPharlin, Luke",9,6,5,3,0,0,0,2
Fremantle,"Mundy, David",33,14,8,19,0,0,0,5
Fremantle,"Mzungu, Tendai",18,9,6,9,1,0,0,5
Fremantle,"Neale, Lachie",36,16,6,20,0,1,0,1
Fremantle,"Pavlich, Matthew",12,8,5,4,2,0,0,2
Fremantle,"Pearce, Alex",13,11,9,2,1,2,0,4
Fremantle,"Pearce, Danyle",24,18,8,6,0,0,0,1
Fremantle,"Sandilands, Aaron",17,4,5,13,2,0,38,0
Fremantle,"Sheridan, Tom",17,11,5,6,0,0,0,2
Fremantle,"Silvagni, Alex",17,12,10,5,0,0,0,2
Fremantle,"Spurr, Lee",15,10,4,5,0,0,0,4
Fremantle,"Suban, Nick",22,12,3,10,1,0,0,3
Fremantle,"Sutcliffe, Cam",21,8,10,13,0,0,0,2
Fremantle,"Walters, Michael",17,8,6,9,0,1,0,2
Fremantle,"Weller, Lachie",7,3,1,4,0,0,0,0
Fremantle,"de Boer, Matt",19,8,5,11,0,0,0,9
Fremantle,"Barlow, Michael",4,2,0,2,0,0,0,2
Fremantle,"Crozier, Hayden",5,4,3,1,0,0,0,0
Fremantle,"Fyfe, Nat",26,17,7,9,0,1,0,5
Fremantle,"Griffin, Jonathon",8,4,2,4,1,0,16,3
Fremantle,"Hill, Stephen",28,17,7,11,1,0,0,6
Fremantle,"Ibbotson, Garrick",16,10,7,6,0,0,0,1
Fremantle,"Johnson, Michael",11,7,6,4,0,0,0,0
Fremantle,"Mayne, Chris",14,6,5,8,1,1,0,6
Fremantle,"Mundy, David",28,15,4,13,1,0,1,7
Fremantle,"Mzungu, Tendai",15,8,3,7,0,0,0,4
Fremantle,"Neale, Lachie",24,15,6,9,0,2,0,1
Fremantle,"Pavlich, Matthew",15,9,7,6,2,0,0,3
Fremantle,"Pearce, Alex",8,4,2,4,0,1,0,2
Fremantle,"Pearce, Danyle",10,8,2,2,0,0,0,5
Fremantle,"Sandilands, Aaron",15,2,2,13,0,2,51,1
Fremantle,"Sheridan, Tom",20,16,6,4,1,0,0,3
Fremantle,"Silvagni, Alex",5,2,1,3,0,0,0,1
Fremantle,"Spurr, Lee",20,16,8,4,0,0,0,3
Fremantle,"Suban, Nick",14,11,3,3,0,2,0,3
Fremantle,"Sutcliffe, Cam",18,14,6,4,0,1,0,2
Fremantle,"Walters, Michael",16,14,5,2,4,1,0,2
Fremantle,"de Boer, Matt",15,4,7,11,0,1,0,7
Fremantle,"Barlow, Michael",23,12,6,11,1,1,0,5
Fremantle,"Crozier, Hayden",7,5,2,2,0,0,0,4
Fremantle,"Dawson, Zac",4,1,2,3,0,0,0,0
Fremantle,"Fyfe, Nat",21,5,4,16,1,0,3,7
Fremantle,"Griffin, Jonathon",7,5,4,2,2,0,5,1
Fremantle,"Hill, Stephen",23,17,2,6,1,1,0,2
Fremantle,"Ibbotson, Garrick",13,10,6,3,0,0,0,1
Fremantle,"Johnson, Michael",24,16,7,8,1,0,0,0
Fremantle,"Mayne, Chris",13,10,6,3,1,1,0,6
Fremantle,"McPharlin, Luke",10,6,5,4,0,0,0,1
Fremantle,"Mundy, David",23,11,4,12,0,1,3,3
Fremantle,"Mzungu, Tendai",10,5,3,5,0,1,0,2
Fremantle,"Neale, Lachie",29,14,5,15,0,1,0,3
Fremantle,"Pearce, Alex",5,3,2,2,1,0,0,2
Fremantle,"Pearce, Danyle",12,10,2,2,0,0,0,0
Fremantle,"Sandilands, Aaron",14,2,4,12,2,0,43,5
Fremantle,"Sheridan, Tom",10,6,4,4,0,0,0,0
Fremantle,"Spurr, Lee",16,13,9,3,0,0,0,4
Fremantle,"Suban, Nick",11,7,2,4,0,1,0,5
Fremantle,"Sutcliffe, Cam",18,10,6,8,0,1,0,2
Fremantle,"Walters, Michael",21,16,8,5,2,0,0,3
Fremantle,"de Boer, Matt",2,1,1,1,0,0,0,4
Fremantle,"Barlow, Michael",31,14,5,17,1,0,0,6
Fremantle,"Dawson, Zac",6,1,1,5,0,0,0,3
Fremantle,"Duffield, Paul",6,6,0,0,0,1,0,2
Fremantle,"Griffin, Jonathon",7,5,1,2,0,0,11,2
Fremantle,"Hill, Stephen",30,18,4,12,1,1,0,3
Fremantle,"Ibbotson, Garrick",20,17,8,3,1,0,0,2
Fremantle,"Johnson, Michael",17,13,11,4,0,0,0,1
Fremantle,"Langdon, Ed",18,11,6,7,0,1,0,3
Fremantle,"Mayne, Chris",18,5,5,13,1,1,1,6
Fremantle,"McPharlin, Luke",21,11,11,10,0,0,0,2
Fremantle,"Mundy, David",35,12,5,23,0,0,2,4
Fremantle,"Mzungu, Tendai",22,11,1,11,1,0,0,5
Fremantle,"Neale, Lachie",34,11,4,23,2,0,0,5
Fremantle,"Pavlich, Matthew",20,8,4,12,3,0,0,0
Fremantle,"Pearce, Clancee",27,6,4,21,0,0,0,2
Fremantle,"Pearce, Danyle",24,20,6,4,3,1,0,2
Fremantle,"Sandilands, Aaron",14,2,4,12,1,0,43,1
Fremantle,"Sheridan, Tom",20,16,5,4,1,0,0,6
Fremantle,"Spurr, Lee",18,12,11,6,0,0,0,0
Fremantle,"Suban, Nick",25,13,5,12,0,0,0,5
Fremantle,"Sutcliffe, Cam",12,5,3,7,0,0,0,1
Fremantle,"de Boer, Matt",15,6,3,9,2,0,0,9
Fremantle,"Ballard, Jacob",6,1,1,5,0,0,0,0
Fremantle,"Barlow, Michael",35,17,4,18,1,0,1,7
Fremantle,"Blakely, Connor",12,3,1,9,0,0,1,1
Fremantle,"Clarke, Zac",4,1,0,3,0,0,16,0
Fremantle,"Crozier, Hayden",5,5,1,0,0,0,0,2
Fremantle,"Duffield, Paul",25,17,6,8,0,0,0,1
Fremantle,"Duffy, Max",12,5,3,7,1,0,0,1
Fremantle,"Grey, Brady",20,11,3,9,0,0,0,3
Fremantle,"Hannath, Jack",11,6,3,5,0,0,13,2
Fremantle,"Hughes, Ethan",22,12,8,10,0,0,0,3
Fremantle,"Ibbotson, Garrick",9,6,5,3,0,1,0,1
Fremantle,"Langdon, Ed",14,9,6,5,0,1,0,2
Fremantle,"Mzungu, Tendai",20,9,5,11,0,0,0,2
Fremantle,"Neale, Lachie",22,7,1,15,1,0,0,3
Fremantle,"Pearce, Alex",12,6,2,6,0,0,0,1
Fremantle,"Pearce, Clancee",18,6,2,12,1,0,0,3
Fremantle,"Sheridan, Tom",24,16,7,8,0,0,0,1
Fremantle,"Smith, Tanner",17,11,8,6,0,0,0,2
Fremantle,"Suban, Nick",14,12,0,2,1,1,0,4
Fremantle,"Taberner, Matthew",15,12,3,3,2,2,0,1
Fremantle,"Weller, Lachie",16,7,3,9,0,0,0,5
Fremantle,"de Boer, Matt",20,7,3,13,1,0,1,5
Fremantle,"Ballantyne, Hayden",16,11,6,5,3,0,0,2
Fremantle,"Barlow, Michael",18,8,4,10,1,0,0,4
Fremantle,"Clarke, Zac",8,3,3,5,1,0,11,3
Fremantle,"Dawson, Zac",10,3,3,7,0,0,1,3
Fremantle,"Fyfe, Nat",32,15,4,17,0,0,3,4
Fremantle,"Hill, Stephen",26,18,4,8,0,0,0,0
Fremantle,"Ibbotson, Garrick",17,10,6,7,0,0,0,0
Fremantle,"Johnson, Michael",18,12,9,6,0,0,0,0
Fremantle,"Mayne, Chris",11,4,4,7,1,2,0,5
Fremantle,"Mundy, David",27,10,3,17,0,0,1,1
Fremantle,"Mzungu, Tendai",14,11,6,3,0,0,0,6
Fremantle,"Neale, Lachie",32,11,3,21,1,0,0,2
Fremantle,"Pavlich, Matthew",16,11,5,5,0,1,0,1
Fremantle,"Pearce, Clancee",3,0,0,3,0,0,0,0
Fremantle,"Pearce, Danyle",20,15,1,5,0,1,0,0
Fremantle,"Sandilands, Aaron",17,1,3,16,0,0,43,3
Fremantle,"Sheridan, Tom",25,16,4,9,0,1,0,3
Fremantle,"Spurr, Lee",14,9,6,5,0,1,0,5
Fremantle,"Suban, Nick",4,2,0,2,0,0,1,1
Fremantle,"Sutcliffe, Cam",12,7,6,5,0,0,0,4
Fremantle,"Walters, Michael",21,14,3,7,3,0,0,2
Fremantle,"de Boer, Matt",22,6,3,16,0,0,0,7
Fremantle,"Ballantyne, Hayden",11,10,5,1,1,0,0,3
Fremantle,"Barlow, Michael",17,7,4,10,1,1,1,5
Fremantle,"Dawson, Zac",11,2,2,9,0,0,0,0
Fremantle,"Fyfe, Nat",24,7,3,17,0,0,3,6
Fremantle,"Griffin, Jonathon",14,8,4,6,2,1,7,0
Fremantle,"Hill, Stephen",19,12,5,7,1,0,0,2
Fremantle,"Ibbotson, Garrick",24,19,15,5,0,0,0,0
Fremantle,"Johnson, Michael",15,7,3,8,0,0,0,1
Fremantle,"Mayne, Chris",12,6,4,6,1,1,0,1
Fremantle,"Mundy, David",27,10,2,17,0,0,0,3
Fremantle,"Mzungu, Tendai",23,9,4,14,0,0,0,6
Fremantle,"Neale, Lachie",22,7,2,15,0,0,0,1
Fremantle,"Pavlich, Matthew",11,8,4,3,1,0,0,5
Fremantle,"Pearce, Danyle",21,16,3,5,0,0,0,2
Fremantle,"Sandilands, Aaron",13,0,2,13,0,0,40,1
Fremantle,"Sheridan, Tom",22,15,6,7,0,0,0,3
Fremantle,"Spurr, Lee",27,20,11,7,0,0,0,2
Fremantle,"Suban, Nick",8,6,0,2,0,0,0,0
Fremantle,"Sutcliffe, Cam",12,7,3,5,0,0,0,1
Fremantle,"Taberner, Matthew",8,4,2,4,0,0,0,1
Fremantle,"Walters, Michael",21,16,3,5,3,2,0,2
Fremantle,"de Boer, Matt",20,10,3,10,0,0,0,6
Gold Coast,"Ablett, Gary",19,12,1,7,2,0,0,0
Gold Coast,"Bennell, Harley",21,11,3,10,1,0,1,1
Gold Coast,"Broughton, Greg",11,3,2,8,0,0,0,3
Gold Coast,"Day, Sam",4,4,3,0,2,1,0,0
Gold Coast,"Garlett, Jarrod",5,3,1,2,0,0,0,0
Gold Coast,"Gorringe, Daniel",12,5,3,7,1,0,4,5
Gold Coast,"Hallahan, Mitch",16,9,3,7,0,1,0,5
Gold Coast,"Harbrow, Jarrod",16,9,6,7,1,0,0,4
Gold Coast,"Kolodjashnij, Kade",13,7,3,6,0,0,0,0
Gold Coast,"Malceski, Nick",18,16,6,2,0,0,0,3
Gold Coast,"Martin, Jack",11,7,7,4,0,1,1,4
Gold Coast,"May, Steven",17,10,5,7,0,0,0,1
Gold Coast,"McKenzie, Trent",15,9,3,6,0,0,0,2
Gold Coast,"Miller, Touk",6,5,2,1,1,1,0,4
Gold Coast,"Prestia, Dion",29,19,3,10,0,2,0,4
Gold Coast,"Rischitelli, Michael",21,16,6,5,2,1,1,2
Gold Coast,"Saad, Adam",13,8,4,5,1,0,0,4
Gold Coast,"Sexton, Alex",8,8,6,0,1,1,0,3
Gold Coast,"Shaw, Matt",16,13,5,3,0,0,0,0
Gold Coast,"Smith, Zac",6,5,4,1,0,0,37,1
Gold Coast,"Swallow, David",16,11,1,5,1,0,1,6
Gold Coast,"Thompson, Rory",8,7,3,1,0,0,0,1
Gold Coast,"Ablett, Gary",23,11,2,12,1,2,0,1
Gold Coast,"Bennell, Harley",25,15,2,10,1,3,0,2
Gold Coast,"Broughton, Greg",14,4,1,10,0,0,0,1
Gold Coast,"Day, Sam",6,6,3,0,0,0,5,0
Gold Coast,"Garlett, Jarrod",11,8,3,3,1,3,0,2
Gold Coast,"Hallahan, Mitch",18,10,2,8,1,0,0,3
Gold Coast,"Harbrow, Jarrod",20,7,2,13,0,0,0,2
Gold Coast,"Kolodjashnij, Kade",21,10,3,11,0,1,0,1
Gold Coast,"Lemmens, Sean",12,4,5,8,0,0,0,2
Gold Coast,"Lynch, Tom",10,7,4,3,3,2,1,2
Gold Coast,"Malceski, Nick",15,13,4,2,0,1,0,3
Gold Coast,"Martin, Jack",18,10,5,8,0,0,0,5
Gold Coast,"May, Steven",12,6,3,6,0,2,0,1
Gold Coast,"Miller, Touk",11,3,1,8,0,0,0,4
Gold Coast,"Prestia, Dion",27,10,1,17,2,1,0,4
Gold Coast,"Rischitelli, Michael",35,17,1,18,1,0,0,4
Gold Coast,"Saad, Adam",21,8,4,13,0,0,0,4
Gold Coast,"Sexton, Alex",8,4,2,4,0,0,0,1
Gold Coast,"Smith, Zac",11,5,1,6,0,0,28,4
Gold Coast,"Swallow, David",24,15,1,9,0,0,2,4
Gold Coast,"Tape, Seb",12,7,1,5,0,0,0,2
Gold Coast,"Thompson, Rory",4,1,1,3,0,0,3,1
Gold Coast,"Bennell, Harley",28,14,1,14,0,2,2,1
Gold Coast,"Day, Sam",9,4,2,5,1,0,1,0
Gold Coast,"Garlett, Jarrod",11,6,1,5,1,2,0,4
Gold Coast,"Gorringe, Daniel",5,1,0,4,0,0,2,2
Gold Coast,"Hall, Aaron",14,7,0,7,1,0,0,0
Gold Coast,"Kolodjashnij, Kade",11,5,3,6,0,0,0,2
Gold Coast,"Lemmens, Sean",14,10,2,4,0,0,0,3
Gold Coast,"Lynch, Tom",19,16,6,3,3,3,1,1
Gold Coast,"Malceski, Nick",15,10,2,5,0,0,0,3
Gold Coast,"Martin, Jack",21,13,7,8,3,2,0,5
Gold Coast,"Matera, Brandon",11,6,1,5,2,0,0,2
Gold Coast,"May, Steven",20,14,7,6,0,0,0,1
Gold Coast,"McKenzie, Trent",18,13,4,5,0,0,0,1
Gold Coast,"Miller, Touk",18,12,6,6,1,2,0,5
Gold Coast,"Prestia, Dion",29,15,1,14,0,0,0,6
Gold Coast,"Rischitelli, Michael",27,21,4,6,1,3,0,5
Gold Coast,"Saad, Adam",16,10,5,6,0,0,0,2
Gold Coast,"Shaw, Matt",15,9,8,6,0,0,2,1
Gold Coast,"Smith, Zac",15,4,1,11,0,0,35,2
Gold Coast,"Swallow, David",20,10,2,10,0,0,1,3
Gold Coast,"Tape, Seb",9,4,1,5,0,0,0,5
Gold Coast,"Thompson, Rory",10,6,5,4,0,0,0,0
Gold Coast,"Bennell, Harley",18,13,1,5,1,0,0,3
Gold Coast,"Dixon, Charlie",6,3,2,3,2,1,0,0
Gold Coast,"Garlett, Jarrod",10,6,3,4,0,1,0,3
Gold Coast,"Hall, Aaron",15,10,4,5,0,0,0,2
Gold Coast,"Kolodjashnij, Kade",21,12,2,9,0,0,0,2
Gold Coast,"Lemmens, Sean",7,3,2,4,0,0,0,2
Gold Coast,"Lynch, Tom",14,10,2,4,0,1,0,2
Gold Coast,"Malceski, Nick",13,7,2,6,0,0,0,2
Gold Coast,"Martin, Jack",5,3,1,2,1,0,0,2
Gold Coast,"Matera, Brandon",17,11,5,6,1,0,0,3
Gold Coast,"May, Steven",10,5,0,5,0,0,0,0
Gold Coast,"McKenzie, Trent",8,5,1,3,0,0,0,4
Gold Coast,"Miller, Touk",22,14,3,8,0,1,0,4
Gold Coast,"Nicholls, Tom",13,7,2,6,0,0,21,5
Gold Coast,"Prestia, Dion",29,16,2,13,0,1,0,2
Gold Coast,"Rischitelli, Michael",31,20,4,11,0,1,0,7
Gold Coast,"Saad, Adam",11,4,2,7,0,0,0,6
Gold Coast,"Sexton, Alex",9,6,0,3,0,1,0,2
Gold Coast,"Shaw, Matt",5,3,3,2,0,0,0,1
Gold Coast,"Smith, Zac",6,4,3,2,1,0,15,4
Gold Coast,"Swallow, David",20,16,4,4,1,1,0,8
Gold Coast,"Thompson, Rory",11,3,3,8,0,0,0,1
Gold Coast,"Bennell, Harley",31,20,7,11,2,1,1,4
Gold Coast,"Dixon, Charlie",19,14,7,5,6,2,1,2
Gold Coast,"Garlett, Jarrod",0,0,0,0,0,0,0,0
Gold Coast,"Glenn, Josh",21,14,5,7,1,1,0,4
Gold Coast,"Harbrow, Jarrod",26,18,9,8,0,0,0,4
Gold Coast,"Kolodjashnij, Kade",24,19,7,5,0,0,0,2
Gold Coast,"Lemmens, Sean",12,5,3,7,1,1,0,5
Gold Coast,"Lonergan, Jesse",12,7,3,5,0,0,0,4
Gold Coast,"Lynch, Tom",17,11,4,6,3,1,1,5
Gold Coast,"Martin, Jack",16,7,1,9,2,1,0,7
Gold Coast,"Matera, Brandon",15,9,2,6,1,0,0,4
Gold Coast,"May, Steven",15,12,6,3,0,0,0,1
Gold Coast,"McKenzie, Trent",13,9,6,4,0,0,0,10
Gold Coast,"Miller, Touk",21,7,1,14,0,0,0,4
Gold Coast,"Nicholls, Tom",15,4,2,11,0,0,27,5
Gold Coast,"Prestia, Dion",28,14,0,14,1,0,0,7
Gold Coast,"Rischitelli, Michael",22,12,3,10,0,0,0,7
Gold Coast,"Saad, Adam",26,9,7,17,0,0,0,3
Gold Coast,"Schade, Henry",8,4,2,4,0,1,0,3
Gold Coast,"Sexton, Alex",19,11,2,8,1,1,0,6
Gold Coast,"Shaw, Matt",17,4,3,13,0,0,0,3
Gold Coast,"Tape, Seb",17,9,7,8,0,0,0,2
Gold Coast,"Cameron, Clay",3,3,2,0,0,0,0,1
Gold Coast,"Dixon, Charlie",6,5,5,1,3,1,1,1
Gold Coast,"Glenn, Josh",7,2,1,5,0,0,0,3
Gold Coast,"Hall, Aaron",12,5,1,7,1,1,0,3
Gold Coast,"Hallahan, Mitch",16,7,5,9,0,1,0,4
Gold Coast,"Harbrow, Jarrod",23,17,7,6,1,0,0,5
Gold Coast,"Kolodjashnij, Kade",20,16,7,4,0,0,0,2
Gold Coast,"Lemmens, Sean",13,3,2,10,1,0,0,3
Gold Coast,"Lonergan, Jesse",13,8,4,5,0,0,0,3
Gold Coast,"Lynch, Tom",17,10,7,7,1,2,1,0
Gold Coast,"Miller, Touk",21,12,3,9,1,0,0,4
Gold Coast,"Nicholls, Tom",13,5,4,8,1,0,17,3
Gold Coast,"Prestia, Dion",28,13,2,15,0,1,0,4
Gold Coast,"Raines, Andrew",17,9,3,8,0,0,0,3
Gold Coast,"Rischitelli, Michael",21,13,5,8,0,0,0,5
Gold Coast,"Russell, Luke",14,7,5,7,0,0,0,0
Gold Coast,"Saad, Adam",26,10,7,16,0,0,0,1
Gold Coast,"Schade, Henry",13,9,5,4,0,0,0,3
Gold Coast,"Sexton, Alex",19,12,4,7,1,0,0,5
Gold Coast,"Shaw, Matt",20,13,6,7,1,1,0,3
Gold Coast,"Smith, Zac",12,4,2,8,0,0,10,4
Gold Coast,"Thompson, Rory",11,5,5,6,0,0,0,1
Gold Coast,"Bennell, Harley",23,20,1,3,1,2,0,3
Gold Coast,"Broughton, Greg",14,6,4,8,0,0,0,3
Gold Coast,"Dixon, Charlie",8,3,3,5,1,1,1,2
Gold Coast,"Hall, Aaron",3,3,2,0,0,0,0,3
Gold Coast,"Hallahan, Mitch",24,12,3,12,0,0,0,11
Gold Coast,"Harbrow, Jarrod",12,9,4,3,0,0,0,6
Gold Coast,"Kolodjashnij, Kade",24,19,3,5,0,0,0,5
Gold Coast,"Lemmens, Sean",7,4,2,3,0,0,0,2
Gold Coast,"Leslie, Jack",11,5,3,6,0,0,0,1
Gold Coast,"Lonergan, Jesse",10,5,2,5,0,0,0,6
Gold Coast,"Matera, Brandon",5,5,1,0,2,0,0,3
Gold Coast,"McKenzie, Trent",11,11,2,0,0,0,0,3
Gold Coast,"Miller, Touk",21,9,1,12,0,0,0,8
Gold Coast,"Nicholls, Tom",12,4,0,8,0,0,31,11
Gold Coast,"Prestia, Dion",27,12,1,15,1,0,0,9
Gold Coast,"Raines, Andrew",16,7,1,9,0,0,0,2
Gold Coast,"Rischitelli, Michael",26,14,1,12,1,0,1,12
Gold Coast,"Schade, Henry",15,8,5,7,0,0,0,2
Gold Coast,"Sexton, Alex",12,10,2,2,0,0,1,4
Gold Coast,"Shaw, Matt",14,4,3,10,0,0,0,1
Gold Coast,"Smith, Zac",2,0,0,2,0,0,11,2
Gold Coast,"Stanley, Danny",12,7,1,5,0,0,0,6
Gold Coast,"Bennell, Harley",23,15,7,8,0,1,0,6
Gold Coast,"Dixon, Charlie",13,10,5,3,4,2,6,4
Gold Coast,"Hall, Aaron",4,1,0,3,0,0,0,2
Gold Coast,"Hallahan, Mitch",24,15,7,9,0,0,0,5
Gold Coast,"Harbrow, Jarrod",18,9,3,9,0,1,0,2
Gold Coast,"Kolodjashnij, Kade",23,15,13,8,0,0,0,2
Gold Coast,"Lemmens, Sean",15,8,4,7,0,1,0,0
Gold Coast,"Leslie, Jack",9,4,3,5,0,0,0,0
Gold Coast,"Lonergan, Jesse",20,16,8,4,0,0,1,4
Gold Coast,"Lynch, Tom",21,14,5,7,0,1,3,2
Gold Coast,"Matera, Brandon",11,6,2,5,1,0,0,0
Gold Coast,"McKenzie, Trent",15,8,5,7,0,0,0,1
Gold Coast,"Miller, Touk",15,8,2,7,0,2,0,7
Gold Coast,"Nicholls, Tom",14,8,7,6,2,0,26,2
Gold Coast,"Prestia, Dion",20,11,6,9,0,0,0,3
Gold Coast,"Raines, Andrew",11,5,2,6,0,0,0,3
Gold Coast,"Rischitelli, Michael",24,11,4,13,0,0,0,4
Gold Coast,"Russell, Luke",5,0,0,5,0,0,0,0
Gold Coast,"Saad, Adam",18,8,4,10,0,0,0,4
Gold Coast,"Schade, Henry",8,2,1,6,0,0,0,3
Gold Coast,"Sexton, Alex",10,7,3,3,2,0,0,2
Gold Coast,"Stanley, Danny",18,13,6,5,0,0,0,1
Gold Coast,"Bennell, Harley",19,16,2,3,0,0,1,4
Gold Coast,"Boston, Andrew",18,14,4,4,0,0,0,5
Gold Coast,"Brooksby, Keegan",7,1,2,6,1,0,12,5
Gold Coast,"Dixon, Charlie",8,6,3,2,1,1,0,1
Gold Coast,"Hallahan, Mitch",30,19,6,11,0,0,0,4
Gold Coast,"Harbrow, Jarrod",7,2,0,5,0,0,0,6
Gold Coast,"Kolodjashnij, Kade",20,11,2,9,0,0,0,0
Gold Coast,"Lemmens, Sean",11,7,2,4,0,0,0,2
Gold Coast,"Lonergan, Jesse",10,6,2,4,0,0,0,7
Gold Coast,"Lynch, Tom",13,8,8,5,2,0,0,3
Gold Coast,"Martin, Jack",1,0,0,1,0,0,0,0
Gold Coast,"Matera, Brandon",15,8,2,7,1,0,0,0
Gold Coast,"May, Steven",15,9,1,6,0,0,0,2
Gold Coast,"McKenzie, Trent",11,7,2,4,0,0,1,6
Gold Coast,"Miller, Touk",18,6,2,12,0,0,0,3
Gold Coast,"Nicholls, Tom",14,2,2,12,0,0,25,6
Gold Coast,"Rischitelli, Michael",23,16,1,7,0,2,1,7
Gold Coast,"Russell, Luke",13,6,0,7,1,0,0,5
Gold Coast,"Saad, Adam",19,6,3,13,0,0,0,2
Gold Coast,"Schade, Henry",7,3,3,4,0,0,0,1
Gold Coast,"Sexton, Alex",9,8,2,1,0,0,0,1
Gold Coast,"Stanley, Danny",19,10,3,9,0,0,0,3
Gold Coast,"Boston, Andrew",11,9,1,2,0,1,0,2
Gold Coast,"Brooksby, Keegan",9,6,5,3,0,1,6,3
Gold Coast,"Broughton, Greg",6,2,2,4,0,0,0,3
Gold Coast,"Cameron, Clay",1,1,0,0,0,0,0,1
Gold Coast,"Hallahan, Mitch",22,15,2,7,0,0,0,3
Gold Coast,"Harbrow, Jarrod",20,13,6,7,1,1,0,3
Gold Coast,"Kolodjashnij, Kade",27,24,8,3,1,0,0,0
Gold Coast,"Lemmens, Sean",11,8,4,3,0,1,0,3
Gold Coast,"Lonergan, Jesse",23,14,6,9,0,0,0,5
Gold Coast,"Lynch, Tom",17,13,10,4,1,0,0,0
Gold Coast,"Matera, Brandon",14,9,6,5,0,1,0,4
Gold Coast,"May, Steven",9,6,2,3,0,0,0,0
Gold Coast,"McKenzie, Trent",12,6,2,6,0,0,0,0
Gold Coast,"Miller, Touk",17,13,0,4,0,0,0,6
Gold Coast,"Nicholls, Tom",18,9,6,9,0,1,22,1
Gold Coast,"Raines, Andrew",10,3,0,7,0,0,0,4
Gold Coast,"Rischitelli, Michael",12,9,5,3,1,2,0,1
Gold Coast,"Russell, Luke",13,9,3,4,0,0,0,3
Gold Coast,"Saad, Adam",16,7,4,9,0,0,0,0
Gold Coast,"Schade, Henry",9,6,5,3,0,0,0,2
Gold Coast,"Stanley, Danny",22,13,5,9,0,0,0,4
Gold Coast,"Wright, Peter",5,3,2,2,1,1,0,0
Gold Coast,"Boston, Andrew",22,17,6,5,0,0,0,6
Gold Coast,"Cameron, Clay",7,4,4,3,0,0,0,4
Gold Coast,"Dixon, Charlie",5,2,2,3,0,0,2,2
Gold Coast,"Hallahan, Mitch",19,14,3,5,0,0,0,4
Gold Coast,"Harbrow, Jarrod",23,16,6,7,0,0,0,6
Gold Coast,"Kolodjashnij, Kade",25,16,7,9,1,0,0,3
Gold Coast,"Lemmens, Sean",10,5,1,5,1,1,0,7
Gold Coast,"Leslie, Jack",7,0,1,7,0,0,0,1
Gold Coast,"Lonergan, Jesse",12,5,2,7,0,0,0,5
Gold Coast,"Lynch, Tom",13,8,5,5,1,1,4,2
Gold Coast,"Malceski, Nick",14,9,6,5,0,0,0,2
Gold Coast,"Matera, Brandon",14,12,5,2,0,0,0,7
Gold Coast,"McKenzie, Trent",7,6,0,1,0,0,0,4
Gold Coast,"Miller, Touk",18,5,2,13,1,0,0,4
Gold Coast,"Nicholls, Tom",13,4,2,9,0,0,18,2
Gold Coast,"Raines, Andrew",14,10,2,4,2,0,0,6
Gold Coast,"Rischitelli, Michael",23,17,4,6,1,0,0,9
Gold Coast,"Russell, Luke",21,15,6,6,0,0,0,4
Gold Coast,"Saad, Adam",25,12,2,13,0,0,0,5
Gold Coast,"Schade, Henry",16,11,4,5,0,0,0,1
Gold Coast,"Stanley, Danny",1,0,0,1,0,0,0,1
Gold Coast,"Wright, Peter",7,4,3,3,0,0,4,2
Gold Coast,"Bennell, Harley",24,17,6,7,1,2,0,5
Gold Coast,"Boston, Andrew",12,9,4,3,1,1,0,0
Gold Coast,"Day, Sam",10,4,2,6,0,0,2,1
Gold Coast,"Dixon, Charlie",9,6,4,3,3,2,0,0
Gold Coast,"Hallahan, Mitch",12,9,4,3,0,0,0,3
Gold Coast,"Harbrow, Jarrod",18,7,3,11,0,0,0,3
Gold Coast,"Kolodjashnij, Kade",17,12,11,5,0,0,0,3
Gold Coast,"Lemmens, Sean",5,2,3,3,0,0,0,2
Gold Coast,"Lonergan, Jesse",9,5,3,4,0,0,0,7
Gold Coast,"Lynch, Tom",11,10,6,1,4,0,0,1
Gold Coast,"Malceski, Nick",12,7,3,5,0,0,0,1
Gold Coast,"Matera, Brandon",15,11,6,4,0,2,0,0
Gold Coast,"May, Steven",13,13,8,0,0,0,0,0
Gold Coast,"McKenzie, Trent",13,11,5,2,0,0,0,2
Gold Coast,"Miller, Touk",11,8,3,3,0,0,0,6
Gold Coast,"Nicholls, Tom",13,2,1,11,0,0,21,0
Gold Coast,"Raines, Andrew",8,6,3,2,0,0,0,0
Gold Coast,"Rischitelli, Michael",25,16,9,9,0,2,0,7
Gold Coast,"Russell, Luke",10,8,2,2,0,1,0,4
Gold Coast,"Saad, Adam",16,7,5,9,0,1,0,2
Gold Coast,"Schade, Henry",11,9,2,2,0,0,0,1
Gold Coast,"Sexton, Alex",8,5,1,3,0,0,0,1
Gold Coast,"Ablett, Gary",31,18,2,13,3,1,0,3
Gold Coast,"Boston, Andrew",14,11,3,3,0,0,0,4
Gold Coast,"Brooksby, Keegan",6,6,3,0,2,0,12,3
Gold Coast,"Day, Sam",7,3,3,4,0,0,0,1
Gold Coast,"Dixon, Charlie",15,11,5,4,7,2,0,3
Gold Coast,"Hall, Aaron",20,12,3,8,3,1,0,4
Gold Coast,"Hallahan, Mitch",21,9,1,12,1,0,0,3
Gold Coast,"Kolodjashnij, Kade",28,18,4,10,1,0,0,2
Gold Coast,"Lonergan, Jesse",0,0,0,0,0,0,0,1
Gold Coast,"Lynch, Tom",8,4,4,4,0,0,0,1
Gold Coast,"Malceski, Nick",23,16,4,7,0,1,0,0
Gold Coast,"Matera, Brandon",13,8,1,5,0,0,0,6
Gold Coast,"May, Steven",10,8,4,2,0,0,0,0
Gold Coast,"McKenzie, Trent",7,4,4,3,0,0,0,1
Gold Coast,"Miller, Touk",20,9,6,11,0,0,0,3
Gold Coast,"Nicholls, Tom",16,3,4,13,0,0,20,6
Gold Coast,"Rischitelli, Michael",28,17,5,11,0,0,0,9
Gold Coast,"Russell, Luke",23,12,5,11,1,1,0,2
Gold Coast,"Saad, Adam",12,7,3,5,0,1,0,3
Gold Coast,"Schade, Henry",1,0,0,1,0,0,0,2
Gold Coast,"Sexton, Alex",14,10,6,4,1,0,0,2
Gold Coast,"Swallow, David",22,9,5,13,0,1,1,8
Gold Coast,"Ablett, Gary",30,24,2,6,1,0,0,6
Gold Coast,"Day, Sam",10,3,3,7,1,0,3,2
Gold Coast,"Dixon, Charlie",2,1,1,1,1,0,0,0
Gold Coast,"Hall, Aaron",17,8,2,9,2,0,0,2
Gold Coast,"Hallahan, Mitch",15,10,1,5,0,0,0,6
Gold Coast,"Harbrow, Jarrod",14,8,2,6,0,0,0,3
Gold Coast,"Kolodjashnij, Kade",30,19,10,11,0,0,0,2
Gold Coast,"Lemmens, Sean",5,3,1,2,0,0,0,2
Gold Coast,"Lonergan, Jesse",10,8,4,2,0,0,0,2
Gold Coast,"Lynch, Tom",16,13,9,3,2,3,1,4
Gold Coast,"Malceski, Nick",18,11,6,7,1,0,0,5
Gold Coast,"Matera, Brandon",11,9,3,2,2,0,0,4
Gold Coast,"May, Steven",16,13,6,3,0,0,1,2
Gold Coast,"McKenzie, Trent",15,13,4,2,0,0,0,4
Gold Coast,"Miller, Touk",21,7,0,14,0,1,0,2
Gold Coast,"Nicholls, Tom",12,6,4,6,0,0,30,5
Gold Coast,"Rischitelli, Michael",21,9,4,12,1,0,0,4
Gold Coast,"Sexton, Alex",4,4,0,0,0,0,0,0
Gold Coast,"Shaw, Matt",14,6,4,8,0,0,0,2
Gold Coast,"Swallow, David",14,9,3,5,0,0,0,6
Gold Coast,"Tape, Seb",7,4,1,3,0,0,0,3
Gold Coast,"Thompson, Rory",12,7,3,5,0,0,0,3
Gold Coast,"Ablett, Gary",30,25,3,5,3,0,0,17
Gold Coast,"Cameron, Clay",3,2,0,1,0,0,0,3
Gold Coast,"Day, Sam",9,3,3,6,0,0,0,5
Gold Coast,"Glenn, Josh",9,3,2,6,0,0,0,2
Gold Coast,"Hall, Aaron",14,7,3,7,0,1,0,3
Gold Coast,"Hallahan, Mitch",11,5,1,6,1,0,0,5
Gold Coast,"Harbrow, Jarrod",17,11,4,6,0,0,0,4
Gold Coast,"Kolodjashnij, Kade",21,7,5,14,0,0,0,2
Gold Coast,"Lonergan, Jesse",14,7,5,7,0,0,0,2
Gold Coast,"Lynch, Tom",14,12,7,2,1,5,0,1
Gold Coast,"Malceski, Nick",25,16,6,9,0,0,0,2
Gold Coast,"Matera, Brandon",7,6,1,1,2,0,0,3
Gold Coast,"May, Steven",15,11,5,4,0,0,0,1
Gold Coast,"McKenzie, Trent",16,11,4,5,0,0,0,4
Gold Coast,"Miller, Touk",27,12,5,15,2,0,0,5
Gold Coast,"Nicholls, Tom",2,0,1,2,0,0,6,1
Gold Coast,"Rischitelli, Michael",17,5,7,12,0,0,0,6
Gold Coast,"Sexton, Alex",17,11,3,6,2,0,0,1
Gold Coast,"Shaw, Matt",11,4,3,7,0,0,0,1
Gold Coast,"Smith, Zac",15,8,3,7,1,1,37,5
Gold Coast,"Thompson, Rory",6,4,5,2,0,0,1,1
Gold Coast,"Wright, Peter",5,5,3,0,0,0,3,1
Gold Coast,"Ablett, Gary",4,4,2,0,0,0,0,1
Gold Coast,"Bennell, Harley",39,18,3,21,0,0,0,4
Gold Coast,"Day, Sam",10,7,5,3,1,0,4,4
Gold Coast,"Dixon, Charlie",14,11,6,3,3,3,1,1
Gold Coast,"Glenn, Josh",10,6,3,4,0,0,0,4
Gold Coast,"Hall, Aaron",24,14,3,10,0,0,0,4
Gold Coast,"Kolodjashnij, Kade",22,11,5,11,0,0,0,2
Gold Coast,"Lemmens, Sean",7,3,4,4,0,0,0,6
Gold Coast,"Lonergan, Jesse",20,10,3,10,1,1,1,9
Gold Coast,"Lynch, Tom",21,15,11,6,4,1,0,0
Gold Coast,"Malceski, Nick",17,12,10,5,0,1,0,3
Gold Coast,"Matera, Brandon",17,16,9,1,2,1,0,3
Gold Coast,"May, Steven",13,10,3,3,0,0,0,0
Gold Coast,"McKenzie, Trent",16,14,2,2,0,0,0,1
Gold Coast,"Miller, Touk",13,7,1,6,0,0,0,3
Gold Coast,"Rischitelli, Michael",14,9,2,5,0,1,0,10
Gold Coast,"Russell, Luke",16,10,4,6,1,0,0,0
Gold Coast,"Schade, Henry",12,4,0,8,0,0,0,1
Gold Coast,"Sexton, Alex",9,6,1,3,0,0,0,1
Gold Coast,"Shaw, Matt",15,10,6,5,0,0,0,5
Gold Coast,"Smith, Zac",14,6,2,8,0,0,25,3
Gold Coast,"Thompson, Rory",4,4,3,0,0,0,0,2
Gold Coast,"Bennell, Harley",28,20,6,8,1,1,0,7
Gold Coast,"Boston, Andrew",8,7,1,1,1,2,0,2
Gold Coast,"Day, Sam",9,5,5,4,0,0,0,1
Gold Coast,"Dixon, Charlie",8,5,4,3,1,0,8,3
Gold Coast,"Glenn, Josh",8,6,1,2,0,0,0,4
Gold Coast,"Hall, Aaron",24,17,4,7,1,0,0,7
Gold Coast,"Harbrow, Jarrod",20,16,6,4,0,2,0,3
Gold Coast,"Kolodjashnij, Kade",24,16,6,8,1,0,0,2
Gold Coast,"Lemmens, Sean",13,8,5,5,0,0,0,2
Gold Coast,"Lonergan, Jesse",16,9,3,7,0,0,1,9
Gold Coast,"Lynch, Tom",9,7,5,2,4,1,0,1
Gold Coast,"Malceski, Nick",12,7,6,5,0,0,0,1
Gold Coast,"Martin, Jack",13,6,5,7,1,0,1,5
Gold Coast,"Matera, Brandon",24,15,6,9,1,1,0,4
Gold Coast,"May, Steven",16,10,5,6,0,0,0,0
Gold Coast,"Miller, Touk",21,8,1,13,0,0,0,5
Gold Coast,"Nicholls, Tom",13,5,3,8,0,0,25,5
Gold Coast,"Russell, Luke",14,7,5,7,1,3,0,0
Gold Coast,"Saad, Adam",18,10,5,8,0,0,0,5
Gold Coast,"Schade, Henry",14,9,5,5,0,0,0,1
Gold Coast,"Shaw, Matt",15,10,7,5,0,0,1,5
Gold Coast,"Thompson, Rory",2,2,1,0,0,0,0,0
Gold Coast,"Bennell, Harley",16,11,4,5,1,0,0,5
Gold Coast,"Boston, Andrew",3,2,0,1,0,0,0,0
Gold Coast,"Day, Sam",9,6,2,3,1,0,2,5
Gold Coast,"Dixon, Charlie",11,7,7,4,3,0,1,2
Gold Coast,"Hall, Aaron",28,20,3,8,1,0,0,5
Gold Coast,"Harbrow, Jarrod",14,8,7,6,1,2,0,2
Gold Coast,"Kolodjashnij, Kade",20,13,5,7,0,0,0,2
Gold Coast,"Lemmens, Sean",4,1,0,3,0,0,0,3
Gold Coast,"Lonergan, Jesse",18,10,0,8,0,0,0,4
Gold Coast,"Lynch, Tom",18,11,9,7,5,2,0,2
Gold Coast,"Malceski, Nick",15,11,4,4,1,0,0,1
Gold Coast,"Martin, Jack",15,10,7,5,1,2,0,3
Gold Coast,"Matera, Brandon",18,13,4,5,1,1,0,4
Gold Coast,"May, Steven",11,6,6,5,0,0,0,2
Gold Coast,"McKenzie, Trent",8,4,1,4,0,1,0,1
Gold Coast,"Miller, Touk",17,8,2,9,1,1,0,4
Gold Coast,"Nicholls, Tom",10,2,0,8,0,0,32,4
Gold Coast,"Rischitelli, Michael",16,9,0,7,0,0,1,5
Gold Coast,"Russell, Luke",10,7,3,3,0,1,0,4
Gold Coast,"Saad, Adam",12,5,5,7,0,0,0,1
Gold Coast,"Schade, Henry",8,5,1,3,0,0,2,1
Gold Coast,"Shaw, Matt",9,4,4,5,1,0,0,4
Gold Coast,"Bennell, Harley",21,10,5,11,0,0,0,5
Gold Coast,"Boston, Andrew",9,6,4,3,1,1,0,0
Gold Coast,"Cameron, Clay",9,6,5,3,0,0,0,1
Gold Coast,"Day, Sam",10,7,4,3,0,0,4,2
Gold Coast,"Dixon, Charlie",6,4,2,2,1,0,0,2
Gold Coast,"Garlett, Jarrod",5,4,0,1,1,0,0,1
Gold Coast,"Hall, Aaron",29,19,6,10,1,1,0,3
Gold Coast,"Hall, Josh",9,6,1,3,0,0,8,7
Gold Coast,"Harbrow, Jarrod",13,8,5,5,0,0,0,4
Gold Coast,"Kolodjashnij, Kade",27,18,5,9,0,0,0,2
Gold Coast,"Lonergan, Jesse",24,12,4,12,0,0,1,4
Gold Coast,"Lynch, Tom",17,11,11,6,3,3,3,0
Gold Coast,"Malceski, Nick",13,10,4,3,0,0,0,4
Gold Coast,"Martin, Jack",6,3,2,3,0,0,1,2
Gold Coast,"Matera, Brandon",18,15,6,3,0,1,0,1
Gold Coast,"May, Steven",18,9,5,9,0,0,0,2
Gold Coast,"Miller, Touk",9,8,3,1,0,0,1,5
Gold Coast,"Nicholls, Tom",5,1,2,4,0,0,14,4
Gold Coast,"Rischitelli, Michael",21,11,3,10,0,0,0,7
Gold Coast,"Russell, Luke",10,6,3,4,1,0,0,2
Gold Coast,"Saad, Adam",13,8,5,5,0,0,0,1
Gold Coast,"Shaw, Matt",17,9,7,8,0,0,1,1
Gold Coast,"Bennell, Harley",19,12,5,7,2,2,2,3
Gold Coast,"Day, Sam",6,3,3,3,1,0,2,2
Gold Coast,"Garlett, Jarrod",13,6,2,7,0,0,0,3
Gold Coast,"Hall, Aaron",31,25,5,6,1,1,0,4
Gold Coast,"Hall, Josh",0,0,0,0,0,0,2,3
Gold Coast,"Kolodjashnij, Kade",22,16,3,6,0,0,0,3
Gold Coast,"Lemmens, Sean",15,10,4,5,0,0,0,3
Gold Coast,"Lonergan, Jesse",21,9,2,12,0,0,0,3
Gold Coast,"Lynch, Tom",13,12,8,1,3,3,1,2
Gold Coast,"Malceski, Nick",14,9,5,5,1,0,0,2
Gold Coast,"Martin, Jack",16,12,9,4,3,3,0,2
Gold Coast,"Matera, Brandon",23,18,6,5,0,2,0,2
Gold Coast,"May, Steven",14,12,4,2,0,0,0,2
Gold Coast,"Miller, Touk",10,6,3,4,0,0,0,10
Gold Coast,"Rischitelli, Michael",23,12,5,11,0,0,0,6
Gold Coast,"Russell, Luke",14,6,2,8,1,0,0,4
Gold Coast,"Saad, Adam",10,2,1,8,0,0,0,1
Gold Coast,"Schade, Henry",15,9,3,6,0,0,0,1
Gold Coast,"Shaw, Matt",20,7,7,13,2,0,0,5
Gold Coast,"Smith, Zac",15,6,3,9,0,0,31,5
Gold Coast,"Stanley, Danny",17,11,2,6,0,2,0,3
Gold Coast,"Thompson, Rory",7,6,4,1,0,0,0,1
Gold Coast,"Bennell, Harley",18,13,2,5,0,1,0,2
Gold Coast,"Cameron, Clay",5,3,0,2,0,0,0,0
Gold Coast,"Day, Sam",9,6,3,3,1,1,3,2
Gold Coast,"Dixon, Charlie",8,7,1,1,3,0,2,3
Gold Coast,"Garlett, Jarrod",11,2,1,9,0,0,0,0
Gold Coast,"Hall, Aaron",24,16,4,8,0,2,0,5
Gold Coast,"Kolodjashnij, Kade",27,20,7,7,0,0,0,1
Gold Coast,"Lemmens, Sean",19,12,5,7,0,0,0,3
Gold Coast,"Lonergan, Jesse",23,12,2,11,0,0,0,1
Gold Coast,"Lynch, Tom",14,11,6,3,1,2,0,4
Gold Coast,"Malceski, Nick",23,16,4,7,0,0,0,3
Gold Coast,"Martin, Jack",17,10,4,7,0,0,0,2
Gold Coast,"Matera, Brandon",26,21,9,5,2,1,0,4
Gold Coast,"May, Steven",11,10,2,1,0,0,0,3
Gold Coast,"Miller, Touk",18,7,1,11,0,0,1,9
Gold Coast,"Rischitelli, Michael",20,14,2,6,0,0,1,6
Gold Coast,"Russell, Luke",6,5,2,1,0,0,1,2
Gold Coast,"Schade, Henry",10,2,2,8,0,0,0,0
Gold Coast,"Shaw, Matt",8,7,2,1,0,0,0,4
Gold Coast,"Smith, Zac",14,5,2,9,0,0,25,1
Gold Coast,"Stanley, Danny",12,7,0,5,0,1,0,1
Gold Coast,"Thompson, Rory",6,3,0,3,0,0,3,2
Gold Coast,"Broughton, Greg",4,1,0,3,0,0,0,0
Gold Coast,"Day, Sam",8,3,4,5,0,0,0,0
Gold Coast,"Dixon, Charlie",13,7,2,6,2,0,9,1
Gold Coast,"Garlett, Jarrod",15,9,3,6,1,1,0,2
Gold Coast,"Hall, Aaron",31,19,5,12,0,0,0,1
Gold Coast,"Kolodjashnij, Kade",23,16,5,7,1,0,0,2
Gold Coast,"Lemmens, Sean",11,6,2,5,0,0,0,2
Gold Coast,"Lonergan, Jesse",12,6,1,6,0,0,0,4
Gold Coast,"Lynch, Tom",13,9,7,4,2,2,0,0
Gold Coast,"Malceski, Nick",18,12,3,6,0,0,0,2
Gold Coast,"Martin, Jack",14,9,6,5,0,0,0,2
Gold Coast,"Matera, Brandon",14,12,5,2,0,2,0,1
Gold Coast,"May, Steven",14,7,4,7,0,1,0,0
Gold Coast,"McKenzie, Trent",7,6,2,1,2,1,0,0
Gold Coast,"Miller, Touk",19,10,3,9,0,0,0,6
Gold Coast,"Rischitelli, Michael",21,14,6,7,0,1,0,4
Gold Coast,"Russell, Luke",14,7,2,7,0,0,0,4
Gold Coast,"Schade, Henry",9,4,2,5,0,0,0,2
Gold Coast,"Shaw, Matt",16,9,6,7,0,0,0,2
Gold Coast,"Smith, Zac",11,3,1,8,0,0,20,4
Gold Coast,"Stanley, Danny",22,16,3,6,1,1,0,2
Gold Coast,"Thompson, Rory",10,6,5,4,0,0,0,2
Geelong,"Bartel, Jimmy",28,16,7,12,0,0,1,2
Geelong,"Bews, Jed",9,3,2,6,1,0,0,2
Geelong,"Blicavs, Mark",18,5,3,13,0,0,8,5
Geelong,"Caddy, Josh",16,9,4,7,1,2,0,3
Geelong,"Clark, Mitch",12,10,8,2,3,0,2,2
Geelong,"Cockatoo, Nakia",6,3,2,3,0,0,0,4
Geelong,"Duncan, Mitch",13,8,7,5,0,1,0,0
Geelong,"Enright, Corey",22,9,5,13,0,1,0,4
Geelong,"Gregson, Cory",5,4,3,1,0,0,0,0
Geelong,"Guthrie, Cameron",22,9,3,13,0,0,0,6
Geelong,"Hawkins, Tom",5,5,2,0,2,0,0,4
Geelong,"Johnson, Steve",27,20,3,7,0,2,0,3
Geelong,"Kelly, James",22,13,6,9,0,1,0,3
Geelong,"Lang, Darcy",13,5,3,8,0,0,0,2
Geelong,"Lonergan, Tom",10,4,5,6,0,0,0,1
Geelong,"Motlop, Steven",32,27,7,5,1,2,0,1
Geelong,"Rivers, Jared",9,4,2,5,0,0,0,3
Geelong,"Selwood, Joel",21,6,4,15,0,0,0,5
Geelong,"Simpson, Dawson",3,1,1,2,0,0,15,2
Geelong,"Smedts, Billie",11,5,4,6,0,0,0,1
Geelong,"Stokes, Mathew",25,15,10,10,0,0,0,1
Geelong,"Taylor, Harry",16,9,8,7,0,0,0,2
Geelong,"Bews, Jed",6,1,3,5,0,0,0,1
Geelong,"Blicavs, Mark",16,9,7,7,0,0,3,2
Geelong,"Caddy, Josh",20,11,3,9,0,1,5,10
Geelong,"Clark, Mitch",5,3,3,2,2,0,3,2
Geelong,"Cockatoo, Nakia",1,0,0,1,0,0,0,3
Geelong,"Duncan, Mitch",12,3,1,9,1,0,0,3
Geelong,"Enright, Corey",20,10,5,10,0,0,0,1
Geelong,"Gregson, Cory",10,8,3,2,0,0,0,5
Geelong,"Guthrie, Cameron",19,11,3,8,1,0,0,4
Geelong,"Hawkins, Tom",11,8,5,3,2,1,0,1
Geelong,"Horlin-Smith, George",18,6,2,12,1,0,0,5
Geelong,"Johnson, Steve",20,11,3,9,0,1,0,3
Geelong,"Kelly, James",22,15,4,7,0,0,0,6
Geelong,"Lang, Darcy",12,4,2,8,0,0,0,4
Geelong,"Lonergan, Tom",15,9,7,6,0,0,0,0
Geelong,"Mackie, Andrew",16,7,5,9,0,0,0,0
Geelong,"Selwood, Joel",27,12,2,15,0,1,0,8
Geelong,"Simpson, Dawson",10,2,1,8,0,0,11,2
Geelong,"Smedts, Billie",14,6,5,8,0,0,0,5
Geelong,"Stanley, Rhys",11,6,2,5,2,1,10,3
Geelong,"Stokes, Mathew",19,9,3,10,0,0,0,2
Geelong,"Taylor, Harry",17,8,7,9,0,0,0,2
Geelong,"Bartel, Jimmy",2,1,0,1,0,0,0,3
Geelong,"Bews, Jed",12,4,2,8,0,0,0,2
Geelong,"Blicavs, Mark",21,11,2,10,1,0,12,5
Geelong,"Caddy, Josh",17,10,1,7,2,0,2,3
Geelong,"Clark, Mitch",15,10,3,5,1,3,1,1
Geelong,"Cockatoo, Nakia",9,7,4,2,0,0,0,2
Geelong,"Duncan, Mitch",24,11,5,13,0,0,0,1
Geelong,"Enright, Corey",23,13,8,10,0,0,0,3
Geelong,"Gregson, Cory",21,13,2,8,2,1,0,0
Geelong,"Guthrie, Cameron",20,12,0,8,0,1,0,7
Geelong,"Johnson, Steve",19,9,2,10,1,0,0,3
Geelong,"Kelly, James",27,17,4,10,0,0,0,5
Geelong,"Lang, Darcy",17,10,2,7,1,0,0,2
Geelong,"Lonergan, Tom",11,5,4,6,0,0,0,2
Geelong,"Motlop, Steven",23,19,7,4,2,2,0,4
Geelong,"Murdoch, Jordan",7,4,1,3,0,0,0,4
Geelong,"Selwood, Joel",38,17,4,21,1,0,0,6
Geelong,"Stanley, Rhys",9,5,3,4,0,0,25,3
Geelong,"Stokes, Mathew",8,2,0,6,0,0,0,1
Geelong,"Taylor, Harry",22,9,8,13,0,0,0,1
Geelong,"Thurlow, Jackson",19,15,6,4,1,0,0,3
Geelong,"Walker, Josh",9,7,2,2,4,0,0,3
Geelong,"Bews, Jed",8,6,2,2,0,0,0,4
Geelong,"Blicavs, Mark",18,10,7,8,0,0,14,7
Geelong,"Caddy, Josh",11,9,3,2,1,0,0,3
Geelong,"Clark, Mitch",13,11,6,2,3,1,2,2
Geelong,"Cockatoo, Nakia",8,3,4,5,0,1,0,1
Geelong,"Duncan, Mitch",16,9,5,7,1,0,0,6
Geelong,"Enright, Corey",26,16,7,10,0,0,0,1
Geelong,"Gregson, Cory",17,11,3,6,0,0,0,3
Geelong,"Guthrie, Cameron",16,9,2,7,1,0,0,3
Geelong,"Hawkins, Tom",10,9,7,1,1,2,0,0
Geelong,"Horlin-Smith, George",10,2,2,8,0,0,0,8
Geelong,"Johnson, Steve",9,5,2,4,2,0,0,2
Geelong,"Kelly, James",9,5,2,4,0,0,0,5
Geelong,"Lang, Darcy",7,5,1,2,0,0,0,1
Geelong,"Motlop, Steven",20,17,2,3,0,2,0,5
Geelong,"Murdoch, Jordan",15,8,3,7,0,0,0,4
Geelong,"Rivers, Jared",10,6,6,4,0,0,0,1
Geelong,"Selwood, Joel",29,13,3,16,0,1,0,5
Geelong,"Stanley, Rhys",14,7,4,7,0,1,18,4
Geelong,"Taylor, Harry",19,11,8,8,0,0,0,2
Geelong,"Thurlow, Jackson",11,7,5,4,0,0,0,2
Geelong,"Walker, Josh",6,1,3,5,0,0,0,0
Geelong,"Bews, Jed",9,2,2,7,0,0,0,1
Geelong,"Blicavs, Mark",17,9,7,8,1,0,15,2
Geelong,"Caddy, Josh",21,7,3,14,0,0,0,1
Geelong,"Duncan, Mitch",29,14,12,15,2,0,0,4
Geelong,"Enright, Corey",18,11,9,7,0,0,0,3
Geelong,"Gregson, Cory",14,6,6,8,0,0,0,3
Geelong,"Guthrie, Cameron",15,7,3,8,0,0,0,2
Geelong,"Hawkins, Tom",8,6,5,2,3,2,0,1
Geelong,"Horlin-Smith, George",3,1,0,2,0,0,0,0
Geelong,"Johnson, Steve",20,12,2,8,1,1,0,3
Geelong,"Kelly, James",20,6,3,14,0,0,0,5
Geelong,"Kersten, Shane",8,6,4,2,1,3,0,1
Geelong,"Lang, Darcy",15,8,4,7,1,0,0,3
Geelong,"Lonergan, Tom",15,12,7,3,0,0,0,0
Geelong,"Motlop, Steven",21,16,3,5,1,1,0,1
Geelong,"Murdoch, Jordan",12,5,2,7,0,0,0,3
Geelong,"Rivers, Jared",21,18,14,3,0,0,0,0
Geelong,"Selwood, Joel",21,10,2,11,0,0,0,5
Geelong,"Simpson, Dawson",8,3,0,5,0,0,21,5
Geelong,"Taylor, Harry",25,13,13,12,0,1,0,0
Geelong,"Thurlow, Jackson",21,11,6,10,0,0,0,0
Geelong,"Walker, Josh",11,8,9,3,2,1,1,1
Geelong,"Bews, Jed",13,4,2,9,0,0,0,2
Geelong,"Blicavs, Mark",27,9,6,18,0,1,6,6
Geelong,"Caddy, Josh",27,10,3,17,0,1,1,9
Geelong,"Clark, Mitch",14,8,5,6,2,1,1,3
Geelong,"Cockatoo, Nakia",9,4,1,5,1,0,0,2
Geelong,"Cowan, Josh",4,2,1,2,0,0,0,0
Geelong,"Duncan, Mitch",38,16,12,22,0,0,0,3
Geelong,"Enright, Corey",29,18,12,11,0,0,0,11
Geelong,"Gregson, Cory",18,10,7,8,3,2,0,4
Geelong,"Guthrie, Cameron",18,10,6,8,0,0,0,3
Geelong,"Hawkins, Tom",10,6,3,4,1,1,0,2
Geelong,"Johnson, Steve",28,13,6,15,1,0,0,6
Geelong,"Kersten, Shane",7,3,3,4,0,0,0,1
Geelong,"Lang, Darcy",16,11,3,5,1,0,0,3
Geelong,"Lonergan, Tom",20,10,10,10,0,0,0,2
Geelong,"Motlop, Steven",26,21,5,5,3,0,0,3
Geelong,"Murdoch, Jordan",13,8,2,5,1,0,0,6
Geelong,"Rivers, Jared",15,13,9,2,0,0,0,3
Geelong,"Selwood, Joel",26,13,5,13,1,0,1,7
Geelong,"Stanley, Rhys",18,10,4,8,1,0,12,3
Geelong,"Taylor, Harry",19,12,8,7,0,0,0,2
Geelong,"Thurlow, Jackson",30,19,7,11,0,0,0,3
Geelong,"Bews, Jed",9,4,4,5,0,0,0,3
Geelong,"Blease, Sam",7,4,2,3,0,0,0,0
Geelong,"Blicavs, Mark",16,6,3,10,1,0,14,4
Geelong,"Caddy, Josh",12,5,1,7,0,0,2,7
Geelong,"Clark, Mitch",10,6,2,4,0,1,1,2
Geelong,"Duncan, Mitch",18,7,5,11,0,0,0,2
Geelong,"Enright, Corey",21,14,8,7,0,0,0,0
Geelong,"Gregson, Cory",11,9,7,2,2,0,0,5
Geelong,"Guthrie, Cameron",16,12,6,4,1,0,0,3
Geelong,"Johnson, Steve",21,13,5,8,2,0,0,4
Geelong,"Kersten, Shane",9,5,5,4,0,2,0,2
Geelong,"Lang, Darcy",11,7,4,4,1,1,0,2
Geelong,"Lonergan, Tom",9,7,7,2,0,0,0,0
Geelong,"Motlop, Steven",17,11,4,6,2,1,0,2
Geelong,"Murdoch, Jordan",16,15,7,1,0,0,0,5
Geelong,"Rivers, Jared",12,6,5,6,0,0,0,2
Geelong,"Selwood, Joel",19,12,1,7,1,1,1,4
Geelong,"Stanley, Rhys",12,7,4,5,0,0,15,1
Geelong,"Stokes, Mathew",27,14,3,13,0,0,0,4
Geelong,"Taylor, Harry",14,8,3,6,0,0,0,2
Geelong,"Thurlow, Jackson",25,16,7,9,1,0,0,1
Geelong,"Walker, Josh",9,6,1,3,0,2,2,1
Geelong,"Bews, Jed",7,5,1,2,0,1,0,3
Geelong,"Blicavs, Mark",27,11,8,16,0,0,15,4
Geelong,"Caddy, Josh",23,13,4,10,3,0,0,2
Geelong,"Clark, Mitch",9,6,4,3,3,0,3,2
Geelong,"Enright, Corey",13,7,4,6,0,0,0,2
Geelong,"Gregson, Cory",16,10,3,6,1,0,0,2
Geelong,"Guthrie, Cameron",23,13,5,10,1,0,0,4
Geelong,"Hawkins, Tom",14,11,5,3,1,2,0,7
Geelong,"Johnson, Steve",25,13,3,12,1,2,0,0
Geelong,"Kelly, James",22,12,8,10,1,0,0,0
Geelong,"Kersten, Shane",13,10,7,3,2,0,0,2
Geelong,"Lang, Darcy",9,4,3,5,1,0,0,2
Geelong,"Lonergan, Tom",18,11,6,7,1,0,0,1
Geelong,"Mackie, Andrew",13,9,6,4,0,0,0,1
Geelong,"Motlop, Steven",12,8,3,4,0,0,0,2
Geelong,"Murdoch, Jordan",26,19,8,7,4,1,0,4
Geelong,"Rivers, Jared",17,10,10,7,0,0,0,1
Geelong,"Selwood, Joel",17,11,0,6,2,0,2,8
Geelong,"Stanley, Rhys",13,6,4,7,1,0,16,3
Geelong,"Stokes, Mathew",25,13,6,12,0,0,0,6
Geelong,"Taylor, Harry",19,7,6,12,0,0,0,4
Geelong,"Thurlow, Jackson",20,16,6,4,0,0,0,0
Geelong,"Bews, Jed",14,6,2,8,0,0,0,4
Geelong,"Blicavs, Mark",12,4,2,8,0,0,25,9
Geelong,"Caddy, Josh",20,11,1,9,1,1,4,6
Geelong,"Clark, Mitch",9,5,4,4,0,0,2,2
Geelong,"Enright, Corey",21,12,10,9,0,0,0,3
Geelong,"Gregson, Cory",13,8,4,5,1,0,0,2
Geelong,"Guthrie, Cameron",20,6,1,14,0,0,1,5
Geelong,"Hawkins, Tom",11,9,7,2,3,2,0,4
Geelong,"Johnson, Steve",27,11,3,16,1,0,1,2
Geelong,"Kelly, James",18,6,1,12,0,0,0,6
Geelong,"Kersten, Shane",6,3,1,3,1,0,0,2
Geelong,"Lang, Darcy",10,6,1,4,0,0,0,4
Geelong,"Lonergan, Tom",10,5,5,5,0,0,0,3
Geelong,"Mackie, Andrew",20,15,4,5,1,0,0,4
Geelong,"Motlop, Steven",23,12,6,11,0,0,0,1
Geelong,"Murdoch, Jordan",10,5,3,5,1,0,0,3
Geelong,"Rivers, Jared",16,4,3,12,0,0,0,4
Geelong,"Selwood, Joel",19,9,1,10,0,0,2,3
Geelong,"Stanley, Rhys",5,3,2,2,0,0,4,2
Geelong,"Stokes, Mathew",13,6,2,7,1,0,0,2
Geelong,"Taylor, Harry",12,5,7,7,0,0,0,4
Geelong,"Thurlow, Jackson",13,10,2,3,0,0,0,4
Geelong,"Bews, Jed",15,7,4,8,0,1,0,2
Geelong,"Blicavs, Mark",16,6,5,10,1,0,15,4
Geelong,"Caddy, Josh",20,10,4,10,2,1,2,5
Geelong,"Enright, Corey",23,16,7,7,0,0,0,7
Geelong,"Gregson, Cory",14,7,3,7,0,0,0,2
Geelong,"Guthrie, Cameron",11,6,2,5,0,1,0,5
Geelong,"Hawkins, Tom",6,4,3,2,4,0,0,1
Geelong,"Johnson, Steve",15,12,5,3,4,1,0,2
Geelong,"Kelly, James",28,16,8,12,0,0,0,5
Geelong,"Kersten, Shane",6,5,4,1,1,0,0,0
Geelong,"Lang, Darcy",22,17,8,5,0,0,0,7
Geelong,"Lonergan, Tom",23,17,11,6,1,0,0,1
Geelong,"Luxford, Michael",5,1,1,4,0,0,0,1
Geelong,"Mackie, Andrew",24,18,13,6,0,0,0,1
Geelong,"Motlop, Steven",19,13,7,6,4,0,0,4
Geelong,"Murdoch, Jordan",17,13,4,4,0,0,0,2
Geelong,"Rivers, Jared",18,11,8,7,0,0,0,1
Geelong,"Selwood, Joel",26,14,5,12,2,0,0,6
Geelong,"Stokes, Mathew",21,15,6,6,0,0,0,7
Geelong,"Taylor, Harry",33,18,10,15,0,0,0,0
Geelong,"Thurlow, Jackson",23,11,6,12,0,0,0,2
Geelong,"Walker, Josh",12,6,2,6,0,1,15,1
Geelong,"Bews, Jed",9,6,0,3,0,0,0,3
Geelong,"Blicavs, Mark",16,6,3,10,0,1,20,12
Geelong,"Caddy, Josh",26,20,3,6,2,1,2,8
Geelong,"Enright, Corey",29,22,9,7,0,0,0,2
Geelong,"Gregson, Cory",9,5,1,4,1,0,0,4
Geelong,"Guthrie, Cameron",23,10,4,13,1,1,0,7
Geelong,"Hawkins, Tom",7,4,3,3,2,0,0,6
Geelong,"Johnson, Steve",17,11,4,6,1,0,0,3
Geelong,"Kelly, James",2,2,0,0,0,0,0,1
Geelong,"Kersten, Shane",7,2,0,5,2,0,0,1
Geelong,"Lang, Darcy",15,8,3,7,1,0,0,5
Geelong,"Lonergan, Tom",16,14,7,2,0,0,0,2
Geelong,"Mackie, Andrew",10,7,3,3,0,0,0,2
Geelong,"Motlop, Steven",15,10,1,5,2,2,0,2
Geelong,"Murdoch, Jordan",21,14,7,7,0,0,0,2
Geelong,"Rivers, Jared",16,13,5,3,0,0,0,3
Geelong,"Selwood, Joel",17,8,1,9,0,1,1,6
Geelong,"Stanley, Rhys",17,9,3,8,2,0,24,3
Geelong,"Stokes, Mathew",24,18,3,6,0,0,0,1
Geelong,"Taylor, Harry",14,11,8,3,0,0,0,0
Geelong,"Thurlow, Jackson",16,10,8,6,0,0,0,3
Geelong,"Walker, Josh",11,6,1,5,0,1,16,1
Geelong,"Bews, Jed",10,6,2,4,0,0,0,7
Geelong,"Blicavs, Mark",22,9,2,13,0,0,25,13
Geelong,"Caddy, Josh",19,10,5,9,0,1,3,7
Geelong,"Enright, Corey",18,14,4,4,0,0,0,2
Geelong,"Gregson, Cory",11,5,3,6,0,0,0,5
Geelong,"Guthrie, Cameron",21,7,4,14,1,0,0,6
Geelong,"Hawkins, Tom",11,10,7,1,2,2,1,1
Geelong,"Johnson, Steve",17,10,4,7,2,1,0,3
Geelong,"Kersten, Shane",6,3,2,3,2,1,0,7
Geelong,"Kolodjashnij, Jake",7,2,1,5,0,0,0,4
Geelong,"Lang, Darcy",15,10,7,5,2,0,1,5
Geelong,"Lonergan, Tom",9,8,3,1,0,0,0,1
Geelong,"Luxford, Michael",3,2,0,1,0,0,0,2
Geelong,"Mackie, Andrew",15,9,4,6,0,0,0,5
Geelong,"Motlop, Steven",27,19,3,8,2,2,0,5
Geelong,"Murdoch, Jordan",10,4,2,6,0,1,0,2
Geelong,"Rivers, Jared",10,6,4,4,0,0,0,0
Geelong,"Selwood, Joel",17,9,2,8,1,0,0,6
Geelong,"Stokes, Mathew",23,13,3,10,0,1,0,4
Geelong,"Taylor, Harry",11,7,6,4,0,1,0,1
Geelong,"Thurlow, Jackson",9,8,3,1,0,0,0,6
Geelong,"Walker, Josh",9,3,2,6,1,0,14,3
Geelong,"Bartel, Jimmy",41,11,6,30,0,0,0,2
Geelong,"Bews, Jed",8,2,0,6,0,0,0,3
Geelong,"Blicavs, Mark",16,3,2,13,0,1,11,10
Geelong,"Caddy, Josh",20,10,5,10,0,1,1,7
Geelong,"Enright, Corey",21,11,3,10,0,0,0,3
Geelong,"Gregson, Cory",13,5,2,8,0,2,0,2
Geelong,"Guthrie, Cameron",26,9,3,17,0,1,1,4
Geelong,"Hawkins, Tom",13,11,8,2,1,1,0,1
Geelong,"Johnson, Steve",20,16,7,4,2,0,0,2
Geelong,"Kelly, James",10,2,1,8,0,1,0,8
Geelong,"Lang, Darcy",16,10,3,6,0,1,0,1
Geelong,"Lonergan, Tom",10,5,3,5,0,0,0,2
Geelong,"Mackie, Andrew",21,14,5,7,2,0,0,3
Geelong,"Motlop, Steven",10,3,3,7,0,1,0,5
Geelong,"Murdoch, Jordan",20,10,4,10,2,0,0,5
Geelong,"Rivers, Jared",11,4,7,7,0,0,0,5
Geelong,"Selwood, Joel",26,10,2,16,1,0,1,10
Geelong,"Simpson, Dawson",5,2,0,3,0,0,31,2
Geelong,"Stokes, Mathew",5,1,0,4,1,0,0,3
Geelong,"Taylor, Harry",17,8,3,9,0,0,0,4
Geelong,"Thurlow, Jackson",14,7,2,7,0,0,0,3
Geelong,"Walker, Josh",9,3,4,6,2,1,1,4
Geelong,"Bartel, Jimmy",23,14,8,9,0,1,0,11
Geelong,"Bews, Jed",10,5,4,5,0,0,0,6
Geelong,"Blicavs, Mark",19,9,8,10,0,0,31,5
Geelong,"Caddy, Josh",37,17,5,20,1,2,2,7
Geelong,"Duncan, Mitch",25,13,4,12,1,1,0,3
Geelong,"Enright, Corey",23,17,3,6,0,0,0,7
Geelong,"Gregson, Cory",10,4,3,6,1,0,0,3
Geelong,"Guthrie, Cameron",19,6,3,13,0,0,0,3
Geelong,"Hawkins, Tom",12,10,6,2,3,0,0,1
Geelong,"Johnson, Steve",20,10,4,10,0,2,0,0
Geelong,"Kelly, James",31,16,9,15,0,3,0,3
Geelong,"Kersten, Shane",8,5,4,3,0,1,0,5
Geelong,"Kolodjashnij, Jake",12,7,2,5,0,0,0,4
Geelong,"Lang, Darcy",11,5,2,6,0,0,0,3
Geelong,"Lonergan, Tom",12,4,3,8,0,0,2,3
Geelong,"Mackie, Andrew",21,15,8,6,0,0,0,4
Geelong,"Motlop, Steven",23,13,6,10,3,0,0,11
Geelong,"Murdoch, Jordan",18,13,4,5,0,0,0,1
Geelong,"Stokes, Mathew",9,2,2,7,0,0,0,1
Geelong,"Taylor, Harry",16,8,7,8,0,0,0,2
Geelong,"Thurlow, Jackson",16,6,3,10,0,0,0,1
Geelong,"Walker, Josh",18,10,8,8,1,1,6,2
Geelong,"Bartel, Jimmy",25,12,4,13,0,0,0,5
Geelong,"Blicavs, Mark",10,3,2,7,0,1,33,5
Geelong,"Caddy, Josh",25,7,4,18,0,2,0,3
Geelong,"Duncan, Mitch",18,7,0,11,1,1,0,2
Geelong,"Enright, Corey",22,14,5,8,0,0,0,0
Geelong,"Gregson, Cory",11,5,4,6,0,0,0,3
Geelong,"Guthrie, Cameron",19,6,2,13,0,0,2,2
Geelong,"Hawkins, Tom",11,10,8,1,5,1,0,0
Geelong,"Johnson, Steve",22,17,5,5,0,2,0,1
Geelong,"Kelly, James",26,12,6,14,0,1,0,1
Geelong,"Kersten, Shane",8,4,3,4,0,0,1,3
Geelong,"Kolodjashnij, Jake",12,6,3,6,0,0,0,0
Geelong,"Lang, Darcy",13,8,3,5,0,0,0,1
Geelong,"Lonergan, Tom",13,9,7,4,0,0,0,1
Geelong,"Mackie, Andrew",19,9,8,10,0,0,0,0
Geelong,"Motlop, Steven",31,16,3,15,2,1,0,2
Geelong,"Murdoch, Jordan",18,13,7,5,0,1,0,1
Geelong,"Selwood, Joel",27,6,2,21,1,1,1,8
Geelong,"Smedts, Billie",2,1,1,1,0,0,0,3
Geelong,"Taylor, Harry",19,15,8,4,0,0,0,1
Geelong,"Thurlow, Jackson",15,10,3,5,0,0,0,1
Geelong,"Walker, Josh",6,2,3,4,0,1,2,2
Geelong,"Bartel, Jimmy",21,13,8,8,0,0,0,6
Geelong,"Blicavs, Mark",20,5,5,15,0,1,19,4
Geelong,"Caddy, Josh",29,16,8,13,1,1,2,6
Geelong,"Cockatoo, Nakia",4,3,3,1,0,0,0,0
Geelong,"Duncan, Mitch",20,8,2,12,0,0,0,1
Geelong,"Enright, Corey",24,15,7,9,0,0,0,2
Geelong,"Guthrie, Cameron",28,8,4,20,2,1,1,7
Geelong,"Hawkins, Tom",13,8,6,5,2,2,0,4
Geelong,"Johnson, Steve",20,15,7,5,3,2,0,1
Geelong,"Kelly, James",21,11,7,10,0,1,0,3
Geelong,"Kersten, Shane",9,1,4,8,0,0,0,4
Geelong,"Kolodjashnij, Jake",13,4,3,9,0,0,0,4
Geelong,"Lang, Darcy",8,6,1,2,1,1,0,2
Geelong,"Lonergan, Tom",14,6,9,8,0,0,0,1
Geelong,"Mackie, Andrew",24,13,10,11,0,0,0,1
Geelong,"Motlop, Steven",29,16,1,13,1,0,0,2
Geelong,"Murdoch, Jordan",22,8,4,14,0,0,0,3
Geelong,"Selwood, Joel",27,14,5,13,2,1,4,11
Geelong,"Smedts, Billie",15,7,6,8,0,0,0,2
Geelong,"Taylor, Harry",21,14,7,7,0,0,0,0
Geelong,"Thurlow, Jackson",12,6,1,6,0,0,0,3
Geelong,"Walker, Josh",15,9,5,6,5,0,4,2
Geelong,"Bartel, Jimmy",25,14,7,11,0,0,0,3
Geelong,"Blicavs, Mark",22,13,5,9,0,0,20,2
Geelong,"Caddy, Josh",22,17,7,5,2,2,2,9
Geelong,"Cockatoo, Nakia",10,4,2,6,0,0,0,1
Geelong,"Duncan, Mitch",22,9,9,13,2,0,0,1
Geelong,"Enright, Corey",24,18,8,6,0,0,0,1
Geelong,"Gregson, Cory",11,5,1,6,1,1,0,3
Geelong,"Guthrie, Cameron",23,7,6,16,0,1,2,11
Geelong,"Hawkins, Tom",17,10,5,7,4,2,0,1
Geelong,"Horlin-Smith, George",4,1,1,3,0,0,0,2
Geelong,"Kelly, James",25,16,7,9,0,0,0,3
Geelong,"Kolodjashnij, Jake",15,8,4,7,0,1,0,4
Geelong,"Lang, Darcy",13,7,2,6,2,1,0,2
Geelong,"Lonergan, Tom",20,8,6,12,0,0,0,2
Geelong,"Mackie, Andrew",24,18,8,6,1,0,0,1
Geelong,"Motlop, Steven",32,20,6,12,1,0,0,2
Geelong,"Murdoch, Jordan",12,8,2,4,0,0,0,1
Geelong,"Selwood, Joel",35,20,6,15,0,1,0,4
Geelong,"Stokes, Mathew",14,9,4,5,1,0,0,1
Geelong,"Taylor, Harry",21,12,13,9,0,0,0,1
Geelong,"Thurlow, Jackson",18,6,5,12,0,0,0,2
Geelong,"Walker, Josh",9,5,5,4,0,0,2,4
Geelong,"Bartel, Jimmy",19,10,7,9,0,0,0,1
Geelong,"Blicavs, Mark",13,5,5,8,0,0,21,8
Geelong,"Caddy, Josh",13,5,3,8,0,1,0,8
Geelong,"Cockatoo, Nakia",6,5,2,1,1,1,0,1
Geelong,"Enright, Corey",28,18,10,10,0,0,0,0
Geelong,"Gregson, Cory",9,3,0,6,0,1,0,4
Geelong,"Guthrie, Cameron",30,13,6,17,3,0,1,5
Geelong,"Hawkins, Tom",10,5,3,5,2,1,0,3
Geelong,"Horlin-Smith, George",26,7,6,19,0,0,0,2
Geelong,"Johnson, Steve",23,15,8,8,2,2,0,3
Geelong,"Kelly, James",10,5,0,5,0,0,0,6
Geelong,"Kolodjashnij, Jake",20,7,6,13,0,0,0,3
Geelong,"Lang, Darcy",18,11,7,7,2,1,0,1
Geelong,"Mackie, Andrew",27,21,8,6,0,0,0,1
Geelong,"Motlop, Steven",18,16,5,2,0,0,0,4
Geelong,"Murdoch, Jordan",17,7,2,10,0,0,0,4
Geelong,"Rivers, Jared",10,4,4,6,0,0,0,2
Geelong,"Selwood, Joel",25,16,5,9,1,0,0,3
Geelong,"Stokes, Mathew",21,7,4,14,0,0,0,0
Geelong,"Taylor, Harry",12,6,3,6,0,0,0,1
Geelong,"Thurlow, Jackson",16,7,4,9,0,0,0,1
Geelong,"Walker, Josh",12,7,4,5,1,2,3,1
Geelong,"Bartel, Jimmy",26,16,7,10,0,0,0,4
Geelong,"Bews, Jed",6,4,2,2,0,0,0,4
Geelong,"Blicavs, Mark",14,7,5,7,0,1,12,8
Geelong,"Caddy, Josh",10,3,3,7,0,0,0,2
Geelong,"Cockatoo, Nakia",5,2,0,3,1,0,0,0
Geelong,"Enright, Corey",26,14,8,12,0,0,0,5
Geelong,"Gregson, Cory",7,4,5,3,1,0,0,4
Geelong,"Guthrie, Cameron",29,11,3,18,1,0,0,8
Geelong,"Hawkins, Tom",9,8,6,1,3,1,0,1
Geelong,"Horlin-Smith, George",19,4,1,15,0,0,0,3
Geelong,"Johnson, Steve",18,16,9,2,4,3,0,3
Geelong,"Kolodjashnij, Jake",17,9,6,8,0,0,0,1
Geelong,"Lang, Darcy",16,6,3,10,0,0,0,2
Geelong,"Lonergan, Tom",14,7,4,7,0,0,0,1
Geelong,"Mackie, Andrew",22,15,7,7,1,0,0,0
Geelong,"Motlop, Steven",33,22,5,11,1,0,0,8
Geelong,"Murdoch, Jordan",16,8,4,8,0,0,0,3
Geelong,"Selwood, Joel",21,10,3,11,0,0,0,8
Geelong,"Taylor, Harry",16,11,9,5,1,0,0,2
Geelong,"Thurlow, Jackson",19,11,5,8,0,0,0,3
Geelong,"Vardy, Nathan",14,9,2,5,2,0,20,3
Geelong,"Walker, Josh",8,5,4,3,0,0,0,0
Geelong,"Bartel, Jimmy",23,6,5,17,0,0,0,2
Geelong,"Bews, Jed",10,5,3,5,0,0,0,3
Geelong,"Blicavs, Mark",27,11,7,16,0,0,13,7
Geelong,"Cockatoo, Nakia",14,7,6,7,0,1,0,3
Geelong,"Enright, Corey",21,9,5,12,0,0,0,1
Geelong,"Gregson, Cory",15,7,4,8,0,1,0,5
Geelong,"Guthrie, Cameron",22,7,1,15,0,1,0,6
Geelong,"Hawkins, Tom",8,4,1,4,2,0,0,2
Geelong,"Johnson, Steve",23,12,7,11,1,0,0,3
Geelong,"Kelly, James",25,12,8,13,0,0,0,2
Geelong,"Kolodjashnij, Jake",18,10,7,8,0,0,0,1
Geelong,"Lang, Darcy",14,3,1,11,1,0,0,3
Geelong,"Lonergan, Tom",20,13,7,7,0,0,1,2
Geelong,"Mackie, Andrew",25,13,4,12,0,0,0,0
Geelong,"Menzel, Daniel",20,12,4,8,4,2,0,1
Geelong,"Motlop, Steven",15,9,1,6,1,0,0,3
Geelong,"Murdoch, Jordan",11,6,3,5,0,0,0,0
Geelong,"Selwood, Joel",19,8,3,11,0,0,0,3
Geelong,"Taylor, Harry",10,5,8,5,0,0,0,4
Geelong,"Thurlow, Jackson",20,7,2,13,0,0,0,0
Geelong,"Vardy, Nathan",10,3,3,7,0,0,10,1
Geelong,"Walker, Josh",5,4,3,1,0,0,0,0
Geelong,"Bartel, Jimmy",26,14,10,12,0,0,0,4
Geelong,"Blicavs, Mark",15,5,2,10,0,0,11,4
Geelong,"Cockatoo, Nakia",12,9,5,3,0,2,0,2
Geelong,"Cowan, Josh",14,6,2,8,1,1,0,1
Geelong,"Enright, Corey",32,23,11,9,0,0,0,2
Geelong,"Gregson, Cory",12,4,2,8,0,0,0,4
Geelong,"Guthrie, Cameron",33,13,2,20,1,0,0,9
Geelong,"Hawkins, Tom",10,7,3,3,3,0,0,3
Geelong,"Horlin-Smith, George",19,8,3,11,1,1,0,1
Geelong,"Johnson, Steve",21,15,10,6,2,6,0,0
Geelong,"Kelly, James",30,19,6,11,0,0,0,9
Geelong,"Kolodjashnij, Jake",12,5,2,7,0,0,0,4
Geelong,"Lonergan, Tom",16,8,8,8,0,1,0,0
Geelong,"Mackie, Andrew",34,20,11,14,1,0,0,4
Geelong,"Menzel, Daniel",5,1,2,4,0,0,0,1
Geelong,"Motlop, Steven",15,11,0,4,0,2,0,1
Geelong,"Selwood, Joel",34,19,5,15,1,1,0,8
Geelong,"Stokes, Mathew",33,11,12,22,1,1,0,0
Geelong,"Taylor, Harry",15,10,9,5,0,1,0,4
Geelong,"Thurlow, Jackson",12,6,3,6,0,0,0,4
Geelong,"Vardy, Nathan",15,7,8,8,3,0,12,4
Geelong,"Walker, Josh",6,6,5,0,3,0,0,1
Greater Western Sydney,"Bugg, Tomas",18,9,2,9,0,0,0,2
Greater Western Sydney,"Cameron, Jeremy",6,6,4,0,4,2,0,1
Greater Western Sydney,"Coniglio, Stephen",5,3,1,2,0,0,0,2
Greater Western Sydney,"Corr, Aidan",7,1,0,6,0,0,0,0
Greater Western Sydney,"Davis, Phil",11,8,6,3,0,0,0,1
Greater Western Sydney,"Greene, Toby",22,12,4,10,0,2,0,1
Greater Western Sydney,"Griffen, Ryan",15,5,2,10,0,1,0,3
Greater Western Sydney,"Hampton, Curtly",10,6,0,4,0,0,0,2
Greater Western Sydney,"Haynes, Nick",16,11,6,5,0,0,0,1
Greater Western Sydney,"Kelly, Josh",17,11,7,6,0,2,0,4
Greater Western Sydney,"McCarthy, Cam",15,8,5,7,3,1,0,0
Greater Western Sydney,"Mumford, Shane",12,3,3,9,0,1,36,0
Greater Western Sydney,"Palmer, Rhys",13,9,4,4,1,2,0,2
Greater Western Sydney,"Patfull, Joel",15,8,6,7,0,0,0,1
Greater Western Sydney,"Scully, Tom",16,8,4,8,0,0,0,1
Greater Western Sydney,"Shaw, Heath",14,11,6,3,0,0,0,1
Greater Western Sydney,"Shiel, Dylan",28,11,6,17,1,0,0,3
Greater Western Sydney,"Smith, Devon",15,9,1,6,0,1,0,5
Greater Western Sydney,"Tomlinson, Adam",13,7,5,6,0,0,7,2
Greater Western Sydney,"Treloar, Adam",32,14,5,18,1,1,0,5
Greater Western Sydney,"Ward, Callan",22,9,4,13,1,0,0,5
Greater Western Sydney,"Whitfield, Lachie",31,18,11,13,1,0,0,0
Greater Western Sydney,"Bugg, Tomas",16,4,1,12,0,0,0,2
Greater Western Sydney,"Cameron, Jeremy",12,7,5,5,1,1,0,2
Greater Western Sydney,"Coniglio, Stephen",26,14,5,12,2,0,0,8
Greater Western Sydney,"Corr, Aidan",6,3,0,3,0,0,0,3
Greater Western Sydney,"Davis, Phil",14,8,8,6,0,0,0,4
Greater Western Sydney,"Greene, Toby",25,11,6,14,0,1,0,1
Greater Western Sydney,"Griffen, Ryan",23,9,5,14,0,0,1,5
Greater Western Sydney,"Haynes, Nick",11,7,3,4,0,0,0,2
Greater Western Sydney,"Kelly, Josh",27,15,7,12,0,1,0,1
Greater Western Sydney,"McCarthy, Cam",9,9,4,0,3,0,0,3
Greater Western Sydney,"Mumford, Shane",13,7,2,6,1,1,38,7
Greater Western Sydney,"Palmer, Rhys",11,7,4,4,0,0,0,4
Greater Western Sydney,"Patfull, Joel",6,5,1,1,0,0,0,3
Greater Western Sydney,"Scully, Tom",17,9,3,8,1,1,0,4
Greater Western Sydney,"Shaw, Heath",23,16,7,7,0,0,0,4
Greater Western Sydney,"Shiel, Dylan",26,14,6,12,3,0,0,8
Greater Western Sydney,"Smith, Devon",9,5,1,4,2,0,0,7
Greater Western Sydney,"Tomlinson, Adam",1,0,0,1,0,0,2,1
Greater Western Sydney,"Treloar, Adam",24,14,2,10,1,0,0,3
Greater Western Sydney,"Ward, Callan",27,17,5,10,0,1,2,4
Greater Western Sydney,"Whitfield, Lachie",19,11,4,8,0,1,0,2
Greater Western Sydney,"Wilson, Nathan",11,9,3,2,1,0,0,0
Greater Western Sydney,"Bugg, Tomas",17,4,5,13,0,0,0,4
Greater Western Sydney,"Cameron, Jeremy",9,9,5,0,2,3,0,5
Greater Western Sydney,"Coniglio, Stephen",24,12,8,12,1,0,0,10
Greater Western Sydney,"Corr, Aidan",10,2,2,8,0,0,0,2
Greater Western Sydney,"Davis, Phil",14,6,5,8,0,0,0,0
Greater Western Sydney,"Greene, Toby",27,10,5,17,0,1,0,2
Greater Western Sydney,"Griffen, Ryan",16,6,4,10,1,0,0,3
Greater Western Sydney,"Haynes, Nick",18,16,7,2,0,0,0,0
Greater Western Sydney,"Kelly, Josh",24,9,3,15,0,0,0,0
Greater Western Sydney,"McCarthy, Cam",10,10,5,0,2,2,0,0
Greater Western Sydney,"Mumford, Shane",13,3,3,10,0,0,28,6
Greater Western Sydney,"Palmer, Rhys",19,12,4,7,3,1,0,4
Greater Western Sydney,"Patfull, Joel",10,7,5,3,0,0,0,1
Greater Western Sydney,"Phillips, Andrew",4,4,2,0,0,0,8,2
Greater Western Sydney,"Scully, Tom",27,16,12,11,1,0,0,0
Greater Western Sydney,"Shaw, Heath",24,19,3,5,0,0,0,2
Greater Western Sydney,"Shiel, Dylan",14,4,1,10,0,0,0,3
Greater Western Sydney,"Smith, Devon",33,18,5,15,0,2,0,2
Greater Western Sydney,"Treloar, Adam",29,13,5,16,0,0,0,1
Greater Western Sydney,"Ward, Callan",23,11,4,12,1,1,1,5
Greater Western Sydney,"Whitfield, Lachie",37,20,8,17,1,2,0,1
Greater Western Sydney,"Wilson, Nathan",4,2,1,2,0,0,0,2
Greater Western Sydney,"Bugg, Tomas",23,11,4,12,0,0,0,4
Greater Western Sydney,"Cameron, Jeremy",21,13,7,8,4,6,0,0
Greater Western Sydney,"Coniglio, Stephen",27,15,4,12,0,1,0,5
Greater Western Sydney,"Corr, Aidan",9,4,3,5,0,0,0,0
Greater Western Sydney,"Davis, Phil",20,13,7,7,0,0,0,1
Greater Western Sydney,"Greene, Toby",26,11,5,15,1,1,0,3
Greater Western Sydney,"Griffen, Ryan",29,8,3,21,0,0,0,3
Greater Western Sydney,"Haynes, Nick",20,13,6,7,0,0,0,1
Greater Western Sydney,"Kelly, Josh",11,5,4,6,0,1,0,0
Greater Western Sydney,"McCarthy, Cam",18,12,6,6,5,2,0,0
Greater Western Sydney,"Mumford, Shane",12,1,1,11,0,0,36,6
Greater Western Sydney,"Palmer, Rhys",18,9,4,9,0,1,0,2
Greater Western Sydney,"Patfull, Joel",16,8,4,8,0,1,0,2
Greater Western Sydney,"Scully, Tom",28,16,6,12,0,1,0,6
Greater Western Sydney,"Shaw, Heath",21,12,4,9,0,0,0,2
Greater Western Sydney,"Shiel, Dylan",39,17,3,22,1,2,0,5
Greater Western Sydney,"Smith, Devon",21,15,7,6,2,1,0,5
Greater Western Sydney,"Stewart, James",13,6,5,7,1,1,3,0
Greater Western Sydney,"Treloar, Adam",27,13,3,14,2,1,1,3
Greater Western Sydney,"Ward, Callan",29,16,7,13,0,0,4,7
Greater Western Sydney,"Whitfield, Lachie",16,9,3,7,0,0,0,0
Greater Western Sydney,"Wilson, Nathan",15,9,2,6,0,0,0,2
Greater Western Sydney,"Bugg, Tomas",15,6,2,9,0,0,0,5
Greater Western Sydney,"Cameron, Jeremy",6,5,3,1,1,2,0,5
Greater Western Sydney,"Coniglio, Stephen",20,9,5,11,0,0,0,8
Greater Western Sydney,"Corr, Aidan",4,3,2,1,0,0,0,2
Greater Western Sydney,"Davis, Phil",15,8,6,7,0,0,0,1
Greater Western Sydney,"Greene, Toby",18,8,5,10,2,0,0,2
Greater Western Sydney,"Griffen, Ryan",17,8,3,9,0,1,0,5
Greater Western Sydney,"Haynes, Nick",15,10,4,5,0,0,0,2
Greater Western Sydney,"Hoskin-Elliott, Will",3,2,1,1,0,0,0,0
Greater Western Sydney,"Kelly, Josh",6,4,1,2,0,0,0,1
Greater Western Sydney,"McCarthy, Cam",11,8,5,3,1,0,0,0
Greater Western Sydney,"Mumford, Shane",13,3,0,10,0,0,28,8
Greater Western Sydney,"Patfull, Joel",22,11,7,11,0,0,0,2
Greater Western Sydney,"Scully, Tom",22,10,6,12,0,0,0,4
Greater Western Sydney,"Shaw, Heath",29,21,9,8,0,0,0,2
Greater Western Sydney,"Shiel, Dylan",36,13,2,23,0,2,0,2
Greater Western Sydney,"Smith, Devon",26,20,8,6,0,2,0,5
Greater Western Sydney,"Stewart, James",12,8,4,4,0,1,1,1
Greater Western Sydney,"Treloar, Adam",21,10,2,11,0,1,0,1
Greater Western Sydney,"Ward, Callan",23,9,6,14,0,0,1,8
Greater Western Sydney,"Whitfield, Lachie",27,13,7,14,0,0,0,2
Greater Western Sydney,"Wilson, Nathan",12,8,4,4,0,0,0,2
Greater Western Sydney,"Bugg, Tomas",7,4,1,3,0,0,0,4
Greater Western Sydney,"Buntine, Matt",8,5,4,3,0,0,0,4
Greater Western Sydney,"Cameron, Jeremy",14,11,8,3,7,0,0,1
Greater Western Sydney,"Coniglio, Stephen",23,7,1,16,0,0,0,8
Greater Western Sydney,"Davis, Phil",8,5,4,3,0,0,0,2
Greater Western Sydney,"Greene, Toby",24,13,6,11,1,3,0,4
Greater Western Sydney,"Griffen, Ryan",24,9,5,15,1,0,1,4
Greater Western Sydney,"Haynes, Nick",10,6,6,4,0,0,0,0
Greater Western Sydney,"Hoskin-Elliott, Will",7,6,3,1,0,0,0,1
Greater Western Sydney,"Kennedy, Adam",8,6,3,2,0,0,0,1
Greater Western Sydney,"McCarthy, Cam",4,4,3,0,1,0,0,3
Greater Western Sydney,"Mumford, Shane",14,2,1,12,0,1,37,8
Greater Western Sydney,"Patfull, Joel",11,6,5,5,0,0,0,1
Greater Western Sydney,"Scully, Tom",21,12,1,9,1,1,0,6
Greater Western Sydney,"Shaw, Heath",22,22,5,0,0,1,0,5
Greater Western Sydney,"Shiel, Dylan",27,8,2,19,0,0,0,5
Greater Western Sydney,"Smith, Devon",20,15,5,5,3,1,0,3
Greater Western Sydney,"Stewart, James",9,5,2,4,1,1,2,1
Greater Western Sydney,"Treloar, Adam",28,12,6,16,1,0,0,4
Greater Western Sydney,"Ward, Callan",31,16,5,15,0,0,3,7
Greater Western Sydney,"Whitfield, Lachie",26,16,5,10,0,0,0,1
Greater Western Sydney,"Williams, Zac",2,2,0,0,0,1,0,1
Greater Western Sydney,"Bugg, Tomas",22,15,4,7,0,2,0,3
Greater Western Sydney,"Buntine, Matt",17,8,3,9,0,0,0,1
Greater Western Sydney,"Cameron, Jeremy",12,10,7,2,5,1,0,0
Greater Western Sydney,"Coniglio, Stephen",32,11,5,21,1,0,0,0
Greater Western Sydney,"Corr, Aidan",10,4,1,6,0,0,0,0
Greater Western Sydney,"Greene, Toby",27,13,7,14,1,0,0,3
Greater Western Sydney,"Griffen, Ryan",12,6,2,6,0,0,0,3
Greater Western Sydney,"Haynes, Nick",20,14,9,6,0,1,0,1
Greater Western Sydney,"Hoskin-Elliott, Will",15,10,8,5,1,1,0,2
Greater Western Sydney,"Kennedy, Adam",20,7,5,13,0,0,0,0
Greater Western Sydney,"McCarthy, Cam",15,12,9,3,2,2,0,2
Greater Western Sydney,"Mumford, Shane",11,4,5,7,0,0,47,6
Greater Western Sydney,"Patfull, Joel",19,10,7,9,1,0,0,1
Greater Western Sydney,"Scully, Tom",20,9,6,11,2,0,0,4
Greater Western Sydney,"Shaw, Heath",20,16,9,4,0,0,0,1
Greater Western Sydney,"Shiel, Dylan",30,16,3,14,0,3,0,4
Greater Western Sydney,"Smith, Devon",16,11,2,5,0,1,0,5
Greater Western Sydney,"Stewart, James",16,10,4,6,2,3,1,0
Greater Western Sydney,"Treloar, Adam",31,11,8,20,3,1,1,5
Greater Western Sydney,"Ward, Callan",27,10,3,17,0,1,1,3
Greater Western Sydney,"Whitfield, Lachie",18,11,7,7,0,1,0,2
Greater Western Sydney,"Williams, Zac",8,4,2,4,1,1,0,1
Greater Western Sydney,"Bugg, Tomas",22,11,10,11,1,0,0,0
Greater Western Sydney,"Buntine, Matt",14,11,9,3,1,0,0,2
Greater Western Sydney,"Cameron, Jeremy",7,7,2,0,2,0,0,1
Greater Western Sydney,"Coniglio, Stephen",18,7,3,11,0,0,0,2
Greater Western Sydney,"Davis, Phil",15,8,5,7,0,0,0,2
Greater Western Sydney,"Greene, Toby",21,10,6,11,3,0,0,2
Greater Western Sydney,"Griffen, Ryan",24,10,2,14,0,0,2,8
Greater Western Sydney,"Haynes, Nick",15,9,5,6,0,0,0,2
Greater Western Sydney,"Hoskin-Elliott, Will",11,6,4,5,0,1,0,1
Greater Western Sydney,"Kelly, Josh",17,10,5,7,1,1,0,5
Greater Western Sydney,"Kennedy, Adam",15,8,6,7,0,0,0,1
Greater Western Sydney,"McCarthy, Cam",12,9,6,3,4,1,0,1
Greater Western Sydney,"Mumford, Shane",9,2,2,7,0,0,47,9
Greater Western Sydney,"Patfull, Joel",12,4,4,8,0,0,0,0
Greater Western Sydney,"Scully, Tom",26,12,6,14,0,0,0,5
Greater Western Sydney,"Shaw, Heath",18,15,0,3,0,0,0,2
Greater Western Sydney,"Shiel, Dylan",34,14,5,20,1,1,1,4
Greater Western Sydney,"Smith, Devon",27,17,5,10,1,2,0,10
Greater Western Sydney,"Stewart, James",12,6,4,6,1,3,2,2
Greater Western Sydney,"Treloar, Adam",35,7,1,28,0,1,0,4
Greater Western Sydney,"Ward, Callan",26,13,8,13,1,0,1,4
Greater Western Sydney,"Williams, Zac",3,1,0,2,0,0,0,1
Greater Western Sydney,"Bugg, Tomas",10,6,1,4,0,0,0,4
Greater Western Sydney,"Buntine, Matt",10,6,3,4,0,0,0,4
Greater Western Sydney,"Cameron, Jeremy",8,7,6,1,3,0,0,1
Greater Western Sydney,"Coniglio, Stephen",25,12,6,13,0,0,0,4
Greater Western Sydney,"Corr, Aidan",16,9,6,7,0,0,0,3
Greater Western Sydney,"Greene, Toby",27,18,9,9,2,0,0,3
Greater Western Sydney,"Griffen, Ryan",10,4,1,6,1,0,0,4
Greater Western Sydney,"Haynes, Nick",11,8,7,3,0,0,0,1
Greater Western Sydney,"Hoskin-Elliott, Will",10,9,5,1,0,0,0,5
Greater Western Sydney,"Kelly, Josh",6,2,2,4,0,0,0,4
Greater Western Sydney,"Kennedy, Adam",7,4,0,3,0,0,0,2
Greater Western Sydney,"McCarthy, Cam",7,4,3,3,1,0,0,0
Greater Western Sydney,"Mumford, Shane",9,1,2,8,0,0,46,5
Greater Western Sydney,"Patfull, Joel",8,5,3,3,0,0,0,3
Greater Western Sydney,"Scully, Tom",17,7,2,10,1,0,0,4
Greater Western Sydney,"Shaw, Heath",28,26,10,2,0,0,0,6
Greater Western Sydney,"Shiel, Dylan",25,11,2,14,0,0,0,4
Greater Western Sydney,"Smith, Devon",11,6,1,5,0,0,0,6
Greater Western Sydney,"Stewart, James",12,8,4,4,2,0,1,3
Greater Western Sydney,"Treloar, Adam",23,8,3,15,1,0,0,4
Greater Western Sydney,"Ward, Callan",19,6,2,13,0,0,2,4
Greater Western Sydney,"Whitfield, Lachie",31,16,11,15,0,1,0,0
Greater Western Sydney,"Bugg, Tomas",13,4,2,9,0,0,0,2
Greater Western Sydney,"Buntine, Matt",11,9,4,2,0,1,0,1
Greater Western Sydney,"Cameron, Jeremy",13,9,7,4,3,2,0,0
Greater Western Sydney,"Coniglio, Stephen",26,10,0,16,2,0,0,8
Greater Western Sydney,"Corr, Aidan",7,6,5,1,0,0,0,3
Greater Western Sydney,"Davis, Phil",12,6,4,6,0,0,0,1
Greater Western Sydney,"Greene, Toby",8,5,3,3,0,0,0,2
Greater Western Sydney,"Griffen, Ryan",15,6,3,9,1,0,2,4
Greater Western Sydney,"Hoskin-Elliott, Will",5,4,2,1,0,1,0,1
Greater Western Sydney,"Kelly, Josh",22,13,4,9,0,1,0,6
Greater Western Sydney,"McCarthy, Cam",10,8,5,2,2,0,0,0
Greater Western Sydney,"Mumford, Shane",15,4,4,11,0,0,51,8
Greater Western Sydney,"Patfull, Joel",13,10,8,3,0,1,0,0
Greater Western Sydney,"Scully, Tom",17,7,4,10,0,1,0,7
Greater Western Sydney,"Shaw, Heath",16,13,3,3,0,0,0,4
Greater Western Sydney,"Shiel, Dylan",27,14,2,13,1,0,0,2
Greater Western Sydney,"Smith, Devon",22,14,8,8,0,3,0,6
Greater Western Sydney,"Stewart, James",9,7,1,2,2,0,1,2
Greater Western Sydney,"Treloar, Adam",27,14,4,13,1,1,0,9
Greater Western Sydney,"Ward, Callan",32,15,5,17,1,0,2,12
Greater Western Sydney,"Whitfield, Lachie",22,12,4,10,1,0,0,2
Greater Western Sydney,"Wilson, Nathan",10,7,4,3,0,1,0,3
Greater Western Sydney,"Bugg, Tomas",22,9,3,13,0,0,0,3
Greater Western Sydney,"Buntine, Matt",16,10,5,6,0,0,0,4
Greater Western Sydney,"Cameron, Jeremy",6,4,4,2,2,1,0,5
Greater Western Sydney,"Coniglio, Stephen",22,8,3,14,0,0,0,1
Greater Western Sydney,"Davis, Phil",2,0,1,2,0,0,0,1
Greater Western Sydney,"Greene, Toby",26,10,4,16,0,0,0,2
Greater Western Sydney,"Griffen, Ryan",24,11,4,13,0,0,0,1
Greater Western Sydney,"Haynes, Nick",18,12,6,6,1,0,0,1
Greater Western Sydney,"Hoskin-Elliott, Will",16,8,8,8,0,4,0,4
Greater Western Sydney,"Kelly, Josh",12,7,6,5,1,0,0,3
Greater Western Sydney,"McCarthy, Cam",11,7,3,4,4,1,0,1
Greater Western Sydney,"Mumford, Shane",12,1,2,11,0,0,29,8
Greater Western Sydney,"Patfull, Joel",6,1,1,5,0,0,0,1
Greater Western Sydney,"Scully, Tom",24,9,7,15,0,0,0,5
Greater Western Sydney,"Shaw, Heath",25,19,8,6,0,0,0,6
Greater Western Sydney,"Shiel, Dylan",34,16,0,18,0,0,0,4
Greater Western Sydney,"Smith, Devon",19,10,4,9,1,1,0,5
Greater Western Sydney,"Stewart, James",8,3,3,5,1,1,7,6
Greater Western Sydney,"Treloar, Adam",29,13,2,16,0,1,0,8
Greater Western Sydney,"Ward, Callan",30,13,6,17,1,0,2,3
Greater Western Sydney,"Whitfield, Lachie",26,22,12,4,0,0,0,2
Greater Western Sydney,"Wilson, Nathan",9,5,1,4,0,0,0,2
Greater Western Sydney,"Bugg, Tomas",9,4,1,5,0,0,0,2
Greater Western Sydney,"Buntine, Matt",15,10,6,5,0,0,0,1
Greater Western Sydney,"Cameron, Jeremy",11,8,6,3,1,2,0,1
Greater Western Sydney,"Corr, Aidan",8,3,2,5,0,0,0,4
Greater Western Sydney,"Greene, Toby",24,11,6,13,0,0,0,5
Greater Western Sydney,"Griffen, Ryan",27,14,9,13,1,0,4,2
Greater Western Sydney,"Haynes, Nick",14,11,11,3,0,0,0,1
Greater Western Sydney,"Kelly, Josh",13,7,3,6,0,0,0,3
Greater Western Sydney,"Lobb, Rory",9,4,4,5,0,0,10,1
Greater Western Sydney,"Marchbank, Caleb",9,6,5,3,0,0,0,1
Greater Western Sydney,"McCarthy, Cam",8,6,2,2,1,0,0,2
Greater Western Sydney,"Palmer, Rhys",17,13,5,4,3,1,0,2
Greater Western Sydney,"Shaw, Heath",30,24,14,6,0,0,0,1
Greater Western Sydney,"Shiel, Dylan",11,6,2,5,0,0,0,5
Greater Western Sydney,"Smith, Devon",17,12,2,5,0,2,0,5
Greater Western Sydney,"Steele, Jack",17,6,3,11,0,1,2,10
Greater Western Sydney,"Stewart, James",7,6,0,1,2,1,0,5
Greater Western Sydney,"Treloar, Adam",29,16,5,13,0,0,2,11
Greater Western Sydney,"Ward, Callan",19,8,6,11,0,0,5,5
Greater Western Sydney,"Whitfield, Lachie",19,12,8,7,0,0,0,2
Greater Western Sydney,"Williams, Zac",20,8,5,12,0,0,0,4
Greater Western Sydney,"Wilson, Nathan",4,3,1,1,0,0,0,1
Greater Western Sydney,"Buntine, Matt",6,5,4,1,0,0,0,1
Greater Western Sydney,"Cameron, Jeremy",11,9,5,2,2,1,0,2
Greater Western Sydney,"Corr, Aidan",8,7,3,1,0,0,0,3
Greater Western Sydney,"Downie, Tom",7,3,3,4,0,0,21,2
Greater Western Sydney,"Greene, Toby",23,16,7,7,0,1,0,4
Greater Western Sydney,"Griffen, Ryan",24,19,10,5,0,0,0,3
Greater Western Sydney,"Hampton, Curtly",10,8,4,2,0,0,0,5
Greater Western Sydney,"Kennedy, Adam",18,10,8,8,0,0,0,2
Greater Western Sydney,"Lobb, Rory",8,6,4,2,1,1,4,4
Greater Western Sydney,"Marchbank, Caleb",8,6,5,2,0,0,0,1
Greater Western Sydney,"McCarthy, Cam",2,2,2,0,0,1,0,2
Greater Western Sydney,"Palmer, Rhys",8,7,1,1,3,0,0,1
Greater Western Sydney,"Scully, Tom",21,10,3,11,1,0,0,5
Greater Western Sydney,"Shaw, Heath",23,23,9,0,0,0,0,3
Greater Western Sydney,"Shiel, Dylan",25,16,3,9,0,1,0,4
Greater Western Sydney,"Smith, Devon",17,14,4,3,1,0,0,4
Greater Western Sydney,"Steele, Jack",13,4,2,9,0,0,2,6
Greater Western Sydney,"Stewart, James",2,1,1,1,0,0,0,0
Greater Western Sydney,"Treloar, Adam",23,8,2,15,1,0,3,8
Greater Western Sydney,"Ward, Callan",18,12,4,6,1,0,7,3
Greater Western Sydney,"Whitfield, Lachie",17,9,10,8,0,1,0,3
Greater Western Sydney,"Williams, Zac",18,14,8,4,0,1,0,1
Greater Western Sydney,"Buntine, Matt",17,14,3,3,0,0,0,0
Greater Western Sydney,"Cameron, Jeremy",13,13,8,0,5,1,0,3
Greater Western Sydney,"Coniglio, Stephen",26,9,3,17,0,0,0,17
Greater Western Sydney,"Corr, Aidan",3,3,2,0,0,0,0,6
Greater Western Sydney,"Downie, Tom",4,2,1,2,0,0,24,6
Greater Western Sydney,"Greene, Toby",24,11,7,13,1,0,0,4
Greater Western Sydney,"Griffen, Ryan",22,13,6,9,0,1,0,6
Greater Western Sydney,"Hampton, Curtly",16,7,3,9,0,0,0,3
Greater Western Sydney,"Haynes, Nick",12,7,5,5,0,0,0,0
Greater Western Sydney,"Lobb, Rory",5,4,0,1,1,1,10,4
Greater Western Sydney,"McCarthy, Cam",6,3,2,3,2,1,0,1
Greater Western Sydney,"Palmer, Rhys",22,12,3,10,0,4,0,7
Greater Western Sydney,"Scully, Tom",26,13,7,13,0,3,1,6
Greater Western Sydney,"Shaw, Heath",22,18,5,4,0,0,0,3
Greater Western Sydney,"Shiel, Dylan",10,4,1,6,1,0,0,2
Greater Western Sydney,"Smith, Devon",17,9,1,8,0,0,0,2
Greater Western Sydney,"Steele, Jack",20,6,3,14,1,0,1,6
Greater Western Sydney,"Tomlinson, Adam",13,8,5,5,0,0,0,3
Greater Western Sydney,"Treloar, Adam",30,17,4,13,0,0,1,5
Greater Western Sydney,"Ward, Callan",31,13,5,18,0,0,2,5
Greater Western Sydney,"Whitfield, Lachie",16,8,3,8,0,0,0,1
Greater Western Sydney,"Williams, Zac",16,10,5,6,1,0,0,6
Greater Western Sydney,"Buntine, Matt",7,4,4,3,0,0,0,2
Greater Western Sydney,"Cameron, Jeremy",12,9,6,3,2,4,0,1
Greater Western Sydney,"Coniglio, Stephen",25,12,5,13,0,0,2,5
Greater Western Sydney,"Corr, Aidan",15,10,8,5,0,0,0,0
Greater Western Sydney,"Downie, Tom",5,3,4,2,1,0,21,6
Greater Western Sydney,"Greene, Toby",25,14,5,11,0,2,0,3
Greater Western Sydney,"Griffen, Ryan",21,12,7,9,0,0,0,3
Greater Western Sydney,"Hampton, Curtly",5,4,1,1,0,0,0,2
Greater Western Sydney,"Haynes, Nick",17,9,6,8,0,0,0,1
Greater Western Sydney,"Kelly, Josh",23,10,4,13,0,1,0,6
Greater Western Sydney,"Lobb, Rory",9,5,4,4,2,0,17,2
Greater Western Sydney,"McCarthy, Cam",4,4,2,0,1,1,0,0
Greater Western Sydney,"Palmer, Rhys",15,8,5,7,1,0,0,2
Greater Western Sydney,"Scully, Tom",23,10,5,13,0,0,0,6
Greater Western Sydney,"Shaw, Heath",29,25,12,4,0,0,0,2
Greater Western Sydney,"Smith, Devon",27,15,3,12,4,0,0,5
Greater Western Sydney,"Steele, Jack",18,6,5,12,0,0,3,5
Greater Western Sydney,"Tomlinson, Adam",18,13,9,5,0,0,0,0
Greater Western Sydney,"Treloar, Adam",19,12,3,7,0,1,1,5
Greater Western Sydney,"Ward, Callan",30,17,8,13,2,2,5,5
Greater Western Sydney,"Whitfield, Lachie",17,13,8,4,0,1,0,0
Greater Western Sydney,"Williams, Zac",20,12,7,8,0,0,0,1
Greater Western Sydney,"Cameron, Jeremy",10,6,4,4,0,0,0,2
Greater Western Sydney,"Coniglio, Stephen",25,12,3,13,0,0,1,6
Greater Western Sydney,"Corr, Aidan",9,5,2,4,0,0,0,0
Greater Western Sydney,"Downie, Tom",8,2,0,6,1,0,26,3
Greater Western Sydney,"Greene, Toby",12,7,3,5,1,0,0,3
Greater Western Sydney,"Griffen, Ryan",21,10,6,11,0,0,0,4
Greater Western Sydney,"Hampton, Curtly",17,10,7,7,0,0,0,2
Greater Western Sydney,"Haynes, Nick",14,8,0,6,0,0,0,1
Greater Western Sydney,"Kelly, Josh",19,13,3,6,1,0,0,1
Greater Western Sydney,"Lamb, Jed",10,7,4,3,1,0,0,1
Greater Western Sydney,"Lobb, Rory",10,7,4,3,0,0,11,5
Greater Western Sydney,"Palmer, Rhys",1,0,0,1,0,0,0,1
Greater Western Sydney,"Patfull, Joel",10,6,3,4,0,0,0,4
Greater Western Sydney,"Scully, Tom",22,11,5,11,0,1,0,5
Greater Western Sydney,"Shaw, Heath",25,18,6,7,0,0,0,1
Greater Western Sydney,"Smith, Devon",16,9,3,7,0,2,0,2
Greater Western Sydney,"Steele, Jack",16,3,0,13,0,0,0,5
Greater Western Sydney,"Tomlinson, Adam",16,10,10,6,1,2,0,0
Greater Western Sydney,"Treloar, Adam",30,16,2,14,0,0,0,6
Greater Western Sydney,"Ward, Callan",16,10,4,6,1,0,3,3
Greater Western Sydney,"Whitfield, Lachie",22,16,8,6,0,0,0,2
Greater Western Sydney,"Williams, Zac",24,13,7,11,0,0,0,1
Greater Western Sydney,"Buntine, Matt",3,3,2,0,0,0,0,4
Greater Western Sydney,"Cameron, Jeremy",8,7,3,1,2,3,0,0
Greater Western Sydney,"Coniglio, Stephen",29,14,5,15,1,1,0,5
Greater Western Sydney,"Corr, Aidan",7,6,2,1,0,0,0,3
Greater Western Sydney,"Davis, Phil",19,11,8,8,0,0,2,1
Greater Western Sydney,"Downie, Tom",5,2,2,3,0,0,4,1
Greater Western Sydney,"Greene, Toby",27,12,5,15,0,1,0,5
Greater Western Sydney,"Griffen, Ryan",22,10,5,12,1,0,2,1
Greater Western Sydney,"Hoskin-Elliott, Will",14,10,6,4,1,0,0,5
Greater Western Sydney,"Kelly, Josh",20,15,6,5,0,0,0,7
Greater Western Sydney,"Lamb, Jed",8,7,2,1,1,2,0,1
Greater Western Sydney,"Lobb, Rory",7,5,4,2,1,0,10,6
Greater Western Sydney,"Patfull, Joel",12,7,8,5,0,0,0,3
Greater Western Sydney,"Scully, Tom",13,7,3,6,1,0,0,6
Greater Western Sydney,"Shaw, Heath",31,25,13,6,0,0,0,6
Greater Western Sydney,"Steele, Jack",7,3,2,4,0,0,1,4
Greater Western Sydney,"Stewart, James",9,5,2,4,0,0,1,2
Greater Western Sydney,"Tomlinson, Adam",14,12,8,2,0,0,0,3
Greater Western Sydney,"Treloar, Adam",33,17,7,16,0,0,0,6
Greater Western Sydney,"Ward, Callan",21,10,6,11,0,0,1,4
Greater Western Sydney,"Whitfield, Lachie",15,8,7,7,0,0,0,4
Greater Western Sydney,"Wilson, Nathan",11,7,4,4,1,0,0,3
Greater Western Sydney,"Cameron, Jeremy",13,9,7,4,2,2,0,1
Greater Western Sydney,"Coniglio, Stephen",27,14,5,13,1,0,5,2
Greater Western Sydney,"Corr, Aidan",8,6,4,2,0,0,1,3
Greater Western Sydney,"Davis, Phil",9,7,5,2,0,0,1,0
Greater Western Sydney,"Greene, Toby",31,15,5,16,1,0,2,5
Greater Western Sydney,"Griffen, Ryan",16,6,3,10,0,0,0,3
Greater Western Sydney,"Haynes, Nick",12,7,5,5,1,0,0,2
Greater Western Sydney,"Hoskin-Elliott, Will",9,8,4,1,1,1,0,5
Greater Western Sydney,"Kelly, Josh",22,9,5,13,2,1,0,1
Greater Western Sydney,"Lobb, Rory",12,5,5,7,0,1,6,3
Greater Western Sydney,"McCarthy, Cam",11,7,5,4,2,0,0,1
Greater Western Sydney,"Palmer, Rhys",11,9,2,2,1,0,0,4
Greater Western Sydney,"Patfull, Joel",8,6,2,2,0,0,0,4
Greater Western Sydney,"Patton, Jonathon",9,7,4,2,0,1,0,0
Greater Western Sydney,"Phillips, Andrew",9,3,6,6,0,0,16,1
Greater Western Sydney,"Scully, Tom",5,4,0,1,0,0,0,3
Greater Western Sydney,"Shaw, Heath",20,18,5,2,0,0,0,5
Greater Western Sydney,"Smith, Devon",10,8,4,2,2,0,0,4
Greater Western Sydney,"Treloar, Adam",24,11,2,13,0,1,0,9
Greater Western Sydney,"Ward, Callan",21,8,1,13,0,0,0,5
Greater Western Sydney,"Whitfield, Lachie",24,15,4,9,1,0,0,3
Greater Western Sydney,"Wilson, Nathan",18,14,6,4,0,0,0,0
Greater Western Sydney,"Bugg, Tomas",10,6,2,4,0,0,0,3
Greater Western Sydney,"Cameron, Jeremy",9,6,3,3,3,1,0,2
Greater Western Sydney,"Corr, Aidan",12,2,4,10,0,0,0,3
Greater Western Sydney,"Davis, Phil",4,1,0,3,0,0,0,0
Greater Western Sydney,"Greene, Toby",27,10,2,17,0,0,0,5
Greater Western Sydney,"Griffen, Ryan",31,14,2,17,0,0,4,8
Greater Western Sydney,"Haynes, Nick",12,8,5,4,0,0,0,6
Greater Western Sydney,"Hoskin-Elliott, Will",10,7,2,3,0,0,0,2
Greater Western Sydney,"Kelly, Josh",25,13,2,12,0,2,0,4
Greater Western Sydney,"Lobb, Rory",8,1,1,7,1,0,7,2
Greater Western Sydney,"McCarthy, Cam",7,4,1,3,1,0,0,3
Greater Western Sydney,"Palmer, Rhys",16,11,6,5,5,3,0,2
Greater Western Sydney,"Patfull, Joel",9,2,2,7,0,0,0,3
Greater Western Sydney,"Patton, Jonathon",9,4,4,5,1,1,0,0
Greater Western Sydney,"Phillips, Andrew",7,2,2,5,0,0,26,2
Greater Western Sydney,"Shaw, Heath",23,18,3,5,1,0,0,1
Greater Western Sydney,"Smith, Devon",13,7,2,6,0,1,0,1
Greater Western Sydney,"Steele, Jack",8,2,1,6,0,1,2,4
Greater Western Sydney,"Ward, Callan",30,13,1,17,0,1,3,4
Greater Western Sydney,"Whitfield, Lachie",12,7,3,5,0,0,0,4
Greater Western Sydney,"Williams, Zac",19,11,5,8,1,0,0,5
Greater Western Sydney,"Wilson, Nathan",16,11,4,5,0,0,0,2
Greater Western Sydney,"Bugg, Tomas",14,5,0,9,0,0,0,2
Greater Western Sydney,"Cameron, Jeremy",9,7,6,2,3,0,0,0
Greater Western Sydney,"Coniglio, Stephen",27,9,1,18,0,0,2,4
Greater Western Sydney,"Corr, Aidan",8,4,3,4,0,0,0,3
Greater Western Sydney,"Greene, Toby",22,6,5,16,0,0,0,3
Greater Western Sydney,"Griffen, Ryan",27,11,2,16,0,0,1,5
Greater Western Sydney,"Haynes, Nick",6,4,0,2,0,0,0,0
Greater Western Sydney,"Hoskin-Elliott, Will",7,5,2,2,0,0,0,2
Greater Western Sydney,"Kelly, Josh",20,9,4,11,0,2,0,4
Greater Western Sydney,"Lobb, Rory",7,2,3,5,0,0,5,2
Greater Western Sydney,"Marchbank, Caleb",14,5,3,9,0,0,0,0
Greater Western Sydney,"McCarthy, Cam",2,1,1,1,0,0,0,1
Greater Western Sydney,"Palmer, Rhys",16,10,2,6,0,2,0,2
Greater Western Sydney,"Patfull, Joel",11,4,5,7,0,0,0,5
Greater Western Sydney,"Patton, Jonathon",11,9,5,2,2,1,0,4
Greater Western Sydney,"Phillips, Andrew",12,5,2,7,1,0,28,2
Greater Western Sydney,"Shaw, Heath",32,26,5,6,0,1,0,3
Greater Western Sydney,"Treloar, Adam",29,13,5,16,0,1,2,5
Greater Western Sydney,"Ward, Callan",26,8,4,18,0,0,2,5
Greater Western Sydney,"Whitfield, Lachie",25,16,6,9,0,0,0,0
Greater Western Sydney,"Williams, Zac",25,12,3,13,0,0,0,1
Greater Western Sydney,"Wilson, Nathan",15,9,3,6,0,0,0,3
Greater Western Sydney,"Bugg, Tomas",22,11,4,11,2,1,0,2
Greater Western Sydney,"Cameron, Jeremy",17,15,12,2,7,3,0,4
Greater Western Sydney,"Coniglio, Stephen",14,7,1,7,0,1,2,3
Greater Western Sydney,"Corr, Aidan",9,6,2,3,0,0,0,2
Greater Western Sydney,"Downie, Tom",11,3,6,8,0,0,37,4
Greater Western Sydney,"Greene, Toby",16,5,2,11,1,0,1,7
Greater Western Sydney,"Griffen, Ryan",13,7,1,6,1,0,0,2
Greater Western Sydney,"Kelly, Josh",18,9,2,9,2,0,0,7
Greater Western Sydney,"Kennedy, Adam",22,13,8,9,0,0,0,0
Greater Western Sydney,"Marchbank, Caleb",10,6,4,4,0,0,0,4
Greater Western Sydney,"McCarthy, Cam",7,5,1,2,0,0,0,3
Greater Western Sydney,"Palmer, Rhys",25,16,9,9,0,2,0,2
Greater Western Sydney,"Plowman, Lachie",20,3,2,17,0,0,0,3
Greater Western Sydney,"Shaw, Heath",21,17,5,4,0,0,0,0
Greater Western Sydney,"Smith, Devon",25,14,2,11,0,0,0,6
Greater Western Sydney,"Stewart, James",11,8,8,3,2,2,0,1
Greater Western Sydney,"Tomlinson, Adam",20,9,6,11,1,0,2,3
Greater Western Sydney,"Treloar, Adam",28,14,5,14,3,0,0,7
Greater Western Sydney,"Ward, Callan",23,9,3,14,0,1,0,7
Greater Western Sydney,"Whitfield, Lachie",22,12,6,10,1,0,0,5
Greater Western Sydney,"Williams, Zac",18,9,6,9,0,0,0,6
Greater Western Sydney,"Wilson, Nathan",18,12,5,6,0,1,0,2
Greater Western Sydney,"Barrett, Jake",7,1,2,6,0,0,0,3
Greater Western Sydney,"Bugg, Tomas",16,6,4,10,0,1,0,1
Greater Western Sydney,"Cameron, Jeremy",8,8,4,0,2,2,1,0
Greater Western Sydney,"Corr, Aidan",7,5,3,2,0,0,0,2
Greater Western Sydney,"Downie, Tom",5,0,2,5,0,0,21,4
Greater Western Sydney,"Greene, Toby",20,11,0,9,1,0,0,0
Greater Western Sydney,"Kelly, Josh",20,11,2,9,0,0,0,9
Greater Western Sydney,"Kennedy, Adam",15,8,5,7,0,0,1,0
Greater Western Sydney,"Marchbank, Caleb",2,0,0,2,0,0,0,0
Greater Western Sydney,"McCarthy, Cam",11,9,3,2,0,2,0,1
Greater Western Sydney,"Palmer, Rhys",20,10,4,10,1,0,0,3
Greater Western Sydney,"Plowman, Lachie",16,8,3,8,0,0,0,1
Greater Western Sydney,"Shaw, Heath",21,18,4,3,0,0,0,1
Greater Western Sydney,"Smith, Devon",21,14,2,7,1,1,0,10
Greater Western Sydney,"Stewart, James",10,5,4,5,1,1,0,2
Greater Western Sydney,"Tomlinson, Adam",15,11,7,4,0,1,5,1
Greater Western Sydney,"Townsend, Jacob",22,10,3,12,1,0,1,6
Greater Western Sydney,"Treloar, Adam",26,11,4,15,0,1,0,3
Greater Western Sydney,"Ward, Callan",32,10,6,22,1,0,1,7
Greater Western Sydney,"Whitfield, Lachie",13,6,2,7,1,0,0,2
Greater Western Sydney,"Williams, Zac",14,8,3,6,2,0,0,3
Greater Western Sydney,"Wilson, Nathan",9,6,3,3,0,0,0,1
Hawthorn,"Anderson, Jed",8,5,1,3,1,2,0,5
Hawthorn,"Breust, Luke",14,12,7,2,5,2,0,0
Hawthorn,"Burgoyne, Shaun",18,8,2,10,0,0,0,6
Hawthorn,"Ceglar, Jonathon",14,8,4,6,0,0,15,3
Hawthorn,"Duryea, Taylor",15,13,8,2,0,0,0,4
Hawthorn,"Frawley, James",18,9,11,9,0,0,0,0
Hawthorn,"Gibson, Josh",26,15,11,11,0,0,0,2
Hawthorn,"Gunston, Jack",12,8,3,4,1,1,0,1
Hawthorn,"Hill, Bradley",15,9,7,6,0,0,0,1
Hawthorn,"Hodge, Luke",27,21,7,6,0,0,3,6
Hawthorn,"Lake, Brian",11,5,7,6,0,0,1,2
Hawthorn,"Langford, Will",19,12,3,7,0,3,1,3
Hawthorn,"Lewis, Jordan",35,25,13,10,0,0,4,4
Hawthorn,"McEvoy, Ben",8,6,4,2,2,0,13,0
Hawthorn,"Mitchell, Sam",21,13,3,8,1,0,0,3
Hawthorn,"Puopolo, Paul",15,8,4,7,3,1,0,5
Hawthorn,"Rioli, Cyril",16,11,8,5,1,2,0,2
Hawthorn,"Roughead, Jarryd",12,9,2,3,3,2,1,6
Hawthorn,"Shiels, Liam",11,7,3,4,0,0,0,1
Hawthorn,"Smith, Isaac",24,12,6,12,0,0,1,1
Hawthorn,"Stratton, Ben",9,6,5,3,0,0,0,2
Hawthorn,"Suckling, Matt",19,14,5,5,0,2,0,2
Hawthorn,"Anderson, Jed",15,6,1,9,0,0,1,6
Hawthorn,"Birchall, Grant",25,19,2,6,0,0,0,3
Hawthorn,"Breust, Luke",13,9,3,4,2,2,0,4
Hawthorn,"Burgoyne, Shaun",23,7,3,16,0,0,0,4
Hawthorn,"Ceglar, Jonathon",14,3,6,11,0,0,24,0
Hawthorn,"Duryea, Taylor",12,6,0,6,0,0,0,2
Hawthorn,"Frawley, James",0,0,0,0,0,0,0,0
Hawthorn,"Gunston, Jack",20,16,11,4,3,1,0,2
Hawthorn,"Hill, Bradley",20,15,6,5,1,0,0,2
Hawthorn,"Hodge, Luke",30,18,7,12,0,1,2,3
Hawthorn,"Lake, Brian",16,11,7,5,0,0,0,2
Hawthorn,"Langford, Will",15,4,0,11,0,0,3,4
Hawthorn,"Lewis, Jordan",34,18,6,16,0,0,2,3
Hawthorn,"McEvoy, Ben",8,1,0,7,0,0,10,2
Hawthorn,"ORourke, Jonathan",16,6,3,10,0,0,0,1
Hawthorn,"Puopolo, Paul",13,6,1,7,2,1,0,9
Hawthorn,"Rioli, Cyril",18,11,2,7,1,1,2,5
Hawthorn,"Roughead, Jarryd",16,9,5,7,1,0,3,3
Hawthorn,"Sicily, James",10,4,1,6,1,1,1,1
Hawthorn,"Smith, Isaac",17,12,5,5,0,0,1,3
Hawthorn,"Stratton, Ben",16,9,6,7,0,0,0,3
Hawthorn,"Suckling, Matt",25,16,9,9,0,1,0,0
Hawthorn,"Anderson, Jed",3,0,0,3,0,0,0,2
Hawthorn,"Birchall, Grant",30,20,5,10,1,0,0,1
Hawthorn,"Breust, Luke",12,4,3,8,2,0,0,4
Hawthorn,"Burgoyne, Shaun",17,11,5,6,0,0,0,4
Hawthorn,"Ceglar, Jonathon",19,6,5,13,0,0,15,3
Hawthorn,"Duryea, Taylor",29,18,11,11,0,0,0,0
Hawthorn,"Gibson, Josh",21,5,6,16,0,0,0,2
Hawthorn,"Gunston, Jack",16,12,8,4,2,0,1,2
Hawthorn,"Hartung, Billy",24,14,2,10,1,0,0,4
Hawthorn,"Hodge, Luke",44,26,7,18,2,0,3,2
Hawthorn,"Lake, Brian",15,5,12,10,0,0,0,1
Hawthorn,"Langford, Will",26,7,3,19,0,1,1,3
Hawthorn,"Lewis, Jordan",41,26,9,15,0,0,3,4
Hawthorn,"McEvoy, Ben",8,2,2,6,1,0,22,3
Hawthorn,"Mitchell, Sam",27,14,2,13,1,0,0,10
Hawthorn,"Puopolo, Paul",16,9,3,7,1,3,0,7
Hawthorn,"Rioli, Cyril",18,12,6,6,1,3,0,4
Hawthorn,"Roughead, Jarryd",28,16,8,12,7,3,0,1
Hawthorn,"Smith, Isaac",36,20,5,16,0,1,0,4
Hawthorn,"Stratton, Ben",11,5,5,6,0,0,0,1
Hawthorn,"Suckling, Matt",25,16,7,9,0,0,0,4
Hawthorn,"Whitecross, Brendan",12,4,4,8,0,0,0,1
Hawthorn,"Birchall, Grant",18,10,3,8,0,0,0,0
Hawthorn,"Breust, Luke",15,10,4,5,1,1,1,2
Hawthorn,"Burgoyne, Shaun",17,12,2,5,0,1,0,7
Hawthorn,"Ceglar, Jonathon",2,2,0,0,0,0,31,2
Hawthorn,"Duryea, Taylor",25,19,14,6,1,0,0,2
Hawthorn,"Gibson, Josh",29,17,12,12,0,1,0,1
Hawthorn,"Gunston, Jack",13,8,5,5,3,2,1,2
Hawthorn,"Hartung, Billy",19,9,2,10,1,1,0,2
Hawthorn,"Hill, Bradley",18,11,2,7,1,1,0,0
Hawthorn,"Hodge, Luke",28,13,5,15,1,0,1,0
Hawthorn,"Lake, Brian",2,1,0,1,0,0,0,1
Hawthorn,"Langford, Will",20,12,3,8,0,1,1,4
Hawthorn,"Lewis, Jordan",36,20,8,16,0,0,1,3
Hawthorn,"McEvoy, Ben",9,2,4,7,0,0,15,3
Hawthorn,"Mitchell, Sam",18,9,1,9,0,0,0,5
Hawthorn,"Puopolo, Paul",9,5,2,4,1,0,0,0
Hawthorn,"Rioli, Cyril",16,9,3,7,2,0,0,4
Hawthorn,"Roughead, Jarryd",11,4,2,7,0,1,1,4
Hawthorn,"Smith, Isaac",29,22,8,7,2,1,1,8
Hawthorn,"Stratton, Ben",14,7,4,7,0,0,0,0
Hawthorn,"Suckling, Matt",24,14,7,10,0,0,0,1
Hawthorn,"Whitecross, Brendan",19,12,8,7,0,0,1,3
Hawthorn,"Birchall, Grant",23,15,9,8,0,0,0,2
Hawthorn,"Breust, Luke",16,9,6,7,4,2,0,2
Hawthorn,"Burgoyne, Shaun",15,11,4,4,0,0,0,1
Hawthorn,"Ceglar, Jonathon",15,7,2,8,2,0,22,2
Hawthorn,"Duryea, Taylor",13,10,3,3,0,0,0,0
Hawthorn,"Gibson, Josh",18,10,7,8,0,0,0,0
Hawthorn,"Gunston, Jack",23,17,13,6,4,3,0,3
Hawthorn,"Hartung, Billy",18,12,3,6,0,1,0,1
Hawthorn,"Hill, Bradley",19,12,4,7,1,1,0,1
Hawthorn,"Hodge, Luke",21,15,7,6,0,0,1,6
Hawthorn,"Langford, Will",17,10,4,7,0,1,0,4
Hawthorn,"Lewis, Jordan",29,16,7,13,1,0,0,4
Hawthorn,"McEvoy, Ben",10,2,2,8,0,1,13,4
Hawthorn,"Mitchell, Sam",33,21,8,12,1,0,0,4
Hawthorn,"Rioli, Cyril",18,12,4,6,1,1,0,2
Hawthorn,"Roughead, Jarryd",18,11,5,7,3,2,1,1
Hawthorn,"Schoenmakers, Ryan",12,10,6,2,0,0,0,0
Hawthorn,"Shiels, Liam",19,9,3,10,0,0,0,5
Hawthorn,"Smith, Isaac",27,17,11,10,2,1,0,2
Hawthorn,"Stratton, Ben",13,8,4,5,0,0,0,5
Hawthorn,"Suckling, Matt",24,13,8,11,0,2,0,0
Hawthorn,"Whitecross, Brendan",8,3,5,5,0,0,0,0
Hawthorn,"Anderson, Jed",14,7,2,7,0,1,2,7
Hawthorn,"Birchall, Grant",29,16,9,13,0,1,0,2
Hawthorn,"Breust, Luke",15,7,3,8,1,2,0,6
Hawthorn,"Burgoyne, Shaun",31,13,5,18,1,0,0,2
Hawthorn,"Ceglar, Jonathon",11,5,2,6,0,0,25,3
Hawthorn,"Duryea, Taylor",21,15,9,6,1,0,0,5
Hawthorn,"Gibson, Josh",24,10,10,14,0,1,0,1
Hawthorn,"Gunston, Jack",19,12,8,7,2,2,0,0
Hawthorn,"Hartung, Billy",22,11,6,11,2,0,0,0
Hawthorn,"Hill, Bradley",20,10,7,10,0,0,0,3
Hawthorn,"Langford, Will",24,13,1,11,0,0,5,3
Hawthorn,"McEvoy, Ben",8,2,2,6,0,0,8,1
Hawthorn,"Mitchell, Sam",34,14,2,20,1,0,0,4
Hawthorn,"Puopolo, Paul",13,6,4,7,1,0,0,5
Hawthorn,"Rioli, Cyril",14,9,6,5,0,1,2,4
Hawthorn,"Roughead, Jarryd",15,8,4,7,2,0,1,3
Hawthorn,"Schoenmakers, Ryan",13,7,2,6,0,0,0,1
Hawthorn,"Shiels, Liam",18,9,2,9,1,1,0,8
Hawthorn,"Smith, Isaac",29,20,4,9,2,2,2,5
Hawthorn,"Stratton, Ben",12,9,4,3,0,0,0,2
Hawthorn,"Suckling, Matt",23,13,7,10,0,0,0,3
Hawthorn,"Whitecross, Brendan",5,4,2,1,0,0,0,1
Hawthorn,"Birchall, Grant",20,7,2,13,0,0,0,2
Hawthorn,"Breust, Luke",14,11,4,3,3,2,1,5
Hawthorn,"Burgoyne, Shaun",23,7,2,16,0,0,0,8
Hawthorn,"Ceglar, Jonathon",10,5,3,5,1,1,32,3
Hawthorn,"Duryea, Taylor",16,12,6,4,0,0,0,3
Hawthorn,"Frawley, James",6,5,3,1,0,0,0,2
Hawthorn,"Gibson, Josh",21,11,7,10,0,0,0,2
Hawthorn,"Gunston, Jack",18,16,11,2,1,0,3,4
Hawthorn,"Hale, David",7,3,4,4,2,0,17,2
Hawthorn,"Hartung, Billy",26,7,5,19,1,0,0,3
Hawthorn,"Hill, Bradley",24,17,6,7,1,2,0,1
Hawthorn,"Langford, Will",26,13,1,13,2,1,1,3
Hawthorn,"Litherland, Angus",10,5,4,5,0,0,0,1
Hawthorn,"Mitchell, Sam",30,16,1,14,1,0,0,6
Hawthorn,"Puopolo, Paul",15,8,2,7,2,0,0,2
Hawthorn,"Rioli, Cyril",11,10,5,1,3,1,0,6
Hawthorn,"Roughead, Jarryd",30,17,10,13,4,1,1,2
Hawthorn,"Schoenmakers, Ryan",8,6,3,2,2,0,3,2
Hawthorn,"Shiels, Liam",26,12,2,14,0,0,1,13
Hawthorn,"Simpkin, Jonathan",7,3,2,4,0,0,0,2
Hawthorn,"Stratton, Ben",14,9,7,5,0,0,0,0
Hawthorn,"Suckling, Matt",18,10,4,8,1,1,0,2
Hawthorn,"Birchall, Grant",17,13,1,4,0,0,0,2
Hawthorn,"Breust, Luke",11,7,3,4,1,1,0,5
Hawthorn,"Burgoyne, Shaun",15,6,1,9,0,0,0,5
Hawthorn,"Ceglar, Jonathon",16,9,2,7,1,1,29,7
Hawthorn,"Frawley, James",9,4,3,5,0,0,0,1
Hawthorn,"Gibson, Josh",20,8,8,12,0,0,0,2
Hawthorn,"Gunston, Jack",21,10,8,11,1,3,1,5
Hawthorn,"Hale, David",7,3,2,4,0,0,16,5
Hawthorn,"Hartung, Billy",9,5,1,4,0,0,0,2
Hawthorn,"Hill, Bradley",26,15,6,11,0,0,0,0
Hawthorn,"Lake, Brian",11,8,4,3,0,0,0,0
Hawthorn,"Langford, Will",20,8,1,12,1,0,3,5
Hawthorn,"Lewis, Jordan",31,15,6,16,0,0,7,3
Hawthorn,"Mitchell, Sam",32,18,4,14,0,0,0,5
Hawthorn,"Puopolo, Paul",8,2,0,6,1,1,0,3
Hawthorn,"Rioli, Cyril",16,10,5,6,2,1,0,4
Hawthorn,"Roughead, Jarryd",21,11,6,10,0,3,0,1
Hawthorn,"Schoenmakers, Ryan",11,6,2,5,2,1,0,4
Hawthorn,"Shiels, Liam",18,11,5,7,0,0,0,8
Hawthorn,"Smith, Isaac",28,18,9,10,0,1,0,1
Hawthorn,"Stratton, Ben",10,7,2,3,0,0,0,2
Hawthorn,"Suckling, Matt",11,9,4,2,0,0,0,3
Hawthorn,"Breust, Luke",14,8,4,6,3,1,1,3
Hawthorn,"Burgoyne, Shaun",23,14,2,9,1,1,0,1
Hawthorn,"Ceglar, Jonathon",15,4,4,11,0,0,23,4
Hawthorn,"Duryea, Taylor",26,20,11,6,0,0,0,4
Hawthorn,"Frawley, James",20,10,7,10,0,0,0,2
Hawthorn,"Gibson, Josh",29,10,10,19,0,0,0,3
Hawthorn,"Gunston, Jack",18,11,6,7,2,1,0,2
Hawthorn,"Hale, David",6,4,3,2,3,0,22,2
Hawthorn,"Hartung, Billy",26,12,7,14,0,0,0,4
Hawthorn,"Hill, Bradley",33,20,6,13,0,0,0,4
Hawthorn,"Hodge, Luke",30,17,5,13,1,0,0,8
Hawthorn,"Howe, Daniel",11,8,5,3,0,0,0,1
Hawthorn,"Lake, Brian",26,17,11,9,0,0,0,1
Hawthorn,"Litherland, Angus",17,10,5,7,0,0,0,1
Hawthorn,"Mitchell, Sam",36,17,2,19,0,0,0,5
Hawthorn,"Puopolo, Paul",17,4,1,13,0,0,0,12
Hawthorn,"Rioli, Cyril",11,5,1,6,1,0,0,4
Hawthorn,"Roughead, Jarryd",11,5,1,6,0,1,0,5
Hawthorn,"Shiels, Liam",28,16,6,12,1,2,1,14
Hawthorn,"Smith, Isaac",30,19,7,11,1,0,1,2
Hawthorn,"Stratton, Ben",19,10,4,9,0,0,0,2
Hawthorn,"Suckling, Matt",28,16,6,12,1,0,0,1
Hawthorn,"Breust, Luke",14,9,2,5,1,1,0,7
Hawthorn,"Burgoyne, Shaun",14,7,6,7,0,0,0,2
Hawthorn,"Ceglar, Jonathon",9,6,4,3,0,0,22,2
Hawthorn,"Duryea, Taylor",19,11,5,8,1,0,0,4
Hawthorn,"Frawley, James",13,7,4,6,0,0,0,0
Hawthorn,"Gibson, Josh",16,10,5,6,0,0,0,1
Hawthorn,"Gunston, Jack",17,13,8,4,3,2,0,2
Hawthorn,"Hale, David",12,4,4,8,0,1,15,1
Hawthorn,"Hartung, Billy",26,12,6,14,1,0,0,1
Hawthorn,"Hill, Bradley",14,9,2,5,2,0,0,3
Hawthorn,"Hodge, Luke",25,18,8,7,2,0,0,2
Hawthorn,"Lake, Brian",12,7,3,5,0,0,0,2
Hawthorn,"Lewis, Jordan",22,12,3,10,1,0,0,2
Hawthorn,"Litherland, Angus",3,1,1,2,0,0,0,1
Hawthorn,"Mitchell, Sam",35,14,2,21,0,0,0,0
Hawthorn,"Rioli, Cyril",13,11,2,2,1,2,0,2
Hawthorn,"Roughead, Jarryd",19,12,6,7,3,0,0,2
Hawthorn,"Schoenmakers, Ryan",10,9,5,1,2,1,0,2
Hawthorn,"Shiels, Liam",16,10,3,6,2,2,0,5
Hawthorn,"Smith, Isaac",22,14,8,8,1,1,1,0
Hawthorn,"Stratton, Ben",8,7,3,1,0,0,0,3
Hawthorn,"Suckling, Matt",18,12,5,6,0,0,0,0
Hawthorn,"Breust, Luke",15,8,3,7,3,0,0,1
Hawthorn,"Burgoyne, Shaun",23,12,4,11,1,0,0,5
Hawthorn,"Ceglar, Jonathon",10,4,2,6,1,0,17,5
Hawthorn,"Duryea, Taylor",16,12,7,4,1,0,0,3
Hawthorn,"Frawley, James",10,9,4,1,0,0,0,2
Hawthorn,"Gibson, Josh",18,14,8,4,0,0,0,1
Hawthorn,"Gunston, Jack",6,2,0,4,0,0,0,1
Hawthorn,"Hale, David",15,4,2,11,2,0,28,3
Hawthorn,"Hartung, Billy",4,2,0,2,1,0,0,1
Hawthorn,"Hill, Bradley",24,13,5,11,1,1,0,0
Hawthorn,"Hodge, Luke",25,19,8,6,1,0,0,0
Hawthorn,"Lake, Brian",14,7,6,7,0,0,0,3
Hawthorn,"Lewis, Jordan",24,13,3,11,0,0,4,2
Hawthorn,"Mitchell, Sam",25,15,3,10,0,0,0,5
Hawthorn,"Puopolo, Paul",11,6,0,5,1,1,0,8
Hawthorn,"Rioli, Cyril",14,11,2,3,1,1,0,8
Hawthorn,"Roughead, Jarryd",12,7,3,5,0,1,3,6
Hawthorn,"Schoenmakers, Ryan",6,3,2,3,0,0,0,2
Hawthorn,"Shiels, Liam",25,15,5,10,1,1,0,8
Hawthorn,"Smith, Isaac",21,14,5,7,2,1,2,4
Hawthorn,"Stratton, Ben",11,6,4,5,0,0,0,3
Hawthorn,"Suckling, Matt",22,16,4,6,1,2,0,4
Hawthorn,"Birchall, Grant",23,17,7,6,0,0,0,0
Hawthorn,"Breust, Luke",14,6,3,8,1,0,0,4
Hawthorn,"Burgoyne, Shaun",13,7,0,6,0,0,0,2
Hawthorn,"Ceglar, Jonathon",14,8,6,6,0,2,28,2
Hawthorn,"Duryea, Taylor",22,18,11,4,0,0,0,1
Hawthorn,"Frawley, James",3,1,1,2,0,0,0,2
Hawthorn,"Gibson, Josh",22,12,11,10,0,1,0,1
Hawthorn,"Gunston, Jack",15,12,10,3,3,4,0,1
Hawthorn,"Hale, David",13,2,1,11,0,0,18,1
Hawthorn,"Hartung, Billy",16,13,3,3,0,1,0,0
Hawthorn,"Hill, Bradley",16,9,5,7,3,0,0,0
Hawthorn,"Hodge, Luke",13,11,4,2,0,1,1,1
Hawthorn,"Lake, Brian",13,7,6,6,0,0,0,3
Hawthorn,"Langford, Will",15,10,2,5,1,0,0,6
Hawthorn,"Lewis, Jordan",24,7,6,17,0,0,3,3
Hawthorn,"Mitchell, Sam",32,19,3,13,0,0,0,1
Hawthorn,"Puopolo, Paul",13,7,3,6,4,1,0,3
Hawthorn,"Roughead, Jarryd",29,18,8,11,1,3,0,7
Hawthorn,"Shiels, Liam",28,11,7,17,0,0,0,6
Hawthorn,"Smith, Isaac",21,13,8,8,1,0,0,2
Hawthorn,"Stratton, Ben",7,3,2,4,0,0,0,4
Hawthorn,"Suckling, Matt",18,11,3,7,2,1,0,0
Hawthorn,"Birchall, Grant",17,11,2,6,0,0,0,0
Hawthorn,"Breust, Luke",9,6,4,3,3,0,0,3
Hawthorn,"Burgoyne, Shaun",22,11,6,11,0,0,0,5
Hawthorn,"Ceglar, Jonathon",5,1,1,4,0,1,17,4
Hawthorn,"Duryea, Taylor",16,5,3,11,0,0,0,3
Hawthorn,"Gibson, Josh",13,8,7,5,0,0,0,3
Hawthorn,"Gunston, Jack",19,12,7,7,2,4,1,1
Hawthorn,"Hale, David",7,4,2,3,0,2,25,3
Hawthorn,"Hill, Bradley",24,12,6,12,0,1,0,4
Hawthorn,"Hodge, Luke",29,13,5,16,0,0,0,9
Hawthorn,"Lake, Brian",11,9,6,2,0,0,0,0
Hawthorn,"Langford, Will",18,7,2,11,0,0,0,4
Hawthorn,"Lewis, Jordan",36,21,10,15,0,0,4,1
Hawthorn,"Mitchell, Sam",33,11,6,22,0,0,0,5
Hawthorn,"Puopolo, Paul",14,4,1,10,0,0,0,1
Hawthorn,"Rioli, Cyril",10,7,5,3,5,0,1,4
Hawthorn,"Schoenmakers, Ryan",12,5,3,7,1,0,0,4
Hawthorn,"Shiels, Liam",29,15,4,14,2,0,0,6
Hawthorn,"Smith, Isaac",25,12,7,13,1,0,0,1
Hawthorn,"Spangher, Matthew",11,6,4,5,0,0,0,1
Hawthorn,"Stratton, Ben",9,6,4,3,0,0,0,6
Hawthorn,"Suckling, Matt",7,5,3,2,1,1,0,1
Hawthorn,"Birchall, Grant",31,18,7,13,0,1,0,3
Hawthorn,"Breust, Luke",19,8,4,11,4,0,1,7
Hawthorn,"Burgoyne, Shaun",13,6,3,7,0,0,0,6
Hawthorn,"Duryea, Taylor",13,10,8,3,1,0,0,1
Hawthorn,"Gibson, Josh",27,18,9,9,0,0,0,2
Hawthorn,"Gunston, Jack",11,6,3,5,0,0,0,3
Hawthorn,"Hale, David",10,2,3,8,1,0,16,4
Hawthorn,"Hartung, Billy",8,5,3,3,0,1,0,1
Hawthorn,"Hill, Bradley",16,13,2,3,1,0,0,0
Hawthorn,"Hodge, Luke",31,23,7,8,3,1,1,7
Hawthorn,"Lake, Brian",24,19,13,5,0,0,0,0
Hawthorn,"Lewis, Jordan",27,14,6,13,1,1,2,4
Hawthorn,"McEvoy, Ben",12,6,7,6,2,0,24,6
Hawthorn,"Mitchell, Sam",39,18,10,21,1,1,0,3
Hawthorn,"Puopolo, Paul",18,7,2,11,2,0,0,12
Hawthorn,"Rioli, Cyril",16,7,3,9,0,1,0,5
Hawthorn,"Schoenmakers, Ryan",13,8,4,5,0,0,0,2
Hawthorn,"Shiels, Liam",28,14,3,14,0,0,0,8
Hawthorn,"Smith, Isaac",21,10,8,11,1,1,0,3
Hawthorn,"Spangher, Matthew",17,13,9,4,0,0,0,0
Hawthorn,"Stratton, Ben",9,4,1,5,0,0,0,3
Hawthorn,"Suckling, Matt",24,18,11,6,0,1,0,3
Hawthorn,"Birchall, Grant",27,19,9,8,0,0,0,1
Hawthorn,"Breust, Luke",19,6,3,13,2,0,1,1
Hawthorn,"Burgoyne, Shaun",12,6,2,6,0,0,0,6
Hawthorn,"Gibson, Josh",20,15,12,5,0,0,0,0
Hawthorn,"Gunston, Jack",18,12,8,6,4,1,0,3
Hawthorn,"Hale, David",8,3,0,5,1,0,16,3
Hawthorn,"Hartung, Billy",8,6,1,2,0,0,0,0
Hawthorn,"Hodge, Luke",30,20,8,10,0,1,1,7
Hawthorn,"Lake, Brian",14,9,3,5,0,0,0,4
Hawthorn,"Lewis, Jordan",22,14,6,8,0,0,3,5
Hawthorn,"Litherland, Angus",17,12,4,5,1,0,0,0
Hawthorn,"McEvoy, Ben",15,6,8,9,2,0,27,5
Hawthorn,"Mitchell, Sam",28,11,2,17,0,0,0,1
Hawthorn,"Puopolo, Paul",15,7,2,8,1,2,0,6
Hawthorn,"Rioli, Cyril",20,12,6,8,3,1,0,8
Hawthorn,"Roughead, Jarryd",16,11,7,5,5,2,1,0
Hawthorn,"Schoenmakers, Ryan",14,8,3,6,1,0,0,1
Hawthorn,"Shiels, Liam",17,6,3,11,1,0,0,7
Hawthorn,"Smith, Isaac",21,14,4,7,1,1,0,4
Hawthorn,"Spangher, Matthew",10,6,4,4,0,0,0,0
Hawthorn,"Stratton, Ben",9,4,0,5,0,0,0,1
Hawthorn,"Suckling, Matt",21,14,0,7,1,0,0,2
Hawthorn,"Birchall, Grant",21,11,5,10,0,0,0,0
Hawthorn,"Breust, Luke",19,12,5,7,3,2,0,2
Hawthorn,"Burgoyne, Shaun",17,10,6,7,0,0,0,3
Hawthorn,"Gibson, Josh",27,18,12,9,0,0,0,1
Hawthorn,"Gunston, Jack",26,20,12,6,6,1,0,4
Hawthorn,"Hale, David",13,5,3,8,1,0,7,0
Hawthorn,"Hartung, Billy",24,12,7,12,2,0,0,1
Hawthorn,"Hill, Bradley",24,15,1,9,0,1,0,1
Hawthorn,"Hodge, Luke",32,20,12,12,1,1,0,3
Hawthorn,"Lake, Brian",17,10,7,7,0,0,0,0
Hawthorn,"Lewis, Jordan",36,14,6,22,2,1,0,0
Hawthorn,"Litherland, Angus",12,8,6,4,0,0,0,1
Hawthorn,"McEvoy, Ben",16,9,8,7,2,0,14,3
Hawthorn,"Mitchell, Sam",35,16,11,19,0,0,0,1
Hawthorn,"ORourke, Jonathan",18,8,5,10,1,0,0,2
Hawthorn,"Puopolo, Paul",11,9,3,2,3,1,0,1
Hawthorn,"Rioli, Cyril",12,7,1,5,2,0,0,6
Hawthorn,"Roughead, Jarryd",22,14,5,8,2,1,0,5
Hawthorn,"Schoenmakers, Ryan",12,5,3,7,2,0,0,3
Hawthorn,"Smith, Isaac",25,13,6,12,0,2,0,0
Hawthorn,"Spangher, Matthew",7,5,6,2,0,0,0,1
Hawthorn,"Suckling, Matt",27,17,8,10,0,0,0,2
Hawthorn,"Birchall, Grant",24,12,5,12,0,0,0,1
Hawthorn,"Breust, Luke",5,1,0,4,0,0,1,3
Hawthorn,"Burgoyne, Shaun",30,13,4,17,0,0,0,3
Hawthorn,"Duryea, Taylor",12,8,4,4,0,0,0,4
Hawthorn,"Frawley, James",16,10,4,6,0,0,0,2
Hawthorn,"Gibson, Josh",16,9,5,7,0,0,0,3
Hawthorn,"Gunston, Jack",12,10,7,2,3,3,0,5
Hawthorn,"Hale, David",7,1,1,6,0,0,13,3
Hawthorn,"Hartung, Billy",12,7,1,5,0,0,0,0
Hawthorn,"Hill, Bradley",13,5,1,8,0,0,0,4
Hawthorn,"Hodge, Luke",28,14,3,14,0,0,5,5
Hawthorn,"Lake, Brian",12,3,4,9,0,0,1,2
Hawthorn,"Lewis, Jordan",34,18,4,16,0,0,2,3
Hawthorn,"McEvoy, Ben",10,1,2,9,0,0,21,2
Hawthorn,"Mitchell, Sam",28,10,2,18,0,0,0,3
Hawthorn,"Puopolo, Paul",9,6,2,3,2,0,0,4
Hawthorn,"Rioli, Cyril",17,10,4,7,1,2,0,2
Hawthorn,"Roughead, Jarryd",15,6,1,9,0,0,0,3
Hawthorn,"Schoenmakers, Ryan",11,4,2,7,1,0,1,4
Hawthorn,"Shiels, Liam",19,10,2,9,0,0,1,8
Hawthorn,"Smith, Isaac",27,16,5,11,0,0,0,4
Hawthorn,"Stratton, Ben",8,3,1,5,0,1,0,3
Hawthorn,"Birchall, Grant",22,17,4,5,1,0,0,0
Hawthorn,"Breust, Luke",22,11,2,11,3,0,0,7
Hawthorn,"Burgoyne, Shaun",17,14,1,3,2,0,0,5
Hawthorn,"Ceglar, Jonathon",5,1,1,4,1,0,25,5
Hawthorn,"Duryea, Taylor",5,5,2,0,0,1,0,0
Hawthorn,"Frawley, James",21,15,5,6,0,0,0,2
Hawthorn,"Gibson, Josh",18,7,3,11,0,0,0,0
Hawthorn,"Gunston, Jack",11,7,5,4,0,2,0,2
Hawthorn,"Hartung, Billy",21,19,6,2,2,0,0,1
Hawthorn,"Hill, Bradley",15,9,1,6,0,0,0,4
Hawthorn,"Hodge, Luke",18,15,6,3,0,1,0,7
Hawthorn,"Lewis, Jordan",30,15,5,15,0,0,3,6
Hawthorn,"McEvoy, Ben",12,3,2,9,0,0,32,8
Hawthorn,"Mitchell, Sam",36,24,5,12,0,0,0,3
Hawthorn,"Puopolo, Paul",10,7,0,3,1,0,0,1
Hawthorn,"Rioli, Cyril",18,11,5,7,1,1,0,9
Hawthorn,"Roughead, Jarryd",17,9,2,8,1,3,0,5
Hawthorn,"Schoenmakers, Ryan",14,9,5,5,0,1,0,5
Hawthorn,"Shiels, Liam",21,13,1,8,1,0,0,17
Hawthorn,"Smith, Isaac",16,13,7,3,0,0,2,4
Hawthorn,"Stratton, Ben",11,6,5,5,0,0,0,8
Hawthorn,"Suckling, Matt",17,12,5,5,0,0,0,2
Hawthorn,"Birchall, Grant",25,19,9,6,0,0,0,1
Hawthorn,"Breust, Luke",17,8,6,9,3,0,0,4
Hawthorn,"Burgoyne, Shaun",21,9,2,12,0,0,0,5
Hawthorn,"Frawley, James",15,11,5,4,0,0,0,1
Hawthorn,"Gibson, Josh",15,5,3,10,0,0,0,4
Hawthorn,"Gunston, Jack",18,12,7,6,1,1,0,0
Hawthorn,"Hale, David",8,1,2,7,0,0,21,2
Hawthorn,"Hartung, Billy",23,12,2,11,0,0,0,0
Hawthorn,"Hill, Bradley",9,8,3,1,0,1,0,3
Hawthorn,"Hodge, Luke",24,16,3,8,4,0,1,4
Hawthorn,"Howe, Daniel",4,2,2,2,0,0,0,0
Hawthorn,"Lake, Brian",14,10,9,4,0,0,0,0
Hawthorn,"Lewis, Jordan",25,15,7,10,0,1,2,2
Hawthorn,"McEvoy, Ben",15,8,4,7,0,0,32,2
Hawthorn,"Mitchell, Sam",28,16,3,12,0,0,0,7
Hawthorn,"Puopolo, Paul",14,8,4,6,1,0,0,8
Hawthorn,"Rioli, Cyril",12,10,1,2,6,0,0,1
Hawthorn,"Roughead, Jarryd",21,12,4,9,2,0,2,4
Hawthorn,"Shiels, Liam",25,10,7,15,1,0,0,11
Hawthorn,"Smith, Isaac",21,12,5,9,1,0,1,4
Hawthorn,"Stratton, Ben",8,5,2,3,0,0,0,5
Hawthorn,"Suckling, Matt",20,14,6,6,0,1,0,1
Hawthorn,"Birchall, Grant",21,15,5,6,0,1,0,2
Hawthorn,"Breust, Luke",12,11,3,1,0,0,1,1
Hawthorn,"Burgoyne, Shaun",17,8,4,9,1,1,0,7
Hawthorn,"Duryea, Taylor",20,18,10,2,0,0,0,2
Hawthorn,"Frawley, James",11,7,7,4,0,0,0,2
Hawthorn,"Gibson, Josh",24,15,9,9,0,0,0,2
Hawthorn,"Gunston, Jack",17,13,9,4,3,1,0,1
Hawthorn,"Hartung, Billy",7,3,3,4,0,0,0,0
Hawthorn,"Hill, Bradley",17,10,3,7,0,1,0,2
Hawthorn,"Hodge, Luke",19,12,2,7,0,0,5,4
Hawthorn,"Lake, Brian",5,2,2,3,0,0,0,2
Hawthorn,"Lewis, Jordan",26,15,5,11,1,0,3,2
Hawthorn,"McEvoy, Ben",14,2,3,12,0,0,22,2
Hawthorn,"Mitchell, Sam",27,15,3,12,0,0,1,3
Hawthorn,"Puopolo, Paul",9,4,1,5,1,0,0,5
Hawthorn,"Rioli, Cyril",10,5,3,5,2,0,0,2
Hawthorn,"Roughead, Jarryd",15,10,5,5,2,2,5,1
Hawthorn,"Schoenmakers, Ryan",11,9,5,2,0,1,0,1
Hawthorn,"Shiels, Liam",15,7,2,8,1,0,0,4
Hawthorn,"Smith, Isaac",26,14,8,12,0,0,1,4
Hawthorn,"Stratton, Ben",12,10,7,2,0,0,0,3
Hawthorn,"Suckling, Matt",11,9,4,2,2,1,0,4
Hawthorn,"Birchall, Grant",21,13,4,8,0,0,0,5
Hawthorn,"Breust, Luke",14,6,5,8,0,1,0,6
Hawthorn,"Burgoyne, Shaun",29,8,4,21,1,0,0,5
Hawthorn,"Duryea, Taylor",13,11,7,2,0,0,0,4
Hawthorn,"Frawley, James",14,11,4,3,3,1,0,4
Hawthorn,"Gibson, Josh",23,18,7,5,0,0,0,0
Hawthorn,"Gunston, Jack",24,15,10,9,4,0,0,3
Hawthorn,"Hale, David",15,8,4,7,1,1,23,3
Hawthorn,"Hartung, Billy",10,4,1,6,0,0,0,0
Hawthorn,"Hill, Bradley",30,21,4,9,1,0,0,4
Hawthorn,"Howe, Daniel",15,7,4,8,0,0,0,5
Hawthorn,"Lake, Brian",11,9,6,2,0,0,0,5
Hawthorn,"Langford, Will",14,7,1,7,0,0,4,7
Hawthorn,"Lewis, Jordan",31,15,5,16,0,0,2,3
Hawthorn,"McEvoy, Ben",15,8,6,7,1,0,23,6
Hawthorn,"Rioli, Cyril",19,10,3,9,1,2,0,4
Hawthorn,"Roughead, Jarryd",30,15,6,15,3,3,0,1
Hawthorn,"Shiels, Liam",34,12,4,22,1,0,0,4
Hawthorn,"Sicily, James",16,7,6,9,2,0,0,2
Hawthorn,"Smith, Isaac",18,9,7,9,1,0,2,1
Hawthorn,"Stratton, Ben",6,1,0,5,0,0,0,5
Hawthorn,"Suckling, Matt",16,10,7,6,2,0,0,2
Hawthorn,"Birchall, Grant",20,14,8,6,1,0,0,0
Hawthorn,"Burgoyne, Shaun",11,2,1,9,0,1,0,2
Hawthorn,"Duryea, Taylor",18,13,8,5,0,1,0,1
Hawthorn,"Frawley, James",15,6,4,9,3,0,0,0
Hawthorn,"Gibson, Josh",25,16,11,9,0,0,0,1
Hawthorn,"Gunston, Jack",14,14,8,0,4,1,0,0
Hawthorn,"Hale, David",13,7,5,6,0,1,13,1
Hawthorn,"Hill, Bradley",27,12,5,15,1,0,0,0
Hawthorn,"Howe, Daniel",21,11,9,10,0,1,0,5
Hawthorn,"Lake, Brian",14,7,3,7,0,0,0,2
Hawthorn,"Langford, Will",20,12,4,8,0,0,0,3
Hawthorn,"Lewis, Jordan",28,11,8,17,1,0,2,4
Hawthorn,"Litherland, Angus",5,2,2,3,0,0,0,1
Hawthorn,"McEvoy, Ben",9,4,5,5,0,0,21,2
Hawthorn,"Mitchell, Sam",34,15,4,19,0,0,0,6
Hawthorn,"Puopolo, Paul",20,10,5,10,1,0,0,2
Hawthorn,"Roughead, Jarryd",19,11,5,8,4,3,0,0
Hawthorn,"Shiels, Liam",20,10,3,10,1,0,0,6
Hawthorn,"Sicily, James",12,8,4,4,1,0,0,0
Hawthorn,"Smith, Isaac",13,4,1,9,0,0,0,0
Hawthorn,"Stratton, Ben",13,10,4,3,0,1,0,4
Hawthorn,"Suckling, Matt",24,14,8,10,0,0,0,2
Hawthorn,"Birchall, Grant",19,11,1,8,0,0,0,3
Hawthorn,"Breust, Luke",13,5,4,8,0,2,0,5
Hawthorn,"Burgoyne, Shaun",13,7,2,6,2,0,0,1
Hawthorn,"Duryea, Taylor",7,6,2,1,0,0,0,1
Hawthorn,"Frawley, James",6,4,1,2,0,0,0,7
Hawthorn,"Gibson, Josh",14,9,6,5,0,0,0,2
Hawthorn,"Gunston, Jack",11,5,2,6,1,0,0,3
Hawthorn,"Hale, David",5,4,1,1,1,0,13,3
Hawthorn,"Hill, Bradley",17,11,1,6,0,0,0,5
Hawthorn,"Hodge, Luke",29,19,7,10,1,0,0,6
Hawthorn,"Lake, Brian",13,8,6,5,0,0,0,2
Hawthorn,"Langford, Will",17,10,1,7,0,0,1,7
Hawthorn,"Lewis, Jordan",25,11,4,14,0,0,5,5
Hawthorn,"McEvoy, Ben",8,5,5,3,0,0,25,5
Hawthorn,"Mitchell, Sam",35,18,3,17,0,0,1,3
Hawthorn,"Puopolo, Paul",14,9,0,5,0,1,0,5
Hawthorn,"Rioli, Cyril",21,12,3,9,1,1,0,6
Hawthorn,"Roughead, Jarryd",20,9,7,11,2,2,0,4
Hawthorn,"Shiels, Liam",16,11,0,5,0,1,0,9
Hawthorn,"Smith, Isaac",16,9,4,7,1,0,1,4
Hawthorn,"Stratton, Ben",5,2,2,3,0,0,0,2
Hawthorn,"Suckling, Matt",15,14,2,1,0,1,0,1
Hawthorn,"Birchall, Grant",25,12,9,13,0,0,0,4
Hawthorn,"Breust, Luke",18,12,7,6,6,0,0,8
Hawthorn,"Burgoyne, Shaun",24,10,5,14,0,1,0,1
Hawthorn,"Duryea, Taylor",22,17,9,5,0,0,0,1
Hawthorn,"Frawley, James",15,9,6,6,0,0,0,2
Hawthorn,"Gibson, Josh",27,12,8,15,0,0,0,2
Hawthorn,"Hale, David",4,4,1,0,0,0,4,1
Hawthorn,"Hartung, Billy",8,5,4,3,0,0,0,2
Hawthorn,"Hill, Bradley",19,12,1,7,1,0,0,3
Hawthorn,"Hodge, Luke",24,15,4,9,4,0,1,4
Hawthorn,"Lake, Brian",19,8,8,11,0,0,0,0
Hawthorn,"Lewis, Jordan",23,16,9,7,2,0,3,1
Hawthorn,"McEvoy, Ben",11,7,5,4,0,0,17,4
Hawthorn,"Mitchell, Sam",33,12,7,21,0,1,0,2
Hawthorn,"Puopolo, Paul",13,6,1,7,1,0,0,4
Hawthorn,"Rioli, Cyril",11,6,5,5,1,1,0,6
Hawthorn,"Roughead, Jarryd",19,10,4,9,2,0,1,4
Hawthorn,"Schoenmakers, Ryan",16,11,8,5,1,1,0,4
Hawthorn,"Shiels, Liam",24,16,7,8,0,1,0,4
Hawthorn,"Smith, Isaac",21,11,8,10,2,0,0,3
Hawthorn,"Stratton, Ben",13,9,6,4,0,1,0,3
Hawthorn,"Suckling, Matt",19,16,9,3,1,1,0,1
Hawthorn,"Birchall, Grant",22,13,9,9,0,0,0,2
Hawthorn,"Breust, Luke",15,5,4,10,1,0,1,2
Hawthorn,"Burgoyne, Shaun",20,12,8,8,0,1,0,3
Hawthorn,"Duryea, Taylor",26,17,10,9,1,0,0,1
Hawthorn,"Frawley, James",18,15,8,3,0,0,0,2
Hawthorn,"Gibson, Josh",25,15,11,10,0,0,0,2
Hawthorn,"Hale, David",7,4,2,3,1,0,9,2
Hawthorn,"Hartung, Billy",5,4,3,1,0,0,0,1
Hawthorn,"Hill, Bradley",25,15,7,10,1,0,0,1
Hawthorn,"Hodge, Luke",25,20,7,5,0,1,0,6
Hawthorn,"Lake, Brian",21,16,13,5,0,0,0,0
Hawthorn,"Lewis, Jordan",20,10,4,10,0,0,0,3
Hawthorn,"McEvoy, Ben",13,6,8,7,1,0,12,0
Hawthorn,"Mitchell, Sam",35,19,6,16,0,0,0,3
Hawthorn,"Puopolo, Paul",14,6,1,8,0,0,0,6
Hawthorn,"Rioli, Cyril",19,12,8,7,3,0,0,4
Hawthorn,"Roughead, Jarryd",22,12,5,10,2,1,0,7
Hawthorn,"Schoenmakers, Ryan",16,10,7,6,2,0,0,2
Hawthorn,"Shiels, Liam",23,12,6,11,0,0,0,4
Hawthorn,"Smith, Isaac",24,19,10,5,1,0,0,3
Hawthorn,"Stratton, Ben",8,6,4,2,0,0,0,2
Hawthorn,"Suckling, Matt",19,15,6,4,2,0,0,1
Hawthorn,"Birchall, Grant",22,17,7,5,1,0,0,2
Hawthorn,"Breust, Luke",18,5,2,13,0,0,0,4
Hawthorn,"Burgoyne, Shaun",26,13,8,13,0,1,0,3
Hawthorn,"Duryea, Taylor",26,17,8,9,0,0,0,1
Hawthorn,"Frawley, James",22,15,11,7,0,0,0,1
Hawthorn,"Gibson, Josh",29,16,9,13,0,0,0,0
Hawthorn,"Gunston, Jack",17,14,10,3,4,2,0,2
Hawthorn,"Hale, David",6,3,1,3,0,0,9,4
Hawthorn,"Hill, Bradley",12,9,2,3,1,0,0,2
Hawthorn,"Hodge, Luke",30,21,8,9,1,1,2,3
Hawthorn,"Lake, Brian",17,14,11,3,0,0,0,2
Hawthorn,"Lewis, Jordan",26,16,9,10,0,0,0,5
Hawthorn,"McEvoy, Ben",9,3,3,6,1,0,20,4
Hawthorn,"Mitchell, Sam",34,19,5,15,0,1,0,4
Hawthorn,"Puopolo, Paul",15,7,5,8,0,0,0,5
Hawthorn,"Rioli, Cyril",18,14,12,4,2,1,0,2
Hawthorn,"Roughead, Jarryd",26,17,9,9,1,0,0,1
Hawthorn,"Schoenmakers, Ryan",21,14,9,7,1,0,0,4
Hawthorn,"Shiels, Liam",17,12,1,5,0,1,0,6
Hawthorn,"Smith, Isaac",23,13,7,10,3,0,1,3
Hawthorn,"Stratton, Ben",14,6,6,8,0,1,0,0
Hawthorn,"Suckling, Matt",8,5,5,3,1,0,0,1
Melbourne,"Brayshaw, Angus",9,7,2,2,0,0,0,9
Melbourne,"Cross, Daniel",24,15,8,9,0,0,0,4
Melbourne,"Dunn, Lynden",16,11,6,5,0,0,0,3
Melbourne,"Frost, Sam",11,3,2,8,0,2,4,5
Melbourne,"Garland, Colin",15,9,4,6,1,0,0,3
Melbourne,"Garlett, Jeff",20,14,3,6,2,4,0,6
Melbourne,"Hogan, Jesse",15,9,7,6,2,0,0,0
Melbourne,"Howe, Jeremy",21,12,6,9,0,0,0,3
Melbourne,"Jamar, Mark",5,5,2,0,1,1,29,1
Melbourne,"Jetta, Neville",12,7,6,5,0,0,0,3
Melbourne,"Jones, Nathan",25,14,3,11,1,0,0,6
Melbourne,"Kennedy Harris, Jay",13,8,4,5,0,0,0,1
Melbourne,"Kent, Dean",10,8,1,2,0,0,0,2
Melbourne,"Lumumba, Heritier",12,9,3,3,1,0,0,0
Melbourne,"McDonald, Tom",26,18,12,8,0,1,0,4
Melbourne,"Newton, Ben",16,11,6,5,2,1,0,6
Melbourne,"Salem, Christian",13,10,2,3,1,0,0,2
Melbourne,"Toumpas, Jimmy",6,2,0,4,0,0,0,0
Melbourne,"Tyson, Dom",20,11,4,9,2,0,0,2
Melbourne,"Vandenberg, Aaron",17,11,4,6,1,2,0,1
Melbourne,"Viney, Jack",24,16,6,8,0,0,1,4
Melbourne,"Watts, Jack",17,11,7,6,3,1,0,1
Melbourne,"Brayshaw, Angus",8,8,3,0,0,0,0,2
Melbourne,"Cross, Daniel",23,13,4,10,0,0,0,1
Melbourne,"Dawes, Chris",12,8,5,4,0,1,2,3
Melbourne,"Dunn, Lynden",16,12,5,4,0,0,0,4
Melbourne,"Frost, Sam",10,7,1,3,0,0,8,1
Melbourne,"Garland, Colin",8,6,5,2,0,0,0,2
Melbourne,"Garlett, Jeff",9,4,3,5,1,2,0,1
Melbourne,"Hogan, Jesse",13,12,8,1,2,2,0,3
Melbourne,"Howe, Jeremy",10,3,1,7,0,0,0,2
Melbourne,"Jamar, Mark",9,7,2,2,1,0,27,4
Melbourne,"Jetta, Neville",14,5,1,9,0,0,0,2
Melbourne,"Jones, Nathan",11,4,1,7,0,0,0,2
Melbourne,"Kent, Dean",13,8,3,5,1,2,0,1
Melbourne,"Lumumba, Heritier",19,10,4,9,0,0,0,4
Melbourne,"McDonald, Tom",16,11,8,5,1,0,0,2
Melbourne,"Newton, Ben",12,8,3,4,2,0,0,0
Melbourne,"Salem, Christian",22,10,6,12,0,0,0,4
Melbourne,"Tyson, Dom",17,7,2,10,0,0,0,3
Melbourne,"Vandenberg, Aaron",16,11,1,5,0,0,0,4
Melbourne,"Vince, Bernie",13,9,4,4,0,0,1,3
Melbourne,"Viney, Jack",19,10,2,9,0,0,0,11
Melbourne,"Watts, Jack",15,10,6,5,0,0,0,2
Melbourne,"Brayshaw, Angus",12,7,2,5,0,0,0,7
Melbourne,"Cross, Daniel",20,8,1,12,0,0,3,6
Melbourne,"Dawes, Chris",10,4,2,6,0,0,3,3
Melbourne,"Dunn, Lynden",10,5,2,5,0,0,0,2
Melbourne,"Frost, Sam",4,2,0,2,0,1,1,0
Melbourne,"Garland, Colin",17,13,5,4,0,0,0,3
Melbourne,"Garlett, Jeff",16,11,3,5,2,4,0,7
Melbourne,"Hogan, Jesse",10,8,5,2,2,2,0,0
Melbourne,"Howe, Jeremy",20,12,5,8,0,0,0,2
Melbourne,"Jamar, Mark",5,2,0,3,0,1,44,5
Melbourne,"Jetta, Neville",10,4,1,6,0,0,0,4
Melbourne,"Jones, Nathan",25,16,2,9,1,1,0,5
Melbourne,"Kennedy Harris, Jay",12,7,1,5,0,0,0,1
Melbourne,"Kent, Dean",13,7,1,6,1,2,0,1
Melbourne,"Lumumba, Heritier",25,12,4,13,0,0,1,7
Melbourne,"McDonald, Tom",16,10,4,6,0,0,0,2
Melbourne,"Newton, Ben",19,9,2,10,1,0,0,0
Melbourne,"Salem, Christian",16,10,0,6,0,0,0,5
Melbourne,"Tyson, Dom",20,6,1,14,0,0,2,8
Melbourne,"Vandenberg, Aaron",19,13,3,6,0,0,1,5
Melbourne,"Vince, Bernie",18,17,1,1,0,0,5,8
Melbourne,"Watts, Jack",12,3,3,9,0,0,0,3
Melbourne,"Brayshaw, Angus",12,7,4,5,1,0,0,6
Melbourne,"Cross, Daniel",16,10,5,6,0,1,1,4
Melbourne,"Dawes, Chris",12,6,2,6,2,0,4,3
Melbourne,"Dunn, Lynden",13,10,4,3,0,0,0,1
Melbourne,"Garland, Colin",15,11,2,4,0,0,0,9
Melbourne,"Garlett, Jeff",11,8,1,3,2,2,0,6
Melbourne,"Hogan, Jesse",13,7,6,6,2,1,0,3
Melbourne,"Howe, Jeremy",18,14,3,4,0,0,0,5
Melbourne,"Jamar, Mark",11,4,3,7,0,0,29,3
Melbourne,"Jetta, Neville",4,1,1,3,0,0,0,3
Melbourne,"Jones, Nathan",24,13,0,11,1,0,0,6
Melbourne,"Kennedy Harris, Jay",8,5,2,3,1,1,0,3
Melbourne,"Kent, Dean",3,1,0,2,0,0,0,3
Melbourne,"Lumumba, Heritier",15,5,3,10,0,0,0,4
Melbourne,"McDonald, Tom",19,14,4,5,0,0,0,3
Melbourne,"Michie, Viv",19,9,1,10,0,0,0,3
Melbourne,"Newton, Ben",19,8,1,11,0,1,0,3
Melbourne,"Salem, Christian",14,10,4,4,0,0,0,7
Melbourne,"Tyson, Dom",17,10,1,7,0,1,0,2
Melbourne,"Vandenberg, Aaron",20,11,2,9,1,1,0,12
Melbourne,"Vince, Bernie",20,13,3,7,1,0,3,6
Melbourne,"Watts, Jack",14,7,3,7,1,0,2,4
Melbourne,"Brayshaw, Angus",16,12,6,4,1,0,0,4
Melbourne,"Cross, Daniel",21,11,4,10,0,0,0,1
Melbourne,"Dunn, Lynden",17,12,3,5,0,0,0,1
Melbourne,"Garland, Colin",11,9,4,2,0,0,0,2
Melbourne,"Garlett, Jeff",7,7,6,0,3,1,0,4
Melbourne,"Grimes, Jack",10,5,2,5,0,0,0,3
Melbourne,"Hogan, Jesse",14,9,6,5,1,0,0,1
Melbourne,"Howe, Jeremy",13,8,5,5,0,3,0,3
Melbourne,"Jamar, Mark",9,4,1,5,0,0,21,5
Melbourne,"Jones, Nathan",18,11,1,7,0,0,0,3
Melbourne,"Kennedy Harris, Jay",15,6,4,9,0,0,0,4
Melbourne,"Lumumba, Heritier",16,10,6,6,0,0,4,4
Melbourne,"McDonald, Tom",17,12,9,5,0,0,1,3
Melbourne,"McKenzie, Jordie",9,3,0,6,0,1,0,0
Melbourne,"Michie, Viv",17,8,7,9,0,0,0,0
Melbourne,"Newton, Ben",12,7,3,5,0,1,0,5
Melbourne,"Pedersen, Cameron",14,6,8,8,0,1,7,1
Melbourne,"Salem, Christian",9,6,4,3,0,1,0,2
Melbourne,"Tyson, Dom",20,10,4,10,0,1,0,1
Melbourne,"Vandenberg, Aaron",16,11,4,5,1,2,0,6
Melbourne,"Vince, Bernie",15,9,1,6,0,0,1,2
Melbourne,"Watts, Jack",7,5,4,2,0,0,0,3
Melbourne,"Brayshaw, Angus",12,6,2,6,0,0,0,4
Melbourne,"Cross, Daniel",23,14,8,9,0,0,4,7
Melbourne,"Dawes, Chris",9,5,5,4,1,1,0,2
Melbourne,"Dunn, Lynden",15,6,4,9,0,0,0,2
Melbourne,"Garland, Colin",15,8,1,7,0,0,0,8
Melbourne,"Garlett, Jeff",14,13,1,1,2,2,0,3
Melbourne,"Hogan, Jesse",14,9,8,5,2,1,0,0
Melbourne,"Howe, Jeremy",10,5,0,5,0,0,0,1
Melbourne,"Jones, Nathan",25,9,1,16,0,0,0,4
Melbourne,"Kennedy Harris, Jay",6,4,2,2,0,2,0,1
Melbourne,"Lumumba, Heritier",19,12,5,7,0,0,0,4
Melbourne,"McDonald, Tom",25,15,10,10,0,0,0,5
Melbourne,"Newton, Ben",14,7,1,7,1,0,1,3
Melbourne,"Pedersen, Cameron",8,4,3,4,0,0,1,2
Melbourne,"Salem, Christian",24,16,6,8,0,0,0,4
Melbourne,"Spencer, Jake",10,1,1,9,0,0,30,7
Melbourne,"Stretch, Billy",7,6,4,1,1,0,0,4
Melbourne,"Toumpas, Jimmy",14,7,5,7,0,0,0,2
Melbourne,"Tyson, Dom",25,13,9,12,0,0,0,3
Melbourne,"Vandenberg, Aaron",15,8,3,7,0,2,0,3
Melbourne,"Vince, Bernie",26,17,6,9,0,0,0,3
Melbourne,"Watts, Jack",7,4,2,3,0,0,1,1
Melbourne,"Bail, Rohan",12,7,5,5,1,0,0,2
Melbourne,"Brayshaw, Angus",8,6,5,2,0,1,0,5
Melbourne,"Cross, Daniel",21,11,9,10,0,0,2,3
Melbourne,"Dawes, Chris",6,4,2,2,0,0,1,0
Melbourne,"Dunn, Lynden",19,8,5,11,0,0,0,3
Melbourne,"Garland, Colin",19,15,10,4,0,0,0,4
Melbourne,"Garlett, Jeff",11,8,2,3,3,2,0,7
Melbourne,"Grimes, Jack",22,16,8,6,0,1,0,2
Melbourne,"Howe, Jeremy",15,3,3,12,0,0,0,1
Melbourne,"Jones, Matt",11,4,3,7,0,0,0,5
Melbourne,"Jones, Nathan",26,17,4,9,0,0,0,4
Melbourne,"Lumumba, Heritier",11,7,3,4,0,0,0,3
Melbourne,"McDonald, Tom",22,14,9,8,0,0,0,0
Melbourne,"Michie, Viv",12,7,2,5,0,0,0,4
Melbourne,"Pedersen, Cameron",14,10,7,4,3,1,4,3
Melbourne,"Salem, Christian",3,2,0,1,0,0,0,1
Melbourne,"Spencer, Jake",7,2,0,5,0,0,21,8
Melbourne,"Stretch, Billy",3,2,2,1,0,0,0,2
Melbourne,"Toumpas, Jimmy",11,4,1,7,0,0,0,0
Melbourne,"Tyson, Dom",25,13,6,12,0,0,1,2
Melbourne,"Vandenberg, Aaron",11,8,0,3,0,0,0,4
Melbourne,"Vince, Bernie",25,13,2,12,0,0,0,1
Melbourne,"Bail, Rohan",5,2,2,3,0,1,0,3
Melbourne,"Brayshaw, Angus",20,12,5,8,0,0,0,4
Melbourne,"Cross, Daniel",19,11,5,8,0,0,1,7
Melbourne,"Dunn, Lynden",20,13,9,7,0,0,0,2
Melbourne,"Fitzpatrick, Jack",14,9,5,5,0,0,0,1
Melbourne,"Garland, Colin",18,14,7,4,0,1,0,3
Melbourne,"Garlett, Jeff",15,7,2,8,1,2,0,3
Melbourne,"Grimes, Jack",22,13,8,9,0,0,0,4
Melbourne,"Hogan, Jesse",21,11,9,10,3,0,0,1
Melbourne,"Howe, Jeremy",18,12,7,6,1,1,0,1
Melbourne,"Jones, Matt",6,4,1,2,1,0,0,2
Melbourne,"Jones, Nathan",28,19,5,9,1,1,0,5
Melbourne,"Lumumba, Heritier",12,7,2,5,0,0,2,8
Melbourne,"McDonald, Tom",18,10,4,8,0,0,0,5
Melbourne,"Newton, Ben",17,8,3,9,1,0,0,4
Melbourne,"Pedersen, Cameron",16,10,7,6,3,1,4,2
Melbourne,"Riley, Aidan",10,3,2,7,0,0,0,1
Melbourne,"Spencer, Jake",13,8,2,5,0,0,40,8
Melbourne,"Toumpas, Jimmy",20,12,5,8,2,0,0,6
Melbourne,"Vandenberg, Aaron",29,14,4,15,0,0,0,11
Melbourne,"Vince, Bernie",26,17,5,9,2,0,1,5
Melbourne,"Watts, Jack",14,7,4,7,0,0,4,2
Melbourne,"Bail, Rohan",11,5,2,6,0,1,0,0
Melbourne,"Brayshaw, Angus",21,11,2,10,0,0,0,8
Melbourne,"Cross, Daniel",21,8,5,13,0,0,0,2
Melbourne,"Dunn, Lynden",22,15,1,7,0,0,0,1
Melbourne,"Fitzpatrick, Jack",5,5,3,0,1,0,0,1
Melbourne,"Garland, Colin",16,11,3,5,0,0,0,6
Melbourne,"Garlett, Jeff",7,6,2,1,2,1,0,2
Melbourne,"Grimes, Jack",18,7,6,11,0,0,0,1
Melbourne,"Hogan, Jesse",16,13,8,3,2,0,0,1
Melbourne,"Howe, Jeremy",6,3,1,3,0,0,0,2
Melbourne,"Jetta, Neville",8,4,1,4,0,0,0,0
Melbourne,"Jones, Matt",8,5,3,3,1,0,0,1
Melbourne,"Jones, Nathan",20,7,1,13,0,0,0,5
Melbourne,"Lumumba, Heritier",14,10,4,4,1,0,0,5
Melbourne,"McDonald, Tom",18,13,6,5,0,0,0,0
Melbourne,"Pedersen, Cameron",17,10,5,7,0,2,2,3
Melbourne,"Spencer, Jake",8,3,1,5,1,0,39,6
Melbourne,"Toumpas, Jimmy",14,8,3,6,0,0,0,1
Melbourne,"Vandenberg, Aaron",19,11,5,8,0,0,0,4
Melbourne,"Vince, Bernie",17,10,2,7,0,1,0,7
Melbourne,"Viney, Jack",7,4,1,3,0,0,0,1
Melbourne,"Watts, Jack",14,6,7,8,0,0,3,0
Melbourne,"Brayshaw, Angus",18,15,2,3,1,1,0,6
Melbourne,"Cross, Daniel",26,11,7,15,0,0,1,3
Melbourne,"Dunn, Lynden",20,10,3,10,0,0,0,3
Melbourne,"Fitzpatrick, Jack",9,5,3,4,1,0,7,1
Melbourne,"Garland, Colin",16,11,4,5,0,0,0,3
Melbourne,"Garlett, Jeff",10,8,0,2,2,0,0,5
Melbourne,"Gawn, Max",11,5,1,6,0,0,31,2
Melbourne,"Hogan, Jesse",9,7,5,2,1,1,0,1
Melbourne,"Howe, Jeremy",10,8,3,2,3,1,0,1
Melbourne,"Jetta, Neville",15,4,4,11,0,0,0,4
Melbourne,"Jones, Matt",6,1,2,5,0,1,0,0
Melbourne,"Jones, Nathan",34,14,4,20,2,0,0,7
Melbourne,"Lumumba, Heritier",22,8,3,14,0,0,0,2
Melbourne,"McDonald, Tom",21,10,4,11,0,1,0,3
Melbourne,"Newton, Ben",9,2,0,7,0,0,0,6
Melbourne,"Pedersen, Cameron",13,6,7,7,0,1,1,4
Melbourne,"Riley, Aidan",11,3,3,8,0,0,0,3
Melbourne,"Toumpas, Jimmy",21,7,3,14,0,0,0,4
Melbourne,"Vandenberg, Aaron",13,8,2,5,0,1,0,2
Melbourne,"Vince, Bernie",34,20,1,14,2,0,0,2
Melbourne,"Viney, Jack",26,8,1,18,0,0,0,2
Melbourne,"Watts, Jack",16,9,3,7,1,0,1,3
Melbourne,"Brayshaw, Angus",19,11,3,8,1,1,0,7
Melbourne,"Cross, Daniel",29,13,6,16,0,0,4,4
Melbourne,"Dunn, Lynden",18,13,5,5,0,0,0,2
Melbourne,"Garlett, Jeff",3,3,0,0,1,0,0,1
Melbourne,"Gawn, Max",16,1,3,15,0,0,39,0
Melbourne,"Grimes, Jack",24,9,6,15,0,0,0,0
Melbourne,"Hogan, Jesse",12,9,6,3,5,1,0,1
Melbourne,"Howe, Jeremy",16,9,5,7,1,2,1,6
Melbourne,"Jetta, Neville",20,7,4,13,0,0,0,3
Melbourne,"Jones, Nathan",32,19,7,13,0,0,0,6
Melbourne,"Lumumba, Heritier",20,10,4,10,0,0,0,2
Melbourne,"McDonald, Tom",22,8,7,14,1,0,0,3
Melbourne,"Michie, Viv",3,1,0,2,0,0,0,1
Melbourne,"Neal-Bullen, Alex",11,4,2,7,0,1,0,1
Melbourne,"Pedersen, Cameron",6,0,0,6,0,0,4,3
Melbourne,"Riley, Aidan",12,5,5,7,0,0,0,1
Melbourne,"Stretch, Billy",15,8,3,7,0,1,0,4
Melbourne,"Toumpas, Jimmy",26,14,5,12,2,0,0,8
Melbourne,"Tyson, Dom",24,14,6,10,0,0,0,6
Melbourne,"Vince, Bernie",38,19,2,19,0,0,1,4
Melbourne,"Viney, Jack",24,9,2,15,1,0,0,7
Melbourne,"Watts, Jack",25,10,9,15,0,1,4,0
Melbourne,"Bail, Rohan",14,4,0,10,0,0,0,2
Melbourne,"Brayshaw, Angus",20,12,1,8,0,0,0,6
Melbourne,"Cross, Daniel",20,5,4,15,0,0,0,2
Melbourne,"Dawes, Chris",9,4,2,5,0,0,0,2
Melbourne,"Dunn, Lynden",26,22,7,4,0,0,0,2
Melbourne,"Garlett, Jeff",15,11,3,4,4,1,0,3
Melbourne,"Gawn, Max",19,10,8,9,1,1,44,5
Melbourne,"Howe, Jeremy",4,3,3,1,2,0,0,3
Melbourne,"Jetta, Neville",13,5,3,8,0,0,0,1
Melbourne,"Jones, Matt",8,6,1,2,2,0,0,4
Melbourne,"Jones, Nathan",35,17,2,18,1,0,0,3
Melbourne,"Lumumba, Heritier",19,10,4,9,0,0,0,2
Melbourne,"McDonald, Tom",6,5,5,1,0,0,0,4
Melbourne,"Neal-Bullen, Alex",11,9,0,2,3,0,0,1
Melbourne,"Riley, Aidan",3,0,1,3,0,0,0,0
Melbourne,"Spencer, Jake",6,3,3,3,1,0,25,3
Melbourne,"Stretch, Billy",10,7,3,3,1,1,0,2
Melbourne,"Toumpas, Jimmy",10,2,0,8,0,0,0,4
Melbourne,"Tyson, Dom",22,10,1,12,1,0,0,7
Melbourne,"Vince, Bernie",38,24,4,14,2,0,0,9
Melbourne,"Viney, Jack",28,11,1,17,0,0,0,4
Melbourne,"Watts, Jack",19,8,1,11,0,0,0,3
Melbourne,"Bail, Rohan",13,10,4,3,0,0,0,2
Melbourne,"Brayshaw, Angus",0,0,0,0,0,0,0,1
Melbourne,"Cross, Daniel",20,9,5,11,0,0,1,5
Melbourne,"Dawes, Chris",6,6,3,0,2,0,0,1
Melbourne,"Dunn, Lynden",12,10,3,2,0,0,0,1
Melbourne,"Garland, Colin",7,5,1,2,0,0,0,5
Melbourne,"Garlett, Jeff",13,11,3,2,1,2,0,10
Melbourne,"Gawn, Max",10,4,3,6,0,0,27,1
Melbourne,"Hogan, Jesse",15,12,7,3,1,2,0,0
Melbourne,"Howe, Jeremy",8,4,3,4,0,0,0,0
Melbourne,"Jetta, Neville",9,3,0,6,0,0,0,1
Melbourne,"Jones, Matt",9,4,2,5,0,0,0,3
Melbourne,"Jones, Nathan",29,14,2,15,0,0,0,5
Melbourne,"McDonald, Tom",11,8,4,3,0,0,0,2
Melbourne,"Neal-Bullen, Alex",16,8,3,8,2,0,0,1
Melbourne,"Spencer, Jake",8,2,2,6,1,0,12,2
Melbourne,"Stretch, Billy",13,7,3,6,0,0,0,2
Melbourne,"Toumpas, Jimmy",13,3,5,10,0,0,0,3
Melbourne,"Tyson, Dom",26,14,5,12,1,0,0,3
Melbourne,"Vince, Bernie",26,16,3,10,0,0,0,5
Melbourne,"Viney, Jack",19,9,2,10,1,0,0,8
Melbourne,"Watts, Jack",22,10,7,12,0,0,0,0
Melbourne,"Brayshaw, Angus",11,8,0,3,0,0,0,3
Melbourne,"Cross, Daniel",19,9,3,10,0,0,0,1
Melbourne,"Dawes, Chris",11,7,4,4,0,3,8,0
Melbourne,"Dunn, Lynden",7,4,0,3,0,0,1,5
Melbourne,"Garland, Colin",13,10,6,3,0,0,0,4
Melbourne,"Garlett, Jeff",9,6,1,3,1,2,0,9
Melbourne,"Gawn, Max",19,12,6,7,0,1,58,4
Melbourne,"Harmes, James",9,3,0,6,0,1,0,3
Melbourne,"Hogan, Jesse",13,6,6,7,1,0,0,1
Melbourne,"Howe, Jeremy",14,9,5,5,1,1,0,4
Melbourne,"Jetta, Neville",13,7,4,6,1,0,0,0
Melbourne,"Jones, Nathan",25,13,4,12,0,1,0,7
Melbourne,"Kennedy Harris, Jay",2,1,1,1,0,0,0,2
Melbourne,"Lumumba, Heritier",12,6,3,6,0,0,0,4
Melbourne,"McDonald, Tom",28,24,6,4,1,2,1,1
Melbourne,"Neal-Bullen, Alex",8,1,0,7,0,0,0,6
Melbourne,"Stretch, Billy",8,2,0,6,0,0,0,4
Melbourne,"Tyson, Dom",18,10,2,8,1,0,0,5
Melbourne,"Vandenberg, Aaron",18,12,3,6,1,1,0,5
Melbourne,"Vince, Bernie",35,25,1,10,0,2,1,3
Melbourne,"Viney, Jack",11,6,2,5,0,1,0,7
Melbourne,"Watts, Jack",16,7,3,9,0,0,2,3
Melbourne,"Brayshaw, Angus",13,8,3,5,0,0,0,5
Melbourne,"Cross, Daniel",26,14,10,12,0,0,1,5
Melbourne,"Dawes, Chris",17,11,6,6,0,0,6,2
Melbourne,"Dunn, Lynden",15,10,6,5,0,0,1,2
Melbourne,"Garland, Colin",10,6,2,4,0,0,0,1
Melbourne,"Garlett, Jeff",12,10,2,2,2,1,0,5
Melbourne,"Gawn, Max",13,6,6,7,0,1,38,2
Melbourne,"Harmes, James",15,7,1,8,0,0,0,1
Melbourne,"Hogan, Jesse",16,13,11,3,4,1,0,1
Melbourne,"Howe, Jeremy",22,15,13,7,0,1,0,5
Melbourne,"Jetta, Neville",10,5,3,5,0,0,0,8
Melbourne,"Jones, Nathan",21,13,2,8,0,2,0,2
Melbourne,"Kennedy Harris, Jay",6,1,3,5,0,0,0,1
Melbourne,"Lumumba, Heritier",8,4,1,4,0,0,0,1
Melbourne,"McDonald, Tom",13,10,7,3,2,0,0,1
Melbourne,"Neal-Bullen, Alex",4,3,2,1,0,1,0,1
Melbourne,"Stretch, Billy",12,6,1,6,0,0,0,5
Melbourne,"Tyson, Dom",20,8,3,12,0,0,0,6
Melbourne,"Vandenberg, Aaron",20,11,6,9,0,1,0,4
Melbourne,"Vince, Bernie",21,12,1,9,0,0,0,5
Melbourne,"Viney, Jack",23,8,1,15,0,1,0,7
Melbourne,"Watts, Jack",11,7,4,4,0,0,3,2
Melbourne,"Brayshaw, Angus",12,7,2,5,0,0,0,2
Melbourne,"Cross, Daniel",24,9,4,15,0,0,0,6
Melbourne,"Dawes, Chris",17,9,4,8,1,1,4,2
Melbourne,"Dunn, Lynden",14,10,4,4,0,0,0,5
Melbourne,"Garland, Colin",10,8,3,2,0,0,0,1
Melbourne,"Garlett, Jeff",7,5,1,2,1,1,0,2
Melbourne,"Gawn, Max",13,5,6,8,1,0,32,1
Melbourne,"Grimes, Jack",28,14,3,14,0,1,0,2
Melbourne,"Harmes, James",13,4,2,9,0,0,0,1
Melbourne,"Hogan, Jesse",7,4,4,3,1,2,0,1
Melbourne,"Howe, Jeremy",22,16,11,6,0,1,0,2
Melbourne,"Jetta, Neville",20,6,3,14,0,0,0,4
Melbourne,"Jones, Nathan",26,13,2,13,1,0,0,4
Melbourne,"Lumumba, Heritier",17,9,5,8,0,0,1,2
Melbourne,"McDonald, Tom",15,7,9,8,0,0,0,0
Melbourne,"Michie, Viv",9,6,1,3,0,1,0,2
Melbourne,"Stretch, Billy",8,3,1,5,0,0,0,3
Melbourne,"Tyson, Dom",24,8,3,16,1,2,0,4
Melbourne,"Vandenberg, Aaron",5,3,1,2,0,0,0,4
Melbourne,"Vince, Bernie",26,11,2,15,0,0,1,4
Melbourne,"Viney, Jack",31,11,3,20,0,1,0,3
Melbourne,"Watts, Jack",25,10,4,15,0,0,2,3
Melbourne,"Brayshaw, Angus",15,5,0,10,0,0,0,6
Melbourne,"Cross, Daniel",24,5,4,19,0,0,2,2
Melbourne,"Dawes, Chris",14,6,6,8,0,1,3,1
Melbourne,"Dunn, Lynden",19,14,6,5,0,0,0,3
Melbourne,"Garland, Colin",22,12,7,10,0,1,0,6
Melbourne,"Garlett, Jeff",15,9,6,6,2,0,0,1
Melbourne,"Gawn, Max",17,4,6,13,0,0,32,3
Melbourne,"Grimes, Jack",18,13,6,5,0,0,0,3
Melbourne,"Harmes, James",8,6,3,2,1,1,0,2
Melbourne,"Hogan, Jesse",16,13,9,3,3,1,0,0
Melbourne,"Howe, Jeremy",17,14,10,3,1,0,0,2
Melbourne,"Jetta, Neville",16,6,4,10,0,0,0,2
Melbourne,"Jones, Nathan",26,12,3,14,1,0,0,3
Melbourne,"Lumumba, Heritier",11,5,2,6,0,1,0,2
Melbourne,"McDonald, Tom",14,5,2,9,0,0,0,1
Melbourne,"Michie, Viv",6,4,0,2,0,0,0,1
Melbourne,"Neal-Bullen, Alex",15,9,3,6,0,1,0,6
Melbourne,"Tyson, Dom",23,10,3,13,0,1,0,9
Melbourne,"Vandenberg, Aaron",17,11,6,6,1,2,0,5
Melbourne,"Vince, Bernie",30,17,4,13,3,1,0,2
Melbourne,"Viney, Jack",24,7,2,17,0,1,0,4
Melbourne,"Watts, Jack",26,16,4,10,1,1,1,1
Melbourne,"Brayshaw, Angus",8,4,3,4,1,0,0,2
Melbourne,"Cross, Daniel",19,6,5,13,0,0,4,0
Melbourne,"Dawes, Chris",19,15,7,4,3,3,4,1
Melbourne,"Dunn, Lynden",15,9,4,6,0,0,0,2
Melbourne,"Garland, Colin",9,7,2,2,0,0,0,1
Melbourne,"Garlett, Jeff",4,4,1,0,1,1,0,1
Melbourne,"Gawn, Max",12,6,3,6,1,0,28,2
Melbourne,"Grimes, Jack",14,9,4,5,0,0,0,1
Melbourne,"Harmes, James",8,6,2,2,0,1,0,2
Melbourne,"Hogan, Jesse",15,11,9,4,4,1,0,2
Melbourne,"Howe, Jeremy",13,8,5,5,0,0,0,2
Melbourne,"Jetta, Neville",8,4,1,4,0,0,0,1
Melbourne,"Jones, Matt",15,9,6,6,0,0,0,2
Melbourne,"Jones, Nathan",12,6,0,6,1,0,0,4
Melbourne,"Lumumba, Heritier",7,5,2,2,0,0,1,4
Melbourne,"McDonald, Tom",15,12,4,3,0,0,0,1
Melbourne,"Michie, Viv",13,8,4,5,0,1,0,1
Melbourne,"Neal-Bullen, Alex",4,3,1,1,1,0,0,1
Melbourne,"Tyson, Dom",24,8,1,16,0,1,1,4
Melbourne,"Vince, Bernie",14,8,1,6,0,0,0,7
Melbourne,"Viney, Jack",23,10,1,13,1,0,0,9
Melbourne,"Watts, Jack",10,7,6,3,1,0,0,0
Melbourne,"Bail, Rohan",11,8,5,3,0,1,0,6
Melbourne,"Brayshaw, Angus",10,5,0,5,0,0,0,5
Melbourne,"Cross, Daniel",16,6,4,10,0,0,0,5
Melbourne,"Dawes, Chris",13,8,6,5,1,1,7,1
Melbourne,"Dunn, Lynden",13,10,4,3,0,0,0,0
Melbourne,"Garland, Colin",13,7,3,6,0,0,0,1
Melbourne,"Garlett, Jeff",9,5,2,4,2,0,0,3
Melbourne,"Gawn, Max",9,5,2,4,1,0,32,4
Melbourne,"Grimes, Jack",11,6,4,5,0,0,0,1
Melbourne,"Harmes, James",15,8,3,7,0,1,0,9
Melbourne,"Hogan, Jesse",12,5,3,7,3,0,0,2
Melbourne,"Howe, Jeremy",13,8,6,5,0,0,0,3
Melbourne,"Jetta, Neville",8,4,2,4,0,0,0,2
Melbourne,"Jones, Matt",18,7,5,11,0,1,0,5
Melbourne,"Jones, Nathan",24,8,4,16,0,1,0,5
Melbourne,"Lumumba, Heritier",10,4,3,6,0,0,1,2
Melbourne,"McDonald, Tom",29,20,13,9,0,0,9,0
Melbourne,"Michie, Viv",20,9,3,11,0,0,0,2
Melbourne,"Neal-Bullen, Alex",13,10,2,3,0,1,0,1
Melbourne,"Vince, Bernie",23,12,4,11,0,0,0,2
Melbourne,"Viney, Jack",19,9,2,10,0,0,0,9
Melbourne,"Watts, Jack",22,12,11,10,1,1,2,1
Melbourne,"Brayshaw, Angus",11,7,4,4,0,0,0,1
Melbourne,"Cross, Daniel",16,7,3,9,0,0,0,5
Melbourne,"Dawes, Chris",12,7,6,5,1,1,1,0
Melbourne,"Dunn, Lynden",17,12,7,5,0,0,0,2
Melbourne,"Garland, Colin",7,6,4,1,0,0,0,1
Melbourne,"Garlett, Jeff",5,4,2,1,1,1,0,3
Melbourne,"Gawn, Max",7,5,1,2,1,1,39,1
Melbourne,"Grimes, Jack",25,15,7,10,1,1,0,3
Melbourne,"Harmes, James",10,2,2,8,0,0,0,3
Melbourne,"Hogan, Jesse",8,5,5,3,0,2,0,3
Melbourne,"Howe, Jeremy",13,9,3,4,0,1,0,1
Melbourne,"Jones, Nathan",16,6,2,10,1,0,0,4
Melbourne,"Lumumba, Heritier",1,0,0,1,0,0,0,1
Melbourne,"McDonald, Tom",25,15,10,10,0,0,3,1
Melbourne,"Michie, Viv",21,13,5,8,0,0,0,4
Melbourne,"Neal-Bullen, Alex",10,8,3,2,0,0,0,3
Melbourne,"Newton, Ben",17,11,3,6,1,1,0,3
Melbourne,"Salem, Christian",13,9,3,4,0,1,0,2
Melbourne,"Stretch, Billy",14,9,3,5,0,0,0,2
Melbourne,"Vince, Bernie",15,7,1,8,0,0,1,6
Melbourne,"Viney, Jack",14,4,0,10,0,0,0,4
Melbourne,"Watts, Jack",19,11,9,8,1,1,4,3
Melbourne,"Cross, Daniel",39,15,8,24,0,0,0,1
Melbourne,"Dunn, Lynden",25,18,6,7,0,1,0,5
Melbourne,"Garland, Colin",22,14,5,8,0,0,0,2
Melbourne,"Garlett, Jeff",18,14,3,4,2,0,0,6
Melbourne,"Gawn, Max",21,6,10,15,1,0,30,3
Melbourne,"Grimes, Jack",22,11,8,11,1,0,0,5
Melbourne,"Hogan, Jesse",9,5,4,4,2,0,0,4
Melbourne,"Howe, Jeremy",19,12,6,7,0,0,0,6
Melbourne,"Jetta, Neville",12,4,5,8,0,0,0,3
Melbourne,"Jones, Matt",12,8,2,4,0,0,0,3
Melbourne,"Jones, Nathan",5,4,1,1,0,0,0,1
Melbourne,"McDonald, Oscar",15,7,7,8,0,0,0,0
Melbourne,"McDonald, Tom",18,11,9,7,0,0,0,2
Melbourne,"Michie, Viv",20,12,5,8,0,2,0,3
Melbourne,"Neal-Bullen, Alex",9,4,4,5,0,0,0,5
Melbourne,"Newton, Ben",14,7,2,7,0,0,0,3
Melbourne,"Salem, Christian",20,14,5,6,0,0,0,1
Melbourne,"Spencer, Jake",2,1,0,1,0,0,6,1
Melbourne,"Stretch, Billy",10,5,5,5,0,0,0,4
Melbourne,"Vince, Bernie",21,15,6,6,1,0,0,10
Melbourne,"Viney, Jack",30,8,3,22,0,0,0,13
Melbourne,"Watts, Jack",14,9,5,5,1,1,0,7
Melbourne,"Brayshaw, Angus",12,12,5,0,0,0,0,6
Melbourne,"Cross, Daniel",25,6,4,19,0,0,1,2
Melbourne,"Dunn, Lynden",13,8,5,5,1,1,12,4
Melbourne,"Garland, Colin",16,12,5,4,0,0,0,3
Melbourne,"Garlett, Jeff",7,7,3,0,2,2,0,2
Melbourne,"Gawn, Max",9,3,3,6,0,0,55,1
Melbourne,"Grimes, Jack",24,15,8,9,1,0,0,4
Melbourne,"Harmes, James",16,7,6,9,2,1,0,3
Melbourne,"Hogan, Jesse",13,10,8,3,3,2,0,0
Melbourne,"Howe, Jeremy",11,11,7,0,1,0,0,2
Melbourne,"Jones, Nathan",36,19,2,17,1,1,0,4
Melbourne,"Kennedy Harris, Jay",11,8,5,3,1,0,0,1
Melbourne,"McDonald, Oscar",15,7,6,8,0,0,0,0
Melbourne,"McDonald, Tom",23,16,9,7,0,0,0,1
Melbourne,"Michie, Viv",21,6,3,15,0,0,0,3
Melbourne,"Neal-Bullen, Alex",3,1,0,2,0,0,0,0
Melbourne,"Newton, Ben",14,10,4,4,3,2,0,3
Melbourne,"Salem, Christian",24,14,4,10,0,1,0,7
Melbourne,"Stretch, Billy",14,8,1,6,0,0,0,7
Melbourne,"Vince, Bernie",38,16,3,22,0,2,1,7
Melbourne,"Viney, Jack",29,11,2,18,0,0,0,12
Melbourne,"White, Mitch",16,9,6,7,0,0,0,1
North Melbourne,"Atley, Shaun",17,8,3,9,0,0,0,8
North Melbourne,"Bastinac, Ryan",15,9,3,6,1,0,0,3
North Melbourne,"Cunnington, Ben",26,11,8,15,0,0,0,2
North Melbourne,"Dal Santo, Nick",20,13,2,7,0,0,0,1
North Melbourne,"Firrito, Michael",10,7,2,3,0,0,0,0
North Melbourne,"Gibson, Sam",23,16,5,7,1,1,0,0
North Melbourne,"Goldstein, Todd",10,2,4,8,0,0,35,4
North Melbourne,"Harvey, Brent",18,9,1,9,0,1,0,0
North Melbourne,"Higgins, Shaun",15,6,4,9,4,0,0,1
North Melbourne,"Jacobs, Ben",11,9,3,2,0,0,0,1
North Melbourne,"Macmillan, Jamie",17,13,7,4,0,0,0,2
North Melbourne,"McDonald, Luke",10,5,4,5,0,0,0,1
North Melbourne,"Petrie, Drew",8,6,3,2,1,2,3,4
North Melbourne,"Swallow, Andrew",22,4,0,18,0,0,0,3
North Melbourne,"Thomas, Lindsay",17,10,4,7,2,0,0,2
North Melbourne,"Thompson, Scott",14,6,4,8,0,0,0,1
North Melbourne,"Tippett, Joel",1,1,1,0,0,0,0,0
North Melbourne,"Turner, Kayne",8,6,1,2,0,1,0,2
North Melbourne,"Waite, Jarrad",10,5,3,5,0,0,0,4
North Melbourne,"Wells, Daniel",11,2,1,9,0,0,2,5
North Melbourne,"Wright, Sam",16,11,6,5,0,0,0,0
North Melbourne,"Ziebell, Jack",17,13,3,4,0,1,1,6
North Melbourne,"Atley, Shaun",16,6,1,10,0,0,0,3
North Melbourne,"Brown, Ben",9,8,4,1,3,1,2,1
North Melbourne,"Cunnington, Ben",26,10,4,16,0,1,0,4
North Melbourne,"Dal Santo, Nick",15,7,2,8,0,0,0,1
North Melbourne,"Firrito, Michael",13,6,2,7,0,0,0,2
North Melbourne,"Gibson, Sam",33,13,6,20,0,1,0,1
North Melbourne,"Goldstein, Todd",23,10,7,13,1,0,37,8
North Melbourne,"Harvey, Brent",27,8,2,19,0,0,0,1
North Melbourne,"Higgins, Shaun",24,11,6,13,2,3,0,2
North Melbourne,"McDonald, Luke",20,6,6,14,0,0,0,0
North Melbourne,"Nahas, Robin",22,11,6,11,1,0,0,4
North Melbourne,"Petrie, Drew",16,9,8,7,2,1,0,1
North Melbourne,"Swallow, Andrew",25,13,2,12,0,0,0,5
North Melbourne,"Thomas, Lindsay",12,9,3,3,2,2,0,3
North Melbourne,"Thompson, Scott",10,5,2,5,0,0,0,0
North Melbourne,"Tippett, Joel",9,6,1,3,0,0,0,0
North Melbourne,"Turner, Kayne",16,14,3,2,0,0,0,2
North Melbourne,"Waite, Jarrad",22,16,12,6,7,1,0,3
North Melbourne,"Wells, Daniel",11,4,0,7,0,0,0,1
North Melbourne,"Wood, Mason",9,5,3,4,0,1,0,1
North Melbourne,"Wright, Sam",16,11,4,5,0,0,0,3
North Melbourne,"Ziebell, Jack",27,18,7,9,2,1,2,7
North Melbourne,"Atley, Shaun",18,6,2,12,0,0,0,2
North Melbourne,"Bastinac, Ryan",18,8,1,10,1,0,0,4
North Melbourne,"Brown, Ben",11,8,6,3,3,0,0,0
North Melbourne,"Cunnington, Ben",20,7,1,13,0,0,0,4
North Melbourne,"Firrito, Michael",14,8,2,6,0,0,0,3
North Melbourne,"Gibson, Sam",28,14,5,14,1,0,0,2
North Melbourne,"Goldstein, Todd",13,2,0,11,0,0,49,6
North Melbourne,"Harvey, Brent",23,13,2,10,1,1,0,0
North Melbourne,"Higgins, Shaun",21,10,2,11,1,1,0,4
North Melbourne,"Jacobs, Ben",30,19,5,11,0,0,0,1
North Melbourne,"McDonald, Luke",28,15,2,13,0,0,0,1
North Melbourne,"Nahas, Robin",13,9,5,4,1,0,0,4
North Melbourne,"Petrie, Drew",14,10,8,4,2,0,0,2
North Melbourne,"Swallow, Andrew",30,12,4,18,0,1,0,10
North Melbourne,"Tarrant, Robbie",21,8,4,13,1,0,0,3
North Melbourne,"Thomas, Lindsay",11,10,2,1,4,2,0,3
North Melbourne,"Thompson, Scott",18,9,9,9,0,0,0,2
North Melbourne,"Turner, Kayne",10,6,3,4,0,0,0,5
North Melbourne,"Waite, Jarrad",10,6,5,4,0,0,0,1
North Melbourne,"Wood, Mason",19,9,5,10,1,1,0,4
North Melbourne,"Wright, Sam",16,7,6,9,0,0,1,1
North Melbourne,"Ziebell, Jack",1,1,1,0,0,0,0,1
North Melbourne,"Atley, Shaun",10,5,2,5,0,1,0,3
North Melbourne,"Bastinac, Ryan",17,8,1,9,1,0,0,3
North Melbourne,"Brown, Ben",13,8,6,5,2,2,5,0
North Melbourne,"Cunnington, Ben",20,4,3,16,0,0,0,2
North Melbourne,"Dumont, Trent",5,4,0,1,1,0,0,0
North Melbourne,"Firrito, Michael",15,5,3,10,0,1,0,1
North Melbourne,"Gibson, Sam",14,9,2,5,0,0,0,2
North Melbourne,"Goldstein, Todd",21,10,2,11,1,1,42,6
North Melbourne,"Harvey, Brent",23,16,1,7,0,0,0,2
North Melbourne,"Higgins, Shaun",21,8,3,13,0,1,0,4
North Melbourne,"Jacobs, Ben",23,13,5,10,0,0,0,0
North Melbourne,"Nahas, Robin",16,9,3,7,3,0,0,2
North Melbourne,"Petrie, Drew",9,4,3,5,1,0,0,2
North Melbourne,"Swallow, Andrew",27,10,4,17,0,0,0,5
North Melbourne,"Tarrant, Robbie",23,16,9,7,0,0,0,0
North Melbourne,"Thomas, Lindsay",12,9,4,3,0,1,0,2
North Melbourne,"Thompson, Scott",21,10,9,11,0,0,0,0
North Melbourne,"Turner, Kayne",12,6,3,6,0,0,0,3
North Melbourne,"Waite, Jarrad",15,8,4,7,3,0,0,3
North Melbourne,"Wood, Mason",22,11,3,11,0,0,0,3
North Melbourne,"Wright, Sam",32,17,9,15,0,0,0,2
North Melbourne,"Ziebell, Jack",20,14,4,6,0,0,0,8
North Melbourne,"Atley, Shaun",19,9,4,10,0,0,0,2
North Melbourne,"Bastinac, Ryan",15,8,3,7,0,0,0,6
North Melbourne,"Black, Aaron",6,3,2,3,0,0,0,1
North Melbourne,"Brown, Ben",10,8,5,2,3,0,2,1
North Melbourne,"Cunnington, Ben",20,8,3,12,1,0,2,7
North Melbourne,"Firrito, Michael",11,6,5,5,0,0,0,3
North Melbourne,"Gibson, Sam",20,11,4,9,0,0,0,0
North Melbourne,"Goldstein, Todd",14,6,4,8,0,1,40,0
North Melbourne,"Harvey, Brent",30,14,6,16,0,0,0,1
North Melbourne,"Higgins, Shaun",13,7,3,6,1,1,0,1
North Melbourne,"Jacobs, Ben",19,8,6,11,0,0,0,0
North Melbourne,"Macmillan, Jamie",21,11,6,10,0,0,0,1
North Melbourne,"Nahas, Robin",13,4,2,9,0,0,0,5
North Melbourne,"Petrie, Drew",12,9,6,3,2,1,0,3
North Melbourne,"Swallow, Andrew",14,7,2,7,1,0,0,6
North Melbourne,"Tarrant, Robbie",20,11,2,9,0,0,0,1
North Melbourne,"Thomas, Lindsay",13,8,2,5,2,1,0,3
North Melbourne,"Thompson, Scott",21,7,8,14,0,0,0,2
North Melbourne,"Turner, Kayne",3,2,1,1,0,0,0,1
North Melbourne,"Wood, Mason",22,12,8,10,0,2,0,2
North Melbourne,"Wright, Sam",23,8,6,15,0,0,0,1
North Melbourne,"Ziebell, Jack",20,16,5,4,0,0,1,4
North Melbourne,"Atley, Shaun",12,7,0,5,0,0,0,5
North Melbourne,"Bastinac, Ryan",4,3,1,1,0,0,0,3
North Melbourne,"Brown, Ben",12,7,9,5,1,2,2,0
North Melbourne,"Cunnington, Ben",17,7,1,10,0,0,0,0
North Melbourne,"Firrito, Michael",14,9,3,5,0,1,0,2
North Melbourne,"Gibson, Sam",15,7,4,8,0,0,0,0
North Melbourne,"Goldstein, Todd",11,2,3,9,0,0,36,2
North Melbourne,"Hansen, Lachlan",12,9,11,3,0,0,0,1
North Melbourne,"Harvey, Brent",22,14,5,8,2,0,0,2
North Melbourne,"Higgins, Shaun",15,7,4,8,3,0,0,1
North Melbourne,"Jacobs, Ben",23,14,5,9,0,0,0,5
North Melbourne,"McDonald, Luke",8,5,2,3,0,0,0,2
North Melbourne,"Nahas, Robin",12,6,3,6,2,0,0,4
North Melbourne,"Petrie, Drew",21,14,10,7,1,2,1,4
North Melbourne,"Swallow, Andrew",16,4,1,12,0,0,0,6
North Melbourne,"Tarrant, Robbie",15,9,6,6,0,0,0,1
North Melbourne,"Thomas, Lindsay",13,9,1,4,5,0,0,3
North Melbourne,"Thompson, Scott",21,13,7,8,0,0,0,2
North Melbourne,"Waite, Jarrad",12,8,5,4,1,3,0,1
North Melbourne,"Wood, Mason",12,7,3,5,0,1,0,0
North Melbourne,"Wright, Sam",21,14,8,7,1,0,0,3
North Melbourne,"Ziebell, Jack",16,13,3,3,0,1,0,9
North Melbourne,"Atley, Shaun",9,3,1,6,0,0,0,0
North Melbourne,"Bastinac, Ryan",19,9,5,10,0,0,0,6
North Melbourne,"Brown, Ben",7,4,3,3,0,0,1,0
North Melbourne,"Cunnington, Ben",26,12,8,14,1,1,3,3
North Melbourne,"Firrito, Michael",12,7,3,5,0,0,0,2
North Melbourne,"Gibson, Sam",25,19,9,6,1,1,0,1
North Melbourne,"Goldstein, Todd",8,7,3,1,0,0,38,2
North Melbourne,"Hansen, Lachlan",24,16,14,8,0,1,0,1
North Melbourne,"Harvey, Brent",20,8,3,12,1,0,0,3
North Melbourne,"Higgins, Shaun",18,9,5,9,1,2,0,4
North Melbourne,"Jacobs, Ben",20,9,9,11,0,0,0,0
North Melbourne,"Macmillan, Jamie",13,8,5,5,0,0,0,1
North Melbourne,"McDonald, Luke",14,6,2,8,0,0,0,4
North Melbourne,"Nahas, Robin",16,11,4,5,1,1,0,2
North Melbourne,"Petrie, Drew",19,14,12,5,2,0,0,4
North Melbourne,"Swallow, Andrew",19,9,1,10,0,0,0,11
North Melbourne,"Tarrant, Robbie",16,13,7,3,0,0,0,3
North Melbourne,"Thomas, Lindsay",14,13,3,1,2,3,0,0
North Melbourne,"Thompson, Scott",10,5,2,5,0,0,0,6
North Melbourne,"Waite, Jarrad",15,13,7,2,2,2,0,3
North Melbourne,"Wright, Sam",19,11,5,8,0,0,0,0
North Melbourne,"Ziebell, Jack",29,26,5,3,2,2,2,1
North Melbourne,"Atley, Shaun",19,10,4,9,0,0,0,1
North Melbourne,"Bastinac, Ryan",18,9,4,9,0,0,1,1
North Melbourne,"Cunnington, Ben",24,8,1,16,0,0,0,6
North Melbourne,"Dumont, Trent",5,3,1,2,0,0,0,3
North Melbourne,"Firrito, Michael",17,11,6,6,0,0,0,1
North Melbourne,"Gibson, Sam",20,6,2,14,0,0,0,3
North Melbourne,"Goldstein, Todd",7,3,3,4,0,1,31,5
North Melbourne,"Hansen, Lachlan",10,4,5,6,0,0,0,0
North Melbourne,"Harvey, Brent",24,16,6,8,1,1,0,3
North Melbourne,"Higgins, Shaun",16,7,9,9,1,0,0,9
North Melbourne,"Jacobs, Ben",24,12,4,12,0,0,0,3
North Melbourne,"Macmillan, Jamie",16,11,5,5,1,2,0,3
North Melbourne,"McDonald, Luke",10,5,5,5,0,0,0,0
North Melbourne,"Nahas, Robin",18,6,2,12,0,0,0,4
North Melbourne,"Petrie, Drew",15,11,9,4,0,2,2,6
North Melbourne,"Tarrant, Robbie",10,5,1,5,0,0,0,0
North Melbourne,"Thomas, Lindsay",4,2,1,2,1,1,0,6
North Melbourne,"Thompson, Scott",14,6,2,8,0,0,0,4
North Melbourne,"Waite, Jarrad",12,6,6,6,0,2,0,5
North Melbourne,"Wood, Mason",11,7,5,4,0,0,0,1
North Melbourne,"Wright, Sam",21,15,4,6,0,0,0,1
North Melbourne,"Ziebell, Jack",20,15,0,5,1,0,2,6
North Melbourne,"Atley, Shaun",15,3,1,12,0,0,0,2
North Melbourne,"Bastinac, Ryan",19,8,2,11,1,0,0,4
North Melbourne,"Brown, Ben",9,4,3,5,0,2,0,0
North Melbourne,"Cunnington, Ben",25,10,0,15,0,0,1,8
North Melbourne,"Dumont, Trent",18,10,0,8,0,0,0,10
North Melbourne,"Firrito, Michael",13,6,1,7,0,0,0,5
North Melbourne,"Gibson, Sam",27,11,4,16,1,2,0,2
North Melbourne,"Goldstein, Todd",19,9,8,10,1,0,51,2
North Melbourne,"Hansen, Lachlan",11,3,4,8,0,0,0,4
North Melbourne,"Harvey, Brent",27,12,1,15,0,0,0,2
North Melbourne,"Higgins, Shaun",20,14,6,6,1,2,0,6
North Melbourne,"Macmillan, Jamie",15,12,4,3,1,0,0,5
North Melbourne,"McDonald, Luke",7,5,2,2,0,0,0,4
North Melbourne,"Nahas, Robin",17,9,3,8,3,1,0,1
North Melbourne,"Petrie, Drew",12,9,9,3,2,2,0,4
North Melbourne,"Tarrant, Robbie",16,9,4,7,0,0,0,5
North Melbourne,"Thomas, Lindsay",18,16,3,2,1,0,0,6
North Melbourne,"Thompson, Scott",12,8,3,4,0,0,0,2
North Melbourne,"Turner, Kayne",4,1,0,3,0,0,0,1
North Melbourne,"Waite, Jarrad",19,11,9,8,3,1,0,1
North Melbourne,"Wright, Sam",13,7,4,6,0,0,0,4
North Melbourne,"Ziebell, Jack",17,12,1,5,0,0,1,11
North Melbourne,"Bastinac, Ryan",24,13,5,11,0,0,0,1
North Melbourne,"Brown, Ben",13,10,5,3,3,0,5,3
North Melbourne,"Cunnington, Ben",20,12,2,8,0,0,1,9
North Melbourne,"Dumont, Trent",13,6,0,7,0,0,1,7
North Melbourne,"Firrito, Michael",10,9,0,1,0,1,0,2
North Melbourne,"Gibson, Sam",19,9,1,10,1,0,0,3
North Melbourne,"Goldstein, Todd",10,6,3,4,1,0,47,6
North Melbourne,"Hansen, Lachlan",13,6,5,7,0,0,0,3
North Melbourne,"Harvey, Brent",24,12,0,12,1,0,0,3
North Melbourne,"Higgins, Shaun",22,16,3,6,4,1,0,6
North Melbourne,"Jacobs, Ben",5,1,0,4,0,0,0,4
North Melbourne,"Macmillan, Jamie",18,14,5,4,0,1,1,1
North Melbourne,"McMahon, Scott",13,10,1,3,0,0,0,2
North Melbourne,"Nahas, Robin",3,2,0,1,0,0,0,3
North Melbourne,"Petrie, Drew",19,10,7,9,1,2,0,2
North Melbourne,"Swallow, Andrew",20,10,2,10,0,0,0,13
North Melbourne,"Tarrant, Robbie",10,4,2,6,0,0,0,3
North Melbourne,"Thomas, Lindsay",10,5,3,5,1,0,0,6
North Melbourne,"Thompson, Scott",15,9,4,6,0,0,0,1
North Melbourne,"Waite, Jarrad",10,5,3,5,0,1,0,2
North Melbourne,"Wright, Sam",18,10,3,8,0,0,0,3
North Melbourne,"Ziebell, Jack",24,20,2,4,1,0,0,8
North Melbourne,"Bastinac, Ryan",17,8,1,9,0,0,0,2
North Melbourne,"Brown, Ben",10,7,4,3,0,0,4,0
North Melbourne,"Cunnington, Ben",23,15,1,8,0,0,0,7
North Melbourne,"Dumont, Trent",7,5,2,2,1,0,0,2
North Melbourne,"Firrito, Michael",12,5,3,7,0,0,0,2
North Melbourne,"Gibson, Sam",20,6,5,14,0,0,0,1
North Melbourne,"Goldstein, Todd",17,5,7,12,0,0,37,6
North Melbourne,"Hansen, Lachlan",18,13,10,5,0,0,0,1
North Melbourne,"Harvey, Brent",22,16,4,6,1,3,0,3
North Melbourne,"Higgins, Shaun",17,8,5,9,2,2,0,4
North Melbourne,"Jacobs, Ben",13,3,3,10,0,0,0,5
North Melbourne,"Macmillan, Jamie",18,13,7,5,0,0,0,1
North Melbourne,"McMahon, Scott",7,5,4,2,0,0,0,0
North Melbourne,"Nahas, Robin",17,12,2,5,2,3,0,2
North Melbourne,"Petrie, Drew",9,4,6,5,1,0,1,1
North Melbourne,"Swallow, Andrew",19,10,1,9,0,0,0,11
North Melbourne,"Tarrant, Robbie",13,5,3,8,0,0,0,1
North Melbourne,"Thomas, Lindsay",8,6,1,2,2,1,0,1
North Melbourne,"Thompson, Scott",12,7,5,5,0,0,0,1
North Melbourne,"Waite, Jarrad",10,7,3,3,0,1,0,4
North Melbourne,"Wright, Sam",19,14,5,5,1,0,0,1
North Melbourne,"Ziebell, Jack",19,16,3,3,0,3,2,5
North Melbourne,"Atley, Shaun",23,12,8,11,1,0,0,1
North Melbourne,"Brown, Ben",6,4,4,2,1,0,7,0
North Melbourne,"Cunnington, Ben",24,11,3,13,1,0,0,5
North Melbourne,"Dal Santo, Nick",34,18,6,16,0,0,0,1
North Melbourne,"Dumont, Trent",8,6,1,2,0,1,0,0
North Melbourne,"Firrito, Michael",11,8,2,3,0,0,0,2
North Melbourne,"Gibson, Sam",17,6,4,11,0,0,0,0
North Melbourne,"Goldstein, Todd",12,6,3,6,0,0,80,5
North Melbourne,"Hansen, Lachlan",14,12,9,2,0,0,0,1
North Melbourne,"Harvey, Brent",28,10,3,18,1,1,0,3
North Melbourne,"Higgins, Shaun",17,6,1,11,2,1,0,2
North Melbourne,"Jacobs, Ben",16,8,5,8,0,0,0,3
North Melbourne,"Macmillan, Jamie",29,21,10,8,3,0,0,0
North Melbourne,"Nahas, Robin",8,6,4,2,4,2,0,1
North Melbourne,"Petrie, Drew",10,7,7,3,2,2,0,3
North Melbourne,"Swallow, Andrew",22,13,4,9,0,1,0,9
North Melbourne,"Tarrant, Robbie",12,8,3,4,0,0,0,0
North Melbourne,"Thomas, Lindsay",9,4,0,5,0,0,0,4
North Melbourne,"Thompson, Scott",13,8,3,5,0,0,0,0
North Melbourne,"Waite, Jarrad",17,9,7,8,3,0,0,3
North Melbourne,"Wright, Sam",23,14,4,9,0,0,0,1
North Melbourne,"Ziebell, Jack",26,18,7,8,0,0,2,6
North Melbourne,"Atley, Shaun",14,6,3,8,0,0,0,1
North Melbourne,"Cunnington, Ben",29,14,5,15,2,0,0,3
North Melbourne,"Dal Santo, Nick",32,15,2,17,0,0,1,7
North Melbourne,"Daw, Majak",3,2,2,1,0,0,4,2
North Melbourne,"Dumont, Trent",7,4,1,3,0,0,0,5
North Melbourne,"Firrito, Michael",15,8,3,7,0,0,0,5
North Melbourne,"Gibson, Sam",24,8,3,16,0,0,0,3
North Melbourne,"Goldstein, Todd",15,9,4,6,0,1,62,6
North Melbourne,"Hansen, Lachlan",11,3,3,8,0,0,0,2
North Melbourne,"Harvey, Brent",23,12,3,11,0,0,0,3
North Melbourne,"Higgins, Shaun",18,8,5,10,2,1,0,5
North Melbourne,"Jacobs, Ben",7,1,1,6,0,0,0,7
North Melbourne,"Macmillan, Jamie",28,15,8,13,0,0,0,1
North Melbourne,"Nahas, Robin",16,12,5,4,1,1,0,3
North Melbourne,"Petrie, Drew",11,8,5,3,3,0,0,3
North Melbourne,"Swallow, Andrew",19,8,1,11,0,0,0,9
North Melbourne,"Tarrant, Robbie",12,6,5,6,0,0,0,2
North Melbourne,"Thomas, Lindsay",17,9,4,8,0,2,0,5
North Melbourne,"Thompson, Scott",14,8,5,6,0,0,0,0
North Melbourne,"Waite, Jarrad",10,7,2,3,1,0,0,2
North Melbourne,"Wright, Sam",24,15,5,9,0,0,0,3
North Melbourne,"Ziebell, Jack",20,15,3,5,1,1,0,5
North Melbourne,"Atley, Shaun",18,9,2,9,1,0,0,3
North Melbourne,"Bastinac, Ryan",27,10,1,17,0,0,0,7
North Melbourne,"Brown, Ben",12,9,4,3,0,0,7,3
North Melbourne,"Cunnington, Ben",24,10,2,14,1,0,0,3
North Melbourne,"Dal Santo, Nick",24,12,2,12,0,1,0,3
North Melbourne,"Firrito, Michael",19,15,7,4,0,0,0,2
North Melbourne,"Garner, Taylor",12,7,2,5,2,3,0,0
North Melbourne,"Gibson, Sam",18,10,5,8,1,0,0,1
North Melbourne,"Goldstein, Todd",19,8,5,11,1,1,45,5
North Melbourne,"Harvey, Brent",14,6,2,8,0,1,0,2
North Melbourne,"Higgins, Shaun",19,11,8,8,3,1,0,4
North Melbourne,"Jacobs, Ben",19,5,2,14,0,0,0,6
North Melbourne,"Macmillan, Jamie",18,8,5,10,1,0,0,3
North Melbourne,"Mullett, Aaron",17,10,3,7,0,0,0,3
North Melbourne,"Petrie, Drew",11,7,4,4,3,0,0,2
North Melbourne,"Swallow, Andrew",24,11,3,13,2,0,0,12
North Melbourne,"Tarrant, Robbie",11,8,5,3,0,0,0,0
North Melbourne,"Thompson, Scott",15,8,5,7,0,0,0,3
North Melbourne,"Turner, Kayne",7,2,3,5,1,0,0,3
North Melbourne,"Waite, Jarrad",18,11,8,7,2,2,0,3
North Melbourne,"Wright, Sam",20,9,6,11,0,0,0,3
North Melbourne,"Ziebell, Jack",16,9,1,7,0,0,0,8
North Melbourne,"Atley, Shaun",20,14,3,6,0,0,0,5
North Melbourne,"Bastinac, Ryan",14,8,2,6,2,1,0,3
North Melbourne,"Black, Aaron",10,5,2,5,1,0,0,1
North Melbourne,"Brown, Ben",10,7,6,3,4,1,1,0
North Melbourne,"Cunnington, Ben",26,8,2,18,0,0,0,7
North Melbourne,"Dal Santo, Nick",34,16,2,18,0,0,1,1
North Melbourne,"Firrito, Michael",17,10,5,7,0,0,0,4
North Melbourne,"Garner, Taylor",11,5,2,6,0,0,0,1
North Melbourne,"Gibson, Sam",11,6,3,5,0,0,0,2
North Melbourne,"Goldstein, Todd",27,13,8,14,1,2,56,4
North Melbourne,"Harvey, Brent",34,19,8,15,0,1,0,4
North Melbourne,"Higgins, Shaun",15,7,3,8,0,2,0,3
North Melbourne,"Jacobs, Ben",15,7,3,8,0,0,0,9
North Melbourne,"Macmillan, Jamie",15,9,2,6,0,0,0,0
North Melbourne,"Mullett, Aaron",7,5,2,2,0,0,0,1
North Melbourne,"Swallow, Andrew",27,13,5,14,0,0,0,2
North Melbourne,"Tarrant, Robbie",9,6,4,3,0,0,0,1
North Melbourne,"Thompson, Scott",12,8,4,4,0,0,0,1
North Melbourne,"Turner, Kayne",7,5,4,2,2,0,0,5
North Melbourne,"Waite, Jarrad",12,9,5,3,1,0,0,6
North Melbourne,"Wright, Sam",8,5,3,3,0,0,0,2
North Melbourne,"Ziebell, Jack",23,16,4,7,3,2,0,5
North Melbourne,"Atley, Shaun",17,9,2,8,0,0,0,4
North Melbourne,"Bastinac, Ryan",22,11,3,11,1,0,0,5
North Melbourne,"Brown, Ben",13,11,4,2,3,2,6,2
North Melbourne,"Cunnington, Ben",17,8,3,9,3,0,0,4
North Melbourne,"Dal Santo, Nick",25,12,4,13,0,0,0,2
North Melbourne,"Firrito, Michael",15,10,2,5,0,0,0,3
North Melbourne,"Garner, Taylor",8,3,0,5,0,1,0,8
North Melbourne,"Gibson, Sam",20,8,5,12,1,1,0,1
North Melbourne,"Goldstein, Todd",15,8,2,7,0,1,39,5
North Melbourne,"Harvey, Brent",27,8,7,19,2,0,0,4
North Melbourne,"Higgins, Shaun",24,12,1,12,0,1,0,7
North Melbourne,"Jacobs, Ben",8,5,0,3,0,1,0,10
North Melbourne,"McDonald, Luke",16,7,6,9,0,0,0,1
North Melbourne,"Petrie, Drew",16,14,6,2,4,1,0,5
North Melbourne,"Swallow, Andrew",20,9,2,11,0,0,0,7
North Melbourne,"Tarrant, Robbie",10,7,4,3,0,0,0,1
North Melbourne,"Thomas, Lindsay",10,7,2,3,0,0,0,1
North Melbourne,"Thompson, Scott",16,12,2,4,0,0,0,3
North Melbourne,"Turner, Kayne",14,7,4,7,1,1,0,6
North Melbourne,"Waite, Jarrad",11,6,2,5,0,1,0,1
North Melbourne,"Wright, Sam",15,6,2,9,0,0,0,0
North Melbourne,"Ziebell, Jack",12,10,2,2,1,0,0,4
North Melbourne,"Atley, Shaun",21,11,3,10,0,0,0,3
North Melbourne,"Bastinac, Ryan",13,6,3,7,0,0,0,2
North Melbourne,"Brown, Ben",6,2,3,4,0,1,4,3
North Melbourne,"Cunnington, Ben",17,8,5,9,1,0,0,2
North Melbourne,"Dal Santo, Nick",22,16,9,6,1,2,0,0
North Melbourne,"Firrito, Michael",14,9,4,5,0,0,0,1
North Melbourne,"Garner, Taylor",7,1,2,6,0,0,0,0
North Melbourne,"Gibson, Sam",23,7,4,16,0,0,0,0
North Melbourne,"Goldstein, Todd",14,7,5,7,2,0,41,1
North Melbourne,"Harvey, Brent",20,14,4,6,2,0,0,2
North Melbourne,"Higgins, Shaun",31,13,3,18,2,0,0,5
North Melbourne,"Jacobs, Ben",21,7,5,14,0,0,0,6
North Melbourne,"McDonald, Luke",22,11,2,11,0,0,0,2
North Melbourne,"Petrie, Drew",12,8,7,4,3,0,0,2
North Melbourne,"Swallow, Andrew",15,7,1,8,1,0,0,7
North Melbourne,"Tarrant, Robbie",21,9,9,12,0,0,0,1
North Melbourne,"Thomas, Lindsay",12,6,6,6,2,2,0,1
North Melbourne,"Thompson, Scott",18,14,6,4,0,0,0,4
North Melbourne,"Turner, Kayne",5,4,1,1,0,0,0,0
North Melbourne,"Waite, Jarrad",13,11,7,2,2,0,0,2
North Melbourne,"Wright, Sam",24,15,10,9,0,0,0,1
North Melbourne,"Ziebell, Jack",26,22,8,4,2,2,0,2
North Melbourne,"Atley, Shaun",15,5,4,10,0,0,0,2
North Melbourne,"Brown, Ben",10,8,4,2,2,2,1,0
North Melbourne,"Cunnington, Ben",31,14,6,17,1,0,0,4
North Melbourne,"Dal Santo, Nick",24,14,3,10,0,1,0,4
North Melbourne,"Garner, Taylor",10,5,1,5,0,0,0,4
North Melbourne,"Gibson, Sam",19,10,4,9,0,0,0,1
North Melbourne,"Goldstein, Todd",20,11,8,9,0,1,50,7
North Melbourne,"Hansen, Lachlan",13,6,6,7,0,0,0,3
North Melbourne,"Harvey, Brent",20,13,1,7,2,2,0,2
North Melbourne,"Higgins, Shaun",31,14,5,17,2,0,0,2
North Melbourne,"Jacobs, Ben",11,9,1,2,1,0,0,7
North Melbourne,"McDonald, Luke",15,9,5,6,0,0,0,1
North Melbourne,"Mullett, Aaron",3,2,0,1,0,0,0,0
North Melbourne,"Nahas, Robin",14,8,5,6,2,0,0,3
North Melbourne,"Petrie, Drew",16,6,8,10,1,1,1,0
North Melbourne,"Swallow, Andrew",20,8,2,12,0,0,0,4
North Melbourne,"Tarrant, Robbie",13,11,6,2,0,0,0,1
North Melbourne,"Thomas, Lindsay",16,12,5,4,5,2,0,4
North Melbourne,"Thompson, Scott",15,11,5,4,0,0,0,1
North Melbourne,"Waite, Jarrad",16,11,8,5,3,1,0,3
North Melbourne,"Wright, Sam",12,9,6,3,0,0,0,2
North Melbourne,"Ziebell, Jack",23,14,5,9,0,1,0,4
North Melbourne,"Atley, Shaun",17,12,5,5,1,0,0,3
North Melbourne,"Brown, Ben",8,5,1,3,0,0,3,0
North Melbourne,"Cunnington, Ben",24,12,3,12,1,1,0,5
North Melbourne,"Dal Santo, Nick",22,13,1,9,0,0,0,5
North Melbourne,"Firrito, Michael",16,12,7,4,0,0,1,2
North Melbourne,"Garner, Taylor",5,4,0,1,2,0,0,2
North Melbourne,"Gibson, Sam",24,16,3,8,1,0,0,2
North Melbourne,"Goldstein, Todd",11,2,1,9,0,0,39,6
North Melbourne,"Hansen, Lachlan",8,4,5,4,0,0,0,0
North Melbourne,"Harvey, Brent",24,10,3,14,2,0,0,4
North Melbourne,"Higgins, Shaun",22,4,1,18,1,1,0,1
North Melbourne,"Jacobs, Ben",20,9,3,11,0,1,0,6
North Melbourne,"McDonald, Luke",15,4,0,11,0,0,0,2
North Melbourne,"Nahas, Robin",4,2,1,2,1,0,0,1
North Melbourne,"Petrie, Drew",15,8,8,7,4,1,0,5
North Melbourne,"Swallow, Andrew",25,13,1,12,0,0,0,7
North Melbourne,"Tarrant, Robbie",11,8,3,3,0,0,1,2
North Melbourne,"Thomas, Lindsay",9,7,4,2,3,1,0,3
North Melbourne,"Thompson, Scott",13,9,7,4,0,0,0,1
North Melbourne,"Waite, Jarrad",13,9,3,4,1,3,0,2
North Melbourne,"Wright, Sam",24,13,6,11,0,0,0,2
North Melbourne,"Ziebell, Jack",17,12,7,5,1,1,0,6
North Melbourne,"Atley, Shaun",16,9,6,7,0,0,0,6
North Melbourne,"Bastinac, Ryan",7,2,3,5,0,0,0,2
North Melbourne,"Brown, Ben",16,11,9,5,2,1,0,0
North Melbourne,"Cunnington, Ben",26,12,2,14,0,0,0,4
North Melbourne,"Dal Santo, Nick",22,11,7,11,0,1,0,4
North Melbourne,"Firrito, Michael",13,5,5,8,0,0,0,0
North Melbourne,"Gibson, Sam",16,10,0,6,0,0,0,4
North Melbourne,"Goldstein, Todd",15,9,6,6,2,0,28,5
North Melbourne,"Hansen, Lachlan",19,10,6,9,0,0,0,1
North Melbourne,"Harvey, Brent",17,15,4,2,4,1,0,1
North Melbourne,"Higgins, Shaun",14,10,6,4,1,0,0,4
North Melbourne,"Jacobs, Ben",16,8,4,8,0,0,0,4
North Melbourne,"Macmillan, Jamie",19,9,6,10,0,1,0,2
North Melbourne,"McDonald, Luke",14,9,3,5,0,0,0,4
North Melbourne,"Nahas, Robin",18,10,6,8,2,0,0,2
North Melbourne,"Petrie, Drew",12,8,6,4,0,1,0,0
North Melbourne,"Swallow, Andrew",21,13,2,8,0,0,0,12
North Melbourne,"Tarrant, Robbie",14,12,10,2,0,0,0,2
North Melbourne,"Thomas, Lindsay",5,3,0,2,0,1,0,2
North Melbourne,"Thompson, Scott",17,10,4,7,0,0,0,4
North Melbourne,"Waite, Jarrad",17,11,7,6,3,0,0,2
North Melbourne,"Wright, Sam",19,11,6,8,0,0,0,3
North Melbourne,"Atley, Shaun",18,10,5,8,0,0,0,1
North Melbourne,"Bastinac, Ryan",16,4,4,12,0,0,0,6
North Melbourne,"Brown, Ben",8,8,7,0,0,1,2,0
North Melbourne,"Cunnington, Ben",13,3,2,10,0,0,0,4
North Melbourne,"Dal Santo, Nick",17,9,1,8,0,0,2,4
North Melbourne,"Firrito, Michael",16,11,7,5,0,0,0,2
North Melbourne,"Garner, Taylor",13,6,4,7,0,2,0,8
North Melbourne,"Gibson, Sam",6,2,0,4,0,0,0,3
North Melbourne,"Goldstein, Todd",15,6,3,9,0,1,54,2
North Melbourne,"Hansen, Lachlan",10,3,2,7,0,0,0,1
North Melbourne,"Harvey, Brent",20,13,2,7,1,1,0,3
North Melbourne,"Higgins, Shaun",16,12,8,4,3,1,0,3
North Melbourne,"Jacobs, Ben",13,7,2,6,0,0,0,5
North Melbourne,"Macmillan, Jamie",21,15,10,6,0,0,0,2
North Melbourne,"Nahas, Robin",10,5,5,5,0,1,0,7
North Melbourne,"Petrie, Drew",13,12,10,1,3,2,0,1
North Melbourne,"Swallow, Andrew",25,11,0,14,0,1,0,3
North Melbourne,"Tarrant, Robbie",24,19,14,5,0,0,0,2
North Melbourne,"Thompson, Scott",19,13,8,6,0,0,0,3
North Melbourne,"Waite, Jarrad",11,10,6,1,3,1,0,4
North Melbourne,"Wright, Sam",12,8,7,4,0,0,0,0
North Melbourne,"Ziebell, Jack",15,14,6,1,0,0,0,6
North Melbourne,"Atley, Shaun",20,11,4,9,0,0,0,3
North Melbourne,"Bastinac, Ryan",18,12,2,6,1,0,0,2
North Melbourne,"Black, Aaron",10,6,3,4,0,1,2,2
North Melbourne,"Brown, Ben",13,8,6,5,2,0,1,3
North Melbourne,"Daw, Majak",8,6,2,2,2,0,25,8
North Melbourne,"Dumont, Trent",15,5,3,10,0,0,0,5
North Melbourne,"Garner, Taylor",13,5,3,8,0,0,0,4
North Melbourne,"Gibson, Sam",21,15,6,6,0,0,0,4
North Melbourne,"Hansen, Lachlan",19,9,11,10,0,0,0,4
North Melbourne,"Harvey, Brent",10,3,1,7,0,0,0,1
North Melbourne,"Jacobs, Ben",13,7,6,6,0,0,0,2
North Melbourne,"Macmillan, Jamie",27,18,4,9,0,0,0,1
North Melbourne,"McDonald, Luke",10,9,1,1,0,0,0,3
North Melbourne,"McKenzie, Brad",18,10,3,8,1,1,0,2
North Melbourne,"Mullett, Aaron",14,9,3,5,0,0,0,1
North Melbourne,"Nahas, Robin",19,10,9,9,0,0,0,5
North Melbourne,"Petrie, Drew",8,8,6,0,1,1,3,1
North Melbourne,"Tarrant, Robbie",14,10,9,4,0,0,0,2
North Melbourne,"Tippett, Joel",11,5,4,6,0,0,0,4
North Melbourne,"Turner, Kayne",12,6,4,6,3,0,0,5
North Melbourne,"Wood, Mason",9,5,1,4,0,1,0,1
North Melbourne,"Ziebell, Jack",14,13,2,1,0,0,6,8
North Melbourne,"Atley, Shaun",17,8,3,9,0,0,0,1
North Melbourne,"Brown, Ben",8,5,0,3,2,1,3,2
North Melbourne,"Cunnington, Ben",21,10,1,11,0,0,0,3
North Melbourne,"Dal Santo, Nick",15,9,2,6,0,0,1,3
North Melbourne,"Firrito, Michael",10,7,5,3,0,0,0,0
North Melbourne,"Garner, Taylor",10,6,2,4,1,0,0,2
North Melbourne,"Gibson, Sam",20,11,6,9,0,0,0,3
North Melbourne,"Goldstein, Todd",13,7,3,6,0,0,46,2
North Melbourne,"Hansen, Lachlan",21,11,9,10,0,0,0,0
North Melbourne,"Harvey, Brent",31,16,2,15,2,0,0,1
North Melbourne,"Higgins, Shaun",15,12,8,3,1,3,0,4
North Melbourne,"Jacobs, Ben",9,4,3,5,0,0,0,8
North Melbourne,"Macmillan, Jamie",20,9,5,11,1,0,0,1
North Melbourne,"Nahas, Robin",9,7,2,2,1,0,0,4
North Melbourne,"Petrie, Drew",13,12,5,1,2,3,0,1
North Melbourne,"Swallow, Andrew",22,8,2,14,0,0,0,9
North Melbourne,"Tarrant, Robbie",10,4,1,6,0,0,0,3
North Melbourne,"Thomas, Lindsay",3,3,1,0,1,0,0,1
North Melbourne,"Thompson, Scott",9,6,3,3,0,0,0,1
North Melbourne,"Waite, Jarrad",16,12,8,4,4,2,0,7
North Melbourne,"Wright, Sam",14,12,4,2,0,0,0,1
North Melbourne,"Ziebell, Jack",23,17,7,6,0,1,1,2
North Melbourne,"Atley, Shaun",16,9,4,7,1,0,0,1
North Melbourne,"Brown, Ben",10,5,2,5,0,0,4,2
North Melbourne,"Cunnington, Ben",29,14,2,15,0,0,1,5
North Melbourne,"Dal Santo, Nick",29,11,3,18,0,0,2,1
North Melbourne,"Firrito, Michael",15,10,1,5,0,0,0,4
North Melbourne,"Garner, Taylor",16,6,6,10,0,1,1,2
North Melbourne,"Gibson, Sam",17,10,2,7,2,2,0,4
North Melbourne,"Goldstein, Todd",11,4,4,7,1,0,34,4
North Melbourne,"Hansen, Lachlan",16,10,5,6,0,0,0,1
North Melbourne,"Harvey, Brent",16,12,2,4,1,1,0,1
North Melbourne,"Higgins, Shaun",28,11,3,17,0,1,0,3
North Melbourne,"Jacobs, Ben",12,4,1,8,0,0,0,5
North Melbourne,"Macmillan, Jamie",20,11,7,9,0,0,0,2
North Melbourne,"McDonald, Luke",13,9,4,4,1,0,0,2
North Melbourne,"Petrie, Drew",14,10,9,4,1,3,0,2
North Melbourne,"Swallow, Andrew",22,12,1,10,0,0,0,6
North Melbourne,"Thomas, Lindsay",3,3,0,0,1,0,0,2
North Melbourne,"Thompson, Scott",6,6,3,0,0,0,0,0
North Melbourne,"Turner, Kayne",6,3,1,3,0,1,0,3
North Melbourne,"Waite, Jarrad",14,11,9,3,3,1,0,2
North Melbourne,"Wright, Sam",20,12,4,8,0,0,0,1
North Melbourne,"Ziebell, Jack",25,21,3,4,0,0,1,8
North Melbourne,"Atley, Shaun",19,13,6,6,0,0,0,1
North Melbourne,"Brown, Ben",10,5,4,5,1,1,3,1
North Melbourne,"Cunnington, Ben",20,8,4,12,0,1,0,6
North Melbourne,"Dal Santo, Nick",24,11,0,13,0,0,2,5
North Melbourne,"Firrito, Michael",10,5,1,5,0,0,0,4
North Melbourne,"Garner, Taylor",7,5,3,2,1,0,0,2
North Melbourne,"Gibson, Sam",21,11,2,10,1,0,0,4
North Melbourne,"Goldstein, Todd",12,5,4,7,0,0,41,3
North Melbourne,"Hansen, Lachlan",13,8,3,5,0,0,0,1
North Melbourne,"Harvey, Brent",26,15,1,11,0,1,0,2
North Melbourne,"Higgins, Shaun",17,10,2,7,2,1,0,5
North Melbourne,"Jacobs, Ben",7,3,0,4,0,0,0,3
North Melbourne,"Macmillan, Jamie",11,6,4,5,0,1,0,4
North Melbourne,"Petrie, Drew",12,11,6,1,0,2,0,4
North Melbourne,"Swallow, Andrew",25,14,2,11,0,0,0,7
North Melbourne,"Tarrant, Robbie",13,4,2,9,0,0,0,1
North Melbourne,"Thomas, Lindsay",2,2,0,0,0,0,0,1
North Melbourne,"Thompson, Scott",14,5,4,9,0,0,0,2
North Melbourne,"Turner, Kayne",16,10,2,6,1,0,0,2
North Melbourne,"Waite, Jarrad",11,7,5,4,0,2,0,2
North Melbourne,"Wright, Sam",23,17,7,6,0,0,0,6
North Melbourne,"Ziebell, Jack",16,9,4,7,1,0,3,4
Port Adelaide,"Boak, Travis",25,13,10,12,1,1,0,5
Port Adelaide,"Broadbent, Matthew",18,13,7,5,0,0,0,1
Port Adelaide,"Butcher, John",7,5,3,2,1,0,0,2
Port Adelaide,"Carlile, Alipate",9,4,4,5,0,0,0,0
Port Adelaide,"Cornes, Kane",19,12,7,7,0,0,0,3
Port Adelaide,"Ebert, Brad",34,20,14,14,1,1,0,7
Port Adelaide,"Gray, Robbie",31,14,6,17,0,0,0,8
Port Adelaide,"Hartlett, Hamish",19,12,8,7,0,0,0,4
Port Adelaide,"Hombsch, Jack",18,8,4,10,0,0,0,2
Port Adelaide,"Impey, Jarman",15,10,5,5,0,0,0,4
Port Adelaide,"Jonas, Tom",18,9,5,9,0,0,0,2
Port Adelaide,"Monfries, Angus",3,1,2,2,0,0,0,0
Port Adelaide,"Neade, Jake",12,7,1,5,1,0,0,4
Port Adelaide,"Pittard, Jasper",13,11,7,2,0,0,0,3
Port Adelaide,"Polec, Jared",29,18,7,11,0,1,0,3
Port Adelaide,"Ryder, Paddy",12,3,5,9,0,0,20,7
Port Adelaide,"Schulz, Jay",11,5,2,6,1,1,0,1
Port Adelaide,"Trengove, Jackson",21,7,7,14,0,0,2,3
Port Adelaide,"Westhoff, Justin",15,11,6,4,0,1,2,4
Port Adelaide,"White, Matt",14,7,3,7,1,0,0,1
Port Adelaide,"Wines, Ollie",27,19,7,8,2,0,1,6
Port Adelaide,"Wingard, Chad",20,15,8,5,2,1,0,3
Port Adelaide,"Boak, Travis",20,2,1,18,0,0,0,4
Port Adelaide,"Broadbent, Matthew",14,10,5,4,0,0,0,0
Port Adelaide,"Carlile, Alipate",18,6,5,12,0,0,0,0
Port Adelaide,"Cornes, Kane",25,15,7,10,0,0,0,2
Port Adelaide,"Ebert, Brad",27,16,6,11,0,0,1,4
Port Adelaide,"Gray, Robbie",32,11,1,21,0,0,0,4
Port Adelaide,"Hartlett, Hamish",21,12,4,9,0,0,3,2
Port Adelaide,"Hombsch, Jack",10,8,1,2,0,0,0,4
Port Adelaide,"Impey, Jarman",5,0,0,5,0,0,0,0
Port Adelaide,"Jonas, Tom",27,8,7,19,0,0,0,2
Port Adelaide,"Monfries, Angus",26,15,10,11,1,1,0,1
Port Adelaide,"Neade, Jake",15,12,4,3,0,1,0,3
Port Adelaide,"Pittard, Jasper",34,23,8,11,0,0,0,3
Port Adelaide,"Polec, Jared",20,14,3,6,0,0,0,5
Port Adelaide,"Redden, Jarrad",9,2,1,7,0,0,6,0
Port Adelaide,"Ryder, Paddy",13,7,4,6,2,0,16,2
Port Adelaide,"Schulz, Jay",17,11,11,6,1,2,0,1
Port Adelaide,"Trengove, Jackson",17,9,4,8,0,0,0,2
Port Adelaide,"Westhoff, Justin",21,9,10,12,1,1,0,2
Port Adelaide,"White, Matt",16,11,8,5,0,0,0,1
Port Adelaide,"Wines, Ollie",29,13,2,16,0,0,4,6
Port Adelaide,"Wingard, Chad",22,9,2,13,1,1,0,4
Port Adelaide,"Ah Chee, Brendon",3,2,0,1,0,0,0,3
Port Adelaide,"Boak, Travis",24,10,3,14,0,0,1,3
Port Adelaide,"Broadbent, Matthew",24,21,8,3,1,1,0,3
Port Adelaide,"Carlile, Alipate",18,12,3,6,0,0,0,3
Port Adelaide,"Ebert, Brad",22,12,7,10,3,0,0,5
Port Adelaide,"Gray, Robbie",23,9,2,14,0,1,0,2
Port Adelaide,"Hartlett, Hamish",28,12,4,16,0,1,1,4
Port Adelaide,"Hombsch, Jack",7,5,4,2,0,0,0,1
Port Adelaide,"Jonas, Tom",15,4,3,11,0,0,0,0
Port Adelaide,"Krakouer, Nathan",17,11,2,6,0,1,0,3
Port Adelaide,"Mitchell, Kane",16,9,5,7,1,0,0,2
Port Adelaide,"Monfries, Angus",17,11,2,6,2,3,0,2
Port Adelaide,"Pittard, Jasper",23,15,6,8,1,0,0,2
Port Adelaide,"Polec, Jared",19,9,3,10,0,0,0,2
Port Adelaide,"Ryder, Paddy",11,5,3,6,0,1,35,2
Port Adelaide,"Schulz, Jay",16,10,4,6,4,1,0,6
Port Adelaide,"Trengove, Jackson",14,8,5,6,0,0,4,1
Port Adelaide,"Westhoff, Justin",12,7,5,5,0,0,1,6
Port Adelaide,"White, Matt",9,8,4,1,3,0,0,3
Port Adelaide,"Wines, Ollie",15,6,2,9,0,0,1,9
Port Adelaide,"Wingard, Chad",19,10,2,9,1,1,0,3
Port Adelaide,"Young, Aaron",18,5,2,13,1,0,0,7
Port Adelaide,"Ah Chee, Brendon",5,1,0,4,0,0,0,1
Port Adelaide,"Boak, Travis",30,12,2,18,0,0,0,5
Port Adelaide,"Broadbent, Matthew",17,14,3,3,0,1,0,2
Port Adelaide,"Carlile, Alipate",12,8,2,4,0,0,0,2
Port Adelaide,"Cornes, Kane",12,7,6,5,0,0,0,1
Port Adelaide,"Ebert, Brad",25,10,5,15,0,0,0,3
Port Adelaide,"Hartlett, Hamish",22,17,5,5,1,1,1,9
Port Adelaide,"Hombsch, Jack",13,7,3,6,0,0,0,0
Port Adelaide,"Jonas, Tom",11,4,1,7,0,0,0,2
Port Adelaide,"Krakouer, Nathan",18,17,6,1,0,0,0,2
Port Adelaide,"Lobbe, Matthew",8,1,3,7,0,0,17,8
Port Adelaide,"Mitchell, Kane",15,11,4,4,1,1,0,6
Port Adelaide,"Monfries, Angus",11,5,3,6,0,0,0,3
Port Adelaide,"Pittard, Jasper",23,13,3,10,0,0,0,1
Port Adelaide,"Polec, Jared",16,11,4,5,2,1,0,6
Port Adelaide,"Ryder, Paddy",12,7,5,5,2,0,21,1
Port Adelaide,"Schulz, Jay",8,6,2,2,5,0,0,1
Port Adelaide,"Trengove, Jackson",4,2,2,2,0,0,0,3
Port Adelaide,"Westhoff, Justin",12,10,7,2,2,0,0,3
Port Adelaide,"White, Matt",12,7,1,5,0,1,0,5
Port Adelaide,"Wingard, Chad",21,9,1,12,1,2,0,3
Port Adelaide,"Young, Aaron",25,14,2,11,1,0,0,2
Port Adelaide,"Boak, Travis",33,15,2,18,1,2,1,3
Port Adelaide,"Broadbent, Matthew",17,11,5,6,0,0,0,3
Port Adelaide,"Carlile, Alipate",19,9,4,10,0,0,0,3
Port Adelaide,"Cornes, Kane",22,9,6,13,0,0,0,7
Port Adelaide,"Ebert, Brad",31,14,9,17,0,1,5,7
Port Adelaide,"Gray, Robbie",32,12,4,20,1,1,0,2
Port Adelaide,"Hartlett, Hamish",18,13,7,5,2,1,0,4
Port Adelaide,"Hombsch, Jack",15,13,5,2,0,1,0,1
Port Adelaide,"Jonas, Tom",15,8,4,7,0,0,0,2
Port Adelaide,"Krakouer, Nathan",10,6,3,4,0,0,0,0
Port Adelaide,"Lobbe, Matthew",7,2,0,5,0,0,38,3
Port Adelaide,"Mitchell, Kane",19,13,3,6,2,0,0,5
Port Adelaide,"Monfries, Angus",16,5,5,11,0,0,0,2
Port Adelaide,"Pittard, Jasper",28,22,7,6,0,0,0,0
Port Adelaide,"Polec, Jared",6,5,2,1,0,0,0,2
Port Adelaide,"Ryder, Paddy",10,5,3,5,3,0,18,0
Port Adelaide,"Schulz, Jay",14,12,9,2,5,1,0,3
Port Adelaide,"Trengove, Jackson",14,6,6,8,0,0,0,1
Port Adelaide,"Westhoff, Justin",17,12,7,5,2,0,1,4
Port Adelaide,"White, Matt",17,13,6,4,0,0,0,9
Port Adelaide,"Wingard, Chad",21,12,4,9,2,0,0,1
Port Adelaide,"Young, Aaron",13,4,1,9,0,0,0,0
Port Adelaide,"Ah Chee, Brendon",4,3,2,1,0,0,2,4
Port Adelaide,"Boak, Travis",23,9,2,14,1,0,1,11
Port Adelaide,"Broadbent, Matthew",12,7,1,5,0,0,0,4
Port Adelaide,"Carlile, Alipate",15,7,3,8,0,0,0,0
Port Adelaide,"Cornes, Kane",21,12,3,9,0,0,0,4
Port Adelaide,"Ebert, Brad",23,9,3,14,0,0,2,9
Port Adelaide,"Gray, Robbie",25,14,7,11,3,0,0,8
Port Adelaide,"Hartlett, Hamish",25,11,4,14,0,2,1,10
Port Adelaide,"Hombsch, Jack",17,12,6,5,0,0,0,3
Port Adelaide,"Jonas, Tom",9,4,4,5,0,0,0,3
Port Adelaide,"Krakouer, Nathan",19,17,2,2,0,0,0,2
Port Adelaide,"Lobbe, Matthew",7,4,1,3,1,0,16,9
Port Adelaide,"Mitchell, Kane",21,13,4,8,0,0,0,6
Port Adelaide,"Monfries, Angus",19,7,5,12,1,0,0,2
Port Adelaide,"Pittard, Jasper",17,10,4,7,0,1,0,3
Port Adelaide,"Ryder, Paddy",14,5,4,9,0,1,13,3
Port Adelaide,"Schulz, Jay",13,12,11,1,1,1,0,0
Port Adelaide,"Trengove, Jackson",13,2,2,11,0,0,0,6
Port Adelaide,"Westhoff, Justin",14,6,5,8,0,1,1,2
Port Adelaide,"White, Matt",17,10,10,7,1,0,0,2
Port Adelaide,"Wingard, Chad",24,15,7,9,2,0,0,2
Port Adelaide,"Young, Aaron",11,3,2,8,0,0,0,3
Port Adelaide,"Amon, Karl",9,6,4,3,1,1,1,2
Port Adelaide,"Boak, Travis",27,18,1,9,0,0,4,8
Port Adelaide,"Broadbent, Matthew",22,10,2,12,0,0,1,6
Port Adelaide,"Cornes, Kane",13,9,3,4,1,0,0,2
Port Adelaide,"Ebert, Brad",16,10,5,6,0,0,1,2
Port Adelaide,"Gray, Robbie",25,13,1,12,1,1,0,10
Port Adelaide,"Hartlett, Hamish",22,16,4,6,0,1,1,7
Port Adelaide,"Hombsch, Jack",13,6,7,7,0,0,0,3
Port Adelaide,"Impey, Jarman",9,5,4,4,0,0,0,8
Port Adelaide,"Jonas, Tom",11,4,2,7,0,0,0,5
Port Adelaide,"Krakouer, Nathan",17,13,6,4,0,1,0,2
Port Adelaide,"Lobbe, Matthew",14,10,2,4,0,0,31,6
Port Adelaide,"Mitchell, Kane",14,6,1,8,0,1,0,6
Port Adelaide,"Monfries, Angus",17,13,6,4,3,1,0,2
Port Adelaide,"OShea, Cameron",7,7,3,0,0,0,0,2
Port Adelaide,"Pittard, Jasper",16,8,4,8,0,0,0,3
Port Adelaide,"Ryder, Paddy",12,8,4,4,0,3,21,3
Port Adelaide,"Schulz, Jay",13,8,7,5,1,2,0,1
Port Adelaide,"Trengove, Jackson",9,2,2,7,0,0,0,2
Port Adelaide,"Westhoff, Justin",16,13,6,3,0,0,2,3
Port Adelaide,"White, Matt",7,3,3,4,0,0,0,1
Port Adelaide,"Wingard, Chad",25,13,2,12,1,3,0,4
Port Adelaide,"Amon, Karl",6,2,1,4,0,0,0,2
Port Adelaide,"Boak, Travis",32,12,5,20,0,1,0,3
Port Adelaide,"Carlile, Alipate",12,6,2,6,0,0,0,0
Port Adelaide,"Cornes, Kane",28,10,5,18,0,0,0,6
Port Adelaide,"Ebert, Brad",25,9,4,16,0,0,4,5
Port Adelaide,"Gray, Robbie",28,13,0,15,1,0,0,8
Port Adelaide,"Gray, Sam",12,3,1,9,0,0,0,2
Port Adelaide,"Hartlett, Hamish",21,10,3,11,0,0,0,5
Port Adelaide,"Hombsch, Jack",22,17,12,5,0,0,0,4
Port Adelaide,"Impey, Jarman",9,7,5,2,0,1,0,2
Port Adelaide,"Jonas, Tom",13,4,4,9,0,0,0,2
Port Adelaide,"Krakouer, Nathan",10,8,2,2,0,0,0,1
Port Adelaide,"Lobbe, Matthew",9,7,2,2,0,0,29,10
Port Adelaide,"Monfries, Angus",16,7,2,9,2,1,0,3
Port Adelaide,"Pittard, Jasper",16,11,3,5,0,0,0,2
Port Adelaide,"Ryder, Paddy",11,7,4,4,0,1,20,0
Port Adelaide,"Schulz, Jay",13,8,2,5,0,2,0,6
Port Adelaide,"Trengove, Jackson",7,3,4,4,0,0,0,0
Port Adelaide,"Westhoff, Justin",20,12,8,8,0,1,3,1
Port Adelaide,"White, Matt",12,6,6,6,0,0,0,1
Port Adelaide,"Wines, Ollie",24,12,3,12,0,1,5,6
Port Adelaide,"Wingard, Chad",20,10,3,10,2,2,0,1
Port Adelaide,"Amon, Karl",12,8,4,4,1,0,0,1
Port Adelaide,"Boak, Travis",31,15,8,16,0,1,0,5
Port Adelaide,"Broadbent, Matthew",24,17,8,7,0,1,0,5
Port Adelaide,"Carlile, Alipate",10,6,4,4,0,0,0,3
Port Adelaide,"Clurey, Tom",9,9,7,0,0,0,0,1
Port Adelaide,"Ebert, Brad",31,19,5,12,1,0,1,5
Port Adelaide,"Gray, Robbie",26,14,4,12,1,0,0,6
Port Adelaide,"Gray, Sam",16,6,2,10,0,0,0,6
Port Adelaide,"Hartlett, Hamish",20,9,2,11,1,0,0,9
Port Adelaide,"Hombsch, Jack",16,13,10,3,0,0,0,0
Port Adelaide,"Impey, Jarman",12,9,9,3,0,0,0,4
Port Adelaide,"Jonas, Tom",8,6,5,2,0,0,0,1
Port Adelaide,"Krakouer, Nathan",4,3,0,1,1,0,0,2
Port Adelaide,"Lobbe, Matthew",8,4,3,4,0,0,45,6
Port Adelaide,"Monfries, Angus",18,13,9,5,3,0,0,1
Port Adelaide,"Pittard, Jasper",12,7,4,5,0,0,0,3
Port Adelaide,"Schulz, Jay",12,11,7,1,4,1,0,2
Port Adelaide,"Stewart, Paul",10,6,5,4,1,0,0,3
Port Adelaide,"Westhoff, Justin",17,10,7,7,2,1,8,3
Port Adelaide,"White, Matt",17,13,9,4,1,1,0,2
Port Adelaide,"Wines, Ollie",29,13,6,16,0,1,3,4
Port Adelaide,"Wingard, Chad",17,15,5,2,2,0,0,2
Port Adelaide,"Amon, Karl",13,10,1,3,0,0,0,3
Port Adelaide,"Boak, Travis",22,10,1,12,1,0,1,2
Port Adelaide,"Broadbent, Matthew",18,14,11,4,0,0,0,2
Port Adelaide,"Carlile, Alipate",8,6,3,2,0,0,0,2
Port Adelaide,"Clurey, Tom",9,8,6,1,0,0,0,2
Port Adelaide,"Ebert, Brad",22,14,6,8,1,0,3,12
Port Adelaide,"Gray, Robbie",20,10,5,10,1,0,0,5
Port Adelaide,"Gray, Sam",9,4,1,5,1,0,0,3
Port Adelaide,"Hartlett, Hamish",20,12,3,8,1,1,3,5
Port Adelaide,"Hombsch, Jack",13,10,6,3,0,0,0,4
Port Adelaide,"Impey, Jarman",17,7,5,10,0,0,0,4
Port Adelaide,"Jonas, Tom",10,8,5,2,0,0,0,5
Port Adelaide,"Lobbe, Matthew",7,4,0,3,0,0,44,5
Port Adelaide,"Monfries, Angus",10,4,3,6,1,0,0,1
Port Adelaide,"Pittard, Jasper",15,12,8,3,0,0,0,9
Port Adelaide,"Schulz, Jay",9,6,6,3,2,0,0,4
Port Adelaide,"Stewart, Paul",16,8,3,8,1,0,0,1
Port Adelaide,"Westhoff, Justin",25,19,14,6,1,1,1,3
Port Adelaide,"White, Matt",16,11,4,5,2,0,0,6
Port Adelaide,"Wines, Ollie",33,17,2,16,1,0,5,5
Port Adelaide,"Wingard, Chad",23,14,6,9,3,2,0,3
Port Adelaide,"Young, Aaron",8,6,0,2,0,0,1,1
Port Adelaide,"Boak, Travis",16,10,2,6,1,0,0,7
Port Adelaide,"Broadbent, Matthew",25,18,8,7,0,0,1,2
Port Adelaide,"Carlile, Alipate",10,4,2,6,0,0,0,1
Port Adelaide,"Clurey, Tom",4,3,1,1,0,0,0,1
Port Adelaide,"Colquhoun, Sam",20,11,1,9,0,0,0,1
Port Adelaide,"Ebert, Brad",28,18,9,10,0,0,1,5
Port Adelaide,"Gray, Robbie",27,13,0,14,2,0,0,4
Port Adelaide,"Gray, Sam",12,9,2,3,0,1,0,0
Port Adelaide,"Hartlett, Hamish",19,10,3,9,0,0,0,6
Port Adelaide,"Hombsch, Jack",10,7,4,3,0,0,1,4
Port Adelaide,"Impey, Jarman",15,4,1,11,0,0,0,3
Port Adelaide,"Jonas, Tom",9,4,1,5,0,0,0,5
Port Adelaide,"Lobbe, Matthew",5,3,0,2,0,0,52,9
Port Adelaide,"Monfries, Angus",9,4,2,5,1,0,0,1
Port Adelaide,"Pittard, Jasper",22,14,4,8,0,0,0,0
Port Adelaide,"Schulz, Jay",11,7,4,4,1,0,0,4
Port Adelaide,"Stewart, Paul",7,4,2,3,0,0,0,2
Port Adelaide,"Westhoff, Justin",13,7,2,6,2,0,2,6
Port Adelaide,"White, Matt",5,1,0,4,0,0,0,2
Port Adelaide,"Wines, Ollie",24,15,0,9,0,0,2,7
Port Adelaide,"Wingard, Chad",27,21,5,6,4,1,0,3
Port Adelaide,"Young, Aaron",7,6,1,1,0,0,0,3
Port Adelaide,"Ah Chee, Brendon",12,7,2,5,0,1,1,1
Port Adelaide,"Boak, Travis",27,11,4,16,2,1,0,6
Port Adelaide,"Broadbent, Matthew",24,16,0,8,0,0,0,3
Port Adelaide,"Carlile, Alipate",11,4,4,7,0,0,0,2
Port Adelaide,"Colquhoun, Sam",22,12,3,10,1,0,0,4
Port Adelaide,"Ebert, Brad",20,11,6,9,1,1,0,5
Port Adelaide,"Gray, Robbie",15,8,4,7,2,0,0,0
Port Adelaide,"Hartlett, Hamish",25,10,5,15,0,1,2,6
Port Adelaide,"Hombsch, Jack",17,11,4,6,0,0,0,3
Port Adelaide,"Impey, Jarman",23,10,3,13,0,0,0,2
Port Adelaide,"Jonas, Tom",16,4,2,12,0,0,0,2
Port Adelaide,"Krakouer, Nathan",18,15,2,3,1,0,0,1
Port Adelaide,"Lobbe, Matthew",15,4,5,11,0,0,42,4
Port Adelaide,"Mitchell, Kane",21,10,3,11,0,1,0,2
Port Adelaide,"Monfries, Angus",12,3,3,9,1,0,0,3
Port Adelaide,"Moore, Andrew",12,5,3,7,0,1,1,6
Port Adelaide,"Pittard, Jasper",19,9,8,10,0,0,1,0
Port Adelaide,"Schulz, Jay",13,6,5,7,0,1,0,0
Port Adelaide,"Trengove, Jackson",9,2,2,7,0,0,1,2
Port Adelaide,"Westhoff, Justin",19,13,9,6,2,0,2,1
Port Adelaide,"Wines, Ollie",26,10,1,16,1,0,2,2
Port Adelaide,"Wingard, Chad",12,7,3,5,5,0,0,1
Port Adelaide,"Ah Chee, Brendon",19,11,3,8,1,0,1,3
Port Adelaide,"Boak, Travis",21,9,3,12,1,2,0,9
Port Adelaide,"Broadbent, Matthew",19,12,4,7,0,1,0,0
Port Adelaide,"Carlile, Alipate",10,4,4,6,0,0,0,0
Port Adelaide,"Colquhoun, Sam",22,15,8,7,0,0,0,0
Port Adelaide,"Ebert, Brad",18,7,3,11,0,0,3,7
Port Adelaide,"Gray, Robbie",32,13,1,19,1,3,1,6
Port Adelaide,"Hartlett, Hamish",22,11,4,11,1,0,2,4
Port Adelaide,"Hombsch, Jack",18,11,4,7,0,0,0,3
Port Adelaide,"Impey, Jarman",20,9,4,11,0,1,0,1
Port Adelaide,"Jonas, Tom",12,4,4,8,0,0,0,0
Port Adelaide,"Krakouer, Nathan",18,15,5,3,2,0,0,2
Port Adelaide,"Lobbe, Matthew",10,4,1,6,0,0,30,3
Port Adelaide,"Monfries, Angus",9,5,1,4,0,0,0,3
Port Adelaide,"Moore, Andrew",6,5,2,1,0,0,0,2
Port Adelaide,"Pittard, Jasper",27,16,8,11,0,0,0,2
Port Adelaide,"Ryder, Paddy",3,2,2,1,0,0,22,3
Port Adelaide,"Schulz, Jay",11,4,4,7,1,1,0,5
Port Adelaide,"Stewart, Paul",16,8,4,8,0,0,0,3
Port Adelaide,"Westhoff, Justin",22,15,8,7,2,0,0,5
Port Adelaide,"Wines, Ollie",29,6,1,23,0,0,4,3
Port Adelaide,"Wingard, Chad",15,7,5,8,3,1,0,3
Port Adelaide,"Ah Chee, Brendon",7,3,1,4,0,0,0,5
Port Adelaide,"Amon, Karl",12,8,3,4,0,0,0,2
Port Adelaide,"Boak, Travis",27,6,2,21,0,0,0,8
Port Adelaide,"Broadbent, Matthew",26,20,7,6,0,0,0,2
Port Adelaide,"Clurey, Tom",10,4,2,6,0,0,0,1
Port Adelaide,"Ebert, Brad",20,12,3,8,0,0,1,4
Port Adelaide,"Gray, Robbie",23,9,3,14,2,1,0,3
Port Adelaide,"Hartlett, Hamish",14,9,0,5,0,0,0,4
Port Adelaide,"Hombsch, Jack",10,7,6,3,0,0,0,4
Port Adelaide,"Impey, Jarman",14,9,1,5,1,1,0,2
Port Adelaide,"Lobbe, Matthew",3,0,0,3,0,0,9,2
Port Adelaide,"Monfries, Angus",23,12,7,11,1,0,0,7
Port Adelaide,"Neade, Jake",12,4,1,8,0,0,0,5
Port Adelaide,"OShea, Cameron",9,6,1,3,0,0,0,0
Port Adelaide,"Pittard, Jasper",14,9,4,5,0,1,0,1
Port Adelaide,"Ryder, Paddy",13,8,4,5,0,0,35,2
Port Adelaide,"Schulz, Jay",15,10,6,5,1,0,0,3
Port Adelaide,"Stewart, Paul",7,4,1,3,0,0,0,4
Port Adelaide,"Trengove, Jackson",13,6,3,7,0,0,4,2
Port Adelaide,"Westhoff, Justin",26,14,6,12,1,1,5,8
Port Adelaide,"Wines, Ollie",33,17,3,16,0,0,2,10
Port Adelaide,"Wingard, Chad",21,18,6,3,3,3,0,2
Port Adelaide,"Ah Chee, Brendon",5,3,1,2,0,0,0,1
Port Adelaide,"Boak, Travis",32,12,5,20,2,0,0,7
Port Adelaide,"Broadbent, Matthew",21,16,5,5,0,0,0,2
Port Adelaide,"Clurey, Tom",11,7,5,4,0,0,0,0
Port Adelaide,"Ebert, Brad",23,12,9,11,0,1,0,5
Port Adelaide,"Gray, Robbie",23,15,4,8,3,0,0,2
Port Adelaide,"Hartlett, Hamish",25,10,6,15,0,0,0,7
Port Adelaide,"Hombsch, Jack",13,4,3,9,0,0,0,7
Port Adelaide,"Impey, Jarman",8,6,4,2,0,1,0,7
Port Adelaide,"Krakouer, Nathan",14,13,1,1,0,0,0,1
Port Adelaide,"Lobbe, Matthew",9,4,3,5,2,0,23,6
Port Adelaide,"Monfries, Angus",17,14,6,3,1,2,0,4
Port Adelaide,"Neade, Jake",10,5,2,5,0,0,0,5
Port Adelaide,"OShea, Cameron",13,9,4,4,0,0,0,4
Port Adelaide,"Ryder, Paddy",15,9,5,6,3,2,17,0
Port Adelaide,"Schulz, Jay",9,4,3,5,3,0,0,1
Port Adelaide,"Stewart, Paul",13,10,6,3,0,0,0,0
Port Adelaide,"Trengove, Jackson",10,4,3,6,0,0,0,0
Port Adelaide,"Westhoff, Justin",13,8,5,5,0,2,0,6
Port Adelaide,"Wines, Ollie",19,11,5,8,0,0,3,2
Port Adelaide,"Wingard, Chad",23,13,4,10,3,1,0,6
Port Adelaide,"Young, Aaron",9,5,3,4,0,0,0,4
Port Adelaide,"Boak, Travis",28,17,2,11,2,1,0,4
Port Adelaide,"Broadbent, Matthew",22,16,6,6,0,0,0,0
Port Adelaide,"Clurey, Tom",9,4,5,5,0,0,0,4
Port Adelaide,"Colquhoun, Sam",16,7,4,9,0,0,0,2
Port Adelaide,"Ebert, Brad",17,10,6,7,1,0,1,8
Port Adelaide,"Gray, Robbie",21,11,1,10,1,0,0,2
Port Adelaide,"Hartlett, Hamish",18,8,1,10,0,0,0,6
Port Adelaide,"Hombsch, Jack",6,3,4,3,0,0,0,2
Port Adelaide,"Impey, Jarman",7,2,0,5,0,0,0,2
Port Adelaide,"Lobbe, Matthew",9,7,2,2,1,0,46,5
Port Adelaide,"Monfries, Angus",7,2,0,5,0,0,0,4
Port Adelaide,"Moore, Andrew",13,10,2,3,1,0,3,7
Port Adelaide,"Neade, Jake",6,3,2,3,2,0,0,4
Port Adelaide,"OShea, Cameron",13,10,7,3,0,0,0,2
Port Adelaide,"Ryder, Paddy",10,10,3,0,4,0,10,0
Port Adelaide,"Schulz, Jay",8,6,3,2,3,1,0,1
Port Adelaide,"Trengove, Jackson",12,5,3,7,0,0,0,0
Port Adelaide,"Westhoff, Justin",14,10,4,4,1,1,0,4
Port Adelaide,"White, Matt",6,4,0,2,1,0,0,2
Port Adelaide,"Wines, Ollie",25,9,3,16,0,0,0,8
Port Adelaide,"Wingard, Chad",17,12,3,5,3,1,0,8
Port Adelaide,"Young, Aaron",8,2,0,6,0,0,0,1
Port Adelaide,"Boak, Travis",29,17,4,12,0,1,0,6
Port Adelaide,"Broadbent, Matthew",23,16,3,7,0,0,0,3
Port Adelaide,"Clurey, Tom",13,9,5,4,0,0,0,1
Port Adelaide,"Colquhoun, Sam",20,14,7,6,0,0,0,3
Port Adelaide,"Ebert, Brad",22,13,6,9,0,0,0,4
Port Adelaide,"Gray, Robbie",37,13,3,24,1,0,0,5
Port Adelaide,"Gray, Sam",20,10,4,10,1,0,0,5
Port Adelaide,"Hartlett, Hamish",27,14,5,13,0,0,0,1
Port Adelaide,"Hombsch, Jack",16,7,6,9,0,0,0,5
Port Adelaide,"Lobbe, Matthew",7,2,2,5,1,0,29,4
Port Adelaide,"Moore, Andrew",20,9,5,11,1,0,0,5
Port Adelaide,"Neade, Jake",16,9,3,7,2,0,0,1
Port Adelaide,"OShea, Cameron",21,7,3,14,0,0,0,4
Port Adelaide,"Pittard, Jasper",16,9,2,7,0,0,0,1
Port Adelaide,"Ryder, Paddy",14,6,5,8,1,3,13,5
Port Adelaide,"Schulz, Jay",9,7,8,2,2,2,0,2
Port Adelaide,"Trengove, Jackson",12,3,4,9,0,0,1,3
Port Adelaide,"Westhoff, Justin",23,17,7,6,2,2,0,2
Port Adelaide,"White, Matt",14,9,2,5,2,0,0,2
Port Adelaide,"Wines, Ollie",5,1,0,4,0,0,0,0
Port Adelaide,"Wingard, Chad",15,11,3,4,4,2,0,3
Port Adelaide,"Young, Aaron",21,9,1,12,0,0,0,4
Port Adelaide,"Boak, Travis",20,9,2,11,1,0,0,6
Port Adelaide,"Broadbent, Matthew",18,11,6,7,0,0,0,5
Port Adelaide,"Clurey, Tom",8,3,2,5,0,0,0,5
Port Adelaide,"Colquhoun, Sam",7,5,2,2,0,0,0,0
Port Adelaide,"Ebert, Brad",20,18,6,2,0,1,2,5
Port Adelaide,"Gray, Robbie",23,9,3,14,1,0,0,3
Port Adelaide,"Gray, Sam",21,7,2,14,0,0,0,5
Port Adelaide,"Hartlett, Hamish",18,11,6,7,0,1,0,5
Port Adelaide,"Hombsch, Jack",9,4,5,5,0,0,0,3
Port Adelaide,"Impey, Jarman",13,7,3,6,0,0,0,4
Port Adelaide,"Lobbe, Matthew",2,2,0,0,0,0,19,6
Port Adelaide,"Moore, Andrew",16,9,4,7,0,0,0,5
Port Adelaide,"Neade, Jake",9,3,1,6,0,0,0,4
Port Adelaide,"OShea, Cameron",9,5,2,4,0,0,0,3
Port Adelaide,"Pittard, Jasper",12,5,4,7,0,0,0,0
Port Adelaide,"Ryder, Paddy",9,4,3,5,1,1,18,0
Port Adelaide,"Schulz, Jay",8,7,6,1,2,1,0,2
Port Adelaide,"Trengove, Jackson",12,6,4,6,0,0,0,2
Port Adelaide,"Westhoff, Justin",19,10,3,9,1,0,5,0
Port Adelaide,"White, Matt",11,8,5,3,1,0,0,0
Port Adelaide,"Wingard, Chad",15,11,4,4,2,0,0,0
Port Adelaide,"Young, Aaron",17,6,3,11,0,1,0,2
Port Adelaide,"Ah Chee, Brendon",24,11,4,13,3,0,1,5
Port Adelaide,"Boak, Travis",19,8,2,11,0,1,0,4
Port Adelaide,"Broadbent, Matthew",20,13,4,7,0,0,0,0
Port Adelaide,"Butcher, John",10,7,3,3,1,0,0,1
Port Adelaide,"Ebert, Brad",17,12,5,5,1,3,0,2
Port Adelaide,"Gray, Robbie",26,11,3,15,1,0,0,2
Port Adelaide,"Gray, Sam",25,13,1,12,0,0,0,2
Port Adelaide,"Hartlett, Hamish",19,11,3,8,1,0,0,11
Port Adelaide,"Hombsch, Jack",14,6,3,8,0,0,0,3
Port Adelaide,"Impey, Jarman",17,6,2,11,0,0,0,4
Port Adelaide,"Jonas, Tom",16,5,5,11,0,0,0,2
Port Adelaide,"Krakouer, Nathan",4,2,2,2,0,0,0,1
Port Adelaide,"Mitchell, Kane",13,8,2,5,0,0,0,4
Port Adelaide,"Monfries, Angus",15,10,5,5,3,1,0,2
Port Adelaide,"Neade, Jake",16,5,5,11,1,0,0,4
Port Adelaide,"OShea, Cameron",20,16,6,4,0,1,0,4
Port Adelaide,"Pittard, Jasper",23,14,5,9,0,2,0,3
Port Adelaide,"Ryder, Paddy",17,6,1,11,0,0,46,3
Port Adelaide,"Trengove, Jackson",13,6,7,7,0,0,2,3
Port Adelaide,"Westhoff, Justin",17,14,9,3,2,1,4,2
Port Adelaide,"White, Matt",9,5,3,4,0,0,0,4
Port Adelaide,"Wingard, Chad",17,13,3,4,3,3,0,6
Port Adelaide,"Ah Chee, Brendon",25,10,6,15,1,0,1,6
Port Adelaide,"Boak, Travis",30,16,6,14,0,2,0,5
Port Adelaide,"Broadbent, Matthew",20,12,8,8,0,0,0,2
Port Adelaide,"Butcher, John",8,6,4,2,0,0,0,0
Port Adelaide,"Ebert, Brad",24,12,6,12,0,1,2,3
Port Adelaide,"Gray, Robbie",34,14,4,20,0,2,0,4
Port Adelaide,"Gray, Sam",34,17,3,17,1,1,0,3
Port Adelaide,"Hartlett, Hamish",26,16,8,10,1,0,0,6
Port Adelaide,"Hombsch, Jack",9,2,1,7,0,0,0,2
Port Adelaide,"Impey, Jarman",13,7,6,6,0,0,0,2
Port Adelaide,"Jonas, Tom",12,7,4,5,0,0,0,2
Port Adelaide,"Krakouer, Nathan",20,11,4,9,0,0,0,2
Port Adelaide,"Mitchell, Kane",2,0,1,2,0,0,0,1
Port Adelaide,"Monfries, Angus",13,9,4,4,3,0,0,0
Port Adelaide,"Neade, Jake",14,5,2,9,2,1,0,2
Port Adelaide,"OShea, Cameron",14,11,5,3,0,0,0,2
Port Adelaide,"Pittard, Jasper",27,20,10,7,0,0,0,1
Port Adelaide,"Ryder, Paddy",14,8,5,6,0,0,40,1
Port Adelaide,"Schulz, Jay",7,5,4,2,3,0,0,2
Port Adelaide,"Westhoff, Justin",24,15,4,9,0,0,5,3
Port Adelaide,"White, Matt",15,13,6,2,1,2,0,2
Port Adelaide,"Wingard, Chad",20,16,5,4,4,1,0,1
Port Adelaide,"Ah Chee, Brendon",18,11,6,7,1,0,0,2
Port Adelaide,"Amon, Karl",16,10,2,6,3,1,0,6
Port Adelaide,"Boak, Travis",19,10,1,9,0,0,0,3
Port Adelaide,"Broadbent, Matthew",23,18,3,5,0,0,0,1
Port Adelaide,"Butcher, John",10,7,5,3,0,0,0,2
Port Adelaide,"Ebert, Brad",19,14,3,5,1,1,1,8
Port Adelaide,"Gray, Robbie",26,15,1,11,0,2,0,4
Port Adelaide,"Gray, Sam",37,20,3,17,0,0,0,3
Port Adelaide,"Hartlett, Hamish",32,20,5,12,0,1,0,7
Port Adelaide,"Hombsch, Jack",13,7,5,6,0,0,0,3
Port Adelaide,"Impey, Jarman",4,2,0,2,0,0,0,0
Port Adelaide,"Jonas, Tom",10,8,1,2,0,0,0,4
Port Adelaide,"Krakouer, Nathan",19,15,6,4,0,0,0,0
Port Adelaide,"Lobbe, Matthew",6,2,1,4,0,0,28,7
Port Adelaide,"Monfries, Angus",10,4,2,6,0,0,0,6
Port Adelaide,"OShea, Cameron",12,11,5,1,0,0,0,3
Port Adelaide,"Pittard, Jasper",15,11,5,4,0,0,0,4
Port Adelaide,"Ryder, Paddy",6,3,0,3,1,0,30,3
Port Adelaide,"Westhoff, Justin",15,8,3,7,2,1,5,4
Port Adelaide,"White, Matt",18,16,1,2,2,1,0,3
Port Adelaide,"Wingard, Chad",16,10,1,6,2,2,0,5
Port Adelaide,"Young, Aaron",6,5,1,1,0,0,0,3
Port Adelaide,"Ah Chee, Brendon",22,8,2,14,0,1,0,6
Port Adelaide,"Amon, Karl",5,4,2,1,0,1,0,1
Port Adelaide,"Boak, Travis",27,11,2,16,0,1,0,6
Port Adelaide,"Broadbent, Matthew",19,14,8,5,0,0,0,2
Port Adelaide,"Butcher, John",11,7,7,4,1,3,0,0
Port Adelaide,"Ebert, Brad",28,14,6,14,0,1,0,7
Port Adelaide,"Gray, Robbie",23,11,3,12,3,1,0,3
Port Adelaide,"Gray, Sam",34,16,5,18,1,0,0,4
Port Adelaide,"Hartlett, Hamish",28,19,4,9,1,0,0,9
Port Adelaide,"Hombsch, Jack",14,11,2,3,0,0,1,2
Port Adelaide,"Impey, Jarman",13,8,3,5,0,0,0,2
Port Adelaide,"Jonas, Tom",16,9,5,7,0,0,0,0
Port Adelaide,"Krakouer, Nathan",21,17,8,4,1,0,0,3
Port Adelaide,"Lobbe, Matthew",15,10,5,5,0,0,19,5
Port Adelaide,"Neade, Jake",12,6,2,6,1,1,0,6
Port Adelaide,"OShea, Cameron",22,16,8,6,0,0,0,2
Port Adelaide,"Pittard, Jasper",21,14,6,7,1,0,0,2
Port Adelaide,"Ryder, Paddy",14,6,8,8,1,0,17,1
Port Adelaide,"Schulz, Jay",10,8,6,2,4,0,0,0
Port Adelaide,"Westhoff, Justin",25,13,13,12,2,0,1,2
Port Adelaide,"White, Matt",16,12,5,4,2,1,0,5
Port Adelaide,"Wingard, Chad",12,9,3,3,0,0,0,3
Richmond,"Batchelor, Jake",15,9,5,6,0,0,0,2
Richmond,"Chaplin, Troy",13,9,1,4,0,0,0,2
Richmond,"Cotchin, Trent",17,6,3,11,0,1,0,1
Richmond,"Deledio, Brett",18,9,3,9,0,2,0,0
Richmond,"Edwards, Shane",21,9,1,12,0,0,0,3
Richmond,"Ellis, Brandon",26,15,9,11,0,1,0,7
Richmond,"Gordon, Nathan",5,3,1,2,1,0,0,0
Richmond,"Griffiths, Ben",12,8,6,4,3,1,4,0
Richmond,"Grigg, Shaun",17,9,4,8,2,2,2,2
Richmond,"Grimes, Dylan",11,4,1,7,0,0,0,1
Richmond,"Houli, Bachar",21,15,5,6,0,2,0,1
Richmond,"Hunt, Taylor",27,17,8,10,0,0,0,5
Richmond,"Lloyd, Sam",14,10,7,4,3,2,0,1
Richmond,"Maric, Ivan",13,8,4,5,0,0,33,4
Richmond,"Martin, Dustin",13,8,0,5,1,0,0,4
Richmond,"McIntosh, Kamdyn",23,14,9,9,1,2,0,2
Richmond,"Miles, Anthony",23,10,4,13,0,0,0,4
Richmond,"Morris, Steven",3,0,1,3,0,0,0,4
Richmond,"Newman, Chris",7,6,1,1,0,0,0,1
Richmond,"Rance, Alex",18,9,4,9,0,0,0,0
Richmond,"Riewoldt, Jack",17,13,8,4,4,0,0,0
Richmond,"Vlastuin, Nick",21,9,6,12,0,0,0,7
Richmond,"Batchelor, Jake",17,13,9,4,0,0,0,0
Richmond,"Chaplin, Troy",18,9,6,9,0,0,0,0
Richmond,"Cotchin, Trent",34,23,4,11,0,0,0,2
Richmond,"Ellis, Brandon",26,12,3,14,0,0,0,5
Richmond,"Gordon, Nathan",11,5,6,6,1,1,0,2
Richmond,"Griffiths, Ben",13,9,7,4,1,1,12,2
Richmond,"Grigg, Shaun",20,8,3,12,0,0,1,2
Richmond,"Grimes, Dylan",10,5,5,5,1,0,0,0
Richmond,"Houli, Bachar",22,14,5,8,0,0,0,3
Richmond,"Hunt, Taylor",23,11,6,12,0,1,0,2
Richmond,"Lambert, Kane",6,3,2,3,0,1,0,1
Richmond,"Lloyd, Sam",16,7,7,9,1,0,0,1
Richmond,"Maric, Ivan",14,4,1,10,0,0,22,2
Richmond,"Martin, Dustin",31,15,2,16,1,0,0,6
Richmond,"McIntosh, Kamdyn",24,18,7,6,0,0,0,2
Richmond,"Miles, Anthony",27,12,4,15,0,0,0,6
Richmond,"Morris, Steven",8,4,2,4,0,0,0,1
Richmond,"Newman, Chris",16,13,7,3,1,1,0,2
Richmond,"Petterd, Ricky",15,10,7,5,1,1,0,2
Richmond,"Rance, Alex",28,14,13,14,0,0,0,2
Richmond,"Riewoldt, Jack",9,7,5,2,2,4,1,4
Richmond,"Vlastuin, Nick",15,8,2,7,0,0,0,4
Richmond,"Astbury, David",14,6,5,8,0,0,0,4
Richmond,"Batchelor, Jake",7,4,4,3,0,0,0,0
Richmond,"Chaplin, Troy",18,9,4,9,0,0,0,1
Richmond,"Cotchin, Trent",37,23,4,14,1,0,0,2
Richmond,"Edwards, Shane",26,15,3,11,1,1,0,3
Richmond,"Ellis, Brandon",24,17,8,7,0,1,0,4
Richmond,"Gordon, Nathan",21,12,6,9,2,0,0,2
Richmond,"Griffiths, Ben",19,14,10,5,2,2,6,1
Richmond,"Grigg, Shaun",23,11,6,12,2,1,0,2
Richmond,"Houli, Bachar",32,18,4,14,0,0,0,2
Richmond,"Hunt, Taylor",23,15,3,8,0,0,0,5
Richmond,"Knights, Chris",4,3,1,1,1,0,0,3
Richmond,"Lloyd, Sam",10,5,5,5,1,0,0,4
Richmond,"Maric, Ivan",11,7,2,4,0,0,29,1
Richmond,"Martin, Dustin",29,16,4,13,2,1,0,4
Richmond,"McIntosh, Kamdyn",14,8,3,6,2,1,0,5
Richmond,"Miles, Anthony",29,15,1,14,0,0,0,4
Richmond,"Morris, Steven",10,4,2,6,1,0,0,3
Richmond,"Newman, Chris",18,12,4,6,2,1,0,0
Richmond,"Rance, Alex",11,9,5,2,0,0,0,8
Richmond,"Riewoldt, Jack",12,10,6,2,4,0,0,0
Richmond,"Vlastuin, Nick",11,4,0,7,0,0,0,1
Richmond,"Arnot, Matt",10,7,1,3,1,0,0,6
Richmond,"Astbury, David",11,6,2,5,0,0,0,3
Richmond,"Batchelor, Jake",7,3,2,4,0,0,0,5
Richmond,"Cotchin, Trent",24,13,2,11,0,1,1,3
Richmond,"Drummond, Nathan",5,4,1,1,0,0,0,2
Richmond,"Edwards, Shane",24,14,1,10,2,1,0,5
Richmond,"Ellis, Brandon",22,14,3,8,0,0,0,7
Richmond,"Gordon, Nathan",10,8,3,2,1,1,0,1
Richmond,"Griffiths, Ben",8,5,3,3,1,2,7,2
Richmond,"Grigg, Shaun",17,10,2,7,0,0,4,12
Richmond,"Houli, Bachar",21,12,3,9,0,0,0,2
Richmond,"Hunt, Taylor",10,7,2,3,1,0,1,4
Richmond,"Lloyd, Sam",12,5,2,7,0,0,0,3
Richmond,"Maric, Ivan",14,6,3,8,0,1,34,7
Richmond,"Martin, Dustin",24,16,0,8,0,0,0,6
Richmond,"McDonough, Matt",7,6,1,1,0,0,0,3
Richmond,"McIntosh, Kamdyn",14,10,2,4,0,1,0,2
Richmond,"Miles, Anthony",25,10,2,15,0,2,0,4
Richmond,"Morris, Steven",4,0,1,4,0,0,0,5
Richmond,"Rance, Alex",10,4,4,6,0,0,0,3
Richmond,"Riewoldt, Jack",17,10,7,7,0,4,0,5
Richmond,"Vlastuin, Nick",10,6,4,4,0,0,0,5
Richmond,"Astbury, David",11,6,5,5,1,0,0,0
Richmond,"Batchelor, Jake",15,8,5,7,0,0,0,2
Richmond,"Chaplin, Troy",16,7,4,9,0,0,0,1
Richmond,"Cotchin, Trent",29,14,2,15,1,2,0,3
Richmond,"Edwards, Shane",21,8,3,13,1,0,0,6
Richmond,"Ellis, Brandon",33,10,5,23,0,0,0,3
Richmond,"Ellis, Corey",13,3,2,10,1,1,0,2
Richmond,"Grigg, Shaun",14,6,3,8,1,0,0,4
Richmond,"Houli, Bachar",33,16,7,17,1,0,0,9
Richmond,"Hunt, Taylor",17,7,4,10,0,0,0,2
Richmond,"Lennon, Ben",3,1,1,2,0,0,0,1
Richmond,"Lloyd, Sam",7,4,3,3,0,0,0,1
Richmond,"Maric, Ivan",16,9,5,7,0,0,25,2
Richmond,"Martin, Dustin",32,20,2,12,0,0,0,4
Richmond,"McIntosh, Kamdyn",18,13,8,5,0,0,0,1
Richmond,"Miles, Anthony",17,9,3,8,1,1,0,2
Richmond,"Morris, Steven",7,4,2,3,0,1,0,3
Richmond,"Newman, Chris",17,6,3,11,0,1,0,1
Richmond,"Rance, Alex",16,3,4,13,0,0,0,5
Richmond,"Riewoldt, Jack",12,9,6,3,3,0,0,1
Richmond,"Vickery, Ty",9,4,4,5,1,1,5,2
Richmond,"Vlastuin, Nick",18,6,3,12,0,0,0,3
Richmond,"Astbury, David",6,2,2,4,0,0,0,1
Richmond,"Batchelor, Jake",13,8,5,5,0,1,0,3
Richmond,"Chaplin, Troy",12,8,5,4,1,0,0,2
Richmond,"Cotchin, Trent",28,16,2,12,0,0,1,2
Richmond,"Deledio, Brett",19,11,4,8,0,0,0,0
Richmond,"Edwards, Shane",19,9,3,10,1,0,0,8
Richmond,"Ellis, Brandon",24,13,5,11,0,2,0,2
Richmond,"Gordon, Nathan",12,5,2,7,0,1,0,1
Richmond,"Griffiths, Ben",4,2,2,2,0,0,0,0
Richmond,"Grigg, Shaun",25,12,2,13,0,0,0,3
Richmond,"Grimes, Dylan",16,10,5,6,0,0,0,2
Richmond,"Houli, Bachar",19,10,1,9,0,0,0,2
Richmond,"Hunt, Taylor",11,4,2,7,0,0,0,1
Richmond,"Maric, Ivan",15,7,2,8,1,1,25,2
Richmond,"Martin, Dustin",30,14,5,16,1,0,0,2
Richmond,"McIntosh, Kamdyn",10,4,0,6,0,1,0,4
Richmond,"Miles, Anthony",30,15,4,15,2,0,0,4
Richmond,"Morris, Steven",10,3,5,7,1,0,0,3
Richmond,"Newman, Chris",5,4,2,1,0,1,0,2
Richmond,"Rance, Alex",16,4,3,12,0,0,2,4
Richmond,"Riewoldt, Jack",12,11,6,1,3,2,2,1
Richmond,"Vlastuin, Nick",20,6,4,14,0,0,0,3
Richmond,"Batchelor, Jake",9,5,3,4,0,0,0,3
Richmond,"Chaplin, Troy",17,11,10,6,0,0,0,1
Richmond,"Cotchin, Trent",32,21,6,11,2,1,0,3
Richmond,"Deledio, Brett",30,17,13,13,2,2,0,2
Richmond,"Ellis, Brandon",29,16,8,13,1,2,0,5
Richmond,"Ellis, Corey",13,6,3,7,0,0,0,1
Richmond,"Elton, Todd",5,2,2,3,0,0,0,1
Richmond,"Grigg, Shaun",28,17,7,11,2,0,0,2
Richmond,"Grimes, Dylan",8,3,0,5,0,0,0,1
Richmond,"Houli, Bachar",22,11,4,11,0,0,0,5
Richmond,"Hunt, Taylor",17,11,5,6,0,0,0,0
Richmond,"Maric, Ivan",16,7,3,9,1,0,34,7
Richmond,"Martin, Dustin",26,21,6,5,0,0,0,6
Richmond,"McBean, Liam",7,3,2,4,0,0,0,1
Richmond,"McIntosh, Kamdyn",15,11,1,4,1,0,0,2
Richmond,"Menadue, Connor",1,1,0,0,0,1,0,2
Richmond,"Miles, Anthony",21,16,5,5,0,0,0,7
Richmond,"Morris, Steven",7,1,2,6,0,0,0,4
Richmond,"Rance, Alex",23,8,6,15,0,0,2,5
Richmond,"Riewoldt, Jack",17,12,8,5,4,0,0,3
Richmond,"Vickery, Ty",12,8,5,4,3,0,7,0
Richmond,"Vlastuin, Nick",12,6,3,6,0,0,0,2
Richmond,"Batchelor, Jake",20,11,5,9,1,0,0,2
Richmond,"Chaplin, Troy",11,5,2,6,0,0,0,1
Richmond,"Cotchin, Trent",17,14,1,3,0,0,0,4
Richmond,"Deledio, Brett",28,11,6,17,1,0,1,5
Richmond,"Edwards, Shane",12,8,2,4,1,1,0,6
Richmond,"Ellis, Brandon",31,20,7,11,1,0,0,2
Richmond,"Ellis, Corey",5,3,1,2,0,0,0,4
Richmond,"Griffiths, Ben",11,8,5,3,1,0,4,5
Richmond,"Grigg, Shaun",26,9,5,17,0,0,0,7
Richmond,"Grimes, Dylan",12,4,2,8,0,0,0,5
Richmond,"Houli, Bachar",12,6,2,6,0,0,0,3
Richmond,"Hunt, Taylor",14,6,3,8,0,0,0,7
Richmond,"Maric, Ivan",19,11,4,8,0,1,22,4
Richmond,"Martin, Dustin",29,20,1,9,1,1,0,2
Richmond,"McIntosh, Kamdyn",18,13,4,5,0,0,0,2
Richmond,"Menadue, Connor",7,4,1,3,1,0,0,3
Richmond,"Miles, Anthony",26,17,4,9,0,0,0,7
Richmond,"Morris, Steven",9,6,2,3,0,2,0,7
Richmond,"Rance, Alex",10,5,3,5,0,0,0,1
Richmond,"Riewoldt, Jack",16,14,9,2,4,0,1,4
Richmond,"Vickery, Ty",4,3,0,1,0,1,3,1
Richmond,"Vlastuin, Nick",12,8,3,4,0,0,0,5
Richmond,"Batchelor, Jake",12,8,2,4,0,0,0,1
Richmond,"Chaplin, Troy",12,9,4,3,0,0,0,1
Richmond,"Cotchin, Trent",24,14,6,10,2,0,0,3
Richmond,"Deledio, Brett",27,17,9,10,0,1,1,3
Richmond,"Edwards, Shane",25,13,7,12,0,2,0,1
Richmond,"Ellis, Brandon",33,17,8,16,0,0,0,1
Richmond,"Ellis, Corey",2,1,0,1,1,0,0,0
Richmond,"Griffiths, Ben",11,9,6,2,1,0,6,2
Richmond,"Grigg, Shaun",20,11,9,9,2,0,0,3
Richmond,"Grimes, Dylan",10,6,2,4,0,0,0,1
Richmond,"Houli, Bachar",17,12,6,5,0,0,0,0
Richmond,"Hunt, Taylor",12,7,5,5,0,0,0,2
Richmond,"Maric, Ivan",15,7,2,8,0,0,23,3
Richmond,"Martin, Dustin",25,22,7,3,1,0,0,2
Richmond,"McBean, Liam",9,6,3,3,0,1,0,1
Richmond,"McIntosh, Kamdyn",19,15,7,4,1,0,0,4
Richmond,"Menadue, Connor",12,7,4,5,0,1,0,3
Richmond,"Miles, Anthony",17,8,1,9,0,0,0,2
Richmond,"Morris, Steven",6,3,1,3,1,0,0,3
Richmond,"Rance, Alex",16,9,6,7,0,0,0,6
Richmond,"Riewoldt, Jack",12,11,8,1,1,2,0,2
Richmond,"Vlastuin, Nick",15,10,5,5,0,0,0,0
Richmond,"Batchelor, Jake",5,2,2,3,0,0,0,1
Richmond,"Chaplin, Troy",13,9,6,4,0,0,0,0
Richmond,"Cotchin, Trent",25,13,3,12,0,1,0,6
Richmond,"Deledio, Brett",15,11,4,4,2,0,0,3
Richmond,"Edwards, Shane",25,12,6,13,1,0,0,3
Richmond,"Ellis, Brandon",26,13,7,13,1,0,0,3
Richmond,"Ellis, Corey",9,5,4,4,1,0,0,3
Richmond,"Griffiths, Ben",9,8,3,1,2,2,4,0
Richmond,"Grigg, Shaun",12,7,3,5,1,0,0,9
Richmond,"Grimes, Dylan",12,10,4,2,0,0,0,2
Richmond,"Houli, Bachar",23,17,4,6,0,0,0,4
Richmond,"Hunt, Taylor",18,13,8,5,0,0,0,0
Richmond,"Maric, Ivan",15,7,4,8,0,0,20,4
Richmond,"Martin, Dustin",34,26,8,8,1,1,0,5
Richmond,"McIntosh, Kamdyn",16,8,2,8,0,0,0,3
Richmond,"Menadue, Connor",0,0,0,0,0,0,0,0
Richmond,"Miles, Anthony",24,11,4,13,0,0,0,6
Richmond,"Morris, Steven",11,4,2,7,1,0,0,0
Richmond,"Rance, Alex",14,5,4,9,0,0,0,2
Richmond,"Riewoldt, Jack",15,13,6,2,2,1,2,5
Richmond,"Vickery, Ty",11,8,6,3,3,0,4,2
Richmond,"Vlastuin, Nick",17,8,4,9,0,0,0,2
Richmond,"Batchelor, Jake",7,6,4,1,0,0,0,2
Richmond,"Chaplin, Troy",13,12,7,1,0,0,0,1
Richmond,"Cotchin, Trent",20,12,3,8,1,0,0,2
Richmond,"Deledio, Brett",24,9,8,15,1,1,0,5
Richmond,"Edwards, Shane",16,9,1,7,0,0,0,3
Richmond,"Ellis, Brandon",31,18,11,13,0,1,0,2
Richmond,"Ellis, Corey",6,2,1,4,0,0,0,0
Richmond,"Griffiths, Ben",8,5,4,3,1,0,6,2
Richmond,"Grigg, Shaun",19,9,3,10,0,0,0,5
Richmond,"Grimes, Dylan",16,7,3,9,0,0,0,3
Richmond,"Houli, Bachar",25,13,7,12,0,0,0,3
Richmond,"Hunt, Taylor",19,12,4,7,0,1,0,2
Richmond,"Maric, Ivan",13,5,3,8,0,1,15,3
Richmond,"Martin, Dustin",31,24,9,7,3,1,0,4
Richmond,"McIntosh, Kamdyn",4,4,0,0,0,0,0,2
Richmond,"Menadue, Connor",9,4,2,5,0,0,0,2
Richmond,"Miles, Anthony",24,12,5,12,1,0,0,5
Richmond,"Morris, Steven",12,2,2,10,0,0,0,5
Richmond,"Rance, Alex",12,6,3,6,0,0,0,4
Richmond,"Riewoldt, Jack",14,9,6,5,1,3,2,3
Richmond,"Vickery, Ty",8,7,3,1,2,0,2,1
Richmond,"Vlastuin, Nick",15,7,1,8,0,0,0,2
Richmond,"Batchelor, Jake",8,5,3,3,0,0,0,1
Richmond,"Chaplin, Troy",18,14,8,4,0,0,0,0
Richmond,"Cotchin, Trent",27,16,5,11,1,2,0,1
Richmond,"Deledio, Brett",23,15,6,8,1,0,0,1
Richmond,"Edwards, Shane",16,9,4,7,0,1,0,2
Richmond,"Ellis, Brandon",24,13,4,11,1,0,0,1
Richmond,"Gordon, Nathan",12,6,3,6,1,1,0,3
Richmond,"Griffiths, Ben",12,4,3,8,0,0,10,2
Richmond,"Grigg, Shaun",24,17,6,7,0,1,0,0
Richmond,"Grimes, Dylan",8,5,2,3,0,0,0,1
Richmond,"Houli, Bachar",14,9,5,5,0,0,0,2
Richmond,"Hunt, Taylor",12,5,3,7,0,0,0,3
Richmond,"Lambert, Kane",9,5,0,4,0,1,0,0
Richmond,"Maric, Ivan",12,10,2,2,1,0,17,4
Richmond,"Martin, Dustin",24,13,4,11,0,0,0,2
Richmond,"McIntosh, Kamdyn",5,4,1,1,0,0,0,2
Richmond,"Miles, Anthony",29,22,5,7,1,0,0,7
Richmond,"Newman, Chris",10,4,3,6,1,0,0,2
Richmond,"Rance, Alex",22,13,8,9,0,0,0,2
Richmond,"Riewoldt, Jack",13,10,9,3,6,1,0,3
Richmond,"Vickery, Ty",16,11,8,5,1,1,6,0
Richmond,"Vlastuin, Nick",20,9,5,11,0,0,0,1
Richmond,"Batchelor, Jake",9,6,3,3,0,0,0,1
Richmond,"Chaplin, Troy",17,8,8,9,0,0,0,3
Richmond,"Cotchin, Trent",33,20,6,13,2,1,1,7
Richmond,"Deledio, Brett",17,13,6,4,1,2,0,5
Richmond,"Edwards, Shane",24,13,3,11,2,1,0,3
Richmond,"Ellis, Brandon",22,15,5,7,0,2,0,4
Richmond,"Gordon, Nathan",16,11,6,5,1,1,0,1
Richmond,"Griffiths, Ben",6,5,4,1,0,2,2,1
Richmond,"Grigg, Shaun",23,10,7,13,0,0,3,5
Richmond,"Grimes, Dylan",5,3,2,2,0,0,0,0
Richmond,"Houli, Bachar",32,22,8,10,0,0,0,0
Richmond,"Hunt, Taylor",9,5,5,4,0,0,0,1
Richmond,"Lambert, Kane",8,6,4,2,0,1,0,3
Richmond,"Maric, Ivan",7,3,3,4,0,0,41,0
Richmond,"Martin, Dustin",28,22,4,6,1,1,0,10
Richmond,"McIntosh, Kamdyn",9,5,0,4,0,0,0,0
Richmond,"Miles, Anthony",22,8,3,14,0,1,0,3
Richmond,"Newman, Chris",12,7,1,5,0,0,0,3
Richmond,"Rance, Alex",14,7,4,7,0,0,0,5
Richmond,"Riewoldt, Jack",11,5,3,6,2,0,0,1
Richmond,"Vickery, Ty",7,5,2,2,1,2,8,2
Richmond,"Vlastuin, Nick",14,9,7,5,0,0,0,1
Richmond,"Batchelor, Jake",8,6,5,2,0,0,0,2
Richmond,"Chaplin, Troy",14,6,6,8,0,0,0,4
Richmond,"Cotchin, Trent",23,16,3,7,2,1,0,3
Richmond,"Deledio, Brett",21,14,7,7,1,3,1,3
Richmond,"Edwards, Shane",10,5,1,5,1,0,0,0
Richmond,"Ellis, Brandon",26,17,6,9,0,0,0,4
Richmond,"Gordon, Nathan",10,4,3,6,0,1,0,1
Richmond,"Grigg, Shaun",25,11,4,14,1,0,2,7
Richmond,"Grimes, Dylan",11,8,4,3,0,0,0,1
Richmond,"Hampson, Shaun",11,10,8,1,0,1,34,1
Richmond,"Houli, Bachar",15,10,4,5,0,0,0,1
Richmond,"Hunt, Taylor",18,12,8,6,0,0,0,2
Richmond,"Lambert, Kane",11,9,5,2,0,0,0,2
Richmond,"Martin, Dustin",21,15,3,6,1,1,0,1
Richmond,"McIntosh, Kamdyn",14,9,4,5,0,0,0,4
Richmond,"Miles, Anthony",19,9,2,10,0,0,0,7
Richmond,"Morris, Steven",3,0,0,3,0,0,0,3
Richmond,"Newman, Chris",6,4,2,2,0,0,0,3
Richmond,"Rance, Alex",22,14,8,8,0,0,1,1
Richmond,"Riewoldt, Jack",15,14,10,1,3,1,0,2
Richmond,"Vickery, Ty",13,8,9,5,1,1,9,1
Richmond,"Vlastuin, Nick",15,8,3,7,0,0,0,3
Richmond,"Batchelor, Jake",14,9,4,5,0,0,0,2
Richmond,"Chaplin, Troy",18,13,7,5,0,0,0,0
Richmond,"Cotchin, Trent",24,8,3,16,0,0,0,5
Richmond,"Deledio, Brett",28,14,8,14,3,0,0,2
Richmond,"Ellis, Brandon",22,14,8,8,0,0,0,3
Richmond,"Gordon, Nathan",4,1,1,3,0,0,0,0
Richmond,"Grigg, Shaun",20,10,4,10,1,1,1,9
Richmond,"Grimes, Dylan",16,12,7,4,0,0,0,2
Richmond,"Hampson, Shaun",12,6,4,6,0,2,24,1
Richmond,"Houli, Bachar",22,17,5,5,0,0,0,2
Richmond,"Hunt, Taylor",22,7,5,15,0,0,0,0
Richmond,"Lambert, Kane",19,7,3,12,1,0,0,2
Richmond,"Lennon, Ben",12,9,1,3,3,0,0,0
Richmond,"Maric, Ivan",10,4,2,6,1,0,17,0
Richmond,"Martin, Dustin",29,15,5,14,0,0,0,4
Richmond,"McDonough, Matt",8,6,3,2,0,1,0,3
Richmond,"McIntosh, Kamdyn",17,11,5,6,0,0,0,2
Richmond,"Miles, Anthony",26,11,6,15,0,2,0,1
Richmond,"Newman, Chris",15,7,1,8,1,0,0,4
Richmond,"Rance, Alex",15,8,5,7,0,0,0,1
Richmond,"Riewoldt, Jack",15,11,6,4,2,4,0,1
Richmond,"Vlastuin, Nick",17,11,7,6,1,0,0,3
Richmond,"Batchelor, Jake",8,7,3,1,0,0,0,1
Richmond,"Chaplin, Troy",23,14,8,9,0,0,0,4
Richmond,"Cotchin, Trent",24,12,2,12,0,1,0,5
Richmond,"Deledio, Brett",15,8,4,7,1,0,0,4
Richmond,"Ellis, Brandon",31,18,10,13,0,0,0,2
Richmond,"Griffiths, Ben",9,5,3,4,0,2,7,5
Richmond,"Grigg, Shaun",22,13,3,9,0,0,0,4
Richmond,"Grimes, Dylan",6,0,0,6,0,0,0,2
Richmond,"Hampson, Shaun",4,1,1,3,0,0,12,0
Richmond,"Houli, Bachar",20,14,10,6,0,0,0,5
Richmond,"Hunt, Taylor",18,12,8,6,0,0,0,0
Richmond,"Lambert, Kane",22,14,4,8,0,1,0,6
Richmond,"Lennon, Ben",13,12,5,1,2,0,0,2
Richmond,"Lloyd, Sam",11,7,4,4,1,2,0,1
Richmond,"Maric, Ivan",10,5,2,5,2,0,13,2
Richmond,"Martin, Dustin",22,16,6,6,0,4,0,5
Richmond,"McIntosh, Kamdyn",15,13,7,2,1,2,0,3
Richmond,"Miles, Anthony",21,10,6,11,0,0,0,3
Richmond,"Newman, Chris",12,9,6,3,2,1,0,4
Richmond,"Rance, Alex",20,10,8,10,0,0,0,3
Richmond,"Riewoldt, Jack",11,8,3,3,1,2,1,3
Richmond,"Vlastuin, Nick",10,8,4,2,0,0,1,3
Richmond,"Batchelor, Jake",15,11,9,4,0,0,0,2
Richmond,"Chaplin, Troy",20,13,8,7,0,0,0,0
Richmond,"Conca, Reece",16,6,2,10,0,1,1,5
Richmond,"Cotchin, Trent",24,16,4,8,0,0,0,6
Richmond,"Deledio, Brett",18,10,2,8,4,0,2,6
Richmond,"Ellis, Brandon",27,16,6,11,0,0,0,5
Richmond,"Grigg, Shaun",22,9,4,13,0,0,0,5
Richmond,"Grimes, Dylan",10,5,2,5,0,0,0,2
Richmond,"Houli, Bachar",23,16,10,7,1,0,0,1
Richmond,"Hunt, Taylor",14,8,4,6,0,0,0,0
Richmond,"Lambert, Kane",17,11,5,6,1,1,0,3
Richmond,"Lennon, Ben",8,7,6,1,0,0,0,1
Richmond,"Lloyd, Sam",3,3,1,0,1,1,0,0
Richmond,"Maric, Ivan",14,10,7,4,0,0,31,2
Richmond,"Martin, Dustin",27,15,4,12,0,0,1,2
Richmond,"McIntosh, Kamdyn",18,15,5,3,1,0,0,1
Richmond,"Miles, Anthony",30,16,3,14,0,0,0,3
Richmond,"Newman, Chris",13,10,4,3,0,0,0,4
Richmond,"Rance, Alex",18,9,6,9,0,0,1,2
Richmond,"Riewoldt, Jack",11,9,7,2,1,2,0,0
Richmond,"Vickery, Ty",10,4,5,6,1,1,5,1
Richmond,"Vlastuin, Nick",13,8,6,5,0,0,0,1
Richmond,"Batchelor, Jake",8,7,3,1,0,0,0,4
Richmond,"Chaplin, Troy",12,9,3,3,0,0,0,1
Richmond,"Conca, Reece",18,10,3,8,0,0,0,2
Richmond,"Cotchin, Trent",18,11,2,7,0,0,0,4
Richmond,"Ellis, Brandon",17,11,4,6,1,0,0,2
Richmond,"Grigg, Shaun",23,13,6,10,1,1,2,3
Richmond,"Grimes, Dylan",6,3,1,3,0,0,0,1
Richmond,"Hampson, Shaun",1,1,0,0,0,0,20,1
Richmond,"Houli, Bachar",23,19,6,4,0,0,0,3
Richmond,"Hunt, Taylor",22,16,7,6,0,0,0,0
Richmond,"Lambert, Kane",19,8,2,11,0,1,0,4
Richmond,"Lennon, Ben",14,9,8,5,0,0,0,0
Richmond,"Lloyd, Sam",8,4,2,4,0,0,0,4
Richmond,"Maric, Ivan",9,5,4,4,1,0,19,2
Richmond,"Martin, Dustin",21,14,4,7,3,0,0,7
Richmond,"McIntosh, Kamdyn",15,10,3,5,0,1,0,3
Richmond,"Miles, Anthony",21,5,1,16,0,0,0,1
Richmond,"Newman, Chris",12,8,5,4,0,0,0,2
Richmond,"Rance, Alex",13,6,6,7,0,0,0,1
Richmond,"Riewoldt, Jack",7,2,0,5,1,0,0,4
Richmond,"Vickery, Ty",7,5,4,2,1,0,1,4
Richmond,"Vlastuin, Nick",14,10,5,4,0,0,0,3
Richmond,"Batchelor, Jake",21,11,7,10,0,0,0,2
Richmond,"Chaplin, Troy",17,11,10,6,0,0,0,2
Richmond,"Cotchin, Trent",28,19,6,9,0,0,0,1
Richmond,"Deledio, Brett",21,14,5,7,3,1,0,2
Richmond,"Ellis, Brandon",29,18,8,11,1,1,0,0
Richmond,"Grigg, Shaun",24,16,4,8,1,1,2,2
Richmond,"Houli, Bachar",29,22,10,7,0,0,0,0
Richmond,"Hunt, Taylor",19,7,4,12,0,0,0,1
Richmond,"Lambert, Kane",27,13,4,14,2,0,0,1
Richmond,"Lennon, Ben",22,16,9,6,0,1,0,1
Richmond,"Lloyd, Sam",16,8,1,8,3,1,0,1
Richmond,"Maric, Ivan",10,3,2,7,1,0,36,2
Richmond,"Martin, Dustin",29,20,7,9,3,1,0,6
Richmond,"McIntosh, Kamdyn",5,4,3,1,0,0,0,1
Richmond,"Miles, Anthony",19,9,6,10,0,0,0,1
Richmond,"Morris, Steven",18,11,5,7,0,0,0,0
Richmond,"Newman, Chris",14,9,5,5,1,0,0,1
Richmond,"Rance, Alex",24,11,9,13,0,0,0,1
Richmond,"Riewoldt, Jack",15,10,6,5,2,0,1,1
Richmond,"Thomas, Matt",19,4,3,15,1,0,0,4
Richmond,"Vickery, Ty",12,7,7,5,4,0,15,0
Richmond,"Vlastuin, Nick",21,13,10,8,0,0,0,0
Richmond,"Batchelor, Jake",21,17,12,4,0,0,0,0
Richmond,"Chaplin, Troy",14,12,11,2,0,0,0,1
Richmond,"Cotchin, Trent",13,6,1,7,0,1,0,5
Richmond,"Deledio, Brett",20,10,8,10,3,0,0,4
Richmond,"Edwards, Shane",17,6,1,11,0,0,0,1
Richmond,"Ellis, Brandon",31,20,10,11,1,1,0,5
Richmond,"Grigg, Shaun",24,17,8,7,1,1,7,2
Richmond,"Houli, Bachar",29,15,6,14,2,0,0,5
Richmond,"Hunt, Taylor",25,17,13,8,0,0,0,3
Richmond,"Lambert, Kane",16,10,5,6,1,1,0,2
Richmond,"Lennon, Ben",5,4,2,1,1,0,0,0
Richmond,"Lloyd, Sam",14,11,4,3,3,1,0,4
Richmond,"Maric, Ivan",16,9,4,7,1,0,25,6
Richmond,"Martin, Dustin",32,22,11,10,1,0,0,1
Richmond,"McIntosh, Kamdyn",19,12,7,7,0,0,0,5
Richmond,"Miles, Anthony",25,14,7,11,0,0,0,3
Richmond,"Morris, Steven",14,5,2,9,0,0,0,2
Richmond,"Newman, Chris",21,15,9,6,1,2,0,2
Richmond,"Rance, Alex",22,13,13,9,0,0,0,3
Richmond,"Riewoldt, Jack",12,7,5,5,2,0,0,0
Richmond,"Vickery, Ty",21,15,10,6,6,0,5,2
Richmond,"Vlastuin, Nick",16,7,3,9,0,0,0,1
Richmond,"Batchelor, Jake",14,7,4,7,0,0,0,2
Richmond,"Chaplin, Troy",13,7,5,6,0,0,0,2
Richmond,"Deledio, Brett",22,15,2,7,2,2,0,4
Richmond,"Edwards, Shane",21,12,1,9,1,2,0,9
Richmond,"Ellis, Brandon",24,14,5,10,0,0,0,4
Richmond,"Grigg, Shaun",21,13,3,8,1,1,0,4
Richmond,"Grimes, Dylan",12,9,4,3,0,0,0,0
Richmond,"Houli, Bachar",22,9,4,13,0,0,0,1
Richmond,"Hunt, Taylor",21,9,3,12,0,0,0,4
Richmond,"Lambert, Kane",20,13,2,7,0,0,0,4
Richmond,"Lennon, Ben",16,13,9,3,0,1,0,1
Richmond,"Lloyd, Sam",6,3,2,3,0,1,0,0
Richmond,"Maric, Ivan",14,7,2,7,1,0,26,3
Richmond,"Martin, Dustin",18,13,3,5,1,2,0,0
Richmond,"McIntosh, Kamdyn",27,21,7,6,0,0,0,2
Richmond,"Miles, Anthony",23,18,8,5,1,0,0,5
Richmond,"Newman, Chris",11,8,3,3,0,1,0,6
Richmond,"Rance, Alex",22,18,4,4,0,0,0,4
Richmond,"Riewoldt, Jack",13,11,7,2,0,2,0,3
Richmond,"Thomas, Matt",20,7,5,13,1,0,0,2
Richmond,"Vickery, Ty",8,6,3,2,2,0,4,4
Richmond,"Vlastuin, Nick",17,11,4,6,0,0,0,5
Richmond,"Batchelor, Jake",17,7,6,10,0,0,0,2
Richmond,"Chaplin, Troy",15,9,7,6,0,0,0,4
Richmond,"Cotchin, Trent",30,17,2,13,0,1,0,3
Richmond,"Deledio, Brett",26,15,10,11,1,1,0,1
Richmond,"Edwards, Shane",15,8,4,7,1,0,0,0
Richmond,"Ellis, Brandon",26,16,5,10,1,0,0,3
Richmond,"Grigg, Shaun",22,10,5,12,0,1,1,2
Richmond,"Grimes, Dylan",15,7,4,8,0,0,0,3
Richmond,"Houli, Bachar",18,12,4,6,1,0,0,4
Richmond,"Hunt, Taylor",14,11,6,3,0,0,0,1
Richmond,"Lambert, Kane",19,10,7,9,2,0,0,2
Richmond,"Lennon, Ben",12,6,3,6,0,1,0,1
Richmond,"Lloyd, Sam",6,4,0,2,0,0,0,1
Richmond,"Maric, Ivan",15,10,2,5,1,0,32,0
Richmond,"Martin, Dustin",21,16,4,5,3,0,0,6
Richmond,"McIntosh, Kamdyn",19,10,5,9,0,0,0,4
Richmond,"Miles, Anthony",24,9,2,15,0,0,0,4
Richmond,"Newman, Chris",9,4,0,5,1,0,0,3
Richmond,"Rance, Alex",15,8,4,7,0,0,0,2
Richmond,"Riewoldt, Jack",10,8,6,2,2,2,0,2
Richmond,"Vickery, Ty",9,6,3,3,3,1,10,2
Richmond,"Vlastuin, Nick",17,11,10,6,0,0,0,5
Richmond,"Batchelor, Jake",13,8,6,5,0,0,1,4
Richmond,"Chaplin, Troy",8,5,7,3,0,0,0,3
Richmond,"Conca, Reece",8,6,2,2,1,0,0,1
Richmond,"Cotchin, Trent",9,3,1,6,0,0,0,3
Richmond,"Deledio, Brett",17,10,2,7,1,0,1,6
Richmond,"Edwards, Shane",8,2,3,6,1,0,0,3
Richmond,"Ellis, Brandon",10,5,1,5,0,0,0,3
Richmond,"Griffiths, Ben",4,3,3,1,0,2,4,1
Richmond,"Grigg, Shaun",17,11,4,6,0,0,2,4
Richmond,"Grimes, Dylan",12,6,4,6,0,0,0,3
Richmond,"Houli, Bachar",17,14,6,3,0,0,0,1
Richmond,"Hunt, Taylor",16,9,5,7,0,0,0,1
Richmond,"Lambert, Kane",10,5,1,5,1,0,0,2
Richmond,"Maric, Ivan",9,3,1,6,0,0,19,1
Richmond,"Martin, Dustin",21,17,4,4,0,0,0,0
Richmond,"McIntosh, Kamdyn",15,10,4,5,1,0,0,4
Richmond,"Miles, Anthony",22,11,6,11,1,0,0,1
Richmond,"Newman, Chris",12,10,4,2,2,1,0,0
Richmond,"Rance, Alex",18,10,5,8,0,0,0,3
Richmond,"Riewoldt, Jack",14,10,7,4,4,0,3,4
Richmond,"Vickery, Ty",11,11,4,0,2,1,1,1
Richmond,"Vlastuin, Nick",12,8,3,4,0,0,0,2
St Kilda,"Armitage, David",25,15,7,10,1,2,1,1
St Kilda,"Bruce, Josh",15,10,5,5,2,2,3,4
St Kilda,"Delaney, Luke",4,3,4,1,0,0,0,0
St Kilda,"Dempster, Sean",17,12,7,5,0,0,0,1
St Kilda,"Dunstan, Luke",13,7,1,6,1,0,2,0
St Kilda,"Fisher, Sam",22,13,3,9,0,0,1,0
St Kilda,"Geary, Jarryn",24,12,9,12,0,0,0,2
St Kilda,"Longer, Billy",9,3,4,6,0,0,20,0
St Kilda,"Lonie, Jack",9,7,2,2,0,0,0,2
St Kilda,"Membrey, Tim",9,7,4,2,2,0,0,1
St Kilda,"Montagna, Leigh",24,16,0,8,0,0,1,9
St Kilda,"Newnes, Jack",14,7,3,7,0,1,0,3
St Kilda,"Riewoldt, Nick",17,13,10,4,1,1,1,1
St Kilda,"Roberton, Dylan",13,8,4,5,0,0,0,5
St Kilda,"Saad, Ahmed",4,1,0,3,0,0,0,1
St Kilda,"Savage, Shane",21,14,5,7,2,0,0,1
St Kilda,"Schneider, Adam",22,11,7,11,2,0,0,2
St Kilda,"Shenton, Cameron",15,10,6,5,0,0,0,2
St Kilda,"Sinclair, Jack",8,4,4,4,0,1,0,0
St Kilda,"Steven, Jack",27,19,6,8,0,0,0,2
St Kilda,"Templeton, Eli",6,4,3,2,0,0,0,1
St Kilda,"Weller, Maverick",14,3,2,11,0,0,0,11
St Kilda,"Armitage, David",36,13,5,23,0,0,2,2
St Kilda,"Billings, Jack",18,8,4,10,0,0,0,1
St Kilda,"Bruce, Josh",14,10,8,4,6,1,5,2
St Kilda,"Curren, Tom",13,8,1,5,1,0,0,2
St Kilda,"Delaney, Luke",9,4,4,5,0,0,0,4
St Kilda,"Dempster, Sean",17,13,7,4,0,0,0,1
St Kilda,"Dunstan, Luke",22,13,3,9,1,0,0,8
St Kilda,"Fisher, Sam",24,17,8,7,0,0,0,0
St Kilda,"Geary, Jarryn",15,10,5,5,0,0,0,5
St Kilda,"Longer, Billy",9,2,0,7,0,0,39,0
St Kilda,"Lonie, Jack",15,12,6,3,1,1,0,2
St Kilda,"Membrey, Tim",11,4,3,7,0,3,0,0
St Kilda,"Newnes, Jack",23,16,12,7,0,0,0,3
St Kilda,"Riewoldt, Nick",17,15,12,2,2,1,4,2
St Kilda,"Roberton, Dylan",15,10,3,5,1,0,1,6
St Kilda,"Saad, Ahmed",8,5,3,3,2,1,0,3
St Kilda,"Savage, Shane",26,20,2,6,0,0,0,2
St Kilda,"Shenton, Cameron",20,12,3,8,0,0,0,4
St Kilda,"Sinclair, Jack",19,7,1,12,2,0,0,1
St Kilda,"Steven, Jack",22,13,5,9,0,0,0,10
St Kilda,"Weller, Maverick",19,5,4,14,0,0,2,6
St Kilda,"Wright, Nathan",12,8,6,4,0,0,0,2
St Kilda,"Armitage, David",33,20,4,13,2,0,1,9
St Kilda,"Billings, Jack",19,12,5,7,0,0,0,3
St Kilda,"Bruce, Josh",3,2,2,1,2,0,3,2
St Kilda,"Delaney, Luke",9,2,2,7,0,0,0,2
St Kilda,"Dempster, Sean",18,9,2,9,0,0,0,1
St Kilda,"Dunstan, Luke",22,12,5,10,0,0,0,4
St Kilda,"Fisher, Sam",18,13,8,5,0,0,1,1
St Kilda,"Geary, Jarryn",12,9,2,3,1,0,0,3
St Kilda,"Longer, Billy",9,5,2,4,0,0,32,3
St Kilda,"Lonie, Jack",6,2,2,4,0,0,0,4
St Kilda,"McCartin, Paddy",9,7,3,2,0,0,0,1
St Kilda,"Membrey, Tim",11,6,4,5,1,0,0,2
St Kilda,"Newnes, Jack",26,14,8,12,0,0,0,1
St Kilda,"Roberton, Dylan",28,17,7,11,1,0,0,2
St Kilda,"Saad, Ahmed",9,6,3,3,1,0,0,4
St Kilda,"Savage, Shane",20,15,3,5,0,0,0,2
St Kilda,"Schneider, Adam",28,11,8,17,0,2,0,7
St Kilda,"Shenton, Cameron",13,8,5,5,0,0,0,0
St Kilda,"Sinclair, Jack",11,5,2,6,1,1,0,4
St Kilda,"Steven, Jack",32,19,7,13,1,3,0,7
St Kilda,"Weller, Maverick",17,6,1,11,0,0,3,7
St Kilda,"Wright, Nathan",7,4,0,3,0,0,0,1
St Kilda,"Armitage, David",27,15,5,12,1,1,0,7
St Kilda,"Billings, Jack",22,10,3,12,1,0,0,5
St Kilda,"Bruce, Josh",13,7,3,6,2,0,1,4
St Kilda,"Curren, Tom",4,2,2,2,0,0,0,5
St Kilda,"Delaney, Luke",12,4,4,8,0,0,0,3
St Kilda,"Dempster, Sean",12,7,5,5,0,0,0,0
St Kilda,"Dunstan, Luke",15,9,3,6,1,0,1,9
St Kilda,"Fisher, Sam",14,8,4,6,0,0,0,1
St Kilda,"Geary, Jarryn",25,18,5,7,0,0,0,4
St Kilda,"Longer, Billy",20,13,4,7,0,0,51,5
St Kilda,"Lonie, Jack",17,10,0,7,2,1,0,5
St Kilda,"McCartin, Paddy",5,3,3,2,0,1,0,1
St Kilda,"Membrey, Tim",8,2,1,6,0,0,0,3
St Kilda,"Newnes, Jack",13,7,3,6,0,0,0,6
St Kilda,"Roberton, Dylan",13,9,0,4,0,0,1,6
St Kilda,"Saad, Ahmed",4,2,1,2,0,0,0,0
St Kilda,"Savage, Shane",15,9,3,6,0,0,0,4
St Kilda,"Schneider, Adam",18,10,6,8,0,1,0,9
St Kilda,"Shenton, Cameron",11,7,2,4,2,0,0,3
St Kilda,"Sinclair, Jack",8,3,0,5,2,0,0,1
St Kilda,"Steven, Jack",16,10,0,6,1,2,0,11
St Kilda,"Wright, Nathan",16,14,2,2,0,1,0,4
St Kilda,"Acres, Blake",5,3,1,2,0,0,0,2
St Kilda,"Armitage, David",35,13,4,22,0,0,2,8
St Kilda,"Billings, Jack",20,15,6,5,2,1,0,2
St Kilda,"Bruce, Josh",17,13,6,4,5,1,0,3
St Kilda,"Delaney, Luke",11,6,5,5,0,0,0,2
St Kilda,"Dempster, Sean",27,13,7,14,0,0,0,8
St Kilda,"Dunstan, Luke",22,12,6,10,1,0,0,4
St Kilda,"Fisher, Sam",20,13,5,7,0,0,4,4
St Kilda,"Geary, Jarryn",17,10,2,7,0,0,0,2
St Kilda,"Hickey, Tom",19,8,4,11,0,1,6,2
St Kilda,"Longer, Billy",6,1,2,5,0,0,34,1
St Kilda,"Lonie, Jack",20,14,4,6,2,3,0,3
St Kilda,"McKenzie, Daniel",13,3,4,10,0,0,0,4
St Kilda,"Membrey, Tim",12,6,3,6,0,0,0,1
St Kilda,"Newnes, Jack",21,11,7,10,0,0,0,2
St Kilda,"Roberton, Dylan",24,15,6,9,0,1,1,0
St Kilda,"Savage, Shane",11,4,1,7,0,0,0,1
St Kilda,"Schneider, Adam",21,10,4,11,0,2,0,2
St Kilda,"Sinclair, Jack",14,2,1,12,0,0,0,4
St Kilda,"Steven, Jack",31,17,5,14,1,1,0,6
St Kilda,"Webster, Jimmy",16,8,3,8,0,0,0,3
St Kilda,"Weller, Maverick",17,7,1,10,0,1,3,4
St Kilda,"Armitage, David",45,21,5,24,1,0,0,5
St Kilda,"Billings, Jack",22,15,7,7,4,2,0,4
St Kilda,"Bruce, Josh",10,6,3,4,1,3,0,1
St Kilda,"Delaney, Luke",12,5,5,7,0,0,0,2
St Kilda,"Dempster, Sean",20,14,7,6,0,0,0,0
St Kilda,"Dunstan, Luke",19,12,1,7,1,0,0,4
St Kilda,"Fisher, Sam",26,19,13,7,0,0,1,4
St Kilda,"Geary, Jarryn",19,10,6,9,0,0,0,1
St Kilda,"Hickey, Tom",12,9,6,3,2,0,5,2
St Kilda,"Longer, Billy",6,2,2,4,0,0,37,2
St Kilda,"Lonie, Jack",11,8,3,3,1,0,0,2
St Kilda,"McKenzie, Daniel",19,8,4,11,0,0,0,4
St Kilda,"Montagna, Leigh",27,10,4,17,0,0,0,2
St Kilda,"Newnes, Jack",17,6,4,11,0,0,0,6
St Kilda,"Riewoldt, Nick",21,11,9,10,1,0,4,1
St Kilda,"Roberton, Dylan",17,9,6,8,0,0,1,2
St Kilda,"Savage, Shane",5,0,0,5,0,0,0,2
St Kilda,"Schneider, Adam",22,10,8,12,1,0,0,1
St Kilda,"Sinclair, Jack",13,8,4,5,2,1,0,1
St Kilda,"Steven, Jack",32,25,11,7,0,2,0,5
St Kilda,"Webster, Jimmy",15,11,3,4,0,0,0,1
St Kilda,"Weller, Maverick",11,4,3,7,0,0,0,7
St Kilda,"Armitage, David",31,13,5,18,0,1,0,3
St Kilda,"Billings, Jack",23,7,2,16,0,2,0,2
St Kilda,"Bruce, Josh",15,13,12,2,5,1,0,4
St Kilda,"Delaney, Luke",10,6,6,4,0,0,0,1
St Kilda,"Dempster, Sean",21,15,8,6,0,0,0,2
St Kilda,"Dunstan, Luke",13,7,2,6,0,2,0,3
St Kilda,"Fisher, Sam",17,10,7,7,0,0,2,5
St Kilda,"Hickey, Tom",13,7,3,6,1,2,7,6
St Kilda,"Longer, Billy",9,2,3,7,0,0,25,1
St Kilda,"Lonie, Jack",0,0,0,0,0,0,0,1
St Kilda,"McKenzie, Daniel",9,4,3,5,0,0,0,1
St Kilda,"Newnes, Jack",23,11,7,12,1,2,0,5
St Kilda,"Riewoldt, Nick",5,2,3,3,0,0,1,1
St Kilda,"Roberton, Dylan",21,11,2,10,0,0,0,1
St Kilda,"Savage, Shane",20,9,4,11,1,0,0,3
St Kilda,"Schneider, Adam",16,10,5,6,0,1,0,3
St Kilda,"Shenton, Cameron",17,13,6,4,1,0,0,0
St Kilda,"Sinclair, Jack",15,10,8,5,0,1,0,2
St Kilda,"Steven, Jack",27,18,1,9,1,0,0,5
St Kilda,"Templeton, Eli",13,7,5,6,0,0,0,9
St Kilda,"Webster, Jimmy",19,12,4,7,0,0,0,2
St Kilda,"Weller, Maverick",19,11,4,8,0,1,0,2
St Kilda,"Acres, Blake",10,5,2,5,0,0,3,2
St Kilda,"Armitage, David",32,10,5,22,0,0,0,4
St Kilda,"Billings, Jack",23,12,3,11,0,1,0,4
St Kilda,"Bruce, Josh",7,6,4,1,2,0,0,4
St Kilda,"Dempster, Sean",13,10,6,3,0,0,0,5
St Kilda,"Dunstan, Luke",17,8,2,9,0,0,0,3
St Kilda,"Fisher, Sam",6,5,2,1,0,0,0,1
St Kilda,"Hickey, Tom",5,1,1,4,0,0,5,5
St Kilda,"Longer, Billy",4,3,0,1,0,0,28,5
St Kilda,"McKenzie, Daniel",14,6,2,8,0,0,0,4
St Kilda,"Membrey, Tim",8,4,4,4,1,0,0,5
St Kilda,"Montagna, Leigh",33,20,6,13,0,2,0,4
St Kilda,"Newnes, Jack",20,12,5,8,1,0,0,1
St Kilda,"Roberton, Dylan",20,12,5,8,1,0,0,0
St Kilda,"Savage, Shane",20,10,7,10,1,0,0,5
St Kilda,"Schneider, Adam",25,12,6,13,1,0,0,7
St Kilda,"Shenton, Cameron",13,4,6,9,0,0,0,1
St Kilda,"Sinclair, Jack",15,5,3,10,2,1,0,3
St Kilda,"Steven, Jack",37,17,9,20,0,0,0,12
St Kilda,"Templeton, Eli",11,6,5,5,1,0,0,3
St Kilda,"Webster, Jimmy",13,8,5,5,0,0,0,3
St Kilda,"Weller, Maverick",22,10,3,12,2,0,0,5
St Kilda,"Acres, Blake",20,11,3,9,0,1,0,4
St Kilda,"Armitage, David",31,16,3,15,2,0,0,5
St Kilda,"Billings, Jack",15,8,3,7,0,0,0,3
St Kilda,"Bruce, Josh",10,7,6,3,1,3,0,2
St Kilda,"Delaney, Luke",7,1,5,6,0,0,1,1
St Kilda,"Dempster, Sean",19,15,6,4,0,0,0,1
St Kilda,"Dunstan, Luke",16,9,2,7,2,1,0,6
St Kilda,"Geary, Jarryn",13,10,4,3,0,0,0,0
St Kilda,"Hickey, Tom",9,2,3,7,0,0,7,1
St Kilda,"Longer, Billy",7,3,2,4,0,0,30,4
St Kilda,"Lonie, Jack",16,11,4,5,1,2,0,2
St Kilda,"McKenzie, Daniel",10,2,1,8,0,0,0,4
St Kilda,"Montagna, Leigh",28,18,7,10,0,1,0,5
St Kilda,"Newnes, Jack",24,18,6,6,0,1,0,1
St Kilda,"Riewoldt, Nick",15,12,10,3,4,1,0,1
St Kilda,"Roberton, Dylan",19,14,6,5,1,0,0,3
St Kilda,"Schneider, Adam",22,11,1,11,2,0,0,1
St Kilda,"Shenton, Cameron",16,11,4,5,0,0,0,3
St Kilda,"Sinclair, Jack",6,4,1,2,0,0,0,1
St Kilda,"Steven, Jack",26,17,4,9,1,0,0,3
St Kilda,"Webster, Jimmy",15,6,5,9,0,0,0,1
St Kilda,"Weller, Maverick",19,9,2,10,2,0,2,4
St Kilda,"Acres, Blake",14,9,4,5,0,0,3,2
St Kilda,"Armitage, David",24,12,7,12,0,1,0,9
St Kilda,"Billings, Jack",21,13,7,8,0,0,0,4
St Kilda,"Bruce, Josh",15,8,8,7,2,2,0,1
St Kilda,"Delaney, Luke",11,5,5,6,0,0,0,0
St Kilda,"Dempster, Sean",12,8,8,4,0,0,0,2
St Kilda,"Geary, Jarryn",25,11,5,14,0,0,0,0
St Kilda,"Hickey, Tom",5,0,1,5,0,0,2,0
St Kilda,"Longer, Billy",8,3,2,5,1,0,26,2
St Kilda,"Lonie, Jack",18,6,3,12,0,0,0,2
St Kilda,"Montagna, Leigh",28,12,5,16,1,0,0,7
St Kilda,"Newnes, Jack",13,9,3,4,0,0,0,3
St Kilda,"Ray, Farren",24,12,5,12,0,0,1,4
St Kilda,"Riewoldt, Nick",22,17,12,5,1,1,0,1
St Kilda,"Roberton, Dylan",28,20,12,8,0,0,0,1
St Kilda,"Ross, Sebastian",19,12,5,7,0,1,0,0
St Kilda,"Savage, Shane",11,4,2,7,2,0,0,0
St Kilda,"Schneider, Adam",20,12,7,8,0,0,0,2
St Kilda,"Shenton, Cameron",14,7,6,7,1,0,0,2
St Kilda,"Sinclair, Jack",12,6,4,6,2,0,0,2
St Kilda,"Steven, Jack",38,23,8,15,0,1,0,4
St Kilda,"Webster, Jimmy",27,15,9,12,0,0,0,2
St Kilda,"Acres, Blake",9,6,3,3,0,0,2,3
St Kilda,"Armitage, David",20,6,0,14,0,1,0,8
St Kilda,"Bruce, Josh",9,6,5,3,1,1,2,2
St Kilda,"Delaney, Luke",5,2,3,3,0,0,0,2
St Kilda,"Dempster, Sean",13,10,10,3,0,0,0,1
St Kilda,"Dunstan, Luke",14,10,1,4,0,2,0,0
St Kilda,"Geary, Jarryn",17,10,3,7,0,0,0,4
St Kilda,"Gilbert, Sam",13,9,7,4,0,0,0,2
St Kilda,"Longer, Billy",8,3,2,5,0,0,35,6
St Kilda,"Lonie, Jack",9,6,3,3,2,0,0,9
St Kilda,"Membrey, Tim",12,8,5,4,1,2,0,3
St Kilda,"Minchington, Darren",9,4,3,5,1,1,0,7
St Kilda,"Montagna, Leigh",28,21,5,7,1,1,0,10
St Kilda,"Newnes, Jack",18,11,4,7,0,0,2,9
St Kilda,"Ray, Farren",18,9,4,9,0,0,1,3
St Kilda,"Riewoldt, Nick",17,14,10,3,4,2,3,4
St Kilda,"Ross, Sebastian",14,8,1,6,1,0,2,7
St Kilda,"Savage, Shane",15,11,4,4,0,0,0,4
St Kilda,"Shenton, Cameron",11,7,2,4,0,0,0,2
St Kilda,"Steven, Jack",21,12,4,9,1,0,0,5
St Kilda,"Webster, Jimmy",14,9,6,5,0,0,0,3
St Kilda,"Weller, Maverick",13,10,2,3,0,0,0,5
St Kilda,"Armitage, David",25,16,4,9,0,1,0,7
St Kilda,"Bruce, Josh",13,11,7,2,3,0,1,2
St Kilda,"Delaney, Luke",5,2,2,3,0,0,0,2
St Kilda,"Dempster, Sean",17,9,7,8,0,0,0,2
St Kilda,"Dunstan, Luke",18,11,2,7,0,0,0,2
St Kilda,"Geary, Jarryn",19,11,4,8,0,0,0,4
St Kilda,"Gilbert, Sam",17,9,8,8,0,0,0,1
St Kilda,"Longer, Billy",11,6,2,5,0,0,30,3
St Kilda,"Lonie, Jack",13,8,4,5,0,2,0,4
St Kilda,"Membrey, Tim",17,14,5,3,0,1,0,1
St Kilda,"Minchington, Darren",9,3,1,6,1,0,0,0
St Kilda,"Montagna, Leigh",35,24,5,11,0,1,0,3
St Kilda,"Newnes, Jack",23,16,8,7,0,0,2,7
St Kilda,"Ray, Farren",24,15,4,9,0,1,0,3
St Kilda,"Riewoldt, Nick",21,11,10,10,2,0,1,0
St Kilda,"Roberton, Dylan",22,17,8,5,0,0,0,3
St Kilda,"Ross, Sebastian",11,7,0,4,0,0,0,2
St Kilda,"Savage, Shane",16,9,3,7,0,0,0,1
St Kilda,"Schneider, Adam",16,11,4,5,0,2,0,7
St Kilda,"Steven, Jack",24,13,6,11,0,1,0,8
St Kilda,"Webster, Jimmy",13,5,3,8,0,0,0,4
St Kilda,"Weller, Maverick",14,7,5,7,1,0,1,2
St Kilda,"Armitage, David",38,20,7,18,2,0,0,3
St Kilda,"Bruce, Josh",14,9,9,5,5,2,2,1
St Kilda,"Dempster, Sean",28,15,9,13,0,0,0,0
St Kilda,"Dunstan, Luke",6,2,2,4,1,0,0,2
St Kilda,"Fisher, Sam",12,5,3,7,0,0,1,1
St Kilda,"Geary, Jarryn",25,10,6,15,0,0,0,1
St Kilda,"Gilbert, Sam",12,9,6,3,0,0,0,3
St Kilda,"Longer, Billy",18,6,8,12,0,0,35,4
St Kilda,"Lonie, Jack",18,10,3,8,1,3,0,2
St Kilda,"Membrey, Tim",16,8,10,8,2,1,0,3
St Kilda,"Montagna, Leigh",31,16,6,15,2,0,0,3
St Kilda,"Newnes, Jack",23,15,11,8,1,0,1,1
St Kilda,"Ray, Farren",23,13,6,10,0,0,0,4
St Kilda,"Riewoldt, Nick",21,16,12,5,4,0,1,1
St Kilda,"Roberton, Dylan",31,20,8,11,0,0,0,3
St Kilda,"Ross, Sebastian",25,14,3,11,0,0,0,3
St Kilda,"Savage, Shane",18,12,6,6,1,0,0,0
St Kilda,"Schneider, Adam",19,11,6,8,1,1,0,2
St Kilda,"Sinclair, Jack",10,4,2,6,2,0,0,6
St Kilda,"Steven, Jack",29,16,8,13,0,0,0,11
St Kilda,"Webster, Jimmy",12,6,4,6,1,0,0,1
St Kilda,"Weller, Maverick",16,12,7,4,2,1,0,6
St Kilda,"Armitage, David",24,10,2,14,0,1,0,7
St Kilda,"Bruce, Josh",12,7,3,5,2,0,1,2
St Kilda,"Dempster, Sean",14,11,5,3,0,0,0,0
St Kilda,"Dunstan, Luke",20,10,4,10,0,0,0,5
St Kilda,"Fisher, Sam",15,9,7,6,0,0,1,4
St Kilda,"Geary, Jarryn",23,9,6,14,0,0,0,6
St Kilda,"Gilbert, Sam",13,8,3,5,0,0,1,2
St Kilda,"Longer, Billy",12,4,1,8,0,0,47,2
St Kilda,"Lonie, Jack",12,6,2,6,0,1,0,2
St Kilda,"Membrey, Tim",8,3,3,5,0,0,0,0
St Kilda,"Montagna, Leigh",28,18,6,10,0,2,0,7
St Kilda,"Newnes, Jack",23,12,10,11,0,1,2,6
St Kilda,"Ray, Farren",7,4,2,3,0,1,2,1
St Kilda,"Riewoldt, Nick",14,10,6,4,1,0,1,3
St Kilda,"Roberton, Dylan",24,15,7,9,0,0,0,6
St Kilda,"Ross, Sebastian",7,2,1,5,0,0,0,3
St Kilda,"Savage, Shane",23,18,7,5,0,0,0,0
St Kilda,"Schneider, Adam",14,5,1,9,0,1,0,5
St Kilda,"Sinclair, Jack",9,4,1,5,1,0,0,5
St Kilda,"Steven, Jack",29,13,1,16,1,1,0,14
St Kilda,"Webster, Jimmy",20,12,4,8,0,1,0,4
St Kilda,"Weller, Maverick",22,10,2,12,1,0,0,8
St Kilda,"Armitage, David",27,14,5,13,1,0,0,6
St Kilda,"Bruce, Josh",10,5,1,5,1,0,3,4
St Kilda,"Dempster, Sean",13,10,6,3,0,0,0,2
St Kilda,"Dunstan, Luke",23,7,8,16,1,0,0,7
St Kilda,"Fisher, Sam",14,8,4,6,0,0,0,6
St Kilda,"Geary, Jarryn",15,9,3,6,0,0,0,8
St Kilda,"Gilbert, Sam",23,11,5,12,0,0,1,5
St Kilda,"Goddard, Hugh",13,5,3,8,0,0,2,0
St Kilda,"Longer, Billy",12,4,3,8,0,0,15,5
St Kilda,"Lonie, Jack",6,3,1,3,0,1,0,1
St Kilda,"McCartin, Paddy",7,5,4,2,1,1,0,1
St Kilda,"Montagna, Leigh",27,16,4,11,1,0,0,3
St Kilda,"Newnes, Jack",20,8,4,12,0,0,3,3
St Kilda,"Ray, Farren",15,11,5,4,0,1,3,2
St Kilda,"Riewoldt, Nick",16,14,9,2,1,3,1,1
St Kilda,"Roberton, Dylan",21,18,6,3,0,0,0,3
St Kilda,"Savage, Shane",25,19,5,6,1,1,0,2
St Kilda,"Sinclair, Jack",5,3,1,2,0,1,0,1
St Kilda,"Steven, Jack",30,15,3,15,0,0,0,4
St Kilda,"Templeton, Eli",11,6,6,5,0,1,0,2
St Kilda,"Webster, Jimmy",7,3,1,4,0,0,0,1
St Kilda,"Weller, Maverick",20,12,5,8,3,1,0,5
St Kilda,"Armitage, David",20,14,1,6,0,1,0,4
St Kilda,"Bruce, Josh",10,7,5,3,1,0,2,2
St Kilda,"Dempster, Sean",23,14,10,9,0,0,0,3
St Kilda,"Dunstan, Luke",16,9,2,7,2,1,0,2
St Kilda,"Fisher, Sam",17,13,10,4,0,0,1,0
St Kilda,"Geary, Jarryn",17,11,5,6,0,0,0,2
St Kilda,"Gilbert, Sam",20,11,3,9,0,0,3,6
St Kilda,"Goddard, Hugh",14,6,5,8,0,0,0,0
St Kilda,"Longer, Billy",10,3,3,7,0,0,17,2
St Kilda,"Lonie, Jack",12,9,0,3,1,1,0,5
St Kilda,"McCartin, Paddy",14,12,9,2,1,0,0,2
St Kilda,"Montagna, Leigh",22,14,3,8,0,0,0,7
St Kilda,"Newnes, Jack",17,9,3,8,1,0,0,4
St Kilda,"Riewoldt, Nick",15,13,13,2,3,1,2,3
St Kilda,"Roberton, Dylan",23,15,8,8,0,0,0,2
St Kilda,"Savage, Shane",18,14,8,4,1,0,0,3
St Kilda,"Schneider, Adam",15,11,1,4,0,1,0,7
St Kilda,"Sinclair, Jack",10,8,1,2,1,1,0,7
St Kilda,"Steven, Jack",16,9,2,7,0,0,0,12
St Kilda,"Templeton, Eli",3,2,2,1,0,0,0,0
St Kilda,"Webster, Jimmy",11,7,2,4,0,0,0,4
St Kilda,"Weller, Maverick",17,11,8,6,1,2,0,6
St Kilda,"Armitage, David",22,7,3,15,0,0,0,6
St Kilda,"Bruce, Josh",8,6,3,2,1,2,0,5
St Kilda,"Dempster, Sean",21,17,10,4,0,0,0,2
St Kilda,"Dunstan, Luke",15,7,4,8,1,1,0,4
St Kilda,"Fisher, Sam",16,15,6,1,0,0,0,0
St Kilda,"Geary, Jarryn",23,14,9,9,0,0,0,2
St Kilda,"Goddard, Hugh",9,2,7,7,0,0,0,2
St Kilda,"Hickey, Tom",12,8,2,4,0,1,23,2
St Kilda,"Longer, Billy",1,1,0,0,0,0,12,0
St Kilda,"McCartin, Paddy",10,9,4,1,0,2,0,1
St Kilda,"McKenzie, Daniel",9,2,1,7,0,0,0,3
St Kilda,"Membrey, Tim",5,3,1,2,1,0,0,0
St Kilda,"Montagna, Leigh",26,13,3,13,2,1,1,3
St Kilda,"Newnes, Jack",22,14,5,8,0,0,2,1
St Kilda,"Roberton, Dylan",20,15,7,5,0,1,0,1
St Kilda,"Savage, Shane",21,14,5,7,0,0,0,1
St Kilda,"Schneider, Adam",14,11,2,3,0,1,0,6
St Kilda,"Sinclair, Jack",20,8,2,12,1,0,0,1
St Kilda,"Steven, Jack",22,12,5,10,0,1,0,8
St Kilda,"Templeton, Eli",8,5,3,3,0,0,0,1
St Kilda,"Webster, Jimmy",8,5,4,3,0,0,0,1
St Kilda,"Weller, Maverick",15,8,1,7,0,1,0,6
St Kilda,"Acres, Blake",14,6,2,8,0,0,1,1
St Kilda,"Armitage, David",22,9,2,13,0,0,0,9
St Kilda,"Bruce, Josh",11,7,4,4,1,1,1,1
St Kilda,"Dempster, Sean",20,10,7,10,0,0,0,0
St Kilda,"Fisher, Sam",11,6,3,5,0,0,1,0
St Kilda,"Geary, Jarryn",21,12,5,9,0,0,0,6
St Kilda,"Gilbert, Sam",20,9,6,11,0,1,1,6
St Kilda,"Goddard, Hugh",12,3,2,9,0,0,1,1
St Kilda,"Hickey, Tom",14,8,2,6,0,0,20,4
St Kilda,"Lonie, Jack",7,5,2,2,1,2,0,3
St Kilda,"McCartin, Paddy",11,7,3,4,1,1,0,2
St Kilda,"McKenzie, Daniel",2,0,0,2,0,0,0,0
St Kilda,"Montagna, Leigh",36,23,11,13,1,0,0,6
St Kilda,"Newnes, Jack",21,13,4,8,0,1,0,7
St Kilda,"Riewoldt, Nick",20,15,8,5,1,1,1,1
St Kilda,"Roberton, Dylan",23,18,10,5,0,0,0,1
St Kilda,"Ross, Sebastian",20,12,1,8,0,0,2,4
St Kilda,"Savage, Shane",10,5,5,5,0,0,0,3
St Kilda,"Sinclair, Jack",11,4,3,7,1,0,0,3
St Kilda,"Steven, Jack",27,17,3,10,2,0,0,3
St Kilda,"Weller, Maverick",16,8,4,8,0,0,0,4
St Kilda,"Wright, Nathan",11,5,2,6,0,0,0,3
St Kilda,"Acres, Blake",11,4,3,7,0,0,1,4
St Kilda,"Armitage, David",28,13,2,15,1,0,0,7
St Kilda,"Bruce, Josh",11,9,7,2,2,2,0,2
St Kilda,"Dempster, Sean",18,9,7,9,0,0,0,1
St Kilda,"Fisher, Sam",14,10,7,4,0,0,1,1
St Kilda,"Geary, Jarryn",20,12,5,8,1,0,0,4
St Kilda,"Gilbert, Sam",21,8,5,13,0,1,0,8
St Kilda,"Goddard, Hugh",20,7,5,13,0,0,0,1
St Kilda,"Hickey, Tom",12,6,7,6,2,2,9,0
St Kilda,"Longer, Billy",8,3,3,5,0,0,12,3
St Kilda,"Minchington, Darren",11,5,2,6,1,3,0,1
St Kilda,"Montagna, Leigh",33,18,8,15,0,0,0,1
St Kilda,"Newnes, Jack",26,15,10,11,1,0,1,1
St Kilda,"Riewoldt, Nick",18,13,12,5,2,2,1,1
St Kilda,"Roberton, Dylan",14,12,3,2,0,0,0,2
St Kilda,"Ross, Sebastian",20,9,2,11,0,0,2,5
St Kilda,"Saunders, Josh",6,3,1,3,0,0,0,3
St Kilda,"Sinclair, Jack",5,2,2,3,1,0,0,1
St Kilda,"Steven, Jack",21,16,2,5,0,1,0,1
St Kilda,"Webster, Jimmy",21,15,2,6,0,0,0,4
St Kilda,"Weller, Maverick",19,10,4,9,0,2,0,4
St Kilda,"Wright, Nathan",15,8,1,7,0,0,0,4
St Kilda,"Bruce, Josh",9,7,6,2,3,1,0,1
St Kilda,"Dunstan, Luke",19,11,4,8,0,1,0,3
St Kilda,"Fisher, Sam",19,15,10,4,0,0,2,2
St Kilda,"Geary, Jarryn",18,9,2,9,0,0,0,3
St Kilda,"Gilbert, Sam",21,9,1,12,2,1,0,9
St Kilda,"Goddard, Hugh",11,4,3,7,0,0,0,1
St Kilda,"Hickey, Tom",14,6,7,8,2,0,13,2
St Kilda,"Holmes, Jason",7,2,1,5,0,0,34,3
St Kilda,"Membrey, Tim",9,8,5,1,1,0,0,5
St Kilda,"Minchington, Darren",10,6,2,4,3,0,0,5
St Kilda,"Montagna, Leigh",23,16,3,7,0,1,0,3
St Kilda,"Murdoch, Brodie",2,2,1,0,0,0,0,0
St Kilda,"Newnes, Jack",19,15,6,4,1,1,1,2
St Kilda,"Ray, Farren",11,6,3,5,0,0,0,6
St Kilda,"Riewoldt, Nick",22,17,10,5,1,0,3,4
St Kilda,"Ross, Sebastian",22,12,4,10,0,1,1,6
St Kilda,"Saunders, Josh",2,0,0,2,0,0,0,1
St Kilda,"Savage, Shane",20,17,5,3,1,2,0,2
St Kilda,"Shenton, Cameron",7,5,4,2,0,0,0,2
St Kilda,"Steven, Jack",26,16,2,10,0,0,0,7
St Kilda,"Webster, Jimmy",17,10,7,7,0,0,0,1
St Kilda,"Weller, Maverick",17,6,3,11,0,0,0,3
St Kilda,"Armitage, David",25,14,6,11,0,2,0,7
St Kilda,"Bruce, Josh",6,4,1,2,0,1,0,2
St Kilda,"Dempster, Sean",14,7,7,7,0,0,0,0
St Kilda,"Dunstan, Luke",9,3,2,6,0,0,0,2
St Kilda,"Fisher, Sam",24,16,11,8,0,0,1,1
St Kilda,"Geary, Jarryn",23,10,10,13,0,0,0,0
St Kilda,"Gilbert, Sam",18,8,2,10,0,1,2,3
St Kilda,"Goddard, Hugh",12,6,4,6,0,0,3,0
St Kilda,"Hickey, Tom",2,1,1,1,0,1,3,1
St Kilda,"Holmes, Jason",3,1,0,2,0,0,18,2
St Kilda,"Minchington, Darren",8,6,2,2,0,0,0,2
St Kilda,"Montagna, Leigh",24,9,5,15,0,0,0,3
St Kilda,"Murdoch, Brodie",11,6,7,5,1,0,0,0
St Kilda,"Newnes, Jack",22,14,5,8,0,0,0,4
St Kilda,"Riewoldt, Nick",14,12,10,2,1,0,5,1
St Kilda,"Roberton, Dylan",25,13,6,12,0,0,0,2
St Kilda,"Ross, Sebastian",19,10,7,9,0,1,3,2
St Kilda,"Savage, Shane",21,14,6,7,0,0,0,3
St Kilda,"Schneider, Adam",12,10,4,2,2,0,0,1
St Kilda,"Steven, Jack",33,15,5,18,0,2,0,6
St Kilda,"Webster, Jimmy",16,11,4,5,0,1,0,2
St Kilda,"Weller, Maverick",13,6,2,7,0,2,0,2
St Kilda,"Armitage, David",27,11,1,16,0,1,1,8
St Kilda,"Bruce, Josh",8,5,2,3,2,1,2,5
St Kilda,"Dempster, Sean",15,10,7,5,0,0,0,4
St Kilda,"Dunstan, Luke",25,9,8,16,0,0,0,2
St Kilda,"Fisher, Sam",21,13,9,8,0,0,0,1
St Kilda,"Geary, Jarryn",16,6,2,10,0,0,0,1
St Kilda,"Gilbert, Sam",17,6,4,11,0,0,2,7
St Kilda,"Goddard, Hugh",4,1,2,3,1,0,0,2
St Kilda,"Holmes, Jason",5,1,0,4,0,0,23,5
St Kilda,"Lonie, Jack",9,6,4,3,0,0,0,1
St Kilda,"Montagna, Leigh",33,13,4,20,0,0,1,6
St Kilda,"Murdoch, Brodie",9,7,7,2,1,0,0,2
St Kilda,"Newnes, Jack",21,9,4,12,0,0,4,7
St Kilda,"Ray, Farren",16,3,2,13,0,0,0,3
St Kilda,"Riewoldt, Nick",12,9,9,3,0,2,1,2
St Kilda,"Roberton, Dylan",13,10,5,3,0,0,0,1
St Kilda,"Ross, Sebastian",25,7,2,18,0,0,0,9
St Kilda,"Savage, Shane",18,10,4,8,0,0,0,1
St Kilda,"Sinclair, Jack",3,2,0,1,0,0,0,2
St Kilda,"Steven, Jack",25,11,1,14,0,0,0,7
St Kilda,"Webster, Jimmy",18,9,3,9,0,0,0,2
St Kilda,"Weller, Maverick",19,9,4,10,0,1,0,3
Sydney,"Bird, Craig",20,11,3,9,2,0,0,3
Sydney,"Cunningham, Harry",17,5,3,12,0,0,0,3
Sydney,"Franklin, Lance",12,9,1,3,3,1,0,4
Sydney,"Goodes, Adam",9,4,2,5,0,1,0,4
Sydney,"Grundy, Heath",17,6,2,11,0,0,0,2
Sydney,"Hannebery, Dan",26,12,1,14,0,0,0,8
Sydney,"Heeney, Isaac",17,13,3,4,1,2,0,7
Sydney,"Jack, Kieren",29,17,5,12,1,2,0,3
Sydney,"Jetta, Lewis",15,12,2,3,0,0,0,3
Sydney,"Kennedy, Josh",30,10,1,20,0,0,0,6
Sydney,"Laidler, Jeremy",22,11,1,11,1,0,2,0
Sydney,"Lloyd, Jake",13,10,4,3,0,0,0,0
Sydney,"Parker, Luke",35,17,1,18,0,0,1,6
Sydney,"Pyke, Mike",5,5,0,0,0,0,37,5
Sydney,"Rampe, Dane",18,8,5,10,0,0,0,6
Sydney,"Reid, Sam",9,3,3,6,0,0,4,1
Sydney,"Richards, Ted",8,7,2,1,0,0,0,1
Sydney,"Rohan, Gary",15,9,4,6,0,1,0,0
Sydney,"Shaw, Rhyce",17,13,2,4,0,0,0,2
Sydney,"Smith, Nick",14,10,1,4,0,0,0,2
Sydney,"Tippett, Kurt",10,6,3,4,2,2,22,3
Sydney,"Towers, Dean",16,6,1,10,0,0,0,2
Sydney,"Bird, Craig",20,11,3,9,0,0,0,6
Sydney,"Franklin, Lance",17,14,8,3,3,1,0,8
Sydney,"Goodes, Adam",6,2,1,4,0,0,0,0
Sydney,"Grundy, Heath",20,11,9,9,0,0,0,1
Sydney,"Hannebery, Dan",28,11,0,17,2,1,0,3
Sydney,"Heeney, Isaac",17,11,5,6,0,1,0,2
Sydney,"Jack, Kieren",31,12,3,19,1,0,0,6
Sydney,"Jetta, Lewis",20,14,4,6,2,2,0,3
Sydney,"Kennedy, Josh",36,13,1,23,0,1,1,9
Sydney,"Laidler, Jeremy",13,4,1,9,0,0,0,2
Sydney,"Lloyd, Jake",20,12,4,8,1,0,0,2
Sydney,"McVeigh, Jarrad",26,14,6,12,1,0,0,2
Sydney,"Parker, Luke",30,11,1,19,0,1,1,3
Sydney,"Pyke, Mike",13,4,2,9,0,0,29,2
Sydney,"Rampe, Dane",22,15,5,7,0,0,0,3
Sydney,"Reid, Sam",10,3,3,7,0,0,0,2
Sydney,"Richards, Ted",11,5,6,6,0,0,0,2
Sydney,"Rohan, Gary",10,6,4,4,1,0,0,3
Sydney,"Shaw, Rhyce",18,13,7,5,0,0,0,3
Sydney,"Smith, Nick",25,16,9,9,0,0,0,5
Sydney,"Tippett, Kurt",10,4,3,6,1,0,26,8
Sydney,"Towers, Dean",14,9,3,5,2,0,0,1
Sydney,"Bird, Craig",22,11,4,11,1,0,0,5
Sydney,"Cunningham, Harry",21,10,10,11,0,0,0,4
Sydney,"Franklin, Lance",18,14,7,4,5,5,0,3
Sydney,"Grundy, Heath",21,9,3,12,0,0,0,2
Sydney,"Hannebery, Dan",35,12,4,23,1,1,0,3
Sydney,"Heeney, Isaac",10,6,2,4,4,0,0,2
Sydney,"Jack, Kieren",24,10,2,14,1,1,0,3
Sydney,"Jetta, Lewis",18,11,4,7,1,1,0,0
Sydney,"Kennedy, Josh",24,12,0,12,0,1,0,2
Sydney,"Laidler, Jeremy",15,10,6,5,0,1,0,1
Sydney,"Lloyd, Jake",24,9,5,15,0,0,0,4
Sydney,"McGlynn, Ben",13,10,5,3,1,1,0,5
Sydney,"McVeigh, Jarrad",28,17,5,11,0,0,0,6
Sydney,"Parker, Luke",15,3,2,12,2,0,0,4
Sydney,"Pyke, Mike",10,6,2,4,0,1,25,1
Sydney,"Rampe, Dane",16,8,2,8,0,0,0,3
Sydney,"Reid, Sam",13,7,3,6,0,0,0,1
Sydney,"Richards, Ted",12,9,3,3,0,0,0,1
Sydney,"Rohan, Gary",14,5,3,9,0,0,0,4
Sydney,"Shaw, Rhyce",21,15,5,6,0,0,0,2
Sydney,"Tippett, Kurt",8,6,3,2,0,1,12,3
Sydney,"Towers, Dean",2,1,0,1,0,0,0,1
Sydney,"Bird, Craig",21,9,3,12,0,1,0,2
Sydney,"Cunningham, Harry",11,9,6,2,0,0,0,0
Sydney,"Franklin, Lance",15,14,7,1,2,2,0,2
Sydney,"Grundy, Heath",18,12,5,6,0,0,0,3
Sydney,"Hannebery, Dan",31,10,4,21,0,0,0,5
Sydney,"Heeney, Isaac",3,1,2,2,0,0,0,1
Sydney,"Jack, Kieren",19,12,4,7,0,0,0,6
Sydney,"Jetta, Lewis",11,4,3,7,1,0,0,2
Sydney,"Kennedy, Josh",23,12,3,11,0,0,0,7
Sydney,"Laidler, Jeremy",15,5,1,10,0,0,0,0
Sydney,"Lloyd, Jake",25,18,8,7,1,0,0,1
Sydney,"McGlynn, Ben",10,6,4,4,0,1,0,3
Sydney,"McVeigh, Jarrad",23,14,7,9,0,1,0,9
Sydney,"Parker, Luke",22,8,5,14,1,1,0,3
Sydney,"Pyke, Mike",9,4,3,5,0,1,16,1
Sydney,"Rampe, Dane",17,12,4,5,0,0,0,2
Sydney,"Reid, Sam",22,10,11,12,0,0,3,3
Sydney,"Richards, Ted",17,11,4,6,0,0,0,3
Sydney,"Rohan, Gary",9,7,4,2,1,0,0,1
Sydney,"Shaw, Rhyce",21,13,8,8,0,0,0,0
Sydney,"Smith, Nick",19,15,6,4,0,0,0,2
Sydney,"Tippett, Kurt",9,6,7,3,2,2,7,1
Sydney,"Bird, Craig",14,6,2,8,0,0,0,3
Sydney,"Cunningham, Harry",4,1,0,3,1,0,0,5
Sydney,"Franklin, Lance",15,11,4,4,3,2,0,2
Sydney,"Goodes, Adam",12,7,0,5,2,0,0,2
Sydney,"Grundy, Heath",17,9,4,8,0,0,0,1
Sydney,"Hannebery, Dan",37,19,1,18,0,0,0,10
Sydney,"Jack, Kieren",18,11,2,7,1,1,0,8
Sydney,"Jetta, Lewis",17,11,1,6,0,0,0,5
Sydney,"Kennedy, Josh",25,14,2,11,0,1,0,7
Sydney,"Laidler, Jeremy",21,9,5,12,0,0,0,2
Sydney,"Lloyd, Jake",20,10,1,10,0,0,0,9
Sydney,"McVeigh, Jarrad",19,12,2,7,0,1,0,11
Sydney,"Mitchell, Tom",30,14,1,16,0,1,0,9
Sydney,"Parker, Luke",26,9,1,17,0,0,3,4
Sydney,"Pyke, Mike",8,2,1,6,0,0,59,3
Sydney,"Rampe, Dane",14,9,6,5,0,0,0,1
Sydney,"Richards, Ted",18,12,0,6,0,0,1,5
Sydney,"Rohan, Gary",20,12,4,8,1,1,0,4
Sydney,"Shaw, Rhyce",14,9,4,5,0,1,0,8
Sydney,"Smith, Nick",18,10,2,8,0,1,0,4
Sydney,"Tippett, Kurt",9,5,2,4,2,1,12,2
Sydney,"Towers, Dean",4,3,0,1,0,1,0,4
Sydney,"Franklin, Lance",22,17,6,5,0,2,0,2
Sydney,"Goodes, Adam",12,8,3,4,1,0,0,3
Sydney,"Grundy, Heath",18,11,6,7,0,0,0,2
Sydney,"Hannebery, Dan",18,9,2,9,1,0,0,6
Sydney,"Heeney, Isaac",5,5,2,0,0,1,0,0
Sydney,"Jack, Kieren",25,13,6,12,0,0,0,8
Sydney,"Jetta, Lewis",24,16,5,8,1,1,0,2
Sydney,"Kennedy, Josh",31,13,6,18,2,1,1,8
Sydney,"Laidler, Jeremy",12,9,6,3,0,0,0,1
Sydney,"Lloyd, Jake",17,9,3,8,0,0,0,0
Sydney,"McGlynn, Ben",19,11,6,8,1,0,0,8
Sydney,"McVeigh, Jarrad",24,17,6,7,0,0,0,2
Sydney,"Mitchell, Tom",28,12,4,16,0,0,0,5
Sydney,"Parker, Luke",24,13,5,11,1,2,2,9
Sydney,"Pyke, Mike",11,8,0,3,1,2,39,2
Sydney,"Rampe, Dane",9,6,3,3,0,0,0,4
Sydney,"Reid, Sam",16,7,5,9,0,0,2,6
Sydney,"Richards, Ted",9,5,4,4,0,1,0,1
Sydney,"Rohan, Gary",14,7,5,7,0,2,0,5
Sydney,"Shaw, Rhyce",12,9,3,3,0,0,0,4
Sydney,"Smith, Nick",10,5,5,5,0,0,0,3
Sydney,"Tippett, Kurt",15,7,3,8,4,0,15,6
Sydney,"Franklin, Lance",22,14,4,8,4,5,0,2
Sydney,"Goodes, Adam",15,9,8,6,1,1,0,2
Sydney,"Grundy, Heath",25,9,6,16,0,0,0,2
Sydney,"Hannebery, Dan",35,13,5,22,0,0,0,1
Sydney,"Jack, Kieren",24,9,4,15,1,0,0,4
Sydney,"Jetta, Lewis",21,15,4,6,0,1,0,2
Sydney,"Kennedy, Josh",33,12,9,21,1,1,0,3
Sydney,"Laidler, Jeremy",14,7,2,7,0,0,0,1
Sydney,"Lloyd, Jake",18,10,2,8,0,0,0,1
Sydney,"McGlynn, Ben",21,12,5,9,0,1,0,10
Sydney,"McVeigh, Jarrad",26,9,3,17,1,0,0,4
Sydney,"Mitchell, Tom",33,12,4,21,3,0,0,4
Sydney,"Parker, Luke",31,20,11,11,5,1,0,5
Sydney,"Pyke, Mike",13,5,1,8,0,0,36,4
Sydney,"Rampe, Dane",11,6,2,5,0,0,0,2
Sydney,"Reid, Sam",11,5,4,6,0,1,0,1
Sydney,"Richards, Ted",14,9,6,5,0,0,0,0
Sydney,"Rohan, Gary",10,5,3,5,1,0,0,2
Sydney,"Shaw, Rhyce",20,15,5,5,0,0,0,0
Sydney,"Smith, Nick",17,8,4,9,0,0,0,3
Sydney,"Tippett, Kurt",7,2,2,5,1,0,5,1
Sydney,"Towers, Dean",5,2,2,3,0,0,0,0
Sydney,"Cunningham, Harry",4,2,1,2,0,0,0,0
Sydney,"Franklin, Lance",7,6,3,1,0,0,0,4
Sydney,"Goodes, Adam",18,14,7,4,1,0,0,2
Sydney,"Grundy, Heath",20,9,5,11,0,0,0,3
Sydney,"Hannebery, Dan",36,18,4,18,0,0,0,4
Sydney,"Jack, Kieren",20,11,5,9,0,0,0,11
Sydney,"Jetta, Lewis",17,9,5,8,0,0,0,4
Sydney,"Kennedy, Josh",29,12,2,17,0,1,0,6
Sydney,"Laidler, Jeremy",13,4,4,9,0,0,0,3
Sydney,"Lloyd, Jake",18,12,4,6,0,0,0,3
Sydney,"McGlynn, Ben",16,11,6,5,2,0,0,4
Sydney,"McVeigh, Jarrad",20,13,8,7,2,0,0,4
Sydney,"Mitchell, Tom",25,11,5,14,0,1,0,5
Sydney,"Parker, Luke",26,12,6,14,1,1,2,6
Sydney,"Pyke, Mike",6,3,0,3,0,0,20,1
Sydney,"Rampe, Dane",20,14,4,6,0,0,0,2
Sydney,"Reid, Sam",17,11,9,6,2,1,2,2
Sydney,"Richards, Ted",12,6,7,6,0,0,0,3
Sydney,"Rohan, Gary",6,5,2,1,1,0,0,1
Sydney,"Shaw, Rhyce",11,8,3,3,0,0,0,3
Sydney,"Smith, Nick",21,16,9,5,0,0,0,4
Sydney,"Tippett, Kurt",9,5,3,4,2,0,10,1
Sydney,"Cunningham, Harry",20,11,3,9,0,1,0,2
Sydney,"Franklin, Lance",22,18,7,4,7,0,0,4
Sydney,"Goodes, Adam",21,14,9,7,2,0,0,2
Sydney,"Hannebery, Dan",25,14,9,11,2,0,0,8
Sydney,"Jack, Brandon",6,4,0,2,0,0,0,4
Sydney,"Jack, Kieren",30,11,2,19,0,0,0,5
Sydney,"Jetta, Lewis",27,20,7,7,0,2,0,4
Sydney,"Kennedy, Josh",22,11,2,11,0,0,0,6
Sydney,"Laidler, Jeremy",11,7,4,4,0,0,0,5
Sydney,"McGlynn, Ben",23,12,7,11,2,0,0,3
Sydney,"McVeigh, Jarrad",17,10,7,7,1,0,0,1
Sydney,"Mitchell, Tom",28,12,4,16,0,1,0,8
Sydney,"Parker, Luke",24,10,1,14,0,0,1,3
Sydney,"Pyke, Mike",7,0,3,7,0,0,53,5
Sydney,"Rampe, Dane",18,11,6,7,0,0,0,0
Sydney,"Reid, Sam",12,10,7,2,0,0,0,2
Sydney,"Richards, Ted",14,13,9,1,0,0,0,3
Sydney,"Robinson, Dan",15,8,5,7,1,0,0,4
Sydney,"Rohan, Gary",9,6,3,3,2,1,0,1
Sydney,"Shaw, Rhyce",24,15,6,9,0,0,0,7
Sydney,"Smith, Nick",15,7,1,8,0,0,0,5
Sydney,"Tippett, Kurt",9,4,2,5,2,1,16,0
Sydney,"Cunningham, Harry",12,8,3,4,2,0,0,1
Sydney,"Franklin, Lance",17,12,6,5,3,2,0,2
Sydney,"Goodes, Adam",17,11,6,6,1,1,0,1
Sydney,"Grundy, Heath",23,9,11,14,0,0,0,2
Sydney,"Hannebery, Dan",42,23,5,19,0,1,0,2
Sydney,"Jack, Kieren",24,10,3,14,1,0,0,3
Sydney,"Jetta, Lewis",31,21,8,10,0,0,0,4
Sydney,"Kennedy, Josh",23,10,2,13,0,1,0,0
Sydney,"Laidler, Jeremy",13,5,2,8,0,0,0,0
Sydney,"Lloyd, Jake",27,14,5,13,0,2,0,2
Sydney,"McVeigh, Jarrad",39,20,8,19,0,0,0,3
Sydney,"Mitchell, Tom",33,11,6,22,1,0,0,8
Sydney,"Parker, Luke",26,13,3,13,1,3,1,4
Sydney,"Pyke, Mike",7,0,1,7,0,0,31,3
Sydney,"Rampe, Dane",32,18,12,14,0,0,0,2
Sydney,"Reid, Sam",7,3,3,4,1,0,1,1
Sydney,"Richards, Ted",13,7,4,6,0,0,0,1
Sydney,"Robinson, Dan",8,4,0,4,0,0,1,2
Sydney,"Rohan, Gary",15,8,6,7,0,1,0,3
Sydney,"Shaw, Rhyce",24,13,5,11,0,0,0,5
Sydney,"Smith, Nick",11,3,3,8,0,0,0,2
Sydney,"Tippett, Kurt",5,4,1,1,3,0,17,0
Sydney,"Cunningham, Harry",21,15,11,6,1,0,0,2
Sydney,"Franklin, Lance",16,14,6,2,4,0,0,6
Sydney,"Goodes, Adam",14,8,5,6,3,0,0,2
Sydney,"Grundy, Heath",16,11,8,5,0,0,0,0
Sydney,"Hannebery, Dan",22,11,5,11,1,0,0,5
Sydney,"Jack, Kieren",20,6,4,14,0,0,0,11
Sydney,"Jetta, Lewis",20,15,4,5,1,0,0,3
Sydney,"Kennedy, Josh",27,8,1,19,0,1,0,7
Sydney,"Laidler, Jeremy",16,10,7,6,0,0,0,2
Sydney,"Lloyd, Jake",14,8,6,6,0,0,0,0
Sydney,"McVeigh, Jarrad",28,18,8,10,0,0,0,1
Sydney,"Mitchell, Tom",26,11,4,15,0,0,0,7
Sydney,"Parker, Luke",33,15,4,18,0,1,2,7
Sydney,"Pyke, Mike",5,2,3,3,0,0,19,1
Sydney,"Rampe, Dane",26,18,14,8,0,1,0,0
Sydney,"Reid, Sam",8,3,3,5,0,1,8,3
Sydney,"Richards, Ted",12,8,9,4,0,0,0,1
Sydney,"Robinson, Dan",3,1,0,2,0,0,0,1
Sydney,"Rohan, Gary",12,6,6,6,2,0,0,2
Sydney,"Shaw, Rhyce",12,8,4,4,0,0,0,1
Sydney,"Smith, Nick",14,8,7,6,0,0,0,4
Sydney,"Tippett, Kurt",15,6,5,9,2,1,8,4
Sydney,"Cunningham, Harry",13,5,3,8,0,2,0,4
Sydney,"Derickx, Tom",8,7,3,1,1,0,7,2
Sydney,"Franklin, Lance",10,6,3,4,2,2,0,2
Sydney,"Goodes, Adam",12,11,9,1,0,0,0,1
Sydney,"Grundy, Heath",19,10,7,9,0,0,0,0
Sydney,"Hannebery, Dan",29,13,1,16,1,0,0,5
Sydney,"Jack, Kieren",27,13,3,14,0,0,0,6
Sydney,"Jetta, Lewis",12,8,2,4,0,0,0,1
Sydney,"Jones, Zak",6,3,2,3,0,0,0,1
Sydney,"Kennedy, Josh",28,15,4,13,1,2,0,6
Sydney,"Laidler, Jeremy",16,10,3,6,0,0,0,0
Sydney,"Lloyd, Jake",21,11,3,10,0,0,0,2
Sydney,"McVeigh, Jarrad",21,13,9,8,0,0,0,1
Sydney,"Mitchell, Tom",10,3,1,7,1,0,0,4
Sydney,"Parker, Luke",24,12,4,12,2,1,0,7
Sydney,"Rampe, Dane",14,10,4,4,0,0,0,2
Sydney,"Reid, Sam",13,3,3,10,0,0,12,8
Sydney,"Richards, Ted",15,5,3,10,0,0,0,0
Sydney,"Rohan, Gary",16,12,7,4,2,0,0,1
Sydney,"Shaw, Rhyce",22,14,5,8,0,0,0,0
Sydney,"Smith, Nick",13,7,6,6,0,0,0,2
Sydney,"Tippett, Kurt",10,4,6,6,1,1,16,5
Sydney,"Cunningham, Harry",6,3,1,3,1,0,0,2
Sydney,"Goodes, Adam",11,9,4,2,3,1,0,6
Sydney,"Grundy, Heath",13,8,6,5,0,0,0,0
Sydney,"Hannebery, Dan",34,18,8,16,1,1,0,7
Sydney,"Jack, Kieren",25,15,5,10,1,0,0,9
Sydney,"Jetta, Lewis",14,14,1,0,1,1,0,3
Sydney,"Jones, Zak",14,8,3,6,0,0,0,1
Sydney,"Kennedy, Josh",33,18,7,15,2,3,0,8
Sydney,"Laidler, Jeremy",14,6,2,8,0,0,0,2
Sydney,"Lloyd, Jake",26,16,7,10,0,0,0,6
Sydney,"McVeigh, Jarrad",12,4,3,8,0,0,0,5
Sydney,"Mitchell, Tom",22,14,4,8,0,0,0,9
Sydney,"Nankervis, Toby",10,7,3,3,1,1,6,2
Sydney,"Parker, Luke",26,15,5,11,1,0,1,8
Sydney,"Pyke, Mike",4,1,1,3,0,0,25,5
Sydney,"Rampe, Dane",14,7,6,7,0,0,0,3
Sydney,"Reid, Sam",11,6,5,5,3,1,2,2
Sydney,"Richards, Ted",7,4,1,3,0,0,0,1
Sydney,"Rohan, Gary",5,4,4,1,0,1,0,0
Sydney,"Shaw, Rhyce",13,6,0,7,0,0,0,1
Sydney,"Smith, Nick",14,9,4,5,0,0,0,1
Sydney,"Towers, Dean",10,5,4,5,0,0,1,3
Sydney,"Cunningham, Harry",6,3,2,3,0,0,0,4
Sydney,"Franklin, Lance",17,10,3,7,3,2,0,1
Sydney,"Goodes, Adam",17,10,6,7,0,1,0,0
Sydney,"Grundy, Heath",19,12,5,7,0,0,0,1
Sydney,"Hannebery, Dan",34,16,6,18,0,0,0,6
Sydney,"Jack, Kieren",20,10,2,10,1,0,0,9
Sydney,"Jetta, Lewis",20,13,2,7,1,0,0,1
Sydney,"Jones, Zak",14,7,3,7,0,0,0,3
Sydney,"Kennedy, Josh",41,13,2,28,0,0,1,9
Sydney,"Laidler, Jeremy",15,10,4,5,0,0,0,1
Sydney,"Lloyd, Jake",24,15,4,9,0,0,0,2
Sydney,"McVeigh, Jarrad",23,13,5,10,1,0,0,5
Sydney,"Mitchell, Tom",27,8,3,19,0,0,0,7
Sydney,"Parker, Luke",23,9,3,14,0,0,3,7
Sydney,"Pyke, Mike",6,1,1,5,0,0,18,4
Sydney,"Rampe, Dane",23,17,11,6,0,0,0,3
Sydney,"Reid, Sam",15,8,6,7,0,0,1,1
Sydney,"Robinson, Dan",12,9,5,3,1,1,1,4
Sydney,"Shaw, Rhyce",12,8,1,4,0,1,0,2
Sydney,"Smith, Nick",10,7,6,3,0,0,0,6
Sydney,"Tippett, Kurt",10,6,5,4,3,0,31,4
Sydney,"Towers, Dean",12,3,3,9,0,1,0,3
Sydney,"Bird, Craig",2,2,2,0,0,0,0,2
Sydney,"Cunningham, Harry",15,7,3,8,0,1,0,5
Sydney,"Franklin, Lance",13,11,3,2,3,2,0,3
Sydney,"Goodes, Adam",23,17,6,6,0,1,0,5
Sydney,"Grundy, Heath",19,10,5,9,0,0,0,3
Sydney,"Hannebery, Dan",32,11,2,21,0,1,0,2
Sydney,"Jack, Brandon",18,11,5,7,0,1,0,3
Sydney,"Jack, Kieren",22,11,4,11,1,2,0,6
Sydney,"Jetta, Lewis",21,15,3,6,0,0,0,2
Sydney,"Jones, Zak",9,3,1,6,0,0,0,3
Sydney,"Kennedy, Josh",30,14,2,16,1,0,0,9
Sydney,"Lloyd, Jake",19,7,3,12,0,1,0,1
Sydney,"McVeigh, Jarrad",22,9,4,13,1,2,0,7
Sydney,"Mitchell, Tom",23,10,3,13,0,0,0,6
Sydney,"Nankervis, Toby",11,4,1,7,0,0,13,5
Sydney,"Parker, Luke",26,9,3,17,1,0,3,2
Sydney,"Rampe, Dane",17,12,7,5,0,0,0,1
Sydney,"Reid, Sam",14,6,6,8,0,0,0,1
Sydney,"Richards, Ted",10,1,2,9,0,0,0,1
Sydney,"Shaw, Rhyce",24,15,7,9,0,0,0,3
Sydney,"Smith, Nick",20,13,6,7,0,0,0,0
Sydney,"Tippett, Kurt",8,4,0,4,0,0,23,1
Sydney,"Cunningham, Harry",18,11,7,7,0,0,0,4
Sydney,"Goodes, Adam",15,10,7,5,1,0,0,3
Sydney,"Grundy, Heath",16,13,3,3,0,0,0,3
Sydney,"Hannebery, Dan",18,5,3,13,0,0,0,9
Sydney,"Heeney, Isaac",12,9,6,3,2,1,0,3
Sydney,"Jack, Brandon",15,7,6,8,2,1,0,5
Sydney,"Jack, Kieren",15,5,0,10,0,0,0,6
Sydney,"Jetta, Lewis",21,16,8,5,1,1,0,3
Sydney,"Jones, Zak",8,6,3,2,0,0,0,5
Sydney,"Kennedy, Josh",31,10,1,21,0,0,0,5
Sydney,"Laidler, Jeremy",17,10,4,7,0,1,0,4
Sydney,"Lloyd, Jake",25,8,4,17,0,0,0,3
Sydney,"McVeigh, Jarrad",16,8,2,8,0,0,0,5
Sydney,"Mitchell, Tom",10,1,0,9,0,0,0,5
Sydney,"Nankervis, Toby",8,2,2,6,0,0,10,6
Sydney,"Parker, Luke",27,11,3,16,0,0,1,3
Sydney,"Pyke, Mike",4,0,1,4,0,0,11,1
Sydney,"Rampe, Dane",17,7,3,10,0,0,0,4
Sydney,"Reid, Sam",18,9,7,9,0,4,4,5
Sydney,"Richards, Xavier",10,6,4,4,0,0,0,4
Sydney,"Shaw, Rhyce",26,15,5,11,1,0,0,3
Sydney,"Smith, Nick",20,9,7,11,0,0,0,2
Sydney,"Cunningham, Harry",25,12,5,13,0,0,0,3
Sydney,"Franklin, Lance",7,6,6,1,3,2,0,1
Sydney,"Grundy, Heath",19,11,9,8,0,0,0,1
Sydney,"Hannebery, Dan",40,16,10,24,3,0,0,2
Sydney,"Heeney, Isaac",12,9,6,3,0,0,0,3
Sydney,"Jack, Brandon",5,2,0,3,0,0,0,0
Sydney,"Jack, Kieren",26,15,10,11,0,1,0,3
Sydney,"Jetta, Lewis",21,13,7,8,1,1,0,2
Sydney,"Kennedy, Josh",32,7,3,25,2,1,0,6
Sydney,"Laidler, Jeremy",18,9,4,9,0,0,0,2
Sydney,"Lloyd, Jake",21,11,4,10,1,0,0,2
Sydney,"McGlynn, Ben",17,11,5,6,0,1,0,1
Sydney,"McVeigh, Jarrad",37,14,8,23,1,0,0,3
Sydney,"Mitchell, Tom",37,10,5,27,0,0,0,8
Sydney,"Nankervis, Toby",7,2,1,5,0,1,4,3
Sydney,"Parker, Luke",29,16,5,13,2,3,2,3
Sydney,"Rampe, Dane",32,24,12,8,0,1,0,2
Sydney,"Reid, Sam",9,4,6,5,1,0,0,1
Sydney,"Richards, Ted",12,7,5,5,0,1,0,5
Sydney,"Shaw, Rhyce",17,9,2,8,0,0,0,0
Sydney,"Smith, Nick",18,11,6,7,0,0,0,1
Sydney,"Tippett, Kurt",19,9,3,10,3,2,25,4
Sydney,"Cunningham, Harry",17,8,6,9,0,0,0,4
Sydney,"Goodes, Adam",12,11,6,1,1,1,0,3
Sydney,"Grundy, Heath",19,11,9,8,0,0,0,0
Sydney,"Hannebery, Dan",19,9,6,10,1,0,0,6
Sydney,"Heeney, Isaac",15,10,7,5,1,1,0,3
Sydney,"Jack, Brandon",15,8,1,7,1,1,0,2
Sydney,"Jack, Kieren",21,7,4,14,0,0,0,5
Sydney,"Jetta, Lewis",23,17,6,6,2,1,0,9
Sydney,"Jones, Zak",7,3,0,4,0,0,0,1
Sydney,"Kennedy, Josh",32,14,2,18,0,1,0,5
Sydney,"Laidler, Jeremy",11,6,4,5,0,1,0,4
Sydney,"Lloyd, Jake",23,15,6,8,0,1,0,3
Sydney,"McVeigh, Jarrad",16,5,5,11,0,0,0,4
Sydney,"Mitchell, Tom",23,8,4,15,1,0,0,5
Sydney,"Nankervis, Toby",3,2,2,1,0,0,9,4
Sydney,"Parker, Luke",20,9,2,11,1,0,0,3
Sydney,"Rampe, Dane",18,11,6,7,0,0,0,2
Sydney,"Reid, Sam",10,5,4,5,0,1,5,1
Sydney,"Richards, Ted",18,3,4,15,0,0,0,2
Sydney,"Shaw, Rhyce",22,11,3,11,0,0,0,4
Sydney,"Smith, Nick",17,9,3,8,0,0,0,4
Sydney,"Tippett, Kurt",11,4,2,7,1,0,32,7
Sydney,"Cunningham, Harry",22,11,8,11,0,1,0,1
Sydney,"Goodes, Adam",14,7,4,7,2,0,0,0
Sydney,"Grundy, Heath",14,9,5,5,0,0,0,2
Sydney,"Hannebery, Dan",31,10,6,21,0,1,0,7
Sydney,"Heeney, Isaac",12,6,3,6,0,2,0,1
Sydney,"Jack, Brandon",10,6,2,4,2,0,0,5
Sydney,"Jack, Kieren",30,18,4,12,0,0,0,5
Sydney,"Jetta, Lewis",20,11,3,9,1,0,0,3
Sydney,"Kennedy, Josh",35,13,2,22,1,0,1,6
Sydney,"Laidler, Jeremy",12,5,3,7,0,0,0,0
Sydney,"Lloyd, Jake",13,5,1,8,0,0,0,2
Sydney,"McVeigh, Jarrad",34,21,9,13,1,1,0,1
Sydney,"Mitchell, Tom",41,15,1,26,1,1,0,8
Sydney,"Parker, Luke",19,7,0,12,0,0,0,3
Sydney,"Pyke, Mike",12,4,2,8,1,0,14,2
Sydney,"Rampe, Dane",16,6,4,10,0,0,0,3
Sydney,"Reid, Sam",15,8,6,7,2,0,6,2
Sydney,"Richards, Ted",6,4,2,2,0,0,0,0
Sydney,"Rohan, Gary",7,5,4,2,2,1,0,2
Sydney,"Shaw, Rhyce",17,12,2,5,0,0,0,2
Sydney,"Smith, Nick",21,12,6,9,0,0,0,6
Sydney,"Tippett, Kurt",13,4,3,9,0,0,27,4
Sydney,"Cunningham, Harry",18,10,4,8,3,1,0,6
Sydney,"Goodes, Adam",26,11,5,15,1,1,0,2
Sydney,"Grundy, Heath",16,11,8,5,0,0,0,0
Sydney,"Hannebery, Dan",23,7,1,16,0,0,1,8
Sydney,"Heeney, Isaac",10,8,4,2,1,0,0,3
Sydney,"Jack, Brandon",18,7,4,11,1,0,0,1
Sydney,"Jack, Kieren",22,12,5,10,2,0,0,6
Sydney,"Jetta, Lewis",11,10,4,1,0,1,0,7
Sydney,"Jones, Zak",15,12,0,3,0,0,0,3
Sydney,"Kennedy, Josh",35,13,4,22,2,2,0,4
Sydney,"Laidler, Jeremy",16,9,4,7,0,0,0,2
Sydney,"Lloyd, Jake",20,12,3,8,0,0,0,2
Sydney,"McVeigh, Jarrad",31,17,0,14,1,0,0,6
Sydney,"Pyke, Mike",6,2,3,4,0,0,29,3
Sydney,"Rampe, Dane",19,9,2,10,0,0,0,2
Sydney,"Reid, Sam",18,9,10,9,1,0,0,2
Sydney,"Richards, Ted",17,9,5,8,0,0,0,2
Sydney,"Rose, James",6,6,3,0,3,0,0,0
Sydney,"Shaw, Rhyce",19,16,5,3,0,0,0,4
Sydney,"Smith, Nick",17,7,6,10,0,0,0,3
Sydney,"Tippett, Kurt",21,15,8,6,5,3,20,0
Sydney,"Towers, Dean",11,7,4,4,0,1,0,0
Sydney,"Cunningham, Harry",17,8,3,9,1,1,0,5
Sydney,"Franklin, Lance",7,5,3,2,1,0,0,1
Sydney,"Goodes, Adam",15,10,9,5,3,2,0,1
Sydney,"Grundy, Heath",26,13,6,13,0,0,0,2
Sydney,"Hannebery, Dan",39,19,7,20,0,1,0,3
Sydney,"Heeney, Isaac",21,12,8,9,4,0,0,4
Sydney,"Jack, Brandon",16,9,4,7,0,0,0,4
Sydney,"Jack, Kieren",29,11,7,18,0,0,0,8
Sydney,"Jetta, Lewis",12,10,4,2,1,0,0,4
Sydney,"Jones, Zak",18,12,5,6,0,0,0,2
Sydney,"Kennedy, Josh",33,18,7,15,0,2,0,6
Sydney,"Laidler, Jeremy",20,5,3,15,0,0,0,1
Sydney,"McVeigh, Jarrad",27,13,4,14,1,0,0,2
Sydney,"Mitchell, Tom",34,20,9,14,2,1,0,4
Sydney,"Pyke, Mike",13,6,4,7,2,0,15,1
Sydney,"Rampe, Dane",15,9,4,6,0,0,0,2
Sydney,"Reid, Sam",18,12,10,6,2,0,0,3
Sydney,"Richards, Ted",16,6,7,10,0,0,0,2
Sydney,"Rohan, Gary",7,6,4,1,0,0,0,3
Sydney,"Shaw, Rhyce",20,12,5,8,0,0,0,3
Sydney,"Smith, Nick",14,10,5,4,0,0,0,1
Sydney,"Tippett, Kurt",20,11,7,9,3,4,15,3
Sydney,"Cunningham, Harry",18,11,2,7,3,0,0,4
Sydney,"Franklin, Lance",13,11,6,2,1,1,0,2
Sydney,"Goodes, Adam",15,5,4,10,1,0,0,2
Sydney,"Grundy, Heath",19,11,6,8,0,0,0,0
Sydney,"Hannebery, Dan",32,17,4,15,1,0,0,5
Sydney,"Heeney, Isaac",17,11,8,6,2,0,0,3
Sydney,"Jack, Brandon",15,9,4,6,0,1,0,2
Sydney,"Jack, Kieren",7,4,3,3,0,0,0,1
Sydney,"Jetta, Lewis",19,14,2,5,0,0,0,2
Sydney,"Jones, Zak",13,10,2,3,0,0,0,2
Sydney,"Kennedy, Josh",31,16,3,15,2,1,0,5
Sydney,"Laidler, Jeremy",22,13,4,9,0,0,0,1
Sydney,"Lloyd, Jake",20,13,10,7,0,0,0,0
Sydney,"Mitchell, Tom",36,19,5,17,1,1,0,12
Sydney,"Pyke, Mike",11,1,6,10,0,0,13,2
Sydney,"Rampe, Dane",21,13,5,8,1,0,0,3
Sydney,"Reid, Sam",25,12,11,13,3,3,2,4
Sydney,"Richards, Ted",9,2,0,7,0,0,0,1
Sydney,"Rohan, Gary",12,10,5,2,0,0,0,1
Sydney,"Shaw, Rhyce",23,13,8,10,0,0,0,0
Sydney,"Tippett, Kurt",18,10,9,8,2,3,15,1
Sydney,"Towers, Dean",20,12,6,8,2,0,0,3
Sydney,"Cunningham, Harry",18,8,3,10,0,0,0,4
Sydney,"Goodes, Adam",25,15,7,10,0,2,0,5
Sydney,"Grundy, Heath",14,5,2,9,0,0,0,0
Sydney,"Hannebery, Dan",34,13,3,21,0,0,0,5
Sydney,"Heeney, Isaac",13,8,5,5,0,2,0,6
Sydney,"Jack, Brandon",8,3,0,5,0,1,0,5
Sydney,"Jetta, Lewis",16,9,3,7,0,0,0,3
Sydney,"Jones, Zak",10,3,0,7,0,0,0,4
Sydney,"Kennedy, Josh",39,16,5,23,0,2,0,8
Sydney,"Laidler, Jeremy",16,9,2,7,1,0,0,2
Sydney,"Lloyd, Jake",20,11,4,9,0,0,0,3
Sydney,"McGlynn, Ben",10,6,5,4,0,2,0,3
Sydney,"McVeigh, Jarrad",23,15,5,8,1,0,0,11
Sydney,"Mitchell, Tom",29,14,4,15,0,1,0,5
Sydney,"Pyke, Mike",5,3,2,2,0,0,11,1
Sydney,"Rampe, Dane",16,11,2,5,0,0,0,2
Sydney,"Reid, Sam",5,3,3,2,1,1,0,1
Sydney,"Richards, Ted",16,2,1,14,0,0,0,3
Sydney,"Rohan, Gary",8,5,5,3,0,1,0,3
Sydney,"Shaw, Rhyce",27,15,7,12,0,0,0,1
Sydney,"Tippett, Kurt",15,12,6,3,3,1,12,6
Sydney,"Towers, Dean",15,9,7,6,1,2,4,2
Sydney,"Cunningham, Harry",13,5,1,8,0,0,0,4
Sydney,"Goodes, Adam",18,15,10,3,2,1,1,2
Sydney,"Grundy, Heath",16,8,5,8,0,0,0,1
Sydney,"Hannebery, Dan",20,6,2,14,1,0,0,3
Sydney,"Heeney, Isaac",13,11,6,2,1,0,0,6
Sydney,"Jetta, Lewis",7,2,0,5,0,0,0,3
Sydney,"Jones, Zak",4,2,1,2,0,0,0,2
Sydney,"Kennedy, Josh",28,14,3,14,1,1,1,11
Sydney,"Laidler, Jeremy",19,8,3,11,0,0,0,1
Sydney,"Lloyd, Jake",17,12,5,5,0,0,0,1
Sydney,"McGlynn, Ben",6,4,2,2,0,0,0,5
Sydney,"McVeigh, Jarrad",21,14,7,7,0,0,0,6
Sydney,"Mitchell, Tom",19,6,3,13,0,0,0,4
Sydney,"Pyke, Mike",9,3,3,6,0,0,19,2
Sydney,"Rampe, Dane",31,23,8,8,0,1,0,6
Sydney,"Richards, Ted",11,6,2,5,0,0,0,1
Sydney,"Rohan, Gary",11,7,4,4,0,1,0,2
Sydney,"Rose, James",9,6,6,3,0,1,0,1
Sydney,"Shaw, Rhyce",11,6,2,5,0,0,0,3
Sydney,"Smith, Nick",24,10,8,14,0,1,0,4
Sydney,"Tippett, Kurt",16,12,10,4,2,1,14,4
Sydney,"Towers, Dean",12,8,4,4,0,0,6,4
West Coast,"Brown, Mitch",2,0,0,2,0,0,0,0
West Coast,"Butler, Sam",18,11,6,7,0,0,0,3
West Coast,"Cripps, Jamie",19,12,5,7,5,0,0,2
West Coast,"Gaff, Andrew",23,11,3,12,1,0,0,4
West Coast,"Hurn, Shannon",22,17,3,5,0,0,0,5
West Coast,"Kennedy, Josh",14,9,5,5,2,2,0,1
West Coast,"Lamb, Tom",10,5,4,5,1,0,0,2
West Coast,"LeCras, Mark",18,7,8,11,1,0,0,1
West Coast,"Lycett, Scott",9,4,4,5,1,0,7,4
West Coast,"Masten, Chris",29,12,7,17,0,0,0,2
West Coast,"McGinnity, Patrick",6,3,0,3,0,0,0,5
West Coast,"McGovern, Jeremy",26,16,12,10,0,0,0,2
West Coast,"Naitanui, Nic",15,4,0,11,1,0,38,2
West Coast,"Nelson, Jackson",9,6,2,3,0,0,0,5
West Coast,"Priddis, Matt",28,7,0,21,0,0,0,5
West Coast,"Rosa, Matt",27,14,9,13,0,1,2,4
West Coast,"Selwood, Scott",19,8,2,11,0,0,0,12
West Coast,"Sheed, Dom",17,8,1,9,0,0,0,0
West Coast,"Sheppard, Brad",15,6,3,9,0,0,0,3
West Coast,"Shuey, Luke",24,9,3,15,2,0,0,7
West Coast,"Wellingham, Sharrod",13,9,6,4,0,0,0,4
West Coast,"Yeo, Elliot",17,10,5,7,0,0,0,3
West Coast,"Bennell, Jamie",11,7,2,4,0,0,0,3
West Coast,"Cripps, Jamie",11,8,4,3,2,0,0,6
West Coast,"Duggan, Liam",5,3,3,2,0,1,0,0
West Coast,"Gaff, Andrew",28,17,5,11,0,2,0,6
West Coast,"Hurn, Shannon",12,8,3,4,0,1,0,2
West Coast,"Kennedy, Josh",15,13,9,2,10,1,0,2
West Coast,"LeCras, Mark",17,17,6,0,4,2,0,3
West Coast,"Lycett, Scott",13,6,5,7,1,1,27,3
West Coast,"Masten, Chris",25,11,6,14,0,1,0,4
West Coast,"McGinnity, Patrick",6,4,1,2,0,0,0,4
West Coast,"McGovern, Jeremy",16,11,8,5,0,0,0,1
West Coast,"Naitanui, Nic",8,2,0,6,1,1,32,5
West Coast,"Nelson, Jackson",13,7,6,6,0,0,0,3
West Coast,"Priddis, Matt",31,10,1,21,0,0,0,7
West Coast,"Rosa, Matt",16,7,2,9,0,0,0,2
West Coast,"Schofield, Will",17,12,6,5,0,0,0,2
West Coast,"Sheed, Dom",23,12,3,11,0,0,0,1
West Coast,"Sheppard, Brad",25,17,4,8,0,0,0,3
West Coast,"Shuey, Luke",24,13,3,11,2,1,0,8
West Coast,"Tunbridge, Simon",10,6,1,4,0,0,0,1
West Coast,"Wellingham, Sharrod",16,7,4,9,0,0,0,2
West Coast,"Yeo, Elliot",14,6,5,8,0,0,0,1
West Coast,"Butler, Sam",16,10,4,6,0,0,0,2
West Coast,"Cripps, Jamie",10,7,6,3,0,1,0,2
West Coast,"Duggan, Liam",4,3,0,1,0,0,0,1
West Coast,"Gaff, Andrew",28,15,6,13,0,0,0,3
West Coast,"Hill, Josh",11,7,5,4,2,0,0,5
West Coast,"Hurn, Shannon",16,9,4,7,0,0,0,0
West Coast,"Kennedy, Josh",12,8,7,4,1,1,0,1
West Coast,"LeCras, Mark",18,13,7,5,5,1,0,1
West Coast,"Lycett, Scott",8,5,2,3,0,0,7,2
West Coast,"Masten, Chris",27,13,3,14,0,0,0,1
West Coast,"McGinnity, Patrick",6,5,1,1,1,1,0,5
West Coast,"McGovern, Jeremy",11,8,4,3,0,0,0,5
West Coast,"Naitanui, Nic",12,5,1,7,2,0,20,3
West Coast,"Nelson, Jackson",12,7,3,5,0,0,0,0
West Coast,"Priddis, Matt",25,10,3,15,0,1,0,7
West Coast,"Rosa, Matt",25,6,4,19,0,0,0,3
West Coast,"Schofield, Will",16,9,7,7,0,0,0,2
West Coast,"Sheed, Dom",20,9,6,11,0,0,0,4
West Coast,"Sheppard, Brad",12,8,5,4,0,1,0,0
West Coast,"Shuey, Luke",17,7,2,10,0,0,0,3
West Coast,"Wellingham, Sharrod",20,14,5,6,1,0,0,2
West Coast,"Yeo, Elliot",14,6,7,8,0,0,0,1
West Coast,"Butler, Sam",28,19,12,9,2,0,0,3
West Coast,"Cripps, Jamie",15,10,4,5,1,3,0,11
West Coast,"Duggan, Liam",11,6,2,5,0,0,0,1
West Coast,"Gaff, Andrew",30,14,4,16,0,0,0,2
West Coast,"Hill, Josh",9,7,3,2,3,1,0,3
West Coast,"Hurn, Shannon",14,12,0,2,0,0,0,5
West Coast,"Kennedy, Josh",17,12,8,5,3,5,0,0
West Coast,"LeCras, Mark",19,12,3,7,1,0,0,4
West Coast,"Lycett, Scott",13,8,5,5,0,1,14,1
West Coast,"Masten, Chris",17,4,0,13,0,0,0,3
West Coast,"McGovern, Jeremy",14,7,8,7,0,0,0,0
West Coast,"McInnes, Fraser",15,7,8,8,1,1,1,0
West Coast,"Naitanui, Nic",10,5,2,5,0,0,38,4
West Coast,"Nelson, Jackson",9,7,1,2,1,0,0,1
West Coast,"Priddis, Matt",28,6,2,22,0,0,0,8
West Coast,"Rosa, Matt",27,10,4,17,1,0,0,0
West Coast,"Schofield, Will",7,4,2,3,0,0,0,1
West Coast,"Sheed, Dom",21,14,1,7,1,0,0,1
West Coast,"Sheppard, Brad",15,9,5,6,1,0,0,1
West Coast,"Shuey, Luke",14,5,1,9,1,1,0,5
West Coast,"Wellingham, Sharrod",14,5,1,9,0,0,0,0
West Coast,"Yeo, Elliot",20,10,4,10,1,2,3,3
West Coast,"Bennell, Jamie",17,12,5,5,0,0,0,3
West Coast,"Butler, Sam",25,16,8,9,0,0,0,0
West Coast,"Cripps, Jamie",16,10,4,6,2,0,0,5
West Coast,"Duggan, Liam",25,15,7,10,0,0,0,3
West Coast,"Gaff, Andrew",32,18,4,14,1,0,0,3
West Coast,"Hill, Josh",19,14,4,5,4,1,0,3
West Coast,"Hurn, Shannon",16,12,4,4,1,2,0,2
West Coast,"Kennedy, Josh",14,10,7,4,6,2,0,2
West Coast,"LeCras, Mark",15,6,4,9,0,1,0,6
West Coast,"Masten, Chris",33,22,11,11,0,1,0,2
West Coast,"McGinnity, Patrick",5,3,1,2,0,0,0,0
West Coast,"McGovern, Jeremy",15,8,8,7,0,0,1,2
West Coast,"McInnes, Fraser",6,3,2,3,0,1,3,1
West Coast,"Naitanui, Nic",8,6,1,2,2,1,19,2
West Coast,"Priddis, Matt",29,6,5,23,0,0,0,9
West Coast,"Schofield, Will",12,8,5,4,0,0,0,1
West Coast,"Sheed, Dom",18,11,4,7,0,0,0,3
West Coast,"Sheppard, Brad",22,13,6,9,0,0,0,2
West Coast,"Shuey, Luke",24,11,3,13,2,0,0,5
West Coast,"Sinclair, Callum",9,8,7,1,0,1,14,1
West Coast,"Wellingham, Sharrod",24,17,8,7,0,0,0,2
West Coast,"Yeo, Elliot",25,13,9,12,0,0,4,5
West Coast,"Bennell, Jamie",6,5,4,1,0,0,0,0
West Coast,"Butler, Sam",19,13,7,6,0,0,0,2
West Coast,"Cripps, Jamie",10,8,4,2,2,2,0,7
West Coast,"Duggan, Liam",14,8,2,6,0,0,0,2
West Coast,"Gaff, Andrew",23,12,6,11,0,0,0,0
West Coast,"Hill, Josh",15,11,3,4,2,1,0,1
West Coast,"Hurn, Shannon",14,10,1,4,0,0,0,2
West Coast,"Kennedy, Josh",14,12,9,2,1,3,0,2
West Coast,"LeCras, Mark",28,17,2,11,1,0,0,6
West Coast,"Masten, Chris",30,14,5,16,0,1,0,3
West Coast,"McGovern, Jeremy",10,8,6,2,0,0,0,2
West Coast,"McInnes, Fraser",9,3,1,6,0,1,1,0
West Coast,"Naitanui, Nic",9,5,2,4,0,0,30,2
West Coast,"Nelson, Jackson",0,0,0,0,0,0,0,0
West Coast,"Priddis, Matt",31,6,0,25,1,0,0,8
West Coast,"Schofield, Will",11,7,4,4,0,0,0,5
West Coast,"Sheed, Dom",18,11,5,7,1,0,0,6
West Coast,"Sheppard, Brad",19,10,7,9,0,0,0,1
West Coast,"Shuey, Luke",23,13,4,10,2,0,1,6
West Coast,"Sinclair, Callum",15,6,6,9,0,0,24,1
West Coast,"Wellingham, Sharrod",22,17,11,5,0,0,0,0
West Coast,"Yeo, Elliot",23,12,5,11,1,2,2,3
West Coast,"Bennell, Jamie",12,6,6,6,0,0,0,3
West Coast,"Butler, Sam",21,12,9,9,0,0,0,1
West Coast,"Cripps, Jamie",11,6,5,5,1,0,0,9
West Coast,"Duggan, Liam",10,6,4,4,0,0,0,1
West Coast,"Gaff, Andrew",24,11,2,13,1,0,0,5
West Coast,"Hill, Josh",14,8,2,6,3,0,0,3
West Coast,"Hurn, Shannon",25,20,12,5,0,1,0,2
West Coast,"Hutchings, Mark",11,2,1,9,0,0,0,4
West Coast,"Kennedy, Josh",10,7,3,3,4,2,0,4
West Coast,"LeCras, Mark",19,16,4,3,3,1,0,2
West Coast,"Masten, Chris",43,24,8,19,0,1,0,2
West Coast,"McInnes, Fraser",22,8,7,14,1,0,1,3
West Coast,"Naitanui, Nic",11,8,0,3,0,0,34,6
West Coast,"Nelson, Jackson",16,8,4,8,0,0,0,2
West Coast,"Priddis, Matt",39,18,6,21,2,0,0,7
West Coast,"Schofield, Will",15,11,8,4,0,0,0,1
West Coast,"Sheed, Dom",24,10,6,14,0,0,0,6
West Coast,"Sheppard, Brad",22,13,9,9,0,0,0,1
West Coast,"Shuey, Luke",28,15,7,13,1,0,0,6
West Coast,"Sinclair, Callum",17,9,4,8,1,0,19,3
West Coast,"Wellingham, Sharrod",25,16,2,9,0,0,0,3
West Coast,"Yeo, Elliot",29,14,9,15,4,2,1,6
West Coast,"Bennell, Jamie",5,2,0,3,0,0,0,2
West Coast,"Butler, Sam",16,7,6,9,0,0,0,2
West Coast,"Cripps, Jamie",12,9,2,3,3,1,0,13
West Coast,"Duggan, Liam",23,16,6,7,0,1,0,4
West Coast,"Gaff, Andrew",33,17,8,16,0,0,0,2
West Coast,"Hill, Josh",11,7,2,4,4,0,0,3
West Coast,"Hurn, Shannon",11,9,2,2,0,0,0,2
West Coast,"Kennedy, Josh",15,10,7,5,4,1,0,4
West Coast,"LeCras, Mark",10,7,3,3,1,0,0,3
West Coast,"Masten, Chris",18,8,2,10,0,1,0,3
West Coast,"McGovern, Jeremy",18,8,6,10,0,0,0,1
West Coast,"McInnes, Fraser",15,7,8,8,1,1,0,3
West Coast,"Naitanui, Nic",14,5,0,9,0,0,37,2
West Coast,"Nelson, Jackson",11,5,1,6,0,1,0,2
West Coast,"Priddis, Matt",32,7,1,25,1,0,0,9
West Coast,"Schofield, Will",14,10,5,4,0,0,0,1
West Coast,"Selwood, Scott",8,5,0,3,0,1,0,4
West Coast,"Sheppard, Brad",13,7,4,6,1,0,0,1
West Coast,"Shuey, Luke",28,14,1,14,1,1,0,1
West Coast,"Sinclair, Callum",13,5,2,8,1,1,21,0
West Coast,"Wellingham, Sharrod",18,9,4,9,0,0,0,0
West Coast,"Yeo, Elliot",15,7,6,8,3,0,1,7
West Coast,"Bennell, Jamie",8,5,2,3,0,0,0,0
West Coast,"Butler, Sam",21,9,9,12,0,0,0,2
West Coast,"Colledge, Brant",6,4,1,2,0,0,0,3
West Coast,"Cripps, Jamie",10,6,2,4,1,2,0,5
West Coast,"Duggan, Liam",15,6,3,9,0,1,0,2
West Coast,"Gaff, Andrew",33,20,9,13,0,0,0,0
West Coast,"Hill, Josh",14,12,5,2,2,3,0,4
West Coast,"Hurn, Shannon",21,15,5,6,0,1,0,1
West Coast,"Kennedy, Josh",20,16,11,4,6,4,0,3
West Coast,"LeCras, Mark",26,23,6,3,1,2,0,2
West Coast,"Masten, Chris",31,14,5,17,0,1,0,1
West Coast,"McGovern, Jeremy",17,9,8,8,0,1,0,1
West Coast,"McInnes, Fraser",9,4,4,5,1,0,0,2
West Coast,"Naitanui, Nic",17,8,2,9,2,0,36,3
West Coast,"Nelson, Jackson",17,11,3,6,0,0,0,1
West Coast,"Priddis, Matt",29,9,2,20,0,1,0,2
West Coast,"Schofield, Will",3,1,3,2,0,0,0,2
West Coast,"Selwood, Scott",20,10,2,10,0,1,0,6
West Coast,"Sheppard, Brad",17,8,4,9,0,0,0,1
West Coast,"Shuey, Luke",24,9,5,15,1,1,1,9
West Coast,"Sinclair, Callum",14,8,6,6,2,2,19,3
West Coast,"Wellingham, Sharrod",23,12,5,11,0,0,0,2
West Coast,"Butler, Sam",15,10,4,5,0,1,0,1
West Coast,"Cripps, Jamie",9,3,1,6,1,0,0,5
West Coast,"Duggan, Liam",15,6,4,9,1,0,0,2
West Coast,"Gaff, Andrew",32,17,6,15,1,0,0,5
West Coast,"Hill, Josh",11,5,0,6,0,1,0,7
West Coast,"Hurn, Shannon",17,15,3,2,1,0,0,0
West Coast,"Kennedy, Josh",11,5,7,6,3,0,0,3
West Coast,"LeCras, Mark",13,8,2,5,0,1,0,5
West Coast,"Masten, Chris",24,9,1,15,0,0,0,3
West Coast,"McGovern, Jeremy",16,8,2,8,0,0,0,2
West Coast,"McInnes, Fraser",8,3,2,5,2,0,0,1
West Coast,"Naitanui, Nic",13,10,2,3,0,4,30,5
West Coast,"Nelson, Jackson",7,4,2,3,0,0,0,3
West Coast,"Priddis, Matt",32,11,1,21,0,0,0,11
West Coast,"Schofield, Will",9,4,3,5,0,0,0,0
West Coast,"Selwood, Scott",10,6,3,4,0,0,0,3
West Coast,"Sheed, Dom",12,5,0,7,0,0,0,3
West Coast,"Sheppard, Brad",19,12,2,7,0,0,0,3
West Coast,"Shuey, Luke",29,14,3,15,0,1,1,3
West Coast,"Sinclair, Callum",7,4,0,3,0,0,14,1
West Coast,"Wellingham, Sharrod",24,12,4,12,1,0,0,0
West Coast,"Yeo, Elliot",21,13,10,8,0,0,1,3
West Coast,"Butler, Sam",17,11,10,6,0,0,0,2
West Coast,"Cripps, Jamie",20,18,8,2,0,2,0,7
West Coast,"Darling, Jack",9,4,4,5,2,1,0,1
West Coast,"Duggan, Liam",11,7,3,4,0,1,0,3
West Coast,"Ellis, Xavier",17,11,4,6,0,0,0,1
West Coast,"Gaff, Andrew",33,18,4,15,1,0,0,0
West Coast,"Hill, Josh",18,14,5,4,1,1,0,3
West Coast,"Hurn, Shannon",13,7,1,6,0,0,0,2
West Coast,"Kennedy, Josh",12,8,7,4,3,2,0,2
West Coast,"LeCras, Mark",21,14,8,7,4,3,0,2
West Coast,"Masten, Chris",24,12,4,12,0,0,0,3
West Coast,"McGovern, Jeremy",6,2,3,4,0,0,0,0
West Coast,"Naitanui, Nic",11,7,0,4,1,1,43,3
West Coast,"Priddis, Matt",32,9,1,23,0,0,0,5
West Coast,"Schofield, Will",14,10,7,4,0,0,0,2
West Coast,"Selwood, Scott",19,10,4,9,1,0,0,5
West Coast,"Sheed, Dom",3,1,0,2,0,0,0,2
West Coast,"Sheppard, Brad",16,8,2,8,0,0,0,3
West Coast,"Shuey, Luke",20,6,2,14,0,0,0,5
West Coast,"Sinclair, Callum",14,8,3,6,1,0,30,1
West Coast,"Wellingham, Sharrod",16,9,6,7,0,0,0,2
West Coast,"Yeo, Elliot",16,8,2,8,0,0,0,3
West Coast,"Cripps, Jamie",10,6,3,4,2,0,0,4
West Coast,"Darling, Jack",11,7,4,4,2,3,0,2
West Coast,"Duggan, Liam",2,1,0,1,0,0,0,0
West Coast,"Ellis, Xavier",24,16,10,8,0,0,0,2
West Coast,"Gaff, Andrew",31,20,6,11,0,1,0,3
West Coast,"Hill, Josh",7,5,4,2,0,0,0,1
West Coast,"Hurn, Shannon",13,9,5,4,0,0,0,0
West Coast,"Kennedy, Josh",11,8,5,3,3,3,0,1
West Coast,"LeCras, Mark",19,8,3,11,2,0,0,1
West Coast,"Masten, Chris",25,14,6,11,0,0,0,1
West Coast,"McGovern, Jeremy",15,13,7,2,0,0,0,2
West Coast,"Naitanui, Nic",12,4,0,8,2,0,33,5
West Coast,"Priddis, Matt",27,7,2,20,0,0,0,9
West Coast,"Rosa, Matt",20,11,7,9,0,1,0,2
West Coast,"Schofield, Will",13,9,7,4,0,0,0,0
West Coast,"Selwood, Scott",25,14,8,11,0,2,0,4
West Coast,"Sheed, Dom",22,9,6,13,1,0,0,1
West Coast,"Sheppard, Brad",19,12,7,7,0,0,0,3
West Coast,"Shuey, Luke",22,8,4,14,0,0,0,3
West Coast,"Sinclair, Callum",5,0,0,5,0,0,13,0
West Coast,"Wellingham, Sharrod",15,8,8,7,0,0,0,2
West Coast,"Yeo, Elliot",21,16,8,5,1,0,0,6
West Coast,"Butler, Sam",13,8,2,5,0,0,0,4
West Coast,"Cripps, Jamie",14,12,6,2,2,1,0,6
West Coast,"Darling, Jack",16,14,10,2,5,2,0,3
West Coast,"Duggan, Liam",7,5,3,2,0,0,0,0
West Coast,"Ellis, Xavier",12,10,3,2,0,0,0,2
West Coast,"Gaff, Andrew",28,21,4,7,0,0,0,3
West Coast,"Hill, Josh",8,6,3,2,1,2,0,1
West Coast,"Hurn, Shannon",14,8,6,6,0,0,0,0
West Coast,"Kennedy, Josh",14,12,9,2,2,4,0,2
West Coast,"LeCras, Mark",16,10,5,6,1,2,0,6
West Coast,"Masten, Chris",27,14,5,13,0,1,0,3
West Coast,"McGovern, Jeremy",9,6,6,3,1,0,0,0
West Coast,"Naitanui, Nic",9,5,1,4,0,0,36,4
West Coast,"Priddis, Matt",22,6,0,16,0,0,0,11
West Coast,"Schofield, Will",20,12,8,8,0,0,0,1
West Coast,"Selwood, Scott",10,7,0,3,0,0,0,0
West Coast,"Sheed, Dom",24,13,4,11,1,0,0,2
West Coast,"Sheppard, Brad",17,10,6,7,0,0,0,0
West Coast,"Shuey, Luke",20,9,5,11,2,1,0,3
West Coast,"Sinclair, Callum",7,5,1,2,1,0,22,2
West Coast,"Wellingham, Sharrod",24,10,8,14,0,0,0,1
West Coast,"Yeo, Elliot",16,7,3,9,0,0,1,5
West Coast,"Cripps, Jamie",26,15,9,11,1,2,0,6
West Coast,"Darling, Jack",9,6,6,3,2,0,0,1
West Coast,"Ellis, Xavier",17,12,5,5,0,0,0,1
West Coast,"Gaff, Andrew",36,27,6,9,3,0,0,4
West Coast,"Hill, Josh",14,11,5,3,2,2,0,3
West Coast,"Hurn, Shannon",18,15,8,3,0,1,0,0
West Coast,"Hutchings, Mark",6,2,0,4,0,0,0,1
West Coast,"Kennedy, Josh",9,5,5,4,2,2,0,4
West Coast,"LeCras, Mark",23,14,8,9,2,2,0,2
West Coast,"Masten, Chris",33,14,7,19,1,0,0,0
West Coast,"McGovern, Jeremy",16,8,6,8,0,0,0,1
West Coast,"Naitanui, Nic",19,7,4,12,0,0,39,4
West Coast,"Priddis, Matt",35,15,4,20,1,0,0,8
West Coast,"Rosa, Matt",28,13,7,15,0,0,0,0
West Coast,"Schofield, Will",12,9,7,3,0,0,0,0
West Coast,"Selwood, Scott",23,6,3,17,1,1,0,4
West Coast,"Sheed, Dom",26,12,3,14,1,1,0,4
West Coast,"Sheppard, Brad",17,9,5,8,0,1,0,2
West Coast,"Shuey, Luke",31,12,4,19,2,0,0,3
West Coast,"Sinclair, Callum",14,7,5,7,0,1,18,1
West Coast,"Wellingham, Sharrod",15,12,2,3,1,0,0,0
West Coast,"Yeo, Elliot",26,13,5,13,3,0,0,2
West Coast,"Cripps, Jamie",21,13,5,8,2,2,0,7
West Coast,"Darling, Jack",12,5,5,7,0,0,0,2
West Coast,"Ellis, Xavier",17,10,6,7,0,0,0,0
West Coast,"Gaff, Andrew",34,19,7,15,0,1,0,2
West Coast,"Hill, Josh",17,9,6,8,1,1,0,0
West Coast,"Hurn, Shannon",23,15,10,8,0,0,0,0
West Coast,"Hutchings, Mark",7,6,2,1,0,0,0,2
West Coast,"Kennedy, Josh",11,9,6,2,3,2,0,3
West Coast,"LeCras, Mark",23,15,6,8,3,1,0,1
West Coast,"Masten, Chris",29,15,5,14,1,1,0,2
West Coast,"McGovern, Jeremy",11,4,3,7,0,0,0,1
West Coast,"Naitanui, Nic",13,6,4,7,1,1,33,6
West Coast,"Priddis, Matt",29,10,2,19,0,0,0,4
West Coast,"Rosa, Matt",24,11,4,13,0,0,0,2
West Coast,"Schofield, Will",12,6,5,6,0,0,0,1
West Coast,"Selwood, Scott",12,4,2,8,0,1,0,0
West Coast,"Sheed, Dom",22,11,6,11,0,3,0,1
West Coast,"Sheppard, Brad",14,10,9,4,0,0,0,0
West Coast,"Shuey, Luke",13,6,2,7,0,1,0,5
West Coast,"Sinclair, Callum",15,11,10,4,0,2,11,2
West Coast,"Wellingham, Sharrod",17,11,5,6,0,0,0,1
West Coast,"Yeo, Elliot",18,13,6,5,0,0,0,3
West Coast,"Barrass, Tom",15,7,5,8,0,0,0,1
West Coast,"Cripps, Jamie",16,11,3,5,1,3,0,5
West Coast,"Darling, Jack",10,7,5,3,3,1,0,5
West Coast,"Ellis, Xavier",16,8,4,8,0,0,0,2
West Coast,"Gaff, Andrew",32,20,2,12,1,0,0,1
West Coast,"Hill, Josh",8,4,3,4,1,0,0,1
West Coast,"Hurn, Shannon",22,16,3,6,0,0,0,2
West Coast,"Hutchings, Mark",26,10,2,16,0,0,0,4
West Coast,"Kennedy, Josh",9,6,3,3,3,2,0,1
West Coast,"LeCras, Mark",24,5,3,19,2,1,0,3
West Coast,"Masten, Chris",28,12,3,16,0,0,0,2
West Coast,"Naitanui, Nic",12,7,4,5,1,0,41,6
West Coast,"Priddis, Matt",34,12,4,22,1,0,0,13
West Coast,"Rosa, Matt",12,5,4,7,0,0,0,0
West Coast,"Schofield, Will",6,3,2,3,0,0,0,0
West Coast,"Selwood, Scott",7,2,0,5,0,0,0,2
West Coast,"Sheed, Dom",22,8,1,14,0,1,0,1
West Coast,"Sheppard, Brad",23,17,10,6,0,0,0,1
West Coast,"Shuey, Luke",25,10,3,15,1,0,0,4
West Coast,"Sinclair, Callum",21,14,9,7,1,0,29,2
West Coast,"Wellingham, Sharrod",26,12,8,14,0,0,0,1
West Coast,"Yeo, Elliot",22,12,7,10,0,0,1,6
West Coast,"Barrass, Tom",11,8,6,3,0,0,0,1
West Coast,"Cripps, Jamie",16,10,3,6,0,1,0,4
West Coast,"Darling, Jack",15,8,7,7,2,3,0,6
West Coast,"Ellis, Xavier",16,14,6,2,1,0,0,0
West Coast,"Gaff, Andrew",28,20,5,8,0,1,0,1
West Coast,"Hill, Josh",6,3,2,3,0,0,0,0
West Coast,"Hurn, Shannon",21,18,4,3,1,0,0,2
West Coast,"Hutchings, Mark",15,8,4,7,0,1,1,3
West Coast,"Kennedy, Josh",6,5,3,1,2,1,0,3
West Coast,"LeCras, Mark",14,8,2,6,1,2,0,1
West Coast,"Masten, Chris",30,7,2,23,0,0,0,2
West Coast,"Naitanui, Nic",8,5,0,3,0,2,33,3
West Coast,"Priddis, Matt",34,17,1,17,0,2,0,7
West Coast,"Rosa, Matt",18,7,4,11,0,0,0,2
West Coast,"Schofield, Will",11,8,7,3,0,0,0,0
West Coast,"Selwood, Scott",8,5,0,3,0,0,0,1
West Coast,"Sheed, Dom",23,12,5,11,2,1,0,4
West Coast,"Sheppard, Brad",18,8,6,10,0,0,0,1
West Coast,"Shuey, Luke",33,16,4,17,0,1,0,3
West Coast,"Sinclair, Callum",18,10,8,8,1,1,20,3
West Coast,"Wellingham, Sharrod",18,14,2,4,0,0,0,4
West Coast,"Yeo, Elliot",16,12,3,4,1,0,0,2
West Coast,"Butler, Sam",12,7,1,5,0,0,0,0
West Coast,"Cripps, Jamie",9,6,1,3,2,0,0,4
West Coast,"Darling, Jack",6,4,4,2,2,0,0,3
West Coast,"Ellis, Xavier",12,10,4,2,0,0,0,2
West Coast,"Gaff, Andrew",35,21,4,14,0,1,0,3
West Coast,"Hurn, Shannon",10,8,2,2,0,0,0,1
West Coast,"Hutchings, Mark",19,10,3,9,1,0,0,9
West Coast,"Kennedy, Josh",7,6,5,1,4,2,0,2
West Coast,"LeCras, Mark",19,12,4,7,0,1,1,1
West Coast,"Lycett, Scott",20,10,0,10,0,0,39,7
West Coast,"Masten, Chris",19,9,0,10,0,0,0,5
West Coast,"McGinnity, Patrick",11,5,3,6,0,1,0,2
West Coast,"McGovern, Jeremy",14,9,2,5,0,0,9,1
West Coast,"Priddis, Matt",28,13,0,15,0,0,0,4
West Coast,"Rosa, Matt",5,2,0,3,1,0,0,0
West Coast,"Schofield, Will",10,7,6,3,0,0,0,1
West Coast,"Selwood, Scott",11,6,2,5,0,0,0,8
West Coast,"Sheed, Dom",8,3,1,5,0,0,0,0
West Coast,"Sheppard, Brad",15,10,6,5,0,0,0,4
West Coast,"Shuey, Luke",27,15,2,12,1,2,1,8
West Coast,"Wellingham, Sharrod",13,8,4,5,0,0,0,1
West Coast,"Yeo, Elliot",11,8,2,3,0,1,2,2
West Coast,"Bennell, Jamie",10,6,3,4,0,0,0,2
West Coast,"Butler, Sam",13,10,5,3,0,0,0,2
West Coast,"Cripps, Jamie",6,2,2,4,0,1,0,2
West Coast,"Darling, Jack",14,9,6,5,2,1,0,1
West Coast,"Ellis, Xavier",13,9,6,4,0,0,0,0
West Coast,"Gaff, Andrew",23,14,4,9,0,0,0,0
West Coast,"Hill, Josh",20,14,4,6,4,2,0,3
West Coast,"Hurn, Shannon",16,14,8,2,0,0,0,2
West Coast,"Hutchings, Mark",18,12,5,6,1,0,0,3
West Coast,"Kennedy, Josh",18,15,7,3,2,3,0,2
West Coast,"Lycett, Scott",4,2,2,2,1,0,4,3
West Coast,"Masten, Chris",16,8,4,8,0,1,0,1
West Coast,"McGinnity, Patrick",10,6,1,4,1,1,0,5
West Coast,"Priddis, Matt",21,10,2,11,0,0,0,5
West Coast,"Rosa, Matt",24,9,5,15,1,0,0,3
West Coast,"Schofield, Will",7,3,1,4,0,0,0,1
West Coast,"Sheed, Dom",15,8,3,7,0,2,0,2
West Coast,"Sheppard, Brad",17,12,8,5,0,0,0,0
West Coast,"Shuey, Luke",19,12,4,7,1,0,0,9
West Coast,"Sinclair, Callum",10,5,3,5,1,1,13,3
West Coast,"Wellingham, Sharrod",12,10,5,2,0,0,0,1
West Coast,"Yeo, Elliot",10,9,4,1,1,0,0,2
West Coast,"Bennell, Jamie",16,7,1,9,0,0,0,0
West Coast,"Cripps, Jamie",18,10,5,8,1,2,0,7
West Coast,"Darling, Jack",15,9,6,6,1,0,0,2
West Coast,"Ellis, Xavier",18,13,5,5,0,0,0,1
West Coast,"Gaff, Andrew",35,18,5,17,0,1,0,4
West Coast,"Hill, Josh",14,8,6,6,4,0,0,2
West Coast,"Hurn, Shannon",11,6,4,5,0,0,0,1
West Coast,"Hutchings, Mark",25,14,4,11,2,0,0,8
West Coast,"Kennedy, Josh",21,15,14,6,7,3,0,3
West Coast,"LeCras, Mark",17,12,6,5,3,2,0,2
West Coast,"McGinnity, Patrick",10,6,2,4,1,0,0,5
West Coast,"Naitanui, Nic",14,4,2,10,1,0,48,3
West Coast,"Nelson, Jackson",6,5,1,1,0,0,0,4
West Coast,"Newman, Murray",5,2,1,3,1,0,0,0
West Coast,"Priddis, Matt",37,15,4,22,0,0,0,7
West Coast,"Rosa, Matt",22,11,4,11,0,0,0,3
West Coast,"Sheed, Dom",22,6,3,16,1,1,0,3
West Coast,"Sheppard, Brad",16,9,7,7,0,0,0,2
West Coast,"Shuey, Luke",31,12,3,19,1,0,0,6
West Coast,"Sinclair, Callum",15,8,5,7,2,0,22,1
West Coast,"Wellingham, Sharrod",14,9,2,5,0,0,0,2
West Coast,"Yeo, Elliot",10,7,2,3,0,0,0,0
West Coast,"Barrass, Tom",11,7,6,4,0,0,0,0
West Coast,"Bennell, Jamie",10,6,2,4,0,0,0,2
West Coast,"Cripps, Jamie",13,8,4,5,2,0,0,4
West Coast,"Darling, Jack",14,9,6,5,0,2,0,4
West Coast,"Ellis, Xavier",13,12,5,1,0,0,0,3
West Coast,"Gaff, Andrew",23,13,2,10,0,0,0,0
West Coast,"Hill, Josh",10,5,4,5,0,0,0,2
West Coast,"Hurn, Shannon",11,6,3,5,0,1,0,2
West Coast,"Hutchings, Mark",14,6,3,8,1,0,0,3
West Coast,"Kennedy, Josh",11,8,1,3,1,1,0,2
West Coast,"LeCras, Mark",13,11,4,2,2,2,0,1
West Coast,"McGinnity, Patrick",10,4,1,6,1,0,0,1
West Coast,"McGovern, Jeremy",9,6,3,3,0,0,0,0
West Coast,"Naitanui, Nic",10,5,4,5,0,1,26,3
West Coast,"Newman, Murray",7,4,3,3,0,0,0,0
West Coast,"Priddis, Matt",22,8,0,14,0,0,0,5
West Coast,"Rosa, Matt",20,12,6,8,0,0,0,5
West Coast,"Sheed, Dom",27,16,2,11,1,0,0,1
West Coast,"Sheppard, Brad",16,11,4,5,0,0,0,1
West Coast,"Shuey, Luke",25,13,5,12,1,0,0,5
West Coast,"Sinclair, Callum",7,4,3,3,1,1,11,2
West Coast,"Yeo, Elliot",9,3,4,6,0,0,0,0
West Coast,"Butler, Sam",16,9,5,7,0,0,0,1
West Coast,"Cripps, Jamie",12,4,3,8,1,1,0,7
West Coast,"Darling, Jack",13,7,2,6,2,2,0,4
West Coast,"Ellis, Xavier",12,8,5,4,0,0,0,1
West Coast,"Gaff, Andrew",36,14,3,22,2,0,0,4
West Coast,"Hill, Josh",15,6,7,9,1,1,0,2
West Coast,"Hurn, Shannon",18,12,6,6,0,1,0,0
West Coast,"Hutchings, Mark",29,10,6,19,0,0,0,7
West Coast,"Kennedy, Josh",17,9,6,8,3,4,0,0
West Coast,"LeCras, Mark",14,9,5,5,4,1,0,2
West Coast,"Masten, Chris",10,3,1,7,0,2,0,0
West Coast,"McGovern, Jeremy",10,8,5,2,0,0,0,2
West Coast,"Naitanui, Nic",16,8,1,8,3,1,30,4
West Coast,"Nelson, Jackson",13,9,2,4,0,0,0,4
West Coast,"Priddis, Matt",35,9,2,26,0,0,0,11
West Coast,"Rosa, Matt",19,8,5,11,0,1,0,5
West Coast,"Sheed, Dom",33,20,4,13,0,1,0,0
West Coast,"Sheppard, Brad",17,12,5,5,0,1,0,1
West Coast,"Shuey, Luke",30,15,6,15,0,0,1,5
West Coast,"Sinclair, Callum",14,7,4,7,1,0,27,2
West Coast,"Wellingham, Sharrod",22,9,6,13,0,0,0,4
West Coast,"Yeo, Elliot",17,8,6,9,1,1,1,7
West Coast,"Butler, Sam",13,6,0,7,0,1,0,1
West Coast,"Cripps, Jamie",13,9,4,4,2,1,0,6
West Coast,"Darling, Jack",6,3,3,3,1,0,0,5
West Coast,"Ellis, Xavier",9,9,3,0,0,0,0,3
West Coast,"Gaff, Andrew",24,13,2,11,0,0,0,2
West Coast,"Hill, Josh",14,11,6,3,3,0,0,2
West Coast,"Hurn, Shannon",26,19,5,7,0,0,0,4
West Coast,"Hutchings, Mark",24,14,3,10,1,0,0,5
West Coast,"Kennedy, Josh",16,10,9,6,3,2,0,0
West Coast,"LeCras, Mark",20,16,9,4,2,1,0,4
West Coast,"McGinnity, Patrick",2,0,0,2,0,0,0,0
West Coast,"McGovern, Jeremy",7,4,3,3,0,0,0,0
West Coast,"Naitanui, Nic",12,7,1,5,0,0,40,1
West Coast,"Rosa, Matt",26,9,5,17,0,0,0,5
West Coast,"Schofield, Will",9,7,1,2,0,0,0,2
West Coast,"Selwood, Scott",19,13,1,6,0,0,0,4
West Coast,"Sheed, Dom",19,10,3,9,0,1,0,2
West Coast,"Sheppard, Brad",13,12,5,1,1,0,0,0
West Coast,"Shuey, Luke",25,13,3,12,0,1,0,2
West Coast,"Sinclair, Callum",11,7,4,4,0,0,19,1
West Coast,"Wellingham, Sharrod",15,8,4,7,0,0,0,6
West Coast,"Yeo, Elliot",19,12,6,7,1,2,0,3
West Coast,"Butler, Sam",16,8,5,8,0,0,0,4
West Coast,"Cripps, Jamie",13,9,5,4,0,4,0,2
West Coast,"Darling, Jack",11,10,6,1,1,2,0,5
West Coast,"Ellis, Xavier",21,16,5,5,0,0,0,2
West Coast,"Gaff, Andrew",20,9,1,11,0,1,0,3
West Coast,"Hill, Josh",10,5,3,5,1,1,0,5
West Coast,"Hurn, Shannon",13,6,2,7,0,0,0,5
West Coast,"Hutchings, Mark",15,7,3,8,0,0,0,7
West Coast,"Kennedy, Josh",20,18,9,2,2,3,0,4
West Coast,"LeCras, Mark",18,15,10,3,1,3,0,5
West Coast,"Masten, Chris",10,5,0,5,0,0,0,4
West Coast,"McGovern, Jeremy",19,10,5,9,0,1,0,0
West Coast,"Naitanui, Nic",11,6,2,5,0,0,29,3
West Coast,"Priddis, Matt",26,9,1,17,1,0,0,7
West Coast,"Rosa, Matt",3,1,1,2,0,0,0,0
West Coast,"Schofield, Will",12,8,3,4,0,0,0,1
West Coast,"Sheed, Dom",19,15,3,4,1,0,0,2
West Coast,"Sheppard, Brad",15,11,7,4,0,1,0,2
West Coast,"Shuey, Luke",11,7,1,4,2,0,0,4
West Coast,"Sinclair, Callum",15,8,3,7,0,0,13,1
West Coast,"Wellingham, Sharrod",27,17,3,10,1,0,0,2
West Coast,"Yeo, Elliot",16,8,1,8,0,0,2,7
West Coast,"Butler, Sam",25,15,3,10,0,1,0,2
West Coast,"Cripps, Jamie",15,6,5,9,0,1,0,3
West Coast,"Darling, Jack",10,6,4,4,1,1,0,2
West Coast,"Ellis, Xavier",9,6,5,3,0,0,0,2
West Coast,"Gaff, Andrew",34,16,3,18,0,0,0,2
West Coast,"Hill, Josh",10,8,3,2,1,1,0,2
West Coast,"Hurn, Shannon",14,11,5,3,0,1,0,0
West Coast,"Hutchings, Mark",21,8,0,13,1,0,0,1
West Coast,"Kennedy, Josh",9,5,6,4,0,0,0,1
West Coast,"LeCras, Mark",16,9,4,7,1,2,0,2
West Coast,"Masten, Chris",20,8,1,12,0,0,0,1
West Coast,"McGovern, Jeremy",10,6,4,4,2,0,1,1
West Coast,"Naitanui, Nic",4,3,0,1,0,1,37,3
West Coast,"Priddis, Matt",25,9,0,16,0,1,0,7
West Coast,"Rosa, Matt",11,5,0,6,0,1,0,0
West Coast,"Schofield, Will",12,5,3,7,0,0,0,1
West Coast,"Sheed, Dom",11,5,0,6,0,0,0,3
West Coast,"Sheppard, Brad",15,10,5,5,0,0,0,3
West Coast,"Shuey, Luke",26,9,2,17,1,1,0,5
West Coast,"Sinclair, Callum",4,0,0,4,0,0,10,2
West Coast,"Wellingham, Sharrod",15,6,2,9,0,0,0,0
West Coast,"Yeo, Elliot",5,2,1,3,1,0,1,2
Western Bulldogs,"Bontempelli, Marcus",22,12,1,10,1,0,2,10
Western Bulldogs,"Boyd, Matthew",33,18,8,15,0,0,0,1
Western Bulldogs,"Boyd, Tom",11,7,2,4,1,1,4,3
Western Bulldogs,"Crameri, Stewart",22,7,6,15,0,2,0,1
Western Bulldogs,"Dahlhaus, Luke",22,13,5,9,1,1,0,9
Western Bulldogs,"Dickson, Tory",11,6,3,5,2,0,0,5
Western Bulldogs,"Goodes, Brett",14,8,3,6,0,0,0,7
Western Bulldogs,"Grant, Jarrad",4,3,2,1,0,1,0,0
Western Bulldogs,"Honeychurch, Mitch",13,10,1,3,1,0,0,7
Western Bulldogs,"Johannisen, Jason",22,9,3,13,2,0,0,2
Western Bulldogs,"Jong, Lin",24,11,3,13,0,0,1,7
Western Bulldogs,"Macrae, Jack",31,16,8,15,0,0,0,1
Western Bulldogs,"Minson, Will",15,11,0,4,0,1,28,7
Western Bulldogs,"Morris, Dale",13,9,4,4,0,0,0,10
Western Bulldogs,"Murphy, Robert",18,13,2,5,0,0,0,1
Western Bulldogs,"Picken, Liam",13,5,4,8,1,0,0,5
Western Bulldogs,"Redpath, Jack",5,4,1,1,1,0,1,0
Western Bulldogs,"Roughead, Jordan",13,8,9,5,0,0,0,2
Western Bulldogs,"Stringer, Jake",16,12,4,4,3,3,0,3
Western Bulldogs,"Talia, Michael",14,11,7,3,0,0,0,3
Western Bulldogs,"Wallis, Mitch",24,7,0,17,0,0,0,7
Western Bulldogs,"Wood, Easton",12,8,3,4,1,0,0,3
Western Bulldogs,"Bontempelli, Marcus",27,19,6,8,0,2,1,10
Western Bulldogs,"Boyd, Matthew",25,17,10,8,0,1,1,4
Western Bulldogs,"Boyd, Tom",4,1,1,3,0,0,4,4
Western Bulldogs,"Cordy, Ayce",2,0,0,2,0,0,4,1
Western Bulldogs,"Crameri, Stewart",11,4,1,7,2,0,0,0
Western Bulldogs,"Dahlhaus, Luke",23,11,5,12,0,0,0,8
Western Bulldogs,"Dickson, Tory",17,12,5,5,4,2,0,3
Western Bulldogs,"Goodes, Brett",5,5,0,0,0,1,0,1
Western Bulldogs,"Grant, Jarrad",10,6,3,4,1,1,0,3
Western Bulldogs,"Honeychurch, Mitch",18,7,4,11,1,1,0,6
Western Bulldogs,"Johannisen, Jason",14,12,5,2,0,0,0,1
Western Bulldogs,"Jong, Lin",13,6,3,7,0,0,1,5
Western Bulldogs,"Macrae, Jack",26,15,7,11,0,1,0,3
Western Bulldogs,"Minson, Will",9,4,2,5,0,0,30,5
Western Bulldogs,"Morris, Dale",6,3,3,3,0,0,0,2
Western Bulldogs,"Murphy, Robert",24,17,3,7,0,0,0,1
Western Bulldogs,"Picken, Liam",15,8,5,7,0,0,0,6
Western Bulldogs,"Roughead, Jordan",8,3,4,5,0,0,0,1
Western Bulldogs,"Stringer, Jake",11,11,4,0,2,1,0,0
Western Bulldogs,"Talia, Michael",12,6,4,6,0,0,0,1
Western Bulldogs,"Wallis, Mitch",26,12,1,14,1,0,0,5
Western Bulldogs,"Wood, Easton",20,16,7,4,1,0,0,3
Western Bulldogs,"Boyd, Tom",14,8,6,6,3,0,0,1
Western Bulldogs,"Cordy, Ayce",2,0,0,2,0,0,6,1
Western Bulldogs,"Crameri, Stewart",17,6,3,11,1,0,1,1
Western Bulldogs,"Dahlhaus, Luke",29,11,2,18,1,0,0,5
Western Bulldogs,"Dickson, Tory",12,9,3,3,0,2,0,4
Western Bulldogs,"Goodes, Brett",5,4,0,1,0,0,0,3
Western Bulldogs,"Grant, Jarrad",13,5,2,8,0,1,0,6
Western Bulldogs,"Honeychurch, Mitch",14,7,2,7,1,1,0,2
Western Bulldogs,"Hrovat, Nathan",16,6,2,10,0,0,0,2
Western Bulldogs,"Johannisen, Jason",18,10,4,8,0,0,0,3
Western Bulldogs,"Jong, Lin",23,10,4,13,1,0,0,6
Western Bulldogs,"Macrae, Jack",18,10,4,8,0,0,2,4
Western Bulldogs,"Minson, Will",16,10,3,6,1,0,21,2
Western Bulldogs,"Morris, Dale",5,4,4,1,0,0,0,0
Western Bulldogs,"Murphy, Robert",24,20,4,4,0,0,0,1
Western Bulldogs,"Picken, Liam",15,6,4,9,0,0,0,3
Western Bulldogs,"Roughead, Jordan",12,5,5,7,0,0,0,2
Western Bulldogs,"Stevens, Koby",16,8,2,8,0,0,2,2
Western Bulldogs,"Stringer, Jake",12,7,1,5,0,0,1,4
Western Bulldogs,"Talia, Michael",27,10,7,17,0,0,0,2
Western Bulldogs,"Wallis, Mitch",4,2,0,2,0,0,0,0
Western Bulldogs,"Webb, Lukas",10,8,3,2,0,0,0,1
Western Bulldogs,"Bontempelli, Marcus",17,12,2,5,1,1,2,7
Western Bulldogs,"Boyd, Matthew",28,20,12,8,0,0,0,1
Western Bulldogs,"Boyd, Tom",8,4,3,4,2,0,1,4
Western Bulldogs,"Cordy, Ayce",10,4,2,6,1,0,13,3
Western Bulldogs,"Crameri, Stewart",15,5,2,10,1,2,0,5
Western Bulldogs,"Dahlhaus, Luke",27,17,5,10,1,2,0,6
Western Bulldogs,"Dickson, Tory",12,9,1,3,0,1,0,3
Western Bulldogs,"Grant, Jarrad",13,6,5,7,1,1,1,5
Western Bulldogs,"Honeychurch, Mitch",6,0,0,6,0,0,0,3
Western Bulldogs,"Hrovat, Nathan",20,12,5,8,0,2,0,4
Western Bulldogs,"Johannisen, Jason",25,18,7,7,0,1,0,1
Western Bulldogs,"Jong, Lin",21,7,3,14,2,0,4,3
Western Bulldogs,"Macrae, Jack",28,13,5,15,1,0,0,7
Western Bulldogs,"Murphy, Robert",25,17,1,8,0,0,0,0
Western Bulldogs,"Picken, Liam",29,14,7,15,1,1,2,4
Western Bulldogs,"Roughead, Jordan",12,3,4,9,0,0,5,2
Western Bulldogs,"Smith, Clay",11,6,3,5,1,0,0,2
Western Bulldogs,"Stevens, Koby",26,12,4,14,0,1,1,7
Western Bulldogs,"Stringer, Jake",15,11,4,4,6,2,0,3
Western Bulldogs,"Talia, Michael",23,16,13,7,0,0,0,0
Western Bulldogs,"Webb, Lukas",16,11,7,5,0,0,0,0
Western Bulldogs,"Wood, Easton",14,8,10,6,0,0,0,1
Western Bulldogs,"Bontempelli, Marcus",23,18,2,5,2,0,0,6
Western Bulldogs,"Boyd, Matthew",22,15,4,7,0,0,0,3
Western Bulldogs,"Boyd, Tom",9,5,3,4,2,0,0,2
Western Bulldogs,"Cordy, Ayce",5,2,0,3,0,0,7,0
Western Bulldogs,"Crameri, Stewart",20,7,1,13,2,0,1,4
Western Bulldogs,"Dahlhaus, Luke",27,18,2,9,0,0,0,6
Western Bulldogs,"Dickson, Tory",18,5,0,13,0,1,0,9
Western Bulldogs,"Honeychurch, Mitch",18,10,2,8,2,2,1,3
Western Bulldogs,"Hrovat, Nathan",10,4,1,6,0,1,0,2
Western Bulldogs,"Johannisen, Jason",22,16,4,6,0,0,0,1
Western Bulldogs,"Jong, Lin",14,9,0,5,1,1,9,8
Western Bulldogs,"Macrae, Jack",21,15,1,6,0,0,2,5
Western Bulldogs,"Murphy, Robert",24,21,4,3,0,1,0,0
Western Bulldogs,"Picken, Liam",33,19,4,14,0,0,0,12
Western Bulldogs,"Roberts, Fletcher",5,1,2,4,0,0,0,7
Western Bulldogs,"Roughead, Jordan",5,2,2,3,0,0,14,5
Western Bulldogs,"Smith, Clay",9,6,1,3,0,0,1,6
Western Bulldogs,"Stevens, Koby",27,13,4,14,0,0,1,6
Western Bulldogs,"Stringer, Jake",13,10,2,3,1,0,0,2
Western Bulldogs,"Talia, Michael",8,2,0,6,0,0,0,1
Western Bulldogs,"Webb, Lukas",17,9,5,8,0,2,0,2
Western Bulldogs,"Wood, Easton",16,8,4,8,1,0,0,3
Western Bulldogs,"Bontempelli, Marcus",15,12,1,3,0,0,4,4
Western Bulldogs,"Boyd, Tom",6,6,4,0,0,2,0,0
Western Bulldogs,"Cordy, Ayce",14,7,5,7,1,0,16,6
Western Bulldogs,"Crameri, Stewart",15,6,3,9,1,1,0,3
Western Bulldogs,"Dahlhaus, Luke",18,6,3,12,1,0,0,2
Western Bulldogs,"Dickson, Tory",23,11,4,12,0,0,0,5
Western Bulldogs,"Goodes, Brett",21,12,3,9,1,0,2,2
Western Bulldogs,"Honeychurch, Mitch",9,2,2,7,1,1,0,7
Western Bulldogs,"Hrovat, Nathan",10,4,1,6,0,0,0,4
Western Bulldogs,"Hunter, Lachie",8,6,3,2,0,0,0,1
Western Bulldogs,"Johannisen, Jason",24,12,5,12,0,0,0,2
Western Bulldogs,"Macrae, Jack",23,16,2,7,0,0,0,5
Western Bulldogs,"Murphy, Robert",15,9,2,6,0,0,0,0
Western Bulldogs,"Picken, Liam",28,16,4,12,2,0,0,4
Western Bulldogs,"Roberts, Fletcher",5,3,1,2,0,0,0,2
Western Bulldogs,"Roughead, Jordan",9,5,2,4,0,0,5,1
Western Bulldogs,"Smith, Clay",8,1,1,7,0,0,0,2
Western Bulldogs,"Stevens, Koby",17,8,3,9,1,1,1,6
Western Bulldogs,"Stringer, Jake",11,8,5,3,4,1,0,3
Western Bulldogs,"Talia, Michael",15,7,2,8,0,0,0,1
Western Bulldogs,"Webb, Lukas",8,4,1,4,0,0,0,3
Western Bulldogs,"Wood, Easton",21,13,10,8,1,0,0,1
Western Bulldogs,"Bontempelli, Marcus",18,14,2,4,1,0,2,3
Western Bulldogs,"Boyd, Matthew",24,16,9,8,0,0,0,2
Western Bulldogs,"Boyd, Tom",8,5,6,3,2,0,3,3
Western Bulldogs,"Cordy, Ayce",8,5,4,3,0,0,3,2
Western Bulldogs,"Crameri, Stewart",15,8,5,7,2,0,1,5
Western Bulldogs,"Dahlhaus, Luke",24,14,4,10,1,0,0,8
Western Bulldogs,"Dale, Bailey",12,6,3,6,1,1,0,1
Western Bulldogs,"Dickson, Tory",14,12,5,2,7,1,0,1
Western Bulldogs,"Goodes, Brett",17,11,6,6,0,0,0,4
Western Bulldogs,"Honeychurch, Mitch",3,3,1,0,0,0,0,4
Western Bulldogs,"Hunter, Lachie",8,4,3,4,0,0,0,3
Western Bulldogs,"Johannisen, Jason",20,16,3,4,0,0,0,1
Western Bulldogs,"Jong, Lin",4,1,0,3,0,0,1,10
Western Bulldogs,"Murphy, Robert",29,17,6,12,0,0,0,3
Western Bulldogs,"Picken, Liam",21,14,6,7,0,1,0,7
Western Bulldogs,"Roberts, Fletcher",15,6,8,9,0,0,0,1
Western Bulldogs,"Roughead, Jordan",17,12,10,5,0,0,2,2
Western Bulldogs,"Stevens, Koby",18,9,4,9,0,0,1,8
Western Bulldogs,"Stringer, Jake",7,4,2,3,0,1,0,4
Western Bulldogs,"Talia, Michael",19,13,7,6,0,0,0,0
Western Bulldogs,"Wallis, Mitch",12,5,5,7,0,0,0,4
Western Bulldogs,"Wood, Easton",16,10,9,6,0,0,0,2
Western Bulldogs,"Biggs, Shane",16,10,3,6,0,0,0,3
Western Bulldogs,"Bontempelli, Marcus",12,7,1,5,0,0,2,3
Western Bulldogs,"Boyd, Matthew",31,13,6,18,0,0,1,5
Western Bulldogs,"Boyd, Tom",1,0,0,1,0,0,1,0
Western Bulldogs,"Cordy, Ayce",13,5,2,8,0,0,20,4
Western Bulldogs,"Crameri, Stewart",15,8,3,7,0,2,0,2
Western Bulldogs,"Dahlhaus, Luke",26,12,6,14,1,1,0,6
Western Bulldogs,"Dale, Bailey",5,3,0,2,1,0,0,4
Western Bulldogs,"Dickson, Tory",9,5,1,4,0,1,0,3
Western Bulldogs,"Goodes, Brett",11,8,3,3,0,0,1,2
Western Bulldogs,"Hunter, Lachie",16,11,4,5,1,1,0,1
Western Bulldogs,"Johannisen, Jason",11,9,3,2,0,0,0,4
Western Bulldogs,"Jong, Lin",9,2,0,7,1,0,2,2
Western Bulldogs,"Murphy, Robert",19,14,1,5,0,0,0,4
Western Bulldogs,"Picken, Liam",19,8,2,11,1,0,0,7
Western Bulldogs,"Roberts, Fletcher",8,4,4,4,0,0,0,1
Western Bulldogs,"Roughead, Jordan",15,6,7,9,0,0,21,3
Western Bulldogs,"Stevens, Koby",16,7,1,9,0,1,1,10
Western Bulldogs,"Stringer, Jake",16,12,4,4,2,3,1,5
Western Bulldogs,"Talia, Michael",15,7,5,8,0,0,0,3
Western Bulldogs,"Wallis, Mitch",23,10,3,13,1,0,0,12
Western Bulldogs,"Wood, Easton",21,8,4,13,1,0,0,0
Western Bulldogs,"Biggs, Shane",6,5,3,1,0,0,0,0
Western Bulldogs,"Bontempelli, Marcus",17,10,1,7,0,1,4,7
Western Bulldogs,"Boyd, Matthew",32,18,8,14,0,1,0,4
Western Bulldogs,"Boyd, Tom",8,7,5,1,1,1,1,1
Western Bulldogs,"Dahlhaus, Luke",29,17,3,12,2,2,0,5
Western Bulldogs,"Dale, Bailey",10,6,1,4,0,0,0,0
Western Bulldogs,"Dickson, Tory",14,10,4,4,4,0,0,1
Western Bulldogs,"Grant, Jarrad",16,8,5,8,1,2,0,2
Western Bulldogs,"Hamling, Joel",16,10,7,6,0,0,0,1
Western Bulldogs,"Hrovat, Nathan",15,5,3,10,0,0,0,2
Western Bulldogs,"Johannisen, Jason",21,17,7,4,1,1,0,1
Western Bulldogs,"Jong, Lin",14,6,1,8,0,0,1,1
Western Bulldogs,"Macrae, Jack",26,12,6,14,0,0,0,5
Western Bulldogs,"Minson, Will",12,8,1,4,2,1,17,2
Western Bulldogs,"Murphy, Robert",25,16,9,9,1,0,0,1
Western Bulldogs,"Picken, Liam",25,14,7,11,2,1,0,6
Western Bulldogs,"Roberts, Fletcher",9,6,5,3,0,0,0,1
Western Bulldogs,"Roughead, Jordan",11,7,5,4,0,1,24,3
Western Bulldogs,"Stevens, Koby",23,14,3,9,1,0,1,5
Western Bulldogs,"Wallis, Mitch",36,17,7,19,1,1,0,7
Western Bulldogs,"Webb, Lukas",13,7,6,6,0,0,0,1
Western Bulldogs,"Wood, Easton",18,15,8,3,0,0,0,2
Western Bulldogs,"Boyd, Matthew",23,16,4,7,0,1,0,3
Western Bulldogs,"Boyd, Tom",4,2,1,2,0,0,1,2
Western Bulldogs,"Crameri, Stewart",16,8,5,8,1,0,0,3
Western Bulldogs,"Dahlhaus, Luke",20,9,1,11,0,1,0,7
Western Bulldogs,"Dale, Bailey",9,7,0,2,1,1,0,5
Western Bulldogs,"Dickson, Tory",14,7,4,7,1,0,0,1
Western Bulldogs,"Grant, Jarrad",18,10,2,8,0,1,6,3
Western Bulldogs,"Hamling, Joel",11,6,3,5,0,0,0,1
Western Bulldogs,"Hrovat, Nathan",12,5,3,7,1,0,0,3
Western Bulldogs,"Johannisen, Jason",12,7,2,5,0,0,0,4
Western Bulldogs,"Jong, Lin",10,0,0,10,0,0,1,5
Western Bulldogs,"Macrae, Jack",31,20,5,11,0,0,0,8
Western Bulldogs,"McLean, Toby",5,1,0,4,0,0,0,0
Western Bulldogs,"Minson, Will",9,6,1,3,0,0,40,5
Western Bulldogs,"Murphy, Robert",12,10,2,2,0,0,0,5
Western Bulldogs,"Roberts, Fletcher",9,3,1,6,0,0,0,2
Western Bulldogs,"Roughead, Jordan",11,6,1,5,2,0,19,3
Western Bulldogs,"Stevens, Koby",22,8,3,14,1,0,1,11
Western Bulldogs,"Stringer, Jake",11,8,3,3,2,1,2,6
Western Bulldogs,"Wallis, Mitch",22,12,5,10,0,0,0,6
Western Bulldogs,"Webb, Lukas",7,5,3,2,0,0,0,2
Western Bulldogs,"Wood, Easton",12,8,6,4,0,0,0,0
Western Bulldogs,"Bontempelli, Marcus",20,9,4,11,1,1,3,6
Western Bulldogs,"Boyd, Matthew",21,16,11,5,0,0,0,2
Western Bulldogs,"Boyd, Tom",12,10,6,2,4,1,2,2
Western Bulldogs,"Dahlhaus, Luke",26,15,2,11,1,0,0,7
Western Bulldogs,"Dale, Bailey",4,3,3,1,1,1,0,0
Western Bulldogs,"Dickson, Tory",11,5,2,6,2,0,0,7
Western Bulldogs,"Grant, Jarrad",22,8,7,14,0,0,2,1
Western Bulldogs,"Hamling, Joel",10,6,8,4,0,0,0,0
Western Bulldogs,"Hrovat, Nathan",15,8,4,7,1,1,0,5
Western Bulldogs,"Johannisen, Jason",16,10,7,6,0,0,0,1
Western Bulldogs,"Macrae, Jack",35,14,6,21,0,1,1,4
Western Bulldogs,"McLean, Toby",16,7,5,9,1,0,0,2
Western Bulldogs,"Minson, Will",3,2,1,1,0,1,15,2
Western Bulldogs,"Murphy, Robert",24,18,6,6,0,0,0,2
Western Bulldogs,"Picken, Liam",22,9,3,13,2,0,0,7
Western Bulldogs,"Roberts, Fletcher",6,4,3,2,0,1,0,0
Western Bulldogs,"Roughead, Jordan",8,3,1,5,0,1,14,7
Western Bulldogs,"Stevens, Koby",22,9,2,13,1,0,0,5
Western Bulldogs,"Stringer, Jake",17,12,4,5,5,0,0,3
Western Bulldogs,"Wallis, Mitch",23,10,3,13,3,0,0,5
Western Bulldogs,"Webb, Lukas",13,9,3,4,0,0,0,2
Western Bulldogs,"Wood, Easton",19,11,7,8,0,0,0,1
Western Bulldogs,"Bontempelli, Marcus",19,10,5,9,1,0,2,4
Western Bulldogs,"Boyd, Matthew",30,20,9,10,0,0,0,1
Western Bulldogs,"Boyd, Tom",11,6,4,5,1,0,2,4
Western Bulldogs,"Dahlhaus, Luke",20,6,2,14,0,0,0,5
Western Bulldogs,"Dale, Bailey",11,6,2,5,1,0,0,1
Western Bulldogs,"Dickson, Tory",11,8,4,3,1,0,0,0
Western Bulldogs,"Grant, Jarrad",18,8,4,10,1,0,0,2
Western Bulldogs,"Hamling, Joel",13,9,6,4,0,0,0,2
Western Bulldogs,"Johannisen, Jason",24,17,7,7,1,0,0,1
Western Bulldogs,"Macrae, Jack",27,13,5,14,0,0,0,9
Western Bulldogs,"McLean, Toby",20,8,7,12,1,0,0,1
Western Bulldogs,"Minson, Will",6,3,3,3,0,0,15,4
Western Bulldogs,"Morris, Dale",8,3,3,5,0,0,0,2
Western Bulldogs,"Murphy, Robert",25,20,8,5,0,0,0,0
Western Bulldogs,"Picken, Liam",19,10,5,9,1,1,0,6
Western Bulldogs,"Roberts, Fletcher",9,7,4,2,0,0,0,2
Western Bulldogs,"Roughead, Jordan",10,7,8,3,0,0,14,2
Western Bulldogs,"Stevens, Koby",20,10,2,10,0,1,0,4
Western Bulldogs,"Stringer, Jake",15,10,4,5,0,2,0,2
Western Bulldogs,"Wallis, Mitch",21,10,5,11,0,0,0,2
Western Bulldogs,"Webb, Lukas",3,1,1,2,1,0,0,0
Western Bulldogs,"Wood, Easton",22,13,13,9,0,0,0,0
Western Bulldogs,"Bontempelli, Marcus",18,10,5,8,0,1,5,1
Western Bulldogs,"Boyd, Matthew",31,21,14,10,1,0,0,3
Western Bulldogs,"Dahlhaus, Luke",17,10,1,7,1,1,0,1
Western Bulldogs,"Daniel, Caleb",14,5,5,9,1,0,0,0
Western Bulldogs,"Dickson, Tory",14,9,6,5,1,0,0,3
Western Bulldogs,"Grant, Jarrad",18,9,4,9,1,0,0,1
Western Bulldogs,"Hamling, Joel",9,7,5,2,0,0,0,1
Western Bulldogs,"Honeychurch, Mitch",15,9,2,6,0,3,0,3
Western Bulldogs,"Johannisen, Jason",23,17,7,6,0,0,0,1
Western Bulldogs,"Macrae, Jack",31,19,6,12,0,0,0,3
Western Bulldogs,"McLean, Toby",21,12,6,9,0,0,0,3
Western Bulldogs,"Minson, Will",10,4,2,6,0,0,35,6
Western Bulldogs,"Morris, Dale",11,8,5,3,0,0,0,3
Western Bulldogs,"Murphy, Robert",20,16,5,4,0,0,0,1
Western Bulldogs,"Picken, Liam",33,15,5,18,0,1,0,7
Western Bulldogs,"Redpath, Jack",9,8,7,1,0,1,1,3
Western Bulldogs,"Roberts, Fletcher",15,5,4,10,0,0,0,1
Western Bulldogs,"Roughead, Jordan",3,1,2,2,0,0,8,3
Western Bulldogs,"Stevens, Koby",28,10,5,18,0,0,0,7
Western Bulldogs,"Stringer, Jake",10,6,2,4,3,0,0,5
Western Bulldogs,"Wallis, Mitch",19,10,2,9,1,2,0,7
Western Bulldogs,"Wood, Easton",19,13,8,6,0,0,0,2
Western Bulldogs,"Bontempelli, Marcus",28,15,7,13,2,0,1,7
Western Bulldogs,"Boyd, Matthew",29,21,9,8,0,1,0,1
Western Bulldogs,"Boyd, Tom",9,6,3,3,0,1,5,1
Western Bulldogs,"Dahlhaus, Luke",23,15,4,8,2,0,0,3
Western Bulldogs,"Daniel, Caleb",16,8,4,8,0,0,0,5
Western Bulldogs,"Dickson, Tory",11,7,3,4,1,0,0,1
Western Bulldogs,"Grant, Jarrad",17,7,5,10,0,0,1,0
Western Bulldogs,"Hunter, Lachie",13,10,5,3,0,1,0,2
Western Bulldogs,"Johannisen, Jason",20,16,5,4,0,0,0,0
Western Bulldogs,"Macrae, Jack",33,20,10,13,1,2,0,4
Western Bulldogs,"Minson, Will",10,5,3,5,0,0,38,4
Western Bulldogs,"Morris, Dale",14,6,5,8,0,0,0,2
Western Bulldogs,"Murphy, Robert",23,13,4,10,0,0,0,2
Western Bulldogs,"Picken, Liam",36,20,7,16,0,0,0,9
Western Bulldogs,"Prudden, Josh",11,7,6,4,0,0,0,1
Western Bulldogs,"Redpath, Jack",8,7,4,1,3,2,0,1
Western Bulldogs,"Roberts, Fletcher",13,6,2,7,0,0,0,1
Western Bulldogs,"Stevens, Koby",8,4,1,4,0,0,0,2
Western Bulldogs,"Stringer, Jake",18,12,2,6,2,1,0,1
Western Bulldogs,"Talia, Michael",10,9,6,1,2,1,0,2
Western Bulldogs,"Wallis, Mitch",24,10,3,14,1,1,0,1
Western Bulldogs,"Wood, Easton",18,13,8,5,0,0,0,1
Western Bulldogs,"Bontempelli, Marcus",17,10,4,7,0,1,4,10
Western Bulldogs,"Boyd, Matthew",19,11,0,8,0,0,0,0
Western Bulldogs,"Boyd, Tom",10,7,3,3,0,0,17,6
Western Bulldogs,"Campbell, Tom",11,4,5,7,0,0,32,3
Western Bulldogs,"Crameri, Stewart",13,3,1,10,0,1,0,5
Western Bulldogs,"Dahlhaus, Luke",37,14,3,23,1,0,0,7
Western Bulldogs,"Dale, Bailey",9,4,1,5,0,0,0,1
Western Bulldogs,"Daniel, Caleb",19,9,3,10,0,0,0,2
Western Bulldogs,"Dickson, Tory",15,6,4,9,3,0,0,5
Western Bulldogs,"Grant, Jarrad",13,7,2,6,1,0,2,2
Western Bulldogs,"Hunter, Lachie",10,3,1,7,0,0,0,2
Western Bulldogs,"Johannisen, Jason",22,14,5,8,0,0,0,3
Western Bulldogs,"Macrae, Jack",29,13,5,16,0,1,0,5
Western Bulldogs,"Morris, Dale",13,7,9,6,0,0,0,1
Western Bulldogs,"Murphy, Robert",22,12,4,10,0,0,0,1
Western Bulldogs,"Picken, Liam",21,11,4,10,0,0,0,9
Western Bulldogs,"Prudden, Josh",11,7,2,4,0,0,0,4
Western Bulldogs,"Redpath, Jack",7,6,5,1,1,1,2,10
Western Bulldogs,"Roughead, Jordan",9,5,2,4,0,0,0,7
Western Bulldogs,"Stringer, Jake",17,12,6,5,1,2,0,3
Western Bulldogs,"Wallis, Mitch",26,10,0,16,2,0,0,4
Western Bulldogs,"Wood, Easton",15,7,4,8,0,0,0,3
Western Bulldogs,"Biggs, Shane",28,19,7,9,0,0,0,2
Western Bulldogs,"Bontempelli, Marcus",28,11,7,17,1,0,1,2
Western Bulldogs,"Boyd, Matthew",38,16,12,22,0,1,0,0
Western Bulldogs,"Campbell, Tom",14,5,1,9,0,1,28,5
Western Bulldogs,"Crameri, Stewart",20,11,7,9,2,2,0,0
Western Bulldogs,"Dahlhaus, Luke",29,11,5,18,1,0,0,2
Western Bulldogs,"Dale, Bailey",14,6,3,8,1,1,0,0
Western Bulldogs,"Daniel, Caleb",14,5,2,9,1,1,0,4
Western Bulldogs,"Dickson, Tory",13,7,3,6,4,0,0,0
Western Bulldogs,"Grant, Jarrad",6,3,2,3,0,1,0,1
Western Bulldogs,"Hunter, Lachie",32,19,10,13,1,0,0,1
Western Bulldogs,"Johannisen, Jason",21,15,9,6,0,0,0,0
Western Bulldogs,"Macrae, Jack",28,11,7,17,0,0,0,7
Western Bulldogs,"Morris, Dale",9,3,6,6,0,0,0,3
Western Bulldogs,"Murphy, Robert",26,17,7,9,1,0,0,1
Western Bulldogs,"Picken, Liam",33,18,6,15,0,2,0,8
Western Bulldogs,"Prudden, Josh",17,7,5,10,0,0,0,1
Western Bulldogs,"Redpath, Jack",10,7,4,3,1,2,3,1
Western Bulldogs,"Stringer, Jake",20,16,7,4,1,3,2,3
Western Bulldogs,"Talia, Michael",11,5,3,6,0,0,0,1
Western Bulldogs,"Wallis, Mitch",25,12,3,13,1,0,0,1
Western Bulldogs,"Wood, Easton",16,8,6,8,0,0,0,0
Western Bulldogs,"Biggs, Shane",22,16,4,6,0,0,0,2
Western Bulldogs,"Bontempelli, Marcus",24,13,4,11,0,1,3,5
Western Bulldogs,"Boyd, Matthew",24,15,4,9,0,0,0,0
Western Bulldogs,"Campbell, Tom",8,2,2,6,0,0,21,2
Western Bulldogs,"Crameri, Stewart",19,12,5,7,7,2,0,4
Western Bulldogs,"Dahlhaus, Luke",29,13,6,16,0,0,0,8
Western Bulldogs,"Dale, Bailey",3,1,2,2,0,0,0,1
Western Bulldogs,"Daniel, Caleb",19,9,3,10,2,0,0,2
Western Bulldogs,"Dickson, Tory",9,5,3,4,4,0,0,3
Western Bulldogs,"Grant, Jarrad",16,9,5,7,0,1,0,0
Western Bulldogs,"Hunter, Lachie",36,19,6,17,0,1,0,4
Western Bulldogs,"Johannisen, Jason",26,19,6,7,1,1,0,0
Western Bulldogs,"Macrae, Jack",27,12,4,15,0,0,0,7
Western Bulldogs,"Morris, Dale",16,8,9,8,0,0,0,2
Western Bulldogs,"Murphy, Robert",19,14,9,5,0,1,0,0
Western Bulldogs,"Picken, Liam",25,9,4,16,0,1,0,6
Western Bulldogs,"Prudden, Josh",11,5,3,6,0,0,0,2
Western Bulldogs,"Redpath, Jack",13,10,5,3,0,2,3,2
Western Bulldogs,"Stringer, Jake",16,12,3,4,4,2,0,2
Western Bulldogs,"Talia, Michael",18,9,4,9,0,0,0,4
Western Bulldogs,"Wallis, Mitch",26,12,6,14,1,0,0,2
Western Bulldogs,"Wood, Easton",20,8,10,12,0,0,0,0
Western Bulldogs,"Biggs, Shane",27,17,1,10,0,0,0,2
Western Bulldogs,"Bontempelli, Marcus",25,11,3,14,1,0,3,3
Western Bulldogs,"Boyd, Matthew",32,18,9,14,0,1,0,2
Western Bulldogs,"Campbell, Tom",14,4,2,10,0,1,15,0
Western Bulldogs,"Crameri, Stewart",19,13,6,6,3,2,0,2
Western Bulldogs,"Dahlhaus, Luke",27,10,4,17,0,0,0,6
Western Bulldogs,"Dale, Bailey",1,0,0,1,0,0,0,1
Western Bulldogs,"Daniel, Caleb",11,4,1,7,1,0,0,1
Western Bulldogs,"Darley, Sam",21,14,6,7,0,0,0,3
Western Bulldogs,"Dickson, Tory",16,13,5,3,3,2,0,2
Western Bulldogs,"Grant, Jarrad",18,10,5,8,1,0,1,3
Western Bulldogs,"Hamling, Joel",11,4,5,7,0,0,0,0
Western Bulldogs,"Hunter, Lachie",31,10,4,21,0,0,0,2
Western Bulldogs,"Jong, Lin",12,3,2,9,0,0,3,6
Western Bulldogs,"Macrae, Jack",30,13,2,17,0,0,0,2
Western Bulldogs,"Morris, Dale",9,3,3,6,0,0,0,3
Western Bulldogs,"Picken, Liam",21,6,3,15,1,0,0,9
Western Bulldogs,"Redpath, Jack",13,10,9,3,4,0,3,4
Western Bulldogs,"Stringer, Jake",13,12,3,1,4,4,0,1
Western Bulldogs,"Talia, Michael",24,10,9,14,0,0,0,0
Western Bulldogs,"Wallis, Mitch",28,13,2,15,1,2,0,4
Western Bulldogs,"Wood, Easton",22,9,6,13,0,0,0,3
Western Bulldogs,"Biggs, Shane",24,19,6,5,1,0,0,0
Western Bulldogs,"Bontempelli, Marcus",16,8,2,8,3,0,4,6
Western Bulldogs,"Boyd, Matthew",21,14,7,7,0,0,1,5
Western Bulldogs,"Campbell, Tom",12,5,2,7,0,1,29,2
Western Bulldogs,"Crameri, Stewart",17,10,6,7,2,0,0,4
Western Bulldogs,"Dahlhaus, Luke",32,13,4,19,1,0,0,3
Western Bulldogs,"Daniel, Caleb",4,1,0,3,0,0,0,1
Western Bulldogs,"Darley, Sam",16,9,2,7,0,0,0,3
Western Bulldogs,"Dickson, Tory",15,9,4,6,3,2,0,4
Western Bulldogs,"Grant, Jarrad",20,12,4,8,3,1,2,3
Western Bulldogs,"Hamling, Joel",7,4,5,3,0,0,0,4
Western Bulldogs,"Hunter, Lachie",28,11,3,17,1,1,0,0
Western Bulldogs,"Jong, Lin",14,6,2,8,2,1,2,5
Western Bulldogs,"Macrae, Jack",21,9,2,12,1,0,0,7
Western Bulldogs,"Morris, Dale",16,6,8,10,0,0,0,5
Western Bulldogs,"Murphy, Robert",22,17,6,5,0,0,0,3
Western Bulldogs,"Picken, Liam",22,12,4,10,0,0,0,6
Western Bulldogs,"Redpath, Jack",8,7,2,1,2,0,4,1
Western Bulldogs,"Stringer, Jake",14,11,4,3,4,0,0,3
Western Bulldogs,"Talia, Michael",22,13,12,9,0,0,0,1
Western Bulldogs,"Wallis, Mitch",24,13,7,11,1,1,0,10
Western Bulldogs,"Wood, Easton",22,13,6,9,0,0,0,1
Western Bulldogs,"Biggs, Shane",18,15,2,3,0,0,0,3
Western Bulldogs,"Bontempelli, Marcus",23,13,2,10,0,0,1,6
Western Bulldogs,"Campbell, Tom",8,4,2,4,0,0,12,1
Western Bulldogs,"Crameri, Stewart",13,8,6,5,3,0,0,1
Western Bulldogs,"Dahlhaus, Luke",24,11,3,13,0,0,0,2
Western Bulldogs,"Daniel, Caleb",18,8,4,10,0,0,0,1
Western Bulldogs,"Dickson, Tory",11,6,3,5,2,0,0,5
Western Bulldogs,"Grant, Jarrad",12,5,5,7,0,0,1,1
Western Bulldogs,"Hamling, Joel",7,4,4,3,0,0,0,1
Western Bulldogs,"Hunter, Lachie",24,12,6,12,0,0,0,4
Western Bulldogs,"Johannisen, Jason",22,14,6,8,0,0,0,3
Western Bulldogs,"Jong, Lin",9,4,2,5,0,1,3,7
Western Bulldogs,"Macrae, Jack",25,13,3,12,0,0,1,7
Western Bulldogs,"Morris, Dale",11,0,3,11,0,0,0,0
Western Bulldogs,"Murphy, Robert",27,12,7,15,0,0,0,1
Western Bulldogs,"Pearce, Daniel",2,1,0,1,0,0,0,0
Western Bulldogs,"Redpath, Jack",10,6,2,4,2,1,8,3
Western Bulldogs,"Smith, Roarke",9,3,3,6,0,0,0,1
Western Bulldogs,"Stringer, Jake",17,14,3,3,5,0,0,0
Western Bulldogs,"Talia, Michael",17,8,3,9,0,0,2,0
Western Bulldogs,"Wallis, Mitch",22,9,1,13,1,3,0,5
Western Bulldogs,"Wood, Easton",15,8,4,7,0,0,0,3
Western Bulldogs,"Biggs, Shane",21,15,2,6,2,0,0,3
Western Bulldogs,"Bontempelli, Marcus",23,12,3,11,1,0,5,4
Western Bulldogs,"Boyd, Matthew",32,21,8,11,0,0,0,1
Western Bulldogs,"Cordy, Zaine",1,0,0,1,0,0,0,2
Western Bulldogs,"Crameri, Stewart",12,9,5,3,2,2,0,3
Western Bulldogs,"Dahlhaus, Luke",28,7,3,21,0,2,0,7
Western Bulldogs,"Dickson, Tory",8,4,2,4,2,0,0,1
Western Bulldogs,"Grant, Jarrad",12,6,4,6,0,1,0,1
Western Bulldogs,"Hamling, Joel",9,6,3,3,0,0,0,3
Western Bulldogs,"Honeychurch, Mitch",13,9,8,4,2,1,0,2
Western Bulldogs,"Hunter, Lachie",33,17,8,16,0,1,0,3
Western Bulldogs,"Johannisen, Jason",20,13,6,7,2,0,0,3
Western Bulldogs,"Macrae, Jack",30,15,5,15,0,0,0,7
Western Bulldogs,"Morris, Dale",10,6,2,4,0,0,0,1
Western Bulldogs,"Murphy, Robert",22,13,3,9,0,0,0,4
Western Bulldogs,"Picken, Liam",22,8,0,14,1,0,0,5
Western Bulldogs,"Redpath, Jack",5,1,2,4,0,0,4,0
Western Bulldogs,"Roughead, Jordan",9,4,2,5,1,0,20,8
Western Bulldogs,"Stringer, Jake",21,15,5,6,1,2,0,3
Western Bulldogs,"Wallis, Mitch",31,9,1,22,0,1,1,3
Western Bulldogs,"Webb, Lukas",14,6,6,8,0,1,0,1
Western Bulldogs,"Wood, Easton",14,5,6,9,0,0,0,1
Western Bulldogs,"Biggs, Shane",18,12,4,6,0,0,0,1
Western Bulldogs,"Bontempelli, Marcus",28,19,4,9,2,0,1,5
Western Bulldogs,"Cordy, Zaine",7,2,2,5,0,0,0,2
Western Bulldogs,"Crameri, Stewart",8,4,3,4,1,0,0,1
Western Bulldogs,"Dahlhaus, Luke",26,12,2,14,1,0,0,4
Western Bulldogs,"Daniel, Caleb",9,5,0,4,1,1,0,3
Western Bulldogs,"Dickson, Tory",9,2,0,7,1,0,0,4
Western Bulldogs,"Goodes, Brett",11,5,2,6,1,0,0,2
Western Bulldogs,"Grant, Jarrad",15,5,2,10,0,1,2,1
Western Bulldogs,"Hamling, Joel",6,3,3,3,0,0,1,1
Western Bulldogs,"Honeychurch, Mitch",12,5,3,7,1,0,0,3
Western Bulldogs,"Hunter, Lachie",20,12,2,8,0,0,0,3
Western Bulldogs,"Johannisen, Jason",15,9,6,6,0,0,0,3
Western Bulldogs,"Macrae, Jack",15,7,3,8,2,0,2,8
Western Bulldogs,"Picken, Liam",21,11,3,10,1,1,0,1
Western Bulldogs,"Redpath, Jack",13,8,3,5,3,0,10,2
Western Bulldogs,"Roberts, Fletcher",6,3,3,3,0,0,0,0
Western Bulldogs,"Roughead, Jordan",8,5,2,3,1,0,24,3
Western Bulldogs,"Stringer, Jake",12,12,3,0,4,2,0,2
Western Bulldogs,"Wallis, Mitch",26,10,6,16,0,1,0,3
Western Bulldogs,"Webb, Lukas",8,5,3,3,0,0,0,2
Western Bulldogs,"Wood, Easton",20,13,7,7,0,0,0,1
Western Bulldogs,"Biggs, Shane",17,13,2,4,0,0,0,5
Western Bulldogs,"Bontempelli, Marcus",24,16,3,8,0,2,0,7
Western Bulldogs,"Boyd, Matthew",21,15,4,6,0,0,0,2
Western Bulldogs,"Crameri, Stewart",19,11,3,8,2,5,0,1
Western Bulldogs,"Dahlhaus, Luke",27,11,2,16,1,0,0,3
Western Bulldogs,"Daniel, Caleb",7,1,1,6,0,0,0,3
Western Bulldogs,"Dickson, Tory",11,5,2,6,5,0,0,2
Western Bulldogs,"Grant, Jarrad",15,8,6,7,1,2,2,4
Western Bulldogs,"Hamling, Joel",12,5,4,7,0,0,0,1
Western Bulldogs,"Honeychurch, Mitch",9,3,1,6,0,0,0,1
Western Bulldogs,"Hunter, Lachie",28,13,9,15,0,0,0,2
Western Bulldogs,"Jong, Lin",23,9,4,14,1,1,3,5
Western Bulldogs,"Macrae, Jack",19,11,1,8,0,1,0,9
Western Bulldogs,"Minson, Will",12,9,1,3,0,0,26,4
Western Bulldogs,"Morris, Dale",14,4,5,10,0,0,0,1
Western Bulldogs,"Murphy, Robert",26,18,3,8,0,0,0,1
Western Bulldogs,"Picken, Liam",24,15,7,9,0,0,0,8
Western Bulldogs,"Redpath, Jack",7,6,6,1,2,0,4,3
Western Bulldogs,"Roberts, Fletcher",16,7,4,9,0,0,0,1
Western Bulldogs,"Stringer, Jake",12,9,2,3,2,2,0,1
Western Bulldogs,"Wallis, Mitch",26,12,6,14,0,1,0,7
Western Bulldogs,"Wood, Easton",19,9,9,10,0,0,0,0
Adelaide,"Betts, Eddie",16,8,2,8,2,1,0,4
Adelaide,"Brown, Luke",20,13,4,7,0,0,0,4
Adelaide,"Crouch, Brad",12,5,1,7,0,0,0,5
Adelaide,"Dangerfield, Patrick",21,8,2,13,2,0,1,1
Adelaide,"Grigg, Mitch",21,12,6,9,1,0,0,1
Adelaide,"Jacobs, Sam",19,14,8,5,1,0,26,0
Adelaide,"Jaensch, Matthew",25,11,3,14,1,0,0,3
Adelaide,"Johnston, Lewis",12,8,4,4,3,0,0,0
Adelaide,"Kerridge, Sam",24,9,5,15,0,0,0,4
Adelaide,"Lyons, Jarryd",9,6,1,3,0,0,0,4
Adelaide,"Mackay, David",17,6,2,11,0,0,0,3
Adelaide,"Martin, Brodie",15,5,2,10,0,0,0,1
Adelaide,"McKernan, Shaun",13,7,3,6,1,1,4,1
Adelaide,"Podsiadly, James",11,3,3,8,0,1,0,3
Adelaide,"Porplyzia, Jason",11,8,3,3,0,0,0,2
Adelaide,"Rutten, Ben",10,4,3,6,0,0,0,3
Adelaide,"Shaw, Sam",11,5,1,6,0,0,0,1
Adelaide,"Sloane, Rory",20,9,3,11,0,2,0,12
Adelaide,"Smith, Brodie",18,8,4,10,1,0,0,0
Adelaide,"Talia, Daniel",14,6,4,8,0,0,0,0
Adelaide,"Thompson, Scott",20,7,1,13,0,1,0,3
Adelaide,"Wright, Matthew",31,16,5,15,0,1,0,5
Adelaide,"Betts, Eddie",9,8,4,1,4,1,0,5
Adelaide,"Brown, Luke",13,8,2,5,0,0,0,3
Adelaide,"Crouch, Brad",23,16,5,7,0,2,0,5
Adelaide,"Dangerfield, Patrick",17,8,3,9,0,0,1,7
Adelaide,"Douglas, Richard",29,19,2,10,1,0,0,3
Adelaide,"Grigg, Mitch",12,7,3,5,2,1,0,3
Adelaide,"Jacobs, Sam",11,5,3,6,0,0,26,2
Adelaide,"Jaensch, Matthew",27,18,14,9,0,0,0,2
Adelaide,"Johnston, Lewis",9,7,1,2,1,0,0,5
Adelaide,"Kerridge, Sam",16,5,4,11,1,0,0,2
Adelaide,"Mackay, David",18,11,4,7,0,0,0,1
Adelaide,"McKernan, Shaun",8,3,0,5,0,0,8,2
Adelaide,"Podsiadly, James",9,4,4,5,1,0,1,1
Adelaide,"Porplyzia, Jason",7,3,2,4,0,0,0,0
Adelaide,"Reilly, Brent",18,13,8,5,0,0,0,1
Adelaide,"Rutten, Ben",13,5,4,8,0,0,0,4
Adelaide,"Shaw, Sam",13,9,6,4,0,0,0,3
Adelaide,"Sloane, Rory",27,15,6,12,0,1,2,6
Adelaide,"Smith, Brodie",28,18,7,10,1,0,0,5
Adelaide,"Talia, Daniel",14,5,5,9,0,0,0,2
Adelaide,"Thompson, Scott",27,11,4,16,0,0,0,4
Adelaide,"Wright, Matthew",14,9,3,5,0,0,0,1
Adelaide,"Betts, Eddie",11,8,3,3,1,1,0,1
Adelaide,"Brown, Luke",18,10,5,8,0,1,0,0
Adelaide,"Crouch, Matt",18,10,2,8,0,1,0,4
Adelaide,"Dangerfield, Patrick",23,12,3,11,1,1,2,2
Adelaide,"Douglas, Richard",25,20,2,5,1,1,0,4
Adelaide,"Grigg, Mitch",11,9,5,2,2,1,0,1
Adelaide,"Hartigan, Kyle",13,7,6,6,0,0,0,1
Adelaide,"Jacobs, Sam",17,6,7,11,0,0,35,4
Adelaide,"Jaensch, Matthew",23,11,8,12,1,0,0,2
Adelaide,"Jenkins, Josh",17,12,7,5,0,4,3,3
Adelaide,"Kerridge, Sam",10,3,2,7,0,0,0,2
Adelaide,"Laird, Rory",21,15,6,6,0,0,0,1
Adelaide,"Mackay, David",20,7,2,13,1,0,0,1
Adelaide,"Petrenko, Jared",10,4,1,6,0,2,0,9
Adelaide,"Podsiadly, James",23,15,9,8,1,1,0,2
Adelaide,"Reilly, Brent",21,12,2,9,0,0,0,4
Adelaide,"Rutten, Ben",14,6,3,8,0,0,0,2
Adelaide,"Sloane, Rory",18,13,7,5,1,0,1,7
Adelaide,"Smith, Brodie",20,10,2,10,0,1,0,2
Adelaide,"Talia, Daniel",12,6,6,6,0,0,0,3
Adelaide,"Thompson, Scott",8,3,3,5,0,0,0,1
Adelaide,"Wright, Matthew",21,13,5,8,0,0,0,5
Adelaide,"Betts, Eddie",14,8,2,6,1,1,0,4
Adelaide,"Brown, Luke",17,7,5,10,1,0,0,4
Adelaide,"Crouch, Matt",23,9,4,14,1,1,0,3
Adelaide,"Dangerfield, Patrick",19,8,5,11,1,0,0,7
Adelaide,"Douglas, Richard",23,18,1,5,1,0,0,4
Adelaide,"Hartigan, Kyle",22,14,9,8,0,0,0,0
Adelaide,"Jacobs, Sam",22,9,7,13,0,1,39,4
Adelaide,"Jaensch, Matthew",21,17,9,4,0,1,0,2
Adelaide,"Jenkins, Josh",16,14,11,2,4,1,4,0
Adelaide,"Kerridge, Sam",13,8,4,5,1,0,0,1
Adelaide,"Laird, Rory",13,5,3,8,0,1,0,4
Adelaide,"Mackay, David",29,14,8,15,2,0,0,3
Adelaide,"Martin, Brodie",4,3,1,1,0,1,0,0
Adelaide,"Petrenko, Jared",17,10,3,7,2,1,0,6
Adelaide,"Podsiadly, James",14,10,6,4,3,0,0,2
Adelaide,"Reilly, Brent",18,13,7,5,0,0,0,0
Adelaide,"Rutten, Ben",14,7,5,7,0,0,0,4
Adelaide,"Sloane, Rory",30,17,9,13,1,1,0,5
Adelaide,"Smith, Brodie",30,20,12,10,0,1,0,1
Adelaide,"Talia, Daniel",8,7,4,1,0,0,0,1
Adelaide,"Thompson, Scott",32,15,8,17,0,0,0,7
Adelaide,"Wright, Matthew",22,9,4,13,2,0,0,5
Adelaide,"Betts, Eddie",9,4,1,5,1,1,0,3
Adelaide,"Brown, Luke",16,6,2,10,0,0,0,1
Adelaide,"Crouch, Matt",28,15,10,13,0,0,0,2
Adelaide,"Dangerfield, Patrick",33,19,7,14,5,2,4,1
Adelaide,"Douglas, Richard",18,11,4,7,2,0,0,7
Adelaide,"Hartigan, Kyle",14,6,6,8,0,0,0,0
Adelaide,"Jacobs, Sam",25,10,8,15,0,1,20,2
Adelaide,"Jaensch, Matthew",29,21,13,8,0,0,0,2
Adelaide,"Jenkins, Josh",15,7,6,8,4,1,2,1
Adelaide,"Kerridge, Sam",8,3,3,5,1,0,0,3
Adelaide,"Laird, Rory",19,11,8,8,1,0,0,0
Adelaide,"Lynch, Tom",6,3,2,3,0,0,0,0
Adelaide,"Mackay, David",18,10,2,8,0,1,0,4
Adelaide,"Petrenko, Jared",15,12,5,3,2,1,0,1
Adelaide,"Podsiadly, James",15,9,4,6,1,1,0,3
Adelaide,"Reilly, Brent",22,11,8,11,0,0,0,1
Adelaide,"Shaw, Sam",16,8,3,8,0,0,0,1
Adelaide,"Sloane, Rory",23,15,8,8,1,0,1,4
Adelaide,"Smith, Brodie",22,17,9,5,0,1,0,0
Adelaide,"Talia, Daniel",21,15,10,6,0,0,0,0
Adelaide,"Thompson, Scott",38,17,9,21,0,1,0,3
Adelaide,"Wright, Matthew",19,14,6,5,3,0,0,2
Adelaide,"Betts, Eddie",11,4,2,7,2,0,0,2
Adelaide,"Brown, Luke",15,7,4,8,0,0,0,2
Adelaide,"Crouch, Matt",22,11,4,11,0,0,0,3
Adelaide,"Dangerfield, Patrick",28,11,3,17,0,1,1,7
Adelaide,"Grigg, Mitch",3,2,0,1,0,1,0,2
Adelaide,"Hartigan, Kyle",11,3,2,8,0,0,0,3
Adelaide,"Jacobs, Sam",11,6,1,5,0,0,24,4
Adelaide,"Jaensch, Matthew",16,12,6,4,0,0,0,4
Adelaide,"Jenkins, Josh",13,10,7,3,3,3,1,0
Adelaide,"Kerridge, Sam",8,2,2,6,0,0,0,5
Adelaide,"Laird, Rory",19,9,5,10,0,0,0,3
Adelaide,"Lynch, Tom",25,15,7,10,2,1,0,0
Adelaide,"Mackay, David",20,6,2,14,1,1,0,2
Adelaide,"Petrenko, Jared",9,8,2,1,0,1,0,3
Adelaide,"Podsiadly, James",12,10,6,2,3,1,0,5
Adelaide,"Reilly, Brent",21,15,7,6,0,0,0,4
Adelaide,"Shaw, Sam",10,6,5,4,0,0,0,0
Adelaide,"Sloane, Rory",18,8,5,10,1,0,1,7
Adelaide,"Smith, Brodie",20,13,4,7,0,1,0,2
Adelaide,"Talia, Daniel",16,13,6,3,0,0,0,2
Adelaide,"Thompson, Scott",24,11,1,13,0,0,0,2
Adelaide,"Wright, Matthew",17,12,4,5,1,1,0,7
Adelaide,"Betts, Eddie",8,3,3,5,0,2,0,3
Adelaide,"Brown, Luke",14,2,1,12,0,0,0,1
Adelaide,"Crouch, Matt",15,7,2,8,1,0,0,5
Adelaide,"Dangerfield, Patrick",25,15,2,10,2,2,0,4
Adelaide,"Grigg, Mitch",14,10,4,4,0,1,0,2
Adelaide,"Hartigan, Kyle",13,8,4,5,0,0,0,3
Adelaide,"Jacobs, Sam",17,7,5,10,0,0,41,4
Adelaide,"Jaensch, Matthew",11,7,2,4,0,0,0,3
Adelaide,"Jenkins, Josh",11,9,6,2,2,0,3,2
Adelaide,"Kerridge, Sam",6,4,1,2,0,0,0,3
Adelaide,"Laird, Rory",22,14,6,8,0,0,0,4
Adelaide,"Lynch, Tom",0,0,0,0,0,0,0,0
Adelaide,"Mackay, David",22,12,4,10,0,1,0,4
Adelaide,"Petrenko, Jared",13,5,0,8,1,1,0,6
Adelaide,"Podsiadly, James",12,8,3,4,2,2,0,1
Adelaide,"Reilly, Brent",19,15,7,4,0,0,0,2
Adelaide,"Shaw, Sam",6,4,1,2,0,0,0,5
Adelaide,"Sloane, Rory",20,10,5,10,0,1,1,6
Adelaide,"Smith, Brodie",30,17,7,13,0,0,0,3
Adelaide,"Talia, Daniel",19,15,8,4,0,0,0,1
Adelaide,"Thompson, Scott",29,18,2,11,1,1,0,5
Adelaide,"Wright, Matthew",14,6,0,8,0,0,0,5
Adelaide,"Betts, Eddie",15,8,4,7,1,1,0,8
Adelaide,"Brown, Luke",10,4,1,6,0,0,0,2
Adelaide,"Cameron, Charlie",13,6,1,7,1,0,0,5
Adelaide,"Crouch, Matt",5,3,1,2,0,0,0,1
Adelaide,"Dangerfield, Patrick",32,21,4,11,0,0,1,8
Adelaide,"Douglas, Richard",19,12,4,7,2,0,0,8
Adelaide,"Hartigan, Kyle",15,8,9,7,0,0,0,1
Adelaide,"Jacobs, Sam",20,10,2,10,0,0,34,3
Adelaide,"Jaensch, Matthew",24,15,4,9,1,1,0,2
Adelaide,"Jenkins, Josh",15,12,5,3,4,2,1,5
Adelaide,"Kerridge, Sam",13,6,3,7,0,0,0,8
Adelaide,"Laird, Rory",13,4,2,9,0,0,0,3
Adelaide,"Mackay, David",20,14,4,6,0,0,0,8
Adelaide,"Martin, Brodie",17,14,7,3,0,0,0,2
Adelaide,"Podsiadly, James",17,13,9,4,1,1,0,3
Adelaide,"Rutten, Ben",15,10,4,5,0,0,0,0
Adelaide,"Sloane, Rory",24,11,4,13,0,1,2,8
Adelaide,"Smith, Brodie",25,16,4,9,0,2,0,3
Adelaide,"Talia, Daniel",15,9,6,6,0,0,0,0
Adelaide,"Thompson, Scott",30,19,3,11,0,1,0,7
Adelaide,"Walker, Taylor",17,11,7,6,0,4,0,3
Adelaide,"Wright, Matthew",15,5,4,10,0,0,0,5
Adelaide,"Betts, Eddie",13,8,2,5,4,1,0,4
Adelaide,"Brown, Luke",15,9,5,6,0,0,0,3
Adelaide,"Cameron, Charlie",7,4,0,3,1,1,0,3
Adelaide,"Dangerfield, Patrick",25,12,3,13,0,2,0,1
Adelaide,"Douglas, Richard",27,14,0,13,0,1,0,4
Adelaide,"Hartigan, Kyle",18,10,5,8,0,0,0,1
Adelaide,"Jacobs, Sam",23,7,1,16,0,0,38,2
Adelaide,"Jaensch, Matthew",19,16,5,3,1,0,0,1
Adelaide,"Jenkins, Josh",7,5,3,2,0,4,1,0
Adelaide,"Kerridge, Sam",9,3,2,6,1,0,0,7
Adelaide,"Laird, Rory",28,15,10,13,0,0,0,1
Adelaide,"Lyons, Jarryd",7,3,1,4,0,0,0,1
Adelaide,"Mackay, David",15,9,2,6,1,0,0,6
Adelaide,"Martin, Brodie",20,9,4,11,0,1,0,5
Adelaide,"Podsiadly, James",12,7,5,5,0,1,0,3
Adelaide,"Rutten, Ben",14,3,5,11,0,0,0,2
Adelaide,"Sloane, Rory",18,8,2,10,0,1,1,7
Adelaide,"Smith, Brodie",14,9,1,5,0,0,0,2
Adelaide,"Talia, Daniel",16,10,6,6,0,0,0,0
Adelaide,"Thompson, Scott",30,13,2,17,1,1,1,5
Adelaide,"Walker, Taylor",13,9,5,4,1,1,0,0
Adelaide,"Wright, Matthew",18,12,4,6,0,1,0,1
Adelaide,"Betts, Eddie",13,8,1,5,2,3,0,1
Adelaide,"Brown, Luke",13,8,3,5,0,0,0,4
Adelaide,"Cameron, Charlie",6,5,1,1,0,2,0,4
Adelaide,"Dangerfield, Patrick",26,15,3,11,0,1,2,3
Adelaide,"Douglas, Richard",22,12,2,10,1,0,1,7
Adelaide,"Jacobs, Sam",5,5,0,0,0,0,25,1
Adelaide,"Jaensch, Matthew",29,18,7,11,1,0,0,2
Adelaide,"Jenkins, Josh",14,10,2,4,2,2,13,1
Adelaide,"Kerridge, Sam",10,6,0,4,0,1,0,5
Adelaide,"Laird, Rory",16,8,3,8,1,0,0,2
Adelaide,"Lyons, Jarryd",18,12,4,6,1,1,0,3
Adelaide,"Mackay, David",15,11,3,4,1,0,0,10
Adelaide,"Martin, Brodie",15,9,6,6,0,0,0,1
Adelaide,"Otten, Andy",11,5,5,6,0,0,0,4
Adelaide,"Podsiadly, James",19,17,8,2,1,0,0,2
Adelaide,"Rutten, Ben",10,6,3,4,0,0,0,1
Adelaide,"Sloane, Rory",29,15,6,14,0,0,0,6
Adelaide,"Smith, Brodie",30,18,6,12,1,0,0,3
Adelaide,"Talia, Daniel",12,7,4,5,0,0,0,3
Adelaide,"Thompson, Scott",26,15,2,11,0,0,0,1
Adelaide,"Walker, Taylor",22,16,10,6,5,1,0,0
Adelaide,"Wright, Matthew",12,9,3,3,0,0,0,1
Adelaide,"Betts, Eddie",9,5,2,4,0,1,0,6
Adelaide,"Brown, Luke",11,5,2,6,0,0,0,0
Adelaide,"Cameron, Charlie",9,6,3,3,3,1,0,3
Adelaide,"Dangerfield, Patrick",18,8,5,10,1,0,0,0
Adelaide,"Douglas, Richard",19,13,3,6,0,1,1,4
Adelaide,"Ellis-Yolmen, Cam",5,2,1,3,0,0,0,0
Adelaide,"Jacobs, Sam",19,11,5,8,0,0,19,2
Adelaide,"Jaensch, Matthew",13,10,3,3,0,0,0,2
Adelaide,"Jenkins, Josh",4,4,1,0,1,0,0,0
Adelaide,"Kerridge, Sam",6,5,1,1,0,0,0,5
Adelaide,"Laird, Rory",16,9,2,7,0,0,0,5
Adelaide,"Lyons, Jarryd",13,4,1,9,0,1,0,4
Adelaide,"Mackay, David",21,9,3,12,0,0,0,5
Adelaide,"Martin, Brodie",8,4,2,4,1,0,0,0
Adelaide,"Otten, Andy",11,7,4,4,0,0,0,2
Adelaide,"Podsiadly, James",10,5,3,5,0,0,0,0
Adelaide,"Rutten, Ben",9,4,3,5,0,0,0,0
Adelaide,"Sloane, Rory",23,7,2,16,0,0,0,7
Adelaide,"Smith, Brodie",24,14,6,10,1,0,0,3
Adelaide,"Talia, Daniel",10,7,5,3,0,0,0,0
Adelaide,"Thompson, Scott",28,13,2,15,0,0,0,3
Adelaide,"Walker, Taylor",11,7,3,4,0,2,0,2
Adelaide,"Betts, Eddie",13,7,1,6,3,1,0,4
Adelaide,"Brown, Luke",10,7,5,3,0,0,0,2
Adelaide,"Crouch, Matt",8,4,1,4,0,0,0,7
Adelaide,"Dangerfield, Patrick",23,14,2,9,0,0,0,1
Adelaide,"Douglas, Richard",20,13,2,7,0,1,0,4
Adelaide,"Jacobs, Sam",18,10,6,8,0,0,33,1
Adelaide,"Jaensch, Matthew",18,9,6,9,0,0,0,2
Adelaide,"Jenkins, Josh",14,9,5,5,2,0,2,1
Adelaide,"Kerridge, Sam",9,4,1,5,4,0,0,0
Adelaide,"Laird, Rory",12,5,1,7,0,0,0,1
Adelaide,"Mackay, David",18,12,6,6,1,0,0,3
Adelaide,"Martin, Brodie",10,6,3,4,0,4,0,1
Adelaide,"Otten, Andy",13,8,4,5,0,0,0,1
Adelaide,"Podsiadly, James",19,15,8,4,2,1,0,1
Adelaide,"Reilly, Brent",19,15,7,4,0,0,0,3
Adelaide,"Rutten, Ben",9,3,2,6,0,0,0,1
Adelaide,"Sloane, Rory",25,16,8,9,0,0,1,3
Adelaide,"Smith, Brodie",29,15,9,14,1,0,0,1
Adelaide,"Talia, Daniel",12,11,4,1,0,0,0,1
Adelaide,"Thompson, Scott",30,13,5,17,0,0,0,9
Adelaide,"Walker, Taylor",13,9,7,4,2,1,0,2
Adelaide,"Wright, Matthew",21,12,8,9,1,0,0,1
Adelaide,"Betts, Eddie",21,11,5,10,3,2,0,1
Adelaide,"Brown, Luke",12,8,2,4,0,0,0,3
Adelaide,"Dangerfield, Patrick",21,5,2,16,1,0,3,4
Adelaide,"Douglas, Richard",20,14,2,6,0,0,0,5
Adelaide,"Jacobs, Sam",20,10,9,10,0,0,35,0
Adelaide,"Jaensch, Matthew",23,15,4,8,0,1,0,3
Adelaide,"Jenkins, Josh",9,8,2,1,4,1,0,1
Adelaide,"Kerridge, Sam",9,5,1,4,0,0,0,3
Adelaide,"Laird, Rory",17,6,5,11,0,0,0,1
Adelaide,"Lyons, Jarryd",11,5,2,6,0,0,0,1
Adelaide,"Mackay, David",6,5,0,1,0,0,0,1
Adelaide,"Martin, Brodie",14,9,8,5,1,2,0,2
Adelaide,"Otten, Andy",18,7,4,11,0,0,0,2
Adelaide,"Podsiadly, James",12,8,7,4,2,0,1,3
Adelaide,"Reilly, Brent",21,14,6,7,0,0,0,1
Adelaide,"Rutten, Ben",10,5,3,5,0,0,0,2
Adelaide,"Sloane, Rory",21,9,1,12,0,0,1,9
Adelaide,"Smith, Brodie",21,13,3,8,1,1,0,2
Adelaide,"Talia, Daniel",7,6,3,1,0,0,0,1
Adelaide,"Thompson, Scott",41,19,6,22,0,0,1,7
Adelaide,"Walker, Taylor",17,9,9,8,2,1,0,2
Adelaide,"Wright, Matthew",26,19,10,7,0,0,0,0
Adelaide,"Betts, Eddie",19,13,2,6,4,2,0,1
Adelaide,"Brown, Luke",7,1,0,6,0,0,0,2
Adelaide,"Crouch, Brad",28,17,2,11,1,1,0,1
Adelaide,"Dangerfield, Patrick",32,13,2,19,1,2,3,4
Adelaide,"Douglas, Richard",23,15,2,8,0,1,2,1
Adelaide,"Jacobs, Sam",19,15,3,4,3,0,36,1
Adelaide,"Jaensch, Matthew",14,8,3,6,0,0,0,3
Adelaide,"Jenkins, Josh",11,6,1,5,1,1,2,2
Adelaide,"Lynch, Tom",21,10,6,11,0,2,0,4
Adelaide,"Lyons, Jarryd",6,5,2,1,0,0,0,0
Adelaide,"Martin, Brodie",16,10,2,6,0,0,0,3
Adelaide,"Otten, Andy",9,5,2,4,0,0,0,5
Adelaide,"Podsiadly, James",12,9,5,3,0,0,0,1
Adelaide,"Porplyzia, Jason",13,10,3,3,1,0,0,4
Adelaide,"Reilly, Brent",12,8,6,4,0,0,0,1
Adelaide,"Sloane, Rory",21,13,3,8,0,0,0,9
Adelaide,"Smith, Brodie",9,7,0,2,0,1,0,0
Adelaide,"Talia, Daniel",13,9,5,4,0,0,0,3
Adelaide,"Thompson, Luke",9,5,3,4,0,0,0,5
Adelaide,"Thompson, Scott",34,20,7,14,1,0,0,7
Adelaide,"Walker, Taylor",15,9,4,6,2,0,0,3
Adelaide,"Wright, Matthew",22,12,5,10,0,0,0,6
Adelaide,"Betts, Eddie",15,9,4,6,5,1,0,2
Adelaide,"Brown, Luke",18,9,2,9,0,0,0,4
Adelaide,"Crouch, Brad",24,8,5,16,1,1,0,7
Adelaide,"Dangerfield, Patrick",22,10,5,12,0,3,2,0
Adelaide,"Douglas, Richard",19,10,3,9,0,0,0,5
Adelaide,"Henderson, Ricky",22,15,7,7,0,0,0,1
Adelaide,"Jacobs, Sam",11,8,4,3,1,0,28,2
Adelaide,"Jaensch, Matthew",19,13,5,6,0,0,0,0
Adelaide,"Jenkins, Josh",13,10,4,3,2,0,2,0
Adelaide,"Laird, Rory",7,5,3,2,0,0,0,2
Adelaide,"Lynch, Tom",20,14,7,6,1,1,0,0
Adelaide,"Mackay, David",19,7,2,12,1,2,0,3
Adelaide,"Martin, Brodie",22,11,4,11,1,1,0,5
Adelaide,"Otten, Andy",19,11,5,8,0,0,0,0
Adelaide,"Podsiadly, James",19,12,11,7,3,1,0,1
Adelaide,"Rutten, Ben",1,0,0,1,0,0,0,0
Adelaide,"Sloane, Rory",32,18,9,14,2,0,2,5
Adelaide,"Smith, Brodie",16,6,6,10,1,0,0,3
Adelaide,"Talia, Daniel",13,9,5,4,0,1,0,1
Adelaide,"Thompson, Scott",21,9,3,12,0,2,0,3
Adelaide,"Walker, Taylor",12,3,3,9,0,1,0,3
Adelaide,"Wright, Matthew",20,15,7,5,2,1,0,0
Adelaide,"Betts, Eddie",7,3,0,4,1,0,0,5
Adelaide,"Brown, Luke",19,7,1,12,0,0,0,5
Adelaide,"Crouch, Brad",40,11,1,29,0,0,0,2
Adelaide,"Dangerfield, Patrick",41,14,2,27,0,3,0,6
Adelaide,"Douglas, Richard",25,12,2,13,0,0,0,4
Adelaide,"Henderson, Ricky",22,8,4,14,0,0,0,0
Adelaide,"Jacobs, Sam",16,11,2,5,0,0,47,1
Adelaide,"Jaensch, Matthew",20,15,4,5,0,0,0,3
Adelaide,"Jenkins, Josh",11,8,4,3,5,1,2,1
Adelaide,"Laird, Rory",16,7,3,9,0,0,0,6
Adelaide,"Lynch, Tom",16,11,2,5,2,1,0,6
Adelaide,"Martin, Brodie",21,9,2,12,0,1,0,6
Adelaide,"Otten, Andy",7,3,0,4,0,0,0,3
Adelaide,"Podsiadly, James",14,10,8,4,2,0,0,2
Adelaide,"Porplyzia, Jason",2,0,0,2,0,0,0,0
Adelaide,"Rutten, Ben",11,4,3,7,0,0,0,1
Adelaide,"Sloane, Rory",33,12,4,21,0,0,1,7
Adelaide,"Smith, Brodie",34,18,4,16,1,0,0,2
Adelaide,"Talia, Daniel",6,2,2,4,0,0,0,3
Adelaide,"Thompson, Scott",20,9,0,11,0,0,0,2
Adelaide,"Walker, Taylor",10,8,6,2,2,1,0,1
Adelaide,"Wright, Matthew",20,8,4,12,1,0,0,6
Adelaide,"Betts, Eddie",10,7,2,3,2,1,0,2
Adelaide,"Brown, Luke",10,6,2,4,0,0,0,3
Adelaide,"Crouch, Brad",25,9,1,16,0,0,0,9
Adelaide,"Dangerfield, Patrick",26,15,4,11,0,1,2,4
Adelaide,"Douglas, Richard",20,17,3,3,2,1,0,4
Adelaide,"Grigg, Mitch",9,4,3,5,0,1,0,0
Adelaide,"Henderson, Ricky",22,16,4,6,0,0,0,2
Adelaide,"Jacobs, Sam",10,6,0,4,0,0,43,2
Adelaide,"Jaensch, Matthew",22,11,7,11,1,1,0,3
Adelaide,"Jenkins, Josh",8,5,2,3,0,0,5,0
Adelaide,"Laird, Rory",21,7,5,14,0,0,0,4
Adelaide,"Lynch, Tom",12,8,5,4,0,2,0,1
Adelaide,"Mackay, David",19,7,2,12,1,1,0,4
Adelaide,"Martin, Brodie",22,14,5,8,1,1,0,4
Adelaide,"Otten, Andy",13,8,4,5,0,0,0,2
Adelaide,"Podsiadly, James",11,6,3,5,1,1,0,3
Adelaide,"Sloane, Rory",19,8,0,11,1,0,0,3
Adelaide,"Smith, Brodie",24,11,5,13,2,0,0,0
Adelaide,"Talia, Daniel",15,8,6,7,0,0,0,0
Adelaide,"Thompson, Luke",11,5,2,6,0,0,0,4
Adelaide,"Walker, Taylor",14,7,5,7,3,1,0,0
Adelaide,"Wright, Matthew",9,5,2,4,0,1,0,3
Adelaide,"Betts, Eddie",14,10,1,4,3,0,0,6
Adelaide,"Brown, Luke",10,4,1,6,0,0,0,1
Adelaide,"Crouch, Brad",30,10,1,20,2,0,0,5
Adelaide,"Dangerfield, Patrick",26,10,2,16,1,0,1,2
Adelaide,"Douglas, Richard",21,13,3,8,0,1,0,6
Adelaide,"Grigg, Mitch",9,5,0,4,0,0,0,1
Adelaide,"Henderson, Ricky",17,14,6,3,0,1,0,1
Adelaide,"Jacobs, Sam",17,10,4,7,0,0,42,3
Adelaide,"Jaensch, Matthew",27,15,6,12,0,0,0,2
Adelaide,"Jenkins, Josh",8,5,2,3,3,0,1,4
Adelaide,"Laird, Rory",14,5,3,9,0,1,0,0
Adelaide,"Mackay, David",16,3,1,13,0,0,0,5
Adelaide,"Martin, Brodie",18,14,6,4,1,2,0,4
Adelaide,"Otten, Andy",13,6,3,7,0,0,0,1
Adelaide,"Podsiadly, James",12,4,4,8,0,0,0,0
Adelaide,"Sloane, Rory",26,11,2,15,1,1,1,7
Adelaide,"Smith, Brodie",23,9,4,14,0,0,0,0
Adelaide,"Talia, Daniel",4,1,1,3,0,0,0,1
Adelaide,"Thompson, Luke",8,3,3,5,0,0,0,2
Adelaide,"Thompson, Scott",31,16,3,15,0,0,0,4
Adelaide,"Walker, Taylor",14,10,3,4,4,1,0,4
Adelaide,"Wright, Matthew",16,9,5,7,1,1,0,8
Adelaide,"Betts, Eddie",17,7,3,10,3,1,0,4
Adelaide,"Brown, Luke",4,2,1,2,0,0,0,0
Adelaide,"Cameron, Charlie",13,6,2,7,1,3,0,2
Adelaide,"Crouch, Brad",30,14,3,16,0,2,1,8
Adelaide,"Dangerfield, Patrick",21,16,5,5,1,1,0,1
Adelaide,"Douglas, Richard",18,11,5,7,0,1,0,3
Adelaide,"Grigg, Mitch",15,9,4,6,1,1,0,2
Adelaide,"Henderson, Ricky",12,9,4,3,0,0,0,0
Adelaide,"Jacobs, Sam",19,13,6,6,2,0,39,2
Adelaide,"Jaensch, Matthew",25,17,5,8,1,1,0,7
Adelaide,"Jenkins, Josh",16,13,7,3,1,2,6,1
Adelaide,"Lynch, Tom",9,7,6,2,2,0,0,2
Adelaide,"Lyons, Jarryd",26,14,7,12,1,0,0,3
Adelaide,"Mackay, David",21,8,5,13,0,0,0,7
Adelaide,"Martin, Brodie",20,12,3,8,3,1,0,3
Adelaide,"Otten, Andy",5,3,2,2,0,0,0,0
Adelaide,"Sloane, Rory",28,18,8,10,2,0,3,11
Adelaide,"Smith, Brodie",19,12,5,7,0,0,0,1
Adelaide,"Talia, Daniel",4,2,2,2,0,0,0,0
Adelaide,"Thompson, Luke",8,6,4,2,0,0,0,0
Adelaide,"Walker, Taylor",21,14,6,7,6,2,0,2
Adelaide,"Wright, Matthew",27,16,5,11,1,0,0,2
Adelaide,"Betts, Eddie",12,6,0,6,2,0,0,2
Adelaide,"Brown, Luke",9,3,2,6,0,0,0,3
Adelaide,"Cameron, Charlie",6,3,1,3,1,1,0,6
Adelaide,"Crouch, Brad",22,14,2,8,0,0,0,7
Adelaide,"Dangerfield, Patrick",24,15,1,9,0,1,2,7
Adelaide,"Douglas, Richard",22,18,1,4,0,0,0,10
Adelaide,"Grigg, Mitch",11,9,0,2,0,0,0,3
Adelaide,"Henderson, Ricky",12,7,4,5,0,1,0,2
Adelaide,"Jacobs, Sam",14,9,4,5,0,1,46,5
Adelaide,"Jaensch, Matthew",19,9,2,10,0,0,0,2
Adelaide,"Jenkins, Josh",9,7,1,2,1,1,5,2
Adelaide,"Lyons, Jarryd",16,13,1,3,0,0,0,5
Adelaide,"Mackay, David",8,6,1,2,1,0,0,2
Adelaide,"Martin, Brodie",15,10,1,5,0,0,0,4
Adelaide,"Podsiadly, James",12,8,2,4,2,1,0,1
Adelaide,"Shaw, Sam",9,7,2,2,0,0,0,4
Adelaide,"Sloane, Rory",19,11,2,8,0,1,0,7
Adelaide,"Smith, Brodie",9,7,2,2,0,0,0,2
Adelaide,"Talia, Daniel",10,8,4,2,0,0,0,1
Adelaide,"Thompson, Luke",11,4,2,7,0,0,0,2
Adelaide,"Walker, Taylor",13,10,4,3,2,2,0,2
Adelaide,"Wright, Matthew",20,16,2,4,0,1,0,3
Adelaide,"Betts, Eddie",17,11,4,6,2,0,0,4
Adelaide,"Brown, Luke",7,3,1,4,0,0,0,5
Adelaide,"Cameron, Charlie",8,6,3,2,2,2,0,1
Adelaide,"Crouch, Brad",22,11,3,11,1,0,0,8
Adelaide,"Dangerfield, Patrick",19,13,7,6,0,2,3,3
Adelaide,"Douglas, Richard",27,17,5,10,0,0,0,5
Adelaide,"Henderson, Ricky",12,9,2,3,0,0,0,0
Adelaide,"Jacobs, Sam",11,5,1,6,0,0,38,0
Adelaide,"Jaensch, Matthew",13,11,3,2,0,0,0,3
Adelaide,"Jenkins, Josh",9,7,4,2,1,3,2,3
Adelaide,"Laird, Rory",1,1,0,0,0,0,0,0
Adelaide,"Lyons, Jarryd",14,10,2,4,3,1,0,2
Adelaide,"Martin, Brodie",21,11,6,10,0,1,0,4
Adelaide,"Podsiadly, James",14,9,7,5,0,2,0,0
Adelaide,"Rutten, Ben",9,8,6,1,0,0,0,4
Adelaide,"Sloane, Rory",17,6,2,11,0,0,0,10
Adelaide,"Smith, Brodie",17,11,3,6,0,0,0,0
Adelaide,"Talia, Daniel",4,1,1,3,0,0,0,1
Adelaide,"Thompson, Luke",7,4,3,3,0,0,0,1
Adelaide,"Thompson, Scott",27,18,5,9,0,0,0,7
Adelaide,"Walker, Taylor",13,7,6,6,2,1,0,0
Adelaide,"Wright, Matthew",10,7,3,3,2,1,0,2
Adelaide,"Betts, Eddie",17,11,5,6,5,1,0,2
Adelaide,"Brown, Luke",18,9,4,9,0,0,0,2
Adelaide,"Crouch, Brad",16,10,2,6,0,0,0,4
Adelaide,"Crouch, Matt",13,4,2,9,1,0,0,1
Adelaide,"Dangerfield, Patrick",26,14,2,12,1,0,0,5
Adelaide,"Douglas, Richard",16,7,6,9,1,0,0,3
Adelaide,"Henderson, Ricky",16,13,6,3,0,0,0,1
Adelaide,"Jacobs, Sam",14,6,4,8,0,0,49,1
Adelaide,"Jaensch, Matthew",26,18,7,8,0,0,0,1
Adelaide,"Jenkins, Josh",14,9,6,5,0,0,0,0
Adelaide,"Kerridge, Sam",15,9,4,6,2,0,0,4
Adelaide,"Lyons, Jarryd",13,7,1,6,2,1,0,2
Adelaide,"Mackay, David",20,11,5,9,1,1,0,5
Adelaide,"Martin, Brodie",6,5,3,1,0,0,0,0
Adelaide,"Podsiadly, James",11,7,4,4,1,0,0,0
Adelaide,"Reilly, Brent",22,14,7,8,0,0,0,2
Adelaide,"Rutten, Ben",13,7,8,6,1,0,0,0
Adelaide,"Sloane, Rory",30,19,9,11,3,0,1,1
Adelaide,"Smith, Brodie",34,18,5,16,1,0,0,0
Adelaide,"Talia, Daniel",15,10,8,5,0,0,0,0
Adelaide,"Thompson, Scott",23,11,3,12,0,0,0,6
Adelaide,"Walker, Taylor",15,9,6,6,3,3,0,0
Brisbane Lions,"Adcock, Jed",14,10,5,4,0,0,0,3
Brisbane Lions,"Aish, James",17,9,5,8,0,0,0,2
Brisbane Lions,"Brown, Jonathan",13,9,7,4,4,2,0,1
Brisbane Lions,"Clarke, Justin",5,2,1,3,0,0,0,2
Brisbane Lions,"Close, Michael",4,1,1,3,0,0,0,5
Brisbane Lions,"Golby, Mitch",16,8,4,8,0,0,0,3
Brisbane Lions,"Green, Josh",21,16,2,5,1,0,0,7
Brisbane Lions,"Hanley, Pearce",17,16,8,1,0,1,0,1
Brisbane Lions,"Harwood, Ryan",6,3,1,3,0,0,0,1
Brisbane Lions,"Lester, Ryan",20,10,3,10,0,0,0,8
Brisbane Lions,"Leuenberger, Matthew",15,9,1,6,0,1,23,1
Brisbane Lions,"Mayes, Sam",19,13,4,6,2,2,0,2
Brisbane Lions,"Merrett, Daniel",9,6,4,3,0,0,0,0
Brisbane Lions,"Moloney, Brent",23,8,3,15,0,0,0,2
Brisbane Lions,"Paparone, Marco",12,9,5,3,0,0,0,4
Brisbane Lions,"Patfull, Joel",6,2,1,4,0,0,0,2
Brisbane Lions,"Redden, Jack",14,5,2,9,0,1,3,11
Brisbane Lions,"Rich, Daniel",19,10,7,9,0,0,0,0
Brisbane Lions,"Rockliff, Tom",19,13,3,6,3,0,0,5
Brisbane Lions,"Taylor, Lewis",3,2,0,1,0,1,0,0
Brisbane Lions,"West, Trent",12,7,4,5,3,0,15,1
Brisbane Lions,"Zorko, Dayne",28,16,3,12,0,2,0,4
Brisbane Lions,"Adcock, Jed",10,6,3,4,0,0,0,4
Brisbane Lions,"Aish, James",15,12,8,3,0,1,0,4
Brisbane Lions,"Bewick, Rohan",4,4,1,0,1,0,0,1
Brisbane Lions,"Brown, Jonathan",13,8,7,5,2,1,0,0
Brisbane Lions,"Clarke, Justin",11,5,4,6,0,0,0,5
Brisbane Lions,"Close, Michael",3,0,0,3,0,0,0,2
Brisbane Lions,"Golby, Mitch",14,9,6,5,0,0,0,3
Brisbane Lions,"Green, Josh",15,11,2,4,1,0,0,1
Brisbane Lions,"Hanley, Pearce",32,19,6,13,0,1,0,3
Brisbane Lions,"Lester, Ryan",16,7,2,9,0,0,0,4
Brisbane Lions,"Leuenberger, Matthew",10,5,3,5,0,0,18,4
Brisbane Lions,"Lisle, Jordan",12,8,5,4,0,0,0,1
Brisbane Lions,"Mayes, Sam",14,10,4,4,4,0,0,2
Brisbane Lions,"Merrett, Daniel",13,11,7,2,0,0,0,1
Brisbane Lions,"Moloney, Brent",24,13,1,11,1,1,0,10
Brisbane Lions,"Paparone, Marco",10,5,1,5,0,0,0,5
Brisbane Lions,"Patfull, Joel",12,6,2,6,0,0,0,2
Brisbane Lions,"Redden, Jack",28,18,8,10,0,0,2,9
Brisbane Lions,"Rich, Daniel",20,8,0,12,0,1,0,5
Brisbane Lions,"Taylor, Lewis",19,10,3,9,0,0,0,2
Brisbane Lions,"West, Trent",3,3,1,0,0,0,18,5
Brisbane Lions,"Zorko, Dayne",30,17,4,13,1,1,0,8
Brisbane Lions,"Adcock, Jed",17,10,4,7,0,0,0,3
Brisbane Lions,"Aish, James",13,7,4,6,1,0,0,2
Brisbane Lions,"Brown, Jonathan",4,2,1,2,0,0,0,2
Brisbane Lions,"Clarke, Justin",15,5,4,10,0,0,0,3
Brisbane Lions,"Close, Michael",6,4,3,2,0,0,0,3
Brisbane Lions,"Golby, Mitch",28,15,9,13,0,0,0,3
Brisbane Lions,"Green, Josh",7,3,0,4,0,1,0,3
Brisbane Lions,"Hanley, Pearce",30,24,6,6,1,1,0,2
Brisbane Lions,"Lester, Ryan",21,9,1,12,0,0,0,3
Brisbane Lions,"Leuenberger, Matthew",8,3,1,5,0,0,31,1
Brisbane Lions,"Lisle, Jordan",18,12,9,6,0,0,0,2
Brisbane Lions,"Mayes, Sam",9,7,3,2,1,0,0,2
Brisbane Lions,"Merrett, Daniel",15,9,5,6,0,0,0,2
Brisbane Lions,"Moloney, Brent",22,9,2,13,0,1,0,9
Brisbane Lions,"Paparone, Marco",13,10,4,3,2,1,0,3
Brisbane Lions,"Patfull, Joel",13,6,4,7,0,0,0,1
Brisbane Lions,"Redden, Jack",27,16,6,11,0,0,1,8
Brisbane Lions,"Rich, Daniel",8,6,4,2,0,0,0,3
Brisbane Lions,"Rockliff, Tom",35,18,11,17,3,0,0,5
Brisbane Lions,"Taylor, Lewis",14,7,4,7,1,1,0,2
Brisbane Lions,"West, Trent",15,9,5,6,0,0,22,1
Brisbane Lions,"Zorko, Dayne",20,10,2,10,0,2,0,3
Brisbane Lions,"Adcock, Jed",21,12,9,9,0,0,0,2
Brisbane Lions,"Aish, James",17,9,5,8,0,0,0,5
Brisbane Lions,"Bewick, Rohan",5,4,2,1,2,1,0,2
Brisbane Lions,"Brown, Jonathan",9,4,3,5,1,0,0,5
Brisbane Lions,"Clarke, Justin",8,6,4,2,1,0,0,2
Brisbane Lions,"Cutler, Tom",9,7,2,2,0,0,0,1
Brisbane Lions,"Golby, Mitch",16,9,7,7,0,0,0,2
Brisbane Lions,"Hanley, Pearce",9,6,5,3,0,0,0,2
Brisbane Lions,"Harwood, Ryan",18,9,5,9,0,0,0,2
Brisbane Lions,"Leuenberger, Matthew",2,0,0,2,0,0,8,1
Brisbane Lions,"Lisle, Jordan",22,16,9,6,0,0,0,0
Brisbane Lions,"Mayes, Sam",21,8,1,13,1,0,0,3
Brisbane Lions,"Moloney, Brent",23,9,2,14,0,0,0,6
Brisbane Lions,"Paine, Jackson",9,3,1,6,0,2,0,5
Brisbane Lions,"Paparone, Marco",14,10,4,4,0,1,0,0
Brisbane Lions,"Patfull, Joel",15,4,4,11,0,0,0,1
Brisbane Lions,"Redden, Jack",22,12,5,10,1,0,1,5
Brisbane Lions,"Robertson, Nick",14,7,1,7,0,0,0,3
Brisbane Lions,"Rockliff, Tom",30,14,3,16,0,0,0,13
Brisbane Lions,"Taylor, Lewis",16,8,3,8,0,0,0,5
Brisbane Lions,"West, Trent",13,8,5,5,0,0,22,2
Brisbane Lions,"Zorko, Dayne",20,6,2,14,1,0,0,6
Brisbane Lions,"Adcock, Jed",25,16,5,9,0,0,1,2
Brisbane Lions,"Aish, James",16,5,4,11,0,0,0,3
Brisbane Lions,"Bewick, Rohan",11,6,2,5,1,1,0,1
Brisbane Lions,"Brown, Jonathan",16,12,9,4,4,1,0,4
Brisbane Lions,"Clarke, Justin",14,9,3,5,0,0,0,1
Brisbane Lions,"Cutler, Tom",21,13,4,8,1,0,0,0
Brisbane Lions,"Gardiner, Darcy",11,6,2,5,0,0,1,1
Brisbane Lions,"Golby, Mitch",9,6,2,3,0,0,0,1
Brisbane Lions,"Lester, Ryan",26,13,4,13,1,0,1,4
Brisbane Lions,"Lisle, Jordan",11,8,4,3,0,0,4,0
Brisbane Lions,"Mayes, Sam",20,9,2,11,0,2,0,3
Brisbane Lions,"McGuane, Luke",4,2,1,2,0,0,0,0
Brisbane Lions,"Moloney, Brent",9,4,0,5,0,1,0,1
Brisbane Lions,"Paine, Jackson",3,2,0,1,1,0,0,1
Brisbane Lions,"Paparone, Marco",14,4,2,10,0,0,0,0
Brisbane Lions,"Patfull, Joel",7,2,2,5,0,1,0,2
Brisbane Lions,"Redden, Jack",24,11,2,13,0,0,2,7
Brisbane Lions,"Robertson, Nick",19,9,6,10,0,0,0,3
Brisbane Lions,"Rockliff, Tom",32,19,5,13,0,0,0,6
Brisbane Lions,"Taylor, Lewis",11,4,0,7,1,1,0,2
Brisbane Lions,"West, Trent",13,4,3,9,0,0,27,2
Brisbane Lions,"Zorko, Dayne",28,10,6,18,0,1,2,4
Brisbane Lions,"Adcock, Jed",24,19,3,5,0,0,0,3
Brisbane Lions,"Aish, James",25,12,8,13,1,0,0,4
Brisbane Lions,"Brown, Jonathan",14,5,2,9,2,0,0,1
Brisbane Lions,"Clarke, Justin",11,4,2,7,0,0,0,2
Brisbane Lions,"Cutler, Tom",4,4,0,0,0,0,0,3
Brisbane Lions,"Gardiner, Darcy",9,6,4,3,0,0,0,2
Brisbane Lions,"Green, Josh",14,9,0,5,1,2,0,3
Brisbane Lions,"Hanley, Pearce",20,16,5,4,0,0,0,1
Brisbane Lions,"Lester, Ryan",21,11,3,10,0,1,3,9
Brisbane Lions,"Mayes, Sam",18,12,1,6,0,1,0,3
Brisbane Lions,"McGuane, Luke",5,2,1,3,0,0,0,1
Brisbane Lions,"Merrett, Daniel",6,5,2,1,1,0,8,1
Brisbane Lions,"Paparone, Marco",8,4,2,4,0,0,0,2
Brisbane Lions,"Patfull, Joel",11,6,6,5,0,0,0,5
Brisbane Lions,"Polkinghorne, James",9,3,1,6,0,0,0,3
Brisbane Lions,"Raines, Andrew",24,11,0,13,1,0,0,3
Brisbane Lions,"Redden, Jack",29,15,3,14,2,0,0,5
Brisbane Lions,"Robertson, Nick",18,7,3,11,0,1,0,5
Brisbane Lions,"Rockliff, Tom",17,9,3,8,0,0,0,8
Brisbane Lions,"Taylor, Lewis",13,5,2,8,2,1,0,1
Brisbane Lions,"West, Trent",14,9,5,5,1,0,39,3
Brisbane Lions,"Zorko, Dayne",24,12,3,12,1,0,0,12
Brisbane Lions,"Adcock, Jed",20,14,5,6,0,0,0,1
Brisbane Lions,"Aish, James",20,13,4,7,0,0,0,2
Brisbane Lions,"Bewick, Rohan",4,1,0,3,0,0,0,2
Brisbane Lions,"Clarke, Justin",10,7,5,3,0,0,0,1
Brisbane Lions,"Cutler, Tom",11,6,3,5,1,0,0,0
Brisbane Lions,"Gardiner, Darcy",7,5,2,2,0,0,0,1
Brisbane Lions,"Golby, Mitch",9,6,4,3,0,0,0,3
Brisbane Lions,"Green, Josh",16,9,3,7,1,2,0,0
Brisbane Lions,"Lester, Ryan",17,10,5,7,1,0,3,5
Brisbane Lions,"Mayes, Sam",20,11,8,9,0,0,0,2
Brisbane Lions,"McGuane, Luke",7,3,2,4,0,1,0,0
Brisbane Lions,"Merrett, Daniel",13,7,5,6,0,0,3,0
Brisbane Lions,"Paparone, Marco",18,12,9,6,2,1,0,1
Brisbane Lions,"Patfull, Joel",12,8,9,4,0,0,0,2
Brisbane Lions,"Polkinghorne, James",9,6,1,3,0,0,0,2
Brisbane Lions,"Raines, Andrew",22,12,4,10,0,0,0,0
Brisbane Lions,"Redden, Jack",17,9,3,8,0,0,1,2
Brisbane Lions,"Robertson, Nick",16,11,5,5,0,1,0,7
Brisbane Lions,"Rockliff, Tom",30,12,7,18,1,1,2,11
Brisbane Lions,"Taylor, Lewis",14,5,5,9,0,0,0,0
Brisbane Lions,"West, Trent",12,5,3,7,0,0,29,1
Brisbane Lions,"Zorko, Dayne",16,7,3,9,0,1,0,6
Brisbane Lions,"Adcock, Jed",20,14,1,6,0,0,0,2
Brisbane Lions,"Aish, James",23,9,4,14,0,0,0,0
Brisbane Lions,"Brown, Jonathan",13,6,4,7,1,0,0,1
Brisbane Lions,"Clarke, Justin",15,8,7,7,0,0,0,0
Brisbane Lions,"Cutler, Tom",15,12,6,3,0,0,0,1
Brisbane Lions,"Gardiner, Darcy",9,2,2,7,0,0,0,3
Brisbane Lions,"Green, Josh",10,6,1,4,3,0,0,6
Brisbane Lions,"Hanley, Pearce",27,10,4,17,0,0,1,3
Brisbane Lions,"Lester, Ryan",19,5,3,14,0,0,1,1
Brisbane Lions,"Maguire, Matt",9,4,3,5,0,0,0,0
Brisbane Lions,"Mayes, Sam",21,13,6,8,0,0,0,2
Brisbane Lions,"Merrett, Daniel",11,6,5,5,1,3,4,2
Brisbane Lions,"Paine, Jackson",15,8,0,7,1,2,0,1
Brisbane Lions,"Paparone, Marco",29,19,7,10,1,0,0,0
Brisbane Lions,"Patfull, Joel",19,10,4,9,0,0,0,3
Brisbane Lions,"Raines, Andrew",17,5,3,12,0,0,0,0
Brisbane Lions,"Redden, Jack",25,14,4,11,0,1,2,3
Brisbane Lions,"Robertson, Nick",3,0,0,3,0,0,0,1
Brisbane Lions,"Rockliff, Tom",35,18,7,17,0,0,2,11
Brisbane Lions,"Taylor, Lewis",19,9,5,10,0,1,0,3
Brisbane Lions,"West, Trent",11,7,2,4,0,0,34,3
Brisbane Lions,"Zorko, Dayne",16,10,0,6,1,0,0,7
Brisbane Lions,"Adcock, Jed",24,18,8,6,0,0,0,4
Brisbane Lions,"Aish, James",20,13,5,7,0,0,0,2
Brisbane Lions,"Beams, Claye",12,6,2,6,1,0,0,5
Brisbane Lions,"Brown, Jonathan",2,1,2,1,0,0,0,2
Brisbane Lions,"Clarke, Justin",10,9,6,1,0,0,0,0
Brisbane Lions,"Close, Michael",4,2,2,2,2,0,0,2
Brisbane Lions,"Cutler, Tom",13,10,8,3,0,0,0,1
Brisbane Lions,"Gardiner, Darcy",15,11,8,4,0,0,0,2
Brisbane Lions,"Golby, Mitch",23,16,7,7,0,0,0,2
Brisbane Lions,"Green, Josh",13,9,3,4,3,0,0,3
Brisbane Lions,"Hanley, Pearce",17,9,6,8,0,1,1,7
Brisbane Lions,"Lester, Ryan",21,11,6,10,0,0,1,4
Brisbane Lions,"Lisle, Jordan",11,8,5,3,0,0,0,3
Brisbane Lions,"Merrett, Daniel",9,6,6,3,0,0,4,1
Brisbane Lions,"Paine, Jackson",14,7,3,7,0,0,0,3
Brisbane Lions,"Paparone, Marco",13,8,5,5,0,0,0,2
Brisbane Lions,"Raines, Andrew",13,7,3,6,0,0,0,3
Brisbane Lions,"Redden, Jack",25,17,8,8,0,0,0,6
Brisbane Lions,"Robertson, Nick",5,2,2,3,0,0,0,2
Brisbane Lions,"Taylor, Lewis",20,11,8,9,0,0,0,3
Brisbane Lions,"West, Trent",10,4,2,6,0,0,25,3
Brisbane Lions,"Zorko, Dayne",3,1,0,2,0,0,0,2
Brisbane Lions,"Adcock, Jed",19,14,3,5,0,0,0,1
Brisbane Lions,"Aish, James",15,6,1,9,0,0,0,5
Brisbane Lions,"Beams, Claye",10,4,3,6,1,0,0,2
Brisbane Lions,"Brown, Jonathan",13,8,5,5,3,1,0,1
Brisbane Lions,"Clarke, Justin",13,7,6,6,0,0,0,1
Brisbane Lions,"Gardiner, Darcy",10,5,3,5,0,0,0,0
Brisbane Lions,"Golby, Mitch",9,2,1,7,0,0,0,0
Brisbane Lions,"Green, Josh",15,7,1,8,2,3,0,0
Brisbane Lions,"Hanley, Pearce",22,14,4,8,0,0,0,9
Brisbane Lions,"Harwood, Ryan",12,7,3,5,0,0,0,4
Brisbane Lions,"Maguire, Matt",8,8,3,0,0,0,0,3
Brisbane Lions,"Mayes, Sam",18,12,4,6,0,2,0,0
Brisbane Lions,"Merrett, Daniel",16,10,2,6,2,0,3,3
Brisbane Lions,"OBrien, Zac",15,9,2,6,1,0,0,2
Brisbane Lions,"Paine, Jackson",4,3,0,1,1,0,0,1
Brisbane Lions,"Paparone, Marco",22,13,7,9,1,2,0,3
Brisbane Lions,"Patfull, Joel",14,7,4,7,0,0,0,0
Brisbane Lions,"Redden, Jack",28,17,9,11,1,0,1,4
Brisbane Lions,"Rockliff, Tom",36,19,6,17,0,0,3,13
Brisbane Lions,"Taylor, Lewis",12,10,5,2,0,1,0,0
Brisbane Lions,"West, Trent",2,0,0,2,0,0,9,1
Brisbane Lions,"Zorko, Dayne",23,12,5,11,2,1,0,7
Brisbane Lions,"Adcock, Jed",11,8,3,3,0,0,0,2
Brisbane Lions,"Aish, James",16,9,4,7,1,0,0,3
Brisbane Lions,"Beams, Claye",24,14,4,10,1,2,1,3
Brisbane Lions,"Bewick, Rohan",30,16,3,14,1,0,0,1
Brisbane Lions,"Brown, Jonathan",13,9,4,4,2,2,0,2
Brisbane Lions,"Clarke, Justin",7,3,5,4,0,0,0,1
Brisbane Lions,"Gardiner, Darcy",6,1,1,5,0,0,0,0
Brisbane Lions,"Golby, Mitch",14,9,6,5,0,0,0,2
Brisbane Lions,"Green, Josh",18,7,2,11,2,0,0,0
Brisbane Lions,"Hanley, Pearce",23,12,3,11,1,1,4,12
Brisbane Lions,"Harwood, Ryan",18,12,4,6,0,0,0,1
Brisbane Lions,"Maguire, Matt",14,10,5,4,0,0,0,0
Brisbane Lions,"Martin, Stefan",17,8,3,9,0,0,32,4
Brisbane Lions,"Mayes, Sam",14,5,4,9,0,0,0,3
Brisbane Lions,"Merrett, Daniel",11,6,3,5,0,0,5,3
Brisbane Lions,"OBrien, Zac",6,2,0,4,0,0,0,3
Brisbane Lions,"Paparone, Marco",8,4,5,4,1,0,0,3
Brisbane Lions,"Patfull, Joel",13,10,6,3,1,0,0,2
Brisbane Lions,"Redden, Jack",26,13,6,13,2,0,2,9
Brisbane Lions,"Rockliff, Tom",20,11,1,9,1,0,2,10
Brisbane Lions,"Taylor, Lewis",21,11,5,10,0,0,0,0
Brisbane Lions,"Zorko, Dayne",19,12,1,7,1,2,0,6
Brisbane Lions,"Adcock, Jed",13,10,2,3,0,0,0,2
Brisbane Lions,"Aish, James",8,5,1,3,0,2,0,3
Brisbane Lions,"Beams, Claye",14,9,5,5,0,2,1,1
Brisbane Lions,"Bewick, Rohan",14,8,3,6,0,0,0,1
Brisbane Lions,"Brown, Jonathan",8,5,3,3,2,0,0,2
Brisbane Lions,"Clarke, Justin",9,6,3,3,0,0,0,1
Brisbane Lions,"Close, Michael",4,4,3,0,2,0,6,3
Brisbane Lions,"Gardiner, Darcy",11,4,3,7,1,0,0,1
Brisbane Lions,"Golby, Mitch",9,8,3,1,0,0,0,2
Brisbane Lions,"Green, Josh",8,4,1,4,1,0,0,0
Brisbane Lions,"Hanley, Pearce",28,18,9,10,0,0,1,3
Brisbane Lions,"Harwood, Ryan",22,13,5,9,0,1,0,2
Brisbane Lions,"Maguire, Matt",14,11,3,3,0,0,0,1
Brisbane Lions,"Martin, Stefan",16,9,4,7,0,0,28,4
Brisbane Lions,"Mayes, Sam",15,5,3,10,0,0,0,1
Brisbane Lions,"OBrien, Zac",10,4,5,6,0,0,0,2
Brisbane Lions,"Paparone, Marco",24,16,7,8,0,0,0,2
Brisbane Lions,"Patfull, Joel",13,6,6,7,0,0,0,0
Brisbane Lions,"Redden, Jack",25,15,5,10,0,1,2,5
Brisbane Lions,"Rockliff, Tom",19,10,5,9,0,0,0,5
Brisbane Lions,"Taylor, Lewis",19,11,4,8,3,0,0,1
Brisbane Lions,"Zorko, Dayne",9,8,4,1,3,0,0,5
Brisbane Lions,"Adcock, Jed",15,12,3,3,0,0,0,5
Brisbane Lions,"Beams, Claye",10,3,1,7,0,0,0,3
Brisbane Lions,"Bewick, Rohan",12,8,6,4,1,0,1,1
Brisbane Lions,"Clarke, Justin",14,3,2,11,0,0,0,2
Brisbane Lions,"Close, Michael",3,2,1,1,0,0,0,8
Brisbane Lions,"Cutler, Tom",9,3,1,6,0,0,0,0
Brisbane Lions,"Gardiner, Darcy",9,5,3,4,0,0,0,3
Brisbane Lions,"Green, Josh",11,6,0,5,1,1,0,4
Brisbane Lions,"Hanley, Pearce",9,6,1,3,0,0,0,5
Brisbane Lions,"Harwood, Ryan",18,3,0,15,0,0,0,4
Brisbane Lions,"Maguire, Matt",14,12,3,2,0,0,0,3
Brisbane Lions,"Martin, Stefan",20,10,2,10,0,0,25,9
Brisbane Lions,"Mayes, Sam",21,10,3,11,0,0,0,5
Brisbane Lions,"Merrett, Daniel",5,4,2,1,1,1,2,3
Brisbane Lions,"OBrien, Zac",16,4,3,12,0,0,0,4
Brisbane Lions,"Paparone, Marco",9,5,0,4,0,0,0,0
Brisbane Lions,"Patfull, Joel",16,12,6,4,0,0,0,2
Brisbane Lions,"Redden, Jack",16,13,5,3,0,0,2,15
Brisbane Lions,"Robertson, Nick",14,5,2,9,0,0,0,8
Brisbane Lions,"Rockliff, Tom",45,26,5,19,0,0,1,12
Brisbane Lions,"Taylor, Lewis",20,9,3,11,0,0,0,1
Brisbane Lions,"Zorko, Dayne",11,3,0,8,0,0,0,6
Brisbane Lions,"Adcock, Jed",17,10,4,7,0,0,0,3
Brisbane Lions,"Aish, James",23,16,9,7,2,0,0,9
Brisbane Lions,"Beams, Claye",18,11,4,7,2,0,0,2
Brisbane Lions,"Bewick, Rohan",24,13,7,11,0,0,0,1
Brisbane Lions,"Clarke, Justin",13,9,9,4,0,0,0,1
Brisbane Lions,"Close, Michael",15,7,5,8,1,0,2,4
Brisbane Lions,"Green, Josh",9,8,2,1,3,0,0,4
Brisbane Lions,"Hanley, Pearce",34,24,6,10,0,1,0,5
Brisbane Lions,"Harwood, Ryan",20,15,8,5,0,0,0,4
Brisbane Lions,"Lester, Ryan",10,4,3,6,0,0,1,5
Brisbane Lions,"Maguire, Matt",11,8,4,3,0,0,0,1
Brisbane Lions,"Martin, Stefan",20,9,6,11,0,0,36,3
Brisbane Lions,"Mayes, Sam",10,7,4,3,0,1,0,1
Brisbane Lions,"McGrath, Ashley",4,3,2,1,0,1,0,3
Brisbane Lions,"McStay, Daniel",5,2,1,3,0,0,0,2
Brisbane Lions,"Merrett, Daniel",7,4,4,3,1,0,0,1
Brisbane Lions,"Paparone, Marco",12,4,4,8,0,0,0,3
Brisbane Lions,"Patfull, Joel",15,11,9,4,0,0,0,5
Brisbane Lions,"Redden, Jack",28,13,5,15,0,1,2,9
Brisbane Lions,"Rockliff, Tom",28,18,4,10,0,0,1,10
Brisbane Lions,"Taylor, Lewis",23,16,10,7,0,1,0,5
Brisbane Lions,"Zorko, Dayne",20,11,2,9,1,0,0,8
Brisbane Lions,"Adcock, Jed",16,8,5,8,0,0,0,1
Brisbane Lions,"Aish, James",8,2,0,6,0,0,0,4
Brisbane Lions,"Beams, Claye",16,9,2,7,0,1,2,0
Brisbane Lions,"Bewick, Rohan",17,8,4,9,1,0,0,1
Brisbane Lions,"Clarke, Justin",15,8,6,7,0,0,0,2
Brisbane Lions,"Close, Michael",7,3,2,4,1,0,2,1
Brisbane Lions,"Gardiner, Darcy",22,9,4,13,0,0,0,3
Brisbane Lions,"Green, Josh",11,8,5,3,1,2,0,2
Brisbane Lions,"Hanley, Pearce",34,18,3,16,0,0,1,1
Brisbane Lions,"Harwood, Ryan",16,8,5,8,0,0,0,6
Brisbane Lions,"Lester, Ryan",20,11,6,9,0,0,1,2
Brisbane Lions,"Maguire, Matt",20,11,4,9,0,0,0,2
Brisbane Lions,"Martin, Stefan",20,10,5,10,0,0,32,2
Brisbane Lions,"Mayes, Sam",10,4,2,6,1,0,0,4
Brisbane Lions,"McGrath, Ashley",6,3,3,3,0,2,0,0
Brisbane Lions,"McStay, Daniel",15,7,6,8,0,0,0,1
Brisbane Lions,"Merrett, Daniel",6,2,2,4,0,1,0,0
Brisbane Lions,"Paparone, Marco",20,11,5,9,0,0,0,1
Brisbane Lions,"Patfull, Joel",22,11,7,11,0,0,0,4
Brisbane Lions,"Rockliff, Tom",36,19,5,17,0,1,1,10
Brisbane Lions,"Taylor, Lewis",18,11,3,7,1,0,0,3
Brisbane Lions,"Zorko, Dayne",21,9,3,12,2,0,0,1
Brisbane Lions,"Adcock, Jed",24,12,5,12,0,0,0,1
Brisbane Lions,"Aish, James",20,10,5,10,0,1,0,9
Brisbane Lions,"Beams, Claye",10,3,1,7,0,0,0,2
Brisbane Lions,"Bewick, Rohan",15,9,5,6,0,0,0,3
Brisbane Lions,"Clarke, Justin",7,2,2,5,0,0,0,3
Brisbane Lions,"Close, Michael",7,4,3,3,0,1,4,1
Brisbane Lions,"Gardiner, Darcy",7,4,2,3,0,0,0,3
Brisbane Lions,"Golby, Mitch",21,15,8,6,0,1,0,3
Brisbane Lions,"Green, Josh",13,9,3,4,2,0,0,2
Brisbane Lions,"Hanley, Pearce",21,12,3,9,0,1,2,2
Brisbane Lions,"Harwood, Ryan",28,12,2,16,1,0,0,4
Brisbane Lions,"Lester, Ryan",20,6,4,14,0,0,1,5
Brisbane Lions,"Maguire, Matt",17,11,9,6,0,0,0,2
Brisbane Lions,"Martin, Stefan",24,13,7,11,0,0,25,2
Brisbane Lions,"Mayes, Sam",20,12,7,8,1,1,0,6
Brisbane Lions,"McGrath, Ashley",10,7,3,3,2,1,0,3
Brisbane Lions,"McStay, Daniel",12,6,6,6,0,0,0,1
Brisbane Lions,"Merrett, Daniel",10,4,3,6,1,0,1,2
Brisbane Lions,"Paparone, Marco",2,0,0,2,0,0,0,1
Brisbane Lions,"Patfull, Joel",19,6,5,13,1,0,0,2
Brisbane Lions,"Taylor, Lewis",13,8,4,5,1,0,0,2
Brisbane Lions,"Zorko, Dayne",26,12,4,14,0,0,0,8
Brisbane Lions,"Adcock, Jed",17,10,1,7,0,0,0,4
Brisbane Lions,"Aish, James",20,12,3,8,0,0,0,4
Brisbane Lions,"Beams, Claye",1,1,0,0,0,0,0,1
Brisbane Lions,"Bewick, Rohan",15,13,2,2,0,0,0,1
Brisbane Lions,"Clarke, Justin",15,6,4,9,0,0,0,1
Brisbane Lions,"Close, Michael",11,5,5,6,2,0,2,1
Brisbane Lions,"Crisp, Jack",20,12,3,8,1,1,0,7
Brisbane Lions,"Gardiner, Darcy",12,4,2,8,0,0,0,1
Brisbane Lions,"Green, Josh",11,8,3,3,3,0,0,7
Brisbane Lions,"Hanley, Pearce",45,29,9,16,2,1,1,5
Brisbane Lions,"Harwood, Ryan",24,14,5,10,0,0,0,5
Brisbane Lions,"Lester, Ryan",19,7,2,12,0,0,4,6
Brisbane Lions,"Maguire, Matt",14,11,4,3,1,0,0,2
Brisbane Lions,"Martin, Stefan",19,11,8,8,0,1,37,4
Brisbane Lions,"Mayes, Sam",17,8,3,9,0,1,0,3
Brisbane Lions,"McGrath, Ashley",9,8,2,1,2,1,0,4
Brisbane Lions,"McStay, Daniel",10,5,3,5,1,0,0,2
Brisbane Lions,"Merrett, Daniel",12,5,3,7,0,1,2,2
Brisbane Lions,"Patfull, Joel",18,8,7,10,0,0,0,2
Brisbane Lions,"Rockliff, Tom",47,31,5,16,1,0,0,10
Brisbane Lions,"Taylor, Lewis",11,5,2,6,1,0,0,4
Brisbane Lions,"Zorko, Dayne",32,19,4,13,2,4,0,7
Brisbane Lions,"Adcock, Jed",23,19,9,4,1,0,0,4
Brisbane Lions,"Aish, James",13,5,5,8,0,1,0,3
Brisbane Lions,"Beams, Claye",12,8,1,4,1,0,1,2
Brisbane Lions,"Bewick, Rohan",27,17,7,10,0,1,0,1
Brisbane Lions,"Clarke, Justin",9,7,6,2,0,0,0,0
Brisbane Lions,"Close, Michael",14,10,4,4,2,1,2,3
Brisbane Lions,"Crisp, Jack",20,13,10,7,0,0,1,3
Brisbane Lions,"Gardiner, Darcy",18,8,12,10,0,0,0,0
Brisbane Lions,"Green, Josh",5,4,3,1,0,1,0,2
Brisbane Lions,"Hanley, Pearce",24,15,4,9,1,1,3,5
Brisbane Lions,"Harwood, Ryan",19,15,8,4,1,0,0,0
Brisbane Lions,"Lester, Ryan",10,5,4,5,0,0,3,5
Brisbane Lions,"Maguire, Matt",14,9,7,5,0,0,0,3
Brisbane Lions,"Martin, Stefan",24,14,6,10,0,0,23,3
Brisbane Lions,"Mayes, Sam",19,8,8,11,0,0,0,0
Brisbane Lions,"McGrath, Ashley",1,0,0,1,0,0,0,0
Brisbane Lions,"McStay, Daniel",14,10,6,4,3,0,0,1
Brisbane Lions,"Merrett, Daniel",10,7,6,3,1,1,0,2
Brisbane Lions,"Patfull, Joel",15,8,8,7,0,0,0,5
Brisbane Lions,"Rockliff, Tom",32,14,3,18,0,0,1,7
Brisbane Lions,"Taylor, Lewis",16,11,5,5,1,0,0,5
Brisbane Lions,"Zorko, Dayne",17,9,1,8,0,0,0,3
Brisbane Lions,"Adcock, Jed",14,10,1,4,0,0,0,2
Brisbane Lions,"Aish, James",17,5,1,12,0,0,0,2
Brisbane Lions,"Bewick, Rohan",22,11,8,11,0,1,0,1
Brisbane Lions,"Clarke, Justin",0,0,0,0,0,0,0,1
Brisbane Lions,"Close, Michael",3,2,2,1,0,1,0,3
Brisbane Lions,"Crisp, Jack",16,10,7,6,3,0,1,3
Brisbane Lions,"Freeman, Jonathan",5,2,2,3,0,1,0,2
Brisbane Lions,"Gardiner, Darcy",11,4,5,7,0,0,0,0
Brisbane Lions,"Green, Josh",13,8,1,5,2,0,0,2
Brisbane Lions,"Hanley, Pearce",27,12,4,15,0,0,2,3
Brisbane Lions,"Harwood, Ryan",17,9,3,8,0,0,0,3
Brisbane Lions,"Maguire, Matt",16,9,8,7,0,1,0,2
Brisbane Lions,"Martin, Stefan",26,14,10,12,0,2,30,0
Brisbane Lions,"Mayes, Sam",21,11,7,10,1,0,0,1
Brisbane Lions,"McStay, Daniel",13,5,6,8,1,0,0,0
Brisbane Lions,"Merrett, Daniel",6,2,3,4,0,0,0,0
Brisbane Lions,"Paparone, Marco",13,6,3,7,0,0,0,1
Brisbane Lions,"Patfull, Joel",17,4,3,13,0,0,0,2
Brisbane Lions,"Robertson, Nick",14,9,5,5,0,0,1,5
Brisbane Lions,"Rockliff, Tom",40,22,10,18,1,1,0,10
Brisbane Lions,"Taylor, Lewis",17,4,2,13,0,0,0,1
Brisbane Lions,"Zorko, Dayne",29,8,1,21,1,1,0,2
Brisbane Lions,"Adcock, Jed",25,12,2,13,1,0,0,9
Brisbane Lions,"Aish, James",19,7,7,12,0,1,0,4
Brisbane Lions,"Beams, Claye",17,8,6,9,1,0,0,1
Brisbane Lions,"Bewick, Rohan",19,9,5,10,1,0,0,3
Brisbane Lions,"Clarke, Justin",10,5,4,5,0,0,0,1
Brisbane Lions,"Close, Michael",6,4,3,2,0,1,1,0
Brisbane Lions,"Crisp, Jack",22,12,5,10,1,3,0,1
Brisbane Lions,"Freeman, Jonathan",8,5,2,3,4,1,0,0
Brisbane Lions,"Gardiner, Darcy",16,10,4,6,1,0,0,5
Brisbane Lions,"Green, Josh",17,10,5,7,2,0,0,1
Brisbane Lions,"Hanley, Pearce",34,24,6,10,1,1,3,6
Brisbane Lions,"Harwood, Ryan",20,13,4,7,0,1,0,4
Brisbane Lions,"Maguire, Matt",18,12,9,6,0,0,0,1
Brisbane Lions,"Martin, Stefan",32,6,7,26,0,0,27,1
Brisbane Lions,"Mayes, Sam",18,14,6,4,0,0,0,1
Brisbane Lions,"McStay, Daniel",14,6,6,8,1,0,0,2
Brisbane Lions,"Merrett, Daniel",9,5,4,4,3,1,1,0
Brisbane Lions,"Paparone, Marco",4,2,1,2,0,0,0,0
Brisbane Lions,"Patfull, Joel",19,10,5,9,0,0,0,1
Brisbane Lions,"Rockliff, Tom",43,18,9,25,0,0,1,9
Brisbane Lions,"Taylor, Lewis",24,16,5,8,0,1,0,2
Brisbane Lions,"Zorko, Dayne",36,15,4,21,2,1,0,5
Brisbane Lions,"Adcock, Jed",20,10,4,10,1,0,0,2
Brisbane Lions,"Aish, James",25,10,5,15,0,0,0,3
Brisbane Lions,"Beams, Claye",14,9,5,5,0,0,0,2
Brisbane Lions,"Bewick, Rohan",33,15,8,18,0,1,0,3
Brisbane Lions,"Clarke, Justin",6,5,3,1,0,0,0,1
Brisbane Lions,"Close, Michael",1,0,0,1,0,0,0,0
Brisbane Lions,"Crisp, Jack",20,8,6,12,1,1,0,2
Brisbane Lions,"Freeman, Jonathan",3,2,2,1,2,0,0,1
Brisbane Lions,"Gardiner, Darcy",11,4,2,7,0,0,0,5
Brisbane Lions,"Green, Josh",12,5,1,7,1,1,0,1
Brisbane Lions,"Hanley, Pearce",20,6,2,14,0,1,0,4
Brisbane Lions,"Harwood, Ryan",22,10,5,12,0,0,0,3
Brisbane Lions,"Maguire, Matt",11,5,3,6,0,0,0,1
Brisbane Lions,"Martin, Stefan",19,7,5,12,0,0,28,5
Brisbane Lions,"Mayes, Sam",14,7,5,7,0,0,0,2
Brisbane Lions,"McGrath, Ashley",13,10,6,3,1,3,0,2
Brisbane Lions,"McStay, Daniel",9,4,2,5,0,0,0,1
Brisbane Lions,"Merrett, Daniel",8,2,3,6,0,0,3,1
Brisbane Lions,"Patfull, Joel",14,5,6,9,0,0,0,1
Brisbane Lions,"Rockliff, Tom",45,18,4,27,0,0,0,8
Brisbane Lions,"Taylor, Lewis",26,13,7,13,0,0,0,0
Brisbane Lions,"Zorko, Dayne",38,15,7,23,0,0,0,5
Brisbane Lions,"Adcock, Jed",18,11,2,7,0,0,0,3
Brisbane Lions,"Aish, James",20,9,6,11,1,0,0,4
Brisbane Lions,"Beams, Claye",9,3,3,6,2,0,0,1
Brisbane Lions,"Bewick, Rohan",12,3,2,9,1,0,0,1
Brisbane Lions,"Bourke, Jordon",14,9,6,5,0,0,0,4
Brisbane Lions,"Clarke, Justin",8,3,2,5,0,0,0,3
Brisbane Lions,"Crisp, Jack",15,8,4,7,0,1,0,1
Brisbane Lions,"Freeman, Jonathan",4,2,2,2,0,1,0,0
Brisbane Lions,"Gardiner, Darcy",8,4,2,4,0,0,0,1
Brisbane Lions,"Golby, Mitch",7,6,2,1,0,0,0,0
Brisbane Lions,"Green, Josh",11,8,1,3,3,0,0,0
Brisbane Lions,"Hanley, Pearce",31,20,2,11,0,2,0,2
Brisbane Lions,"Lester, Ryan",24,7,3,17,1,0,1,4
Brisbane Lions,"Leuenberger, Matthew",11,2,2,9,0,1,36,6
Brisbane Lions,"Martin, Stefan",32,11,6,21,1,1,15,2
Brisbane Lions,"Mayes, Sam",12,6,7,6,0,1,0,1
Brisbane Lions,"McStay, Daniel",15,5,6,10,1,0,0,0
Brisbane Lions,"Merrett, Daniel",7,4,2,3,1,0,0,0
Brisbane Lions,"OBrien, Zac",30,12,3,18,0,0,0,5
Brisbane Lions,"Paine, Jackson",5,2,2,3,0,0,0,1
Brisbane Lions,"Patfull, Joel",15,9,4,6,0,0,0,4
Brisbane Lions,"Taylor, Lewis",22,11,3,11,1,0,0,2
Carlton,"Bell, Tom",15,7,2,8,0,2,0,5
Carlton,"Curnow, Ed",19,9,1,10,2,0,0,8
Carlton,"Ellard, David",18,10,4,8,2,1,0,7
Carlton,"Everitt, Andrejs",12,6,5,6,1,0,0,2
Carlton,"Garlett, Jeff",7,6,3,1,1,2,0,2
Carlton,"Gibbs, Bryce",23,11,5,12,2,1,0,2
Carlton,"Henderson, Lachie",6,4,4,2,0,0,0,0
Carlton,"Jamison, Michael",8,6,6,2,0,0,0,2
Carlton,"Kreuzer, Matthew",14,9,3,5,0,0,13,0
Carlton,"McInnes, Andrew",11,7,1,4,0,0,0,2
Carlton,"McLean, Brock",17,5,4,12,0,0,0,3
Carlton,"Menzel, Troy",2,0,1,2,0,0,0,0
Carlton,"Murphy, Marc",23,7,2,16,0,0,0,6
Carlton,"Robinson, Mitch",20,15,2,5,0,2,0,2
Carlton,"Simpson, Kade",25,12,1,13,0,0,1,4
Carlton,"Thomas, Dale",16,9,2,7,1,2,0,2
Carlton,"Tuohy, Zach",13,7,1,6,0,1,0,2
Carlton,"Waite, Jarrad",8,6,4,2,2,0,0,3
Carlton,"Walker, Andrew",22,16,3,6,0,0,0,1
Carlton,"Warnock, Robert",4,3,1,1,0,0,31,1
Carlton,"Watson, Matthew",13,6,3,7,0,0,0,2
Carlton,"Yarran, Chris",14,9,4,5,1,0,0,1
Carlton,"Bell, Tom",22,13,7,9,1,0,0,1
Carlton,"Buckley, Dylan",18,10,2,8,0,0,0,6
Carlton,"Curnow, Ed",25,13,7,12,0,0,0,9
Carlton,"Ellard, David",8,4,2,4,0,1,0,6
Carlton,"Everitt, Andrejs",13,11,3,2,2,0,0,5
Carlton,"Garlett, Jeff",13,13,5,0,1,3,0,2
Carlton,"Gibbs, Bryce",12,5,0,7,1,0,1,6
Carlton,"Henderson, Lachie",14,10,8,4,0,0,0,2
Carlton,"Jamison, Michael",6,4,0,2,0,1,0,3
Carlton,"Lucas, Kane",6,5,1,1,0,0,0,1
Carlton,"McLean, Brock",8,2,0,6,0,0,0,0
Carlton,"Menzel, Troy",11,10,3,1,2,0,0,1
Carlton,"Murphy, Marc",28,19,4,9,0,2,0,3
Carlton,"Robinson, Mitch",24,13,7,11,0,0,0,1
Carlton,"Rowe, Sam",8,4,3,4,0,0,6,2
Carlton,"Simpson, Kade",23,20,6,3,1,0,0,2
Carlton,"Thomas, Dale",23,12,3,11,0,0,0,4
Carlton,"Tuohy, Zach",10,7,4,3,0,0,0,2
Carlton,"Waite, Jarrad",13,11,7,2,1,3,0,5
Carlton,"Warnock, Robert",14,6,0,8,0,0,30,4
Carlton,"White, Simon",9,5,4,4,0,0,0,2
Carlton,"Yarran, Chris",21,16,5,5,3,1,0,2
Carlton,"Bell, Tom",10,9,3,1,0,0,0,0
Carlton,"Buckley, Dylan",12,7,6,5,0,0,0,1
Carlton,"Carrazzo, Andrew",23,7,0,16,0,0,0,5
Carlton,"Curnow, Ed",15,8,5,7,0,0,0,4
Carlton,"Ellard, David",9,5,2,4,2,0,0,2
Carlton,"Everitt, Andrejs",17,15,5,2,0,0,0,0
Carlton,"Garlett, Jeff",5,4,1,1,1,0,0,4
Carlton,"Gibbs, Bryce",27,14,7,13,0,0,3,2
Carlton,"Henderson, Lachie",7,4,3,3,1,2,0,4
Carlton,"Jamison, Michael",15,7,3,8,0,0,0,1
Carlton,"Menzel, Troy",13,8,5,5,2,1,0,2
Carlton,"Murphy, Marc",21,15,4,6,1,0,0,8
Carlton,"Robinson, Mitch",22,9,2,13,0,0,0,5
Carlton,"Rowe, Sam",15,4,5,11,0,1,14,2
Carlton,"Simpson, Kade",19,15,6,4,0,1,0,4
Carlton,"Thomas, Dale",18,8,7,10,0,0,0,5
Carlton,"Tuohy, Zach",15,8,1,7,1,0,0,3
Carlton,"Waite, Jarrad",9,7,4,2,0,2,0,1
Carlton,"Walker, Andrew",27,14,5,13,0,0,0,0
Carlton,"Warnock, Robert",5,4,1,1,0,0,41,1
Carlton,"White, Simon",2,0,0,2,0,0,0,1
Carlton,"Yarran, Chris",11,8,2,3,0,0,0,2
Carlton,"Buckley, Dylan",12,8,2,4,0,0,0,1
Carlton,"Carrazzo, Andrew",17,8,2,9,0,1,0,5
Carlton,"Casboult, Levi",16,8,8,8,1,0,4,3
Carlton,"Cripps, Patrick",17,5,3,12,0,1,0,5
Carlton,"Curnow, Ed",33,16,9,17,0,0,0,9
Carlton,"Ellard, David",13,7,1,6,2,2,0,5
Carlton,"Everitt, Andrejs",16,7,4,9,0,2,0,0
Carlton,"Gibbs, Bryce",26,13,2,13,0,3,2,6
Carlton,"Graham, Nick",11,10,5,1,0,1,0,4
Carlton,"Henderson, Lachie",15,8,5,7,1,1,0,1
Carlton,"Jamison, Michael",12,7,7,5,0,0,0,2
Carlton,"Lucas, Kane",20,12,8,8,0,0,0,1
Carlton,"Menzel, Troy",1,1,1,0,0,0,0,2
Carlton,"Murphy, Marc",18,10,3,8,1,0,0,4
Carlton,"Rowe, Sam",12,6,6,6,0,0,0,3
Carlton,"Scotland, Heath",19,9,3,10,0,0,0,4
Carlton,"Simpson, Kade",27,19,9,8,0,0,0,2
Carlton,"Thomas, Dale",18,13,6,5,0,0,0,1
Carlton,"Tuohy, Zach",10,7,2,3,0,0,0,2
Carlton,"Walker, Andrew",25,21,5,4,0,0,0,2
Carlton,"Warnock, Robert",15,9,4,6,0,0,35,0
Carlton,"Yarran, Chris",21,17,4,4,2,2,0,3
Carlton,"Bell, Tom",18,10,3,8,1,0,0,7
Carlton,"Carrazzo, Andrew",22,9,2,13,0,0,0,8
Carlton,"Casboult, Levi",10,3,5,7,0,1,4,2
Carlton,"Cripps, Patrick",7,4,1,3,0,0,0,1
Carlton,"Curnow, Ed",21,6,1,15,0,0,0,8
Carlton,"Ellard, David",8,5,3,3,1,1,0,3
Carlton,"Everitt, Andrejs",15,7,4,8,1,0,0,2
Carlton,"Gibbs, Bryce",29,18,2,11,1,0,3,5
Carlton,"Henderson, Lachie",16,13,8,3,5,3,0,1
Carlton,"Judd, Chris",3,2,0,1,0,0,0,0
Carlton,"Lucas, Kane",12,4,0,8,0,0,0,9
Carlton,"Murphy, Marc",28,16,5,12,2,1,0,12
Carlton,"Rowe, Sam",5,1,0,4,0,0,0,1
Carlton,"Scotland, Heath",18,10,7,8,2,0,0,0
Carlton,"Simpson, Kade",23,16,7,7,0,1,0,2
Carlton,"Thomas, Dale",16,11,3,5,1,1,0,7
Carlton,"Tuohy, Zach",18,11,2,7,0,0,0,2
Carlton,"Waite, Jarrad",17,13,8,4,3,2,0,2
Carlton,"Walker, Andrew",26,19,5,7,0,0,0,5
Carlton,"Warnock, Robert",9,5,1,4,0,0,38,4
Carlton,"White, Simon",12,6,3,6,0,0,0,2
Carlton,"Yarran, Chris",13,11,3,2,1,0,0,5
Carlton,"Buckley, Dylan",16,10,4,6,1,1,0,3
Carlton,"Casboult, Levi",14,6,9,8,0,0,5,0
Carlton,"Everitt, Andrejs",17,8,7,9,0,0,0,2
Carlton,"Garlett, Jeff",14,10,4,4,3,1,0,5
Carlton,"Gibbs, Bryce",24,14,3,10,0,1,0,11
Carlton,"Henderson, Lachie",10,10,9,0,2,0,0,3
Carlton,"Jamison, Michael",14,9,4,5,0,0,0,2
Carlton,"Lucas, Kane",19,6,5,13,0,0,0,2
Carlton,"McLean, Brock",32,18,4,14,1,1,0,5
Carlton,"Menzel, Troy",8,6,1,2,1,0,0,1
Carlton,"Murphy, Marc",32,17,5,15,1,0,0,11
Carlton,"Robinson, Mitch",20,10,3,10,1,0,0,2
Carlton,"Rowe, Sam",8,3,3,5,0,0,0,0
Carlton,"Scotland, Heath",19,14,5,5,0,0,0,2
Carlton,"Simpson, Kade",26,16,6,10,0,1,0,5
Carlton,"Thomas, Dale",22,11,6,11,0,1,0,4
Carlton,"Tuohy, Zach",14,7,5,7,1,0,0,3
Carlton,"Waite, Jarrad",20,16,10,4,2,1,0,0
Carlton,"Walker, Andrew",21,17,3,4,0,0,0,6
Carlton,"Warnock, Robert",8,3,0,5,1,0,22,2
Carlton,"White, Simon",15,6,5,9,0,0,0,3
Carlton,"Yarran, Chris",11,8,4,3,0,0,0,0
Carlton,"Bell, Tom",9,6,1,3,1,0,0,5
Carlton,"Buckley, Dylan",16,8,5,8,0,0,0,2
Carlton,"Casboult, Levi",14,5,8,9,1,2,5,0
Carlton,"Docherty, Sam",13,9,6,4,0,0,0,1
Carlton,"Everitt, Andrejs",23,13,12,10,1,1,0,2
Carlton,"Garlett, Jeff",7,7,2,0,1,0,0,3
Carlton,"Gibbs, Bryce",18,9,4,9,1,0,0,3
Carlton,"Henderson, Lachie",6,3,2,3,2,0,0,0
Carlton,"Jamison, Michael",12,9,4,3,0,0,0,2
Carlton,"Lucas, Kane",6,2,2,4,0,0,0,2
Carlton,"McLean, Brock",19,13,1,6,1,0,0,2
Carlton,"Menzel, Troy",4,2,0,2,0,1,0,1
Carlton,"Murphy, Marc",20,12,1,8,0,0,0,5
Carlton,"Robinson, Mitch",14,9,6,5,1,1,0,3
Carlton,"Rowe, Sam",13,7,5,6,0,0,0,1
Carlton,"Scotland, Heath",19,13,2,6,0,1,0,6
Carlton,"Simpson, Kade",24,13,5,11,0,1,0,3
Carlton,"Thomas, Dale",13,11,6,2,0,0,0,3
Carlton,"Tuohy, Zach",22,10,2,12,0,0,0,0
Carlton,"Walker, Andrew",24,14,5,10,0,0,0,2
Carlton,"Warnock, Robert",13,10,0,3,1,0,24,1
Carlton,"White, Simon",16,11,9,5,0,0,1,2
Carlton,"Armfield, Dennis",12,8,2,4,0,0,0,6
Carlton,"Buckley, Dylan",15,6,5,9,0,0,0,4
Carlton,"Casboult, Levi",10,7,7,3,0,3,5,3
Carlton,"Docherty, Sam",20,15,7,5,2,1,0,3
Carlton,"Ellard, David",10,6,6,4,1,0,0,7
Carlton,"Everitt, Andrejs",18,9,8,9,0,0,0,4
Carlton,"Garlett, Jeff",4,2,0,2,1,0,0,1
Carlton,"Gibbs, Bryce",38,16,6,22,0,0,3,5
Carlton,"Henderson, Lachie",11,9,5,2,0,1,0,3
Carlton,"Jamison, Michael",16,13,7,3,1,0,0,0
Carlton,"McLean, Brock",29,18,7,11,0,1,0,6
Carlton,"Menzel, Troy",14,11,6,3,3,2,0,2
Carlton,"Murphy, Marc",32,17,8,15,0,0,0,4
Carlton,"Robinson, Mitch",18,8,5,10,1,0,0,4
Carlton,"Rowe, Sam",16,10,6,6,0,0,0,2
Carlton,"Simpson, Kade",36,24,10,12,1,0,0,3
Carlton,"Thomas, Dale",8,7,4,1,1,0,0,2
Carlton,"Tuohy, Zach",14,8,6,6,0,0,0,1
Carlton,"Walker, Andrew",17,13,5,4,0,0,0,1
Carlton,"Warnock, Robert",13,7,0,6,0,0,40,0
Carlton,"White, Simon",7,4,3,3,0,0,0,3
Carlton,"Yarran, Chris",22,15,5,7,4,1,0,3
Carlton,"Armfield, Dennis",12,3,1,9,0,0,0,6
Carlton,"Buckley, Dylan",12,8,4,4,0,0,0,2
Carlton,"Casboult, Levi",10,4,4,6,1,0,5,4
Carlton,"Docherty, Sam",17,13,3,4,2,0,0,1
Carlton,"Ellard, David",15,10,3,5,1,1,0,3
Carlton,"Everitt, Andrejs",21,7,1,14,1,1,0,7
Carlton,"Garlett, Jeff",3,1,1,2,0,0,0,1
Carlton,"Gibbs, Bryce",31,14,4,17,0,1,2,6
Carlton,"Henderson, Lachie",6,3,2,3,0,0,0,4
Carlton,"Jamison, Michael",10,7,2,3,0,0,0,1
Carlton,"McLean, Brock",26,15,6,11,0,1,0,4
Carlton,"Menzel, Troy",11,10,6,1,3,2,0,0
Carlton,"Murphy, Marc",24,16,3,8,0,0,0,0
Carlton,"Rowe, Sam",15,7,5,8,0,0,0,0
Carlton,"Simpson, Kade",37,21,11,16,1,0,0,3
Carlton,"Thomas, Dale",23,16,9,7,1,0,0,5
Carlton,"Tuohy, Zach",19,16,3,3,0,0,0,1
Carlton,"Waite, Jarrad",17,14,7,3,1,2,0,4
Carlton,"Walker, Andrew",20,15,7,5,0,0,0,2
Carlton,"Warnock, Robert",11,2,2,9,0,0,29,1
Carlton,"White, Simon",11,8,3,3,0,0,0,3
Carlton,"Yarran, Chris",23,15,7,8,1,1,0,2
Carlton,"Buckley, Dylan",6,2,1,4,0,0,0,3
Carlton,"Carrazzo, Andrew",18,8,6,10,0,0,0,6
Carlton,"Casboult, Levi",14,5,4,9,0,0,12,5
Carlton,"Docherty, Sam",30,21,5,9,1,0,0,1
Carlton,"Ellard, David",6,5,0,1,1,0,0,4
Carlton,"Everitt, Andrejs",20,13,3,7,1,1,0,2
Carlton,"Garlett, Jeff",6,6,3,0,3,0,0,1
Carlton,"Gibbs, Bryce",18,9,3,9,0,0,0,4
Carlton,"Henderson, Lachie",10,9,6,1,3,1,0,1
Carlton,"Jamison, Michael",8,6,3,2,0,0,0,1
Carlton,"McLean, Brock",26,17,6,9,0,3,0,1
Carlton,"Menzel, Troy",10,6,2,4,1,0,0,1
Carlton,"Murphy, Marc",38,22,8,16,1,1,0,6
Carlton,"Robinson, Mitch",12,5,4,7,0,0,0,6
Carlton,"Rowe, Sam",7,5,3,2,0,0,1,4
Carlton,"Simpson, Kade",29,17,5,12,0,0,0,3
Carlton,"Thomas, Dale",19,10,5,9,0,1,0,4
Carlton,"Tuohy, Zach",16,7,2,9,1,1,0,1
Carlton,"Waite, Jarrad",7,5,1,2,1,0,0,3
Carlton,"Warnock, Robert",14,8,0,6,0,0,57,2
Carlton,"White, Simon",11,8,3,3,0,0,0,1
Carlton,"Yarran, Chris",21,14,2,7,0,1,0,4
Carlton,"Armfield, Dennis",11,5,1,6,0,0,0,1
Carlton,"Carrazzo, Andrew",17,5,1,12,0,0,0,8
Carlton,"Casboult, Levi",16,10,8,6,1,1,5,3
Carlton,"Docherty, Sam",21,14,7,7,0,1,0,4
Carlton,"Everitt, Andrejs",19,9,5,10,0,1,1,0
Carlton,"Garlett, Jeff",13,9,2,4,1,1,0,4
Carlton,"Gibbs, Bryce",29,21,3,8,4,2,1,6
Carlton,"Henderson, Lachie",8,5,3,3,0,0,0,2
Carlton,"Jamison, Michael",12,10,10,2,0,1,0,1
Carlton,"McLean, Brock",18,10,7,8,1,0,0,5
Carlton,"Menzel, Troy",12,10,4,2,2,0,0,1
Carlton,"Murphy, Marc",20,11,3,9,0,0,0,6
Carlton,"Robinson, Mitch",18,6,2,12,0,0,0,3
Carlton,"Rowe, Sam",9,7,6,2,1,0,0,5
Carlton,"Simpson, Kade",21,14,3,7,0,1,0,2
Carlton,"Thomas, Dale",18,9,4,9,3,0,0,1
Carlton,"Tuohy, Zach",10,4,1,6,0,0,0,2
Carlton,"Waite, Jarrad",11,8,5,3,0,1,0,2
Carlton,"Walker, Andrew",22,17,6,5,0,1,0,1
Carlton,"Warnock, Robert",6,5,2,1,1,0,39,3
Carlton,"White, Simon",5,3,0,2,0,0,0,2
Carlton,"Yarran, Chris",17,13,1,4,1,1,0,4
Carlton,"Armfield, Dennis",7,3,1,4,0,0,0,0
Carlton,"Carrazzo, Andrew",32,18,6,14,0,0,0,5
Carlton,"Casboult, Levi",12,7,5,5,4,0,6,1
Carlton,"Docherty, Sam",13,9,3,4,0,2,0,1
Carlton,"Everitt, Andrejs",17,3,3,14,0,0,0,3
Carlton,"Gibbs, Bryce",23,15,6,8,1,1,1,6
Carlton,"Graham, Nick",6,5,4,1,0,0,0,2
Carlton,"Judd, Chris",26,17,3,9,0,0,0,6
Carlton,"McLean, Brock",22,11,4,11,0,1,0,3
Carlton,"Menzel, Troy",15,13,4,2,2,1,0,0
Carlton,"Murphy, Marc",28,11,5,17,0,0,0,1
Carlton,"Robinson, Mitch",18,9,6,9,3,1,1,8
Carlton,"Rowe, Sam",14,5,6,9,0,0,0,0
Carlton,"Simpson, Kade",24,14,7,10,0,0,0,0
Carlton,"Thomas, Dale",14,8,2,6,1,0,0,3
Carlton,"Tuohy, Zach",11,5,1,6,0,1,0,2
Carlton,"Waite, Jarrad",13,10,6,3,1,2,0,3
Carlton,"Walker, Andrew",24,13,4,11,1,1,0,2
Carlton,"Warnock, Robert",4,4,0,0,0,0,27,1
Carlton,"Watson, Matthew",12,9,3,3,0,1,0,2
Carlton,"White, Simon",12,6,4,6,0,0,0,2
Carlton,"Yarran, Chris",12,8,2,4,0,0,0,7
Carlton,"Armfield, Dennis",5,5,1,0,1,0,0,0
Carlton,"Carrazzo, Andrew",20,8,2,12,0,0,0,7
Carlton,"Casboult, Levi",5,3,3,2,0,0,9,6
Carlton,"Curnow, Ed",24,13,3,11,0,0,0,4
Carlton,"Docherty, Sam",18,10,2,8,0,0,0,3
Carlton,"Everitt, Andrejs",19,11,7,8,1,1,1,2
Carlton,"Gibbs, Bryce",28,19,4,9,1,1,0,4
Carlton,"Henderson, Lachie",7,5,5,2,0,1,0,1
Carlton,"Jamison, Michael",13,6,7,7,0,0,0,1
Carlton,"Judd, Chris",20,11,3,9,0,0,0,5
Carlton,"McLean, Brock",19,15,5,4,2,1,0,1
Carlton,"Menzel, Troy",14,10,5,4,3,2,0,4
Carlton,"Robinson, Mitch",31,18,9,13,0,0,2,5
Carlton,"Rowe, Sam",12,5,1,7,0,0,0,2
Carlton,"Simpson, Kade",11,5,0,6,0,0,0,1
Carlton,"Thomas, Dale",16,12,7,4,2,1,0,3
Carlton,"Tuohy, Zach",15,9,1,6,1,1,0,2
Carlton,"Waite, Jarrad",16,8,3,8,2,0,0,1
Carlton,"Walker, Andrew",23,16,4,7,1,0,0,1
Carlton,"Warnock, Robert",5,4,0,1,0,0,30,3
Carlton,"White, Simon",7,4,2,3,0,0,0,1
Carlton,"Yarran, Chris",13,5,2,8,0,0,0,1
Carlton,"Armfield, Dennis",3,0,0,3,0,0,0,2
Carlton,"Carrazzo, Andrew",16,4,0,12,0,0,0,7
Carlton,"Casboult, Levi",10,6,5,4,1,0,5,2
Carlton,"Curnow, Ed",28,17,6,11,0,1,0,4
Carlton,"Docherty, Sam",19,13,6,6,0,1,0,4
Carlton,"Everitt, Andrejs",13,10,3,3,2,0,1,3
Carlton,"Gibbs, Bryce",25,13,3,12,1,0,1,4
Carlton,"Henderson, Lachie",13,8,3,5,2,1,0,2
Carlton,"Jamison, Michael",11,8,6,3,0,0,0,1
Carlton,"Johnson, Blaine",7,4,1,3,0,0,0,0
Carlton,"Judd, Chris",27,14,3,13,1,0,0,3
Carlton,"McLean, Brock",13,9,3,4,1,1,0,1
Carlton,"Menzel, Troy",5,2,3,3,1,0,0,1
Carlton,"Murphy, Marc",15,7,2,8,1,0,0,6
Carlton,"Robinson, Mitch",23,15,5,8,0,1,1,4
Carlton,"Rowe, Sam",11,4,5,7,0,0,1,3
Carlton,"Simpson, Kade",26,20,7,6,0,1,0,2
Carlton,"Thomas, Dale",15,8,5,7,1,1,0,1
Carlton,"Tuohy, Zach",10,7,4,3,0,0,0,2
Carlton,"Walker, Andrew",16,12,3,4,0,0,0,3
Carlton,"Warnock, Robert",8,3,2,5,0,0,35,3
Carlton,"Yarran, Chris",23,17,2,6,0,0,0,2
Carlton,"Bell, Tom",6,3,0,3,1,1,0,5
Carlton,"Carrazzo, Andrew",13,7,4,6,0,0,0,3
Carlton,"Casboult, Levi",11,8,8,3,4,0,8,1
Carlton,"Curnow, Ed",19,7,4,12,0,0,0,6
Carlton,"Docherty, Sam",25,16,8,9,2,0,0,2
Carlton,"Everitt, Andrejs",23,18,13,5,2,0,0,2
Carlton,"Gibbs, Bryce",14,8,3,6,0,0,1,6
Carlton,"Henderson, Lachie",14,9,8,5,4,1,0,2
Carlton,"Jamison, Michael",19,14,14,5,0,0,0,2
Carlton,"Johnson, Blaine",15,10,9,5,0,1,0,2
Carlton,"Judd, Chris",21,11,3,10,1,0,0,0
Carlton,"McLean, Brock",22,14,4,8,0,1,0,5
Carlton,"Menzel, Troy",9,7,8,2,2,0,0,0
Carlton,"Murphy, Marc",27,15,2,12,0,0,0,3
Carlton,"Rowe, Sam",14,7,8,7,0,0,0,2
Carlton,"Simpson, Kade",20,12,6,8,0,0,0,0
Carlton,"Thomas, Dale",18,13,7,5,0,0,0,3
Carlton,"Tuohy, Zach",16,9,6,7,0,0,0,0
Carlton,"Walker, Andrew",28,20,10,8,0,0,0,1
Carlton,"Warnock, Robert",8,5,1,3,1,0,34,1
Carlton,"White, Simon",13,12,7,1,4,0,0,3
Carlton,"Yarran, Chris",15,12,6,3,3,0,0,1
Carlton,"Bell, Tom",14,11,4,3,1,0,0,0
Carlton,"Casboult, Levi",13,7,7,6,0,1,8,1
Carlton,"Curnow, Ed",21,13,4,8,0,0,0,5
Carlton,"Docherty, Sam",13,10,3,3,0,1,0,4
Carlton,"Ellard, David",5,1,1,4,0,0,0,6
Carlton,"Everitt, Andrejs",16,9,4,7,1,0,2,1
Carlton,"Gibbs, Bryce",29,13,7,16,0,0,2,7
Carlton,"Graham, Nick",6,5,1,1,0,0,0,1
Carlton,"Henderson, Lachie",14,10,5,4,2,0,0,3
Carlton,"Jamison, Michael",10,4,3,6,0,0,0,2
Carlton,"Johnson, Blaine",5,3,1,2,1,0,0,0
Carlton,"Judd, Chris",13,6,2,7,0,1,0,6
Carlton,"McLean, Brock",11,7,4,4,1,0,1,5
Carlton,"Murphy, Marc",29,15,5,14,0,0,0,6
Carlton,"Rowe, Sam",14,8,6,6,0,0,0,4
Carlton,"Simpson, Kade",20,19,7,1,0,0,0,3
Carlton,"Thomas, Dale",14,8,3,6,0,1,0,2
Carlton,"Tuohy, Zach",17,14,2,3,0,1,0,0
Carlton,"Walker, Andrew",20,16,6,4,0,0,0,1
Carlton,"Warnock, Robert",2,1,0,1,0,0,36,3
Carlton,"White, Simon",13,12,5,1,1,1,0,2
Carlton,"Yarran, Chris",13,9,5,4,0,0,0,1
Carlton,"Bell, Tom",12,9,5,3,0,0,0,9
Carlton,"Casboult, Levi",4,2,4,2,0,1,5,1
Carlton,"Curnow, Ed",13,5,2,8,0,1,0,3
Carlton,"Docherty, Sam",17,12,7,5,0,1,0,4
Carlton,"Ellard, David",16,11,4,5,0,0,0,1
Carlton,"Everitt, Andrejs",7,4,2,3,0,0,0,1
Carlton,"Gibbs, Bryce",27,17,3,10,2,0,0,5
Carlton,"Graham, Nick",12,10,5,2,1,0,0,2
Carlton,"Henderson, Lachie",17,14,7,3,6,3,0,1
Carlton,"Jamison, Michael",9,7,5,2,0,1,0,0
Carlton,"Judd, Chris",21,15,6,6,1,0,0,4
Carlton,"Menzel, Troy",6,6,2,0,0,0,0,3
Carlton,"Murphy, Marc",26,15,6,11,0,0,0,1
Carlton,"Robinson, Mitch",19,7,5,12,0,0,2,6
Carlton,"Rowe, Sam",13,7,6,6,0,0,0,2
Carlton,"Simpson, Kade",28,17,10,11,0,0,0,4
Carlton,"Thomas, Dale",13,11,9,2,0,0,0,2
Carlton,"Tuohy, Zach",13,11,6,2,0,0,0,1
Carlton,"Waite, Jarrad",19,15,11,4,4,1,0,6
Carlton,"White, Simon",12,9,6,3,0,0,0,0
Carlton,"Wood, Cameron",10,8,7,2,1,1,26,3
Carlton,"Yarran, Chris",22,17,9,5,1,0,0,5
Carlton,"Bell, Tom",9,7,3,2,0,0,0,1
Carlton,"Carrazzo, Andrew",19,8,2,11,0,0,0,7
Carlton,"Casboult, Levi",6,3,4,3,1,0,10,3
Carlton,"Curnow, Ed",14,5,2,9,0,0,0,3
Carlton,"Docherty, Sam",18,14,5,4,0,0,0,4
Carlton,"Ellard, David",13,10,5,3,1,1,0,7
Carlton,"Gibbs, Bryce",20,13,4,7,0,2,0,7
Carlton,"Graham, Nick",10,7,3,3,1,1,0,2
Carlton,"Henderson, Lachie",18,13,5,5,0,0,0,3
Carlton,"Jamison, Michael",12,9,9,3,0,0,0,1
Carlton,"Johnson, Blaine",3,2,1,1,0,0,0,1
Carlton,"Judd, Chris",22,15,3,7,1,1,0,4
Carlton,"McLean, Brock",2,2,1,0,0,0,0,0
Carlton,"Murphy, Marc",21,15,1,6,2,3,0,2
Carlton,"Rowe, Sam",5,4,2,1,1,0,0,2
Carlton,"Simpson, Kade",23,20,11,3,1,0,0,2
Carlton,"Thomas, Dale",29,24,12,5,0,0,0,0
Carlton,"Tuohy, Zach",10,7,3,3,0,0,0,1
Carlton,"Waite, Jarrad",19,15,7,4,3,0,0,4
Carlton,"White, Simon",9,4,4,5,0,0,1,1
Carlton,"Wood, Cameron",13,8,4,5,0,1,12,3
Carlton,"Yarran, Chris",20,19,9,1,0,2,0,1
Carlton,"Bell, Tom",19,16,10,3,4,0,1,3
Carlton,"Carrazzo, Andrew",15,8,4,7,0,0,0,4
Carlton,"Casboult, Levi",7,5,4,2,0,0,11,2
Carlton,"Curnow, Ed",22,13,2,9,0,1,0,5
Carlton,"Docherty, Sam",19,15,5,4,0,0,0,2
Carlton,"Ellard, David",16,6,3,10,0,1,0,8
Carlton,"Gibbs, Bryce",28,19,6,9,1,0,2,5
Carlton,"Graham, Nick",17,12,6,5,0,0,0,2
Carlton,"Jamison, Michael",10,3,4,7,0,0,0,1
Carlton,"Judd, Chris",27,13,4,14,2,1,0,1
Carlton,"McLean, Brock",13,9,3,4,1,3,0,3
Carlton,"Menzel, Troy",12,6,2,6,0,0,0,4
Carlton,"Murphy, Marc",28,18,4,10,0,1,0,4
Carlton,"Rowe, Sam",8,7,7,1,0,0,0,2
Carlton,"Sheehan, Ciaran",13,8,5,5,0,0,0,2
Carlton,"Simpson, Kade",30,20,9,10,0,0,0,1
Carlton,"Thomas, Dale",27,19,11,8,1,0,0,3
Carlton,"Tuohy, Zach",16,9,1,7,0,0,0,1
Carlton,"Waite, Jarrad",22,15,9,7,5,1,0,4
Carlton,"White, Simon",14,10,8,4,0,0,2,2
Carlton,"Wood, Cameron",11,9,3,2,0,0,38,2
Carlton,"Yarran, Chris",1,1,1,0,0,0,0,0
Carlton,"Armfield, Dennis",5,3,2,2,0,1,0,3
Carlton,"Bell, Tom",18,12,5,6,1,0,0,3
Carlton,"Carrazzo, Andrew",32,10,4,22,0,0,0,5
Carlton,"Casboult, Levi",6,4,4,2,0,0,6,1
Carlton,"Curnow, Ed",22,14,8,8,0,0,0,1
Carlton,"Docherty, Sam",22,13,6,9,0,1,0,1
Carlton,"Ellard, David",5,4,0,1,0,1,0,3
Carlton,"Gibbs, Bryce",25,18,4,7,2,1,0,1
Carlton,"Graham, Nick",9,6,2,3,0,0,0,4
Carlton,"Jamison, Michael",8,5,6,3,0,0,0,0
Carlton,"Judd, Chris",20,14,7,6,1,0,0,4
Carlton,"Menzel, Troy",13,11,4,2,2,2,0,1
Carlton,"Murphy, Marc",19,14,2,5,1,1,0,9
Carlton,"Rowe, Sam",13,9,9,4,0,0,1,2
Carlton,"Sheehan, Ciaran",15,12,2,3,0,0,0,1
Carlton,"Simpson, Kade",15,12,5,3,0,0,0,1
Carlton,"Thomas, Dale",6,4,2,2,0,0,0,2
Carlton,"Tuohy, Zach",14,11,4,3,0,0,0,0
Carlton,"Waite, Jarrad",15,9,6,6,2,1,0,5
Carlton,"White, Simon",6,2,1,4,1,0,0,3
Carlton,"Wood, Cameron",8,4,1,4,0,0,19,2
Carlton,"Yarran, Chris",22,16,8,6,1,0,0,1
Carlton,"Bell, Tom",17,11,3,6,0,0,0,2
Carlton,"Carrazzo, Andrew",18,8,0,10,0,0,0,8
Carlton,"Casboult, Levi",15,11,5,4,1,2,7,3
Carlton,"Curnow, Ed",22,15,3,7,0,0,0,4
Carlton,"Docherty, Sam",11,10,3,1,0,0,0,3
Carlton,"Gibbs, Bryce",29,16,5,13,1,0,0,4
Carlton,"Graham, Nick",15,7,3,8,0,0,0,3
Carlton,"Holman, Nick",8,5,2,3,0,0,0,4
Carlton,"Jamison, Michael",8,6,4,2,0,0,0,2
Carlton,"Johnson, Blaine",12,8,2,4,0,0,0,4
Carlton,"Judd, Chris",18,12,6,6,0,1,0,5
Carlton,"Lucas, Kane",11,7,4,4,0,1,0,1
Carlton,"Menzel, Troy",6,4,4,2,0,2,0,1
Carlton,"Murphy, Marc",5,3,2,2,0,0,0,2
Carlton,"Rowe, Sam",19,13,11,6,0,0,0,1
Carlton,"Sheehan, Ciaran",8,3,1,5,0,0,0,2
Carlton,"Simpson, Kade",10,10,1,0,0,0,0,0
Carlton,"Tuohy, Zach",11,10,4,1,0,0,0,3
Carlton,"Waite, Jarrad",9,5,2,4,1,1,0,2
Carlton,"White, Simon",11,9,5,2,1,0,0,2
Carlton,"Wood, Cameron",16,10,8,6,0,0,22,0
Carlton,"Yarran, Chris",15,11,3,4,1,0,0,1
Carlton,"Armfield, Dennis",4,4,1,0,1,0,0,2
Carlton,"Bell, Tom",17,7,2,10,1,0,0,5
Carlton,"Carrazzo, Andrew",19,11,7,8,0,0,0,8
Carlton,"Casboult, Levi",7,5,6,2,0,0,11,2
Carlton,"Cripps, Patrick",3,1,1,2,0,0,0,3
Carlton,"Curnow, Ed",21,9,3,12,0,0,0,1
Carlton,"Docherty, Sam",21,13,6,8,0,0,0,5
Carlton,"Gibbs, Bryce",22,13,5,9,0,2,0,3
Carlton,"Jamison, Michael",13,7,4,6,0,0,0,3
Carlton,"Judd, Chris",28,11,4,17,0,0,0,3
Carlton,"Lucas, Kane",11,8,4,3,1,0,0,1
Carlton,"McLean, Brock",30,17,7,13,1,0,0,5
Carlton,"Menzel, Troy",9,7,5,2,2,0,0,3
Carlton,"Rowe, Sam",12,12,5,0,0,0,0,2
Carlton,"Sheehan, Ciaran",14,10,1,4,0,1,0,1
Carlton,"Simpson, Kade",23,13,7,10,0,0,0,5
Carlton,"Tuohy, Zach",14,11,3,3,0,1,0,0
Carlton,"Waite, Jarrad",16,12,11,4,1,0,0,1
Carlton,"Watson, Matthew",16,10,4,6,4,0,1,0
Carlton,"White, Simon",13,10,8,3,0,1,0,0
Carlton,"Wood, Cameron",9,5,3,4,1,0,26,2
Carlton,"Yarran, Chris",13,9,5,4,2,0,0,1
Collingwood,"Adams, Taylor",15,6,2,9,0,0,0,4
Collingwood,"Ball, Luke",25,15,7,10,0,1,1,9
Collingwood,"Beams, Dayne",31,16,3,15,0,1,0,9
Collingwood,"Brown, Nathan",9,4,1,5,0,0,0,0
Collingwood,"Clarke, Martin",13,7,4,6,0,0,0,0
Collingwood,"Cloke, Travis",7,4,4,3,0,0,0,2
Collingwood,"Elliott, Jamie",13,10,2,3,1,0,0,2
Collingwood,"Frost, Jack",11,6,3,5,0,0,0,4
Collingwood,"Goldsack, Tyson",8,2,0,6,0,0,0,4
Collingwood,"Grundy, Brodie",14,4,2,10,0,1,13,9
Collingwood,"Kennedy, Ben",8,1,0,7,0,0,0,2
Collingwood,"Langdon, Tom",24,20,6,4,0,0,0,5
Collingwood,"Lumumba, Heritier",23,11,4,12,0,0,0,4
Collingwood,"Macaffer, Brent",16,11,8,5,1,0,0,5
Collingwood,"Maxwell, Nick",15,7,5,8,0,0,0,2
Collingwood,"Pendlebury, Scott",26,16,3,10,1,0,0,9
Collingwood,"Sidebottom, Steele",22,15,3,7,0,3,0,3
Collingwood,"Sinclair, Ben",20,9,5,11,0,1,0,1
Collingwood,"Swan, Dane",27,17,4,10,1,0,0,2
Collingwood,"Toovey, Alan",5,1,0,4,0,0,0,3
Collingwood,"Witts, Jarrod",8,5,4,3,0,1,11,3
Collingwood,"Young, Clinton",17,13,6,4,1,1,0,1
Collingwood,"Adams, Taylor",7,4,1,3,0,0,0,1
Collingwood,"Ball, Luke",18,8,2,10,0,0,0,6
Collingwood,"Beams, Dayne",30,14,3,16,1,0,0,6
Collingwood,"Blair, Jarryd",17,12,5,5,0,1,0,0
Collingwood,"Brown, Nathan",9,6,1,3,0,0,0,1
Collingwood,"Cloke, Travis",14,12,9,2,2,1,0,1
Collingwood,"Dwyer, Sam",11,2,0,9,0,0,0,1
Collingwood,"Elliott, Jamie",11,9,2,2,3,2,0,5
Collingwood,"Frost, Jack",12,7,4,5,0,0,0,3
Collingwood,"Goldsack, Tyson",10,6,4,4,2,0,0,2
Collingwood,"Grundy, Brodie",13,5,3,8,0,1,30,5
Collingwood,"Langdon, Tom",15,13,7,2,0,0,0,2
Collingwood,"Lumumba, Heritier",28,15,9,13,0,0,0,0
Collingwood,"Macaffer, Brent",13,7,4,6,0,1,0,3
Collingwood,"Maxwell, Nick",22,13,8,9,0,0,0,3
Collingwood,"Pendlebury, Scott",33,23,4,10,1,1,0,10
Collingwood,"Sidebottom, Steele",15,9,4,6,0,1,0,1
Collingwood,"Sinclair, Ben",17,6,7,11,1,0,0,2
Collingwood,"Swan, Dane",16,13,3,3,1,0,0,2
Collingwood,"Toovey, Alan",13,8,2,5,0,0,0,6
Collingwood,"White, Jesse",11,5,0,6,0,2,7,4
Collingwood,"Young, Clinton",17,12,6,5,1,0,0,1
Collingwood,"Adams, Taylor",5,3,2,2,0,0,0,2
Collingwood,"Ball, Luke",23,10,4,13,0,0,1,3
Collingwood,"Beams, Dayne",28,15,2,13,0,1,0,3
Collingwood,"Blair, Jarryd",11,5,5,6,1,0,0,6
Collingwood,"Cloke, Travis",8,5,4,3,0,0,0,0
Collingwood,"Dwyer, Sam",7,4,2,3,0,0,0,1
Collingwood,"Elliott, Jamie",15,12,9,3,5,0,0,2
Collingwood,"Fasolo, Alex",17,13,5,4,0,1,0,3
Collingwood,"Frost, Jack",12,7,5,5,0,0,0,1
Collingwood,"Goldsack, Tyson",11,9,6,2,1,1,0,4
Collingwood,"Grundy, Brodie",6,3,0,3,0,0,24,3
Collingwood,"Keeffe, Lachlan",7,4,1,3,0,0,0,0
Collingwood,"Langdon, Tom",20,11,7,9,0,0,0,0
Collingwood,"Lumumba, Heritier",23,13,3,10,0,0,0,3
Collingwood,"Macaffer, Brent",11,8,4,3,0,1,0,1
Collingwood,"Maxwell, Nick",16,11,8,5,0,0,0,5
Collingwood,"Pendlebury, Scott",26,15,4,11,0,0,0,4
Collingwood,"Sidebottom, Steele",29,21,5,8,1,1,0,6
Collingwood,"Swan, Dane",23,18,4,5,0,1,0,3
Collingwood,"Toovey, Alan",14,8,4,6,1,0,0,1
Collingwood,"White, Jesse",13,11,7,2,2,0,6,2
Collingwood,"Young, Clinton",17,14,10,3,0,0,0,2
Collingwood,"Ball, Luke",22,13,4,9,1,0,1,8
Collingwood,"Beams, Dayne",30,20,5,10,3,1,0,4
Collingwood,"Blair, Jarryd",11,5,2,6,1,0,0,5
Collingwood,"Cloke, Travis",9,6,3,3,0,2,0,1
Collingwood,"Elliott, Jamie",16,12,6,4,2,0,0,2
Collingwood,"Fasolo, Alex",20,11,4,9,0,1,0,3
Collingwood,"Frost, Jack",5,1,0,4,0,0,0,0
Collingwood,"Goldsack, Tyson",16,6,3,10,0,1,0,4
Collingwood,"Grundy, Brodie",4,1,0,3,0,1,24,0
Collingwood,"Keeffe, Lachlan",8,4,2,4,0,0,0,0
Collingwood,"Langdon, Tom",13,9,5,4,0,0,0,2
Collingwood,"Lumumba, Heritier",18,13,9,5,0,1,0,6
Collingwood,"Macaffer, Brent",9,4,3,5,0,0,0,11
Collingwood,"Maxwell, Nick",8,4,1,4,0,0,0,5
Collingwood,"Pendlebury, Scott",24,12,2,12,3,1,1,6
Collingwood,"Sidebottom, Steele",22,16,3,6,1,0,0,5
Collingwood,"Swan, Dane",27,17,3,10,2,1,0,3
Collingwood,"Thomas, Josh",8,2,0,6,0,0,0,1
Collingwood,"Toovey, Alan",13,7,3,6,0,0,0,6
Collingwood,"White, Jesse",15,14,7,1,3,2,0,4
Collingwood,"Witts, Jarrod",17,7,4,10,0,0,10,0
Collingwood,"Young, Clinton",21,14,4,7,0,1,0,4
Collingwood,"Ball, Luke",3,2,1,1,0,0,0,1
Collingwood,"Beams, Dayne",25,15,7,10,2,0,0,8
Collingwood,"Blair, Jarryd",16,6,2,10,0,1,0,3
Collingwood,"Cloke, Travis",14,13,11,1,4,4,0,2
Collingwood,"Elliott, Jamie",24,15,9,9,2,1,0,4
Collingwood,"Fasolo, Alex",32,12,7,20,0,1,0,3
Collingwood,"Frost, Jack",14,11,8,3,0,0,0,6
Collingwood,"Goldsack, Tyson",17,9,5,8,1,1,0,4
Collingwood,"Grundy, Brodie",11,4,0,7,0,0,14,7
Collingwood,"Keeffe, Lachlan",13,9,2,4,0,0,0,3
Collingwood,"Langdon, Tom",13,8,7,5,0,0,0,1
Collingwood,"Lumumba, Heritier",30,19,7,11,1,0,0,0
Collingwood,"Macaffer, Brent",14,6,4,8,0,0,0,3
Collingwood,"Maxwell, Nick",17,11,7,6,0,0,0,1
Collingwood,"Pendlebury, Scott",31,19,8,12,1,2,0,3
Collingwood,"Sidebottom, Steele",34,24,12,10,0,1,0,3
Collingwood,"Swan, Dane",35,23,11,12,0,1,0,5
Collingwood,"Thomas, Josh",17,6,3,11,0,0,0,2
Collingwood,"Toovey, Alan",17,12,7,5,0,0,0,3
Collingwood,"White, Jesse",10,7,4,3,2,2,1,0
Collingwood,"Witts, Jarrod",8,5,2,3,0,0,5,1
Collingwood,"Young, Clinton",16,12,4,4,0,0,0,1
Collingwood,"Ball, Luke",23,11,6,12,0,0,0,5
Collingwood,"Beams, Dayne",32,19,5,13,0,1,0,9
Collingwood,"Blair, Jarryd",15,3,1,12,0,0,0,7
Collingwood,"Cloke, Travis",10,9,6,1,0,3,0,5
Collingwood,"Elliott, Jamie",19,17,5,2,1,0,0,4
Collingwood,"Fasolo, Alex",5,1,0,4,0,0,0,2
Collingwood,"Frost, Jack",5,2,3,3,0,0,0,2
Collingwood,"Goldsack, Tyson",11,5,3,6,1,0,0,10
Collingwood,"Grundy, Brodie",12,4,5,8,1,0,25,6
Collingwood,"Keeffe, Lachlan",9,8,3,1,0,0,0,2
Collingwood,"Langdon, Tom",22,11,7,11,0,0,0,0
Collingwood,"Lumumba, Heritier",20,12,6,8,0,1,0,2
Collingwood,"Macaffer, Brent",15,12,3,3,0,1,0,4
Collingwood,"Maxwell, Nick",9,5,3,4,0,0,0,3
Collingwood,"Pendlebury, Scott",30,11,2,19,0,2,0,7
Collingwood,"Sidebottom, Steele",26,18,3,8,3,0,0,6
Collingwood,"Swan, Dane",26,15,4,11,4,2,0,5
Collingwood,"Thomas, Josh",16,11,2,5,0,0,0,3
Collingwood,"Toovey, Alan",10,5,1,5,0,0,0,3
Collingwood,"White, Jesse",13,9,5,4,2,0,0,2
Collingwood,"Witts, Jarrod",9,6,2,3,0,1,16,7
Collingwood,"Young, Clinton",17,13,6,4,0,0,0,4
Collingwood,"Adams, Taylor",16,7,1,9,0,0,0,1
Collingwood,"Ball, Luke",12,8,3,4,1,0,0,4
Collingwood,"Beams, Dayne",21,14,1,7,4,1,0,6
Collingwood,"Blair, Jarryd",22,13,7,9,0,2,0,6
Collingwood,"Cloke, Travis",15,13,7,2,2,4,1,1
Collingwood,"Dwyer, Sam",20,10,8,10,1,1,0,0
Collingwood,"Elliott, Jamie",20,14,11,6,3,0,0,4
Collingwood,"Frost, Jack",7,4,2,3,0,0,0,1
Collingwood,"Goldsack, Tyson",11,6,4,5,0,0,0,7
Collingwood,"Grundy, Brodie",11,5,1,6,1,0,16,4
Collingwood,"Keeffe, Lachlan",9,6,3,3,0,0,0,0
Collingwood,"Kennedy, Ben",5,4,1,1,0,1,0,0
Collingwood,"Langdon, Tom",23,15,8,8,0,1,0,3
Collingwood,"Lumumba, Heritier",11,7,3,4,0,0,0,2
Collingwood,"Macaffer, Brent",13,8,3,5,0,0,0,5
Collingwood,"Pendlebury, Scott",26,15,3,11,0,1,0,4
Collingwood,"Sidebottom, Steele",19,12,5,7,0,1,0,2
Collingwood,"Swan, Dane",32,17,5,15,0,1,0,2
Collingwood,"Thomas, Josh",15,9,0,6,0,0,0,5
Collingwood,"White, Jesse",7,2,0,5,0,0,3,3
Collingwood,"Williams, Marley",17,11,2,6,0,1,0,1
Collingwood,"Witts, Jarrod",9,7,2,2,2,0,15,4
Collingwood,"Ball, Luke",19,12,3,7,0,0,0,7
Collingwood,"Beams, Dayne",30,17,2,13,1,1,0,4
Collingwood,"Blair, Jarryd",20,8,2,12,1,2,0,3
Collingwood,"Cloke, Travis",11,7,3,4,1,1,2,2
Collingwood,"Dwyer, Sam",7,4,0,3,0,0,0,1
Collingwood,"Elliott, Jamie",10,7,5,3,0,1,0,3
Collingwood,"Frost, Jack",7,1,1,6,0,0,0,2
Collingwood,"Goldsack, Tyson",10,4,2,6,0,0,0,7
Collingwood,"Grundy, Brodie",12,7,3,5,0,0,32,1
Collingwood,"Keeffe, Lachlan",8,7,4,1,0,0,0,1
Collingwood,"Langdon, Tom",23,13,8,10,0,0,0,6
Collingwood,"Lumumba, Heritier",21,9,4,12,1,0,0,5
Collingwood,"Macaffer, Brent",10,8,1,2,0,0,0,5
Collingwood,"Maxwell, Nick",16,11,4,5,0,0,0,3
Collingwood,"Pendlebury, Scott",33,9,1,24,1,0,0,5
Collingwood,"Sidebottom, Steele",27,15,9,12,0,3,0,2
Collingwood,"Swan, Dane",21,9,3,12,1,1,0,3
Collingwood,"Toovey, Alan",15,8,3,7,0,0,0,1
Collingwood,"White, Jesse",11,7,2,4,1,0,5,1
Collingwood,"Williams, Marley",15,10,6,5,0,0,0,2
Collingwood,"Witts, Jarrod",4,1,1,3,0,0,13,2
Collingwood,"Young, Clinton",14,10,4,4,0,1,0,5
Collingwood,"Ball, Luke",19,9,3,10,1,0,0,6
Collingwood,"Beams, Dayne",31,10,1,21,2,1,0,6
Collingwood,"Blair, Jarryd",14,9,5,5,3,1,0,2
Collingwood,"Brown, Nathan",0,0,0,0,0,0,0,0
Collingwood,"Cloke, Travis",6,6,3,0,1,1,0,2
Collingwood,"Elliott, Jamie",17,14,7,3,2,0,1,2
Collingwood,"Fasolo, Alex",16,11,4,5,1,1,0,2
Collingwood,"Frost, Jack",2,2,1,0,0,0,0,1
Collingwood,"Goldsack, Tyson",10,4,5,6,1,0,0,11
Collingwood,"Grundy, Brodie",12,7,2,5,1,1,9,4
Collingwood,"Langdon, Tom",12,7,4,5,0,0,0,6
Collingwood,"Lumumba, Heritier",25,13,3,12,0,0,0,0
Collingwood,"Macaffer, Brent",19,18,5,1,1,0,0,7
Collingwood,"Maxwell, Nick",20,9,3,11,0,0,0,6
Collingwood,"Pendlebury, Scott",32,17,5,15,1,0,0,5
Collingwood,"Sidebottom, Steele",29,20,4,9,1,1,0,5
Collingwood,"Swan, Dane",26,15,5,11,0,0,0,6
Collingwood,"Toovey, Alan",6,1,2,5,0,0,0,9
Collingwood,"White, Jesse",6,4,1,2,1,0,2,0
Collingwood,"Williams, Marley",19,13,3,6,0,0,0,2
Collingwood,"Witts, Jarrod",9,5,3,4,1,0,9,2
Collingwood,"Young, Clinton",15,8,4,7,0,0,0,8
Collingwood,"Adams, Taylor",18,7,3,11,0,2,0,7
Collingwood,"Beams, Dayne",33,19,4,14,1,0,0,7
Collingwood,"Blair, Jarryd",17,7,2,10,1,0,0,3
Collingwood,"Cloke, Travis",23,17,12,6,5,2,0,4
Collingwood,"Elliott, Jamie",17,12,5,5,4,2,0,1
Collingwood,"Fasolo, Alex",12,8,3,4,4,1,0,2
Collingwood,"Frost, Jack",7,3,1,4,0,0,0,3
Collingwood,"Goldsack, Tyson",6,1,2,5,0,0,0,6
Collingwood,"Keeffe, Lachlan",16,11,8,5,0,0,0,1
Collingwood,"Langdon, Tom",22,8,3,14,0,1,0,3
Collingwood,"Lumumba, Heritier",23,7,4,16,0,0,0,1
Collingwood,"Macaffer, Brent",15,9,2,6,0,0,0,8
Collingwood,"Maxwell, Nick",1,1,1,0,0,0,0,0
Collingwood,"Pendlebury, Scott",32,10,3,22,0,0,1,7
Collingwood,"Seedsman, Paul",18,12,5,6,0,1,0,2
Collingwood,"Sidebottom, Steele",22,14,5,8,0,0,0,6
Collingwood,"Thomas, Josh",29,18,7,11,3,2,0,5
Collingwood,"Toovey, Alan",6,5,1,1,0,0,0,1
Collingwood,"White, Jesse",16,8,6,8,2,0,15,2
Collingwood,"Williams, Marley",21,14,5,7,0,0,0,0
Collingwood,"Witts, Jarrod",14,9,6,5,1,0,20,5
Collingwood,"Young, Clinton",26,23,10,3,0,1,0,3
Collingwood,"Ball, Luke",11,5,2,6,0,0,0,1
Collingwood,"Beams, Dayne",19,10,1,9,2,1,0,3
Collingwood,"Blair, Jarryd",17,7,5,10,0,0,0,7
Collingwood,"Cloke, Travis",14,11,7,3,2,1,0,2
Collingwood,"Dwyer, Sam",21,13,8,8,0,1,0,1
Collingwood,"Elliott, Jamie",9,9,4,0,1,1,0,5
Collingwood,"Fasolo, Alex",5,5,2,0,0,0,0,0
Collingwood,"Frost, Jack",8,6,6,2,0,0,0,3
Collingwood,"Goldsack, Tyson",7,5,4,2,1,1,0,3
Collingwood,"Grundy, Brodie",16,10,8,6,0,2,16,1
Collingwood,"Keeffe, Lachlan",18,13,7,5,0,0,0,4
Collingwood,"Langdon, Tom",21,10,9,11,0,0,0,2
Collingwood,"Lumumba, Heritier",19,9,2,10,0,1,0,2
Collingwood,"Macaffer, Brent",19,12,6,7,1,0,0,2
Collingwood,"Pendlebury, Scott",26,15,7,11,1,0,1,1
Collingwood,"Seedsman, Paul",18,14,7,4,0,1,0,2
Collingwood,"Swan, Dane",25,17,7,8,0,1,0,6
Collingwood,"Thomas, Josh",20,13,6,7,0,0,0,5
Collingwood,"Toovey, Alan",11,7,4,4,0,0,0,0
Collingwood,"Williams, Marley",20,15,4,5,0,0,0,3
Collingwood,"Witts, Jarrod",6,4,3,2,0,0,11,4
Collingwood,"Young, Clinton",26,14,13,12,0,0,0,1
Collingwood,"Adams, Taylor",30,14,4,16,1,0,0,7
Collingwood,"Ball, Luke",15,8,3,7,1,0,0,6
Collingwood,"Blair, Jarryd",7,4,2,3,0,1,0,8
Collingwood,"Broomhead, Tim",3,3,0,0,0,0,0,2
Collingwood,"Cloke, Travis",12,10,9,2,6,1,0,2
Collingwood,"Dwyer, Sam",28,15,8,13,0,0,0,6
Collingwood,"Elliott, Jamie",14,11,8,3,4,0,0,4
Collingwood,"Frost, Jack",8,3,3,5,0,0,0,7
Collingwood,"Grundy, Brodie",4,2,1,2,0,0,14,2
Collingwood,"Keeffe, Lachlan",18,11,5,7,0,0,0,2
Collingwood,"Langdon, Tom",21,14,7,7,0,0,0,4
Collingwood,"Lumumba, Heritier",24,12,4,12,0,0,1,1
Collingwood,"Macaffer, Brent",12,6,5,6,0,0,0,2
Collingwood,"Pendlebury, Scott",30,15,2,15,1,1,2,6
Collingwood,"Seedsman, Paul",22,13,5,9,0,0,0,3
Collingwood,"Swan, Dane",23,11,6,12,1,1,0,5
Collingwood,"Thomas, Josh",22,10,4,12,1,0,0,5
Collingwood,"Toovey, Alan",10,6,2,4,0,0,0,5
Collingwood,"White, Jesse",5,4,2,1,0,0,6,6
Collingwood,"Williams, Marley",14,11,0,3,0,0,0,4
Collingwood,"Witts, Jarrod",12,5,4,7,0,0,19,6
Collingwood,"Young, Clinton",16,5,0,11,0,0,0,6
Collingwood,"Adams, Taylor",25,9,5,16,1,0,0,3
Collingwood,"Ball, Luke",22,10,6,12,0,0,0,6
Collingwood,"Beams, Dayne",27,15,2,12,0,0,0,4
Collingwood,"Blair, Jarryd",18,7,2,11,1,1,0,9
Collingwood,"Broomhead, Tim",4,4,2,0,0,0,0,4
Collingwood,"Cloke, Travis",17,13,10,4,5,1,0,0
Collingwood,"Dwyer, Sam",22,7,5,15,0,0,0,1
Collingwood,"Elliott, Jamie",17,12,5,5,2,1,0,2
Collingwood,"Frost, Jack",11,4,3,7,0,0,0,5
Collingwood,"Keeffe, Lachlan",10,5,0,5,0,0,0,0
Collingwood,"Langdon, Tom",5,2,1,3,0,0,0,0
Collingwood,"Lumumba, Heritier",12,5,3,7,0,0,0,1
Collingwood,"Macaffer, Brent",13,8,4,5,1,1,0,0
Collingwood,"Pendlebury, Scott",35,12,5,23,0,0,0,3
Collingwood,"Seedsman, Paul",14,6,3,8,0,0,0,2
Collingwood,"Swan, Dane",31,16,6,15,0,1,0,1
Collingwood,"Thomas, Josh",12,4,2,8,0,0,0,4
Collingwood,"Toovey, Alan",13,8,3,5,0,0,0,5
Collingwood,"White, Jesse",10,7,2,3,0,2,12,0
Collingwood,"Williams, Marley",15,9,4,6,0,0,0,1
Collingwood,"Witts, Jarrod",12,9,4,3,2,0,25,5
Collingwood,"Young, Clinton",20,15,4,5,1,0,0,2
Collingwood,"Adams, Taylor",26,15,4,11,0,1,0,1
Collingwood,"Ball, Luke",17,8,5,9,2,1,0,6
Collingwood,"Beams, Dayne",21,15,7,6,1,3,0,5
Collingwood,"Blair, Jarryd",16,5,1,11,0,0,0,7
Collingwood,"Cloke, Travis",12,8,9,4,1,2,0,2
Collingwood,"Dwyer, Sam",21,11,3,10,0,1,0,1
Collingwood,"Elliott, Jamie",5,3,3,2,0,1,0,1
Collingwood,"Frost, Jack",10,2,1,8,0,0,0,4
Collingwood,"Goldsack, Tyson",16,8,3,8,1,0,0,1
Collingwood,"Keeffe, Lachlan",15,8,4,7,1,0,0,1
Collingwood,"Kennedy, Ben",16,8,1,8,0,0,0,0
Collingwood,"Lumumba, Heritier",22,11,3,11,0,1,0,3
Collingwood,"Macaffer, Brent",11,7,3,4,0,1,0,7
Collingwood,"Pendlebury, Scott",24,11,4,13,2,0,0,11
Collingwood,"Seedsman, Paul",20,10,5,10,0,1,0,2
Collingwood,"Sidebottom, Steele",33,17,6,16,2,0,0,9
Collingwood,"Swan, Dane",30,12,4,18,0,0,0,2
Collingwood,"Thomas, Josh",15,11,0,4,0,0,0,6
Collingwood,"Toovey, Alan",20,9,3,11,0,0,0,7
Collingwood,"White, Jesse",12,9,3,3,0,0,8,3
Collingwood,"Witts, Jarrod",17,9,6,8,1,0,26,6
Collingwood,"Young, Clinton",15,12,4,3,2,0,0,6
Collingwood,"Adams, Taylor",18,12,4,6,0,0,0,2
Collingwood,"Beams, Dayne",25,11,4,14,0,2,0,3
Collingwood,"Blair, Jarryd",13,6,6,7,0,0,0,2
Collingwood,"Cloke, Travis",17,11,8,6,2,3,0,1
Collingwood,"Dwyer, Sam",9,5,3,4,0,0,0,0
Collingwood,"Frost, Jack",9,7,3,2,0,0,0,1
Collingwood,"Goldsack, Tyson",7,4,3,3,1,0,0,1
Collingwood,"Grundy, Brodie",7,3,1,4,0,0,10,3
Collingwood,"Keeffe, Lachlan",17,11,7,6,0,0,0,0
Collingwood,"Kennedy, Ben",18,13,3,5,2,0,0,3
Collingwood,"Langdon, Tom",12,9,5,3,0,0,0,2
Collingwood,"Lumumba, Heritier",14,9,2,5,0,0,0,3
Collingwood,"Macaffer, Brent",14,7,1,7,0,0,0,3
Collingwood,"Pendlebury, Scott",25,12,3,13,0,0,1,9
Collingwood,"Seedsman, Paul",16,8,5,8,1,0,0,3
Collingwood,"Sidebottom, Steele",26,16,7,10,1,0,0,1
Collingwood,"Swan, Dane",19,14,7,5,0,2,0,1
Collingwood,"Thomas, Josh",10,4,1,6,1,0,0,1
Collingwood,"Toovey, Alan",8,3,0,5,0,0,0,3
Collingwood,"Williams, Marley",19,10,3,9,0,0,0,1
Collingwood,"Witts, Jarrod",12,7,1,5,0,1,33,3
Collingwood,"Young, Clinton",17,12,8,5,2,3,0,3
Collingwood,"Adams, Taylor",24,13,4,11,0,0,0,2
Collingwood,"Ball, Luke",19,8,6,11,0,1,0,3
Collingwood,"Beams, Dayne",23,10,4,13,2,0,0,5
Collingwood,"Blair, Jarryd",16,6,2,10,0,0,0,1
Collingwood,"Cloke, Travis",9,5,5,4,0,0,0,1
Collingwood,"Frost, Jack",13,7,6,6,0,0,0,1
Collingwood,"Goldsack, Tyson",9,1,0,8,0,0,0,4
Collingwood,"Kennedy, Ben",9,6,3,3,0,0,0,0
Collingwood,"Langdon, Tom",7,6,3,1,0,0,0,3
Collingwood,"Lumumba, Heritier",18,9,1,9,1,0,0,3
Collingwood,"Macaffer, Brent",17,9,6,8,0,0,0,4
Collingwood,"Maxwell, Nick",11,6,4,5,0,0,0,0
Collingwood,"Pendlebury, Scott",23,15,2,8,0,2,1,3
Collingwood,"Seedsman, Paul",14,8,2,6,1,0,0,5
Collingwood,"Sidebottom, Steele",28,17,9,11,0,0,0,3
Collingwood,"Swan, Dane",20,9,2,11,0,0,0,0
Collingwood,"Thomas, Josh",16,8,2,8,0,0,0,3
Collingwood,"Toovey, Alan",17,8,4,9,0,0,0,5
Collingwood,"White, Jesse",12,10,5,2,0,2,13,1
Collingwood,"Williams, Marley",20,13,2,7,0,0,0,2
Collingwood,"Witts, Jarrod",5,5,0,0,0,0,27,0
Collingwood,"Young, Clinton",8,6,4,2,1,0,0,1
Collingwood,"Adams, Taylor",18,4,1,14,0,0,0,6
Collingwood,"Beams, Dayne",29,17,4,12,2,0,0,4
Collingwood,"Blair, Jarryd",18,11,2,7,1,1,0,6
Collingwood,"Broomhead, Tim",15,9,1,6,0,1,0,2
Collingwood,"Cloke, Travis",16,10,7,6,3,1,0,0
Collingwood,"Elliott, Jamie",14,7,4,7,1,1,0,8
Collingwood,"Frost, Jack",9,7,2,2,0,0,0,1
Collingwood,"Goldsack, Tyson",14,6,4,8,0,0,0,1
Collingwood,"Keeffe, Lachlan",11,9,4,2,0,0,0,0
Collingwood,"Kennedy, Ben",4,4,0,0,0,1,0,1
Collingwood,"Langdon, Tom",14,9,4,5,0,0,0,2
Collingwood,"Lumumba, Heritier",25,12,4,13,0,0,0,6
Collingwood,"Macaffer, Brent",13,6,1,7,0,0,0,3
Collingwood,"Martin, Kyle",14,7,1,7,1,0,0,4
Collingwood,"Pendlebury, Scott",26,14,3,12,1,0,1,3
Collingwood,"Reid, Ben",9,5,2,4,0,1,0,0
Collingwood,"Seedsman, Paul",11,4,3,7,0,0,0,5
Collingwood,"Sidebottom, Steele",32,22,10,10,0,1,0,3
Collingwood,"White, Jesse",11,8,1,3,2,1,9,1
Collingwood,"Williams, Marley",12,9,3,3,0,0,0,4
Collingwood,"Witts, Jarrod",12,7,4,5,1,0,23,5
Collingwood,"Young, Clinton",13,8,5,5,0,0,0,1
Collingwood,"Adams, Taylor",28,20,3,8,0,0,0,7
Collingwood,"Armstrong, Tony",17,8,4,9,0,0,0,2
Collingwood,"Beams, Dayne",32,18,5,14,1,1,0,7
Collingwood,"Blair, Jarryd",12,3,3,9,1,0,0,8
Collingwood,"Broomhead, Tim",15,7,3,8,2,1,0,1
Collingwood,"Cloke, Travis",15,12,10,3,3,2,0,4
Collingwood,"Dwyer, Sam",24,15,7,9,1,1,0,1
Collingwood,"Elliott, Jamie",14,11,9,3,1,1,0,2
Collingwood,"Fasolo, Alex",17,11,8,6,0,0,0,6
Collingwood,"Frost, Jack",10,9,6,1,0,0,0,2
Collingwood,"Goldsack, Tyson",18,11,6,7,0,0,0,2
Collingwood,"Keeffe, Lachlan",15,9,7,6,0,0,0,2
Collingwood,"Langdon, Tom",21,13,8,8,0,0,0,2
Collingwood,"Lumumba, Heritier",23,18,4,5,0,0,0,7
Collingwood,"Macaffer, Brent",12,10,1,2,0,0,1,5
Collingwood,"Martin, Kyle",0,0,0,0,0,0,0,0
Collingwood,"Pendlebury, Scott",27,8,4,19,0,0,0,5
Collingwood,"Reid, Ben",6,5,1,1,0,0,0,0
Collingwood,"Sidebottom, Steele",31,25,8,6,2,2,0,4
Collingwood,"White, Jesse",10,6,3,4,0,0,8,1
Collingwood,"Williams, Marley",17,12,9,5,0,0,0,0
Collingwood,"Witts, Jarrod",7,2,2,5,0,0,28,5
Collingwood,"Armstrong, Tony",19,10,4,9,0,0,0,6
Collingwood,"Beams, Dayne",35,17,6,18,1,1,0,5
Collingwood,"Blair, Jarryd",17,3,1,14,0,0,0,8
Collingwood,"Broomhead, Tim",15,6,1,9,1,1,0,5
Collingwood,"Cloke, Travis",10,10,7,0,1,1,0,0
Collingwood,"Dwyer, Sam",8,3,1,5,1,0,0,0
Collingwood,"Elliott, Jamie",21,15,7,6,1,0,0,9
Collingwood,"Fasolo, Alex",16,8,3,8,0,0,0,2
Collingwood,"Frost, Jack",9,5,5,4,0,0,0,3
Collingwood,"Goldsack, Tyson",12,5,2,7,0,0,0,7
Collingwood,"Keeffe, Lachlan",11,7,2,4,0,0,0,2
Collingwood,"Kennedy, Ben",21,9,1,12,2,0,0,4
Collingwood,"Lumumba, Heritier",15,9,2,6,0,0,0,4
Collingwood,"Macaffer, Brent",13,6,7,7,0,0,0,2
Collingwood,"Pendlebury, Scott",31,15,5,16,0,0,0,4
Collingwood,"Reid, Ben",13,9,6,4,1,0,0,4
Collingwood,"Sidebottom, Steele",33,15,5,18,1,0,0,2
Collingwood,"Toovey, Alan",5,3,2,2,0,0,0,4
Collingwood,"White, Jesse",8,3,2,5,1,0,11,3
Collingwood,"Williams, Marley",19,12,7,7,0,0,0,2
Collingwood,"Witts, Jarrod",15,6,3,9,0,1,20,2
Collingwood,"Young, Clinton",10,4,2,6,0,0,0,2
Collingwood,"Armstrong, Tony",17,11,6,6,0,0,0,3
Collingwood,"Ball, Luke",20,8,5,12,0,0,0,4
Collingwood,"Beams, Dayne",14,6,2,8,0,1,0,2
Collingwood,"Blair, Jarryd",19,7,3,12,0,1,0,5
Collingwood,"Broomhead, Tim",17,11,7,6,3,0,0,1
Collingwood,"Cloke, Travis",6,5,3,1,1,0,0,2
Collingwood,"Fasolo, Alex",18,11,7,7,1,1,0,1
Collingwood,"Frost, Jack",8,7,4,1,0,0,0,3
Collingwood,"Goldsack, Tyson",7,6,4,1,1,0,0,3
Collingwood,"Grundy, Brodie",12,8,7,4,0,2,16,2
Collingwood,"Keeffe, Lachlan",10,8,5,2,0,0,0,0
Collingwood,"Kennedy, Ben",17,9,2,8,0,0,0,5
Collingwood,"Lumumba, Heritier",12,3,2,9,0,0,0,1
Collingwood,"Macaffer, Brent",23,13,7,10,0,0,0,4
Collingwood,"Reid, Ben",0,0,0,0,0,0,0,0
Collingwood,"Sidebottom, Steele",24,13,4,11,0,0,0,6
Collingwood,"Sinclair, Ben",10,7,2,3,0,0,0,1
Collingwood,"Swan, Dane",28,14,5,14,1,0,0,2
Collingwood,"Toovey, Alan",9,5,3,4,0,0,0,2
Collingwood,"Williams, Marley",22,15,3,7,0,0,0,3
Collingwood,"Witts, Jarrod",5,1,1,4,0,0,25,6
Collingwood,"Young, Clinton",20,15,5,5,1,1,0,1
Collingwood,"Armstrong, Tony",19,13,3,6,0,0,0,3
Collingwood,"Ball, Luke",20,12,5,8,0,0,0,1
Collingwood,"Blair, Jarryd",20,9,1,11,1,0,0,9
Collingwood,"Broomhead, Tim",23,14,5,9,2,1,0,3
Collingwood,"Dwyer, Sam",18,9,5,9,0,0,0,3
Collingwood,"Fasolo, Alex",10,5,2,5,0,2,0,5
Collingwood,"Frost, Jack",5,4,1,1,0,0,0,1
Collingwood,"Goldsack, Tyson",9,5,4,4,0,0,0,3
Collingwood,"Grundy, Brodie",11,6,1,5,0,0,23,1
Collingwood,"Keeffe, Lachlan",11,9,3,2,0,0,0,2
Collingwood,"Langdon, Tom",14,8,3,6,0,0,0,3
Collingwood,"Macaffer, Brent",2,1,2,1,0,0,0,2
Collingwood,"Pendlebury, Scott",28,14,2,14,0,0,0,8
Collingwood,"Ramsay, Jackson",12,8,2,4,0,0,0,4
Collingwood,"Sidebottom, Steele",20,11,3,9,1,0,0,8
Collingwood,"Sinclair, Ben",16,8,3,8,1,0,0,3
Collingwood,"Swan, Dane",15,7,0,8,0,0,0,1
Collingwood,"Thomas, Josh",29,15,4,14,3,1,0,8
Collingwood,"White, Jesse",8,3,2,5,2,0,0,2
Collingwood,"Williams, Marley",20,14,4,6,1,1,0,6
Collingwood,"Witts, Jarrod",11,5,2,6,0,0,20,1
Collingwood,"Young, Clinton",2,1,1,1,0,0,0,0
Collingwood,"Armstrong, Tony",7,6,2,1,0,0,0,1
Collingwood,"Ball, Luke",21,9,4,12,0,0,0,7
Collingwood,"Blair, Jarryd",7,3,1,4,1,0,0,7
Collingwood,"Broomhead, Tim",11,6,2,5,1,0,0,1
Collingwood,"Dwyer, Sam",18,7,4,11,0,0,0,0
Collingwood,"Fasolo, Alex",12,7,6,5,1,1,0,2
Collingwood,"Frost, Jack",5,4,1,1,0,0,0,7
Collingwood,"Gault, Corey",7,6,3,1,2,0,4,4
Collingwood,"Goldsack, Tyson",16,12,2,4,0,1,0,2
Collingwood,"Grundy, Brodie",7,4,2,3,0,0,6,3
Collingwood,"Keeffe, Lachlan",10,7,4,3,0,0,0,0
Collingwood,"Langdon, Tom",13,6,5,7,0,0,0,1
Collingwood,"Lumumba, Heritier",14,6,3,8,0,1,1,1
Collingwood,"Pendlebury, Scott",28,14,3,14,0,0,0,3
Collingwood,"Ramsay, Jackson",10,6,3,4,0,0,0,3
Collingwood,"Seedsman, Paul",7,4,2,3,0,0,1,0
Collingwood,"Sidebottom, Steele",36,27,4,9,1,0,0,3
Collingwood,"Sinclair, Ben",10,4,0,6,0,0,0,0
Collingwood,"Thomas, Josh",15,13,2,2,0,0,0,3
Collingwood,"White, Jesse",11,9,7,2,2,3,2,3
Collingwood,"Williams, Marley",12,6,3,6,0,1,0,2
Collingwood,"Witts, Jarrod",7,3,3,4,0,0,19,3
Essendon,"Ambrose, Patrick",10,4,3,6,0,0,0,6
Essendon,"Baguley, Mark",18,11,9,7,0,1,2,2
Essendon,"Carlisle, Jake",19,10,7,9,0,2,0,0
Essendon,"Chapman, Paul",22,16,7,6,4,1,0,0
Essendon,"Daniher, Joe",11,9,6,2,2,0,1,3
Essendon,"Fletcher, Dustin",15,13,9,2,0,0,0,1
Essendon,"Gleeson, Martin",14,8,5,6,0,0,0,1
Essendon,"Goddard, Brendon",26,15,3,11,3,2,0,6
Essendon,"Hardingham, Kyle",17,12,9,5,2,0,0,1
Essendon,"Heppell, Dyson",37,24,16,13,0,0,0,1
Essendon,"Hibberd, Michael",23,19,9,4,0,0,0,1
Essendon,"Hocking, Heath",15,5,2,10,0,0,0,3
Essendon,"Hooker, Cale",26,17,16,9,0,0,0,2
Essendon,"Howlett, Ben",19,11,5,8,1,1,0,9
Essendon,"Hurley, Michael",19,14,10,5,0,0,0,1
Essendon,"Merrett, Jackson",24,16,9,8,0,0,0,5
Essendon,"Merrett, Zach",11,6,4,5,0,0,0,2
Essendon,"Myers, David",27,15,5,12,0,0,1,6
Essendon,"Ryder, Paddy",11,7,3,4,1,1,34,0
Essendon,"Stanton, Brent",20,13,8,7,0,0,0,2
Essendon,"Watson, Jobe",38,21,9,17,2,0,0,3
Essendon,"Zaharakis, David",28,20,5,8,0,0,0,2
Essendon,"Ambrose, Patrick",12,7,4,5,3,0,0,4
Essendon,"Baguley, Mark",13,8,6,5,0,0,0,1
Essendon,"Carlisle, Jake",16,14,10,2,2,2,10,2
Essendon,"Chapman, Paul",20,18,6,2,1,0,0,7
Essendon,"Daniher, Joe",13,10,6,3,0,1,7,3
Essendon,"Fletcher, Dustin",23,19,11,4,0,0,0,0
Essendon,"Gleeson, Martin",17,11,8,6,0,0,0,1
Essendon,"Goddard, Brendon",28,13,5,15,0,0,2,2
Essendon,"Hardingham, Kyle",11,7,4,4,2,0,0,2
Essendon,"Heppell, Dyson",22,11,8,11,0,0,0,2
Essendon,"Hibberd, Michael",27,14,7,13,0,1,0,1
Essendon,"Hocking, Heath",20,8,6,12,1,1,0,2
Essendon,"Hooker, Cale",27,13,10,14,0,0,0,1
Essendon,"Howlett, Ben",17,14,3,3,0,2,0,3
Essendon,"Hurley, Michael",17,9,4,8,0,0,0,1
Essendon,"Merrett, Jackson",13,9,7,4,1,0,0,8
Essendon,"Merrett, Zach",6,5,2,1,0,0,0,3
Essendon,"Myers, David",26,16,3,10,0,1,1,5
Essendon,"Ryder, Paddy",4,2,1,2,0,0,19,1
Essendon,"Stanton, Brent",25,16,8,9,1,0,0,7
Essendon,"Watson, Jobe",30,10,7,20,0,0,1,7
Essendon,"Zaharakis, David",24,15,4,9,1,1,0,3
Essendon,"Ashby, Jason",13,7,5,6,0,0,0,0
Essendon,"Baguley, Mark",26,17,7,9,0,0,0,2
Essendon,"Carlisle, Jake",17,13,9,4,1,0,18,2
Essendon,"Chapman, Paul",23,19,11,4,4,3,0,3
Essendon,"Daniher, Joe",14,8,5,6,1,0,9,2
Essendon,"Fletcher, Dustin",18,14,6,4,0,0,0,1
Essendon,"Gleeson, Martin",10,6,2,4,0,1,0,1
Essendon,"Goddard, Brendon",20,13,13,7,2,3,0,2
Essendon,"Hardingham, Kyle",7,7,6,0,3,0,0,2
Essendon,"Heppell, Dyson",28,18,6,10,1,0,0,5
Essendon,"Hibberd, Michael",27,16,8,11,0,0,0,0
Essendon,"Hocking, Heath",28,15,8,13,1,0,1,3
Essendon,"Hooker, Cale",19,11,9,8,0,0,0,2
Essendon,"Howlett, Ben",15,7,3,8,0,0,0,8
Essendon,"Hurley, Michael",23,12,8,11,0,0,0,0
Essendon,"Melksham, Jake",21,13,8,8,1,0,0,2
Essendon,"Merrett, Jackson",35,21,10,14,0,0,0,3
Essendon,"Myers, David",19,11,6,8,0,0,0,4
Essendon,"Stanton, Brent",25,15,6,10,3,0,0,1
Essendon,"Watson, Jobe",26,10,4,16,0,1,0,5
Essendon,"Winderlich, Jason",10,5,5,5,4,0,0,0
Essendon,"Zaharakis, David",22,10,5,12,0,0,0,3
Essendon,"Ashby, Jason",22,8,2,14,0,0,0,2
Essendon,"Baguley, Mark",23,15,4,8,0,0,0,5
Essendon,"Carlisle, Jake",11,6,3,5,0,0,9,2
Essendon,"Colyer, Travis",17,11,3,6,0,1,0,4
Essendon,"Daniher, Joe",15,8,7,7,1,0,2,3
Essendon,"Gleeson, Martin",21,14,8,7,1,0,0,3
Essendon,"Goddard, Brendon",2,2,2,0,0,0,0,1
Essendon,"Hardingham, Kyle",6,4,3,2,2,0,0,1
Essendon,"Heppell, Dyson",35,19,7,16,0,0,0,10
Essendon,"Hibberd, Michael",27,15,8,12,0,0,0,1
Essendon,"Hocking, Heath",8,5,4,3,0,0,0,5
Essendon,"Hooker, Cale",26,15,10,11,0,0,0,1
Essendon,"Howlett, Ben",20,12,9,8,0,0,1,6
Essendon,"Hurley, Michael",17,9,2,8,0,0,0,2
Essendon,"Jetta, Leroy",8,8,4,0,1,2,0,2
Essendon,"Melksham, Jake",14,5,6,9,1,1,1,2
Essendon,"Merrett, Jackson",19,11,6,8,0,0,0,0
Essendon,"Stanton, Brent",32,15,6,17,1,0,0,2
Essendon,"Watson, Jobe",23,8,3,15,1,0,0,3
Essendon,"Winderlich, Jason",9,3,2,6,1,0,1,2
Essendon,"Zaharakis, David",21,10,4,11,0,0,0,3
Essendon,"van Unen, Dylan",14,4,5,10,0,0,0,1
Essendon,"Ashby, Jason",11,6,2,5,0,0,0,2
Essendon,"Baguley, Mark",21,15,13,6,0,0,0,1
Essendon,"Carlisle, Jake",9,2,3,7,0,0,4,0
Essendon,"Chapman, Paul",27,14,8,13,0,2,0,4
Essendon,"Daniher, Joe",9,4,6,5,0,0,0,1
Essendon,"Fletcher, Dustin",24,18,6,6,0,0,0,0
Essendon,"Gleeson, Martin",23,12,5,11,0,1,0,2
Essendon,"Hardingham, Kyle",6,5,2,1,0,2,0,3
Essendon,"Heppell, Dyson",17,9,1,8,0,0,0,2
Essendon,"Hibberd, Michael",27,18,13,9,0,0,0,1
Essendon,"Hocking, Heath",7,1,1,6,0,0,0,6
Essendon,"Hooker, Cale",29,19,15,10,0,0,0,2
Essendon,"Howlett, Ben",20,9,6,11,0,1,0,3
Essendon,"Hurley, Michael",22,14,11,8,0,0,0,1
Essendon,"Jetta, Leroy",10,6,1,4,2,1,0,1
Essendon,"Melksham, Jake",15,11,5,4,2,0,0,4
Essendon,"Merrett, Jackson",19,11,8,8,0,0,0,3
Essendon,"Myers, David",21,12,6,9,1,0,0,2
Essendon,"Ryder, Paddy",13,8,4,5,1,2,25,2
Essendon,"Stanton, Brent",29,20,9,9,3,0,0,3
Essendon,"Watson, Jobe",29,9,4,20,0,0,0,2
Essendon,"Zaharakis, David",22,10,7,12,0,0,0,1
Essendon,"Ashby, Jason",15,7,1,8,0,0,0,5
Essendon,"Baguley, Mark",21,9,4,12,0,0,0,2
Essendon,"Carlisle, Jake",8,5,4,3,0,0,4,1
Essendon,"Chapman, Paul",21,11,6,10,0,1,0,2
Essendon,"Daniher, Joe",11,7,8,4,1,0,5,0
Essendon,"Dempsey, Courtenay",10,6,1,4,0,0,0,1
Essendon,"Fletcher, Dustin",17,12,5,5,0,0,0,0
Essendon,"Gleeson, Martin",13,11,6,2,0,2,0,3
Essendon,"Hardingham, Kyle",2,1,1,1,0,0,0,2
Essendon,"Heppell, Dyson",33,13,2,20,0,0,2,11
Essendon,"Hibberd, Michael",25,11,2,14,0,0,0,5
Essendon,"Hooker, Cale",16,4,3,12,0,0,0,1
Essendon,"Howlett, Ben",23,7,4,16,0,0,0,6
Essendon,"Hurley, Michael",17,11,5,6,0,0,0,1
Essendon,"Melksham, Jake",23,14,6,9,1,1,0,2
Essendon,"Merrett, Jackson",17,7,5,10,1,1,0,5
Essendon,"Merrett, Zach",13,7,2,6,1,0,0,5
Essendon,"Ryder, Paddy",15,9,3,6,1,1,36,4
Essendon,"Stanton, Brent",32,22,7,10,1,0,0,7
Essendon,"Watson, Jobe",19,7,2,12,1,0,0,9
Essendon,"Winderlich, Jason",12,5,4,7,1,2,0,3
Essendon,"Zaharakis, David",18,11,3,7,0,1,0,6
Essendon,"Ashby, Jason",2,2,2,0,0,0,0,0
Essendon,"Baguley, Mark",13,8,6,5,0,0,0,2
Essendon,"Carlisle, Jake",9,6,5,3,0,1,0,3
Essendon,"Chapman, Paul",17,14,6,3,1,1,0,4
Essendon,"Daniher, Joe",12,8,5,4,1,1,2,0
Essendon,"Dempsey, Courtenay",16,12,7,4,1,0,0,3
Essendon,"Fletcher, Dustin",25,16,9,9,0,0,0,0
Essendon,"Goddard, Brendon",22,17,7,5,1,3,3,3
Essendon,"Heppell, Dyson",25,11,6,14,1,0,0,4
Essendon,"Hibberd, Michael",20,15,7,5,0,0,0,1
Essendon,"Hocking, Heath",10,6,4,4,0,1,0,6
Essendon,"Hooker, Cale",24,15,13,9,0,0,0,2
Essendon,"Howlett, Ben",8,6,2,2,1,0,0,5
Essendon,"Hurley, Michael",20,13,10,7,0,0,0,0
Essendon,"Melksham, Jake",17,10,2,7,0,0,0,0
Essendon,"Merrett, Jackson",8,6,2,2,0,0,0,1
Essendon,"Merrett, Zach",10,7,4,3,0,0,0,6
Essendon,"Ryder, Paddy",11,8,2,3,0,0,28,4
Essendon,"Stanton, Brent",13,10,4,3,1,1,0,4
Essendon,"Watson, Jobe",18,11,4,7,2,0,0,4
Essendon,"Winderlich, Jason",12,10,4,2,1,1,0,1
Essendon,"Zaharakis, David",23,14,4,9,0,0,0,6
Essendon,"Ambrose, Patrick",7,6,5,1,0,1,0,2
Essendon,"Aylett, Kurt",7,5,3,2,0,0,0,0
Essendon,"Baguley, Mark",17,10,5,7,0,0,0,5
Essendon,"Carlisle, Jake",9,6,6,3,1,0,3,3
Essendon,"Chapman, Paul",23,12,8,11,0,2,0,5
Essendon,"Daniher, Joe",11,6,3,5,1,2,3,1
Essendon,"Dempsey, Courtenay",25,15,5,10,0,0,0,5
Essendon,"Fletcher, Dustin",20,12,6,8,0,0,0,0
Essendon,"Gleeson, Martin",8,4,1,4,0,0,0,1
Essendon,"Goddard, Brendon",30,18,9,12,1,0,2,3
Essendon,"Heppell, Dyson",36,14,6,22,0,0,1,6
Essendon,"Hibberd, Michael",28,15,6,13,0,0,0,3
Essendon,"Hocking, Heath",15,7,2,8,0,0,0,7
Essendon,"Hooker, Cale",20,11,10,9,0,0,0,2
Essendon,"Hurley, Michael",20,16,9,4,0,0,0,2
Essendon,"Melksham, Jake",22,8,5,14,0,0,0,3
Essendon,"Merrett, Jackson",8,4,1,4,1,0,0,2
Essendon,"Merrett, Zach",11,8,4,3,2,0,0,2
Essendon,"Ryder, Paddy",15,8,7,7,1,0,31,4
Essendon,"Stanton, Brent",25,16,8,9,0,1,0,4
Essendon,"Watson, Jobe",35,16,7,19,1,0,0,9
Essendon,"Zaharakis, David",16,9,4,7,1,0,0,5
Essendon,"Ambrose, Patrick",14,9,5,5,0,0,0,5
Essendon,"Aylett, Kurt",9,4,5,5,0,0,0,4
Essendon,"Baguley, Mark",20,10,9,10,0,0,0,8
Essendon,"Bellchambers, Tom",10,6,3,4,1,0,29,3
Essendon,"Carlisle, Jake",6,2,2,4,2,0,0,0
Essendon,"Daniher, Joe",7,4,4,3,1,0,0,1
Essendon,"Dempsey, Courtenay",22,13,3,9,0,2,0,1
Essendon,"Fletcher, Dustin",23,15,6,8,0,0,0,0
Essendon,"Goddard, Brendon",34,17,6,17,1,0,2,2
Essendon,"Heppell, Dyson",31,16,11,15,0,2,0,4
Essendon,"Hibberd, Michael",32,21,3,11,0,0,0,2
Essendon,"Hocking, Heath",19,12,2,7,1,1,0,11
Essendon,"Hooker, Cale",15,7,3,8,0,0,0,1
Essendon,"Hurley, Michael",20,8,3,12,0,0,0,2
Essendon,"Melksham, Jake",14,5,3,9,0,0,0,2
Essendon,"Merrett, Jackson",11,5,4,6,0,0,0,2
Essendon,"Merrett, Zach",19,7,5,12,0,0,0,6
Essendon,"Myers, David",18,9,0,9,0,0,0,2
Essendon,"Ryder, Paddy",16,9,8,7,2,2,17,4
Essendon,"Stanton, Brent",26,18,3,8,0,0,0,2
Essendon,"Watson, Jobe",30,17,5,13,0,0,1,6
Essendon,"Zaharakis, David",31,17,7,14,1,1,0,6
Essendon,"Ambrose, Patrick",15,6,4,9,0,0,0,5
Essendon,"Baguley, Mark",17,11,4,6,0,0,0,5
Essendon,"Bellchambers, Tom",12,4,2,8,1,0,12,1
Essendon,"Carlisle, Jake",20,9,10,11,0,0,0,1
Essendon,"Chapman, Paul",17,10,7,7,1,1,0,8
Essendon,"Daniher, Joe",12,10,7,2,3,1,0,1
Essendon,"Dempsey, Courtenay",17,9,4,8,0,0,0,3
Essendon,"Fletcher, Dustin",25,20,13,5,1,0,0,3
Essendon,"Goddard, Brendon",30,22,11,8,0,1,0,0
Essendon,"Heppell, Dyson",21,9,5,12,1,1,0,2
Essendon,"Hibberd, Michael",23,14,6,9,1,0,0,1
Essendon,"Hocking, Heath",9,4,2,5,0,1,0,7
Essendon,"Hooker, Cale",17,11,7,6,0,0,0,2
Essendon,"Howlett, Ben",25,15,5,10,5,0,0,5
Essendon,"Melksham, Jake",6,2,2,4,0,0,0,1
Essendon,"Merrett, Zach",22,14,5,8,2,0,0,3
Essendon,"Myers, David",23,13,6,10,0,0,1,1
Essendon,"Ryder, Paddy",12,8,4,4,0,1,12,5
Essendon,"Stanton, Brent",27,23,9,4,0,2,0,5
Essendon,"Watson, Jobe",36,14,4,22,0,0,0,4
Essendon,"Winderlich, Jason",5,2,2,3,0,1,0,3
Essendon,"Zaharakis, David",31,23,13,8,0,2,0,2
Essendon,"Ambrose, Patrick",18,8,4,10,0,0,0,0
Essendon,"Baguley, Mark",24,13,4,11,0,0,0,6
Essendon,"Bellchambers, Tom",8,2,4,6,0,1,16,1
Essendon,"Carlisle, Jake",13,8,7,5,0,0,0,1
Essendon,"Chapman, Paul",19,11,6,8,0,0,0,4
Essendon,"Daniher, Joe",15,9,9,6,3,4,0,0
Essendon,"DellOlio, Cory",11,3,1,8,2,0,0,2
Essendon,"Dempsey, Courtenay",15,4,1,11,0,0,0,4
Essendon,"Fletcher, Dustin",8,6,4,2,0,0,0,1
Essendon,"Goddard, Brendon",18,12,5,6,0,0,1,3
Essendon,"Heppell, Dyson",30,15,2,15,0,1,0,2
Essendon,"Hibberd, Michael",18,13,3,5,0,0,0,3
Essendon,"Hocking, Heath",6,4,2,2,1,0,0,4
Essendon,"Hooker, Cale",16,7,2,9,0,0,1,2
Essendon,"Howlett, Ben",13,8,4,5,1,0,0,7
Essendon,"Melksham, Jake",14,5,1,9,0,1,0,2
Essendon,"Merrett, Zach",21,12,4,9,0,0,0,6
Essendon,"Myers, David",9,4,3,5,0,0,0,1
Essendon,"Ryder, Paddy",7,5,2,2,1,1,22,2
Essendon,"Stanton, Brent",21,13,4,8,1,2,0,3
Essendon,"Watson, Jobe",27,21,3,6,0,0,0,3
Essendon,"Zaharakis, David",34,18,4,16,2,1,0,5
Essendon,"Ambrose, Patrick",13,7,5,6,1,1,0,3
Essendon,"Baguley, Mark",20,15,7,5,0,0,0,1
Essendon,"Bellchambers, Tom",11,7,5,4,0,3,14,3
Essendon,"Carlisle, Jake",16,12,5,4,0,0,0,2
Essendon,"Chapman, Paul",18,8,3,10,1,0,0,2
Essendon,"Daniher, Joe",11,6,5,5,1,2,0,0
Essendon,"Dempsey, Courtenay",19,10,4,9,0,1,0,3
Essendon,"Goddard, Brendon",31,20,10,11,1,2,3,8
Essendon,"Heppell, Dyson",22,11,5,11,0,0,0,9
Essendon,"Hibberd, Michael",24,18,6,6,0,0,0,3
Essendon,"Hocking, Heath",17,8,2,9,0,0,0,14
Essendon,"Hooker, Cale",16,9,9,7,0,0,0,2
Essendon,"Howlett, Ben",17,7,4,10,0,0,0,10
Essendon,"Hurley, Michael",16,10,4,6,0,0,0,1
Essendon,"Kavanagh, Elliott",4,3,0,1,0,0,0,2
Essendon,"Melksham, Jake",17,8,2,9,0,0,0,1
Essendon,"Merrett, Zach",14,11,2,3,1,0,0,4
Essendon,"Myers, David",20,9,3,11,0,1,4,4
Essendon,"Ryder, Paddy",12,7,3,5,1,0,16,1
Essendon,"Stanton, Brent",13,10,3,3,0,1,0,6
Essendon,"Winderlich, Jason",7,3,3,4,0,1,0,3
Essendon,"Zaharakis, David",31,23,5,8,4,1,0,1
Essendon,"Ambrose, Patrick",13,7,7,6,1,0,0,3
Essendon,"Baguley, Mark",13,6,3,7,0,0,0,5
Essendon,"Bellchambers, Tom",6,3,4,3,0,0,9,1
Essendon,"Colyer, Travis",15,12,8,3,1,0,0,2
Essendon,"Daniher, Joe",9,7,6,2,1,0,2,1
Essendon,"Dempsey, Courtenay",17,9,3,8,0,0,0,3
Essendon,"Fletcher, Dustin",9,5,3,4,0,0,0,3
Essendon,"Goddard, Brendon",32,23,12,9,1,1,0,5
Essendon,"Heppell, Dyson",27,15,5,12,0,0,0,4
Essendon,"Hibberd, Michael",30,21,6,9,0,0,0,1
Essendon,"Hocking, Heath",13,6,5,7,1,0,0,1
Essendon,"Hooker, Cale",22,14,7,8,0,0,0,3
Essendon,"Howlett, Ben",13,9,2,4,1,0,0,2
Essendon,"Hurley, Michael",20,11,2,9,1,0,0,0
Essendon,"Kavanagh, Elliott",15,7,3,8,0,0,0,3
Essendon,"Melksham, Jake",24,11,3,13,1,0,1,7
Essendon,"Merrett, Zach",7,3,2,4,0,0,0,2
Essendon,"Myers, David",21,12,4,9,0,0,0,3
Essendon,"Ryder, Paddy",15,9,7,6,2,1,21,1
Essendon,"Stanton, Brent",19,14,5,5,2,0,0,6
Essendon,"Winderlich, Jason",20,10,6,10,2,0,0,0
Essendon,"Zaharakis, David",16,11,4,5,1,2,0,2
Essendon,"Ambrose, Patrick",13,6,3,7,0,1,0,4
Essendon,"Carlisle, Jake",13,9,6,4,2,2,0,2
Essendon,"Chapman, Paul",11,8,3,3,0,0,0,5
Essendon,"Colyer, Travis",19,13,7,6,2,2,0,3
Essendon,"Daniher, Joe",9,5,3,4,2,1,4,1
Essendon,"Dempsey, Courtenay",14,11,4,3,1,0,0,7
Essendon,"Fletcher, Dustin",17,12,2,5,0,0,0,0
Essendon,"Goddard, Brendon",20,14,9,6,0,0,0,2
Essendon,"Hardingham, Kyle",3,2,2,1,0,1,0,2
Essendon,"Heppell, Dyson",40,21,6,19,0,1,2,7
Essendon,"Hibberd, Michael",18,9,5,9,1,0,1,1
Essendon,"Hocking, Heath",12,5,3,7,0,0,0,3
Essendon,"Hooker, Cale",7,5,3,2,0,0,0,2
Essendon,"Howlett, Ben",11,6,3,5,1,0,0,5
Essendon,"Hurley, Michael",18,12,6,6,0,0,0,0
Essendon,"Melksham, Jake",12,7,3,5,0,0,0,4
Essendon,"Merrett, Jackson",9,4,2,5,1,0,0,2
Essendon,"Merrett, Zach",7,4,1,3,0,0,0,0
Essendon,"Myers, David",20,10,5,10,0,0,0,4
Essendon,"Ryder, Paddy",17,8,5,9,0,0,32,3
Essendon,"Stanton, Brent",20,15,5,5,1,1,0,6
Essendon,"Zaharakis, David",25,11,5,14,0,2,0,6
Essendon,"Ambrose, Patrick",6,4,2,2,1,0,0,2
Essendon,"Baguley, Mark",6,5,4,1,0,0,0,5
Essendon,"Carlisle, Jake",10,9,3,1,2,0,0,4
Essendon,"Chapman, Paul",17,10,2,7,0,2,0,1
Essendon,"Colyer, Travis",19,17,8,2,0,2,0,4
Essendon,"Daniher, Joe",12,12,5,0,0,3,2,2
Essendon,"Dempsey, Courtenay",16,10,5,6,0,0,0,5
Essendon,"Goddard, Brendon",20,14,6,6,1,0,0,3
Essendon,"Hardingham, Kyle",2,2,0,0,0,0,0,5
Essendon,"Heppell, Dyson",17,7,2,10,1,0,0,5
Essendon,"Hocking, Heath",8,3,3,5,0,0,0,9
Essendon,"Hooker, Cale",13,5,3,8,0,0,0,2
Essendon,"Howlett, Ben",11,9,2,2,0,1,0,7
Essendon,"Hurley, Michael",14,10,4,4,0,0,0,2
Essendon,"Melksham, Jake",10,6,2,4,0,0,0,3
Essendon,"Merrett, Jackson",6,3,0,3,1,0,0,9
Essendon,"Merrett, Zach",23,16,6,7,0,0,0,4
Essendon,"Myers, David",24,14,3,10,1,0,4,8
Essendon,"Ryder, Paddy",9,5,2,4,1,1,27,3
Essendon,"Stanton, Brent",25,16,5,9,0,1,0,1
Essendon,"Winderlich, Jason",24,17,7,7,0,0,0,5
Essendon,"Zaharakis, David",30,18,4,12,0,1,0,7
Essendon,"Ambrose, Patrick",15,10,6,5,3,0,0,5
Essendon,"Baguley, Mark",23,17,11,6,0,0,0,1
Essendon,"Carlisle, Jake",26,22,19,4,4,2,0,2
Essendon,"Chapman, Paul",20,14,3,6,3,0,0,8
Essendon,"Colyer, Travis",14,9,3,5,0,0,0,3
Essendon,"Daniher, Joe",10,8,6,2,1,1,3,0
Essendon,"DellOlio, Cory",6,3,2,3,0,2,0,1
Essendon,"Dempsey, Courtenay",21,10,7,11,0,0,0,6
Essendon,"Fletcher, Dustin",26,16,13,10,0,0,0,1
Essendon,"Heppell, Dyson",29,14,2,15,0,0,0,1
Essendon,"Hocking, Heath",9,4,0,5,1,0,0,9
Essendon,"Hooker, Cale",23,17,9,6,0,0,0,0
Essendon,"Howlett, Ben",18,9,4,9,0,0,0,4
Essendon,"Hurley, Michael",18,10,7,8,0,0,0,1
Essendon,"Melksham, Jake",17,10,5,7,0,0,0,3
Essendon,"Merrett, Jackson",14,11,7,3,0,0,0,1
Essendon,"Merrett, Zach",24,10,2,14,2,0,0,4
Essendon,"Myers, David",26,12,3,14,0,0,3,3
Essendon,"Ryder, Paddy",12,5,4,7,0,1,28,5
Essendon,"Stanton, Brent",32,22,14,10,1,0,0,4
Essendon,"Winderlich, Jason",23,14,12,9,0,0,0,3
Essendon,"Zaharakis, David",19,13,9,6,1,0,0,3
Essendon,"Ambrose, Patrick",4,2,0,2,1,0,0,4
Essendon,"Baguley, Mark",14,8,6,6,0,0,0,2
Essendon,"Carlisle, Jake",19,13,12,6,8,2,1,7
Essendon,"Chapman, Paul",21,13,6,8,1,1,0,3
Essendon,"Colyer, Travis",15,12,1,3,1,1,0,3
Essendon,"DellOlio, Cory",2,1,1,1,1,0,0,4
Essendon,"Dempsey, Courtenay",11,6,1,5,0,0,0,5
Essendon,"Fletcher, Dustin",16,11,6,5,0,0,0,0
Essendon,"Goddard, Brendon",17,8,5,9,0,0,0,1
Essendon,"Heppell, Dyson",22,14,4,8,0,0,0,8
Essendon,"Hibberd, Michael",16,8,4,8,0,0,1,0
Essendon,"Hocking, Heath",9,8,2,1,0,0,0,2
Essendon,"Hooker, Cale",18,13,12,5,0,0,3,0
Essendon,"Howlett, Ben",3,2,1,1,0,0,0,6
Essendon,"Hurley, Michael",20,11,5,9,0,0,0,4
Essendon,"Merrett, Jackson",7,4,1,3,0,1,1,0
Essendon,"Merrett, Zach",18,10,3,8,0,0,0,2
Essendon,"Myers, David",20,12,4,8,0,2,1,8
Essendon,"Ryder, Paddy",18,16,5,2,2,0,35,3
Essendon,"Stanton, Brent",17,11,6,6,0,1,0,9
Essendon,"Winderlich, Jason",21,10,8,11,1,0,0,1
Essendon,"Zaharakis, David",16,10,1,6,0,1,0,1
Essendon,"Ambrose, Patrick",4,1,1,3,1,0,0,3
Essendon,"Baguley, Mark",16,7,4,9,0,0,0,4
Essendon,"Bellchambers, Tom",3,1,2,2,0,0,13,1
Essendon,"Carlisle, Jake",11,7,2,4,1,2,0,3
Essendon,"Chapman, Paul",21,8,2,13,0,0,0,6
Essendon,"Colyer, Travis",15,7,2,8,0,0,0,1
Essendon,"DellOlio, Cory",7,3,3,4,0,0,0,2
Essendon,"Dempsey, Courtenay",13,8,2,5,0,0,0,1
Essendon,"Fletcher, Dustin",13,9,4,4,0,0,0,1
Essendon,"Goddard, Brendon",21,13,2,8,0,1,2,1
Essendon,"Heppell, Dyson",24,15,2,9,1,0,0,6
Essendon,"Hocking, Heath",15,5,0,10,0,0,1,7
Essendon,"Hooker, Cale",14,7,1,7,0,0,0,1
Essendon,"Howlett, Ben",12,5,2,7,1,0,0,6
Essendon,"Hurley, Michael",29,18,7,11,1,0,0,0
Essendon,"Merrett, Jackson",14,5,2,9,0,0,0,1
Essendon,"Merrett, Zach",19,7,2,12,0,0,0,8
Essendon,"Myers, David",19,10,4,9,1,0,1,5
Essendon,"Ryder, Paddy",15,10,4,5,2,2,28,3
Essendon,"Stanton, Brent",19,10,5,9,0,1,0,1
Essendon,"Winderlich, Jason",17,7,2,10,0,0,0,2
Essendon,"Zaharakis, David",25,14,0,11,0,1,0,6
Essendon,"Baguley, Mark",14,9,5,5,0,0,0,0
Essendon,"Carlisle, Jake",7,7,5,0,2,3,0,1
Essendon,"Chapman, Paul",23,16,8,7,2,0,0,2
Essendon,"Colyer, Travis",15,10,4,5,0,0,0,2
Essendon,"Daniher, Joe",8,6,4,2,0,1,1,2
Essendon,"DellOlio, Cory",14,8,3,6,1,0,0,3
Essendon,"Dempsey, Courtenay",20,11,6,9,0,0,0,3
Essendon,"Fantasia, Orazio",9,2,2,7,0,0,0,1
Essendon,"Goddard, Brendon",24,11,5,13,1,1,2,1
Essendon,"Heppell, Dyson",32,23,6,9,1,0,1,4
Essendon,"Hocking, Heath",14,6,4,8,0,0,0,2
Essendon,"Hooker, Cale",11,3,3,8,0,0,0,1
Essendon,"Howlett, Ben",16,10,6,6,0,0,0,6
Essendon,"Hurley, Michael",13,10,5,3,0,1,0,3
Essendon,"Kavanagh, Elliott",4,0,1,4,0,0,0,0
Essendon,"Melksham, Jake",18,10,7,8,2,1,0,2
Essendon,"Merrett, Zach",14,6,5,8,1,0,0,1
Essendon,"Myers, David",17,9,3,8,0,0,1,4
Essendon,"Ryder, Paddy",17,9,3,8,0,0,37,2
Essendon,"Stanton, Brent",25,15,7,10,0,0,0,1
Essendon,"Winderlich, Jason",19,7,3,12,1,1,1,5
Essendon,"Zaharakis, David",32,19,4,13,0,0,0,4
Essendon,"Ambrose, Patrick",15,5,4,10,1,0,0,5
Essendon,"Baguley, Mark",24,13,9,11,0,0,0,6
Essendon,"Chapman, Paul",15,11,1,4,1,0,0,5
Essendon,"Colyer, Travis",24,13,6,11,0,0,0,2
Essendon,"Daniher, Joe",10,6,4,4,2,1,3,1
Essendon,"Dempsey, Courtenay",14,9,2,5,0,0,0,2
Essendon,"Goddard, Brendon",18,6,4,12,0,1,0,3
Essendon,"Heppell, Dyson",39,20,3,19,0,0,1,3
Essendon,"Hibberd, Michael",32,14,6,18,0,0,0,0
Essendon,"Hocking, Heath",21,9,4,12,0,0,0,5
Essendon,"Hooker, Cale",21,12,9,9,0,0,0,2
Essendon,"Howlett, Ben",18,12,4,6,0,1,0,8
Essendon,"Hurley, Michael",24,15,5,9,0,0,0,1
Essendon,"Melksham, Jake",5,0,1,5,0,0,0,0
Essendon,"Merrett, Zach",12,7,1,5,0,0,0,2
Essendon,"Myers, David",29,19,2,10,1,1,0,3
Essendon,"Ryder, Paddy",7,3,2,4,0,0,19,2
Essendon,"Stanton, Brent",24,15,5,9,1,1,0,1
Essendon,"Steinberg, Ariel",11,7,2,4,0,0,0,2
Essendon,"Watson, Jobe",30,11,5,19,1,1,1,1
Essendon,"Winderlich, Jason",19,10,7,9,3,2,0,1
Essendon,"Zaharakis, David",31,14,4,17,1,0,0,2
Essendon,"Ambrose, Patrick",9,3,4,6,0,0,0,4
Essendon,"Baguley, Mark",14,8,7,6,0,1,0,3
Essendon,"Carlisle, Jake",7,6,3,1,2,1,0,2
Essendon,"Chapman, Paul",24,12,8,12,0,0,0,8
Essendon,"Colyer, Travis",16,13,3,3,1,1,0,0
Essendon,"Daniher, Joe",15,10,4,5,1,1,9,4
Essendon,"Dempsey, Courtenay",15,10,6,5,0,0,0,3
Essendon,"Fantasia, Orazio",6,2,3,4,0,0,0,0
Essendon,"Goddard, Brendon",28,18,9,10,3,2,1,3
Essendon,"Hibberd, Michael",23,18,12,5,0,0,0,1
Essendon,"Hocking, Heath",12,3,4,9,1,0,0,4
Essendon,"Hooker, Cale",13,7,7,6,0,0,0,1
Essendon,"Howlett, Ben",18,9,5,9,0,0,0,11
Essendon,"Hurley, Michael",27,22,12,5,2,0,0,1
Essendon,"Merrett, Zach",19,13,3,6,1,0,0,10
Essendon,"Myers, David",18,10,2,8,1,1,0,6
Essendon,"Ryder, Paddy",15,9,4,6,2,1,44,2
Essendon,"Stanton, Brent",22,15,1,7,0,1,0,3
Essendon,"Steinberg, Ariel",8,4,3,4,0,0,0,1
Essendon,"Watson, Jobe",24,11,4,13,0,0,0,4
Essendon,"Winderlich, Jason",7,5,3,2,0,0,0,3
Essendon,"Zaharakis, David",24,16,7,8,2,0,0,4
Essendon,"Ambrose, Patrick",12,5,6,7,1,0,0,4
Essendon,"Baguley, Mark",19,12,9,7,0,0,0,1
Essendon,"Bellchambers, Tom",12,10,5,2,0,0,18,4
Essendon,"Chapman, Paul",17,13,8,4,1,1,0,3
Essendon,"Colyer, Travis",19,14,7,5,0,1,0,3
Essendon,"Daniher, Joe",12,8,5,4,2,0,0,0
Essendon,"Dempsey, Courtenay",13,8,5,5,0,0,0,2
Essendon,"Fantasia, Orazio",11,5,3,6,0,2,0,0
Essendon,"Gleeson, Martin",4,3,2,1,1,0,0,0
Essendon,"Goddard, Brendon",19,12,5,7,1,1,1,1
Essendon,"Heppell, Dyson",25,13,6,12,0,0,2,1
Essendon,"Hibberd, Michael",21,12,6,9,0,0,0,1
Essendon,"Hocking, Heath",16,8,3,8,0,1,0,4
Essendon,"Hooker, Cale",16,12,9,4,0,0,0,1
Essendon,"Howlett, Ben",11,6,1,5,0,0,1,6
Essendon,"Hurley, Michael",16,10,4,6,0,0,0,3
Essendon,"Merrett, Zach",16,7,6,9,1,0,0,4
Essendon,"Ryder, Paddy",15,12,7,3,2,1,19,2
Essendon,"Stanton, Brent",24,13,8,11,1,0,0,2
Essendon,"Watson, Jobe",21,11,3,10,2,0,0,4
Essendon,"Winderlich, Jason",16,9,4,7,1,0,0,2
Essendon,"Zaharakis, David",21,14,3,7,0,0,0,3
Essendon,"Baguley, Mark",20,7,2,13,0,0,0,4
Essendon,"Bellchambers, Tom",12,8,4,4,1,1,9,0
Essendon,"Chapman, Paul",22,12,3,10,2,1,0,3
Essendon,"Colyer, Travis",15,12,4,3,2,0,0,2
Essendon,"Daniher, Joe",11,8,4,3,4,1,0,2
Essendon,"Dempsey, Courtenay",3,1,1,2,0,0,0,0
Essendon,"Gleeson, Martin",3,2,0,1,0,0,0,3
Essendon,"Goddard, Brendon",23,14,5,9,1,0,1,1
Essendon,"Heppell, Dyson",34,20,5,14,0,1,4,2
Essendon,"Hibberd, Michael",24,15,4,9,0,0,0,3
Essendon,"Hocking, Heath",16,12,5,4,0,0,0,4
Essendon,"Hooker, Cale",13,6,0,7,0,0,0,2
Essendon,"Howlett, Ben",15,7,2,8,1,0,0,7
Essendon,"Hurley, Michael",20,13,5,7,0,0,0,0
Essendon,"Merrett, Zach",18,10,4,8,0,2,0,5
Essendon,"Myers, David",20,12,2,8,0,1,2,6
Essendon,"Ryder, Paddy",15,7,5,8,1,1,19,3
Essendon,"Stanton, Brent",19,10,3,9,0,0,0,6
Essendon,"Steinberg, Ariel",11,5,2,6,0,0,0,0
Essendon,"Watson, Jobe",25,8,6,17,0,0,0,6
Essendon,"Winderlich, Jason",12,6,3,6,0,0,0,1
Essendon,"Zaharakis, David",20,12,2,8,0,0,0,4
Fremantle,"Ballantyne, Hayden",10,8,4,2,3,1,0,0
Fremantle,"Barlow, Michael",29,12,7,17,1,0,0,9
Fremantle,"Crowley, Ryan",16,8,2,8,2,0,0,3
Fremantle,"Dawson, Zac",12,4,4,8,0,0,0,1
Fremantle,"Duffield, Paul",14,9,5,5,0,0,0,3
Fremantle,"Fyfe, Nat",20,8,1,12,1,1,0,2
Fremantle,"Hannath, Jack",3,3,2,0,0,0,7,3
Fremantle,"Hill, Stephen",25,16,2,9,1,1,0,0
Fremantle,"Johnson, Michael",23,18,5,5,0,0,0,2
Fremantle,"Mayne, Chris",8,4,2,4,0,2,0,7
Fremantle,"McPharlin, Luke",11,8,5,3,0,0,0,0
Fremantle,"Mundy, David",22,15,5,7,2,0,0,3
Fremantle,"Mzungu, Tendai",27,20,4,7,1,0,0,3
Fremantle,"Neale, Lachie",5,2,1,3,0,0,0,2
Fremantle,"Pavlich, Matthew",15,10,7,5,1,4,0,3
Fremantle,"Pearce, Danyle",26,19,3,7,2,1,0,2
Fremantle,"Sandilands, Aaron",19,3,7,16,0,0,39,3
Fremantle,"Sheridan, Tom",8,5,0,3,1,0,0,5
Fremantle,"Spurr, Lee",18,10,6,8,0,0,0,2
Fremantle,"Sutcliffe, Cam",16,11,6,5,0,0,0,3
Fremantle,"Walters, Michael",16,9,2,7,2,2,0,5
Fremantle,"de Boer, Matt",21,9,2,12,0,0,0,10
Fremantle,"Ballantyne, Hayden",13,8,3,5,0,1,0,3
Fremantle,"Barlow, Michael",32,19,7,13,2,1,0,4
Fremantle,"Crowley, Ryan",10,6,0,4,1,0,0,4
Fremantle,"Dawson, Zac",11,3,1,8,0,0,1,1
Fremantle,"Duffield, Paul",23,16,7,7,1,1,0,4
Fremantle,"Fyfe, Nat",29,12,4,17,0,1,2,4
Fremantle,"Hannath, Jack",5,3,1,2,0,0,6,1
Fremantle,"Hill, Stephen",23,13,2,10,1,0,0,4
Fremantle,"Johnson, Michael",20,15,6,5,1,0,0,2
Fremantle,"Mayne, Chris",12,4,1,8,0,0,0,5
Fremantle,"McPharlin, Luke",12,8,3,4,0,0,0,2
Fremantle,"Mundy, David",33,24,5,9,0,0,2,4
Fremantle,"Mzungu, Tendai",18,14,2,4,2,0,0,3
Fremantle,"Pavlich, Matthew",12,7,3,5,0,1,0,2
Fremantle,"Pearce, Danyle",16,10,1,6,1,0,0,1
Fremantle,"Sandilands, Aaron",11,3,1,8,0,0,58,6
Fremantle,"Sheridan, Tom",9,5,1,4,1,1,0,2
Fremantle,"Spurr, Lee",20,14,6,6,0,0,0,1
Fremantle,"Suban, Nick",9,4,1,5,0,2,0,3
Fremantle,"Sutcliffe, Cam",9,7,2,2,0,0,0,5
Fremantle,"Walters, Michael",13,11,4,2,2,5,0,5
Fremantle,"de Boer, Matt",17,9,2,8,0,0,0,9
Fremantle,"Ballantyne, Hayden",12,11,4,1,1,0,0,1
Fremantle,"Crowley, Ryan",17,13,4,4,1,2,0,0
Fremantle,"Crozier, Hayden",13,8,3,5,0,1,0,3
Fremantle,"Duffield, Paul",11,7,3,4,2,0,0,1
Fremantle,"Hannath, Jack",10,9,4,1,0,1,13,2
Fremantle,"Hill, Stephen",24,17,3,7,0,0,0,3
Fremantle,"Ibbotson, Garrick",3,2,0,1,0,0,0,0
Fremantle,"Johnson, Michael",20,12,5,8,0,0,0,1
Fremantle,"Mayne, Chris",9,3,4,6,1,0,0,1
Fremantle,"McPharlin, Luke",14,11,8,3,0,0,0,1
Fremantle,"Mundy, David",20,13,1,7,0,1,1,6
Fremantle,"Mzungu, Tendai",13,8,1,5,0,1,0,3
Fremantle,"Neale, Lachie",19,8,2,11,0,1,0,2
Fremantle,"Pavlich, Matthew",16,10,5,6,4,1,0,1
Fremantle,"Pearce, Danyle",31,18,5,13,1,1,0,4
Fremantle,"Sandilands, Aaron",11,4,5,7,1,0,33,2
Fremantle,"Sheridan, Tom",9,3,2,6,0,0,0,1
Fremantle,"Spurr, Lee",8,5,3,3,0,0,0,1
Fremantle,"Suban, Nick",10,5,1,5,0,0,0,3
Fremantle,"Sutcliffe, Cam",13,7,1,6,0,0,0,3
Fremantle,"Walters, Michael",9,6,1,3,0,0,0,1
Fremantle,"de Boer, Matt",19,7,1,12,0,0,0,9
Fremantle,"Ballantyne, Hayden",21,14,3,7,1,1,0,0
Fremantle,"Clarke, Zac",19,10,11,9,1,1,17,0
Fremantle,"Crowley, Ryan",13,7,3,6,1,0,0,4
Fremantle,"Crozier, Hayden",12,8,3,4,0,1,0,2
Fremantle,"Dawson, Zac",8,2,2,6,0,0,0,1
Fremantle,"Duffield, Paul",24,15,4,9,0,0,0,4
Fremantle,"Hill, Stephen",22,16,2,6,2,0,1,2
Fremantle,"Johnson, Michael",27,19,9,8,0,0,0,2
Fremantle,"McPharlin, Luke",31,22,13,9,1,0,0,0
Fremantle,"Mundy, David",8,5,3,3,1,0,0,3
Fremantle,"Mzungu, Tendai",20,13,6,7,1,0,0,4
Fremantle,"Neale, Lachie",19,8,2,11,2,0,0,3
Fremantle,"Pavlich, Matthew",20,14,8,6,3,1,0,2
Fremantle,"Pearce, Clancee",22,9,7,13,0,0,0,0
Fremantle,"Pearce, Danyle",23,16,3,7,2,1,0,3
Fremantle,"Sandilands, Aaron",11,2,2,9,0,0,45,1
Fremantle,"Simpson, Josh",13,7,1,6,0,0,0,5
Fremantle,"Spurr, Lee",15,12,9,3,0,0,0,2
Fremantle,"Suban, Nick",15,12,3,3,1,0,0,5
Fremantle,"Sutcliffe, Cam",20,16,3,4,0,0,0,2
Fremantle,"Taberner, Matthew",6,4,2,2,2,0,0,4
Fremantle,"de Boer, Matt",23,6,5,17,0,0,0,8
Fremantle,"Ballantyne, Hayden",11,9,3,2,2,0,0,4
Fremantle,"Clarke, Zac",7,2,1,5,0,0,13,6
Fremantle,"Crowley, Ryan",9,4,4,5,0,0,1,4
Fremantle,"Dawson, Zac",16,3,3,13,0,0,0,2
Fremantle,"Duffield, Paul",16,9,4,7,0,0,0,2
Fremantle,"Fyfe, Nat",32,18,4,14,0,0,1,5
Fremantle,"Hill, Stephen",21,12,1,9,0,1,0,3
Fremantle,"Johnson, Michael",18,15,7,3,2,0,0,3
Fremantle,"Mayne, Chris",10,5,3,5,0,0,0,6
Fremantle,"McPharlin, Luke",16,13,8,3,0,0,0,1
Fremantle,"Mundy, David",31,21,5,10,1,1,2,3
Fremantle,"Mzungu, Tendai",17,11,4,6,1,0,0,2
Fremantle,"Neale, Lachie",27,14,6,13,0,1,0,4
Fremantle,"Pavlich, Matthew",22,13,9,9,4,1,0,2
Fremantle,"Pearce, Clancee",13,6,4,7,0,0,0,3
Fremantle,"Pearce, Danyle",21,13,6,8,0,0,0,1
Fremantle,"Sandilands, Aaron",11,5,1,6,0,0,48,1
Fremantle,"Spurr, Lee",17,10,6,7,0,0,0,3
Fremantle,"Suban, Nick",4,2,0,2,0,0,0,1
Fremantle,"Sutcliffe, Cam",15,9,2,6,0,0,0,5
Fremantle,"Taberner, Matthew",4,3,2,1,0,0,0,2
Fremantle,"de Boer, Matt",13,7,1,6,1,0,0,3
Fremantle,"Clarke, Zac",7,3,3,4,0,0,5,1
Fremantle,"Crowley, Ryan",15,7,3,8,0,0,1,0
Fremantle,"Crozier, Hayden",11,7,6,4,0,0,0,6
Fremantle,"Dawson, Zac",8,0,1,8,0,0,0,2
Fremantle,"Duffield, Paul",19,16,6,3,0,0,0,2
Fremantle,"Fyfe, Nat",33,22,4,11,2,0,0,3
Fremantle,"Hill, Stephen",19,14,2,5,0,1,0,4
Fremantle,"Johnson, Michael",27,17,11,10,0,1,0,2
Fremantle,"Mayne, Chris",15,5,5,10,1,0,0,1
Fremantle,"McPharlin, Luke",17,11,9,6,0,0,0,0
Fremantle,"Mundy, David",27,20,7,7,1,1,0,5
Fremantle,"Mzungu, Tendai",12,9,3,3,0,0,0,7
Fremantle,"Neale, Lachie",21,6,1,15,1,0,0,3
Fremantle,"Pavlich, Matthew",20,11,5,9,2,1,0,0
Fremantle,"Pearce, Clancee",20,9,4,11,0,1,0,3
Fremantle,"Pearce, Danyle",23,17,4,6,0,2,0,3
Fremantle,"Sandilands, Aaron",7,2,2,5,1,0,42,2
Fremantle,"Sheridan, Tom",3,2,2,1,0,0,0,0
Fremantle,"Spurr, Lee",19,12,3,7,0,0,0,1
Fremantle,"Suban, Nick",11,8,2,3,0,1,0,5
Fremantle,"Sutcliffe, Cam",20,13,7,7,0,1,0,4
Fremantle,"de Boer, Matt",6,2,1,4,0,0,0,6
Fremantle,"Ballantyne, Hayden",17,16,9,1,2,2,0,2
Fremantle,"Barlow, Michael",21,9,5,12,1,0,0,2
Fremantle,"Clarke, Zac",14,7,5,7,3,0,3,2
Fremantle,"Crowley, Ryan",11,9,6,2,1,0,0,5
Fremantle,"Crozier, Hayden",13,6,3,7,0,1,0,2
Fremantle,"Dawson, Zac",5,1,1,4,0,0,0,1
Fremantle,"Duffield, Paul",24,18,10,6,0,0,0,6
Fremantle,"Fyfe, Nat",26,11,6,15,1,1,0,5
Fremantle,"Johnson, Michael",22,15,8,7,0,0,0,1
Fremantle,"Mayne, Chris",15,7,4,8,1,0,0,6
Fremantle,"McPharlin, Luke",22,12,9,10,0,0,1,3
Fremantle,"Mundy, David",26,16,4,10,0,0,0,6
Fremantle,"Mzungu, Tendai",19,14,7,5,0,1,0,4
Fremantle,"Neale, Lachie",32,11,4,21,1,0,1,2
Fremantle,"Pavlich, Matthew",14,8,6,6,0,0,0,2
Fremantle,"Pearce, Clancee",15,11,9,4,0,1,0,2
Fremantle,"Pearce, Danyle",24,17,5,7,0,0,0,3
Fremantle,"Sandilands, Aaron",21,4,6,17,0,0,38,2
Fremantle,"Spurr, Lee",17,10,7,7,0,0,0,2
Fremantle,"Suban, Nick",12,6,2,6,0,0,0,0
Fremantle,"Sutcliffe, Cam",25,16,7,9,0,0,0,6
Fremantle,"de Boer, Matt",23,12,10,11,1,0,0,3
Fremantle,"Ballantyne, Hayden",9,7,1,2,0,1,0,5
Fremantle,"Barlow, Michael",23,10,3,13,0,0,1,5
Fremantle,"Clarke, Zac",10,5,4,5,3,1,9,1
Fremantle,"Crowley, Ryan",21,16,5,5,0,0,0,1
Fremantle,"Crozier, Hayden",12,4,3,8,0,0,0,4
Fremantle,"Duffield, Paul",13,8,2,5,0,0,0,5
Fremantle,"Fyfe, Nat",34,17,7,17,2,0,0,3
Fremantle,"Hill, Stephen",15,10,2,5,1,0,0,1
Fremantle,"Johnson, Michael",18,11,10,7,0,0,0,0
Fremantle,"Mayne, Chris",15,8,4,7,1,2,0,3
Fremantle,"Mundy, David",31,14,7,17,0,2,0,3
Fremantle,"Mzungu, Tendai",22,16,11,6,0,1,0,5
Fremantle,"Neale, Lachie",28,13,3,15,0,0,0,3
Fremantle,"Pavlich, Matthew",12,4,4,8,1,1,0,3
Fremantle,"Pearce, Clancee",9,3,1,6,0,0,0,3
Fremantle,"Pearce, Danyle",16,8,1,8,0,0,0,5
Fremantle,"Sandilands, Aaron",14,2,4,12,0,0,41,3
Fremantle,"Silvagni, Alex",12,10,4,2,0,0,0,3
Fremantle,"Spurr, Lee",9,6,4,3,0,0,0,3
Fremantle,"Suban, Nick",16,13,2,3,2,1,0,3
Fremantle,"Sutcliffe, Cam",19,9,3,10,0,0,0,7
Fremantle,"de Boer, Matt",21,10,7,11,1,0,0,4
Fremantle,"Ballantyne, Hayden",12,10,2,2,3,2,0,4
Fremantle,"Barlow, Michael",26,15,4,11,1,2,1,3
Fremantle,"Clarke, Zac",16,9,4,7,0,1,18,4
Fremantle,"Crowley, Ryan",18,10,3,8,0,0,0,3
Fremantle,"Dawson, Zac",7,1,1,6,0,0,0,5
Fremantle,"Duffield, Paul",13,12,3,1,1,0,0,3
Fremantle,"Fyfe, Nat",25,13,7,12,1,1,2,6
Fremantle,"Hill, Stephen",29,16,1,13,0,1,0,3
Fremantle,"Johnson, Michael",22,13,4,9,0,0,0,2
Fremantle,"Mayne, Chris",10,2,1,8,0,0,0,6
Fremantle,"Mundy, David",34,13,4,21,0,0,1,2
Fremantle,"Mzungu, Tendai",23,16,8,7,2,2,0,0
Fremantle,"Neale, Lachie",18,7,4,11,0,0,0,1
Fremantle,"Pavlich, Matthew",16,11,6,5,3,3,0,0
Fremantle,"Pearce, Danyle",21,12,1,9,1,1,0,0
Fremantle,"Sandilands, Aaron",16,2,4,14,0,1,26,5
Fremantle,"Sheridan, Tom",14,5,3,9,1,0,0,3
Fremantle,"Silvagni, Alex",8,4,4,4,0,0,0,2
Fremantle,"Spurr, Lee",18,13,5,5,0,0,0,2
Fremantle,"Suban, Nick",19,10,1,9,0,1,0,2
Fremantle,"Sutcliffe, Cam",18,12,7,6,0,0,0,1
Fremantle,"de Boer, Matt",13,4,2,9,0,0,0,1
Fremantle,"Ballantyne, Hayden",12,10,4,2,3,1,0,1
Fremantle,"Barlow, Michael",28,13,10,15,0,2,0,8
Fremantle,"Clarke, Zac",14,9,7,5,0,2,10,4
Fremantle,"Crowley, Ryan",17,12,3,5,1,0,1,0
Fremantle,"Dawson, Zac",11,2,3,9,0,0,1,1
Fremantle,"Duffield, Paul",21,11,4,10,1,0,0,8
Fremantle,"Fyfe, Nat",14,5,2,9,0,1,1,6
Fremantle,"Hill, Stephen",24,20,4,4,4,0,0,5
Fremantle,"Ibbotson, Garrick",11,8,2,3,0,0,1,1
Fremantle,"Johnson, Michael",21,13,6,8,0,0,0,2
Fremantle,"Mayne, Chris",10,3,3,7,0,1,0,5
Fremantle,"McPharlin, Luke",18,11,9,7,0,0,0,1
Fremantle,"Mundy, David",17,6,2,11,0,0,2,7
Fremantle,"Mzungu, Tendai",22,12,4,10,0,0,0,3
Fremantle,"Neale, Lachie",26,7,3,19,0,1,0,3
Fremantle,"Pavlich, Matthew",12,10,8,2,2,0,0,0
Fremantle,"Pearce, Danyle",20,13,4,7,0,3,0,2
Fremantle,"Sandilands, Aaron",13,2,3,11,1,0,39,3
Fremantle,"Sheridan, Tom",9,3,0,6,0,0,0,5
Fremantle,"Spurr, Lee",14,6,3,8,0,0,0,1
Fremantle,"Suban, Nick",14,6,1,8,1,0,0,6
Fremantle,"Sutcliffe, Cam",14,8,3,6,0,0,0,2
Fremantle,"Ballantyne, Hayden",10,7,4,3,1,1,0,2
Fremantle,"Barlow, Michael",30,11,7,19,0,0,1,4
Fremantle,"Clarke, Zac",10,7,7,3,0,2,5,3
Fremantle,"Crowley, Ryan",16,10,5,6,0,1,0,7
Fremantle,"Dawson, Zac",15,3,6,12,1,0,0,0
Fremantle,"Duffield, Paul",27,23,5,4,1,1,0,3
Fremantle,"Fyfe, Nat",23,11,5,12,2,1,0,3
Fremantle,"Hill, Stephen",27,15,5,12,0,1,0,1
Fremantle,"Ibbotson, Garrick",23,12,6,11,0,0,0,3
Fremantle,"Johnson, Michael",13,7,5,6,0,0,0,2
Fremantle,"Mayne, Chris",17,5,5,12,1,1,0,3
Fremantle,"McPharlin, Luke",21,9,7,12,0,0,0,0
Fremantle,"Mundy, David",32,13,2,19,0,1,0,4
Fremantle,"Mzungu, Tendai",17,9,6,8,0,2,0,4
Fremantle,"Neale, Lachie",21,12,4,9,0,0,0,1
Fremantle,"Pavlich, Matthew",17,13,12,4,3,3,0,2
Fremantle,"Pearce, Danyle",21,12,3,9,1,0,0,5
Fremantle,"Sandilands, Aaron",20,7,8,13,0,1,38,3
Fremantle,"Sheridan, Tom",11,4,3,7,1,0,0,1
Fremantle,"Spurr, Lee",32,16,4,16,0,0,0,3
Fremantle,"Suban, Nick",18,11,3,7,1,0,0,3
Fremantle,"Sutcliffe, Cam",22,13,3,9,0,1,0,2
Fremantle,"Ballantyne, Hayden",11,11,6,0,6,1,0,3
Fremantle,"Barlow, Michael",23,14,7,9,2,1,1,5
Fremantle,"Clarke, Zac",10,6,2,4,1,0,10,5
Fremantle,"Crowley, Ryan",15,10,5,5,0,0,0,3
Fremantle,"Dawson, Zac",9,2,1,7,0,0,0,0
Fremantle,"Duffield, Paul",16,9,3,7,0,0,0,5
Fremantle,"Fyfe, Nat",33,15,4,18,1,1,1,3
Fremantle,"Hill, Stephen",24,13,1,11,0,0,0,0
Fremantle,"Ibbotson, Garrick",13,6,2,7,0,0,0,1
Fremantle,"Mayne, Chris",13,4,3,9,0,1,0,2
Fremantle,"Mundy, David",24,12,4,12,1,0,1,4
Fremantle,"Mzungu, Tendai",8,3,1,5,0,0,0,1
Fremantle,"Neale, Lachie",16,5,5,11,0,0,0,2
Fremantle,"Pavlich, Matthew",13,8,5,5,3,0,0,0
Fremantle,"Pearce, Danyle",5,3,0,2,1,0,0,2
Fremantle,"Sandilands, Aaron",8,2,4,6,0,0,45,2
Fremantle,"Sheridan, Tom",13,8,0,5,0,1,0,3
Fremantle,"Silvagni, Alex",9,6,1,3,0,0,0,0
Fremantle,"Spurr, Lee",20,13,6,7,1,0,0,2
Fremantle,"Suban, Nick",12,8,6,4,0,0,0,3
Fremantle,"Sutcliffe, Cam",14,6,0,8,0,1,0,4
Fremantle,"Sylvia, Colin",3,1,1,2,0,0,0,1
Fremantle,"Ballantyne, Hayden",14,9,5,5,5,2,0,3
Fremantle,"Barlow, Michael",26,14,3,12,2,1,0,4
Fremantle,"Clarke, Zac",18,11,5,7,0,0,18,3
Fremantle,"Crowley, Ryan",24,11,4,13,1,1,0,1
Fremantle,"Dawson, Zac",6,2,1,4,0,0,2,0
Fremantle,"Duffield, Paul",19,14,5,5,0,0,0,1
Fremantle,"Fyfe, Nat",29,19,1,10,0,1,1,6
Fremantle,"Hill, Stephen",16,11,1,5,0,0,1,10
Fremantle,"Ibbotson, Garrick",12,10,6,2,0,1,0,3
Fremantle,"Mayne, Chris",19,7,7,12,1,1,0,6
Fremantle,"Mundy, David",26,21,2,5,0,1,0,9
Fremantle,"Mzungu, Tendai",18,9,0,9,0,0,1,6
Fremantle,"Neale, Lachie",34,9,6,25,0,0,0,7
Fremantle,"Pavlich, Matthew",11,9,2,2,3,2,0,3
Fremantle,"Pearce, Clancee",8,2,1,6,0,0,0,0
Fremantle,"Pearce, Danyle",25,16,1,9,1,0,0,5
Fremantle,"Sandilands, Aaron",13,3,2,10,1,0,41,2
Fremantle,"Silvagni, Alex",10,9,6,1,0,0,2,2
Fremantle,"Spurr, Lee",8,3,2,5,0,0,0,5
Fremantle,"Suban, Nick",17,9,2,8,1,0,0,8
Fremantle,"Sutcliffe, Cam",13,8,3,5,0,0,0,2
Fremantle,"Sylvia, Colin",17,6,1,11,0,1,0,5
Fremantle,"Ballantyne, Hayden",12,10,4,2,3,0,0,3
Fremantle,"Barlow, Michael",25,11,3,14,0,0,2,6
Fremantle,"Clarke, Zac",10,5,4,5,0,2,6,3
Fremantle,"Crowley, Ryan",13,9,5,4,0,0,0,3
Fremantle,"Dawson, Zac",13,5,5,8,0,0,2,1
Fremantle,"Duffield, Paul",30,18,9,12,0,1,0,2
Fremantle,"Fyfe, Nat",31,15,4,16,1,0,4,7
Fremantle,"Hill, Stephen",32,26,5,6,3,1,0,5
Fremantle,"Ibbotson, Garrick",19,11,7,8,0,0,0,2
Fremantle,"Mayne, Chris",17,6,6,11,1,0,0,4
Fremantle,"Mundy, David",24,13,4,11,0,0,2,5
Fremantle,"Mzungu, Tendai",15,8,4,7,0,1,1,3
Fremantle,"Neale, Lachie",20,10,4,10,1,2,0,5
Fremantle,"Pavlich, Matthew",11,5,3,6,1,0,0,0
Fremantle,"Pearce, Clancee",3,2,2,1,0,0,0,1
Fremantle,"Pearce, Danyle",25,18,5,7,1,2,0,2
Fremantle,"Sandilands, Aaron",14,3,4,11,0,0,35,0
Fremantle,"Spurr, Lee",20,14,7,6,0,0,0,0
Fremantle,"Suban, Nick",19,11,5,8,1,1,0,7
Fremantle,"Sutcliffe, Cam",12,10,8,2,0,0,0,3
Fremantle,"Sylvia, Colin",8,4,3,4,1,0,0,1
Fremantle,"Taberner, Matthew",13,12,7,1,0,0,1,5
Fremantle,"Apeness, Michael",5,2,2,3,0,1,0,3
Fremantle,"Ballantyne, Hayden",11,8,3,3,3,1,0,4
Fremantle,"Barlow, Michael",29,15,7,14,1,0,0,9
Fremantle,"Clarke, Zac",15,7,3,8,2,0,15,5
Fremantle,"Crowley, Ryan",16,6,2,10,0,0,1,3
Fremantle,"Dawson, Zac",14,7,7,7,0,0,1,0
Fremantle,"Duffield, Paul",20,13,6,7,0,0,0,5
Fremantle,"Fyfe, Nat",29,12,3,17,0,1,3,3
Fremantle,"Ibbotson, Garrick",22,15,10,7,0,0,1,1
Fremantle,"Mayne, Chris",11,5,1,6,1,0,0,2
Fremantle,"McPharlin, Luke",17,11,8,6,0,0,0,0
Fremantle,"Morabito, Anthony",8,5,0,3,0,1,0,2
Fremantle,"Mundy, David",22,13,4,9,0,0,2,3
Fremantle,"Mzungu, Tendai",20,14,4,6,2,0,0,3
Fremantle,"Neale, Lachie",30,18,3,12,1,0,0,8
Fremantle,"Pearce, Clancee",22,8,3,14,0,0,0,3
Fremantle,"Pearce, Danyle",18,13,2,5,2,1,0,6
Fremantle,"Sandilands, Aaron",11,5,5,6,1,0,24,0
Fremantle,"Spurr, Lee",24,15,8,9,0,0,0,0
Fremantle,"Suban, Nick",21,18,6,3,1,0,0,7
Fremantle,"Sutcliffe, Cam",15,13,6,2,1,1,0,3
Fremantle,"Sylvia, Colin",12,5,2,7,0,1,0,3
Fremantle,"Apeness, Michael",9,2,3,7,0,0,0,4
Fremantle,"Ballantyne, Hayden",13,12,7,1,5,3,0,1
Fremantle,"Barlow, Michael",23,14,6,9,1,0,0,1
Fremantle,"Clarke, Zac",16,7,4,9,1,0,23,3
Fremantle,"Crowley, Ryan",9,4,1,5,0,0,0,1
Fremantle,"Dawson, Zac",8,2,6,6,0,0,0,0
Fremantle,"Duffield, Paul",15,9,7,6,0,0,0,6
Fremantle,"Fyfe, Nat",29,17,5,12,2,0,1,1
Fremantle,"Johnson, Michael",19,13,10,6,0,1,0,1
Fremantle,"Mayne, Chris",18,8,6,10,1,1,0,4
Fremantle,"Morabito, Anthony",15,7,1,8,0,0,0,0
Fremantle,"Mundy, David",25,14,4,11,0,0,0,5
Fremantle,"Mzungu, Tendai",26,20,11,6,0,0,0,2
Fremantle,"Neale, Lachie",24,11,5,13,1,0,0,3
Fremantle,"Pavlich, Matthew",20,12,6,8,3,1,0,2
Fremantle,"Pearce, Clancee",10,6,2,4,0,0,0,1
Fremantle,"Pearce, Danyle",16,13,1,3,2,1,0,6
Fremantle,"Sandilands, Aaron",9,4,3,5,1,0,30,2
Fremantle,"Spurr, Lee",22,14,9,8,1,0,0,5
Fremantle,"Suban, Nick",13,9,0,4,3,0,1,1
Fremantle,"Sutcliffe, Cam",22,16,5,6,0,1,0,2
Fremantle,"Sylvia, Colin",9,3,2,6,0,1,0,1
Fremantle,"Barlow, Michael",24,9,6,15,1,0,0,4
Fremantle,"Clarke, Zac",11,5,4,6,0,0,23,2
Fremantle,"Crowley, Ryan",14,9,3,5,0,0,4,4
Fremantle,"Dawson, Zac",7,2,3,5,0,0,1,1
Fremantle,"Duffield, Paul",21,14,5,7,0,0,0,9
Fremantle,"Fyfe, Nat",18,10,6,8,2,0,3,5
Fremantle,"Griffin, Jonathon",3,3,1,0,0,0,7,1
Fremantle,"Johnson, Michael",18,13,3,5,0,0,0,1
Fremantle,"Mayne, Chris",15,9,6,6,1,0,0,7
Fremantle,"McPharlin, Luke",10,5,4,5,0,0,0,1
Fremantle,"Morabito, Anthony",4,3,1,1,1,0,0,2
Fremantle,"Mundy, David",15,9,1,6,0,0,0,4
Fremantle,"Mzungu, Tendai",20,13,5,7,0,0,1,3
Fremantle,"Neale, Lachie",13,7,2,6,0,0,0,5
Fremantle,"Pavlich, Matthew",10,7,6,3,2,0,0,0
Fremantle,"Pearce, Danyle",17,14,1,3,1,1,0,8
Fremantle,"Spurr, Lee",9,9,6,0,0,0,0,4
Fremantle,"Suban, Nick",15,9,2,6,0,0,0,2
Fremantle,"Sutcliffe, Cam",10,6,3,4,0,0,0,6
Fremantle,"Sylvia, Colin",7,3,1,4,0,0,0,2
Fremantle,"Taberner, Matthew",11,7,4,4,1,1,0,2
Fremantle,"de Boer, Matt",10,4,2,6,0,0,0,4
Fremantle,"Ballantyne, Hayden",8,7,4,1,3,1,0,3
Fremantle,"Barlow, Michael",24,16,10,8,2,1,3,4
Fremantle,"Clarke, Zac",13,9,9,4,0,0,21,1
Fremantle,"Crowley, Ryan",11,6,1,5,1,1,0,3
Fremantle,"Dawson, Zac",12,4,6,8,0,0,0,1
Fremantle,"Duffield, Paul",17,12,7,5,0,0,0,6
Fremantle,"Fyfe, Nat",28,16,4,12,2,0,3,2
Fremantle,"Hill, Stephen",14,11,3,3,1,0,0,4
Fremantle,"Ibbotson, Garrick",12,9,6,3,0,1,1,2
Fremantle,"Johnson, Michael",17,15,3,2,0,0,0,1
Fremantle,"Mayne, Chris",12,4,7,8,0,0,0,2
Fremantle,"McPharlin, Luke",17,8,7,9,0,0,0,3
Fremantle,"Mundy, David",19,12,4,7,1,1,0,4
Fremantle,"Mzungu, Tendai",9,3,2,6,0,0,0,1
Fremantle,"Neale, Lachie",16,10,5,6,1,0,0,5
Fremantle,"Pavlich, Matthew",4,2,1,2,0,0,0,0
Fremantle,"Pearce, Danyle",13,10,2,3,0,2,0,4
Fremantle,"Sandilands, Aaron",15,4,2,11,0,0,46,2
Fremantle,"Spurr, Lee",17,12,3,5,1,0,1,3
Fremantle,"Suban, Nick",15,9,2,6,0,1,0,7
Fremantle,"Sutcliffe, Cam",9,6,3,3,0,0,0,3
Fremantle,"de Boer, Matt",9,5,3,4,0,1,0,2
Fremantle,"Ballantyne, Hayden",10,7,3,3,1,2,0,0
Fremantle,"Barlow, Michael",33,20,6,13,1,0,2,6
Fremantle,"Clarke, Zac",13,5,2,8,0,1,8,1
Fremantle,"Crowley, Ryan",10,4,0,6,0,0,0,6
Fremantle,"Crozier, Hayden",13,9,2,4,3,0,0,3
Fremantle,"Dawson, Zac",6,2,3,4,0,0,1,0
Fremantle,"Duffield, Paul",23,12,6,11,0,0,0,9
Fremantle,"Duffy, Max",8,5,0,3,2,1,0,0
Fremantle,"Fyfe, Nat",25,12,4,13,2,0,1,8
Fremantle,"Hill, Stephen",21,17,3,4,1,1,0,2
Fremantle,"Johnson, Michael",13,7,3,6,0,0,2,0
Fremantle,"Mayne, Chris",16,7,7,9,0,0,0,3
Fremantle,"McPharlin, Luke",5,3,3,2,0,0,0,0
Fremantle,"Mundy, David",27,18,5,9,0,2,2,3
Fremantle,"Neale, Lachie",21,7,3,14,0,0,0,1
Fremantle,"Pavlich, Matthew",12,6,4,6,0,1,1,2
Fremantle,"Pearce, Danyle",17,12,2,5,0,1,0,2
Fremantle,"Sandilands, Aaron",15,4,4,11,0,1,33,1
Fremantle,"Spurr, Lee",25,12,2,13,0,0,0,1
Fremantle,"Suban, Nick",11,5,0,6,0,0,0,4
Fremantle,"Sutcliffe, Cam",16,13,5,3,1,0,0,4
Fremantle,"de Boer, Matt",16,6,2,10,0,0,0,7
Fremantle,"Barlow, Michael",31,15,7,16,1,1,1,5
Fremantle,"Clarke, Zac",13,5,4,8,0,0,15,3
Fremantle,"Crowley, Ryan",20,7,3,13,0,0,0,0
Fremantle,"Crozier, Hayden",9,7,2,2,2,2,0,4
Fremantle,"Dawson, Zac",12,4,5,8,0,0,1,1
Fremantle,"Duffield, Paul",15,4,1,11,0,0,0,3
Fremantle,"Duffy, Max",2,2,2,0,0,0,0,0
Fremantle,"Fyfe, Nat",24,6,1,18,2,0,1,8
Fremantle,"Hill, Stephen",23,16,1,7,3,1,0,3
Fremantle,"Johnson, Michael",29,18,8,11,0,0,0,1
Fremantle,"Mayne, Chris",13,3,6,10,0,0,0,6
Fremantle,"Mundy, David",33,21,3,12,0,0,1,6
Fremantle,"Mzungu, Tendai",21,10,2,11,0,0,0,3
Fremantle,"Neale, Lachie",27,10,6,17,0,0,0,4
Fremantle,"Pavlich, Matthew",21,15,8,6,5,1,1,2
Fremantle,"Pearce, Danyle",18,11,0,7,1,0,0,4
Fremantle,"Sandilands, Aaron",10,2,2,8,1,0,29,0
Fremantle,"Silvagni, Alex",19,14,7,5,0,0,0,1
Fremantle,"Spurr, Lee",21,14,6,7,0,0,0,0
Fremantle,"Sutcliffe, Cam",20,12,6,8,0,0,0,3
Fremantle,"Taberner, Matthew",15,7,6,8,1,0,0,1
Fremantle,"Walters, Michael",15,10,5,5,1,0,0,1
Fremantle,"Ballantyne, Hayden",19,15,10,4,3,4,0,3
Fremantle,"Clarke, Zac",16,8,3,8,1,0,6,2
Fremantle,"Crowley, Ryan",14,6,2,8,0,0,0,2
Fremantle,"Crozier, Hayden",17,11,4,6,1,0,0,5
Fremantle,"Dawson, Zac",8,1,4,7,0,0,1,0
Fremantle,"Duffield, Paul",16,9,4,7,0,0,0,2
Fremantle,"Hill, Stephen",26,19,4,7,1,1,0,3
Fremantle,"Ibbotson, Garrick",9,6,6,3,0,0,0,1
Fremantle,"Johnson, Michael",15,13,6,2,0,0,0,1
Fremantle,"Mayne, Chris",16,6,7,10,1,0,0,4
Fremantle,"Mundy, David",24,7,3,17,2,1,2,2
Fremantle,"Mzungu, Tendai",22,13,6,9,0,1,0,7
Fremantle,"Neale, Lachie",26,20,7,6,0,2,0,3
Fremantle,"Pearce, Danyle",20,16,2,4,1,1,0,1
Fremantle,"Sandilands, Aaron",11,1,2,10,0,0,31,1
Fremantle,"Silvagni, Alex",7,6,5,1,0,0,0,3
Fremantle,"Spurr, Lee",12,7,3,5,0,0,0,1
Fremantle,"Suban, Nick",13,7,2,6,0,1,0,9
Fremantle,"Sutcliffe, Cam",11,8,3,3,0,0,0,3
Fremantle,"Taberner, Matthew",22,14,10,8,1,2,0,4
Fremantle,"Walters, Michael",16,14,5,2,3,2,0,2
Fremantle,"de Boer, Matt",18,6,4,12,1,0,1,8
Fremantle,"Ballantyne, Hayden",11,8,4,3,4,1,0,6
Fremantle,"Barlow, Michael",27,10,2,17,0,0,1,4
Fremantle,"Clarke, Zac",7,3,3,4,0,0,17,3
Fremantle,"Crowley, Ryan",15,11,4,4,0,0,0,5
Fremantle,"Crozier, Hayden",3,3,0,0,0,1,0,3
Fremantle,"Dawson, Zac",18,3,7,15,0,0,1,1
Fremantle,"Duffield, Paul",18,12,5,6,0,0,0,1
Fremantle,"Hill, Stephen",14,9,3,5,0,0,0,2
Fremantle,"Ibbotson, Garrick",17,9,6,8,0,0,0,3
Fremantle,"Johnson, Michael",13,8,1,5,0,0,0,0
Fremantle,"Mayne, Chris",13,4,8,9,2,0,0,3
Fremantle,"Mundy, David",19,13,3,6,1,0,0,8
Fremantle,"Mzungu, Tendai",22,12,6,10,1,0,1,1
Fremantle,"Neale, Lachie",34,14,7,20,0,1,0,5
Fremantle,"Pavlich, Matthew",18,12,4,6,2,1,0,2
Fremantle,"Pearce, Danyle",19,12,2,7,0,0,0,3
Fremantle,"Sandilands, Aaron",11,4,5,7,0,2,37,0
Fremantle,"Spurr, Lee",22,13,8,9,0,0,0,2
Fremantle,"Suban, Nick",9,6,0,3,0,0,0,1
Fremantle,"Sutcliffe, Cam",21,12,6,9,1,0,0,2
Fremantle,"Taberner, Matthew",14,9,7,5,2,1,0,1
Fremantle,"Walters, Michael",14,12,5,2,3,0,0,2
Fremantle,"Ballantyne, Hayden",7,7,3,0,0,1,0,6
Fremantle,"Barlow, Michael",28,16,3,12,0,0,0,9
Fremantle,"Clarke, Zac",10,5,5,5,0,0,6,5
Fremantle,"Crowley, Ryan",14,9,4,5,0,0,0,1
Fremantle,"Crozier, Hayden",5,3,1,2,0,0,0,1
Fremantle,"Dawson, Zac",10,4,6,6,0,0,3,2
Fremantle,"Duffield, Paul",22,19,9,3,0,1,0,5
Fremantle,"Fyfe, Nat",29,14,6,15,1,0,2,3
Fremantle,"Hill, Stephen",16,12,3,4,0,0,0,1
Fremantle,"Ibbotson, Garrick",22,10,5,12,0,0,0,3
Fremantle,"Mayne, Chris",11,5,5,6,0,1,0,3
Fremantle,"Mundy, David",25,13,2,12,1,0,1,7
Fremantle,"Mzungu, Tendai",21,20,5,1,2,0,2,2
Fremantle,"Neale, Lachie",31,15,5,16,0,1,0,3
Fremantle,"Pavlich, Matthew",19,12,3,7,4,1,0,0
Fremantle,"Pearce, Danyle",8,5,1,3,0,0,0,0
Fremantle,"Sandilands, Aaron",13,5,4,8,0,1,42,0
Fremantle,"Silvagni, Alex",5,2,2,3,0,0,0,8
Fremantle,"Spurr, Lee",24,13,5,11,0,0,0,1
Fremantle,"Sutcliffe, Cam",14,8,2,6,1,0,0,6
Fremantle,"Taberner, Matthew",5,3,1,2,0,1,0,3
Fremantle,"Walters, Michael",12,5,1,7,1,1,0,3
Fremantle,"Barlow, Michael",23,12,8,11,2,0,0,5
Fremantle,"Clarke, Zac",9,4,2,5,0,0,4,0
Fremantle,"Crowley, Ryan",11,4,2,7,0,0,0,3
Fremantle,"Crozier, Hayden",13,11,6,2,2,0,0,3
Fremantle,"Dawson, Zac",6,3,1,3,0,0,0,5
Fremantle,"Duffield, Paul",13,10,1,3,0,0,0,3
Fremantle,"Fyfe, Nat",28,7,1,21,2,1,1,11
Fremantle,"Hill, Stephen",28,20,5,8,0,2,0,0
Fremantle,"Ibbotson, Garrick",14,10,8,4,0,1,2,1
Fremantle,"Mayne, Chris",9,4,5,5,0,1,0,2
Fremantle,"Mundy, David",24,16,3,8,0,1,2,3
Fremantle,"Mzungu, Tendai",13,9,4,4,0,0,0,1
Fremantle,"Neale, Lachie",32,18,3,14,0,1,0,1
Fremantle,"Pavlich, Matthew",12,5,8,7,0,3,0,2
Fremantle,"Pearce, Danyle",20,15,1,5,1,0,0,3
Fremantle,"Sandilands, Aaron",9,2,5,7,1,0,50,3
Fremantle,"Spurr, Lee",12,8,5,4,0,0,0,1
Fremantle,"Suban, Nick",10,6,1,4,0,1,0,1
Fremantle,"Sutcliffe, Cam",19,13,5,6,0,0,0,2
Fremantle,"Taberner, Matthew",2,2,1,0,0,1,0,3
Fremantle,"Walters, Michael",12,12,6,0,3,3,0,1
Fremantle,"de Boer, Matt",13,9,0,4,0,1,0,4
Gold Coast,"Ablett, Gary",41,22,4,19,2,0,0,3
Gold Coast,"Broughton, Greg",24,9,9,15,0,0,0,2
Gold Coast,"Cameron, Clay",7,5,1,2,0,0,0,4
Gold Coast,"Day, Sam",9,7,5,2,2,1,7,2
Gold Coast,"Dixon, Charlie",5,1,1,4,0,0,0,2
Gold Coast,"Hall, Aaron",16,7,2,9,0,0,0,1
Gold Coast,"Harbrow, Jarrod",22,16,8,6,0,1,0,5
Gold Coast,"Lemmens, Sean",12,10,1,2,0,0,0,2
Gold Coast,"Lynch, Tom",12,7,4,5,2,1,0,1
Gold Coast,"Martin, Jack",3,0,0,3,0,0,0,0
Gold Coast,"Matera, Brandon",16,7,3,9,1,0,0,6
Gold Coast,"May, Steven",16,15,5,1,0,0,0,1
Gold Coast,"McKenzie, Trent",13,12,3,1,0,0,0,1
Gold Coast,"Nicholls, Tom",11,1,1,10,0,0,24,2
Gold Coast,"OMeara, Jaeger",22,12,5,10,1,0,0,10
Gold Coast,"Prestia, Dion",32,16,7,16,1,1,0,4
Gold Coast,"Rischitelli, Michael",28,13,2,15,0,1,0,5
Gold Coast,"Shaw, Matt",16,9,5,7,0,1,0,1
Gold Coast,"Stanley, Danny",19,6,2,13,2,0,0,1
Gold Coast,"Sumner, Timmy",14,9,1,5,0,3,0,2
Gold Coast,"Swallow, David",27,17,9,10,1,4,0,2
Gold Coast,"Warnock, Matthew",9,4,2,5,0,0,0,1
Gold Coast,"Ablett, Gary",24,10,0,14,0,0,0,6
Gold Coast,"Broughton, Greg",10,8,2,2,0,0,0,3
Gold Coast,"Cameron, Clay",11,6,0,5,0,0,0,3
Gold Coast,"Day, Sam",12,7,4,5,2,0,5,0
Gold Coast,"Dixon, Charlie",8,5,4,3,0,2,4,1
Gold Coast,"Hall, Aaron",15,6,1,9,1,0,0,4
Gold Coast,"Harbrow, Jarrod",19,13,1,6,0,1,0,5
Gold Coast,"Kolodjashnij, Kade",19,10,2,9,0,0,0,4
Gold Coast,"Lemmens, Sean",13,10,1,3,0,0,0,2
Gold Coast,"Lynch, Tom",11,5,2,6,1,0,0,2
Gold Coast,"Matera, Brandon",7,6,1,1,1,3,0,7
Gold Coast,"May, Steven",14,13,5,1,0,0,0,7
Gold Coast,"McKenzie, Trent",19,16,6,3,0,0,0,5
Gold Coast,"Nicholls, Tom",14,7,2,7,0,0,10,6
Gold Coast,"OMeara, Jaeger",13,10,3,3,0,0,0,8
Gold Coast,"Prestia, Dion",22,12,4,10,0,1,0,4
Gold Coast,"Rischitelli, Michael",21,11,3,10,0,1,0,7
Gold Coast,"Shaw, Matt",8,2,1,6,0,0,0,2
Gold Coast,"Stanley, Danny",16,7,2,9,0,0,0,5
Gold Coast,"Sumner, Timmy",3,0,0,3,0,0,0,3
Gold Coast,"Swallow, David",27,15,1,12,0,0,0,4
Gold Coast,"Thompson, Rory",6,4,0,2,0,0,0,4
Gold Coast,"Ablett, Gary",38,20,1,18,3,0,0,10
Gold Coast,"Broughton, Greg",16,8,3,8,0,0,0,2
Gold Coast,"Cameron, Clay",10,6,5,4,0,0,1,0
Gold Coast,"Day, Sam",13,7,4,6,4,0,7,4
Gold Coast,"Hall, Aaron",14,5,0,9,0,0,0,6
Gold Coast,"Harbrow, Jarrod",18,14,2,4,1,0,0,6
Gold Coast,"Kolodjashnij, Kade",24,10,4,14,1,0,0,0
Gold Coast,"Lemmens, Sean",16,10,2,6,1,0,0,2
Gold Coast,"Lynch, Tom",14,8,7,6,1,0,0,3
Gold Coast,"Matera, Brandon",15,8,2,7,2,1,0,2
Gold Coast,"May, Steven",18,14,5,4,0,0,0,2
Gold Coast,"McKenzie, Trent",22,15,7,7,0,0,0,2
Gold Coast,"Nicholls, Tom",10,4,1,6,0,0,32,4
Gold Coast,"OMeara, Jaeger",24,14,2,10,1,1,0,7
Gold Coast,"Prestia, Dion",32,15,0,17,0,1,0,5
Gold Coast,"Rischitelli, Michael",24,10,4,14,0,1,0,3
Gold Coast,"Russell, Luke",9,6,3,3,0,1,0,0
Gold Coast,"Shaw, Matt",8,5,3,3,1,0,0,1
Gold Coast,"Stanley, Danny",18,8,4,10,0,0,0,3
Gold Coast,"Swallow, David",26,16,2,10,2,2,1,3
Gold Coast,"Thompson, Rory",6,4,3,2,0,0,2,1
Gold Coast,"Warnock, Matthew",12,5,3,7,0,0,1,0
Gold Coast,"Ablett, Gary",35,18,1,17,1,0,0,8
Gold Coast,"Broughton, Greg",17,6,2,11,0,1,0,5
Gold Coast,"Cameron, Clay",4,4,1,0,0,0,0,3
Gold Coast,"Day, Sam",9,5,2,4,0,0,4,2
Gold Coast,"Hall, Aaron",17,7,4,10,1,0,0,2
Gold Coast,"Harbrow, Jarrod",21,14,4,7,0,1,0,2
Gold Coast,"Hutchins, Jack",5,4,1,1,0,0,1,1
Gold Coast,"Kolodjashnij, Kade",17,10,5,7,0,0,0,2
Gold Coast,"Lemmens, Sean",9,5,2,4,0,0,0,4
Gold Coast,"Lynch, Tom",11,7,4,4,1,0,0,1
Gold Coast,"May, Steven",11,8,3,3,0,0,1,3
Gold Coast,"McKenzie, Trent",23,14,4,9,0,0,0,1
Gold Coast,"Nicholls, Tom",12,4,3,8,0,0,23,2
Gold Coast,"OMeara, Jaeger",20,13,4,7,1,0,0,4
Gold Coast,"Prestia, Dion",27,15,4,12,0,0,0,2
Gold Coast,"Rischitelli, Michael",16,10,2,6,1,0,0,1
Gold Coast,"Russell, Luke",5,2,1,3,0,0,0,1
Gold Coast,"Shaw, Matt",18,11,4,7,1,0,0,1
Gold Coast,"Stanley, Danny",17,8,5,9,0,1,0,2
Gold Coast,"Swallow, David",27,18,3,9,1,1,1,8
Gold Coast,"Thompson, Rory",5,1,0,4,0,0,4,5
Gold Coast,"Warnock, Matthew",14,6,3,8,0,1,0,1
Gold Coast,"Ablett, Gary",32,21,4,11,2,1,0,2
Gold Coast,"Broughton, Greg",25,10,9,15,1,0,0,2
Gold Coast,"Day, Sam",10,9,7,1,1,2,2,1
Gold Coast,"Hall, Aaron",10,5,2,5,1,1,0,3
Gold Coast,"Harbrow, Jarrod",14,6,1,8,0,1,0,6
Gold Coast,"Hutchins, Jack",4,3,2,1,0,0,0,0
Gold Coast,"Kolodjashnij, Kade",19,12,8,7,0,0,0,1
Gold Coast,"Lemmens, Sean",14,9,4,5,0,0,0,1
Gold Coast,"Lynch, Tom",10,8,6,2,2,2,0,1
Gold Coast,"Matera, Brandon",10,8,2,2,2,3,0,5
Gold Coast,"May, Steven",13,11,4,2,0,1,0,3
Gold Coast,"McKenzie, Trent",17,14,4,3,0,0,0,5
Gold Coast,"Nicholls, Tom",10,5,2,5,0,0,28,6
Gold Coast,"OMeara, Jaeger",18,10,2,8,0,1,0,3
Gold Coast,"Prestia, Dion",22,12,4,10,0,1,0,4
Gold Coast,"Rischitelli, Michael",25,15,6,10,0,0,0,2
Gold Coast,"Russell, Luke",7,5,3,2,0,0,1,6
Gold Coast,"Shaw, Matt",18,11,7,7,0,0,0,1
Gold Coast,"Stanley, Danny",17,8,4,9,0,1,0,4
Gold Coast,"Swallow, David",18,9,5,9,2,2,1,3
Gold Coast,"Thompson, Rory",13,8,4,5,0,0,4,2
Gold Coast,"Warnock, Matthew",12,8,7,4,0,0,0,1
Gold Coast,"Ablett, Gary",30,13,0,17,2,0,0,11
Gold Coast,"Broughton, Greg",20,8,4,12,1,0,0,2
Gold Coast,"Day, Sam",13,8,5,5,1,0,4,1
Gold Coast,"Hall, Aaron",14,10,3,4,2,2,0,4
Gold Coast,"Harbrow, Jarrod",19,14,6,5,0,0,0,4
Gold Coast,"Hutchins, Jack",8,4,2,4,0,0,0,1
Gold Coast,"Kolodjashnij, Kade",20,17,6,3,0,0,0,2
Gold Coast,"Lemmens, Sean",13,9,5,4,0,0,0,3
Gold Coast,"Lynch, Tom",17,12,8,5,5,1,0,3
Gold Coast,"Matera, Brandon",14,11,5,3,2,2,0,2
Gold Coast,"May, Steven",15,11,3,4,0,0,0,1
Gold Coast,"McKenzie, Trent",16,13,7,3,0,0,0,3
Gold Coast,"OMeara, Jaeger",30,14,1,16,0,0,1,10
Gold Coast,"Prestia, Dion",32,16,6,16,1,1,0,1
Gold Coast,"Rischitelli, Michael",13,10,5,3,2,2,0,1
Gold Coast,"Russell, Luke",15,10,6,5,0,1,0,4
Gold Coast,"Shaw, Matt",22,11,9,11,1,0,0,0
Gold Coast,"Stanley, Danny",20,13,7,7,2,1,0,3
Gold Coast,"Sumner, Timmy",6,3,0,3,0,1,0,4
Gold Coast,"Swallow, David",26,10,0,16,1,1,0,2
Gold Coast,"Thompson, Rory",9,2,1,7,0,0,22,7
Gold Coast,"Warnock, Matthew",11,3,1,8,0,0,0,0
Gold Coast,"Ablett, Gary",28,15,4,13,4,1,0,3
Gold Coast,"Bennell, Harley",23,14,7,9,2,2,1,2
Gold Coast,"Broughton, Greg",20,8,3,12,0,0,0,5
Gold Coast,"Day, Sam",17,7,4,10,1,0,4,2
Gold Coast,"Dixon, Charlie",9,6,2,3,3,1,5,5
Gold Coast,"Hall, Aaron",14,8,5,6,1,0,0,4
Gold Coast,"Harbrow, Jarrod",27,18,5,9,0,0,0,3
Gold Coast,"Kolodjashnij, Kade",25,13,5,12,0,0,0,2
Gold Coast,"Lemmens, Sean",14,8,0,6,0,0,0,1
Gold Coast,"Lynch, Tom",21,13,8,8,2,1,0,3
Gold Coast,"Matera, Brandon",15,10,3,5,3,1,0,3
Gold Coast,"May, Steven",10,10,2,0,0,0,0,2
Gold Coast,"McKenzie, Trent",16,10,5,6,0,0,0,7
Gold Coast,"Nicholls, Tom",8,1,0,7,0,0,11,2
Gold Coast,"OMeara, Jaeger",26,12,4,14,0,1,0,6
Gold Coast,"Prestia, Dion",28,16,3,12,1,0,0,2
Gold Coast,"Rischitelli, Michael",14,9,2,5,1,1,0,1
Gold Coast,"Russell, Luke",5,2,0,3,0,0,0,2
Gold Coast,"Shaw, Matt",20,11,7,9,0,0,0,5
Gold Coast,"Stanley, Danny",19,12,5,7,0,0,0,2
Gold Coast,"Swallow, David",20,7,1,13,0,0,0,9
Gold Coast,"Thompson, Rory",11,4,2,7,0,0,0,1
Gold Coast,"Ablett, Gary",37,16,0,21,4,0,0,4
Gold Coast,"Bennell, Harley",12,7,7,5,3,0,0,2
Gold Coast,"Broughton, Greg",19,10,3,9,0,0,0,2
Gold Coast,"Day, Sam",7,5,4,2,1,1,0,1
Gold Coast,"Dixon, Charlie",13,6,4,7,0,1,4,2
Gold Coast,"Hall, Aaron",10,7,3,3,1,1,0,3
Gold Coast,"Harbrow, Jarrod",26,12,3,14,0,1,0,1
Gold Coast,"Lemmens, Sean",7,4,0,3,0,0,0,1
Gold Coast,"Lynch, Tom",11,9,5,2,4,0,0,2
Gold Coast,"Matera, Brandon",17,11,1,6,4,1,0,3
Gold Coast,"May, Steven",10,8,2,2,0,0,0,1
Gold Coast,"McKenzie, Trent",17,7,3,10,0,0,0,2
Gold Coast,"OMeara, Jaeger",29,12,2,17,0,1,1,8
Gold Coast,"Prestia, Dion",28,13,4,15,0,0,0,3
Gold Coast,"Rischitelli, Michael",23,10,6,13,0,0,0,1
Gold Coast,"Russell, Luke",21,10,5,11,1,1,0,0
Gold Coast,"Sexton, Alex",6,4,4,2,0,0,0,0
Gold Coast,"Shaw, Matt",17,4,3,13,0,0,0,2
Gold Coast,"Smith, Zac",10,4,1,6,0,0,29,2
Gold Coast,"Stanley, Danny",15,7,2,8,0,0,0,3
Gold Coast,"Swallow, David",28,16,7,12,1,1,1,4
Gold Coast,"Thompson, Rory",12,6,3,6,0,0,0,2
Gold Coast,"Ablett, Gary",24,9,1,15,0,1,0,3
Gold Coast,"Bennell, Harley",19,8,6,11,2,1,1,0
Gold Coast,"Broughton, Greg",14,3,1,11,0,0,0,2
Gold Coast,"Day, Sam",5,3,0,2,0,0,2,4
Gold Coast,"Dixon, Charlie",10,8,4,2,4,0,5,3
Gold Coast,"Hall, Aaron",16,12,4,4,0,2,0,1
Gold Coast,"Harbrow, Jarrod",26,16,6,10,0,0,0,8
Gold Coast,"Kolodjashnij, Kade",21,12,4,9,0,0,0,2
Gold Coast,"Lemmens, Sean",3,1,0,2,0,0,0,2
Gold Coast,"Lynch, Tom",16,9,3,7,4,1,0,4
Gold Coast,"Matera, Brandon",17,13,6,4,3,1,0,4
Gold Coast,"May, Steven",14,12,6,2,0,0,0,2
Gold Coast,"McKenzie, Trent",11,8,6,3,0,0,0,1
Gold Coast,"OMeara, Jaeger",17,12,3,5,0,1,0,8
Gold Coast,"Prestia, Dion",35,15,6,20,0,1,0,5
Gold Coast,"Rischitelli, Michael",18,10,1,8,0,0,0,2
Gold Coast,"Russell, Luke",16,10,4,6,2,0,1,1
Gold Coast,"Sexton, Alex",13,8,3,5,0,1,0,1
Gold Coast,"Shaw, Matt",23,11,7,12,1,0,0,4
Gold Coast,"Smith, Zac",11,4,4,7,1,0,22,3
Gold Coast,"Stanley, Danny",17,10,8,7,0,0,0,1
Gold Coast,"Swallow, David",17,7,2,10,1,0,1,5
Gold Coast,"Ablett, Gary",25,12,1,13,2,0,0,6
Gold Coast,"Broughton, Greg",16,9,6,7,0,0,0,7
Gold Coast,"Cameron, Clay",5,1,2,4,0,0,0,2
Gold Coast,"Day, Sam",17,8,7,9,0,1,5,2
Gold Coast,"Dixon, Charlie",22,12,4,10,2,1,4,1
Gold Coast,"Hall, Aaron",12,7,0,5,1,1,0,9
Gold Coast,"Harbrow, Jarrod",21,15,2,6,0,0,0,2
Gold Coast,"Kolodjashnij, Kade",13,9,2,4,1,1,0,2
Gold Coast,"Lemmens, Sean",7,4,1,3,0,0,0,0
Gold Coast,"Lynch, Tom",12,4,0,8,0,0,0,1
Gold Coast,"Matera, Brandon",11,8,3,3,1,0,0,2
Gold Coast,"May, Steven",12,8,3,4,0,0,1,3
Gold Coast,"McKenzie, Trent",11,7,3,4,0,0,0,3
Gold Coast,"OMeara, Jaeger",18,11,1,7,0,0,0,8
Gold Coast,"Prestia, Dion",29,19,6,10,2,1,0,7
Gold Coast,"Rischitelli, Michael",18,10,3,8,0,1,1,7
Gold Coast,"Russell, Luke",9,4,0,5,0,0,0,4
Gold Coast,"Sexton, Alex",8,4,0,4,0,0,0,4
Gold Coast,"Shaw, Matt",16,7,5,9,0,0,2,3
Gold Coast,"Smith, Zac",15,7,1,8,0,1,30,2
Gold Coast,"Stanley, Danny",18,12,7,6,0,0,0,1
Gold Coast,"Swallow, David",37,15,4,22,2,0,1,1
Gold Coast,"Ablett, Gary",37,15,5,22,1,2,0,9
Gold Coast,"Bennell, Harley",22,18,9,4,1,3,0,1
Gold Coast,"Broughton, Greg",22,7,3,15,0,0,0,0
Gold Coast,"Cameron, Clay",4,1,1,3,0,0,1,0
Gold Coast,"Day, Sam",8,5,4,3,0,1,2,0
Gold Coast,"Dixon, Charlie",12,4,4,8,2,0,5,2
Gold Coast,"Harbrow, Jarrod",20,14,4,6,0,1,0,5
Gold Coast,"Hunt, Karmichael",8,2,0,6,0,0,0,2
Gold Coast,"Kolodjashnij, Kade",17,14,7,3,2,0,0,0
Gold Coast,"Lynch, Tom",15,11,5,4,1,2,0,0
Gold Coast,"Matera, Brandon",12,9,4,3,1,0,0,3
Gold Coast,"May, Steven",13,10,5,3,0,0,0,1
Gold Coast,"McKenzie, Trent",16,14,6,2,0,2,0,4
Gold Coast,"OMeara, Jaeger",26,12,6,14,1,0,1,3
Gold Coast,"Prestia, Dion",28,14,4,14,0,0,0,6
Gold Coast,"Rischitelli, Michael",18,6,4,12,0,1,0,4
Gold Coast,"Russell, Luke",16,12,6,4,1,0,0,3
Gold Coast,"Shaw, Matt",7,5,3,2,0,0,1,1
Gold Coast,"Smith, Zac",12,7,3,5,0,0,39,4
Gold Coast,"Stanley, Danny",13,7,3,6,0,0,0,4
Gold Coast,"Swallow, David",17,12,0,5,0,0,2,6
Gold Coast,"Thompson, Rory",12,8,7,4,0,0,2,3
Gold Coast,"Ablett, Gary",33,20,1,13,0,2,0,8
Gold Coast,"Bennell, Harley",20,10,2,10,1,2,0,3
Gold Coast,"Broughton, Greg",19,6,2,13,0,0,0,3
Gold Coast,"Day, Sam",9,5,3,4,0,0,0,0
Gold Coast,"Dixon, Charlie",7,4,1,3,3,0,14,2
Gold Coast,"Hall, Aaron",6,2,0,4,1,0,0,0
Gold Coast,"Harbrow, Jarrod",13,6,3,7,1,1,0,3
Gold Coast,"Kolodjashnij, Kade",10,4,2,6,0,0,0,1
Gold Coast,"Lynch, Tom",11,7,6,4,3,2,0,1
Gold Coast,"Matera, Brandon",12,6,1,6,2,0,0,3
Gold Coast,"May, Steven",15,14,5,1,0,0,0,1
Gold Coast,"McKenzie, Trent",16,12,7,4,0,0,0,4
Gold Coast,"OMeara, Jaeger",22,9,6,13,1,0,0,5
Gold Coast,"Prestia, Dion",38,20,5,18,1,0,0,5
Gold Coast,"Rischitelli, Michael",15,7,3,8,2,0,0,5
Gold Coast,"Russell, Luke",13,6,4,7,0,0,0,1
Gold Coast,"Sexton, Alex",4,4,2,0,0,1,0,1
Gold Coast,"Shaw, Matt",19,8,4,11,0,0,0,2
Gold Coast,"Smith, Zac",15,6,2,9,0,0,19,7
Gold Coast,"Stanley, Danny",18,10,2,8,0,0,0,1
Gold Coast,"Swallow, David",21,9,3,12,0,1,1,8
Gold Coast,"Thompson, Rory",10,9,6,1,0,0,0,0
Gold Coast,"Ablett, Gary",33,20,5,13,1,0,0,8
Gold Coast,"Bennell, Harley",27,20,11,7,6,3,1,2
Gold Coast,"Broughton, Greg",20,12,5,8,0,1,0,7
Gold Coast,"Day, Sam",7,4,3,3,0,0,1,2
Gold Coast,"Dixon, Charlie",10,6,4,4,3,2,5,2
Gold Coast,"Harbrow, Jarrod",21,14,7,7,1,1,0,6
Gold Coast,"Kolodjashnij, Kade",23,13,9,10,0,0,0,1
Gold Coast,"Lynch, Tom",16,9,6,7,1,1,0,2
Gold Coast,"Martin, Jack",15,8,3,7,1,1,0,6
Gold Coast,"Matera, Brandon",3,3,2,0,0,0,0,0
Gold Coast,"May, Steven",13,9,5,4,0,0,0,1
Gold Coast,"McKenzie, Trent",16,12,4,4,0,1,0,3
Gold Coast,"OMeara, Jaeger",18,13,3,5,2,0,0,3
Gold Coast,"Prestia, Dion",28,18,11,10,0,0,0,6
Gold Coast,"Rischitelli, Michael",17,9,3,8,0,0,0,0
Gold Coast,"Russell, Luke",9,8,4,1,2,0,0,1
Gold Coast,"Sexton, Alex",15,6,1,9,0,0,0,1
Gold Coast,"Shaw, Matt",16,9,6,7,0,1,0,0
Gold Coast,"Smith, Zac",8,3,1,5,0,1,21,2
Gold Coast,"Stanley, Danny",11,5,2,6,0,0,0,2
Gold Coast,"Swallow, David",27,18,4,9,0,2,1,6
Gold Coast,"Thompson, Rory",5,3,2,2,0,0,0,5
Gold Coast,"Ablett, Gary",45,28,2,17,2,0,0,6
Gold Coast,"Bennell, Harley",17,11,1,6,1,0,0,2
Gold Coast,"Broughton, Greg",6,3,1,3,0,0,0,4
Gold Coast,"Day, Sam",7,5,1,2,0,1,2,3
Gold Coast,"Dixon, Charlie",14,10,4,4,2,1,10,6
Gold Coast,"Harbrow, Jarrod",13,8,3,5,0,0,0,7
Gold Coast,"Kolodjashnij, Kade",12,7,3,5,0,0,0,3
Gold Coast,"Lonergan, Jesse",10,4,0,6,0,0,0,5
Gold Coast,"Lynch, Tom",13,11,7,2,2,0,0,1
Gold Coast,"Martin, Jack",7,6,1,1,1,0,0,1
Gold Coast,"May, Steven",13,10,2,3,0,0,0,0
Gold Coast,"McKenzie, Trent",15,14,2,1,0,0,0,5
Gold Coast,"OMeara, Jaeger",26,17,4,9,0,0,2,4
Gold Coast,"Prestia, Dion",19,10,2,9,1,0,0,6
Gold Coast,"Rischitelli, Michael",22,16,4,6,0,0,0,1
Gold Coast,"Russell, Luke",14,9,4,5,0,0,0,2
Gold Coast,"Sexton, Alex",9,5,2,4,0,0,0,2
Gold Coast,"Shaw, Matt",9,6,1,3,0,0,1,0
Gold Coast,"Smith, Zac",14,7,0,7,1,0,17,0
Gold Coast,"Stanley, Danny",11,7,1,4,0,0,0,4
Gold Coast,"Swallow, David",28,15,2,13,0,0,0,11
Gold Coast,"Thompson, Rory",7,6,3,1,0,0,0,3
Gold Coast,"Ablett, Gary",19,15,1,4,0,0,0,4
Gold Coast,"Bennell, Harley",26,12,8,14,1,2,0,1
Gold Coast,"Broughton, Greg",22,11,7,11,0,0,0,3
Gold Coast,"Day, Sam",13,10,8,3,4,1,4,1
Gold Coast,"Dixon, Charlie",5,4,3,1,2,1,0,0
Gold Coast,"Hall, Aaron",11,9,4,2,1,2,0,3
Gold Coast,"Harbrow, Jarrod",26,15,3,11,0,0,0,0
Gold Coast,"Kolodjashnij, Kade",19,13,6,6,0,1,0,1
Gold Coast,"Lemmens, Sean",11,4,2,7,0,0,0,6
Gold Coast,"Lonergan, Jesse",13,5,3,8,0,0,0,2
Gold Coast,"Lynch, Tom",21,12,6,9,2,3,0,1
Gold Coast,"Martin, Jack",10,6,4,4,0,0,0,1
Gold Coast,"May, Steven",18,12,7,6,0,0,0,3
Gold Coast,"McKenzie, Trent",18,13,4,5,0,0,0,2
Gold Coast,"OMeara, Jaeger",25,16,8,9,0,0,0,6
Gold Coast,"Prestia, Dion",19,10,2,9,1,0,0,4
Gold Coast,"Rischitelli, Michael",21,6,2,15,0,0,0,3
Gold Coast,"Sexton, Alex",5,5,3,0,0,1,0,2
Gold Coast,"Smith, Zac",12,3,0,9,0,0,14,2
Gold Coast,"Stanley, Danny",26,12,6,14,0,0,0,2
Gold Coast,"Swallow, David",31,15,7,16,0,0,5,3
Gold Coast,"Thompson, Rory",7,4,5,3,0,0,0,2
Gold Coast,"Bennell, Harley",18,8,1,10,1,1,1,0
Gold Coast,"Broughton, Greg",11,6,3,5,0,1,0,7
Gold Coast,"Day, Sam",15,8,3,7,0,0,6,2
Gold Coast,"Dixon, Charlie",10,6,2,4,3,0,12,2
Gold Coast,"Hall, Aaron",7,3,0,4,0,0,0,0
Gold Coast,"Harbrow, Jarrod",13,7,2,6,0,0,0,4
Gold Coast,"Kolodjashnij, Kade",18,11,6,7,0,0,0,1
Gold Coast,"Lemmens, Sean",18,9,1,9,0,0,0,3
Gold Coast,"Lonergan, Jesse",16,8,3,8,0,1,0,1
Gold Coast,"Lynch, Tom",16,9,4,7,2,2,0,1
Gold Coast,"Martin, Jack",6,3,1,3,1,0,0,2
Gold Coast,"May, Steven",15,12,3,3,0,0,0,6
Gold Coast,"Murphy, Tom",13,10,4,3,0,0,0,2
Gold Coast,"OMeara, Jaeger",22,16,3,6,2,1,0,9
Gold Coast,"Prestia, Dion",22,11,3,11,0,0,0,4
Gold Coast,"Rischitelli, Michael",9,6,5,3,0,0,0,4
Gold Coast,"Sexton, Alex",6,4,1,2,0,1,0,2
Gold Coast,"Shaw, Matt",10,5,1,5,0,1,0,1
Gold Coast,"Smith, Zac",12,4,1,8,0,2,22,6
Gold Coast,"Stanley, Danny",20,13,5,7,0,0,0,2
Gold Coast,"Swallow, David",20,10,4,10,0,0,1,3
Gold Coast,"Thompson, Rory",8,6,5,2,0,0,0,1
Gold Coast,"Bennell, Harley",14,9,2,5,0,1,0,1
Gold Coast,"Broughton, Greg",13,5,2,8,0,0,0,7
Gold Coast,"Cameron, Clay",6,3,2,3,0,0,0,7
Gold Coast,"Day, Sam",15,9,4,6,1,0,7,1
Gold Coast,"Dixon, Charlie",2,1,0,1,0,0,0,0
Gold Coast,"Hall, Aaron",16,12,1,4,1,0,0,10
Gold Coast,"Harbrow, Jarrod",11,10,1,1,0,0,0,4
Gold Coast,"Herbert, Louis",3,3,1,0,0,0,0,5
Gold Coast,"Lemmens, Sean",18,12,0,6,0,0,0,6
Gold Coast,"Lonergan, Jesse",15,4,0,11,0,0,0,4
Gold Coast,"Lynch, Tom",14,8,4,6,0,2,2,3
Gold Coast,"Martin, Jack",12,7,0,5,1,0,0,3
Gold Coast,"May, Steven",9,7,0,2,0,0,2,1
Gold Coast,"OMeara, Jaeger",12,9,0,3,0,0,1,13
Gold Coast,"Prestia, Dion",22,9,2,13,0,0,0,6
Gold Coast,"Russell, Luke",12,7,2,5,0,1,0,2
Gold Coast,"Sexton, Alex",10,8,1,2,3,1,0,4
Gold Coast,"Shaw, Matt",16,7,5,9,1,0,0,3
Gold Coast,"Smith, Zac",3,2,0,1,0,0,16,2
Gold Coast,"Stanley, Danny",23,15,3,8,1,1,0,9
Gold Coast,"Swallow, David",17,12,2,5,0,0,1,9
Gold Coast,"Thompson, Rory",9,2,1,7,0,0,11,3
Gold Coast,"Bennell, Harley",20,14,4,6,2,0,0,1
Gold Coast,"Broughton, Greg",18,10,6,8,0,1,0,4
Gold Coast,"Day, Sam",8,4,2,4,1,0,5,1
Gold Coast,"Gorringe, Daniel",13,5,1,8,0,0,18,0
Gold Coast,"Hall, Aaron",22,15,6,7,0,1,0,2
Gold Coast,"Harbrow, Jarrod",15,10,3,5,0,0,0,2
Gold Coast,"Herbert, Louis",1,0,0,1,0,0,0,0
Gold Coast,"Lemmens, Sean",17,12,3,5,0,0,0,2
Gold Coast,"Lonergan, Jesse",16,8,3,8,1,0,0,3
Gold Coast,"Lynch, Tom",14,9,6,5,4,2,0,1
Gold Coast,"Martin, Jack",17,10,2,7,1,1,0,1
Gold Coast,"May, Steven",12,8,3,4,0,0,0,1
Gold Coast,"McKenzie, Trent",13,9,5,4,1,0,0,3
Gold Coast,"OMeara, Jaeger",22,8,3,14,1,0,1,7
Gold Coast,"Prestia, Dion",31,14,2,17,0,1,0,6
Gold Coast,"Rischitelli, Michael",19,9,2,10,1,2,0,6
Gold Coast,"Sexton, Alex",13,8,4,5,2,1,0,4
Gold Coast,"Shaw, Matt",19,7,5,12,1,1,0,3
Gold Coast,"Stanley, Danny",13,6,4,7,1,0,1,0
Gold Coast,"Sumner, Timmy",11,4,1,7,0,1,0,1
Gold Coast,"Swallow, David",12,9,4,3,1,1,0,1
Gold Coast,"Thompson, Rory",9,3,3,6,0,0,0,1
Gold Coast,"Bennell, Harley",27,12,2,15,0,0,1,3
Gold Coast,"Broughton, Greg",14,5,6,9,0,0,0,3
Gold Coast,"Day, Sam",7,6,1,1,0,1,5,2
Gold Coast,"Gorringe, Daniel",13,5,3,8,0,1,19,3
Gold Coast,"Hall, Aaron",10,5,4,5,1,0,0,3
Gold Coast,"Harbrow, Jarrod",17,13,4,4,2,0,0,3
Gold Coast,"Kolodjashnij, Kade",20,15,8,5,0,1,0,4
Gold Coast,"Lemmens, Sean",22,13,9,9,0,0,0,2
Gold Coast,"Lonergan, Jesse",11,5,3,6,0,0,1,7
Gold Coast,"Lynch, Tom",24,12,9,12,1,2,0,2
Gold Coast,"Martin, Jack",14,10,6,4,1,1,0,2
Gold Coast,"Matera, Brandon",17,10,4,7,0,0,0,1
Gold Coast,"May, Steven",13,8,5,5,0,0,0,4
Gold Coast,"McKenzie, Trent",15,9,1,6,0,0,0,0
Gold Coast,"OMeara, Jaeger",26,15,6,11,1,1,2,5
Gold Coast,"Prestia, Dion",18,10,3,8,0,0,0,2
Gold Coast,"Rischitelli, Michael",3,0,0,3,0,0,0,1
Gold Coast,"Sexton, Alex",8,3,0,5,0,0,0,1
Gold Coast,"Shaw, Matt",9,3,4,6,0,0,0,2
Gold Coast,"Stanley, Danny",20,12,7,8,1,1,1,6
Gold Coast,"Swallow, David",19,12,2,7,1,1,3,10
Gold Coast,"Thompson, Rory",9,6,5,3,0,0,0,1
Gold Coast,"Bennell, Harley",27,19,3,8,2,0,2,7
Gold Coast,"Day, Sam",7,6,0,1,0,0,7,5
Gold Coast,"Dixon, Charlie",2,1,0,1,0,0,1,0
Gold Coast,"Gorringe, Daniel",8,8,0,0,1,0,17,2
Gold Coast,"Harbrow, Jarrod",14,11,1,3,1,2,0,4
Gold Coast,"Herbert, Louis",7,4,0,3,0,0,0,2
Gold Coast,"Kolodjashnij, Kade",9,7,3,2,1,0,0,1
Gold Coast,"Lemmens, Sean",15,11,3,4,0,0,0,2
Gold Coast,"Lonergan, Jesse",11,6,0,5,0,0,0,3
Gold Coast,"Lynch, Tom",18,11,7,7,1,0,0,2
Gold Coast,"Martin, Jack",4,2,0,2,0,0,0,5
Gold Coast,"Matera, Brandon",8,5,1,3,1,0,0,2
Gold Coast,"McKenzie, Trent",22,18,7,4,0,0,0,2
Gold Coast,"OMeara, Jaeger",17,13,2,4,0,0,0,6
Gold Coast,"Prestia, Dion",26,18,0,8,0,0,0,9
Gold Coast,"Rischitelli, Michael",14,8,2,6,0,0,1,10
Gold Coast,"Sexton, Alex",9,5,1,4,0,0,0,1
Gold Coast,"Stanley, Danny",14,12,2,2,0,0,2,2
Gold Coast,"Sumner, Timmy",3,2,1,1,0,0,0,2
Gold Coast,"Swallow, David",20,15,1,5,0,0,5,6
Gold Coast,"Tape, Seb",7,4,1,3,0,0,0,6
Gold Coast,"Thompson, Rory",3,0,1,3,0,0,2,2
Gold Coast,"Bennell, Harley",27,10,3,17,0,0,0,2
Gold Coast,"Cameron, Clay",12,9,6,3,1,2,0,1
Gold Coast,"Day, Sam",10,2,1,8,0,0,19,1
Gold Coast,"Harbrow, Jarrod",22,13,2,9,0,0,0,0
Gold Coast,"Kolodjashnij, Kade",4,4,4,0,0,0,0,6
Gold Coast,"Lemmens, Sean",11,6,2,5,2,0,0,0
Gold Coast,"Leslie, Jack",12,4,3,8,0,0,4,1
Gold Coast,"Lonergan, Jesse",6,3,0,3,0,0,0,3
Gold Coast,"Lynch, Tom",16,10,8,6,4,2,0,4
Gold Coast,"Martin, Jack",17,11,9,6,0,1,1,2
Gold Coast,"Matera, Brandon",19,14,5,5,2,3,0,3
Gold Coast,"McKenzie, Trent",14,10,6,4,0,0,0,2
Gold Coast,"OMeara, Jaeger",24,12,7,12,0,0,0,6
Gold Coast,"Prestia, Dion",28,15,2,13,2,0,0,7
Gold Coast,"Rischitelli, Michael",21,11,4,10,0,0,0,5
Gold Coast,"Sexton, Alex",4,2,1,2,0,1,0,1
Gold Coast,"Shaw, Matt",14,10,6,4,1,0,0,2
Gold Coast,"Stanley, Danny",15,10,6,5,0,0,0,3
Gold Coast,"Sumner, Timmy",4,3,1,1,0,0,0,1
Gold Coast,"Swallow, David",27,17,2,10,1,1,2,8
Gold Coast,"Tape, Seb",3,1,0,2,0,0,0,1
Gold Coast,"Thompson, Rory",11,9,4,2,0,0,0,3
Gold Coast,"Bennell, Harley",22,13,1,9,1,1,0,2
Gold Coast,"Broughton, Greg",23,10,7,13,0,0,0,3
Gold Coast,"Cameron, Clay",8,5,4,3,0,0,0,1
Gold Coast,"Day, Sam",8,3,2,5,1,0,22,1
Gold Coast,"Harbrow, Jarrod",24,15,4,9,0,0,0,3
Gold Coast,"Kolodjashnij, Kade",18,11,4,7,0,0,0,1
Gold Coast,"Lemmens, Sean",15,8,4,7,0,0,0,2
Gold Coast,"Leslie, Jack",4,0,1,4,0,0,0,2
Gold Coast,"Lonergan, Jesse",6,3,0,3,1,0,1,0
Gold Coast,"Lynch, Tom",18,12,7,6,3,1,2,2
Gold Coast,"Martin, Jack",19,14,7,5,4,0,0,2
Gold Coast,"Matera, Brandon",22,18,9,4,2,2,0,3
Gold Coast,"OMeara, Jaeger",15,8,2,7,0,0,0,3
Gold Coast,"Prestia, Dion",30,11,3,19,0,0,0,4
Gold Coast,"Rischitelli, Michael",34,15,7,19,1,0,0,5
Gold Coast,"Sexton, Alex",11,7,2,4,1,0,0,2
Gold Coast,"Shaw, Matt",16,8,8,8,0,0,0,2
Gold Coast,"Stanley, Danny",10,3,2,7,0,0,0,1
Gold Coast,"Swallow, David",21,13,2,8,1,3,2,6
Gold Coast,"Tape, Seb",11,5,1,6,0,0,0,2
Gold Coast,"Thompson, Rory",12,6,3,6,0,0,0,3
Gold Coast,"Warnock, Matthew",11,5,4,6,0,0,0,3
Geelong,"Bartel, Jimmy",21,15,5,6,4,1,0,2
Geelong,"Blicavs, Mark",6,4,2,2,0,0,3,2
Geelong,"Brown, Mitch",14,9,3,5,3,0,0,3
Geelong,"Caddy, Josh",20,10,5,10,1,0,0,4
Geelong,"Duncan, Mitch",19,14,5,5,1,0,0,3
Geelong,"Enright, Corey",20,13,7,7,1,0,0,7
Geelong,"Guthrie, Cameron",13,4,1,9,0,1,0,11
Geelong,"Hawkins, Tom",6,5,5,1,1,1,0,0
Geelong,"Hunt, Taylor",16,11,3,5,0,0,0,0
Geelong,"Johnson, Steve",31,15,6,16,1,2,0,4
Geelong,"Kelly, James",24,14,6,10,0,0,0,5
Geelong,"Lonergan, Tom",12,5,7,7,0,0,0,6
Geelong,"Mackie, Andrew",23,18,8,5,0,0,0,4
Geelong,"McCarthy, Lincoln",9,6,2,3,0,1,0,5
Geelong,"McIntosh, Hamish",12,6,3,6,1,0,19,0
Geelong,"Murdoch, Jordan",14,10,2,4,1,0,0,5
Geelong,"Rivers, Jared",8,4,5,4,0,0,1,3
Geelong,"Selwood, Joel",34,16,3,18,2,1,1,6
Geelong,"Simpson, Dawson",5,2,1,3,1,0,17,1
Geelong,"Stokes, Mathew",28,17,3,11,1,1,0,4
Geelong,"Taylor, Harry",14,10,5,4,0,1,1,1
Geelong,"Varcoe, Travis",15,6,4,9,0,0,0,6
Geelong,"Bartel, Jimmy",11,6,2,5,2,1,0,6
Geelong,"Blicavs, Mark",11,5,1,6,0,0,1,4
Geelong,"Brown, Mitch",7,3,1,4,0,0,0,0
Geelong,"Caddy, Josh",17,6,2,11,0,0,0,3
Geelong,"Duncan, Mitch",13,9,4,4,1,1,0,1
Geelong,"Enright, Corey",9,7,5,2,0,0,0,3
Geelong,"Guthrie, Cameron",11,8,4,3,0,0,0,6
Geelong,"Hawkins, Tom",8,5,4,3,2,2,0,3
Geelong,"Horlin-Smith, George",9,4,2,5,2,0,0,1
Geelong,"Hunt, Taylor",10,6,2,4,1,0,0,4
Geelong,"Johnson, Steve",37,23,5,14,0,2,1,10
Geelong,"Kelly, James",24,17,7,7,0,1,0,7
Geelong,"Lonergan, Tom",10,5,4,5,0,0,0,3
Geelong,"Mackie, Andrew",23,19,9,4,0,0,0,0
Geelong,"McCarthy, Lincoln",12,8,0,4,0,1,0,4
Geelong,"McIntosh, Hamish",15,6,3,9,0,2,27,1
Geelong,"Murdoch, Jordan",18,10,2,8,2,0,0,7
Geelong,"Selwood, Joel",25,13,2,12,1,0,0,7
Geelong,"Simpson, Dawson",3,0,0,3,0,0,26,2
Geelong,"Stokes, Mathew",26,11,3,15,0,0,0,5
Geelong,"Taylor, Harry",11,7,6,4,0,0,0,4
Geelong,"Varcoe, Travis",16,9,2,7,2,2,0,10
Geelong,"Bartel, Jimmy",27,17,5,10,0,1,0,1
Geelong,"Blicavs, Mark",6,5,4,1,0,2,2,0
Geelong,"Brown, Mitch",10,6,3,4,0,2,0,1
Geelong,"Burbury, George",12,7,3,5,0,1,0,5
Geelong,"Caddy, Josh",16,8,3,8,0,1,0,4
Geelong,"Duncan, Mitch",30,17,6,13,0,1,0,2
Geelong,"Guthrie, Cameron",18,8,4,10,1,0,0,6
Geelong,"Hawkins, Tom",11,9,5,2,4,2,0,1
Geelong,"Horlin-Smith, George",22,10,7,12,1,0,0,1
Geelong,"Johnson, Steve",20,10,3,10,1,1,0,1
Geelong,"Kelly, James",22,15,6,7,0,0,0,3
Geelong,"Lonergan, Tom",10,8,4,2,0,0,0,2
Geelong,"Mackie, Andrew",20,15,6,5,1,0,0,3
Geelong,"McIntosh, Hamish",16,10,5,6,1,0,12,1
Geelong,"Murdoch, Jordan",11,7,4,4,1,1,0,4
Geelong,"Rivers, Jared",12,4,4,8,0,0,0,1
Geelong,"Selwood, Joel",30,8,2,22,0,1,0,11
Geelong,"Sheringham, Jackson",15,7,4,8,0,0,0,4
Geelong,"Simpson, Dawson",7,1,0,6,0,0,20,4
Geelong,"Stokes, Mathew",29,19,5,10,1,0,0,2
Geelong,"Taylor, Harry",14,10,7,4,0,0,0,4
Geelong,"Varcoe, Travis",13,5,3,8,1,0,0,4
Geelong,"Bartel, Jimmy",26,18,9,8,2,1,0,2
Geelong,"Blicavs, Mark",12,11,6,1,0,0,5,4
Geelong,"Burbury, George",13,12,5,1,1,1,0,7
Geelong,"Caddy, Josh",7,5,2,2,0,0,0,3
Geelong,"Duncan, Mitch",28,14,5,14,1,0,0,2
Geelong,"Enright, Corey",22,13,8,9,0,0,0,2
Geelong,"Guthrie, Cameron",24,13,6,11,0,1,0,9
Geelong,"Hawkins, Tom",11,10,8,1,3,2,0,0
Geelong,"Horlin-Smith, George",23,15,5,8,3,1,0,4
Geelong,"Hunt, Taylor",18,11,5,7,0,1,0,6
Geelong,"Johnson, Steve",37,24,11,13,1,1,0,8
Geelong,"Kelly, James",24,16,6,8,0,0,0,8
Geelong,"Lonergan, Tom",10,4,4,6,0,0,0,0
Geelong,"Mackie, Andrew",19,16,7,3,0,0,0,0
Geelong,"McIntosh, Hamish",17,8,5,9,1,1,5,2
Geelong,"Murdoch, Jordan",13,7,4,6,0,1,0,2
Geelong,"Rivers, Jared",24,12,12,12,0,0,0,3
Geelong,"Selwood, Joel",27,18,9,9,3,1,0,2
Geelong,"Simpson, Dawson",10,4,4,6,0,0,15,2
Geelong,"Stokes, Mathew",38,19,10,19,0,0,0,0
Geelong,"Taylor, Harry",12,8,5,4,0,0,0,1
Geelong,"Varcoe, Travis",12,4,1,8,1,0,0,6
Geelong,"Bartel, Jimmy",25,15,9,10,0,0,0,6
Geelong,"Blicavs, Mark",8,4,3,4,0,0,4,0
Geelong,"Burbury, George",11,4,3,7,0,2,0,3
Geelong,"Duncan, Mitch",22,14,8,8,0,0,0,3
Geelong,"Enright, Corey",16,10,2,6,2,0,0,2
Geelong,"Guthrie, Cameron",14,10,2,4,1,0,0,7
Geelong,"Hawkins, Tom",16,10,10,6,5,3,0,2
Geelong,"Horlin-Smith, George",15,8,2,7,0,1,0,2
Geelong,"Hunt, Taylor",15,9,2,6,0,0,0,6
Geelong,"Johnson, Steve",34,20,10,14,3,1,0,2
Geelong,"Kelly, James",15,11,3,4,0,0,0,2
Geelong,"Lonergan, Tom",4,0,1,4,0,0,0,1
Geelong,"Mackie, Andrew",12,6,2,6,0,1,0,1
Geelong,"McIntosh, Hamish",17,10,6,7,1,2,14,3
Geelong,"Murdoch, Jordan",13,10,4,3,2,1,0,3
Geelong,"Rivers, Jared",14,6,7,8,0,0,0,2
Geelong,"Selwood, Joel",20,13,1,7,0,0,0,2
Geelong,"Sheringham, Jackson",2,2,0,0,0,0,0,0
Geelong,"Simpson, Dawson",6,3,0,3,0,0,19,6
Geelong,"Stokes, Mathew",24,12,3,12,0,0,0,2
Geelong,"Taylor, Harry",16,11,8,5,0,0,0,1
Geelong,"Varcoe, Travis",10,4,1,6,1,0,0,5
Geelong,"Bartel, Jimmy",24,16,8,8,1,0,0,2
Geelong,"Blicavs, Mark",13,5,4,8,1,0,10,1
Geelong,"Burbury, George",10,4,3,6,0,0,0,6
Geelong,"Duncan, Mitch",27,18,7,9,0,2,0,2
Geelong,"Enright, Corey",11,4,4,7,0,0,0,4
Geelong,"Guthrie, Cameron",19,10,5,9,0,1,0,3
Geelong,"Hawkins, Tom",9,8,5,1,3,2,0,2
Geelong,"Horlin-Smith, George",20,11,4,9,1,1,0,4
Geelong,"Hunt, Taylor",4,3,1,1,0,0,0,4
Geelong,"Johnson, Steve",25,14,4,11,1,0,0,6
Geelong,"Kelly, James",23,20,4,3,0,0,0,3
Geelong,"Lonergan, Tom",11,5,3,6,0,0,0,3
Geelong,"McIntosh, Hamish",9,6,3,3,0,0,19,2
Geelong,"Murdoch, Jordan",14,10,3,4,0,3,0,8
Geelong,"Rivers, Jared",11,6,6,5,0,0,0,2
Geelong,"Selwood, Joel",17,8,3,9,0,0,1,6
Geelong,"Sheringham, Jackson",12,6,3,6,0,1,0,2
Geelong,"Stokes, Mathew",28,13,6,15,0,0,0,1
Geelong,"Taylor, Harry",6,2,3,4,0,0,1,1
Geelong,"Thurlow, Jackson",10,8,2,2,0,0,0,4
Geelong,"Varcoe, Travis",21,9,4,12,0,1,0,4
Geelong,"Walker, Josh",5,4,4,1,2,0,0,2
Geelong,"Bartel, Jimmy",24,16,4,8,1,3,0,9
Geelong,"Blicavs, Mark",4,3,2,1,0,0,12,5
Geelong,"Burbury, George",9,2,1,7,0,0,0,6
Geelong,"Duncan, Mitch",21,11,5,10,2,1,0,3
Geelong,"Enright, Corey",24,13,3,11,0,0,0,3
Geelong,"Guthrie, Cameron",14,9,2,5,0,0,1,8
Geelong,"Hawkins, Tom",14,8,4,6,0,3,0,0
Geelong,"Horlin-Smith, George",11,8,3,3,0,0,0,4
Geelong,"Hunt, Taylor",14,10,6,4,2,0,0,4
Geelong,"Johnson, Steve",29,20,5,9,1,1,0,7
Geelong,"Kelly, James",20,17,4,3,0,0,0,1
Geelong,"Lonergan, Tom",12,8,5,4,0,0,0,4
Geelong,"McIntosh, Hamish",9,9,3,0,1,0,25,0
Geelong,"Motlop, Steven",16,11,2,5,0,0,0,0
Geelong,"Murdoch, Jordan",18,10,3,8,2,1,0,4
Geelong,"Rivers, Jared",11,5,4,6,0,0,0,0
Geelong,"Selwood, Joel",19,13,0,6,1,1,0,7
Geelong,"Sheringham, Jackson",11,9,3,2,0,0,0,5
Geelong,"Simpson, Dawson",3,0,0,3,0,0,16,0
Geelong,"Stokes, Mathew",30,17,8,13,0,0,0,2
Geelong,"Taylor, Harry",19,13,13,6,0,0,0,4
Geelong,"Varcoe, Travis",9,6,1,3,1,0,0,3
Geelong,"Bartel, Jimmy",19,13,5,6,1,2,0,4
Geelong,"Bews, Jed",15,10,8,5,0,0,0,5
Geelong,"Blicavs, Mark",11,7,6,4,0,0,2,3
Geelong,"Duncan, Mitch",26,18,10,8,0,1,0,5
Geelong,"Enright, Corey",23,13,7,10,0,0,0,3
Geelong,"Guthrie, Cameron",29,9,4,20,0,0,0,2
Geelong,"Hawkins, Tom",10,7,6,3,3,0,0,0
Geelong,"Horlin-Smith, George",30,15,5,15,1,0,0,1
Geelong,"Hunt, Taylor",16,8,2,8,0,0,0,8
Geelong,"Johnson, Steve",20,9,1,11,0,1,0,3
Geelong,"Kelly, James",30,15,8,15,0,0,0,3
Geelong,"Lonergan, Tom",16,8,2,8,0,0,0,1
Geelong,"Mackie, Andrew",22,12,7,10,0,0,0,4
Geelong,"McIntosh, Hamish",13,6,3,7,0,0,23,6
Geelong,"Motlop, Steven",12,11,4,1,1,1,0,4
Geelong,"Murdoch, Jordan",16,7,4,9,1,0,0,4
Geelong,"Rivers, Jared",12,6,4,6,0,0,0,3
Geelong,"Selwood, Joel",35,15,8,20,0,0,0,7
Geelong,"Sheringham, Jackson",4,2,0,2,0,0,0,3
Geelong,"Simpson, Dawson",3,1,2,2,0,0,8,5
Geelong,"Taylor, Harry",7,4,4,3,0,0,0,0
Geelong,"Varcoe, Travis",14,6,5,8,2,0,0,4
Geelong,"Bartel, Jimmy",32,23,9,9,2,2,0,7
Geelong,"Bews, Jed",8,3,1,5,0,0,0,4
Geelong,"Blicavs, Mark",9,6,1,3,1,0,0,2
Geelong,"Duncan, Mitch",19,8,6,11,2,0,0,3
Geelong,"Enright, Corey",19,9,2,10,1,0,0,5
Geelong,"Guthrie, Cameron",22,9,2,13,0,1,0,8
Geelong,"Hawkins, Tom",17,12,7,5,4,3,0,3
Geelong,"Horlin-Smith, George",21,12,5,9,1,0,0,3
Geelong,"Kelly, James",33,16,10,17,0,0,0,6
Geelong,"Lonergan, Tom",4,1,2,3,0,0,0,0
Geelong,"Mackie, Andrew",27,17,9,10,0,0,0,5
Geelong,"McIntosh, Hamish",16,7,5,9,0,0,7,7
Geelong,"Motlop, Steven",21,13,4,8,1,1,0,0
Geelong,"Murdoch, Jordan",14,9,4,5,2,1,0,2
Geelong,"Rivers, Jared",14,4,3,10,0,0,0,0
Geelong,"Selwood, Joel",26,17,6,9,1,2,0,2
Geelong,"Sheringham, Jackson",11,6,3,5,0,1,0,5
Geelong,"Simpson, Dawson",7,1,0,6,0,1,21,3
Geelong,"Stokes, Mathew",28,17,3,11,0,0,0,3
Geelong,"Stringer, Jesse",11,8,3,3,1,0,0,4
Geelong,"Taylor, Harry",13,8,4,5,0,0,0,2
Geelong,"Varcoe, Travis",19,7,4,12,0,1,0,3
Geelong,"Bartel, Jimmy",27,15,2,12,0,0,0,3
Geelong,"Bews, Jed",9,3,2,6,0,0,0,4
Geelong,"Blicavs, Mark",20,10,7,10,0,0,1,1
Geelong,"Duncan, Mitch",21,11,5,10,0,0,0,6
Geelong,"Guthrie, Cameron",16,5,4,11,0,0,0,3
Geelong,"Hawkins, Tom",10,7,5,3,3,1,0,0
Geelong,"Horlin-Smith, George",18,3,1,15,0,0,0,4
Geelong,"Johnson, Steve",26,15,4,11,1,1,0,2
Geelong,"Kelly, James",21,15,2,6,0,1,0,3
Geelong,"Mackie, Andrew",19,14,3,5,0,0,0,2
Geelong,"McIntosh, Hamish",16,8,5,8,0,0,28,0
Geelong,"Motlop, Steven",12,9,2,3,0,0,0,2
Geelong,"Murdoch, Jordan",8,5,3,3,0,1,0,6
Geelong,"Rivers, Jared",13,5,3,8,0,0,0,1
Geelong,"Selwood, Joel",30,8,2,22,0,1,0,7
Geelong,"Sheringham, Jackson",8,5,2,3,0,0,0,0
Geelong,"Simpson, Dawson",7,3,2,4,1,0,21,1
Geelong,"Smedts, Billie",4,3,1,1,0,0,0,0
Geelong,"Stokes, Mathew",30,16,2,14,0,0,0,3
Geelong,"Stringer, Jesse",12,2,2,10,0,0,0,1
Geelong,"Taylor, Harry",18,9,5,9,0,0,0,3
Geelong,"Varcoe, Travis",14,4,2,10,0,0,0,3
Geelong,"Bartel, Jimmy",18,12,4,6,1,2,1,3
Geelong,"Bews, Jed",7,1,0,6,0,0,0,1
Geelong,"Blicavs, Mark",12,4,5,8,0,0,11,5
Geelong,"Duncan, Mitch",16,8,2,8,0,0,1,2
Geelong,"Enright, Corey",19,13,1,6,0,0,0,1
Geelong,"Guthrie, Cameron",23,9,3,14,0,1,0,5
Geelong,"Hawkins, Tom",17,12,10,5,4,0,0,0
Geelong,"Horlin-Smith, George",22,10,4,12,2,0,0,4
Geelong,"Johnson, Steve",19,9,2,10,0,1,0,7
Geelong,"Kelly, James",27,14,2,13,0,1,0,3
Geelong,"Lonergan, Tom",7,3,3,4,0,1,0,3
Geelong,"Mackie, Andrew",17,10,4,7,1,2,0,4
Geelong,"McIntosh, Hamish",12,5,0,7,0,0,26,5
Geelong,"Motlop, Steven",15,12,5,3,1,0,0,3
Geelong,"Murdoch, Jordan",11,8,1,3,2,0,0,3
Geelong,"Rivers, Jared",17,10,4,7,0,0,0,4
Geelong,"Selwood, Joel",18,7,2,11,1,0,0,6
Geelong,"Smedts, Billie",12,7,2,5,0,0,0,0
Geelong,"Stokes, Mathew",22,12,6,10,3,1,0,2
Geelong,"Stringer, Jesse",7,5,0,2,0,0,0,2
Geelong,"Taylor, Harry",14,9,6,5,0,0,0,2
Geelong,"Walker, Josh",9,4,2,5,1,0,1,0
Geelong,"Bartel, Jimmy",32,23,13,9,1,1,0,5
Geelong,"Blicavs, Mark",18,9,6,9,0,0,11,1
Geelong,"Duncan, Mitch",20,16,13,4,3,0,0,4
Geelong,"Enright, Corey",22,10,7,12,0,0,0,5
Geelong,"Guthrie, Cameron",15,7,3,8,0,0,0,2
Geelong,"Hartman, Brad",14,6,1,8,0,0,0,5
Geelong,"Hawkins, Tom",20,16,13,4,3,2,0,1
Geelong,"Horlin-Smith, George",8,3,2,5,0,1,0,1
Geelong,"Kelly, James",25,16,6,9,0,0,0,12
Geelong,"Lang, Darcy",7,5,2,2,1,1,0,6
Geelong,"Lonergan, Tom",14,8,4,6,0,0,0,2
Geelong,"Mackie, Andrew",26,21,13,5,1,0,0,3
Geelong,"Motlop, Steven",29,15,10,14,1,1,0,1
Geelong,"Murdoch, Jordan",14,11,4,3,2,2,0,2
Geelong,"Selwood, Joel",11,8,4,3,3,0,0,3
Geelong,"Simpson, Dawson",8,1,3,7,0,0,52,3
Geelong,"Smedts, Billie",14,9,4,5,0,0,0,4
Geelong,"Stokes, Mathew",36,20,7,16,1,1,0,5
Geelong,"Stringer, Jesse",9,3,2,6,1,0,0,5
Geelong,"Taylor, Harry",11,6,5,5,0,0,0,1
Geelong,"Varcoe, Travis",18,8,7,10,0,1,0,0
Geelong,"Walker, Josh",8,7,5,1,3,0,0,1
Geelong,"Bartel, Jimmy",19,8,3,11,0,0,0,2
Geelong,"Blicavs, Mark",9,3,1,6,0,0,5,1
Geelong,"Caddy, Josh",12,4,0,8,0,0,0,1
Geelong,"Christensen, Allen",21,11,4,10,0,0,0,3
Geelong,"Duncan, Mitch",29,11,6,18,0,0,0,3
Geelong,"Enright, Corey",18,10,4,8,1,0,0,3
Geelong,"Guthrie, Cameron",21,10,1,11,0,1,0,5
Geelong,"Hawkins, Tom",8,7,3,1,3,2,0,1
Geelong,"Johnson, Steve",27,12,6,15,1,1,0,3
Geelong,"Kelly, James",20,9,0,11,0,0,0,5
Geelong,"Kersten, Shane",10,9,7,1,3,1,0,4
Geelong,"Lonergan, Tom",11,7,3,4,0,0,0,3
Geelong,"Mackie, Andrew",17,11,3,6,0,0,0,3
Geelong,"McIntosh, Hamish",10,4,3,6,0,0,27,2
Geelong,"Motlop, Steven",24,18,9,6,3,1,0,3
Geelong,"Murdoch, Jordan",12,7,2,5,0,0,0,1
Geelong,"Rivers, Jared",15,9,6,6,0,0,0,1
Geelong,"Selwood, Joel",28,13,4,15,0,2,2,1
Geelong,"Smedts, Billie",12,5,2,7,0,0,0,2
Geelong,"Stokes, Mathew",2,1,0,1,0,0,0,1
Geelong,"Varcoe, Travis",20,7,4,13,0,0,0,2
Geelong,"Walker, Josh",10,3,1,7,0,0,8,3
Geelong,"Bartel, Jimmy",28,20,6,8,0,0,0,3
Geelong,"Bews, Jed",5,2,1,3,0,0,0,2
Geelong,"Blicavs, Mark",17,10,8,7,0,0,9,1
Geelong,"Caddy, Josh",4,2,1,2,0,1,0,0
Geelong,"Christensen, Allen",21,9,1,12,0,0,0,4
Geelong,"Duncan, Mitch",22,15,10,7,2,0,0,4
Geelong,"Enright, Corey",21,11,6,10,1,0,0,3
Geelong,"Guthrie, Cameron",18,10,3,8,0,0,0,4
Geelong,"Hawkins, Tom",13,10,5,3,3,1,0,2
Geelong,"Horlin-Smith, George",20,10,2,10,1,3,0,4
Geelong,"Johnson, Steve",25,13,4,12,0,0,0,6
Geelong,"Kelly, James",16,11,9,5,0,0,0,4
Geelong,"Kersten, Shane",5,5,3,0,2,1,0,1
Geelong,"Lonergan, Tom",14,6,6,8,0,0,0,2
Geelong,"Mackie, Andrew",26,14,8,12,0,1,0,1
Geelong,"Motlop, Steven",21,16,5,5,2,1,0,0
Geelong,"Murdoch, Jordan",13,12,8,1,0,1,0,5
Geelong,"Rivers, Jared",9,7,5,2,0,0,0,0
Geelong,"Selwood, Joel",26,15,7,11,2,0,0,9
Geelong,"Simpson, Dawson",9,2,2,7,0,0,27,4
Geelong,"Taylor, Harry",11,6,2,5,0,0,0,2
Geelong,"Varcoe, Travis",13,8,4,5,0,0,0,7
Geelong,"Bartel, Jimmy",19,10,3,9,1,0,0,15
Geelong,"Bews, Jed",10,6,2,4,0,0,0,4
Geelong,"Blicavs, Mark",11,5,3,6,0,0,19,5
Geelong,"Caddy, Josh",18,8,5,10,0,0,0,6
Geelong,"Christensen, Allen",13,10,2,3,1,0,0,5
Geelong,"Duncan, Mitch",20,11,5,9,2,0,0,10
Geelong,"Enright, Corey",20,12,4,8,0,0,0,3
Geelong,"Guthrie, Cameron",20,8,3,12,0,0,0,11
Geelong,"Hartman, Brad",2,2,0,0,0,0,0,3
Geelong,"Hawkins, Tom",11,8,5,3,2,1,0,0
Geelong,"Horlin-Smith, George",14,7,0,7,0,1,0,2
Geelong,"Johnson, Steve",25,15,5,10,1,1,0,14
Geelong,"Kersten, Shane",8,6,1,2,2,2,0,4
Geelong,"Lonergan, Tom",12,8,4,4,0,0,0,4
Geelong,"Mackie, Andrew",20,17,8,3,0,0,0,5
Geelong,"McIntosh, Hamish",17,10,4,7,0,0,32,3
Geelong,"Motlop, Steven",30,21,5,9,0,2,0,4
Geelong,"Murdoch, Jordan",13,9,4,4,1,1,0,7
Geelong,"Rivers, Jared",12,7,7,5,0,0,0,7
Geelong,"Selwood, Joel",13,5,2,8,0,0,1,11
Geelong,"Taylor, Harry",23,17,11,6,0,0,1,4
Geelong,"Varcoe, Travis",15,6,2,9,0,0,0,2
Geelong,"Bartel, Jimmy",15,10,2,5,1,0,0,6
Geelong,"Blicavs, Mark",12,5,4,7,0,1,14,8
Geelong,"Caddy, Josh",14,5,3,9,0,0,2,12
Geelong,"Christensen, Allen",19,7,5,12,1,1,0,5
Geelong,"Duncan, Mitch",14,10,4,4,1,0,0,3
Geelong,"Enright, Corey",25,13,10,12,0,0,0,1
Geelong,"Guthrie, Cameron",9,5,1,4,1,0,0,6
Geelong,"Hartman, Brad",11,6,1,5,1,0,0,2
Geelong,"Hawkins, Tom",9,8,6,1,3,1,0,2
Geelong,"Horlin-Smith, George",11,8,3,3,0,2,0,5
Geelong,"Johnson, Steve",27,17,8,10,2,0,0,7
Geelong,"Kelly, James",27,19,10,8,0,1,0,4
Geelong,"Kersten, Shane",9,9,6,0,2,1,0,1
Geelong,"Lonergan, Tom",17,13,7,4,0,1,0,1
Geelong,"Mackie, Andrew",10,7,4,3,0,0,0,2
Geelong,"McIntosh, Hamish",20,10,5,10,1,0,26,6
Geelong,"Motlop, Steven",26,18,7,8,1,1,0,2
Geelong,"Murdoch, Jordan",14,8,4,6,0,1,0,3
Geelong,"Rivers, Jared",14,10,8,4,0,0,0,2
Geelong,"Selwood, Joel",31,18,5,13,0,2,0,6
Geelong,"Taylor, Harry",23,15,9,8,0,0,1,1
Geelong,"Varcoe, Travis",17,8,2,9,0,0,0,3
Geelong,"Bartel, Jimmy",16,9,5,7,1,0,1,5
Geelong,"Caddy, Josh",16,7,2,9,2,0,2,4
Geelong,"Duncan, Mitch",25,10,7,15,1,0,0,3
Geelong,"Enright, Corey",30,14,7,16,0,2,0,2
Geelong,"Guthrie, Cameron",27,9,2,18,1,0,0,5
Geelong,"Hartman, Brad",0,0,0,0,0,0,0,0
Geelong,"Hawkins, Tom",15,11,8,4,2,2,1,0
Geelong,"Horlin-Smith, George",23,6,1,17,0,1,0,4
Geelong,"Johnson, Steve",30,19,12,11,3,1,0,4
Geelong,"Kelly, James",21,8,2,13,0,0,0,0
Geelong,"Kersten, Shane",8,6,2,2,0,1,0,3
Geelong,"Lonergan, Tom",12,5,3,7,0,0,0,0
Geelong,"Mackie, Andrew",18,13,6,5,0,0,0,4
Geelong,"McIntosh, Hamish",5,2,1,3,0,1,20,2
Geelong,"Motlop, Steven",28,20,3,8,0,1,0,3
Geelong,"Murdoch, Jordan",10,6,2,4,1,1,0,2
Geelong,"Rivers, Jared",14,8,7,6,0,0,0,0
Geelong,"Selwood, Joel",39,19,8,20,1,3,0,2
Geelong,"Simpson, Dawson",5,2,3,3,1,1,20,0
Geelong,"Stokes, Mathew",28,14,4,14,0,0,0,3
Geelong,"Taylor, Harry",30,14,9,16,0,1,0,2
Geelong,"Varcoe, Travis",17,6,3,11,0,0,0,0
Geelong,"Bartel, Jimmy",21,12,5,9,1,1,0,2
Geelong,"Blicavs, Mark",9,8,6,1,0,0,6,6
Geelong,"Caddy, Josh",18,11,8,7,2,2,0,7
Geelong,"Christensen, Allen",29,17,4,12,1,3,0,3
Geelong,"Duncan, Mitch",24,16,8,8,3,2,0,2
Geelong,"Enright, Corey",17,11,6,6,0,1,0,2
Geelong,"Guthrie, Cameron",20,10,5,10,0,0,0,4
Geelong,"Hawkins, Tom",11,9,6,2,3,1,0,4
Geelong,"Horlin-Smith, George",5,2,0,3,0,0,0,0
Geelong,"Johnson, Steve",20,11,3,9,0,0,0,3
Geelong,"Kelly, James",15,10,5,5,0,0,0,3
Geelong,"Kersten, Shane",5,2,1,3,1,1,0,1
Geelong,"Lonergan, Tom",8,5,6,3,1,0,0,0
Geelong,"Mackie, Andrew",22,15,4,7,0,0,0,0
Geelong,"Motlop, Steven",21,13,6,8,2,1,0,1
Geelong,"Murdoch, Jordan",14,6,3,8,0,0,0,5
Geelong,"Rivers, Jared",9,8,6,1,0,0,0,2
Geelong,"Selwood, Joel",29,19,12,10,1,0,0,4
Geelong,"Simpson, Dawson",6,1,1,5,0,0,25,3
Geelong,"Stokes, Mathew",23,13,3,10,0,0,0,3
Geelong,"Taylor, Harry",17,11,5,6,1,0,0,4
Geelong,"Varcoe, Travis",11,5,2,6,0,0,0,3
Geelong,"Bartel, Jimmy",17,14,6,3,3,2,0,2
Geelong,"Blicavs, Mark",12,8,6,4,0,0,9,8
Geelong,"Caddy, Josh",8,3,2,5,1,0,1,5
Geelong,"Christensen, Allen",22,11,3,11,1,1,0,2
Geelong,"Duncan, Mitch",23,18,6,5,2,1,1,1
Geelong,"Enright, Corey",27,16,7,11,0,0,0,4
Geelong,"Guthrie, Cameron",20,11,3,9,0,0,0,1
Geelong,"Hawkins, Tom",14,10,7,4,1,0,0,3
Geelong,"Horlin-Smith, George",8,2,1,6,0,0,0,2
Geelong,"Johnson, Steve",15,8,1,7,0,0,0,4
Geelong,"Kelly, James",22,17,3,5,0,0,0,7
Geelong,"Kersten, Shane",6,3,3,3,0,0,0,2
Geelong,"Lonergan, Tom",14,5,6,9,0,0,0,3
Geelong,"Mackie, Andrew",22,15,7,7,2,0,0,2
Geelong,"McIntosh, Hamish",18,12,5,6,0,0,20,5
Geelong,"Motlop, Steven",17,13,6,4,1,2,0,2
Geelong,"Murdoch, Jordan",10,4,0,6,0,0,0,2
Geelong,"Rivers, Jared",18,8,11,10,0,0,0,5
Geelong,"Selwood, Joel",27,13,6,14,1,1,0,11
Geelong,"Stokes, Mathew",10,6,2,4,0,1,0,5
Geelong,"Taylor, Harry",27,17,19,10,0,0,0,1
Geelong,"Varcoe, Travis",11,5,1,6,0,1,0,3
Geelong,"Bews, Jed",6,5,3,1,0,0,0,5
Geelong,"Blicavs, Mark",19,10,6,9,1,1,13,3
Geelong,"Caddy, Josh",28,12,6,16,1,2,0,4
Geelong,"Christensen, Allen",20,15,5,5,2,1,0,4
Geelong,"Duncan, Mitch",14,8,5,6,0,0,0,2
Geelong,"Enright, Corey",26,13,2,13,0,0,0,1
Geelong,"Guthrie, Cameron",11,7,5,4,0,0,0,4
Geelong,"Hawkins, Tom",15,10,8,5,0,3,0,2
Geelong,"Horlin-Smith, George",16,11,2,5,1,0,0,3
Geelong,"Kelly, James",22,14,5,8,0,0,0,0
Geelong,"Kersten, Shane",4,3,3,1,0,0,0,3
Geelong,"Lonergan, Tom",13,3,4,10,0,0,0,0
Geelong,"Mackie, Andrew",17,11,7,6,0,1,0,2
Geelong,"McIntosh, Hamish",16,12,8,4,1,2,18,1
Geelong,"Motlop, Steven",18,13,6,5,3,2,0,0
Geelong,"Rivers, Jared",12,10,5,2,0,0,0,3
Geelong,"Selwood, Joel",21,14,5,7,1,0,0,7
Geelong,"Smedts, Billie",13,9,5,4,0,0,0,2
Geelong,"Stokes, Mathew",24,12,2,12,0,0,0,0
Geelong,"Taylor, Harry",24,10,8,14,0,0,0,2
Geelong,"Thurlow, Jackson",3,3,1,0,1,1,0,0
Geelong,"Varcoe, Travis",11,3,0,8,0,0,0,3
Geelong,"Bartel, Jimmy",21,10,4,11,1,0,2,2
Geelong,"Blicavs, Mark",18,5,4,13,0,0,10,3
Geelong,"Caddy, Josh",26,10,2,16,0,0,0,3
Geelong,"Christensen, Allen",24,11,3,13,0,0,0,5
Geelong,"Duncan, Mitch",37,12,7,25,1,0,1,2
Geelong,"Enright, Corey",27,12,6,15,0,0,0,3
Geelong,"Guthrie, Cameron",33,10,2,23,0,1,0,1
Geelong,"Hartman, Brad",11,7,0,4,0,0,0,3
Geelong,"Hawkins, Tom",10,9,6,1,3,1,0,1
Geelong,"Kelly, James",17,11,3,6,0,0,0,3
Geelong,"Kersten, Shane",1,0,0,1,0,0,0,0
Geelong,"Lonergan, Tom",14,12,7,2,0,0,0,1
Geelong,"Mackie, Andrew",29,18,10,11,0,0,0,0
Geelong,"McIntosh, Hamish",16,6,2,10,0,0,17,2
Geelong,"Motlop, Steven",15,8,2,7,1,0,0,1
Geelong,"Murdoch, Jordan",15,8,5,7,2,0,0,2
Geelong,"Rivers, Jared",15,8,6,7,0,0,0,3
Geelong,"Selwood, Joel",24,5,3,19,1,0,0,4
Geelong,"Stokes, Mathew",33,15,5,18,0,0,0,2
Geelong,"Taylor, Harry",12,9,8,3,1,0,0,2
Geelong,"Thurlow, Jackson",10,5,4,5,1,0,0,0
Geelong,"Varcoe, Travis",25,8,8,17,0,0,0,2
Geelong,"Bartel, Jimmy",28,16,6,12,1,0,0,4
Geelong,"Blicavs, Mark",11,3,1,8,0,0,14,6
Geelong,"Brown, Mitch",15,12,5,3,1,1,0,3
Geelong,"Caddy, Josh",24,11,5,13,3,1,0,3
Geelong,"Duncan, Mitch",35,13,8,22,0,0,0,4
Geelong,"Enright, Corey",30,15,8,15,1,1,0,1
Geelong,"Guthrie, Cameron",10,4,2,6,0,0,0,3
Geelong,"Hawkins, Tom",17,11,10,6,7,2,0,3
Geelong,"Horlin-Smith, George",18,8,1,10,0,1,0,4
Geelong,"Kelly, James",20,13,8,7,0,0,0,3
Geelong,"Lonergan, Tom",8,5,3,3,0,0,0,0
Geelong,"Mackie, Andrew",12,7,3,5,0,0,0,0
Geelong,"McCarthy, Lincoln",13,7,3,6,0,2,0,1
Geelong,"Murdoch, Jordan",14,6,3,8,2,2,0,4
Geelong,"Rivers, Jared",11,8,6,3,0,0,0,1
Geelong,"Selwood, Joel",29,15,6,14,2,1,0,9
Geelong,"Smedts, Billie",2,1,1,1,0,0,0,0
Geelong,"Stokes, Mathew",30,13,1,17,1,0,0,3
Geelong,"Taylor, Harry",6,3,0,3,0,0,0,2
Geelong,"Thurlow, Jackson",20,13,8,7,1,0,0,2
Geelong,"Varcoe, Travis",20,9,2,11,1,0,0,6
Geelong,"Walker, Josh",10,6,4,4,1,3,9,2
Geelong,"Bartel, Jimmy",20,13,6,7,2,0,1,6
Geelong,"Blicavs, Mark",20,8,3,12,1,0,14,1
Geelong,"Caddy, Josh",13,6,1,7,0,0,1,4
Geelong,"Duncan, Mitch",22,9,4,13,0,1,0,3
Geelong,"Enright, Corey",21,12,2,9,0,0,0,3
Geelong,"Guthrie, Cameron",25,13,4,12,0,0,0,4
Geelong,"Hawkins, Tom",7,5,2,2,1,2,0,1
Geelong,"Horlin-Smith, George",17,10,5,7,0,0,0,2
Geelong,"Johnson, Steve",17,11,2,6,1,0,0,3
Geelong,"Kelly, James",11,8,2,3,0,0,0,2
Geelong,"Lonergan, Tom",10,6,6,4,0,1,0,0
Geelong,"Mackie, Andrew",9,7,2,2,0,0,0,0
Geelong,"McIntosh, Hamish",8,4,3,4,0,0,15,1
Geelong,"Motlop, Steven",13,6,1,7,0,0,0,0
Geelong,"Murdoch, Jordan",9,7,2,2,1,0,0,2
Geelong,"Rivers, Jared",10,6,2,4,0,0,0,3
Geelong,"Selwood, Joel",31,17,4,14,3,0,0,6
Geelong,"Stokes, Mathew",28,16,5,12,0,0,0,7
Geelong,"Taylor, Harry",14,7,3,7,0,1,0,2
Geelong,"Thurlow, Jackson",1,0,0,1,0,0,0,2
Geelong,"Varcoe, Travis",19,9,5,10,0,0,0,4
Geelong,"Walker, Josh",6,2,3,4,1,0,6,3
Geelong,"Bartel, Jimmy",14,10,4,4,1,1,0,3
Geelong,"Blicavs, Mark",9,4,3,5,1,0,22,6
Geelong,"Brown, Mitch",10,7,5,3,0,0,1,4
Geelong,"Caddy, Josh",26,13,5,13,1,2,1,1
Geelong,"Duncan, Mitch",20,11,5,9,1,0,0,5
Geelong,"Enright, Corey",15,11,6,4,1,0,0,0
Geelong,"Guthrie, Cameron",12,5,1,7,0,0,0,6
Geelong,"Hawkins, Tom",18,15,13,3,5,3,0,1
Geelong,"Horlin-Smith, George",10,4,1,6,0,0,0,3
Geelong,"Kelly, James",9,6,2,3,0,0,0,2
Geelong,"Lonergan, Tom",9,6,3,3,0,0,0,3
Geelong,"Mackie, Andrew",18,14,7,4,0,0,0,0
Geelong,"McCarthy, Lincoln",6,3,0,3,0,1,0,1
Geelong,"Motlop, Steven",14,11,4,3,0,2,0,1
Geelong,"Murdoch, Jordan",7,3,2,4,0,0,0,2
Geelong,"Rivers, Jared",10,6,4,4,0,1,0,1
Geelong,"Selwood, Joel",24,14,5,10,0,0,0,8
Geelong,"Stokes, Mathew",12,7,2,5,0,0,0,2
Geelong,"Taylor, Harry",10,7,4,3,0,0,0,1
Geelong,"Thurlow, Jackson",5,2,0,3,0,0,0,1
Geelong,"Varcoe, Travis",14,9,2,5,0,0,0,5
Geelong,"Walker, Josh",7,5,4,2,3,1,7,3
Greater Western Sydney,"Addison, Dylan",9,3,3,6,0,1,0,5
Greater Western Sydney,"Bugg, Tomas",11,10,3,1,0,0,0,7
Greater Western Sydney,"Cameron, Jeremy",9,7,2,2,4,0,0,0
Greater Western Sydney,"Coniglio, Stephen",27,18,2,9,1,0,0,11
Greater Western Sydney,"Davis, Phil",7,7,4,0,0,0,0,1
Greater Western Sydney,"Frost, Sam",12,8,5,4,1,0,0,2
Greater Western Sydney,"Giles, Jonathan",7,6,2,1,0,2,10,1
Greater Western Sydney,"Greene, Toby",23,13,3,10,1,0,0,3
Greater Western Sydney,"Hampton, Curtly",16,8,2,8,0,0,0,2
Greater Western Sydney,"Haynes, Nick",21,15,4,6,0,0,0,3
Greater Western Sydney,"Hunt, Josh",18,15,7,3,0,0,0,7
Greater Western Sydney,"Kennedy, Adam",15,10,4,5,1,0,0,3
Greater Western Sydney,"Mumford, Shane",13,3,5,10,0,1,45,7
Greater Western Sydney,"Palmer, Rhys",4,2,1,2,0,0,0,0
Greater Western Sydney,"Patton, Jonathon",13,9,4,4,3,1,0,3
Greater Western Sydney,"Scully, Tom",19,6,1,13,1,1,0,6
Greater Western Sydney,"Shaw, Heath",20,19,5,1,0,0,0,3
Greater Western Sydney,"Shiel, Dylan",7,4,0,3,0,0,0,4
Greater Western Sydney,"Smith, Devon",11,8,3,3,1,0,0,4
Greater Western Sydney,"Treloar, Adam",34,16,2,18,0,1,0,8
Greater Western Sydney,"Ward, Callan",31,18,2,13,1,0,3,5
Greater Western Sydney,"Whitfield, Lachie",21,14,3,7,1,0,0,3
Greater Western Sydney,"Addison, Dylan",12,7,5,5,0,0,0,2
Greater Western Sydney,"Bugg, Tomas",18,9,3,9,0,0,0,5
Greater Western Sydney,"Cameron, Jeremy",10,7,3,3,1,3,0,6
Greater Western Sydney,"Coniglio, Stephen",23,13,4,10,0,0,0,5
Greater Western Sydney,"Frost, Sam",12,9,4,3,0,0,0,0
Greater Western Sydney,"Giles, Jonathan",9,6,1,3,4,0,9,4
Greater Western Sydney,"Greene, Toby",26,11,6,15,0,0,0,2
Greater Western Sydney,"Hampton, Curtly",23,12,4,11,0,0,0,1
Greater Western Sydney,"Haynes, Nick",15,12,5,3,0,0,0,2
Greater Western Sydney,"Hunt, Josh",11,6,0,5,0,0,0,1
Greater Western Sydney,"Kelly, Josh",11,4,1,7,0,0,0,3
Greater Western Sydney,"Kennedy, Adam",18,11,9,7,0,0,0,5
Greater Western Sydney,"Mumford, Shane",18,4,2,14,1,0,46,8
Greater Western Sydney,"Patton, Jonathon",6,3,1,3,0,2,0,1
Greater Western Sydney,"Plowman, Lachie",9,7,4,2,0,0,0,2
Greater Western Sydney,"Scully, Tom",23,12,5,11,0,1,0,5
Greater Western Sydney,"Shaw, Heath",14,13,4,1,0,0,0,0
Greater Western Sydney,"Smith, Devon",22,13,5,9,5,1,0,3
Greater Western Sydney,"Townsend, Jacob",10,6,0,4,1,0,0,6
Greater Western Sydney,"Treloar, Adam",23,11,2,12,0,1,0,2
Greater Western Sydney,"Ward, Callan",28,15,5,13,0,0,1,6
Greater Western Sydney,"Whitfield, Lachie",13,6,3,7,1,0,0,0
Greater Western Sydney,"Addison, Dylan",11,5,5,6,0,0,0,4
Greater Western Sydney,"Bugg, Tomas",22,12,6,10,0,1,0,7
Greater Western Sydney,"Cameron, Jeremy",9,8,3,1,2,0,0,2
Greater Western Sydney,"Coniglio, Stephen",27,15,3,12,1,0,0,6
Greater Western Sydney,"Frost, Sam",11,6,3,5,0,0,0,2
Greater Western Sydney,"Giles, Jonathan",8,7,0,1,0,0,16,4
Greater Western Sydney,"Greene, Toby",21,16,1,5,0,1,0,5
Greater Western Sydney,"Hampton, Curtly",20,12,4,8,0,0,0,7
Greater Western Sydney,"Haynes, Nick",12,10,6,2,0,0,0,2
Greater Western Sydney,"Hoskin-Elliott, Will",5,5,1,0,0,1,0,2
Greater Western Sydney,"Hunt, Josh",14,7,2,7,0,0,0,2
Greater Western Sydney,"Kelly, Josh",17,10,0,7,2,0,0,4
Greater Western Sydney,"Kennedy, Adam",14,10,2,4,0,1,0,3
Greater Western Sydney,"Mumford, Shane",10,3,1,7,1,0,60,9
Greater Western Sydney,"Patton, Jonathon",9,6,4,3,2,0,0,4
Greater Western Sydney,"Plowman, Lachie",11,7,3,4,0,1,0,3
Greater Western Sydney,"Scully, Tom",17,8,1,9,0,2,0,6
Greater Western Sydney,"Shaw, Heath",23,17,6,6,0,0,0,2
Greater Western Sydney,"Smith, Devon",19,10,2,9,1,1,0,8
Greater Western Sydney,"Townsend, Jacob",12,10,1,2,0,1,0,8
Greater Western Sydney,"Treloar, Adam",33,19,2,14,1,3,0,14
Greater Western Sydney,"Ward, Callan",26,12,2,14,0,0,3,11
Greater Western Sydney,"Bugg, Tomas",19,9,2,10,0,0,0,4
Greater Western Sydney,"Cameron, Jeremy",8,6,4,2,3,2,0,0
Greater Western Sydney,"Coniglio, Stephen",22,12,5,10,0,1,1,2
Greater Western Sydney,"Frost, Sam",12,6,4,6,0,0,0,0
Greater Western Sydney,"Giles, Jonathan",13,12,2,1,1,1,37,1
Greater Western Sydney,"Greene, Toby",23,10,1,13,1,0,0,3
Greater Western Sydney,"Hampton, Curtly",22,15,4,7,1,1,0,5
Greater Western Sydney,"Haynes, Nick",18,14,3,4,1,0,0,2
Greater Western Sydney,"Hoskin-Elliott, Will",4,2,0,2,0,1,0,0
Greater Western Sydney,"Hunt, Josh",22,15,7,7,0,0,0,2
Greater Western Sydney,"Kelly, Josh",19,9,2,10,1,0,0,5
Greater Western Sydney,"Kennedy, Adam",10,7,1,3,1,0,0,0
Greater Western Sydney,"Lamb, Jed",9,6,1,3,0,0,0,7
Greater Western Sydney,"Patton, Jonathon",13,10,9,3,1,1,0,0
Greater Western Sydney,"Plowman, Lachie",10,3,3,7,0,0,0,4
Greater Western Sydney,"Scully, Tom",21,8,4,13,0,0,0,3
Greater Western Sydney,"Shaw, Heath",27,13,4,14,0,0,1,1
Greater Western Sydney,"Sumner, Liam",5,4,1,1,1,0,0,3
Greater Western Sydney,"Tomlinson, Adam",14,5,5,9,1,1,2,3
Greater Western Sydney,"Townsend, Jacob",5,3,2,2,0,0,0,10
Greater Western Sydney,"Treloar, Adam",23,9,3,14,0,0,0,9
Greater Western Sydney,"Ward, Callan",16,12,0,4,0,0,1,3
Greater Western Sydney,"Boyd, Tom",5,2,2,3,0,0,6,0
Greater Western Sydney,"Bugg, Tomas",13,7,4,6,0,0,0,1
Greater Western Sydney,"Cameron, Jeremy",8,7,4,1,2,2,0,0
Greater Western Sydney,"Coniglio, Stephen",29,15,3,14,0,0,0,8
Greater Western Sydney,"Frost, Sam",9,3,1,6,0,0,0,1
Greater Western Sydney,"Giles, Jonathan",9,6,2,3,0,0,28,3
Greater Western Sydney,"Greene, Toby",28,7,7,21,1,0,0,3
Greater Western Sydney,"Hampton, Curtly",17,10,2,7,0,0,0,1
Greater Western Sydney,"Haynes, Nick",21,15,3,6,0,0,0,0
Greater Western Sydney,"Hoskin-Elliott, Will",17,11,7,6,0,1,0,3
Greater Western Sydney,"Hunt, Josh",15,10,4,5,0,1,0,1
Greater Western Sydney,"Kelly, Josh",20,12,4,8,2,0,0,2
Greater Western Sydney,"Kennedy, Adam",18,6,4,12,0,0,0,2
Greater Western Sydney,"Lamb, Jed",12,10,8,2,2,2,0,4
Greater Western Sydney,"Patton, Jonathon",6,6,4,0,1,2,0,2
Greater Western Sydney,"Plowman, Lachie",5,1,1,4,0,0,0,3
Greater Western Sydney,"Scully, Tom",19,10,4,9,1,0,0,3
Greater Western Sydney,"Smith, Devon",19,12,4,7,0,0,0,1
Greater Western Sydney,"Tomlinson, Adam",10,6,5,4,0,0,0,3
Greater Western Sydney,"Treloar, Adam",23,6,1,17,1,0,0,4
Greater Western Sydney,"Ward, Callan",12,5,4,7,0,0,0,1
Greater Western Sydney,"Williams, Zac",15,9,2,6,0,0,0,3
Greater Western Sydney,"Boyd, Tom",2,2,1,0,0,0,3,0
Greater Western Sydney,"Bugg, Tomas",7,0,1,7,0,0,0,3
Greater Western Sydney,"Cameron, Jeremy",9,7,4,2,4,0,0,1
Greater Western Sydney,"Coniglio, Stephen",27,12,3,15,1,3,0,4
Greater Western Sydney,"Frost, Sam",9,3,2,6,0,0,0,2
Greater Western Sydney,"Giles, Jonathan",7,1,0,6,0,0,42,2
Greater Western Sydney,"Hampton, Curtly",24,12,7,12,0,1,0,4
Greater Western Sydney,"Haynes, Nick",17,11,7,6,0,0,0,0
Greater Western Sydney,"Hoskin-Elliott, Will",16,13,5,3,2,1,0,0
Greater Western Sydney,"Hunt, Josh",18,9,6,9,0,2,0,4
Greater Western Sydney,"Kennedy, Adam",17,13,5,4,1,0,0,2
Greater Western Sydney,"Lamb, Jed",19,11,6,8,1,0,0,3
Greater Western Sydney,"ORourke, Jonathan",14,5,1,9,0,0,0,2
Greater Western Sydney,"Patton, Jonathon",18,12,5,6,2,0,0,1
Greater Western Sydney,"Plowman, Lachie",9,4,2,5,0,1,0,0
Greater Western Sydney,"Scully, Tom",16,6,0,10,0,0,0,7
Greater Western Sydney,"Shaw, Heath",27,19,4,8,0,1,0,3
Greater Western Sydney,"Smith, Devon",16,10,6,6,0,2,0,2
Greater Western Sydney,"Tomlinson, Adam",23,14,8,9,1,0,3,4
Greater Western Sydney,"Treloar, Adam",28,12,3,16,0,0,0,7
Greater Western Sydney,"Ward, Callan",32,11,3,21,1,1,3,5
Greater Western Sydney,"Williams, Zac",9,4,4,5,0,0,0,2
Greater Western Sydney,"Buntine, Matt",10,5,5,5,0,0,0,2
Greater Western Sydney,"Cameron, Jeremy",10,6,3,4,1,0,0,0
Greater Western Sydney,"Coniglio, Stephen",20,9,4,11,0,0,0,3
Greater Western Sydney,"Frost, Sam",14,7,5,7,0,0,0,2
Greater Western Sydney,"Giles, Jonathan",11,9,1,2,1,1,44,4
Greater Western Sydney,"Greene, Toby",22,8,5,14,0,0,0,4
Greater Western Sydney,"Hampton, Curtly",13,9,5,4,0,0,0,6
Greater Western Sydney,"Haynes, Nick",21,15,6,6,0,0,0,2
Greater Western Sydney,"Hoskin-Elliott, Will",20,16,8,4,2,0,0,1
Greater Western Sydney,"Kelly, Josh",21,12,6,9,1,0,0,3
Greater Western Sydney,"Kennedy, Adam",13,8,5,5,0,0,0,4
Greater Western Sydney,"Lamb, Jed",9,4,3,5,1,0,0,3
Greater Western Sydney,"ORourke, Jonathan",7,2,3,5,0,0,0,1
Greater Western Sydney,"Palmer, Rhys",13,10,3,3,2,3,0,0
Greater Western Sydney,"Patton, Jonathon",13,8,6,5,2,0,0,0
Greater Western Sydney,"Scully, Tom",14,7,2,7,1,1,0,6
Greater Western Sydney,"Shaw, Heath",18,13,3,5,0,0,0,3
Greater Western Sydney,"Shiel, Dylan",23,15,4,8,1,0,0,3
Greater Western Sydney,"Smith, Devon",27,17,9,10,3,0,0,5
Greater Western Sydney,"Tomlinson, Adam",12,6,3,6,0,1,1,4
Greater Western Sydney,"Treloar, Adam",22,10,5,12,0,0,0,6
Greater Western Sydney,"Ward, Callan",40,19,11,21,0,0,4,8
Greater Western Sydney,"Buntine, Matt",12,5,2,7,0,0,0,2
Greater Western Sydney,"Coniglio, Stephen",17,8,1,9,0,0,0,4
Greater Western Sydney,"Corr, Aidan",8,4,1,4,0,0,0,3
Greater Western Sydney,"Frost, Sam",13,5,5,8,0,0,0,4
Greater Western Sydney,"Giles, Jonathan",9,5,0,4,1,0,18,3
Greater Western Sydney,"Greene, Toby",33,15,4,18,1,0,0,3
Greater Western Sydney,"Haynes, Nick",2,1,1,1,0,0,0,0
Greater Western Sydney,"Hoskin-Elliott, Will",10,7,3,3,2,0,0,1
Greater Western Sydney,"Hunt, Josh",13,12,6,1,1,0,0,0
Greater Western Sydney,"Kelly, Josh",21,8,1,13,1,0,0,3
Greater Western Sydney,"Kennedy, Adam",21,11,12,10,0,0,0,1
Greater Western Sydney,"Lamb, Jed",6,4,3,2,1,0,0,3
Greater Western Sydney,"Palmer, Rhys",29,15,6,14,1,0,0,2
Greater Western Sydney,"Patton, Jonathon",10,4,3,6,0,1,0,1
Greater Western Sydney,"Phillips, Andrew",7,4,2,3,1,0,6,0
Greater Western Sydney,"Scully, Tom",23,8,3,15,0,0,0,4
Greater Western Sydney,"Shaw, Heath",21,11,6,10,0,0,0,1
Greater Western Sydney,"Shiel, Dylan",22,6,1,16,0,1,0,4
Greater Western Sydney,"Smith, Devon",17,6,1,11,2,1,0,2
Greater Western Sydney,"Tomlinson, Adam",19,11,10,8,1,1,0,1
Greater Western Sydney,"Ward, Callan",29,8,2,21,0,0,5,6
Greater Western Sydney,"Whitfield, Lachie",16,10,7,6,0,0,0,1
Greater Western Sydney,"Addison, Dylan",16,10,7,6,0,1,0,2
Greater Western Sydney,"Cameron, Jeremy",4,3,1,1,1,1,0,2
Greater Western Sydney,"Coniglio, Stephen",19,7,7,12,1,0,0,5
Greater Western Sydney,"Corr, Aidan",12,10,5,2,0,0,0,3
Greater Western Sydney,"Giles, Jonathan",2,1,0,1,0,0,9,2
Greater Western Sydney,"Gilham, Stephen",9,4,4,5,0,0,0,1
Greater Western Sydney,"Hampton, Curtly",18,9,5,9,0,0,1,2
Greater Western Sydney,"Hoskin-Elliott, Will",12,10,2,2,1,3,0,3
Greater Western Sydney,"Kelly, Josh",0,0,0,0,0,0,0,0
Greater Western Sydney,"Kennedy, Adam",17,7,5,10,0,0,0,3
Greater Western Sydney,"Mumford, Shane",8,3,0,5,0,0,20,4
Greater Western Sydney,"Palmer, Rhys",11,6,3,5,1,1,1,4
Greater Western Sydney,"Patton, Jonathon",7,7,4,0,0,1,0,1
Greater Western Sydney,"Scully, Tom",20,10,8,10,1,0,0,4
Greater Western Sydney,"Shaw, Heath",13,12,5,1,0,0,0,1
Greater Western Sydney,"Shiel, Dylan",34,15,3,19,0,0,0,8
Greater Western Sydney,"Smith, Devon",16,11,4,5,0,2,0,4
Greater Western Sydney,"Tomlinson, Adam",20,12,10,8,0,0,2,2
Greater Western Sydney,"Townsend, Jacob",15,7,3,8,0,0,0,8
Greater Western Sydney,"Treloar, Adam",34,16,8,18,0,0,0,3
Greater Western Sydney,"Ward, Callan",19,7,1,12,0,0,1,5
Greater Western Sydney,"Whitfield, Lachie",13,9,4,4,0,0,0,2
Greater Western Sydney,"Addison, Dylan",2,1,0,1,0,0,0,1
Greater Western Sydney,"Cameron, Jeremy",7,6,4,1,1,2,0,3
Greater Western Sydney,"Corr, Aidan",5,3,2,2,0,0,0,0
Greater Western Sydney,"Frost, Sam",14,7,2,7,0,0,0,3
Greater Western Sydney,"Hampton, Curtly",14,7,1,7,0,0,0,3
Greater Western Sydney,"Hoskin-Elliott, Will",13,10,6,3,2,0,0,3
Greater Western Sydney,"Jaksch, Kristian",8,4,2,4,0,0,0,5
Greater Western Sydney,"Kennedy, Adam",15,9,4,6,0,0,0,3
Greater Western Sydney,"Lamb, Jed",13,11,4,2,0,1,0,4
Greater Western Sydney,"Mohr, Tim",16,11,6,5,0,0,0,1
Greater Western Sydney,"Mumford, Shane",10,2,2,8,0,0,46,6
Greater Western Sydney,"Palmer, Rhys",12,6,0,6,2,0,0,5
Greater Western Sydney,"Patton, Jonathon",10,6,4,4,2,1,2,3
Greater Western Sydney,"Scully, Tom",26,16,5,10,0,0,0,5
Greater Western Sydney,"Shaw, Heath",27,22,3,5,0,1,0,6
Greater Western Sydney,"Shiel, Dylan",14,11,3,3,1,0,0,7
Greater Western Sydney,"Smith, Devon",26,13,3,13,4,0,0,10
Greater Western Sydney,"Tomlinson, Adam",12,8,4,4,0,0,1,1
Greater Western Sydney,"Townsend, Jacob",10,5,0,5,0,1,0,11
Greater Western Sydney,"Treloar, Adam",32,16,4,16,1,0,1,6
Greater Western Sydney,"Ward, Callan",29,18,2,11,0,0,6,13
Greater Western Sydney,"Whitfield, Lachie",32,22,9,10,0,0,0,4
Greater Western Sydney,"Coniglio, Stephen",9,7,5,2,0,0,0,3
Greater Western Sydney,"Corr, Aidan",4,1,1,3,0,0,0,5
Greater Western Sydney,"Frost, Sam",11,8,7,3,0,1,0,1
Greater Western Sydney,"Hampton, Curtly",7,6,2,1,0,0,0,2
Greater Western Sydney,"Hoskin-Elliott, Will",13,7,4,6,0,0,0,4
Greater Western Sydney,"Jaksch, Kristian",4,4,2,0,0,0,0,0
Greater Western Sydney,"Kennedy, Adam",18,9,6,9,0,0,0,0
Greater Western Sydney,"Lamb, Jed",11,8,4,3,1,1,0,2
Greater Western Sydney,"Lobb, Rory",7,3,2,4,1,0,2,5
Greater Western Sydney,"Mohr, Tim",17,12,6,5,0,1,0,0
Greater Western Sydney,"Mumford, Shane",15,4,0,11,0,0,37,4
Greater Western Sydney,"Palmer, Rhys",16,8,5,8,2,0,0,3
Greater Western Sydney,"Patton, Jonathon",16,10,4,6,0,1,0,2
Greater Western Sydney,"Scully, Tom",23,10,2,13,0,0,0,2
Greater Western Sydney,"Shaw, Heath",31,30,7,1,0,0,0,3
Greater Western Sydney,"Shiel, Dylan",30,16,6,14,0,1,0,2
Greater Western Sydney,"Smith, Devon",33,28,6,5,1,1,0,3
Greater Western Sydney,"Tomlinson, Adam",18,11,7,7,1,0,0,4
Greater Western Sydney,"Townsend, Jacob",13,7,7,6,0,0,0,4
Greater Western Sydney,"Treloar, Adam",27,20,7,7,3,1,1,5
Greater Western Sydney,"Ward, Callan",27,12,6,15,0,0,0,6
Greater Western Sydney,"Whitfield, Lachie",21,13,8,8,0,1,0,2
Greater Western Sydney,"Bugg, Tomas",17,9,6,8,0,0,0,3
Greater Western Sydney,"Cameron, Jeremy",14,11,7,3,4,4,0,1
Greater Western Sydney,"Coniglio, Stephen",7,7,3,0,0,0,0,2
Greater Western Sydney,"Davis, Phil",10,5,6,5,0,0,0,2
Greater Western Sydney,"Frost, Sam",12,8,5,4,0,0,0,1
Greater Western Sydney,"Hoskin-Elliott, Will",13,7,4,6,1,2,0,4
Greater Western Sydney,"Hunt, Josh",9,8,3,1,1,0,0,1
Greater Western Sydney,"Kelly, Josh",18,8,2,10,0,1,1,5
Greater Western Sydney,"Mohr, Tim",19,17,11,2,0,0,0,3
Greater Western Sydney,"Mumford, Shane",13,4,2,9,0,0,36,5
Greater Western Sydney,"Palmer, Rhys",26,12,3,14,1,0,0,5
Greater Western Sydney,"Patton, Jonathon",11,9,5,2,3,1,5,4
Greater Western Sydney,"Scully, Tom",30,18,6,12,1,0,0,4
Greater Western Sydney,"Shaw, Heath",27,18,8,9,0,0,0,1
Greater Western Sydney,"Shiel, Dylan",27,13,4,14,2,0,0,5
Greater Western Sydney,"Smith, Devon",18,12,3,6,0,1,0,4
Greater Western Sydney,"Tomlinson, Adam",18,9,7,9,2,0,0,3
Greater Western Sydney,"Townsend, Jacob",5,2,0,3,0,1,0,4
Greater Western Sydney,"Treloar, Adam",26,11,4,15,2,0,0,7
Greater Western Sydney,"Ward, Callan",31,22,7,9,0,0,1,7
Greater Western Sydney,"Whitfield, Lachie",32,16,5,16,1,1,0,1
Greater Western Sydney,"Wilson, Nathan",9,7,3,2,1,0,0,1
Greater Western Sydney,"Boyd, Tom",9,4,4,5,1,1,0,2
Greater Western Sydney,"Bugg, Tomas",8,4,2,4,0,0,0,2
Greater Western Sydney,"Coniglio, Stephen",29,17,3,12,0,0,0,8
Greater Western Sydney,"Davis, Phil",15,12,4,3,0,0,0,2
Greater Western Sydney,"Frost, Sam",13,8,4,5,0,0,0,2
Greater Western Sydney,"Hoskin-Elliott, Will",15,12,3,3,2,0,0,5
Greater Western Sydney,"Hunt, Josh",13,12,10,1,0,0,0,1
Greater Western Sydney,"Jaksch, Kristian",10,8,3,2,1,0,0,0
Greater Western Sydney,"Kelly, Josh",21,14,2,7,1,2,0,4
Greater Western Sydney,"Kennedy, Adam",14,7,4,7,0,0,0,0
Greater Western Sydney,"Mohr, Tim",7,2,1,5,0,0,0,2
Greater Western Sydney,"Mumford, Shane",18,5,5,13,0,0,55,9
Greater Western Sydney,"Palmer, Rhys",17,9,2,8,3,0,0,3
Greater Western Sydney,"Patton, Jonathon",13,10,9,3,2,0,2,1
Greater Western Sydney,"Shaw, Heath",20,14,5,6,0,1,0,0
Greater Western Sydney,"Shiel, Dylan",21,12,4,9,2,2,0,10
Greater Western Sydney,"Smith, Devon",15,7,1,8,1,0,0,6
Greater Western Sydney,"Tomlinson, Adam",18,7,8,11,0,0,0,4
Greater Western Sydney,"Treloar, Adam",24,14,3,10,0,0,0,5
Greater Western Sydney,"Ward, Callan",29,17,4,12,1,2,1,8
Greater Western Sydney,"Whitfield, Lachie",20,11,9,9,1,0,0,3
Greater Western Sydney,"Wilson, Nathan",5,4,0,1,0,0,0,0
Greater Western Sydney,"Bugg, Tomas",13,6,0,7,2,0,0,6
Greater Western Sydney,"Cameron, Jeremy",7,6,5,1,2,0,0,3
Greater Western Sydney,"Coniglio, Stephen",26,14,5,12,0,1,0,4
Greater Western Sydney,"Davis, Phil",14,7,5,7,0,0,0,6
Greater Western Sydney,"Frost, Sam",15,4,4,11,0,0,0,3
Greater Western Sydney,"Hoskin-Elliott, Will",10,8,6,2,1,1,0,4
Greater Western Sydney,"Hunt, Josh",11,7,3,4,0,0,0,3
Greater Western Sydney,"Jaksch, Kristian",16,11,5,5,0,1,0,1
Greater Western Sydney,"Kelly, Josh",22,8,1,14,0,1,0,1
Greater Western Sydney,"Kennedy, Adam",12,3,0,9,0,0,0,1
Greater Western Sydney,"Mohr, Tim",16,14,2,2,0,0,0,4
Greater Western Sydney,"Mumford, Shane",8,4,2,4,0,0,33,3
Greater Western Sydney,"Palmer, Rhys",23,10,3,13,0,1,0,4
Greater Western Sydney,"Patton, Jonathon",12,9,4,3,0,1,3,4
Greater Western Sydney,"Shaw, Heath",4,4,2,0,0,0,0,0
Greater Western Sydney,"Shiel, Dylan",24,12,5,12,0,1,0,4
Greater Western Sydney,"Smith, Devon",27,15,2,12,1,0,0,6
Greater Western Sydney,"Tomlinson, Adam",14,6,4,8,0,1,0,2
Greater Western Sydney,"Treloar, Adam",28,8,3,20,0,0,0,6
Greater Western Sydney,"Ward, Callan",22,7,3,15,1,1,4,5
Greater Western Sydney,"Whitfield, Lachie",22,13,8,9,1,1,0,2
Greater Western Sydney,"Wilson, Nathan",12,10,2,2,0,0,0,3
Greater Western Sydney,"Bugg, Tomas",8,6,0,2,1,2,0,3
Greater Western Sydney,"Cameron, Jeremy",6,6,3,0,1,1,0,0
Greater Western Sydney,"Coniglio, Stephen",26,15,3,11,1,0,0,3
Greater Western Sydney,"Davis, Phil",5,2,2,3,0,0,0,1
Greater Western Sydney,"Frost, Sam",9,4,1,5,0,0,0,3
Greater Western Sydney,"Greene, Toby",14,6,7,8,0,0,0,2
Greater Western Sydney,"Hoskin-Elliott, Will",16,10,6,6,1,1,0,4
Greater Western Sydney,"Jaksch, Kristian",8,6,1,2,0,0,0,1
Greater Western Sydney,"Kelly, Josh",10,5,3,5,0,0,0,0
Greater Western Sydney,"Kennedy, Adam",19,7,5,12,0,1,0,2
Greater Western Sydney,"Mohr, Tim",12,10,3,2,0,1,0,5
Greater Western Sydney,"Mumford, Shane",12,4,4,8,1,0,38,5
Greater Western Sydney,"Palmer, Rhys",21,9,4,12,2,3,0,3
Greater Western Sydney,"Patton, Jonathon",15,8,5,7,1,0,0,0
Greater Western Sydney,"Scully, Tom",10,3,1,7,0,0,0,3
Greater Western Sydney,"Shiel, Dylan",25,11,1,14,0,1,0,1
Greater Western Sydney,"Smith, Devon",25,18,3,7,0,2,0,3
Greater Western Sydney,"Tomlinson, Adam",14,10,6,4,0,0,0,2
Greater Western Sydney,"Treloar, Adam",31,12,5,19,0,1,0,4
Greater Western Sydney,"Ward, Callan",14,7,3,7,0,0,0,6
Greater Western Sydney,"Whitfield, Lachie",15,9,3,6,0,2,0,0
Greater Western Sydney,"Williams, Zac",20,14,6,6,1,1,0,5
Greater Western Sydney,"Bugg, Tomas",15,5,5,10,0,0,0,1
Greater Western Sydney,"Buntine, Matt",14,11,6,3,0,0,0,1
Greater Western Sydney,"Cameron, Jeremy",17,12,7,5,2,4,0,0
Greater Western Sydney,"Davis, Phil",23,14,7,9,0,0,0,2
Greater Western Sydney,"Greene, Toby",35,15,7,20,1,0,0,3
Greater Western Sydney,"Hoskin-Elliott, Will",3,1,0,2,0,0,0,1
Greater Western Sydney,"Kelly, Josh",21,11,2,10,0,0,0,4
Greater Western Sydney,"Kennedy, Adam",20,14,4,6,0,0,0,1
Greater Western Sydney,"Lobb, Rory",6,3,3,3,0,0,1,0
Greater Western Sydney,"Mohr, Tim",14,7,4,7,0,0,0,1
Greater Western Sydney,"Mumford, Shane",11,1,1,10,0,0,29,5
Greater Western Sydney,"ORourke, Jonathan",6,1,0,5,0,0,0,0
Greater Western Sydney,"Palmer, Rhys",20,14,6,6,0,0,0,5
Greater Western Sydney,"Plowman, Lachie",4,1,1,3,0,0,0,2
Greater Western Sydney,"Scully, Tom",16,6,1,10,0,0,0,5
Greater Western Sydney,"Shiel, Dylan",29,7,4,22,0,0,0,2
Greater Western Sydney,"Smith, Devon",24,19,8,5,0,1,0,4
Greater Western Sydney,"Tomlinson, Adam",19,12,10,7,2,0,0,6
Greater Western Sydney,"Townsend, Jacob",14,7,4,7,0,0,0,9
Greater Western Sydney,"Ward, Callan",29,9,5,20,1,0,0,10
Greater Western Sydney,"Whitfield, Lachie",20,10,5,10,3,1,0,1
Greater Western Sydney,"Williams, Zac",9,6,2,3,0,0,0,2
Greater Western Sydney,"Boyd, Tom",6,6,3,0,2,1,0,0
Greater Western Sydney,"Bugg, Tomas",19,11,5,8,0,0,0,1
Greater Western Sydney,"Cameron, Jeremy",15,13,10,2,1,2,0,0
Greater Western Sydney,"Davis, Phil",13,8,5,5,0,0,0,0
Greater Western Sydney,"Greene, Toby",32,11,3,21,0,0,0,2
Greater Western Sydney,"Hoskin-Elliott, Will",27,13,7,14,1,3,0,4
Greater Western Sydney,"Hunt, Josh",12,12,8,0,1,0,0,1
Greater Western Sydney,"Kelly, Josh",7,4,3,3,1,0,0,2
Greater Western Sydney,"Kennedy, Adam",17,13,3,4,0,0,0,1
Greater Western Sydney,"Mohr, Tim",9,6,1,3,0,0,0,1
Greater Western Sydney,"Mumford, Shane",12,1,0,11,0,0,29,9
Greater Western Sydney,"ORourke, Jonathan",9,5,2,4,0,0,0,2
Greater Western Sydney,"Palmer, Rhys",16,9,5,7,1,1,0,0
Greater Western Sydney,"Patton, Jonathon",15,11,9,4,2,1,3,1
Greater Western Sydney,"Plowman, Lachie",7,7,4,0,0,0,0,1
Greater Western Sydney,"Scully, Tom",20,11,6,9,0,0,0,5
Greater Western Sydney,"Shiel, Dylan",14,8,6,6,2,1,0,4
Greater Western Sydney,"Smith, Devon",20,12,2,8,0,0,0,3
Greater Western Sydney,"Tomlinson, Adam",20,10,7,10,0,0,0,0
Greater Western Sydney,"Treloar, Adam",30,17,3,13,0,1,0,2
Greater Western Sydney,"Ward, Callan",31,11,4,20,1,2,1,5
Greater Western Sydney,"Williams, Zac",16,6,2,10,0,0,0,4
Greater Western Sydney,"Boyd, Tom",8,5,4,3,2,0,3,0
Greater Western Sydney,"Bugg, Tomas",14,7,1,7,0,0,0,2
Greater Western Sydney,"Davis, Phil",16,9,5,7,0,0,0,1
Greater Western Sydney,"Frost, Sam",16,8,5,8,0,0,0,0
Greater Western Sydney,"Golds, Tim",10,5,3,5,0,0,0,1
Greater Western Sydney,"Greene, Toby",27,9,4,18,0,0,0,10
Greater Western Sydney,"Hoskin-Elliott, Will",16,13,13,3,1,1,0,1
Greater Western Sydney,"Hunt, Josh",9,4,2,5,0,0,0,1
Greater Western Sydney,"Kelly, Josh",13,9,5,4,0,0,0,3
Greater Western Sydney,"Kennedy, Adam",22,8,6,14,0,0,0,3
Greater Western Sydney,"Mumford, Shane",15,3,3,12,0,0,22,4
Greater Western Sydney,"ORourke, Jonathan",13,7,3,6,0,0,0,3
Greater Western Sydney,"Palmer, Rhys",12,7,6,5,1,0,0,4
Greater Western Sydney,"Patton, Jonathon",12,10,9,2,2,3,1,0
Greater Western Sydney,"Plowman, Lachie",10,7,3,3,0,0,0,0
Greater Western Sydney,"Shaw, Heath",23,17,4,6,0,0,0,1
Greater Western Sydney,"Shiel, Dylan",24,16,6,8,0,0,0,5
Greater Western Sydney,"Smith, Devon",18,11,3,7,0,1,0,8
Greater Western Sydney,"Tomlinson, Adam",12,9,7,3,0,1,0,1
Greater Western Sydney,"Treloar, Adam",29,13,8,16,1,1,0,4
Greater Western Sydney,"Ward, Callan",26,13,4,13,1,3,2,2
Greater Western Sydney,"Williams, Zac",13,7,3,6,0,0,0,0
Greater Western Sydney,"Boyd, Tom",6,3,3,3,0,1,6,0
Greater Western Sydney,"Bugg, Tomas",6,3,1,3,0,0,0,0
Greater Western Sydney,"Buntine, Matt",16,8,4,8,0,0,0,0
Greater Western Sydney,"Davis, Phil",9,6,7,3,0,0,0,1
Greater Western Sydney,"Golds, Tim",6,3,0,3,0,0,0,0
Greater Western Sydney,"Greene, Toby",35,10,9,25,0,0,0,5
Greater Western Sydney,"Hoskin-Elliott, Will",7,6,4,1,1,2,0,1
Greater Western Sydney,"Kelly, Josh",17,8,4,9,1,1,0,2
Greater Western Sydney,"Kennedy, Adam",12,10,8,2,0,0,0,2
Greater Western Sydney,"Lamb, Jed",5,4,2,1,0,1,0,0
Greater Western Sydney,"Mumford, Shane",17,6,2,11,0,1,19,1
Greater Western Sydney,"ORourke, Jonathan",21,9,6,12,0,0,0,1
Greater Western Sydney,"Palmer, Rhys",11,6,0,5,0,0,0,6
Greater Western Sydney,"Patton, Jonathon",15,8,6,7,2,1,4,0
Greater Western Sydney,"Plowman, Lachie",8,5,3,3,0,0,0,1
Greater Western Sydney,"Shaw, Heath",31,27,8,4,0,0,0,3
Greater Western Sydney,"Shiel, Dylan",21,10,7,11,0,1,0,4
Greater Western Sydney,"Smith, Devon",21,12,9,9,2,0,0,4
Greater Western Sydney,"Tomlinson, Adam",13,8,6,5,0,0,0,1
Greater Western Sydney,"Treloar, Adam",24,8,4,16,1,0,0,4
Greater Western Sydney,"Ward, Callan",16,10,3,6,0,1,1,2
Greater Western Sydney,"Williams, Zac",13,7,4,6,0,0,0,0
Greater Western Sydney,"Boyd, Tom",10,4,3,6,1,0,4,2
Greater Western Sydney,"Bugg, Tomas",33,19,9,14,0,0,0,4
Greater Western Sydney,"Buntine, Matt",21,17,12,4,0,0,0,3
Greater Western Sydney,"Davis, Phil",2,1,2,1,0,0,0,0
Greater Western Sydney,"Greene, Toby",29,16,9,13,0,0,0,7
Greater Western Sydney,"Hoskin-Elliott, Will",16,12,8,4,3,1,0,3
Greater Western Sydney,"Kelly, Josh",27,18,9,9,2,0,0,7
Greater Western Sydney,"Kennedy, Adam",18,11,8,7,0,0,0,2
Greater Western Sydney,"Mumford, Shane",10,3,3,7,1,0,21,5
Greater Western Sydney,"ORourke, Jonathan",19,8,7,11,0,0,0,2
Greater Western Sydney,"Palmer, Rhys",17,11,3,6,4,2,0,2
Greater Western Sydney,"Patton, Jonathon",1,1,1,0,0,0,0,0
Greater Western Sydney,"Plowman, Lachie",14,5,4,9,0,0,0,4
Greater Western Sydney,"Shaw, Heath",16,14,6,2,0,0,0,1
Greater Western Sydney,"Shiel, Dylan",25,12,5,13,1,0,2,7
Greater Western Sydney,"Smith, Devon",31,24,10,7,2,1,0,5
Greater Western Sydney,"Stewart, James",12,7,3,5,0,2,0,0
Greater Western Sydney,"Tomlinson, Adam",24,19,12,5,0,0,0,0
Greater Western Sydney,"Treloar, Adam",26,11,2,15,1,1,0,6
Greater Western Sydney,"Ward, Callan",11,7,4,4,0,0,1,1
Greater Western Sydney,"Whiley, Mark",19,11,7,8,0,0,0,2
Greater Western Sydney,"Wilson, Nathan",18,14,6,4,0,1,0,0
Greater Western Sydney,"Boyd, Tom",3,1,1,2,1,0,2,4
Greater Western Sydney,"Bugg, Tomas",21,11,4,10,1,0,0,9
Greater Western Sydney,"Buntine, Matt",15,6,5,9,0,0,0,1
Greater Western Sydney,"Frost, Sam",11,5,2,6,0,0,1,0
Greater Western Sydney,"Golds, Tim",11,7,4,4,0,0,0,1
Greater Western Sydney,"Greene, Toby",42,30,7,12,1,1,0,5
Greater Western Sydney,"Hoskin-Elliott, Will",14,11,3,3,1,2,0,5
Greater Western Sydney,"Hunt, Josh",13,6,4,7,1,1,0,3
Greater Western Sydney,"Kelly, Josh",28,17,6,11,0,2,0,6
Greater Western Sydney,"Kennedy, Adam",18,6,2,12,0,0,0,1
Greater Western Sydney,"Mumford, Shane",15,5,1,10,0,0,46,9
Greater Western Sydney,"ORourke, Jonathan",5,0,0,5,0,0,0,0
Greater Western Sydney,"Palmer, Rhys",22,9,1,13,1,1,1,2
Greater Western Sydney,"Plowman, Lachie",16,12,5,4,0,0,0,8
Greater Western Sydney,"Shaw, Heath",15,12,3,3,0,0,0,1
Greater Western Sydney,"Shiel, Dylan",22,9,3,13,0,1,0,7
Greater Western Sydney,"Smith, Devon",24,10,0,14,2,1,0,8
Greater Western Sydney,"Stewart, James",10,7,2,3,0,2,0,0
Greater Western Sydney,"Tomlinson, Adam",14,12,4,2,0,0,0,2
Greater Western Sydney,"Treloar, Adam",27,12,2,15,0,0,0,5
Greater Western Sydney,"Whiley, Mark",17,9,3,8,1,0,0,9
Greater Western Sydney,"Wilson, Nathan",14,9,7,5,0,0,0,2
Greater Western Sydney,"Boyd, Tom",6,4,2,2,1,0,2,1
Greater Western Sydney,"Bugg, Tomas",10,5,4,5,0,0,0,5
Greater Western Sydney,"Buntine, Matt",15,10,5,5,0,0,0,1
Greater Western Sydney,"Davis, Phil",19,10,8,9,0,0,0,2
Greater Western Sydney,"Greene, Toby",32,20,8,12,1,0,0,5
Greater Western Sydney,"Hampton, Curtly",11,7,4,4,0,0,0,6
Greater Western Sydney,"Hoskin-Elliott, Will",15,13,6,2,5,0,0,1
Greater Western Sydney,"Hunt, Josh",18,12,5,6,0,0,0,2
Greater Western Sydney,"Kelly, Josh",19,11,4,8,1,0,0,4
Greater Western Sydney,"McCarthy, Cam",5,3,2,2,1,0,0,2
Greater Western Sydney,"Mumford, Shane",11,3,5,8,0,0,36,6
Greater Western Sydney,"Palmer, Rhys",13,4,3,9,2,0,0,1
Greater Western Sydney,"Plowman, Lachie",11,8,5,3,0,1,0,1
Greater Western Sydney,"Shaw, Heath",29,23,12,6,0,0,0,1
Greater Western Sydney,"Shiel, Dylan",31,9,3,22,0,2,0,5
Greater Western Sydney,"Smith, Devon",23,18,5,5,1,0,0,2
Greater Western Sydney,"Stewart, James",12,10,4,2,3,0,0,3
Greater Western Sydney,"Sumner, Liam",4,3,1,1,0,0,0,0
Greater Western Sydney,"Tomlinson, Adam",13,6,4,7,0,1,0,4
Greater Western Sydney,"Treloar, Adam",28,10,1,18,2,1,0,4
Greater Western Sydney,"Williams, Zac",20,10,5,10,1,2,0,5
Greater Western Sydney,"Wilson, Nathan",8,7,3,1,0,0,0,2
Hawthorn,"Birchall, Grant",31,18,8,13,0,0,0,0
Hawthorn,"Breust, Luke",22,11,6,11,5,0,0,2
Hawthorn,"Burgoyne, Shaun",23,10,5,13,0,0,0,5
Hawthorn,"Cheney, Kyle",8,5,3,3,0,0,0,0
Hawthorn,"Duryea, Taylor",19,12,6,7,0,0,0,1
Hawthorn,"Gibson, Josh",10,5,2,5,0,0,0,3
Hawthorn,"Gunston, Jack",14,12,8,2,2,3,0,3
Hawthorn,"Hale, David",19,8,6,11,0,1,18,1
Hawthorn,"Hill, Bradley",26,11,4,15,0,0,0,2
Hawthorn,"Hodge, Luke",19,15,8,4,0,0,1,3
Hawthorn,"Langford, Will",16,12,2,4,0,1,2,6
Hawthorn,"Lewis, Jordan",22,14,6,8,1,0,1,7
Hawthorn,"McEvoy, Ben",13,5,6,8,1,0,22,3
Hawthorn,"Mitchell, Sam",21,11,2,10,1,0,1,1
Hawthorn,"OBrien, Tim",6,2,2,4,1,0,0,1
Hawthorn,"Puopolo, Paul",18,8,4,10,0,2,0,1
Hawthorn,"Roughead, Jarryd",19,13,5,6,5,1,0,1
Hawthorn,"Shiels, Liam",21,17,2,4,2,1,0,8
Hawthorn,"Simpkin, Jonathan",23,8,3,15,0,0,0,3
Hawthorn,"Smith, Isaac",26,19,7,7,2,1,1,0
Hawthorn,"Suckling, Matt",18,14,8,4,1,0,0,2
Hawthorn,"Wanganeen, Derick",4,1,1,3,0,0,0,2
Hawthorn,"Birchall, Grant",16,6,3,10,0,0,0,0
Hawthorn,"Breust, Luke",14,7,4,7,2,1,0,0
Hawthorn,"Burgoyne, Shaun",30,21,7,9,0,0,0,5
Hawthorn,"Cheney, Kyle",15,9,4,6,0,0,0,0
Hawthorn,"Duryea, Taylor",9,4,1,5,0,0,0,2
Hawthorn,"Gibson, Josh",22,16,5,6,0,0,0,2
Hawthorn,"Gunston, Jack",11,11,8,0,1,2,0,3
Hawthorn,"Hale, David",6,4,1,2,1,1,20,3
Hawthorn,"Hill, Bradley",22,14,7,8,1,1,0,3
Hawthorn,"Hodge, Luke",10,10,5,0,0,0,0,1
Hawthorn,"Langford, Will",13,8,2,5,0,1,1,1
Hawthorn,"Lewis, Jordan",13,7,3,6,1,0,2,4
Hawthorn,"Litherland, Angus",10,4,2,6,0,0,0,1
Hawthorn,"McEvoy, Ben",14,9,5,5,0,0,28,2
Hawthorn,"OBrien, Tim",4,2,1,2,0,0,0,1
Hawthorn,"Puopolo, Paul",16,9,2,7,1,0,0,6
Hawthorn,"Rioli, Cyril",19,14,5,5,2,3,0,1
Hawthorn,"Roughead, Jarryd",10,8,3,2,1,0,0,2
Hawthorn,"Shiels, Liam",16,12,6,4,0,2,0,5
Hawthorn,"Simpkin, Jonathan",9,6,2,3,1,0,0,0
Hawthorn,"Smith, Isaac",17,12,6,5,0,0,0,3
Hawthorn,"Suckling, Matt",18,12,1,6,2,0,0,1
Hawthorn,"Birchall, Grant",29,17,7,12,1,1,0,0
Hawthorn,"Breust, Luke",24,12,7,12,3,0,0,4
Hawthorn,"Burgoyne, Shaun",24,11,4,13,0,0,0,5
Hawthorn,"Ceglar, Jonathon",10,1,3,9,0,0,12,1
Hawthorn,"Cheney, Kyle",19,12,4,7,0,0,0,1
Hawthorn,"Duryea, Taylor",20,19,10,1,0,0,0,1
Hawthorn,"Gibson, Josh",25,12,7,13,0,0,0,1
Hawthorn,"Gunston, Jack",19,12,7,7,2,0,0,1
Hawthorn,"Hale, David",12,8,6,4,1,0,14,5
Hawthorn,"Hill, Bradley",30,19,9,11,1,0,0,0
Hawthorn,"Langford, Will",14,5,1,9,1,0,0,2
Hawthorn,"Lewis, Jordan",37,19,3,18,0,0,4,2
Hawthorn,"Litherland, Angus",2,2,0,0,0,0,0,0
Hawthorn,"Mitchell, Sam",36,17,5,19,0,0,0,4
Hawthorn,"Puopolo, Paul",19,13,6,6,3,2,0,1
Hawthorn,"Rioli, Cyril",20,13,5,7,2,0,1,2
Hawthorn,"Roughead, Jarryd",22,13,4,9,2,1,0,1
Hawthorn,"Shiels, Liam",26,15,6,11,1,1,0,2
Hawthorn,"Simpkin, Jonathan",30,15,12,15,0,0,0,1
Hawthorn,"Smith, Isaac",30,21,12,9,3,1,1,1
Hawthorn,"Spangher, Matthew",14,9,4,5,0,0,0,1
Hawthorn,"Suckling, Matt",30,21,8,9,1,1,0,2
Hawthorn,"Birchall, Grant",27,11,7,16,0,0,0,1
Hawthorn,"Breust, Luke",20,6,2,14,2,1,0,3
Hawthorn,"Burgoyne, Shaun",25,13,7,12,0,0,0,2
Hawthorn,"Ceglar, Jonathon",17,5,1,12,0,0,19,1
Hawthorn,"Cheney, Kyle",15,11,6,4,0,0,0,1
Hawthorn,"Duryea, Taylor",18,11,3,7,0,0,0,3
Hawthorn,"Gibson, Josh",31,17,10,14,0,0,0,1
Hawthorn,"Gunston, Jack",25,19,10,6,5,0,0,2
Hawthorn,"Hale, David",7,4,1,3,1,1,15,1
Hawthorn,"Hill, Bradley",23,15,6,8,1,0,0,7
Hawthorn,"Hodge, Luke",32,23,9,9,0,0,0,3
Hawthorn,"Langford, Will",19,8,1,11,0,0,0,4
Hawthorn,"Lewis, Jordan",26,16,12,10,0,2,4,3
Hawthorn,"Mitchell, Sam",36,15,6,21,2,0,0,2
Hawthorn,"Puopolo, Paul",12,6,0,6,1,1,0,7
Hawthorn,"Rioli, Cyril",11,8,4,3,2,0,0,2
Hawthorn,"Roughead, Jarryd",17,11,2,6,4,1,1,1
Hawthorn,"Shiels, Liam",26,19,3,7,1,0,2,4
Hawthorn,"Simpkin, Jonathan",14,11,3,3,1,0,0,0
Hawthorn,"Smith, Isaac",24,16,4,8,1,1,3,2
Hawthorn,"Spangher, Matthew",10,7,3,3,0,0,0,1
Hawthorn,"Suckling, Matt",30,18,4,12,2,0,0,1
Hawthorn,"Birchall, Grant",28,16,5,12,0,0,0,0
Hawthorn,"Breust, Luke",13,7,2,6,3,2,0,2
Hawthorn,"Burgoyne, Shaun",16,7,4,9,0,0,0,6
Hawthorn,"Cheney, Kyle",17,10,4,7,0,0,0,3
Hawthorn,"Duryea, Taylor",14,8,5,6,1,0,0,2
Hawthorn,"Gibson, Josh",14,8,5,6,0,0,0,3
Hawthorn,"Gunston, Jack",15,10,9,5,3,2,0,2
Hawthorn,"Hale, David",13,5,4,8,1,1,16,3
Hawthorn,"Hallahan, Mitch",6,4,3,2,1,0,0,0
Hawthorn,"Hill, Bradley",25,12,4,13,0,0,0,3
Hawthorn,"Hodge, Luke",21,13,7,8,0,0,0,2
Hawthorn,"Langford, Will",13,4,0,9,0,0,0,4
Hawthorn,"Lewis, Jordan",21,7,3,14,0,0,5,2
Hawthorn,"McEvoy, Ben",8,3,3,5,1,0,8,3
Hawthorn,"Mitchell, Sam",26,19,1,7,0,0,0,3
Hawthorn,"Puopolo, Paul",14,8,1,6,0,1,0,8
Hawthorn,"Rioli, Cyril",7,5,3,2,1,1,0,5
Hawthorn,"Roughead, Jarryd",15,12,3,3,0,2,1,0
Hawthorn,"Simpkin, Jonathan",26,12,6,14,0,0,0,3
Hawthorn,"Smith, Isaac",19,11,2,8,1,0,0,0
Hawthorn,"Stratton, Ben",6,2,1,4,0,0,0,5
Hawthorn,"Suckling, Matt",19,12,4,7,0,1,0,0
Hawthorn,"Birchall, Grant",26,13,6,13,0,0,0,0
Hawthorn,"Breust, Luke",13,6,4,7,2,0,0,2
Hawthorn,"Burgoyne, Shaun",24,13,4,11,1,0,0,3
Hawthorn,"Duryea, Taylor",19,11,6,8,0,1,0,2
Hawthorn,"Gibson, Josh",17,8,3,9,0,0,0,5
Hawthorn,"Gunston, Jack",15,8,4,7,2,0,0,2
Hawthorn,"Hale, David",14,7,8,7,2,2,14,1
Hawthorn,"Hallahan, Mitch",20,12,6,8,0,0,0,4
Hawthorn,"Hill, Bradley",23,10,4,13,1,0,0,1
Hawthorn,"Hodge, Luke",30,21,4,9,2,1,0,2
Hawthorn,"Lake, Brian",11,8,5,3,0,0,0,2
Hawthorn,"Langford, Will",20,8,1,12,0,0,1,8
Hawthorn,"Lewis, Jordan",24,14,6,10,1,1,4,2
Hawthorn,"McEvoy, Ben",22,4,6,18,1,0,22,6
Hawthorn,"Mitchell, Sam",36,23,12,13,0,1,0,4
Hawthorn,"Puopolo, Paul",14,8,4,6,1,0,0,6
Hawthorn,"Rioli, Cyril",17,10,4,7,4,0,0,6
Hawthorn,"Roughead, Jarryd",14,8,4,6,1,1,2,3
Hawthorn,"Simpkin, Jonathan",8,6,2,2,0,0,0,1
Hawthorn,"Smith, Isaac",19,12,8,7,0,0,2,4
Hawthorn,"Stratton, Ben",11,7,5,4,0,0,0,1
Hawthorn,"Suckling, Matt",22,13,6,9,0,0,0,0
Hawthorn,"Birchall, Grant",34,18,7,16,0,2,0,2
Hawthorn,"Breust, Luke",29,12,5,17,4,0,0,6
Hawthorn,"Burgoyne, Shaun",33,24,5,9,2,0,0,2
Hawthorn,"Duryea, Taylor",18,8,5,10,0,0,0,1
Hawthorn,"Gibson, Josh",30,16,8,14,0,0,0,2
Hawthorn,"Gunston, Jack",24,11,8,13,4,2,0,1
Hawthorn,"Hale, David",7,4,5,3,2,0,15,1
Hawthorn,"Hallahan, Mitch",18,5,4,13,0,0,0,2
Hawthorn,"Hartung, Billy",26,16,6,10,1,1,0,3
Hawthorn,"Hill, Bradley",24,12,1,12,1,1,0,0
Hawthorn,"Hodge, Luke",33,23,8,10,0,1,0,2
Hawthorn,"Lake, Brian",11,4,4,7,0,0,0,1
Hawthorn,"Lewis, Jordan",27,10,7,17,1,0,3,7
Hawthorn,"Litherland, Angus",10,6,1,4,0,0,0,1
Hawthorn,"McEvoy, Ben",12,2,3,10,0,0,30,4
Hawthorn,"Mitchell, Sam",4,1,0,3,0,0,0,0
Hawthorn,"Puopolo, Paul",16,11,3,5,2,0,0,5
Hawthorn,"Rioli, Cyril",24,13,6,11,2,1,0,7
Hawthorn,"Roughead, Jarryd",23,14,5,9,4,2,2,2
Hawthorn,"Schoenmakers, Ryan",15,9,6,6,4,1,0,3
Hawthorn,"Smith, Isaac",29,18,4,11,0,0,0,4
Hawthorn,"Suckling, Matt",31,24,12,7,0,1,0,0
Hawthorn,"Birchall, Grant",22,13,3,9,1,0,0,3
Hawthorn,"Breust, Luke",13,7,5,6,3,0,0,0
Hawthorn,"Burgoyne, Shaun",28,13,1,15,0,1,0,4
Hawthorn,"Cheney, Kyle",19,9,1,10,0,0,0,2
Hawthorn,"Duryea, Taylor",20,10,6,10,1,0,0,2
Hawthorn,"Gibson, Josh",14,7,5,7,0,0,0,2
Hawthorn,"Gunston, Jack",11,8,3,3,0,2,0,1
Hawthorn,"Hale, David",11,5,2,6,1,0,20,1
Hawthorn,"Hallahan, Mitch",25,6,1,19,0,0,0,5
Hawthorn,"Hartung, Billy",7,3,3,4,0,0,0,0
Hawthorn,"Hill, Bradley",18,13,4,5,0,2,0,3
Hawthorn,"Langford, Will",23,15,4,8,0,0,1,5
Hawthorn,"Lewis, Jordan",28,11,2,17,0,0,6,3
Hawthorn,"McEvoy, Ben",15,5,5,10,0,0,30,2
Hawthorn,"Puopolo, Paul",21,10,4,11,1,0,0,1
Hawthorn,"Rioli, Cyril",11,7,3,4,0,0,0,2
Hawthorn,"Roughead, Jarryd",13,9,5,4,3,1,1,6
Hawthorn,"Schoenmakers, Ryan",15,12,4,3,0,0,0,1
Hawthorn,"Simpkin, Jonathan",15,8,3,7,2,2,0,4
Hawthorn,"Smith, Isaac",22,12,4,10,0,0,1,3
Hawthorn,"Stratton, Ben",6,3,2,3,0,0,0,2
Hawthorn,"Suckling, Matt",14,9,3,5,1,0,0,2
Hawthorn,"Birchall, Grant",22,13,4,9,1,0,0,2
Hawthorn,"Breust, Luke",14,10,2,4,3,0,0,4
Hawthorn,"Burgoyne, Shaun",24,14,1,10,2,0,1,5
Hawthorn,"Ceglar, Jonathon",15,7,6,8,0,0,9,0
Hawthorn,"Duryea, Taylor",16,12,6,4,0,0,0,2
Hawthorn,"Gunston, Jack",16,12,10,4,3,1,0,1
Hawthorn,"Hale, David",6,2,1,4,0,1,14,4
Hawthorn,"Hallahan, Mitch",20,9,4,11,1,3,0,7
Hawthorn,"Hartung, Billy",17,11,3,6,1,0,0,2
Hawthorn,"Hill, Bradley",18,8,2,10,0,0,0,4
Hawthorn,"Hodge, Luke",20,11,3,9,0,0,2,1
Hawthorn,"Langford, Will",14,5,2,9,0,0,0,4
Hawthorn,"Lewis, Jordan",38,16,7,22,2,0,1,2
Hawthorn,"McEvoy, Ben",5,0,2,5,0,0,9,0
Hawthorn,"Puopolo, Paul",22,8,3,14,0,0,0,5
Hawthorn,"Schoenmakers, Ryan",19,12,5,7,0,0,0,3
Hawthorn,"Sewell, Brad",18,8,1,10,0,0,0,3
Hawthorn,"Shiels, Liam",23,12,4,11,0,0,0,9
Hawthorn,"Simpkin, Jonathan",18,9,0,9,0,1,0,2
Hawthorn,"Smith, Isaac",27,16,5,11,0,0,3,5
Hawthorn,"Stratton, Ben",18,8,6,10,0,0,0,5
Hawthorn,"Suckling, Matt",28,17,8,11,0,1,0,4
Hawthorn,"Birchall, Grant",24,14,4,10,0,1,0,3
Hawthorn,"Breust, Luke",13,7,3,6,2,0,1,3
Hawthorn,"Burgoyne, Shaun",18,11,4,7,0,0,0,6
Hawthorn,"Ceglar, Jonathon",13,5,4,8,0,0,32,2
Hawthorn,"Cheney, Kyle",18,13,5,5,0,0,0,1
Hawthorn,"Duryea, Taylor",11,8,2,3,0,1,0,2
Hawthorn,"Gunston, Jack",11,9,4,2,4,0,0,6
Hawthorn,"Hale, David",5,2,0,3,0,1,13,1
Hawthorn,"Hallahan, Mitch",16,6,0,10,0,1,1,6
Hawthorn,"Hartung, Billy",13,7,3,6,0,0,0,1
Hawthorn,"Hill, Bradley",18,10,2,8,0,1,0,4
Hawthorn,"Hodge, Luke",26,14,2,12,0,0,2,1
Hawthorn,"Langford, Will",20,11,1,9,1,0,1,8
Hawthorn,"Litherland, Angus",19,12,2,7,0,0,0,8
Hawthorn,"Puopolo, Paul",14,5,4,9,0,0,0,5
Hawthorn,"Roughead, Jarryd",11,7,3,4,2,1,2,4
Hawthorn,"Schoenmakers, Ryan",14,13,4,1,0,0,0,0
Hawthorn,"Sewell, Brad",23,14,2,9,1,0,0,7
Hawthorn,"Shiels, Liam",24,17,4,7,0,1,0,5
Hawthorn,"Simpkin, Jonathan",22,13,6,9,0,0,0,4
Hawthorn,"Smith, Isaac",23,12,7,11,4,0,3,2
Hawthorn,"Suckling, Matt",21,14,7,7,0,0,0,3
Hawthorn,"Birchall, Grant",22,13,3,9,0,0,0,2
Hawthorn,"Breust, Luke",9,2,1,7,1,0,0,7
Hawthorn,"Burgoyne, Shaun",18,7,4,11,0,1,2,3
Hawthorn,"Ceglar, Jonathon",9,5,2,4,0,0,24,3
Hawthorn,"Cheney, Kyle",11,4,4,7,0,0,0,3
Hawthorn,"Duryea, Taylor",19,14,5,5,0,0,0,0
Hawthorn,"Gunston, Jack",13,8,3,5,3,2,0,1
Hawthorn,"Hartung, Billy",2,2,0,0,0,0,0,2
Hawthorn,"Hill, Bradley",20,11,2,9,0,0,0,1
Hawthorn,"Hodge, Luke",28,17,4,11,1,1,2,7
Hawthorn,"Lewis, Jordan",30,11,7,19,0,0,6,4
Hawthorn,"Litherland, Angus",15,10,2,5,0,0,0,1
Hawthorn,"Lowden, Luke",12,6,0,6,3,0,15,2
Hawthorn,"Puopolo, Paul",15,6,2,9,0,0,0,5
Hawthorn,"Rioli, Cyril",16,9,5,7,1,0,0,4
Hawthorn,"Roughead, Jarryd",24,17,8,7,8,2,0,6
Hawthorn,"Schoenmakers, Ryan",11,5,2,6,0,0,0,0
Hawthorn,"Sewell, Brad",14,6,4,8,0,0,0,8
Hawthorn,"Shiels, Liam",24,15,6,9,0,0,0,8
Hawthorn,"Smith, Isaac",24,15,4,9,1,3,1,6
Hawthorn,"Spangher, Matthew",22,14,10,8,0,0,0,3
Hawthorn,"Suckling, Matt",21,9,3,12,1,0,0,1
Hawthorn,"Birchall, Grant",23,12,5,11,0,0,0,1
Hawthorn,"Breust, Luke",17,10,1,7,1,0,0,4
Hawthorn,"Burgoyne, Shaun",17,8,3,9,0,0,1,5
Hawthorn,"Ceglar, Jonathon",16,10,4,6,2,0,22,2
Hawthorn,"Cheney, Kyle",15,8,6,7,0,0,0,1
Hawthorn,"Duryea, Taylor",18,10,5,8,0,0,0,2
Hawthorn,"Hale, David",5,3,1,2,1,0,13,3
Hawthorn,"Hill, Bradley",21,13,4,8,1,0,0,2
Hawthorn,"Hodge, Luke",21,15,4,6,0,0,2,3
Hawthorn,"Lewis, Jordan",22,7,6,15,0,0,2,2
Hawthorn,"Litherland, Angus",8,5,2,3,0,0,0,1
Hawthorn,"OBrien, Tim",8,5,5,3,1,0,0,2
Hawthorn,"Puopolo, Paul",16,8,6,8,0,0,0,3
Hawthorn,"Rioli, Cyril",20,12,5,8,3,3,0,3
Hawthorn,"Ross, Ben",5,4,2,1,1,0,0,1
Hawthorn,"Roughead, Jarryd",13,11,4,2,3,3,0,4
Hawthorn,"Schoenmakers, Ryan",10,6,3,4,0,0,0,0
Hawthorn,"Sewell, Brad",29,16,5,13,1,0,0,4
Hawthorn,"Shiels, Liam",19,11,4,8,1,0,0,5
Hawthorn,"Smith, Isaac",22,12,7,10,1,0,2,4
Hawthorn,"Spangher, Matthew",17,11,6,6,0,1,0,0
Hawthorn,"Suckling, Matt",20,14,5,6,2,1,0,0
Hawthorn,"Birchall, Grant",23,18,7,5,0,0,0,2
Hawthorn,"Breust, Luke",20,11,3,9,4,0,0,5
Hawthorn,"Burgoyne, Shaun",22,12,5,10,0,0,0,4
Hawthorn,"Ceglar, Jonathon",13,5,6,8,1,0,13,1
Hawthorn,"Duryea, Taylor",13,7,4,6,0,0,1,1
Hawthorn,"Gunston, Jack",18,10,9,8,1,1,0,0
Hawthorn,"Hale, David",9,4,3,5,0,0,13,0
Hawthorn,"Hill, Bradley",14,8,2,6,1,0,0,1
Hawthorn,"Hodge, Luke",26,18,10,8,0,0,1,2
Hawthorn,"Lake, Brian",13,7,8,6,0,0,0,0
Hawthorn,"Lewis, Jordan",27,15,6,12,0,1,1,7
Hawthorn,"Litherland, Angus",15,13,6,2,0,0,0,1
Hawthorn,"Puopolo, Paul",17,10,3,7,1,1,0,4
Hawthorn,"Rioli, Cyril",14,5,6,9,2,0,0,5
Hawthorn,"Ross, Ben",6,3,2,3,0,0,0,0
Hawthorn,"Roughead, Jarryd",17,9,4,8,3,3,4,0
Hawthorn,"Schoenmakers, Ryan",18,9,6,9,2,1,0,6
Hawthorn,"Sewell, Brad",26,17,6,9,1,0,0,2
Hawthorn,"Shiels, Liam",22,11,7,11,0,0,0,4
Hawthorn,"Smith, Isaac",22,18,6,4,1,2,0,2
Hawthorn,"Spangher, Matthew",19,13,7,6,0,0,0,5
Hawthorn,"Suckling, Matt",21,9,8,12,0,0,0,0
Hawthorn,"Birchall, Grant",14,9,0,5,2,0,0,0
Hawthorn,"Breust, Luke",12,8,0,4,3,0,0,8
Hawthorn,"Burgoyne, Shaun",21,10,2,11,1,1,0,4
Hawthorn,"Ceglar, Jonathon",14,9,3,5,1,0,37,1
Hawthorn,"Duryea, Taylor",6,3,1,3,0,0,0,1
Hawthorn,"Gunston, Jack",18,12,4,6,0,1,1,2
Hawthorn,"Hale, David",10,5,2,5,0,0,19,5
Hawthorn,"Hill, Bradley",17,9,1,8,0,0,0,2
Hawthorn,"Hodge, Luke",26,21,2,5,3,0,1,6
Hawthorn,"Lake, Brian",17,9,5,8,0,0,0,1
Hawthorn,"Lewis, Jordan",28,17,4,11,2,0,4,5
Hawthorn,"Litherland, Angus",13,10,4,3,0,0,0,1
Hawthorn,"Puopolo, Paul",16,11,0,5,0,0,0,7
Hawthorn,"Rioli, Cyril",16,11,3,5,1,0,0,6
Hawthorn,"Roughead, Jarryd",15,12,6,3,2,4,0,1
Hawthorn,"Schoenmakers, Ryan",19,16,3,3,0,1,0,3
Hawthorn,"Sewell, Brad",22,13,2,9,0,0,0,3
Hawthorn,"Shiels, Liam",25,19,2,6,0,0,0,10
Hawthorn,"Smith, Isaac",27,21,4,6,2,1,2,9
Hawthorn,"Spangher, Matthew",15,10,4,5,0,0,0,0
Hawthorn,"Stratton, Ben",14,9,3,5,0,0,0,2
Hawthorn,"Suckling, Matt",14,8,4,6,0,0,0,4
Hawthorn,"Birchall, Grant",11,4,0,7,0,0,0,1
Hawthorn,"Breust, Luke",14,5,1,9,1,0,0,4
Hawthorn,"Burgoyne, Shaun",22,10,3,12,1,0,0,3
Hawthorn,"Ceglar, Jonathon",12,4,2,8,0,0,11,4
Hawthorn,"Duryea, Taylor",10,7,1,3,1,0,0,3
Hawthorn,"Gunston, Jack",21,13,7,8,6,1,0,1
Hawthorn,"Hale, David",4,1,1,3,0,0,20,2
Hawthorn,"Hodge, Luke",28,17,6,11,0,0,2,5
Hawthorn,"Lake, Brian",14,10,5,4,0,0,0,1
Hawthorn,"Lewis, Jordan",23,10,2,13,1,1,3,6
Hawthorn,"Litherland, Angus",11,6,6,5,0,0,0,4
Hawthorn,"Mitchell, Sam",23,9,2,14,0,0,1,2
Hawthorn,"Puopolo, Paul",14,9,1,5,0,1,0,8
Hawthorn,"Ross, Ben",14,7,2,7,0,0,0,2
Hawthorn,"Roughead, Jarryd",19,12,3,7,2,3,0,3
Hawthorn,"Schoenmakers, Ryan",14,10,4,4,1,1,0,2
Hawthorn,"Sewell, Brad",2,1,0,1,0,0,0,0
Hawthorn,"Shiels, Liam",19,8,3,11,0,1,1,4
Hawthorn,"Smith, Isaac",17,8,3,9,0,0,2,2
Hawthorn,"Spangher, Matthew",13,11,6,2,0,0,0,2
Hawthorn,"Stratton, Ben",9,5,3,4,0,0,0,3
Hawthorn,"Suckling, Matt",20,12,2,8,0,0,0,4
Hawthorn,"Birchall, Grant",25,15,3,10,0,0,0,5
Hawthorn,"Breust, Luke",15,10,4,5,3,1,0,4
Hawthorn,"Burgoyne, Shaun",18,10,4,8,1,0,0,5
Hawthorn,"Ceglar, Jonathon",13,7,5,6,2,1,19,3
Hawthorn,"Duryea, Taylor",14,8,3,6,1,0,0,2
Hawthorn,"Gunston, Jack",17,8,5,9,4,1,0,0
Hawthorn,"Hodge, Luke",26,18,2,8,0,1,0,7
Hawthorn,"Langford, Will",20,8,1,12,0,1,0,6
Hawthorn,"Lewis, Jordan",25,12,4,13,0,0,2,3
Hawthorn,"Litherland, Angus",14,6,2,8,0,0,0,1
Hawthorn,"McEvoy, Ben",15,6,4,9,2,0,24,1
Hawthorn,"Mitchell, Sam",28,12,3,16,0,0,0,8
Hawthorn,"Puopolo, Paul",18,8,2,10,0,0,0,4
Hawthorn,"Ross, Ben",5,3,2,2,0,0,0,0
Hawthorn,"Roughead, Jarryd",11,7,5,4,0,1,1,10
Hawthorn,"Schoenmakers, Ryan",18,15,8,3,0,0,0,1
Hawthorn,"Shiels, Liam",23,10,1,13,0,0,0,9
Hawthorn,"Simpkin, Jonathan",24,10,3,14,2,1,0,4
Hawthorn,"Smith, Isaac",21,13,8,8,0,2,0,4
Hawthorn,"Spangher, Matthew",12,8,5,4,0,0,0,3
Hawthorn,"Stratton, Ben",9,4,2,5,0,0,0,3
Hawthorn,"Suckling, Matt",26,17,6,9,0,1,0,0
Hawthorn,"Birchall, Grant",24,13,6,11,0,0,0,0
Hawthorn,"Breust, Luke",14,9,3,5,3,1,0,1
Hawthorn,"Burgoyne, Shaun",23,11,4,12,1,0,0,3
Hawthorn,"Ceglar, Jonathon",5,2,1,3,0,0,10,1
Hawthorn,"Gibson, Josh",21,10,5,11,0,0,0,2
Hawthorn,"Gunston, Jack",13,6,2,7,1,2,0,4
Hawthorn,"Hill, Bradley",17,8,5,9,0,0,0,1
Hawthorn,"Hodge, Luke",28,16,3,12,1,0,0,5
Hawthorn,"Langford, Will",16,7,2,9,0,0,1,1
Hawthorn,"Lewis, Jordan",35,19,6,16,0,0,5,2
Hawthorn,"Litherland, Angus",14,8,4,6,0,1,0,0
Hawthorn,"McEvoy, Ben",12,4,4,8,0,0,27,5
Hawthorn,"Mitchell, Sam",32,17,4,15,0,1,1,1
Hawthorn,"Puopolo, Paul",15,10,1,5,2,1,0,5
Hawthorn,"Roughead, Jarryd",18,10,7,8,4,4,1,3
Hawthorn,"Schoenmakers, Ryan",9,5,4,4,0,0,0,2
Hawthorn,"Shiels, Liam",26,17,2,9,0,0,1,2
Hawthorn,"Simpkin, Jonathan",15,6,5,9,0,1,0,3
Hawthorn,"Smith, Isaac",18,11,7,7,3,0,0,1
Hawthorn,"Stratton, Ben",12,5,5,7,0,0,0,5
Hawthorn,"Suckling, Matt",19,14,5,5,0,0,0,0
Hawthorn,"Woodward, Alex",3,2,0,1,0,0,0,0
Hawthorn,"Birchall, Grant",27,12,4,15,0,0,0,0
Hawthorn,"Breust, Luke",12,7,2,5,1,2,0,1
Hawthorn,"Burgoyne, Shaun",24,11,3,13,0,1,0,3
Hawthorn,"Duryea, Taylor",18,14,4,4,1,0,0,3
Hawthorn,"Gibson, Josh",10,4,5,6,0,0,0,2
Hawthorn,"Gunston, Jack",13,7,2,6,3,0,0,1
Hawthorn,"Hale, David",15,2,4,13,1,0,17,2
Hawthorn,"Hill, Bradley",20,9,4,11,0,0,0,2
Hawthorn,"Hodge, Luke",25,18,5,7,0,1,0,3
Hawthorn,"Langford, Will",21,7,3,14,0,0,0,5
Hawthorn,"Lewis, Jordan",26,13,4,13,2,1,3,3
Hawthorn,"Litherland, Angus",13,7,4,6,0,0,0,3
Hawthorn,"McEvoy, Ben",15,8,5,7,1,0,23,3
Hawthorn,"Puopolo, Paul",16,9,2,7,0,0,0,4
Hawthorn,"Roughead, Jarryd",15,12,5,3,6,1,1,3
Hawthorn,"Schoenmakers, Ryan",9,4,1,5,0,0,0,1
Hawthorn,"Shiels, Liam",28,15,3,13,0,1,0,8
Hawthorn,"Simpkin, Jonathan",4,3,1,1,1,0,0,1
Hawthorn,"Spangher, Matthew",14,7,7,7,0,0,0,4
Hawthorn,"Stratton, Ben",19,10,3,9,0,0,0,4
Hawthorn,"Suckling, Matt",28,22,3,6,0,2,0,2
Hawthorn,"Woodward, Alex",15,4,1,11,0,1,0,8
Hawthorn,"Birchall, Grant",26,18,9,8,0,0,0,2
Hawthorn,"Breust, Luke",13,8,5,5,3,0,0,1
Hawthorn,"Burgoyne, Shaun",23,6,4,17,0,0,0,5
Hawthorn,"Duryea, Taylor",15,8,6,7,0,0,0,0
Hawthorn,"Gibson, Josh",12,8,3,4,0,0,0,2
Hawthorn,"Hale, David",11,5,2,6,1,1,20,4
Hawthorn,"Hartung, Billy",4,1,0,3,0,0,0,1
Hawthorn,"Hill, Bradley",14,10,4,4,2,1,0,2
Hawthorn,"Hodge, Luke",22,12,6,10,0,0,3,4
Hawthorn,"Langford, Will",27,11,3,16,0,0,0,4
Hawthorn,"Lewis, Jordan",34,17,6,17,1,1,5,7
Hawthorn,"McEvoy, Ben",12,4,5,8,0,1,22,0
Hawthorn,"Mitchell, Sam",30,17,2,13,0,0,0,2
Hawthorn,"Puopolo, Paul",17,7,2,10,1,0,0,2
Hawthorn,"Roughead, Jarryd",19,13,7,6,5,3,0,2
Hawthorn,"Schoenmakers, Ryan",11,7,5,4,1,0,0,3
Hawthorn,"Shiels, Liam",28,19,5,9,1,2,1,4
Hawthorn,"Simpkin, Jonathan",15,9,1,6,0,0,0,2
Hawthorn,"Smith, Isaac",19,13,3,6,2,1,1,3
Hawthorn,"Spangher, Matthew",12,5,2,7,0,0,0,4
Hawthorn,"Stratton, Ben",18,7,7,11,0,0,0,2
Hawthorn,"Suckling, Matt",24,13,3,11,0,0,0,2
Hawthorn,"Birchall, Grant",19,11,2,8,0,1,0,2
Hawthorn,"Breust, Luke",14,10,6,4,2,1,0,1
Hawthorn,"Burgoyne, Shaun",21,12,4,9,1,1,0,5
Hawthorn,"Duryea, Taylor",17,9,7,8,0,0,0,0
Hawthorn,"Gibson, Josh",22,14,8,8,0,0,0,1
Hawthorn,"Gunston, Jack",12,7,3,5,1,2,0,2
Hawthorn,"Hale, David",9,6,6,3,2,1,13,2
Hawthorn,"Hill, Bradley",13,8,3,5,0,0,0,1
Hawthorn,"Hodge, Luke",28,20,4,8,1,1,5,7
Hawthorn,"Lake, Brian",13,8,6,5,0,0,0,0
Hawthorn,"Langford, Will",24,10,0,14,0,1,2,7
Hawthorn,"Lewis, Jordan",44,22,9,22,0,0,2,4
Hawthorn,"McEvoy, Ben",9,1,4,8,0,0,12,2
Hawthorn,"Mitchell, Sam",24,14,9,10,0,0,0,5
Hawthorn,"OBrien, Tim",7,2,1,5,0,0,0,5
Hawthorn,"Puopolo, Paul",12,8,2,4,4,1,0,3
Hawthorn,"Schoenmakers, Ryan",15,10,6,5,0,0,0,3
Hawthorn,"Shiels, Liam",20,11,3,9,1,1,0,4
Hawthorn,"Simpkin, Jonathan",11,6,7,5,1,0,0,1
Hawthorn,"Smith, Isaac",20,12,5,8,0,1,1,1
Hawthorn,"Stratton, Ben",8,3,2,5,0,0,0,4
Hawthorn,"Suckling, Matt",11,5,2,6,0,0,0,2
Hawthorn,"Birchall, Grant",22,18,8,4,0,1,0,1
Hawthorn,"Breust, Luke",8,4,3,4,1,1,0,3
Hawthorn,"Burgoyne, Shaun",19,10,2,9,0,0,0,4
Hawthorn,"Ceglar, Jonathon",10,5,4,5,1,0,23,3
Hawthorn,"Gibson, Josh",28,13,8,15,0,0,0,2
Hawthorn,"Gunston, Jack",13,9,4,4,1,0,0,1
Hawthorn,"Hale, David",10,7,5,3,3,0,15,2
Hawthorn,"Hill, Bradley",14,10,3,4,0,0,0,4
Hawthorn,"Hodge, Luke",18,12,8,6,0,0,4,3
Hawthorn,"Lake, Brian",20,11,7,9,0,0,0,2
Hawthorn,"Langford, Will",23,10,4,13,2,1,0,2
Hawthorn,"Lewis, Jordan",25,13,7,12,1,1,4,4
Hawthorn,"Mitchell, Sam",28,12,6,16,0,0,0,2
Hawthorn,"Puopolo, Paul",17,9,5,8,0,3,0,4
Hawthorn,"Roughead, Jarryd",11,5,4,6,3,0,0,4
Hawthorn,"Sewell, Brad",17,10,2,7,1,0,0,3
Hawthorn,"Shiels, Liam",16,12,3,4,1,0,0,8
Hawthorn,"Simpkin, Jonathan",16,11,4,5,0,0,0,3
Hawthorn,"Smith, Isaac",20,13,2,7,0,1,1,2
Hawthorn,"Spangher, Matthew",6,3,2,3,0,1,0,1
Hawthorn,"Stratton, Ben",19,8,9,11,0,0,0,2
Hawthorn,"Suckling, Matt",6,3,2,3,0,0,0,0
Hawthorn,"Birchall, Grant",28,18,5,10,0,0,0,2
Hawthorn,"Breust, Luke",15,7,3,8,1,0,0,4
Hawthorn,"Burgoyne, Shaun",25,13,4,12,0,0,0,2
Hawthorn,"Ceglar, Jonathon",11,6,5,5,1,1,15,2
Hawthorn,"Duryea, Taylor",20,12,7,8,0,0,0,3
Hawthorn,"Gibson, Josh",36,17,11,19,0,0,0,1
Hawthorn,"Gunston, Jack",23,15,9,8,5,1,0,2
Hawthorn,"Hale, David",14,8,6,6,2,1,16,1
Hawthorn,"Hartung, Billy",10,6,6,4,1,0,0,0
Hawthorn,"Lake, Brian",12,7,7,5,0,0,0,2
Hawthorn,"Langford, Will",14,4,2,10,0,1,0,5
Hawthorn,"Lewis, Jordan",34,24,11,10,1,1,4,3
Hawthorn,"Litherland, Angus",17,7,2,10,0,0,0,3
Hawthorn,"Mitchell, Sam",30,11,8,19,0,0,0,2
Hawthorn,"Puopolo, Paul",19,8,6,11,2,2,0,4
Hawthorn,"Roughead, Jarryd",17,12,6,5,4,3,0,4
Hawthorn,"Schoenmakers, Ryan",13,8,9,5,0,0,0,2
Hawthorn,"Sewell, Brad",21,8,4,13,0,0,0,2
Hawthorn,"Shiels, Liam",23,12,5,11,0,0,0,7
Hawthorn,"Simpkin, Jonathan",27,14,6,13,1,0,0,5
Hawthorn,"Smith, Isaac",31,16,5,15,0,1,1,2
Hawthorn,"Spangher, Matthew",15,11,5,4,0,0,0,2
Hawthorn,"Birchall, Grant",27,17,8,10,0,0,0,1
Hawthorn,"Breust, Luke",12,7,2,5,1,1,0,6
Hawthorn,"Burgoyne, Shaun",16,8,3,8,0,0,0,3
Hawthorn,"Ceglar, Jonathon",9,3,2,6,0,0,20,3
Hawthorn,"Duryea, Taylor",12,5,2,7,0,0,0,5
Hawthorn,"Gibson, Josh",22,15,8,7,0,0,0,3
Hawthorn,"Gunston, Jack",14,11,7,3,3,1,0,3
Hawthorn,"Hale, David",15,4,8,11,1,0,24,3
Hawthorn,"Hill, Bradley",27,20,6,7,0,0,0,3
Hawthorn,"Hodge, Luke",22,16,8,6,1,1,0,3
Hawthorn,"Lake, Brian",13,4,3,9,0,1,0,0
Hawthorn,"Langford, Will",18,8,1,10,1,1,0,6
Hawthorn,"Lewis, Jordan",20,15,2,5,3,0,0,5
Hawthorn,"Mitchell, Sam",36,19,5,17,0,0,1,2
Hawthorn,"Puopolo, Paul",8,5,1,3,2,0,0,2
Hawthorn,"Roughead, Jarryd",14,9,5,5,2,3,1,5
Hawthorn,"Sewell, Brad",14,9,4,5,0,0,0,6
Hawthorn,"Shiels, Liam",27,16,5,11,0,0,0,10
Hawthorn,"Simpkin, Jonathan",6,2,1,4,0,0,0,0
Hawthorn,"Smith, Isaac",27,14,8,13,1,0,0,3
Hawthorn,"Spangher, Matthew",13,11,6,2,0,0,0,4
Hawthorn,"Stratton, Ben",15,9,5,6,0,0,0,5
Hawthorn,"Birchall, Grant",16,9,3,7,0,0,0,3
Hawthorn,"Breust, Luke",15,5,2,10,0,0,1,5
Hawthorn,"Burgoyne, Shaun",12,8,4,4,0,1,0,2
Hawthorn,"Ceglar, Jonathon",11,5,2,6,0,1,18,1
Hawthorn,"Duryea, Taylor",13,11,4,2,1,0,0,2
Hawthorn,"Gibson, Josh",13,7,3,6,0,0,0,1
Hawthorn,"Gunston, Jack",16,9,6,7,2,0,0,1
Hawthorn,"Hale, David",15,5,2,10,1,0,21,6
Hawthorn,"Hill, Bradley",22,13,5,9,0,0,0,4
Hawthorn,"Hodge, Luke",27,19,10,8,1,1,7,5
Hawthorn,"Lake, Brian",9,2,4,7,0,0,0,0
Hawthorn,"Langford, Will",29,9,2,20,1,1,0,6
Hawthorn,"Lewis, Jordan",22,8,5,14,0,0,2,2
Hawthorn,"Mitchell, Sam",26,16,4,10,0,0,0,8
Hawthorn,"Puopolo, Paul",20,6,4,14,0,0,0,5
Hawthorn,"Roughead, Jarryd",17,12,4,5,6,2,0,1
Hawthorn,"Shiels, Liam",18,12,3,6,0,0,0,8
Hawthorn,"Simpkin, Jonathan",8,3,1,5,0,0,1,2
Hawthorn,"Smith, Isaac",19,12,7,7,2,0,1,4
Hawthorn,"Spangher, Matthew",11,6,3,5,0,0,0,2
Hawthorn,"Stratton, Ben",10,5,1,5,0,0,0,1
Hawthorn,"Suckling, Matt",20,14,6,6,1,0,0,0
Hawthorn,"Birchall, Grant",25,18,7,7,0,0,0,0
Hawthorn,"Breust, Luke",17,11,4,6,3,1,0,5
Hawthorn,"Burgoyne, Shaun",24,11,4,13,2,0,0,1
Hawthorn,"Duryea, Taylor",9,5,3,4,0,0,0,1
Hawthorn,"Gibson, Josh",32,13,6,19,0,0,0,1
Hawthorn,"Gunston, Jack",18,11,5,7,2,3,0,1
Hawthorn,"Hale, David",7,2,3,5,1,0,10,4
Hawthorn,"Hill, Bradley",23,13,6,10,1,0,0,3
Hawthorn,"Hodge, Luke",35,21,12,14,2,1,3,4
Hawthorn,"Lake, Brian",20,10,7,10,0,0,0,3
Hawthorn,"Langford, Will",21,16,3,5,3,0,0,6
Hawthorn,"Lewis, Jordan",37,21,8,16,0,0,8,3
Hawthorn,"McEvoy, Ben",15,4,5,11,0,1,14,3
Hawthorn,"Mitchell, Sam",33,15,9,18,0,1,0,9
Hawthorn,"Puopolo, Paul",10,5,1,5,1,1,0,4
Hawthorn,"Rioli, Cyril",9,5,0,4,0,0,0,2
Hawthorn,"Roughead, Jarryd",13,11,5,2,5,1,0,2
Hawthorn,"Shiels, Liam",22,12,2,10,0,1,0,5
Hawthorn,"Smith, Isaac",17,10,5,7,0,0,0,1
Hawthorn,"Spangher, Matthew",15,6,2,9,0,0,0,1
Hawthorn,"Stratton, Ben",22,13,5,9,0,0,0,2
Hawthorn,"Suckling, Matt",18,12,3,6,1,0,0,2
Melbourne,"Bail, Rohan",22,13,9,9,0,1,0,3
Melbourne,"Byrnes, Shannon",14,7,3,7,2,0,0,2
Melbourne,"Cross, Daniel",15,6,4,9,0,0,1,11
Melbourne,"Dunn, Lynden",20,15,8,5,0,0,0,0
Melbourne,"Fitzpatrick, Jack",4,2,2,2,0,0,2,1
Melbourne,"Frawley, James",18,13,9,5,0,0,0,1
Melbourne,"Georgiou, Alex",14,6,4,8,0,0,0,2
Melbourne,"Grimes, Jack",27,11,5,16,0,0,0,0
Melbourne,"Howe, Jeremy",10,6,2,4,0,1,1,0
Melbourne,"Jones, Matt",22,9,4,13,0,0,0,2
Melbourne,"Jones, Nathan",38,19,6,19,0,1,0,7
Melbourne,"Kennedy Harris, Jay",5,4,3,1,0,0,0,2
Melbourne,"McDonald, Tom",15,8,3,7,0,0,0,0
Melbourne,"Michie, Viv",17,10,3,7,0,0,0,3
Melbourne,"Pedersen, Cameron",11,10,6,1,0,3,2,2
Melbourne,"Spencer, Jake",12,2,2,10,0,0,40,9
Melbourne,"Terlich, Dean",16,5,2,11,1,0,0,2
Melbourne,"Toumpas, Jimmy",17,11,6,6,1,0,0,0
Melbourne,"Trengove, Jack",24,12,6,12,0,1,0,2
Melbourne,"Tyson, Dom",32,16,9,16,1,0,1,2
Melbourne,"Vince, Bernie",28,20,6,8,1,4,0,4
Melbourne,"Watts, Jack",27,10,7,17,0,0,0,1
Melbourne,"Bail, Rohan",15,9,4,6,0,0,0,4
Melbourne,"Byrnes, Shannon",12,7,3,5,2,1,0,2
Melbourne,"Cross, Daniel",27,7,4,20,0,1,1,12
Melbourne,"Dunn, Lynden",16,13,8,3,0,0,4,1
Melbourne,"Fitzpatrick, Jack",4,0,0,4,0,0,3,2
Melbourne,"Frawley, James",25,17,15,8,0,0,0,3
Melbourne,"Georgiou, Alex",16,7,7,9,0,0,0,5
Melbourne,"Grimes, Jack",22,10,4,12,0,0,0,2
Melbourne,"Howe, Jeremy",13,9,6,4,0,2,0,0
Melbourne,"Jones, Matt",21,13,4,8,0,0,0,3
Melbourne,"Jones, Nathan",34,19,6,15,0,0,0,8
Melbourne,"Kennedy Harris, Jay",6,4,2,2,1,1,0,1
Melbourne,"McDonald, Tom",13,9,5,4,0,0,0,0
Melbourne,"Michie, Viv",10,4,2,6,0,0,0,2
Melbourne,"Pedersen, Cameron",9,4,2,5,0,0,2,4
Melbourne,"Spencer, Jake",5,0,1,5,0,0,21,0
Melbourne,"Terlich, Dean",28,19,8,9,0,0,0,3
Melbourne,"Toumpas, Jimmy",18,11,7,7,1,0,0,4
Melbourne,"Trengove, Jack",20,11,4,9,0,0,0,2
Melbourne,"Tyson, Dom",30,15,12,15,0,0,0,1
Melbourne,"Vince, Bernie",29,23,10,6,0,0,0,0
Melbourne,"Watts, Jack",18,11,9,7,0,0,0,3
Melbourne,"Bail, Rohan",13,7,1,6,0,0,0,5
Melbourne,"Byrnes, Shannon",7,2,1,5,0,0,0,2
Melbourne,"Cross, Daniel",19,9,1,10,0,0,5,4
Melbourne,"Dunn, Lynden",9,7,5,2,2,0,1,3
Melbourne,"Evans, Michael",17,14,4,3,0,1,0,2
Melbourne,"Fitzpatrick, Jack",4,2,2,2,0,1,4,1
Melbourne,"Frawley, James",13,11,6,2,1,1,0,3
Melbourne,"Georgiou, Alex",9,4,2,5,0,0,0,1
Melbourne,"Grimes, Jack",19,8,2,11,0,0,0,4
Melbourne,"Howe, Jeremy",23,12,3,11,0,0,0,3
Melbourne,"Jones, Matt",20,13,5,7,1,0,0,4
Melbourne,"Jones, Nathan",18,11,2,7,0,0,0,5
Melbourne,"Kennedy Harris, Jay",5,3,0,2,0,0,0,3
Melbourne,"Kent, Dean",12,6,2,6,1,0,0,1
Melbourne,"McDonald, Tom",13,8,3,5,0,0,0,1
Melbourne,"Pedersen, Cameron",15,9,1,6,0,0,0,5
Melbourne,"Spencer, Jake",10,4,0,6,0,0,25,4
Melbourne,"Terlich, Dean",14,11,1,3,0,0,0,5
Melbourne,"Tyson, Dom",25,10,2,15,0,0,1,1
Melbourne,"Vince, Bernie",19,12,3,7,0,0,1,3
Melbourne,"Viney, Jack",12,7,1,5,0,0,0,8
Melbourne,"Watts, Jack",18,11,2,7,2,0,0,2
Melbourne,"Bail, Rohan",14,12,4,2,2,1,0,10
Melbourne,"Cross, Daniel",24,6,3,18,0,1,0,8
Melbourne,"Dawes, Chris",8,6,3,2,2,0,0,2
Melbourne,"Dunn, Lynden",16,15,11,1,1,2,0,1
Melbourne,"Evans, Michael",3,3,1,0,0,0,0,4
Melbourne,"Frawley, James",24,18,14,6,2,1,1,0
Melbourne,"Georgiou, Alex",6,4,1,2,0,0,0,0
Melbourne,"Grimes, Jack",22,17,6,5,0,0,0,2
Melbourne,"Howe, Jeremy",8,5,2,3,0,0,0,3
Melbourne,"Jones, Matt",22,13,5,9,0,0,0,4
Melbourne,"Jones, Nathan",28,16,1,12,1,0,0,4
Melbourne,"Kennedy Harris, Jay",11,8,1,3,1,0,0,2
Melbourne,"Kent, Dean",12,10,5,2,0,1,0,1
Melbourne,"McDonald, Tom",16,11,2,5,0,0,0,4
Melbourne,"McKenzie, Jordie",14,7,1,7,0,0,0,7
Melbourne,"Pedersen, Cameron",13,5,1,8,1,0,3,5
Melbourne,"Spencer, Jake",10,6,5,4,0,0,30,5
Melbourne,"Terlich, Dean",9,6,3,3,0,0,0,4
Melbourne,"Tyson, Dom",17,9,7,8,0,0,0,5
Melbourne,"Vince, Bernie",11,5,4,6,0,1,0,4
Melbourne,"Viney, Jack",21,11,4,10,0,0,0,5
Melbourne,"Watts, Jack",14,8,3,6,2,0,0,4
Melbourne,"Bail, Rohan",11,7,3,4,0,0,0,5
Melbourne,"Cross, Daniel",21,9,4,12,0,0,1,5
Melbourne,"Dawes, Chris",17,13,5,4,2,4,2,3
Melbourne,"Dunn, Lynden",19,13,3,6,0,0,0,1
Melbourne,"Evans, Michael",5,2,0,3,1,0,0,2
Melbourne,"Frawley, James",13,9,5,4,2,2,2,3
Melbourne,"Georgiou, Alex",9,6,4,3,0,0,0,1
Melbourne,"Grimes, Jack",17,10,5,7,0,0,0,0
Melbourne,"Howe, Jeremy",16,12,9,4,1,1,0,3
Melbourne,"Jetta, Neville",9,3,2,6,0,0,0,0
Melbourne,"Jones, Matt",18,12,4,6,0,1,0,2
Melbourne,"Jones, Nathan",30,22,3,8,1,0,0,5
Melbourne,"Kennedy Harris, Jay",13,6,1,7,1,1,0,3
Melbourne,"McDonald, Tom",14,12,7,2,0,0,0,1
Melbourne,"McKenzie, Jordie",10,1,1,9,0,0,0,2
Melbourne,"Pedersen, Cameron",9,6,2,3,1,0,9,1
Melbourne,"Spencer, Jake",3,1,1,2,0,0,27,0
Melbourne,"Terlich, Dean",13,11,6,2,1,0,0,0
Melbourne,"Tyson, Dom",13,5,3,8,0,1,0,2
Melbourne,"Vince, Bernie",22,16,4,6,0,0,0,1
Melbourne,"Viney, Jack",24,13,1,11,1,0,0,0
Melbourne,"Watts, Jack",11,4,2,7,0,0,0,3
Melbourne,"Bail, Rohan",9,5,3,4,0,0,0,8
Melbourne,"Byrnes, Shannon",12,6,1,6,1,2,0,4
Melbourne,"Cross, Daniel",26,9,6,17,0,0,3,2
Melbourne,"Dawes, Chris",8,5,3,3,1,0,1,2
Melbourne,"Dunn, Lynden",26,17,7,9,0,0,0,2
Melbourne,"Frawley, James",11,6,4,5,0,1,0,2
Melbourne,"Georgiou, Alex",12,6,6,6,0,0,0,0
Melbourne,"Grimes, Jack",23,11,7,12,0,0,0,0
Melbourne,"Howe, Jeremy",8,4,3,4,0,1,0,5
Melbourne,"Jamar, Mark",8,3,1,5,0,0,35,3
Melbourne,"Jetta, Neville",4,1,1,3,0,0,0,3
Melbourne,"Jones, Matt",29,18,12,11,1,0,0,0
Melbourne,"Jones, Nathan",33,17,7,16,0,1,0,7
Melbourne,"Kennedy Harris, Jay",20,7,3,13,0,0,0,4
Melbourne,"McDonald, Tom",11,6,6,5,0,0,0,2
Melbourne,"Pedersen, Cameron",22,9,7,13,0,1,9,3
Melbourne,"Salem, Christian",6,6,3,0,1,0,0,1
Melbourne,"Terlich, Dean",16,13,8,3,0,0,0,6
Melbourne,"Tyson, Dom",16,8,2,8,1,0,0,4
Melbourne,"Vince, Bernie",31,28,6,3,0,1,0,2
Melbourne,"Viney, Jack",20,12,2,8,0,1,0,7
Melbourne,"Watts, Jack",15,5,3,10,0,0,0,4
Melbourne,"Bail, Rohan",21,14,3,7,1,0,0,5
Melbourne,"Byrnes, Shannon",10,2,2,8,0,0,0,4
Melbourne,"Cross, Daniel",21,6,1,15,0,0,2,3
Melbourne,"Dawes, Chris",20,14,5,6,3,0,1,2
Melbourne,"Dunn, Lynden",17,11,4,6,0,0,0,2
Melbourne,"Frawley, James",9,7,3,2,0,1,0,3
Melbourne,"Georgiou, Alex",5,1,0,4,0,0,0,1
Melbourne,"Grimes, Jack",17,9,5,8,0,0,0,3
Melbourne,"Howe, Jeremy",23,13,5,10,0,0,0,2
Melbourne,"Jamar, Mark",10,6,1,4,1,0,38,2
Melbourne,"Jetta, Neville",15,6,3,9,0,0,0,4
Melbourne,"Jones, Matt",21,14,5,7,0,0,0,3
Melbourne,"Jones, Nathan",14,6,0,8,1,0,0,7
Melbourne,"Kennedy Harris, Jay",25,10,5,15,1,1,0,2
Melbourne,"McDonald, Tom",15,10,3,5,0,0,0,2
Melbourne,"Pedersen, Cameron",15,9,7,6,0,0,12,3
Melbourne,"Salem, Christian",3,2,2,1,1,0,0,3
Melbourne,"Terlich, Dean",21,9,3,12,0,0,0,3
Melbourne,"Tyson, Dom",29,12,6,17,1,1,0,1
Melbourne,"Vince, Bernie",26,17,4,9,0,0,0,6
Melbourne,"Viney, Jack",23,13,2,10,1,0,0,4
Melbourne,"Watts, Jack",17,11,3,6,1,0,0,2
Melbourne,"Bail, Rohan",13,8,4,5,0,0,0,7
Melbourne,"Byrnes, Shannon",10,4,1,6,0,0,0,2
Melbourne,"Cross, Daniel",23,9,6,14,1,0,2,5
Melbourne,"Dawes, Chris",11,8,5,3,1,1,1,0
Melbourne,"Dunn, Lynden",17,14,5,3,0,1,0,1
Melbourne,"Frawley, James",12,8,4,4,2,1,0,1
Melbourne,"Garland, Colin",11,5,3,6,0,0,0,4
Melbourne,"Grimes, Jack",9,5,1,4,0,0,0,5
Melbourne,"Howe, Jeremy",18,11,5,7,0,0,0,3
Melbourne,"Jamar, Mark",6,5,2,1,1,0,53,6
Melbourne,"Jetta, Neville",8,2,1,6,0,0,0,7
Melbourne,"Jones, Matt",17,12,5,5,0,2,0,3
Melbourne,"Jones, Nathan",24,11,1,13,0,0,0,1
Melbourne,"Kennedy Harris, Jay",11,8,2,3,2,1,0,1
Melbourne,"McDonald, Tom",10,6,2,4,0,0,0,1
Melbourne,"Pedersen, Cameron",11,4,3,7,1,0,10,4
Melbourne,"Salem, Christian",7,4,2,3,1,1,0,2
Melbourne,"Terlich, Dean",11,8,1,3,0,0,0,3
Melbourne,"Tyson, Dom",27,19,6,8,2,0,0,3
Melbourne,"Vince, Bernie",17,16,1,1,1,0,2,4
Melbourne,"Viney, Jack",21,7,1,14,0,1,0,9
Melbourne,"Watts, Jack",15,9,5,6,0,0,2,3
Melbourne,"Bail, Rohan",13,10,5,3,0,1,0,2
Melbourne,"Cross, Daniel",22,11,6,11,0,0,1,5
Melbourne,"Dawes, Chris",10,7,2,3,1,1,0,8
Melbourne,"Dunn, Lynden",14,12,7,2,0,0,0,1
Melbourne,"Garland, Colin",15,9,6,6,0,0,0,3
Melbourne,"Gawn, Max",12,5,5,7,0,1,19,2
Melbourne,"Grimes, Jack",23,10,3,13,0,0,0,1
Melbourne,"Howe, Jeremy",24,20,8,4,0,0,0,1
Melbourne,"Jamar, Mark",6,3,0,3,0,0,30,2
Melbourne,"Jones, Matt",18,8,5,10,1,0,0,2
Melbourne,"Jones, Nathan",33,17,1,16,1,0,0,4
Melbourne,"Kennedy Harris, Jay",6,3,3,3,1,0,0,0
Melbourne,"McDonald, Tom",12,6,5,6,0,0,0,1
Melbourne,"Pedersen, Cameron",16,10,8,6,2,2,0,8
Melbourne,"Riley, Aidan",11,3,3,8,1,0,0,1
Melbourne,"Salem, Christian",8,6,2,2,0,1,0,2
Melbourne,"Terlich, Dean",12,9,4,3,0,0,0,4
Melbourne,"Toumpas, Jimmy",15,11,6,4,0,0,0,3
Melbourne,"Tyson, Dom",23,15,9,8,2,0,0,3
Melbourne,"Vince, Bernie",25,18,1,7,1,0,0,4
Melbourne,"Viney, Jack",24,9,3,15,1,0,0,6
Melbourne,"Watts, Jack",19,13,11,6,3,0,0,4
Melbourne,"Bail, Rohan",20,11,7,9,2,0,0,3
Melbourne,"Cross, Daniel",21,8,7,13,0,0,2,5
Melbourne,"Dunn, Lynden",27,15,7,12,0,0,0,1
Melbourne,"Frawley, James",16,12,9,4,2,2,0,3
Melbourne,"Garland, Colin",18,14,7,4,0,0,0,4
Melbourne,"Gawn, Max",6,3,1,3,1,0,10,0
Melbourne,"Grimes, Jack",18,7,5,11,0,0,0,1
Melbourne,"Howe, Jeremy",21,14,10,7,0,0,0,2
Melbourne,"Jamar, Mark",12,2,1,10,0,0,25,1
Melbourne,"Jetta, Neville",13,8,2,5,0,0,0,2
Melbourne,"Jones, Matt",24,6,1,18,0,0,0,1
Melbourne,"Jones, Nathan",30,14,5,16,0,0,0,0
Melbourne,"Kennedy Harris, Jay",19,8,5,11,0,0,0,3
Melbourne,"McDonald, Tom",15,10,4,5,0,0,0,1
Melbourne,"Pedersen, Cameron",16,9,6,7,2,1,1,2
Melbourne,"Salem, Christian",16,13,4,3,2,2,0,2
Melbourne,"Terlich, Dean",21,12,6,9,0,0,0,1
Melbourne,"Toumpas, Jimmy",6,5,2,1,0,1,0,0
Melbourne,"Tyson, Dom",30,19,9,11,2,0,0,1
Melbourne,"Vince, Bernie",26,17,4,9,0,1,0,2
Melbourne,"Viney, Jack",25,12,0,13,0,1,0,4
Melbourne,"Watts, Jack",21,10,4,11,0,0,0,2
Melbourne,"Bail, Rohan",19,10,7,9,0,0,0,3
Melbourne,"Cross, Daniel",21,8,6,13,0,0,2,3
Melbourne,"Dawes, Chris",18,8,6,10,0,1,0,3
Melbourne,"Dunn, Lynden",24,20,10,4,0,1,0,0
Melbourne,"Frawley, James",14,13,11,1,0,1,0,1
Melbourne,"Garland, Colin",15,8,3,7,0,0,0,0
Melbourne,"Gawn, Max",19,7,7,12,0,0,6,2
Melbourne,"Grimes, Jack",19,14,9,5,0,0,0,3
Melbourne,"Howe, Jeremy",11,10,5,1,1,0,0,4
Melbourne,"Jamar, Mark",8,6,5,2,0,0,12,0
Melbourne,"Jetta, Neville",17,11,9,6,0,0,0,2
Melbourne,"Jones, Matt",23,12,5,11,0,0,0,1
Melbourne,"Jones, Nathan",29,15,3,14,1,0,0,6
Melbourne,"Kennedy Harris, Jay",3,3,1,0,0,1,0,1
Melbourne,"McDonald, Tom",13,8,6,5,0,0,0,2
Melbourne,"Pedersen, Cameron",14,11,11,3,0,0,0,4
Melbourne,"Salem, Christian",7,4,1,3,0,0,0,0
Melbourne,"Terlich, Dean",9,7,2,2,0,0,0,1
Melbourne,"Tyson, Dom",16,9,4,7,0,0,0,0
Melbourne,"Vince, Bernie",25,16,6,9,1,0,0,8
Melbourne,"Viney, Jack",20,11,6,9,0,0,0,2
Melbourne,"Watts, Jack",21,13,9,8,0,2,0,2
Melbourne,"Bail, Rohan",12,8,3,4,0,0,0,5
Melbourne,"Cross, Daniel",20,10,7,10,0,0,2,4
Melbourne,"Dawes, Chris",11,7,6,4,0,1,0,8
Melbourne,"Dunn, Lynden",29,22,11,7,0,0,0,2
Melbourne,"Frawley, James",16,11,9,5,2,1,0,2
Melbourne,"Garland, Colin",11,9,4,2,0,0,0,2
Melbourne,"Grimes, Jack",19,13,5,6,1,1,0,1
Melbourne,"Howe, Jeremy",19,12,8,7,0,0,0,2
Melbourne,"Jamar, Mark",6,2,1,4,0,0,42,5
Melbourne,"Jetta, Neville",14,11,4,3,0,0,0,5
Melbourne,"Jones, Matt",14,10,7,4,0,0,0,2
Melbourne,"Jones, Nathan",27,11,3,16,1,0,0,5
Melbourne,"Kent, Dean",18,12,7,6,2,0,0,3
Melbourne,"McDonald, Tom",18,12,8,6,0,0,0,2
Melbourne,"McKenzie, Jordie",13,3,1,10,0,0,0,1
Melbourne,"Pedersen, Cameron",16,6,5,10,2,1,4,1
Melbourne,"Riley, Aidan",3,2,1,1,0,1,0,2
Melbourne,"Salem, Christian",4,3,2,1,1,0,0,3
Melbourne,"Tyson, Dom",24,13,3,11,0,1,0,6
Melbourne,"Vince, Bernie",16,9,1,7,1,0,0,6
Melbourne,"Viney, Jack",25,11,9,14,0,0,0,5
Melbourne,"Watts, Jack",17,11,6,6,2,0,0,2
Melbourne,"Bail, Rohan",9,2,1,7,1,0,0,3
Melbourne,"Cross, Daniel",24,6,3,18,0,0,4,8
Melbourne,"Dawes, Chris",8,6,4,2,3,1,1,4
Melbourne,"Dunn, Lynden",20,17,6,3,0,1,0,0
Melbourne,"Frawley, James",8,6,4,2,1,1,0,2
Melbourne,"Garland, Colin",14,11,5,3,0,0,0,1
Melbourne,"Grimes, Jack",17,9,5,8,0,0,0,3
Melbourne,"Howe, Jeremy",10,10,5,0,0,0,0,1
Melbourne,"Jamar, Mark",9,3,2,6,0,0,41,1
Melbourne,"Jetta, Neville",13,7,3,6,0,0,0,4
Melbourne,"Jones, Matt",26,15,6,11,0,0,0,4
Melbourne,"Jones, Nathan",28,11,2,17,0,1,0,5
Melbourne,"Kent, Dean",9,3,2,6,0,0,0,3
Melbourne,"McDonald, Tom",18,10,4,8,0,0,0,1
Melbourne,"McKenzie, Jordie",16,4,1,12,0,0,0,1
Melbourne,"Pedersen, Cameron",19,11,8,8,1,0,4,2
Melbourne,"Riley, Aidan",4,2,1,2,1,0,0,2
Melbourne,"Salem, Christian",2,1,1,1,0,0,0,0
Melbourne,"Tyson, Dom",20,11,5,9,0,0,0,6
Melbourne,"Vince, Bernie",41,24,9,17,3,0,0,5
Melbourne,"Viney, Jack",20,8,4,12,0,0,0,1
Melbourne,"Watts, Jack",23,12,8,11,0,1,0,1
Melbourne,"Bail, Rohan",14,8,4,6,0,0,0,6
Melbourne,"Barry, Dom",2,1,0,1,0,0,0,3
Melbourne,"Dawes, Chris",10,3,2,7,2,0,0,4
Melbourne,"Dunn, Lynden",18,10,2,8,0,0,0,3
Melbourne,"Frawley, James",22,13,10,9,0,0,0,0
Melbourne,"Garland, Colin",20,14,9,6,0,1,0,5
Melbourne,"Gawn, Max",9,4,5,5,1,1,23,0
Melbourne,"Grimes, Jack",20,11,7,9,2,0,0,4
Melbourne,"Howe, Jeremy",23,12,7,11,0,0,0,6
Melbourne,"Jamar, Mark",13,9,3,4,3,1,43,2
Melbourne,"Jetta, Neville",19,7,3,12,1,0,0,5
Melbourne,"Jones, Matt",16,8,5,8,0,0,0,7
Melbourne,"Jones, Nathan",23,11,1,12,0,0,0,9
Melbourne,"Kent, Dean",7,2,1,5,0,0,0,2
Melbourne,"Nicholson, Daniel",9,4,4,5,0,0,0,4
Melbourne,"Pedersen, Cameron",13,7,4,6,1,0,3,4
Melbourne,"Salem, Christian",8,5,0,3,0,0,0,1
Melbourne,"Terlich, Dean",5,3,2,2,0,0,0,2
Melbourne,"Tyson, Dom",19,7,5,12,0,0,0,5
Melbourne,"Vince, Bernie",24,18,4,6,1,0,0,8
Melbourne,"Viney, Jack",14,11,3,3,1,1,0,7
Melbourne,"Watts, Jack",19,10,6,9,1,2,0,4
Melbourne,"Bail, Rohan",17,9,1,8,1,0,0,3
Melbourne,"Barry, Dom",2,2,1,0,0,0,0,0
Melbourne,"Dawes, Chris",11,7,5,4,1,2,1,3
Melbourne,"Dunn, Lynden",13,5,2,8,0,0,0,1
Melbourne,"Frawley, James",16,10,6,6,0,0,0,4
Melbourne,"Garland, Colin",9,6,2,3,0,0,0,6
Melbourne,"Gawn, Max",7,2,3,5,0,0,12,1
Melbourne,"Grimes, Jack",20,11,6,9,0,1,0,2
Melbourne,"Howe, Jeremy",15,10,4,5,0,0,0,3
Melbourne,"Jamar, Mark",10,5,2,5,1,0,23,2
Melbourne,"Jones, Matt",23,13,7,10,0,0,0,5
Melbourne,"Jones, Nathan",23,13,5,10,0,1,0,5
Melbourne,"Kent, Dean",11,9,2,2,1,1,0,4
Melbourne,"McDonald, Tom",22,12,5,10,0,0,0,1
Melbourne,"McKenzie, Jordie",9,3,2,6,0,0,0,3
Melbourne,"Pedersen, Cameron",10,3,1,7,0,0,6,0
Melbourne,"Salem, Christian",7,7,4,0,0,1,0,4
Melbourne,"Terlich, Dean",18,11,3,7,0,1,0,3
Melbourne,"Tyson, Dom",21,13,3,8,0,0,0,5
Melbourne,"Vince, Bernie",17,13,4,4,0,0,0,8
Melbourne,"Viney, Jack",21,13,2,8,0,0,0,2
Melbourne,"Watts, Jack",13,5,1,8,0,2,0,3
Melbourne,"Bail, Rohan",12,7,1,5,0,0,0,6
Melbourne,"Dawes, Chris",12,8,5,4,0,0,1,1
Melbourne,"Dunn, Lynden",10,7,5,3,0,1,0,1
Melbourne,"Frawley, James",21,11,8,10,0,0,0,1
Melbourne,"Garland, Colin",8,7,0,1,0,0,0,4
Melbourne,"Grimes, Jack",17,8,2,9,0,0,0,6
Melbourne,"Howe, Jeremy",21,11,4,10,2,0,0,4
Melbourne,"Jamar, Mark",6,2,1,4,0,1,24,1
Melbourne,"Jetta, Neville",9,5,5,4,0,0,0,4
Melbourne,"Jones, Matt",10,7,5,3,0,0,0,0
Melbourne,"Jones, Nathan",23,16,1,7,0,0,0,8
Melbourne,"Kent, Dean",11,3,1,8,1,0,0,2
Melbourne,"McDonald, Tom",9,8,4,1,0,0,0,3
Melbourne,"McKenzie, Jordie",14,9,1,5,0,0,0,5
Melbourne,"Pedersen, Cameron",10,6,3,4,1,0,10,5
Melbourne,"Riley, Aidan",17,7,2,10,0,0,0,7
Melbourne,"Tapscott, Luke",9,4,0,5,0,1,1,4
Melbourne,"Terlich, Dean",4,3,2,1,0,0,0,2
Melbourne,"Tyson, Dom",20,8,2,12,0,0,0,5
Melbourne,"Vince, Bernie",20,13,3,7,1,0,0,2
Melbourne,"Viney, Jack",20,8,2,12,0,0,0,6
Melbourne,"Watts, Jack",12,7,4,5,0,0,0,2
Melbourne,"Bail, Rohan",21,9,3,12,1,0,0,2
Melbourne,"Blease, Sam",10,8,2,2,1,2,0,3
Melbourne,"Dawes, Chris",9,6,4,3,0,1,1,3
Melbourne,"Dunn, Lynden",13,10,3,3,0,0,0,1
Melbourne,"Frawley, James",19,11,9,8,1,1,0,1
Melbourne,"Garland, Colin",13,11,6,2,0,0,0,3
Melbourne,"Grimes, Jack",17,10,7,7,0,0,0,1
Melbourne,"Howe, Jeremy",17,7,3,10,0,0,0,1
Melbourne,"Jamar, Mark",12,6,3,6,0,0,47,1
Melbourne,"Jetta, Neville",17,6,2,11,0,0,0,4
Melbourne,"Jones, Nathan",31,13,3,18,0,0,0,5
Melbourne,"Kennedy Harris, Jay",9,5,1,4,1,0,0,3
Melbourne,"Kent, Dean",8,4,1,4,0,1,0,0
Melbourne,"McDonald, Tom",13,9,6,4,0,0,0,0
Melbourne,"McKenzie, Jordie",11,3,0,8,0,1,0,2
Melbourne,"Pedersen, Cameron",10,6,4,4,1,0,10,3
Melbourne,"Riley, Aidan",12,4,0,8,0,1,0,7
Melbourne,"Tapscott, Luke",13,8,0,5,1,1,0,1
Melbourne,"Tyson, Dom",32,15,5,17,2,0,0,7
Melbourne,"Vince, Bernie",17,8,6,9,1,0,0,2
Melbourne,"Viney, Jack",21,10,4,11,0,1,0,5
Melbourne,"Watts, Jack",19,10,6,9,1,0,0,3
Melbourne,"Bail, Rohan",17,10,5,7,1,1,0,4
Melbourne,"Blease, Sam",11,8,1,3,0,0,0,1
Melbourne,"Dawes, Chris",9,4,2,5,0,1,1,4
Melbourne,"Dunn, Lynden",15,12,4,3,0,0,0,0
Melbourne,"Frawley, James",16,12,10,4,1,1,0,0
Melbourne,"Garland, Colin",13,8,4,5,0,0,0,2
Melbourne,"Howe, Jeremy",23,14,12,9,0,0,0,4
Melbourne,"Jamar, Mark",12,7,1,5,0,1,31,6
Melbourne,"Jetta, Neville",15,9,3,6,0,0,0,2
Melbourne,"Jones, Nathan",30,13,2,17,1,0,0,2
Melbourne,"Kennedy Harris, Jay",3,2,1,1,0,0,0,1
Melbourne,"Kent, Dean",16,12,5,4,2,3,0,0
Melbourne,"McDonald, Tom",18,9,5,9,0,0,0,1
Melbourne,"McKenzie, Jordie",16,5,2,11,0,1,0,2
Melbourne,"Pedersen, Cameron",11,5,1,6,0,0,6,1
Melbourne,"Riley, Aidan",14,5,3,9,0,2,0,5
Melbourne,"Tapscott, Luke",9,7,4,2,0,1,0,1
Melbourne,"Terlich, Dean",25,12,5,13,0,0,0,4
Melbourne,"Tyson, Dom",27,12,6,15,1,1,0,2
Melbourne,"Vince, Bernie",26,18,7,8,0,1,0,1
Melbourne,"Viney, Jack",19,5,2,14,0,0,0,3
Melbourne,"Watts, Jack",17,8,7,9,0,0,0,1
Melbourne,"Bail, Rohan",12,5,3,7,0,0,0,3
Melbourne,"Barry, Dom",17,9,1,8,0,0,0,1
Melbourne,"Cross, Daniel",22,4,4,18,0,0,2,3
Melbourne,"Dawes, Chris",18,10,7,8,1,0,0,1
Melbourne,"Dunn, Lynden",15,12,5,3,0,0,0,2
Melbourne,"Frawley, James",14,10,6,4,1,2,0,7
Melbourne,"Garland, Colin",11,9,5,2,0,0,0,4
Melbourne,"Gawn, Max",15,9,9,6,2,3,18,3
Melbourne,"Howe, Jeremy",20,14,7,6,0,0,0,5
Melbourne,"Jamar, Mark",8,5,2,3,0,0,29,3
Melbourne,"Jetta, Neville",12,6,5,6,0,0,0,10
Melbourne,"Jones, Matt",16,8,2,8,0,0,0,5
Melbourne,"Jones, Nathan",28,13,2,15,0,1,0,6
Melbourne,"Kennedy Harris, Jay",4,4,2,0,1,1,0,1
Melbourne,"Kent, Dean",9,7,3,2,1,0,0,4
Melbourne,"McDonald, Tom",13,9,6,4,0,0,0,2
Melbourne,"Michie, Viv",19,8,2,11,0,0,0,2
Melbourne,"Riley, Aidan",9,6,3,3,1,1,0,3
Melbourne,"Tyson, Dom",30,14,3,16,1,0,1,1
Melbourne,"Vince, Bernie",24,17,6,7,0,2,0,0
Melbourne,"Viney, Jack",14,5,1,9,1,0,0,2
Melbourne,"Watts, Jack",17,6,0,11,0,0,0,3
Melbourne,"Barry, Dom",10,5,3,5,0,1,0,2
Melbourne,"Cross, Daniel",18,5,3,13,0,1,2,4
Melbourne,"Dawes, Chris",10,5,5,5,0,0,0,1
Melbourne,"Dunn, Lynden",18,10,5,8,0,2,0,1
Melbourne,"Frawley, James",8,4,3,4,0,0,0,2
Melbourne,"Garland, Colin",11,8,4,3,1,1,0,4
Melbourne,"Gawn, Max",14,4,5,10,0,0,22,1
Melbourne,"Grimes, Jack",9,4,2,5,0,0,0,2
Melbourne,"Howe, Jeremy",18,12,6,6,0,0,0,1
Melbourne,"Jamar, Mark",9,4,2,5,0,2,20,4
Melbourne,"Jetta, Neville",19,10,4,9,0,0,0,3
Melbourne,"Jones, Matt",13,10,6,3,0,0,0,1
Melbourne,"Jones, Nathan",30,16,6,14,0,0,0,5
Melbourne,"Kent, Dean",19,15,6,4,1,2,0,2
Melbourne,"McDonald, Tom",20,10,4,10,0,0,0,4
Melbourne,"Michie, Viv",22,10,6,12,0,0,0,4
Melbourne,"Riley, Aidan",13,3,0,10,0,0,0,1
Melbourne,"Salem, Christian",7,5,2,2,0,1,0,4
Melbourne,"Tyson, Dom",22,11,7,11,0,2,0,2
Melbourne,"Vince, Bernie",28,19,5,9,0,1,0,1
Melbourne,"Viney, Jack",12,4,3,8,0,0,0,5
Melbourne,"Watts, Jack",15,8,5,7,1,1,0,4
Melbourne,"Bail, Rohan",24,13,1,11,1,0,0,3
Melbourne,"Cross, Daniel",18,3,1,15,0,0,1,6
Melbourne,"Dawes, Chris",13,8,5,5,1,1,0,3
Melbourne,"Dunn, Lynden",20,11,4,9,0,0,0,1
Melbourne,"Fitzpatrick, Jack",13,8,7,5,2,0,1,0
Melbourne,"Frawley, James",13,9,7,4,0,0,0,2
Melbourne,"Garland, Colin",10,6,1,4,0,0,0,1
Melbourne,"Gawn, Max",10,5,2,5,0,0,18,1
Melbourne,"Howe, Jeremy",21,16,5,5,1,0,0,3
Melbourne,"Jamar, Mark",7,2,1,5,0,0,25,1
Melbourne,"Jetta, Neville",8,2,1,6,0,0,0,5
Melbourne,"Jones, Matt",14,6,3,8,0,0,0,3
Melbourne,"Jones, Nathan",29,12,0,17,0,0,0,5
Melbourne,"Kent, Dean",10,4,2,6,0,0,0,0
Melbourne,"McDonald, Tom",19,10,5,9,0,0,0,3
Melbourne,"Michie, Viv",23,6,5,17,0,0,0,2
Melbourne,"Pedersen, Cameron",14,6,2,8,1,1,1,1
Melbourne,"Salem, Christian",6,1,1,5,0,0,0,0
Melbourne,"Tyson, Dom",25,14,5,11,1,0,0,3
Melbourne,"Vince, Bernie",34,20,3,14,1,2,0,3
Melbourne,"Viney, Jack",22,5,3,17,0,0,0,4
Melbourne,"Watts, Jack",13,6,4,7,0,0,0,3
Melbourne,"Bail, Rohan",18,12,7,6,0,0,0,2
Melbourne,"Barry, Dom",7,2,1,5,0,0,0,1
Melbourne,"Cross, Daniel",25,7,5,18,0,0,0,2
Melbourne,"Dawes, Chris",19,11,7,8,2,1,1,2
Melbourne,"Dunn, Lynden",11,5,3,6,1,0,0,1
Melbourne,"Fitzpatrick, Jack",12,7,4,5,2,0,7,2
Melbourne,"Frawley, James",12,8,4,4,0,0,0,5
Melbourne,"Gawn, Max",3,0,1,3,0,0,5,1
Melbourne,"Howe, Jeremy",15,10,8,5,0,0,0,1
Melbourne,"Jamar, Mark",12,6,3,6,1,0,22,1
Melbourne,"Jetta, Neville",16,6,2,10,0,0,0,0
Melbourne,"Jones, Matt",14,6,2,8,0,1,0,1
Melbourne,"Jones, Nathan",27,15,4,12,0,1,0,6
Melbourne,"Kent, Dean",14,11,5,3,3,2,0,3
Melbourne,"McDonald, Tom",16,12,8,4,2,0,0,3
Melbourne,"McKenzie, Jordie",18,5,1,13,0,0,0,4
Melbourne,"Michie, Viv",14,9,6,5,0,0,0,5
Melbourne,"Riley, Aidan",17,10,1,7,0,0,0,3
Melbourne,"Tyson, Dom",24,14,7,10,2,0,1,5
Melbourne,"Vince, Bernie",25,14,3,11,1,1,0,2
Melbourne,"Viney, Jack",19,12,3,7,0,2,0,2
Melbourne,"Watts, Jack",24,12,4,12,0,0,0,2
North Melbourne,"Adams, Leigh",17,9,10,8,0,0,0,2
North Melbourne,"Atley, Shaun",18,9,4,9,0,0,0,1
North Melbourne,"Bastinac, Ryan",14,8,0,6,0,0,0,7
North Melbourne,"Black, Aaron",7,3,4,4,1,0,0,2
North Melbourne,"Cunnington, Ben",16,11,2,5,0,0,0,7
North Melbourne,"Dal Santo, Nick",21,10,3,11,1,0,1,2
North Melbourne,"Gibson, Sam",14,6,3,8,0,0,0,4
North Melbourne,"Goldstein, Todd",5,1,0,4,0,0,34,5
North Melbourne,"Grima, Nathan",10,6,2,4,0,0,0,3
North Melbourne,"Hansen, Lachlan",11,3,3,8,0,0,0,2
North Melbourne,"Harvey, Brent",21,13,7,8,1,1,0,4
North Melbourne,"Macmillan, Jamie",23,11,4,12,0,0,0,2
North Melbourne,"McDonald, Luke",14,10,2,4,0,0,0,2
North Melbourne,"McKenzie, Brad",11,6,4,5,1,0,0,3
North Melbourne,"McMahon, Scott",4,2,1,2,0,0,0,3
North Melbourne,"Mullett, Aaron",22,14,6,8,0,0,0,5
North Melbourne,"Petrie, Drew",3,3,2,0,0,0,9,0
North Melbourne,"Thomas, Lindsay",13,7,6,6,4,0,0,3
North Melbourne,"Thompson, Scott",17,9,7,8,0,0,0,1
North Melbourne,"Wells, Daniel",11,6,1,5,0,0,0,2
North Melbourne,"Wright, Sam",7,3,0,4,1,2,0,0
North Melbourne,"Ziebell, Jack",12,9,2,3,0,0,0,3
North Melbourne,"Adams, Leigh",19,10,3,9,1,0,0,5
North Melbourne,"Atley, Shaun",20,11,7,9,0,0,0,2
North Melbourne,"Bastinac, Ryan",20,12,6,8,0,2,0,5
North Melbourne,"Black, Aaron",12,9,7,3,1,3,0,2
North Melbourne,"Cunnington, Ben",18,8,2,10,0,1,0,4
North Melbourne,"Currie, Daniel",6,4,3,2,1,0,9,2
North Melbourne,"Dal Santo, Nick",32,19,5,13,0,1,2,1
North Melbourne,"Gibson, Sam",31,18,7,13,0,0,0,4
North Melbourne,"Goldstein, Todd",6,1,1,5,0,0,29,5
North Melbourne,"Greenwood, Levi",13,9,5,4,1,0,0,0
North Melbourne,"Grima, Nathan",10,9,2,1,0,0,0,2
North Melbourne,"Hansen, Lachlan",20,14,10,6,0,0,0,4
North Melbourne,"Harvey, Brent",25,17,8,8,3,1,0,2
North Melbourne,"Macmillan, Jamie",14,7,2,7,0,0,0,4
North Melbourne,"McDonald, Luke",19,11,3,8,0,0,0,4
North Melbourne,"McKenzie, Brad",21,11,5,10,1,0,0,0
North Melbourne,"Mullett, Aaron",15,9,3,6,0,1,0,2
North Melbourne,"Petrie, Drew",11,7,6,4,2,1,1,2
North Melbourne,"Thomas, Lindsay",4,2,1,2,0,0,0,4
North Melbourne,"Thompson, Scott",22,12,6,10,0,0,0,3
North Melbourne,"Wells, Daniel",12,7,1,5,1,1,0,3
North Melbourne,"Ziebell, Jack",14,6,4,8,1,0,1,5
North Melbourne,"Adams, Leigh",16,5,4,11,0,2,0,9
North Melbourne,"Atley, Shaun",24,8,5,16,0,1,0,5
North Melbourne,"Bastinac, Ryan",26,19,8,7,0,1,0,5
North Melbourne,"Black, Aaron",7,5,4,2,1,0,0,5
North Melbourne,"Cunnington, Ben",30,16,6,14,0,0,0,7
North Melbourne,"Currie, Daniel",5,3,2,2,0,0,8,4
North Melbourne,"Dal Santo, Nick",30,12,5,18,1,0,1,5
North Melbourne,"Gibson, Sam",33,19,7,14,0,1,0,4
North Melbourne,"Goldstein, Todd",13,4,2,9,1,1,33,5
North Melbourne,"Greenwood, Levi",34,17,11,17,0,0,0,7
North Melbourne,"Grima, Nathan",21,13,6,8,0,0,0,0
North Melbourne,"Hansen, Lachlan",19,13,13,6,0,0,0,2
North Melbourne,"Harvey, Brent",23,14,4,9,3,2,0,2
North Melbourne,"Jacobs, Ben",7,2,0,5,1,0,0,1
North Melbourne,"Macmillan, Jamie",11,6,4,5,1,0,0,2
North Melbourne,"McDonald, Luke",23,10,4,13,0,0,0,8
North Melbourne,"McKenzie, Brad",25,16,5,9,0,0,0,0
North Melbourne,"Mullett, Aaron",22,17,8,5,2,1,0,2
North Melbourne,"Petrie, Drew",4,1,2,3,0,1,0,1
North Melbourne,"Thomas, Lindsay",12,10,0,2,3,1,0,3
North Melbourne,"Thompson, Scott",14,8,4,6,1,0,0,1
North Melbourne,"Wells, Daniel",20,10,4,10,0,1,0,5
North Melbourne,"Adams, Leigh",29,18,5,11,1,1,0,7
North Melbourne,"Atley, Shaun",18,6,2,12,0,0,0,5
North Melbourne,"Bastinac, Ryan",16,11,5,5,0,0,0,4
North Melbourne,"Black, Aaron",12,7,1,5,3,0,0,3
North Melbourne,"Cunnington, Ben",30,17,5,13,0,1,0,10
North Melbourne,"Dal Santo, Nick",28,19,5,9,0,0,2,5
North Melbourne,"Firrito, Michael",20,11,1,9,0,0,0,2
North Melbourne,"Gibson, Sam",24,16,6,8,0,0,0,5
North Melbourne,"Goldstein, Todd",9,3,0,6,1,0,38,4
North Melbourne,"Greenwood, Levi",21,11,2,10,0,0,0,3
North Melbourne,"Grima, Nathan",20,18,4,2,0,0,0,2
North Melbourne,"Hansen, Lachlan",15,10,5,5,0,0,0,5
North Melbourne,"Harvey, Brent",15,10,3,5,0,1,0,7
North Melbourne,"Jacobs, Ben",3,3,3,0,0,0,0,0
North Melbourne,"McDonald, Luke",20,9,5,11,0,1,0,2
North Melbourne,"McKenzie, Brad",15,8,4,7,0,0,0,3
North Melbourne,"Mullett, Aaron",8,7,0,1,2,1,0,2
North Melbourne,"Nahas, Robin",17,11,4,6,1,0,0,4
North Melbourne,"Petrie, Drew",15,9,4,6,1,1,3,3
North Melbourne,"Thomas, Lindsay",6,4,0,2,1,2,0,3
North Melbourne,"Thompson, Scott",24,14,7,10,0,0,0,4
North Melbourne,"Wells, Daniel",24,16,3,8,3,0,4,4
North Melbourne,"Adams, Leigh",18,7,5,11,0,0,0,2
North Melbourne,"Atley, Shaun",21,8,2,13,0,0,0,1
North Melbourne,"Bastinac, Ryan",16,7,5,9,2,0,0,4
North Melbourne,"Black, Aaron",12,5,3,7,0,1,0,2
North Melbourne,"Cunnington, Ben",28,18,7,10,0,0,0,4
North Melbourne,"Currie, Daniel",6,3,2,3,1,0,3,3
North Melbourne,"Dal Santo, Nick",21,14,2,7,0,1,0,3
North Melbourne,"Firrito, Michael",23,14,7,9,0,0,0,3
North Melbourne,"Gibson, Sam",21,10,6,11,1,0,1,3
North Melbourne,"Goldstein, Todd",15,2,4,13,0,0,23,0
North Melbourne,"Greenwood, Levi",15,8,2,7,1,0,0,5
North Melbourne,"Grima, Nathan",23,14,4,9,0,0,0,0
North Melbourne,"Hansen, Lachlan",11,5,3,6,0,0,0,1
North Melbourne,"Harvey, Brent",29,14,7,15,1,0,0,3
North Melbourne,"Jacobs, Ben",15,8,3,7,0,1,0,4
North Melbourne,"McDonald, Luke",20,11,2,9,0,0,0,2
North Melbourne,"McKenzie, Brad",12,6,3,6,0,0,0,1
North Melbourne,"Mullett, Aaron",13,8,2,5,0,0,0,3
North Melbourne,"Petrie, Drew",13,9,8,4,0,1,0,2
North Melbourne,"Thomas, Lindsay",13,9,2,4,2,1,0,3
North Melbourne,"Thompson, Scott",17,7,5,10,0,0,0,2
North Melbourne,"Wells, Daniel",17,5,2,12,0,0,2,0
North Melbourne,"Adams, Leigh",21,10,6,11,0,0,0,3
North Melbourne,"Atley, Shaun",22,9,7,13,0,0,0,2
North Melbourne,"Bastinac, Ryan",22,12,5,10,0,0,0,1
North Melbourne,"Black, Aaron",10,7,2,3,1,2,0,2
North Melbourne,"Cunnington, Ben",23,12,5,11,0,0,0,7
North Melbourne,"Dal Santo, Nick",28,12,2,16,1,0,2,4
North Melbourne,"Daw, Majak",7,3,2,4,1,2,5,3
North Melbourne,"Firrito, Michael",15,12,2,3,0,0,1,1
North Melbourne,"Gibson, Sam",31,19,7,12,2,1,0,5
North Melbourne,"Goldstein, Todd",9,3,2,6,0,0,24,5
North Melbourne,"Greenwood, Levi",17,7,2,10,0,1,0,3
North Melbourne,"Grima, Nathan",21,16,4,5,0,0,0,2
North Melbourne,"Hansen, Lachlan",19,7,7,12,0,0,0,0
North Melbourne,"Harvey, Brent",29,15,3,14,0,1,0,5
North Melbourne,"McDonald, Luke",17,8,5,9,0,0,0,4
North Melbourne,"McKenzie, Brad",7,6,3,1,0,0,0,1
North Melbourne,"Mullett, Aaron",19,12,5,7,1,0,0,2
North Melbourne,"Nahas, Robin",9,5,1,4,1,1,0,3
North Melbourne,"Petrie, Drew",15,9,3,6,2,1,0,2
North Melbourne,"Thomas, Lindsay",10,6,1,4,1,1,0,5
North Melbourne,"Tippett, Joel",7,5,2,2,0,0,0,0
North Melbourne,"Ziebell, Jack",23,16,7,7,0,1,1,3
North Melbourne,"Adams, Leigh",14,7,2,7,0,0,0,2
North Melbourne,"Atley, Shaun",23,11,6,12,0,0,0,1
North Melbourne,"Bastinac, Ryan",12,9,3,3,1,1,0,1
North Melbourne,"Black, Aaron",11,7,5,4,1,1,0,2
North Melbourne,"Cunnington, Ben",27,16,3,11,0,0,0,6
North Melbourne,"Dal Santo, Nick",26,12,1,14,0,0,0,1
North Melbourne,"Daw, Majak",8,5,2,3,2,1,6,3
North Melbourne,"Firrito, Michael",14,6,2,8,0,0,0,0
North Melbourne,"Gibson, Sam",30,18,9,12,1,0,0,3
North Melbourne,"Goldstein, Todd",15,4,3,11,0,0,43,6
North Melbourne,"Greenwood, Levi",27,15,5,12,1,2,1,8
North Melbourne,"Grima, Nathan",20,17,6,3,0,0,0,3
North Melbourne,"Hansen, Lachlan",30,23,17,7,0,0,1,2
North Melbourne,"Harvey, Brent",19,12,5,7,1,0,0,2
North Melbourne,"McDonald, Luke",5,4,2,1,0,0,0,1
North Melbourne,"McKenzie, Brad",15,9,4,6,1,0,0,2
North Melbourne,"Mullett, Aaron",13,10,4,3,1,0,0,3
North Melbourne,"Petrie, Drew",13,7,4,6,1,1,0,3
North Melbourne,"Thomas, Lindsay",11,8,3,3,1,0,0,5
North Melbourne,"Thompson, Scott",16,7,7,9,0,0,0,0
North Melbourne,"Tippett, Joel",9,5,4,4,0,0,0,0
North Melbourne,"Ziebell, Jack",27,18,9,9,0,0,0,9
North Melbourne,"Adams, Leigh",21,10,5,11,2,0,0,1
North Melbourne,"Atley, Shaun",14,6,2,8,0,0,0,2
North Melbourne,"Bastinac, Ryan",2,1,0,1,0,0,0,2
North Melbourne,"Black, Aaron",12,9,4,3,3,2,0,4
North Melbourne,"Cunnington, Ben",23,11,3,12,0,0,0,6
North Melbourne,"Dal Santo, Nick",34,15,8,19,0,1,1,3
North Melbourne,"Daw, Majak",8,6,5,2,1,4,11,4
North Melbourne,"Gibson, Sam",35,20,10,15,0,1,0,1
North Melbourne,"Goldstein, Todd",10,7,2,3,1,0,33,4
North Melbourne,"Greenwood, Levi",27,12,4,15,1,1,0,1
North Melbourne,"Hansen, Lachlan",18,10,6,8,0,0,0,1
North Melbourne,"Harvey, Brent",39,19,7,20,2,1,0,3
North Melbourne,"McDonald, Luke",22,13,8,9,0,0,0,1
North Melbourne,"McMahon, Scott",10,6,5,4,0,0,0,1
North Melbourne,"Nahas, Robin",22,14,7,8,0,0,0,8
North Melbourne,"Petrie, Drew",13,8,5,5,1,4,0,3
North Melbourne,"Swallow, Andrew",18,9,2,9,0,1,0,2
North Melbourne,"Thomas, Lindsay",19,14,6,5,4,2,0,2
North Melbourne,"Thompson, Scott",18,9,5,9,0,0,0,1
North Melbourne,"Tippett, Joel",9,2,1,7,0,0,0,2
North Melbourne,"Wright, Sam",20,9,4,11,1,2,0,0
North Melbourne,"Ziebell, Jack",23,15,5,8,1,1,0,1
North Melbourne,"Adams, Leigh",21,10,5,11,0,0,0,3
North Melbourne,"Atley, Shaun",19,10,5,9,0,0,0,2
North Melbourne,"Bastinac, Ryan",15,11,2,4,2,2,0,3
North Melbourne,"Black, Aaron",6,4,3,2,1,1,0,2
North Melbourne,"Cunnington, Ben",15,9,3,6,0,0,0,2
North Melbourne,"Dal Santo, Nick",27,16,1,11,0,1,1,3
North Melbourne,"Daw, Majak",9,4,2,5,1,1,6,3
North Melbourne,"Firrito, Michael",18,10,3,8,0,0,0,1
North Melbourne,"Gibson, Sam",19,13,5,6,0,0,0,1
North Melbourne,"Goldstein, Todd",10,1,3,9,0,0,29,3
North Melbourne,"Greenwood, Levi",33,22,8,11,0,0,0,8
North Melbourne,"Hansen, Lachlan",14,7,6,7,0,0,0,1
North Melbourne,"Harvey, Brent",33,15,2,18,0,1,0,3
North Melbourne,"McDonald, Luke",13,7,5,6,0,0,0,1
North Melbourne,"Nahas, Robin",15,9,4,6,2,3,0,3
North Melbourne,"Petrie, Drew",9,6,4,3,3,0,0,2
North Melbourne,"Swallow, Andrew",15,7,4,8,0,1,0,7
North Melbourne,"Thomas, Lindsay",11,8,2,3,3,2,0,1
North Melbourne,"Thompson, Scott",17,9,5,8,0,0,0,1
North Melbourne,"Tippett, Joel",6,5,3,1,0,0,0,2
North Melbourne,"Wright, Sam",10,5,0,5,0,0,0,1
North Melbourne,"Ziebell, Jack",27,20,4,7,1,0,0,5
North Melbourne,"Adams, Leigh",21,13,2,8,2,2,0,8
North Melbourne,"Anthony, Liam",5,3,0,2,1,0,0,2
North Melbourne,"Atley, Shaun",17,10,2,7,1,0,0,2
North Melbourne,"Bastinac, Ryan",27,14,6,13,0,0,0,5
North Melbourne,"Black, Aaron",10,6,6,4,2,1,0,3
North Melbourne,"Cunnington, Ben",33,16,4,17,1,0,0,6
North Melbourne,"Dal Santo, Nick",34,15,6,19,0,1,0,2
North Melbourne,"Daw, Majak",8,5,0,3,0,0,10,6
North Melbourne,"Firrito, Michael",19,9,8,10,0,0,0,2
North Melbourne,"Gibson, Sam",20,14,6,6,0,0,0,10
North Melbourne,"Goldstein, Todd",5,2,0,3,0,1,22,4
North Melbourne,"Greenwood, Levi",33,17,12,16,0,2,0,3
North Melbourne,"Hansen, Lachlan",9,6,5,3,0,0,0,1
North Melbourne,"Harvey, Brent",27,17,2,10,1,1,1,3
North Melbourne,"McDonald, Luke",20,10,6,10,0,0,0,4
North Melbourne,"Mullett, Aaron",19,9,4,10,0,0,0,1
North Melbourne,"Nahas, Robin",16,8,4,8,0,1,0,2
North Melbourne,"Petrie, Drew",9,5,2,4,2,0,1,1
North Melbourne,"Swallow, Andrew",21,12,4,9,1,1,0,9
North Melbourne,"Thomas, Lindsay",7,4,0,3,1,0,0,3
North Melbourne,"Thompson, Scott",22,13,5,9,0,0,0,0
North Melbourne,"Ziebell, Jack",17,13,3,4,0,0,0,3
North Melbourne,"Adams, Leigh",12,4,1,8,0,1,0,3
North Melbourne,"Anthony, Liam",14,7,4,7,0,1,0,2
North Melbourne,"Atley, Shaun",15,6,3,9,0,0,0,2
North Melbourne,"Bastinac, Ryan",17,11,3,6,2,0,0,3
North Melbourne,"Black, Aaron",11,6,2,5,1,0,0,3
North Melbourne,"Cunnington, Ben",17,12,1,5,1,0,0,7
North Melbourne,"Dal Santo, Nick",14,5,0,9,0,1,1,1
North Melbourne,"Daw, Majak",4,1,1,3,0,1,1,2
North Melbourne,"Firrito, Michael",11,10,1,1,0,0,0,3
North Melbourne,"Gibson, Sam",17,9,4,8,0,1,0,7
North Melbourne,"Goldstein, Todd",20,5,6,15,1,0,43,5
North Melbourne,"Greenwood, Levi",29,15,6,14,1,0,0,5
North Melbourne,"Hansen, Lachlan",19,10,7,9,0,0,0,1
North Melbourne,"Harvey, Brent",25,13,6,12,3,2,0,5
North Melbourne,"McDonald, Luke",16,8,3,8,0,0,0,3
North Melbourne,"Mullett, Aaron",15,9,1,6,0,1,0,0
North Melbourne,"Nahas, Robin",18,10,6,8,2,0,0,4
North Melbourne,"Petrie, Drew",15,12,6,3,4,1,0,1
North Melbourne,"Swallow, Andrew",29,14,3,15,0,1,0,7
North Melbourne,"Thompson, Scott",6,3,0,3,0,0,0,2
North Melbourne,"Wright, Sam",15,9,1,6,0,0,0,3
North Melbourne,"Ziebell, Jack",18,12,6,6,2,1,0,7
North Melbourne,"Adams, Leigh",14,2,2,12,0,2,0,4
North Melbourne,"Anthony, Liam",9,5,2,4,0,0,0,1
North Melbourne,"Atley, Shaun",21,8,4,13,0,0,0,3
North Melbourne,"Bastinac, Ryan",15,11,3,4,1,0,0,2
North Melbourne,"Black, Aaron",9,5,3,4,0,0,0,3
North Melbourne,"Cunnington, Ben",24,15,3,9,0,1,0,7
North Melbourne,"Dal Santo, Nick",27,9,2,18,0,0,2,2
North Melbourne,"Firrito, Michael",20,14,6,6,0,0,0,0
North Melbourne,"Gibson, Sam",25,10,4,15,0,0,0,2
North Melbourne,"Goldstein, Todd",10,0,2,10,0,0,38,6
North Melbourne,"Greenwood, Levi",32,18,6,14,1,1,0,2
North Melbourne,"Hansen, Lachlan",16,9,6,7,1,0,0,2
North Melbourne,"Harvey, Brent",31,18,4,13,2,3,0,4
North Melbourne,"McDonald, Luke",22,11,3,11,0,0,0,2
North Melbourne,"Mullett, Aaron",14,7,1,7,0,0,0,2
North Melbourne,"Nahas, Robin",8,6,3,2,0,1,0,2
North Melbourne,"Petrie, Drew",6,4,3,2,1,1,6,3
North Melbourne,"Swallow, Andrew",26,15,2,11,0,0,0,2
North Melbourne,"Tarrant, Robbie",3,1,1,2,0,0,0,1
North Melbourne,"Thomas, Lindsay",10,9,6,1,4,1,0,1
North Melbourne,"Thompson, Scott",16,11,8,5,0,0,0,1
North Melbourne,"Ziebell, Jack",13,5,3,8,0,0,0,4
North Melbourne,"Adams, Leigh",11,5,2,6,0,0,0,3
North Melbourne,"Atley, Shaun",25,7,5,18,1,0,0,0
North Melbourne,"Bastinac, Ryan",18,11,6,7,0,1,0,2
North Melbourne,"Black, Aaron",13,9,6,4,1,0,0,2
North Melbourne,"Brown, Ben",8,4,5,4,1,0,1,1
North Melbourne,"Cunnington, Ben",14,9,4,5,1,0,0,5
North Melbourne,"Dal Santo, Nick",21,10,3,11,0,0,2,4
North Melbourne,"Firrito, Michael",24,15,6,9,0,0,0,2
North Melbourne,"Gibson, Sam",25,14,8,11,0,0,0,4
North Melbourne,"Goldstein, Todd",13,7,4,6,0,0,31,6
North Melbourne,"Greenwood, Levi",30,19,8,11,2,2,0,4
North Melbourne,"Hansen, Lachlan",8,5,4,3,0,0,0,1
North Melbourne,"Harvey, Brent",28,14,5,14,1,0,0,3
North Melbourne,"McDonald, Luke",17,12,6,5,0,1,0,0
North Melbourne,"McKenzie, Brad",17,12,7,5,0,0,0,0
North Melbourne,"Mullett, Aaron",17,11,5,6,2,0,0,1
North Melbourne,"Nahas, Robin",7,5,5,2,1,3,0,3
North Melbourne,"Petrie, Drew",17,13,11,4,1,5,0,5
North Melbourne,"Swallow, Andrew",17,6,1,11,1,0,0,8
North Melbourne,"Thomas, Lindsay",9,9,4,0,2,0,0,5
North Melbourne,"Thompson, Scott",26,17,12,9,0,0,0,3
North Melbourne,"Ziebell, Jack",24,18,9,6,1,2,1,4
North Melbourne,"Adams, Leigh",13,4,1,9,0,0,0,2
North Melbourne,"Atley, Shaun",13,8,1,5,0,0,0,4
North Melbourne,"Bastinac, Ryan",19,9,3,10,0,1,0,2
North Melbourne,"Black, Aaron",10,6,2,4,0,1,0,1
North Melbourne,"Brown, Ben",1,1,1,0,0,0,4,1
North Melbourne,"Cunnington, Ben",19,6,0,13,0,1,0,6
North Melbourne,"Dal Santo, Nick",30,14,4,16,0,0,2,6
North Melbourne,"Firrito, Michael",11,8,2,3,0,0,0,0
North Melbourne,"Gibson, Sam",28,14,6,14,1,1,0,6
North Melbourne,"Goldstein, Todd",11,5,1,6,0,0,48,6
North Melbourne,"Greenwood, Levi",20,11,2,9,0,2,0,5
North Melbourne,"Harvey, Brent",23,10,2,13,1,2,0,2
North Melbourne,"Jacobs, Ben",13,6,1,7,0,0,0,0
North Melbourne,"McDonald, Luke",16,8,2,8,0,0,0,2
North Melbourne,"McKenzie, Brad",4,2,0,2,0,0,0,5
North Melbourne,"Mullett, Aaron",17,14,0,3,0,1,0,0
North Melbourne,"Petrie, Drew",15,11,5,4,4,1,1,4
North Melbourne,"Swallow, Andrew",23,13,0,10,2,0,0,9
North Melbourne,"Thomas, Lindsay",14,10,2,4,1,0,0,2
North Melbourne,"Thompson, Scott",9,6,2,3,0,0,0,2
North Melbourne,"Warren, Max",2,1,0,1,0,0,0,2
North Melbourne,"Ziebell, Jack",17,12,2,5,0,2,0,4
North Melbourne,"Adams, Leigh",18,10,4,8,0,1,0,2
North Melbourne,"Anthony, Liam",12,9,7,3,0,0,0,0
North Melbourne,"Atley, Shaun",27,6,2,21,0,0,0,1
North Melbourne,"Bastinac, Ryan",19,12,3,7,1,1,1,4
North Melbourne,"Black, Aaron",14,10,6,4,3,2,0,0
North Melbourne,"Brown, Ben",13,5,4,8,2,1,1,3
North Melbourne,"Cunnington, Ben",17,8,1,9,0,0,0,4
North Melbourne,"Dal Santo, Nick",36,15,2,21,0,1,1,1
North Melbourne,"Firrito, Michael",20,8,6,12,0,0,0,2
North Melbourne,"Gibson, Sam",25,15,7,10,1,1,0,3
North Melbourne,"Goldstein, Todd",11,4,3,7,0,0,34,4
North Melbourne,"Greenwood, Levi",27,18,6,9,2,0,2,7
North Melbourne,"Hansen, Lachlan",28,20,14,8,0,0,0,1
North Melbourne,"Harvey, Brent",30,17,7,13,0,1,0,1
North Melbourne,"Jacobs, Ben",20,6,4,14,0,0,0,2
North Melbourne,"McDonald, Luke",19,9,3,10,0,0,0,6
North Melbourne,"McMahon, Scott",17,10,6,7,0,0,0,2
North Melbourne,"Petrie, Drew",14,9,5,5,5,1,0,4
North Melbourne,"Swallow, Andrew",22,14,5,8,1,0,0,6
North Melbourne,"Thomas, Lindsay",14,5,2,9,1,0,0,3
North Melbourne,"Thompson, Scott",14,10,8,4,0,0,0,6
North Melbourne,"Wright, Sam",22,12,6,10,0,0,0,1
North Melbourne,"Adams, Leigh",8,2,1,6,1,0,0,2
North Melbourne,"Atley, Shaun",19,11,1,8,0,0,0,2
North Melbourne,"Bastinac, Ryan",20,15,6,5,2,2,0,9
North Melbourne,"Black, Aaron",10,5,6,5,1,0,0,1
North Melbourne,"Brown, Ben",10,7,6,3,1,2,4,1
North Melbourne,"Cunnington, Ben",22,12,5,10,0,0,0,8
North Melbourne,"Dal Santo, Nick",22,14,4,8,0,1,1,4
North Melbourne,"Firrito, Michael",17,12,8,5,0,0,0,1
North Melbourne,"Gibson, Sam",27,14,8,13,0,0,0,0
North Melbourne,"Goldstein, Todd",20,7,5,13,2,0,39,5
North Melbourne,"Greenwood, Levi",24,13,6,11,0,0,1,5
North Melbourne,"Hansen, Lachlan",15,7,8,8,0,0,0,0
North Melbourne,"Harvey, Brent",27,18,8,9,2,0,0,1
North Melbourne,"Jacobs, Ben",16,8,4,8,0,1,0,1
North Melbourne,"McKenzie, Brad",7,5,1,2,0,0,0,2
North Melbourne,"McMahon, Scott",13,7,0,6,1,0,0,1
North Melbourne,"Mullett, Aaron",9,8,1,1,0,0,0,1
North Melbourne,"Petrie, Drew",17,10,7,7,1,1,0,3
North Melbourne,"Swallow, Andrew",25,8,2,17,0,0,0,7
North Melbourne,"Thomas, Lindsay",17,15,4,2,2,4,0,3
North Melbourne,"Thompson, Scott",13,7,2,6,0,0,0,2
North Melbourne,"Wright, Sam",30,21,10,9,0,0,0,1
North Melbourne,"Adams, Leigh",9,3,1,6,0,1,0,1
North Melbourne,"Atley, Shaun",13,3,4,10,0,0,0,1
North Melbourne,"Bastinac, Ryan",12,4,1,8,0,0,0,2
North Melbourne,"Black, Aaron",8,7,5,1,0,1,0,0
North Melbourne,"Cunnington, Ben",13,7,2,6,2,1,0,6
North Melbourne,"Dal Santo, Nick",19,15,3,4,1,1,1,6
North Melbourne,"Daw, Majak",10,7,5,3,0,0,5,4
North Melbourne,"Firrito, Michael",9,7,4,2,0,0,0,1
North Melbourne,"Gibson, Sam",17,9,5,8,0,0,0,2
North Melbourne,"Goldstein, Todd",9,4,1,5,0,0,43,8
North Melbourne,"Greenwood, Levi",22,17,4,5,2,1,0,4
North Melbourne,"Hansen, Lachlan",13,3,6,10,0,0,0,2
North Melbourne,"Harvey, Brent",20,10,7,10,2,0,0,3
North Melbourne,"Jacobs, Ben",13,7,2,6,0,0,0,2
North Melbourne,"McDonald, Luke",23,13,3,10,0,1,0,3
North Melbourne,"McMahon, Scott",7,4,2,3,0,0,0,0
North Melbourne,"Petrie, Drew",11,9,6,2,1,1,0,2
North Melbourne,"Swallow, Andrew",25,11,5,14,0,0,0,6
North Melbourne,"Thomas, Lindsay",9,6,2,3,4,0,0,2
North Melbourne,"Thompson, Scott",16,8,8,8,0,0,0,0
North Melbourne,"Wright, Sam",21,16,6,5,0,0,0,4
North Melbourne,"Ziebell, Jack",5,4,1,1,1,0,0,2
North Melbourne,"Adams, Leigh",10,7,4,3,0,1,0,0
North Melbourne,"Atley, Shaun",14,8,6,6,0,0,0,1
North Melbourne,"Bastinac, Ryan",21,11,5,10,0,0,0,4
North Melbourne,"Black, Aaron",8,6,5,2,2,2,0,2
North Melbourne,"Cunnington, Ben",19,11,4,8,0,0,0,8
North Melbourne,"Dal Santo, Nick",19,10,1,9,1,0,1,3
North Melbourne,"Daw, Majak",5,4,3,1,1,1,10,2
North Melbourne,"Firrito, Michael",10,5,4,5,0,0,0,2
North Melbourne,"Gibson, Sam",23,8,9,15,0,0,0,4
North Melbourne,"Goldstein, Todd",18,7,3,11,0,2,30,5
North Melbourne,"Greenwood, Levi",25,20,6,5,1,2,0,2
North Melbourne,"Hansen, Lachlan",17,8,8,9,0,0,0,1
North Melbourne,"Harvey, Brent",20,10,4,10,1,1,0,2
North Melbourne,"Jacobs, Ben",21,9,6,12,0,0,0,1
North Melbourne,"McDonald, Luke",14,5,1,9,0,1,0,3
North Melbourne,"Mullett, Aaron",7,6,2,1,0,0,0,1
North Melbourne,"Petrie, Drew",6,3,4,3,1,0,0,2
North Melbourne,"Swallow, Andrew",16,8,4,8,0,0,0,3
North Melbourne,"Thomas, Lindsay",13,12,1,1,3,1,0,1
North Melbourne,"Thompson, Scott",15,8,6,7,0,0,0,1
North Melbourne,"Wright, Sam",18,12,4,6,0,1,0,1
North Melbourne,"Ziebell, Jack",18,14,4,4,0,1,0,8
North Melbourne,"Adams, Leigh",22,9,4,13,1,0,0,0
North Melbourne,"Atley, Shaun",16,12,7,4,0,0,0,3
North Melbourne,"Bastinac, Ryan",28,19,9,9,1,1,0,3
North Melbourne,"Black, Aaron",9,7,5,2,1,0,0,0
North Melbourne,"Brown, Ben",8,6,6,2,2,0,6,1
North Melbourne,"Cunnington, Ben",29,15,5,14,3,1,1,6
North Melbourne,"Dal Santo, Nick",10,6,0,4,0,1,0,2
North Melbourne,"Firrito, Michael",15,7,7,8,1,0,0,1
North Melbourne,"Gibson, Sam",18,12,8,6,0,0,0,2
North Melbourne,"Goldstein, Todd",20,7,3,13,0,1,29,3
North Melbourne,"Grima, Nathan",17,11,9,6,0,0,0,1
North Melbourne,"Harvey, Brent",28,15,4,13,2,0,0,0
North Melbourne,"Jacobs, Ben",21,11,5,10,0,0,0,1
North Melbourne,"McDonald, Luke",16,8,4,8,0,1,0,1
North Melbourne,"Mullett, Aaron",6,5,2,1,0,0,0,0
North Melbourne,"Petrie, Drew",18,15,9,3,5,3,0,1
North Melbourne,"Swallow, Andrew",22,8,2,14,0,0,0,4
North Melbourne,"Thomas, Lindsay",15,9,3,6,0,0,0,2
North Melbourne,"Thompson, Scott",11,6,3,5,0,0,0,3
North Melbourne,"Turner, Kayne",12,6,5,6,1,0,0,2
North Melbourne,"Wright, Sam",16,12,5,4,0,0,0,0
North Melbourne,"Ziebell, Jack",21,14,4,7,2,1,1,4
North Melbourne,"Adams, Leigh",7,3,2,4,0,0,0,0
North Melbourne,"Atley, Shaun",19,12,5,7,0,0,0,3
North Melbourne,"Bastinac, Ryan",20,10,5,10,1,0,0,3
North Melbourne,"Black, Aaron",17,10,7,7,2,0,0,1
North Melbourne,"Brown, Ben",15,9,6,6,2,1,3,3
North Melbourne,"Cunnington, Ben",18,10,4,8,4,1,0,9
North Melbourne,"Dal Santo, Nick",14,7,2,7,1,1,0,4
North Melbourne,"Firrito, Michael",19,12,7,7,0,0,0,2
North Melbourne,"Gibson, Sam",31,18,7,13,1,0,0,5
North Melbourne,"Goldstein, Todd",10,6,1,4,1,0,36,5
North Melbourne,"Greenwood, Levi",20,11,3,9,1,0,0,9
North Melbourne,"Grima, Nathan",19,9,7,10,0,0,0,0
North Melbourne,"Harvey, Brent",23,12,6,11,1,1,0,2
North Melbourne,"Jacobs, Ben",18,10,3,8,0,0,0,2
North Melbourne,"McDonald, Luke",18,8,5,10,0,0,0,0
North Melbourne,"Petrie, Drew",17,12,8,5,2,3,0,6
North Melbourne,"Swallow, Andrew",29,16,4,13,0,0,0,11
North Melbourne,"Thomas, Lindsay",16,9,4,7,1,2,0,2
North Melbourne,"Thompson, Scott",22,16,8,6,0,0,0,2
North Melbourne,"Wells, Daniel",18,9,4,9,0,0,1,7
North Melbourne,"Wright, Sam",23,17,6,6,0,0,0,0
North Melbourne,"Ziebell, Jack",15,9,1,6,0,0,0,5
North Melbourne,"Adams, Leigh",7,2,1,5,0,0,0,1
North Melbourne,"Atley, Shaun",16,8,1,8,0,0,0,3
North Melbourne,"Bastinac, Ryan",22,13,3,9,2,0,0,2
North Melbourne,"Black, Aaron",10,7,5,3,0,2,0,1
North Melbourne,"Brown, Ben",11,6,3,5,1,1,2,0
North Melbourne,"Cunnington, Ben",21,8,4,13,0,0,0,2
North Melbourne,"Dal Santo, Nick",28,20,4,8,0,1,0,1
North Melbourne,"Firrito, Michael",19,10,5,9,0,0,0,1
North Melbourne,"Gibson, Sam",25,13,5,12,0,0,0,1
North Melbourne,"Goldstein, Todd",11,2,0,9,1,1,37,6
North Melbourne,"Greenwood, Levi",26,15,8,11,0,3,0,3
North Melbourne,"Grima, Nathan",15,9,4,6,0,0,0,2
North Melbourne,"Jacobs, Ben",13,6,2,7,0,0,0,2
North Melbourne,"McDonald, Luke",11,7,2,4,0,0,0,5
North Melbourne,"Mullett, Aaron",15,12,3,3,0,0,0,1
North Melbourne,"Petrie, Drew",10,9,6,1,3,0,0,2
North Melbourne,"Swallow, Andrew",24,12,2,12,0,0,0,5
North Melbourne,"Thomas, Lindsay",16,9,3,7,1,2,0,0
North Melbourne,"Thompson, Scott",13,8,3,5,0,0,0,3
North Melbourne,"Turner, Kayne",12,10,4,2,2,1,0,5
North Melbourne,"Wright, Sam",18,14,7,4,0,0,0,0
North Melbourne,"Ziebell, Jack",25,18,8,7,4,5,0,3
North Melbourne,"Adams, Leigh",9,4,3,5,1,0,0,3
North Melbourne,"Atley, Shaun",21,11,5,10,1,0,0,3
North Melbourne,"Bastinac, Ryan",15,10,2,5,1,0,0,4
North Melbourne,"Black, Aaron",11,7,6,4,0,1,0,3
North Melbourne,"Brown, Ben",16,10,5,6,3,2,5,0
North Melbourne,"Cunnington, Ben",16,4,3,12,0,0,0,3
North Melbourne,"Currie, Daniel",5,2,3,3,1,0,36,6
North Melbourne,"Dal Santo, Nick",14,9,2,5,1,0,0,1
North Melbourne,"Gibson, Sam",15,13,6,2,0,0,0,2
North Melbourne,"Grima, Nathan",11,7,3,4,0,0,0,2
North Melbourne,"Hansen, Lachlan",5,4,3,1,0,0,0,1
North Melbourne,"Jacobs, Ben",11,3,2,8,0,0,0,1
North Melbourne,"Macmillan, Jamie",15,8,4,7,0,0,0,0
North Melbourne,"Mullett, Aaron",18,15,4,3,1,0,0,2
North Melbourne,"Petrie, Drew",13,10,5,3,1,2,0,4
North Melbourne,"Swallow, Andrew",21,14,1,7,0,1,0,8
North Melbourne,"Thompson, Scott",19,9,6,10,0,0,0,4
North Melbourne,"Turner, Kayne",11,8,2,3,4,0,0,5
North Melbourne,"Wells, Daniel",20,13,3,7,0,1,0,2
North Melbourne,"Wood, Mason",7,6,4,1,3,1,0,3
North Melbourne,"Wright, Sam",14,9,5,5,0,0,0,5
North Melbourne,"Ziebell, Jack",17,12,3,5,2,0,1,8
North Melbourne,"Atley, Shaun",21,16,4,5,0,1,0,1
North Melbourne,"Bastinac, Ryan",7,5,1,2,0,0,0,0
North Melbourne,"Black, Aaron",12,10,9,2,0,0,0,3
North Melbourne,"Brown, Ben",9,8,6,1,4,1,0,1
North Melbourne,"Cunnington, Ben",30,12,7,18,1,0,0,3
North Melbourne,"Dal Santo, Nick",24,16,4,8,1,0,1,4
North Melbourne,"Firrito, Michael",10,5,5,5,0,0,0,3
North Melbourne,"Gibson, Sam",27,17,10,10,1,0,0,3
North Melbourne,"Goldstein, Todd",11,4,1,7,0,0,39,7
North Melbourne,"Greenwood, Levi",32,20,7,12,1,0,0,7
North Melbourne,"Grima, Nathan",19,12,10,7,0,0,0,2
North Melbourne,"Jacobs, Ben",15,6,2,9,0,0,0,1
North Melbourne,"Macmillan, Jamie",19,10,5,9,0,0,0,5
North Melbourne,"McDonald, Luke",11,7,4,4,0,0,0,2
North Melbourne,"Petrie, Drew",11,7,5,4,2,2,2,0
North Melbourne,"Swallow, Andrew",23,9,5,14,0,1,0,3
North Melbourne,"Thomas, Lindsay",10,8,2,2,3,1,0,2
North Melbourne,"Thompson, Scott",24,17,13,7,0,1,0,2
North Melbourne,"Turner, Kayne",12,7,3,5,0,0,0,3
North Melbourne,"Wells, Daniel",28,14,9,14,0,0,0,1
North Melbourne,"Wright, Sam",23,14,8,9,0,0,0,1
North Melbourne,"Ziebell, Jack",12,10,2,2,1,0,1,3
North Melbourne,"Atley, Shaun",9,4,2,5,0,0,0,2
North Melbourne,"Bastinac, Ryan",2,2,1,0,0,0,0,1
North Melbourne,"Black, Aaron",11,7,4,4,1,3,0,2
North Melbourne,"Brown, Ben",8,4,3,4,0,1,0,4
North Melbourne,"Cunnington, Ben",22,7,1,15,0,0,0,3
North Melbourne,"Dal Santo, Nick",35,22,8,13,1,0,1,4
North Melbourne,"Firrito, Michael",13,8,2,5,0,0,0,3
North Melbourne,"Gibson, Sam",35,17,8,18,0,0,0,5
North Melbourne,"Goldstein, Todd",15,8,4,7,1,1,54,5
North Melbourne,"Greenwood, Levi",22,14,5,8,0,1,0,5
North Melbourne,"Grima, Nathan",13,10,3,3,0,0,0,1
North Melbourne,"Harvey, Brent",25,14,2,11,1,0,0,3
North Melbourne,"Macmillan, Jamie",5,1,0,4,0,0,0,1
North Melbourne,"McDonald, Luke",20,11,6,9,0,0,0,1
North Melbourne,"Petrie, Drew",13,11,7,2,4,4,0,2
North Melbourne,"Swallow, Andrew",21,9,4,12,0,0,0,4
North Melbourne,"Thomas, Lindsay",9,8,3,1,3,3,0,1
North Melbourne,"Thompson, Scott",17,10,6,7,0,0,0,3
North Melbourne,"Turner, Kayne",8,3,2,5,1,0,0,9
North Melbourne,"Wells, Daniel",22,11,5,11,0,0,0,1
North Melbourne,"Wright, Sam",21,12,5,9,0,0,0,1
North Melbourne,"Ziebell, Jack",13,10,6,3,2,0,0,8
North Melbourne,"Atley, Shaun",19,10,3,9,1,0,0,0
North Melbourne,"Bastinac, Ryan",6,3,1,3,0,1,0,1
North Melbourne,"Black, Aaron",2,1,0,1,0,0,0,2
North Melbourne,"Brown, Ben",8,6,4,2,2,0,1,2
North Melbourne,"Cunnington, Ben",28,14,3,14,0,0,0,4
North Melbourne,"Dal Santo, Nick",24,7,3,17,0,0,2,2
North Melbourne,"Firrito, Michael",20,9,8,11,0,0,0,4
North Melbourne,"Gibson, Sam",19,9,2,10,0,0,0,1
North Melbourne,"Goldstein, Todd",12,4,1,8,1,0,29,2
North Melbourne,"Greenwood, Levi",21,13,1,8,1,0,0,1
North Melbourne,"Grima, Nathan",11,8,5,3,0,0,0,3
North Melbourne,"Harvey, Brent",19,13,3,6,1,1,0,6
North Melbourne,"Jacobs, Ben",11,7,2,4,0,0,0,2
North Melbourne,"McDonald, Luke",13,7,2,6,0,1,0,2
North Melbourne,"Petrie, Drew",15,14,8,1,3,4,0,3
North Melbourne,"Swallow, Andrew",18,10,4,8,0,0,0,6
North Melbourne,"Thomas, Lindsay",15,6,3,9,0,0,0,2
North Melbourne,"Thompson, Scott",9,2,2,7,0,0,0,0
North Melbourne,"Turner, Kayne",7,5,3,2,0,0,0,2
North Melbourne,"Wells, Daniel",15,9,7,6,0,1,0,0
North Melbourne,"Wright, Sam",22,13,7,9,0,0,0,0
North Melbourne,"Ziebell, Jack",15,5,2,10,0,1,0,5
Port Adelaide,"Boak, Travis",23,9,2,14,0,0,0,6
Port Adelaide,"Broadbent, Matthew",9,8,4,1,0,1,0,0
Port Adelaide,"Butcher, John",12,8,4,4,1,2,0,4
Port Adelaide,"Cassisi, Domenic",6,3,1,3,0,0,0,2
Port Adelaide,"Clurey, Tom",7,6,2,1,0,0,0,1
Port Adelaide,"Cornes, Kane",30,20,12,10,0,0,0,5
Port Adelaide,"Ebert, Brad",16,11,6,5,1,0,1,8
Port Adelaide,"Gray, Robbie",17,11,3,6,4,1,0,2
Port Adelaide,"Hartlett, Hamish",21,10,4,11,2,0,0,1
Port Adelaide,"Hombsch, Jack",15,10,7,5,0,0,0,1
Port Adelaide,"Impey, Jarman",12,8,3,4,0,0,0,3
Port Adelaide,"Jonas, Tom",10,2,2,8,0,0,0,3
Port Adelaide,"Lobbe, Matthew",12,7,2,5,0,0,28,5
Port Adelaide,"Monfries, Angus",20,16,8,4,0,0,0,3
Port Adelaide,"Pittard, Jasper",16,11,5,5,0,0,0,1
Port Adelaide,"Polec, Jared",24,15,4,9,1,1,0,1
Port Adelaide,"Schulz, Jay",15,11,9,4,2,1,0,3
Port Adelaide,"Trengove, Jackson",15,6,3,9,0,0,4,3
Port Adelaide,"Westhoff, Justin",20,13,8,7,5,0,0,1
Port Adelaide,"White, Matt",12,10,8,2,0,2,0,4
Port Adelaide,"Wines, Ollie",28,13,6,15,2,2,1,9
Port Adelaide,"Wingard, Chad",22,13,5,9,0,0,0,7
Port Adelaide,"Boak, Travis",19,9,1,10,1,0,0,2
Port Adelaide,"Broadbent, Matthew",18,15,4,3,0,0,0,2
Port Adelaide,"Butcher, John",11,6,3,5,1,0,0,0
Port Adelaide,"Carlile, Alipate",3,2,1,1,0,0,0,4
Port Adelaide,"Cassisi, Domenic",20,3,0,17,0,0,0,2
Port Adelaide,"Cornes, Kane",33,22,10,11,0,0,0,5
Port Adelaide,"Ebert, Brad",21,17,10,4,1,1,0,9
Port Adelaide,"Gray, Robbie",13,6,2,7,2,2,0,2
Port Adelaide,"Hartlett, Hamish",29,16,6,13,1,1,0,1
Port Adelaide,"Hombsch, Jack",17,9,1,8,0,0,0,2
Port Adelaide,"Impey, Jarman",13,11,1,2,0,0,0,2
Port Adelaide,"Jonas, Tom",10,7,6,3,0,0,0,3
Port Adelaide,"Lobbe, Matthew",13,4,1,9,1,0,29,4
Port Adelaide,"Monfries, Angus",19,15,7,4,0,1,0,5
Port Adelaide,"Pittard, Jasper",16,13,4,3,0,0,0,4
Port Adelaide,"Polec, Jared",20,12,4,8,0,1,0,3
Port Adelaide,"Schulz, Jay",19,14,10,5,3,1,0,2
Port Adelaide,"Trengove, Jackson",14,4,2,10,0,0,3,3
Port Adelaide,"Westhoff, Justin",12,11,6,1,1,0,0,4
Port Adelaide,"White, Matt",9,7,3,2,2,1,0,1
Port Adelaide,"Wines, Ollie",23,13,2,10,2,1,0,6
Port Adelaide,"Wingard, Chad",17,14,6,3,4,2,0,4
Port Adelaide,"Boak, Travis",29,13,3,16,1,1,0,0
Port Adelaide,"Broadbent, Matthew",26,20,5,6,1,0,0,1
Port Adelaide,"Butcher, John",10,7,6,3,0,1,0,1
Port Adelaide,"Carlile, Alipate",10,5,2,5,0,0,0,1
Port Adelaide,"Cassisi, Domenic",18,7,3,11,0,0,0,5
Port Adelaide,"Cornes, Kane",20,9,4,11,0,0,0,3
Port Adelaide,"Ebert, Brad",23,14,2,9,0,1,2,7
Port Adelaide,"Gray, Robbie",24,8,2,16,0,0,0,2
Port Adelaide,"Hartlett, Hamish",21,14,7,7,2,0,2,6
Port Adelaide,"Hombsch, Jack",15,9,4,6,0,0,0,4
Port Adelaide,"Impey, Jarman",8,5,2,3,0,1,0,6
Port Adelaide,"Jonas, Tom",14,6,3,8,0,0,0,3
Port Adelaide,"Lobbe, Matthew",5,1,1,4,0,0,29,6
Port Adelaide,"Monfries, Angus",14,10,5,4,2,2,0,2
Port Adelaide,"Pittard, Jasper",9,5,1,4,0,0,0,1
Port Adelaide,"Polec, Jared",19,11,3,8,0,1,0,3
Port Adelaide,"Schulz, Jay",9,5,2,4,3,0,0,2
Port Adelaide,"Trengove, Jackson",16,6,4,10,0,0,0,3
Port Adelaide,"Westhoff, Justin",17,14,10,3,1,1,4,1
Port Adelaide,"White, Matt",16,7,1,9,0,0,0,3
Port Adelaide,"Wines, Ollie",26,12,4,14,1,1,3,7
Port Adelaide,"Wingard, Chad",14,8,2,6,2,2,0,4
Port Adelaide,"Boak, Travis",41,13,7,28,1,1,0,4
Port Adelaide,"Broadbent, Matthew",28,18,8,10,0,0,0,1
Port Adelaide,"Carlile, Alipate",8,5,4,3,0,0,0,2
Port Adelaide,"Cassisi, Domenic",19,10,5,9,0,1,0,2
Port Adelaide,"Cornes, Kane",38,19,7,19,0,0,0,7
Port Adelaide,"Ebert, Brad",35,18,9,17,1,0,0,8
Port Adelaide,"Gray, Robbie",29,19,9,10,2,4,0,2
Port Adelaide,"Gray, Sam",16,10,5,6,3,0,0,3
Port Adelaide,"Hartlett, Hamish",16,8,4,8,0,1,0,6
Port Adelaide,"Hombsch, Jack",8,5,6,3,0,0,0,3
Port Adelaide,"Impey, Jarman",8,5,2,3,1,0,0,3
Port Adelaide,"Jonas, Tom",21,8,7,13,0,0,0,1
Port Adelaide,"Lobbe, Matthew",12,6,3,6,0,0,27,3
Port Adelaide,"OShea, Cameron",16,8,3,8,0,0,0,2
Port Adelaide,"Pittard, Jasper",19,15,4,4,0,1,0,5
Port Adelaide,"Polec, Jared",25,16,7,9,1,0,2,3
Port Adelaide,"Schulz, Jay",12,10,7,2,7,1,0,5
Port Adelaide,"Trengove, Jackson",14,5,5,9,0,0,10,1
Port Adelaide,"Westhoff, Justin",20,13,10,7,3,1,0,1
Port Adelaide,"White, Matt",26,19,9,7,3,2,0,7
Port Adelaide,"Wines, Ollie",28,10,2,18,1,0,5,4
Port Adelaide,"Young, Aaron",8,3,4,5,1,0,1,1
Port Adelaide,"Boak, Travis",17,9,1,8,0,0,0,7
Port Adelaide,"Broadbent, Matthew",19,13,2,6,0,0,0,2
Port Adelaide,"Carlile, Alipate",17,10,5,7,0,0,0,3
Port Adelaide,"Cassisi, Domenic",16,7,3,9,0,1,0,9
Port Adelaide,"Cornes, Kane",20,11,4,9,0,0,0,3
Port Adelaide,"Ebert, Brad",26,19,10,7,2,1,3,2
Port Adelaide,"Gray, Robbie",24,14,8,10,2,0,0,4
Port Adelaide,"Gray, Sam",11,6,1,5,0,0,0,3
Port Adelaide,"Hartlett, Hamish",20,13,6,7,1,1,0,1
Port Adelaide,"Impey, Jarman",16,11,5,5,0,0,0,1
Port Adelaide,"Jonas, Tom",12,9,5,3,0,0,0,2
Port Adelaide,"Lobbe, Matthew",8,4,2,4,1,1,25,8
Port Adelaide,"OShea, Cameron",14,6,5,8,0,0,0,5
Port Adelaide,"Pittard, Jasper",15,11,4,4,0,0,0,2
Port Adelaide,"Polec, Jared",27,20,7,7,0,1,0,4
Port Adelaide,"Schulz, Jay",15,10,8,5,2,1,0,2
Port Adelaide,"Trengove, Jackson",15,7,3,8,0,0,4,3
Port Adelaide,"Westhoff, Justin",22,14,6,8,0,0,0,4
Port Adelaide,"White, Matt",19,12,6,7,1,1,0,2
Port Adelaide,"Wines, Ollie",19,12,5,7,0,0,1,6
Port Adelaide,"Wingard, Chad",10,7,6,3,1,1,0,2
Port Adelaide,"Young, Aaron",6,2,2,4,0,0,0,0
Port Adelaide,"Boak, Travis",32,13,5,19,2,0,0,4
Port Adelaide,"Broadbent, Matthew",18,16,4,2,0,1,0,2
Port Adelaide,"Carlile, Alipate",10,4,2,6,0,0,0,0
Port Adelaide,"Cassisi, Domenic",15,9,2,6,0,0,0,0
Port Adelaide,"Cornes, Kane",33,16,7,17,0,0,0,4
Port Adelaide,"Ebert, Brad",28,20,5,8,0,0,5,5
Port Adelaide,"Gray, Robbie",20,14,10,6,2,2,0,1
Port Adelaide,"Gray, Sam",10,4,3,6,1,0,0,1
Port Adelaide,"Hartlett, Hamish",29,18,8,11,2,1,0,2
Port Adelaide,"Hombsch, Jack",25,17,9,8,0,0,0,4
Port Adelaide,"Impey, Jarman",3,1,0,2,0,0,0,1
Port Adelaide,"Jonas, Tom",15,6,4,9,0,0,0,2
Port Adelaide,"Lobbe, Matthew",13,6,3,7,2,0,32,4
Port Adelaide,"Pittard, Jasper",15,6,8,9,0,0,0,2
Port Adelaide,"Polec, Jared",24,11,3,13,0,1,0,2
Port Adelaide,"Schulz, Jay",9,7,5,2,1,0,0,2
Port Adelaide,"Trengove, Jackson",12,7,2,5,0,1,6,1
Port Adelaide,"Westhoff, Justin",12,8,3,4,0,1,0,2
Port Adelaide,"White, Matt",12,10,4,2,2,1,0,4
Port Adelaide,"Wines, Ollie",24,5,3,19,0,0,5,5
Port Adelaide,"Wingard, Chad",16,12,7,4,3,1,0,0
Port Adelaide,"Young, Aaron",15,7,3,8,1,1,0,4
Port Adelaide,"Boak, Travis",19,8,3,11,0,1,0,4
Port Adelaide,"Broadbent, Matthew",14,9,2,5,0,0,0,3
Port Adelaide,"Cassisi, Domenic",9,4,1,5,0,0,0,3
Port Adelaide,"Cornes, Kane",29,15,3,14,0,1,0,5
Port Adelaide,"Ebert, Brad",15,10,2,5,0,1,1,4
Port Adelaide,"Gray, Robbie",30,18,5,12,1,2,1,4
Port Adelaide,"Hombsch, Jack",18,9,4,9,0,0,0,2
Port Adelaide,"Impey, Jarman",4,3,0,1,1,1,0,2
Port Adelaide,"Jonas, Tom",7,3,3,4,0,0,0,2
Port Adelaide,"Lobbe, Matthew",8,3,1,5,0,0,25,8
Port Adelaide,"Monfries, Angus",10,6,1,4,3,1,0,7
Port Adelaide,"Newton, Ben",15,4,4,11,0,1,0,3
Port Adelaide,"Pittard, Jasper",18,12,2,6,0,0,2,4
Port Adelaide,"Polec, Jared",30,20,2,10,3,0,0,2
Port Adelaide,"Schulz, Jay",12,9,7,3,6,0,0,0
Port Adelaide,"Stewart, Paul",22,11,7,11,0,0,0,2
Port Adelaide,"Trengove, Jackson",16,8,3,8,0,0,4,2
Port Adelaide,"Westhoff, Justin",13,10,4,3,0,1,3,0
Port Adelaide,"White, Matt",20,13,7,7,3,0,0,3
Port Adelaide,"Wines, Ollie",28,16,2,12,0,1,2,4
Port Adelaide,"Wingard, Chad",16,9,1,7,3,0,0,2
Port Adelaide,"Young, Aaron",18,7,5,11,0,0,0,3
Port Adelaide,"Boak, Travis",28,11,4,17,0,0,0,3
Port Adelaide,"Broadbent, Matthew",16,11,4,5,0,0,0,1
Port Adelaide,"Carlile, Alipate",11,7,1,4,0,0,0,3
Port Adelaide,"Cassisi, Domenic",15,2,0,13,0,0,0,4
Port Adelaide,"Cornes, Kane",29,15,4,14,0,0,0,5
Port Adelaide,"Ebert, Brad",20,13,8,7,0,0,3,8
Port Adelaide,"Gray, Robbie",30,15,5,15,0,0,0,2
Port Adelaide,"Hartlett, Hamish",19,8,3,11,0,0,1,9
Port Adelaide,"Hombsch, Jack",10,7,5,3,0,0,0,2
Port Adelaide,"Impey, Jarman",10,6,2,4,0,0,0,1
Port Adelaide,"Mitchell, Kane",20,15,5,5,2,1,0,8
Port Adelaide,"Monfries, Angus",20,8,2,12,0,0,0,2
Port Adelaide,"Pittard, Jasper",22,16,3,6,1,1,0,0
Port Adelaide,"Polec, Jared",18,7,0,11,0,2,1,4
Port Adelaide,"Renouf, Brent",3,1,1,2,0,1,13,1
Port Adelaide,"Schulz, Jay",5,4,3,1,1,1,0,4
Port Adelaide,"Trengove, Jackson",14,9,3,5,0,0,11,6
Port Adelaide,"Westhoff, Justin",19,11,9,8,0,1,3,2
Port Adelaide,"White, Matt",17,7,3,10,2,1,0,3
Port Adelaide,"Wines, Ollie",27,11,7,16,1,2,3,3
Port Adelaide,"Wingard, Chad",17,13,5,4,5,2,0,2
Port Adelaide,"Young, Aaron",6,2,1,4,1,0,0,2
Port Adelaide,"Boak, Travis",34,16,4,18,1,0,0,7
Port Adelaide,"Broadbent, Matthew",21,16,5,5,0,0,0,1
Port Adelaide,"Carlile, Alipate",12,7,6,5,0,0,0,2
Port Adelaide,"Cassisi, Domenic",9,4,2,5,0,0,0,1
Port Adelaide,"Cornes, Kane",25,15,5,10,0,1,0,2
Port Adelaide,"Ebert, Brad",28,15,7,13,0,0,1,6
Port Adelaide,"Gray, Robbie",18,10,2,8,2,0,0,3
Port Adelaide,"Hartlett, Hamish",14,7,3,7,2,1,0,2
Port Adelaide,"Hombsch, Jack",8,6,6,2,0,1,0,3
Port Adelaide,"Impey, Jarman",12,9,4,3,0,0,0,1
Port Adelaide,"Lobbe, Matthew",13,3,2,10,0,0,34,5
Port Adelaide,"Mitchell, Kane",15,9,5,6,1,0,0,8
Port Adelaide,"Monfries, Angus",10,6,2,4,4,1,0,4
Port Adelaide,"Pittard, Jasper",14,10,3,4,0,0,0,1
Port Adelaide,"Polec, Jared",26,15,8,11,1,0,0,1
Port Adelaide,"Schulz, Jay",6,3,0,3,1,0,0,2
Port Adelaide,"Trengove, Jackson",17,8,6,9,0,0,7,1
Port Adelaide,"Westhoff, Justin",15,11,8,4,0,1,1,1
Port Adelaide,"White, Matt",12,5,2,7,0,0,0,1
Port Adelaide,"Wines, Ollie",22,12,3,10,0,0,4,7
Port Adelaide,"Wingard, Chad",15,8,1,7,3,3,0,2
Port Adelaide,"Young, Aaron",5,0,0,5,0,0,0,1
Port Adelaide,"Boak, Travis",28,14,5,14,1,1,0,1
Port Adelaide,"Broadbent, Matthew",24,20,10,4,0,0,0,2
Port Adelaide,"Carlile, Alipate",13,10,6,3,0,0,0,0
Port Adelaide,"Cornes, Kane",30,16,6,14,0,0,0,3
Port Adelaide,"Ebert, Brad",13,5,2,8,1,0,1,7
Port Adelaide,"Gray, Robbie",25,13,2,12,2,1,0,3
Port Adelaide,"Hombsch, Jack",17,15,9,2,0,0,0,5
Port Adelaide,"Impey, Jarman",16,9,4,7,0,0,0,3
Port Adelaide,"Lobbe, Matthew",15,3,4,12,0,0,28,5
Port Adelaide,"Mitchell, Kane",18,10,3,8,1,0,0,2
Port Adelaide,"Moore, Andrew",8,3,2,5,0,0,0,2
Port Adelaide,"Neade, Jake",8,4,4,4,1,1,0,1
Port Adelaide,"Pittard, Jasper",17,9,9,8,0,1,0,2
Port Adelaide,"Polec, Jared",10,6,1,4,1,0,0,2
Port Adelaide,"Schulz, Jay",12,6,6,6,2,0,0,1
Port Adelaide,"Stewart, Paul",11,6,4,5,0,0,0,2
Port Adelaide,"Trengove, Jackson",16,8,6,8,0,0,1,0
Port Adelaide,"Westhoff, Justin",20,16,9,4,2,2,1,3
Port Adelaide,"White, Matt",16,12,3,4,1,1,0,5
Port Adelaide,"Wines, Ollie",25,9,2,16,1,0,1,3
Port Adelaide,"Wingard, Chad",5,4,0,1,0,0,0,1
Port Adelaide,"Young, Aaron",17,6,5,11,1,0,3,2
Port Adelaide,"Broadbent, Matthew",20,15,8,5,0,0,0,2
Port Adelaide,"Carlile, Alipate",19,13,7,6,0,0,0,1
Port Adelaide,"Cassisi, Domenic",15,6,4,9,1,1,0,5
Port Adelaide,"Cornes, Kane",23,15,4,8,0,0,0,5
Port Adelaide,"Ebert, Brad",22,11,4,11,1,0,0,9
Port Adelaide,"Gray, Robbie",25,16,6,9,4,1,0,3
Port Adelaide,"Gray, Sam",15,6,3,9,0,0,0,4
Port Adelaide,"Hartlett, Hamish",36,17,8,19,1,1,0,5
Port Adelaide,"Hombsch, Jack",8,5,5,3,0,0,0,1
Port Adelaide,"Impey, Jarman",20,16,8,4,1,0,0,1
Port Adelaide,"Jonas, Tom",19,11,7,8,0,0,0,0
Port Adelaide,"Lobbe, Matthew",11,8,5,3,1,0,43,8
Port Adelaide,"Mitchell, Kane",18,13,8,5,0,2,0,6
Port Adelaide,"Newton, Ben",12,8,2,4,0,1,0,0
Port Adelaide,"Pittard, Jasper",25,16,13,9,1,0,0,1
Port Adelaide,"Polec, Jared",18,12,4,6,1,2,0,4
Port Adelaide,"Schulz, Jay",17,15,11,2,3,2,0,2
Port Adelaide,"Trengove, Jackson",16,9,4,7,1,1,5,1
Port Adelaide,"Westhoff, Justin",19,11,9,8,1,0,3,3
Port Adelaide,"Wines, Ollie",26,8,1,18,0,0,3,5
Port Adelaide,"Wingard, Chad",23,16,10,7,3,2,0,3
Port Adelaide,"Young, Aaron",14,4,4,10,0,0,1,0
Port Adelaide,"Boak, Travis",26,8,4,18,0,0,1,4
Port Adelaide,"Broadbent, Matthew",24,16,5,8,0,1,0,4
Port Adelaide,"Carlile, Alipate",14,6,1,8,0,0,0,1
Port Adelaide,"Cassisi, Domenic",17,9,2,8,0,0,0,5
Port Adelaide,"Cornes, Kane",18,7,3,11,0,0,0,1
Port Adelaide,"Ebert, Brad",40,17,5,23,1,1,3,5
Port Adelaide,"Gray, Robbie",35,12,1,23,0,2,0,3
Port Adelaide,"Hartlett, Hamish",7,4,2,3,0,0,0,0
Port Adelaide,"Hombsch, Jack",16,9,6,7,0,0,0,3
Port Adelaide,"Impey, Jarman",8,3,3,5,0,0,0,3
Port Adelaide,"Jonas, Tom",23,7,4,16,0,0,0,1
Port Adelaide,"Lobbe, Matthew",21,12,3,9,0,1,40,8
Port Adelaide,"Mitchell, Kane",19,10,3,9,0,3,0,8
Port Adelaide,"Monfries, Angus",12,6,2,6,3,0,0,5
Port Adelaide,"Pittard, Jasper",18,14,5,4,0,0,0,0
Port Adelaide,"Schulz, Jay",13,9,7,4,4,1,0,8
Port Adelaide,"Trengove, Jackson",19,6,5,13,0,0,3,3
Port Adelaide,"Westhoff, Justin",23,15,8,8,1,2,0,3
Port Adelaide,"White, Matt",16,12,4,4,2,1,2,4
Port Adelaide,"Wines, Ollie",26,7,2,19,0,0,3,6
Port Adelaide,"Wingard, Chad",16,9,1,7,2,0,0,4
Port Adelaide,"Young, Aaron",13,6,1,7,0,0,0,2
Port Adelaide,"Boak, Travis",30,14,4,16,2,1,0,4
Port Adelaide,"Broadbent, Matthew",20,13,6,7,0,0,0,5
Port Adelaide,"Carlile, Alipate",16,8,5,8,0,0,0,1
Port Adelaide,"Cornes, Kane",28,16,5,12,1,1,0,5
Port Adelaide,"Ebert, Brad",21,12,2,9,1,0,0,6
Port Adelaide,"Gray, Robbie",28,10,9,18,0,1,0,3
Port Adelaide,"Gray, Sam",12,8,5,4,1,2,0,4
Port Adelaide,"Hombsch, Jack",25,9,6,16,0,0,0,3
Port Adelaide,"Jonas, Tom",17,10,4,7,1,0,0,3
Port Adelaide,"Lobbe, Matthew",8,4,1,4,0,0,28,11
Port Adelaide,"Logan, Tom",21,12,8,9,0,0,0,6
Port Adelaide,"Mitchell, Kane",13,4,2,9,1,0,0,3
Port Adelaide,"Monfries, Angus",12,3,2,9,0,0,0,4
Port Adelaide,"Pittard, Jasper",16,10,2,6,0,0,0,3
Port Adelaide,"Polec, Jared",17,12,2,5,1,1,3,2
Port Adelaide,"Schulz, Jay",22,16,14,6,8,2,0,2
Port Adelaide,"Trengove, Jackson",14,7,2,7,0,0,10,3
Port Adelaide,"Westhoff, Justin",25,14,10,11,3,1,5,6
Port Adelaide,"White, Matt",15,12,6,3,0,0,0,4
Port Adelaide,"Wines, Ollie",30,7,2,23,0,0,2,6
Port Adelaide,"Wingard, Chad",30,13,3,17,0,1,0,4
Port Adelaide,"Young, Aaron",6,3,0,3,0,1,1,1
Port Adelaide,"Boak, Travis",33,14,5,19,1,0,0,2
Port Adelaide,"Broadbent, Matthew",19,13,6,6,0,0,0,3
Port Adelaide,"Carlile, Alipate",10,5,2,5,0,0,0,2
Port Adelaide,"Cornes, Kane",22,9,3,13,0,0,0,10
Port Adelaide,"Ebert, Brad",23,13,4,10,1,0,1,8
Port Adelaide,"Gray, Robbie",21,11,1,10,0,2,0,6
Port Adelaide,"Gray, Sam",13,8,5,5,0,1,0,0
Port Adelaide,"Hartlett, Hamish",11,7,2,4,1,0,0,3
Port Adelaide,"Hombsch, Jack",11,7,5,4,0,0,1,6
Port Adelaide,"Impey, Jarman",8,3,2,5,0,0,0,6
Port Adelaide,"Jonas, Tom",18,8,2,10,0,0,0,3
Port Adelaide,"Lobbe, Matthew",8,3,1,5,0,0,43,4
Port Adelaide,"Mitchell, Kane",11,6,3,5,0,0,0,6
Port Adelaide,"Monfries, Angus",8,6,4,2,0,1,0,1
Port Adelaide,"Pittard, Jasper",20,17,7,3,0,0,0,5
Port Adelaide,"Polec, Jared",14,10,1,4,3,0,0,3
Port Adelaide,"Schulz, Jay",10,7,6,3,2,1,1,6
Port Adelaide,"Trengove, Jackson",6,1,1,5,0,0,1,2
Port Adelaide,"Westhoff, Justin",16,11,4,5,1,2,2,0
Port Adelaide,"White, Matt",17,12,7,5,1,1,0,8
Port Adelaide,"Wines, Ollie",29,13,2,16,0,1,0,6
Port Adelaide,"Wingard, Chad",11,8,1,3,0,2,0,1
Port Adelaide,"Boak, Travis",22,9,6,13,1,0,0,0
Port Adelaide,"Broadbent, Matthew",6,6,5,0,0,0,0,3
Port Adelaide,"Cassisi, Domenic",6,3,2,3,0,0,0,6
Port Adelaide,"Cornes, Kane",15,6,1,9,0,0,0,2
Port Adelaide,"Ebert, Brad",21,16,7,5,0,0,0,2
Port Adelaide,"Gray, Robbie",30,11,3,19,1,1,0,2
Port Adelaide,"Hartlett, Hamish",29,14,2,15,0,2,1,2
Port Adelaide,"Hombsch, Jack",12,5,3,7,0,0,0,0
Port Adelaide,"Impey, Jarman",18,9,2,9,0,0,0,5
Port Adelaide,"Jonas, Tom",22,12,5,10,0,0,0,1
Port Adelaide,"Lobbe, Matthew",12,4,2,8,0,1,35,4
Port Adelaide,"Mitchell, Kane",9,5,1,4,1,1,0,6
Port Adelaide,"Monfries, Angus",12,9,3,3,0,0,0,4
Port Adelaide,"OShea, Cameron",28,17,3,11,0,0,0,1
Port Adelaide,"Pittard, Jasper",23,13,1,10,0,0,0,5
Port Adelaide,"Polec, Jared",22,12,2,10,0,0,0,0
Port Adelaide,"Schulz, Jay",7,7,5,0,3,0,0,1
Port Adelaide,"Westhoff, Justin",18,12,6,6,0,2,6,1
Port Adelaide,"White, Matt",17,13,5,4,1,1,0,4
Port Adelaide,"Wines, Ollie",19,7,2,12,0,0,2,8
Port Adelaide,"Wingard, Chad",15,9,1,6,0,3,0,4
Port Adelaide,"Young, Aaron",11,3,1,8,0,0,0,1
Port Adelaide,"Boak, Travis",39,13,4,26,1,0,0,6
Port Adelaide,"Broadbent, Matthew",15,10,2,5,2,0,0,3
Port Adelaide,"Cornes, Kane",26,14,7,12,0,0,0,5
Port Adelaide,"Ebert, Brad",16,7,2,9,0,0,1,3
Port Adelaide,"Gray, Robbie",15,8,4,7,4,1,0,1
Port Adelaide,"Gray, Sam",6,5,3,1,1,0,0,2
Port Adelaide,"Hartlett, Hamish",21,12,4,9,1,1,0,6
Port Adelaide,"Hombsch, Jack",12,6,2,6,0,0,0,3
Port Adelaide,"Impey, Jarman",12,6,2,6,0,0,0,2
Port Adelaide,"Jonas, Tom",8,7,4,1,0,0,0,2
Port Adelaide,"Lobbe, Matthew",13,6,3,7,0,0,31,12
Port Adelaide,"Logan, Tom",19,10,8,9,0,0,0,2
Port Adelaide,"Mitchell, Kane",8,3,2,5,0,0,0,1
Port Adelaide,"OShea, Cameron",18,6,5,12,0,0,0,0
Port Adelaide,"Pittard, Jasper",12,8,4,4,0,0,1,2
Port Adelaide,"Polec, Jared",18,9,4,9,1,0,2,3
Port Adelaide,"Schulz, Jay",12,9,9,3,2,2,0,4
Port Adelaide,"Westhoff, Justin",14,8,3,6,0,0,4,0
Port Adelaide,"White, Matt",14,11,4,3,2,2,0,3
Port Adelaide,"Wines, Ollie",25,7,4,18,1,1,1,4
Port Adelaide,"Wingard, Chad",17,7,4,10,1,1,0,4
Port Adelaide,"Young, Aaron",15,5,2,10,0,0,1,2
Port Adelaide,"Boak, Travis",19,7,2,12,1,0,0,5
Port Adelaide,"Broadbent, Matthew",12,9,5,3,0,0,0,0
Port Adelaide,"Cassisi, Domenic",14,11,5,3,0,0,0,2
Port Adelaide,"Cornes, Kane",19,13,7,6,0,1,0,9
Port Adelaide,"Ebert, Brad",24,16,5,8,0,1,4,5
Port Adelaide,"Gray, Robbie",26,11,4,15,0,1,0,6
Port Adelaide,"Hartlett, Hamish",17,11,3,6,0,1,1,5
Port Adelaide,"Hombsch, Jack",8,7,3,1,0,0,1,3
Port Adelaide,"Impey, Jarman",12,5,4,7,0,0,0,2
Port Adelaide,"Jonas, Tom",9,5,3,4,0,0,0,3
Port Adelaide,"Lobbe, Matthew",9,3,1,6,0,0,35,10
Port Adelaide,"Newton, Ben",6,3,2,3,0,0,1,5
Port Adelaide,"OShea, Cameron",25,18,12,7,0,0,0,1
Port Adelaide,"Pittard, Jasper",15,13,4,2,1,0,0,6
Port Adelaide,"Polec, Jared",8,4,1,4,0,0,0,2
Port Adelaide,"Schulz, Jay",9,8,3,1,2,2,1,0
Port Adelaide,"Stewart, Paul",8,3,1,5,2,0,0,3
Port Adelaide,"Westhoff, Justin",21,17,7,4,2,1,3,2
Port Adelaide,"White, Matt",9,5,2,4,0,0,0,4
Port Adelaide,"Wines, Ollie",26,15,1,11,0,0,4,9
Port Adelaide,"Wingard, Chad",13,10,6,3,1,1,0,3
Port Adelaide,"Young, Aaron",16,9,4,7,1,0,1,4
Port Adelaide,"Boak, Travis",23,6,1,17,1,0,0,4
Port Adelaide,"Broadbent, Matthew",27,18,7,9,0,0,0,5
Port Adelaide,"Carlile, Alipate",11,4,1,7,0,0,0,2
Port Adelaide,"Cornes, Kane",22,11,6,11,0,1,0,3
Port Adelaide,"Ebert, Brad",24,14,6,10,0,0,1,5
Port Adelaide,"Gray, Robbie",14,3,2,11,1,1,0,1
Port Adelaide,"Hartlett, Hamish",23,11,3,12,4,0,1,8
Port Adelaide,"Hombsch, Jack",18,12,6,6,0,0,0,3
Port Adelaide,"Impey, Jarman",13,8,6,5,0,0,0,2
Port Adelaide,"Jonas, Tom",14,9,3,5,0,0,0,2
Port Adelaide,"Lobbe, Matthew",11,6,4,5,0,0,27,6
Port Adelaide,"Monfries, Angus",13,8,5,5,1,0,0,1
Port Adelaide,"Moore, Andrew",18,8,6,10,1,0,0,3
Port Adelaide,"Newton, Ben",7,3,1,4,0,0,0,1
Port Adelaide,"OShea, Cameron",28,13,6,15,0,0,0,1
Port Adelaide,"Pittard, Jasper",8,4,1,4,0,0,0,2
Port Adelaide,"Polec, Jared",22,7,3,15,0,0,1,3
Port Adelaide,"Schulz, Jay",14,8,5,6,1,0,0,1
Port Adelaide,"Stewart, Paul",6,4,2,2,0,0,1,2
Port Adelaide,"Westhoff, Justin",22,13,7,9,0,1,4,6
Port Adelaide,"Wines, Ollie",25,10,3,15,0,1,0,2
Port Adelaide,"Wingard, Chad",15,7,2,8,1,0,0,3
Port Adelaide,"Boak, Travis",31,15,7,16,2,0,0,9
Port Adelaide,"Broadbent, Matthew",23,14,6,9,0,0,0,2
Port Adelaide,"Carlile, Alipate",11,9,4,2,0,0,0,0
Port Adelaide,"Cornes, Kane",20,16,6,4,0,0,0,4
Port Adelaide,"Ebert, Brad",27,17,2,10,0,2,2,5
Port Adelaide,"Gray, Robbie",37,15,1,22,0,2,0,6
Port Adelaide,"Hartlett, Hamish",19,13,6,6,0,0,0,4
Port Adelaide,"Hombsch, Jack",10,5,5,5,0,0,0,4
Port Adelaide,"Jonas, Tom",18,15,9,3,0,0,0,2
Port Adelaide,"Lobbe, Matthew",6,3,3,3,1,0,34,2
Port Adelaide,"Mitchell, Kane",11,5,5,6,0,0,0,2
Port Adelaide,"Monfries, Angus",10,5,3,5,0,0,0,1
Port Adelaide,"Moore, Andrew",19,10,4,9,0,1,0,1
Port Adelaide,"Neade, Jake",10,9,1,1,2,2,0,2
Port Adelaide,"OShea, Cameron",24,11,5,13,0,0,0,4
Port Adelaide,"Pittard, Jasper",6,5,3,1,0,0,0,0
Port Adelaide,"Polec, Jared",29,16,2,13,0,0,0,0
Port Adelaide,"Schulz, Jay",14,8,6,6,0,3,0,2
Port Adelaide,"Trengove, Jackson",11,4,3,7,0,1,4,0
Port Adelaide,"Westhoff, Justin",13,8,5,5,1,1,0,2
Port Adelaide,"Wines, Ollie",20,8,2,12,0,1,5,4
Port Adelaide,"Wingard, Chad",15,10,3,5,1,2,0,3
Port Adelaide,"Boak, Travis",19,9,3,10,0,0,0,4
Port Adelaide,"Broadbent, Matthew",20,18,3,2,0,1,0,3
Port Adelaide,"Carlile, Alipate",14,8,1,6,0,0,0,4
Port Adelaide,"Cornes, Kane",19,10,2,9,0,0,0,7
Port Adelaide,"Ebert, Brad",13,6,1,7,0,1,2,4
Port Adelaide,"Gray, Robbie",26,19,3,7,1,1,0,2
Port Adelaide,"Hartlett, Hamish",24,13,3,11,1,2,0,4
Port Adelaide,"Hombsch, Jack",6,5,3,1,0,0,0,1
Port Adelaide,"Jonas, Tom",18,14,3,4,0,0,0,5
Port Adelaide,"Lobbe, Matthew",16,13,0,3,0,0,56,12
Port Adelaide,"Logan, Tom",11,8,2,3,0,0,1,1
Port Adelaide,"Moore, Andrew",18,10,2,8,1,0,1,3
Port Adelaide,"Neade, Jake",14,10,0,4,0,0,0,7
Port Adelaide,"OShea, Cameron",11,7,4,4,0,0,0,1
Port Adelaide,"Pittard, Jasper",15,15,3,0,0,0,0,1
Port Adelaide,"Polec, Jared",4,4,1,0,0,1,0,4
Port Adelaide,"Schulz, Jay",10,6,3,4,1,1,1,3
Port Adelaide,"Westhoff, Justin",24,18,7,6,1,1,1,1
Port Adelaide,"White, Matt",13,12,3,1,1,1,1,3
Port Adelaide,"Wines, Ollie",23,8,0,15,0,0,1,3
Port Adelaide,"Wingard, Chad",15,6,2,9,1,1,0,3
Port Adelaide,"Young, Aaron",3,2,1,1,0,0,0,3
Port Adelaide,"Boak, Travis",27,15,6,12,1,0,0,2
Port Adelaide,"Broadbent, Matthew",15,12,2,3,0,0,0,2
Port Adelaide,"Carlile, Alipate",12,5,1,7,0,0,0,4
Port Adelaide,"Cornes, Kane",27,13,4,14,0,0,0,3
Port Adelaide,"Ebert, Brad",13,5,5,8,1,0,1,7
Port Adelaide,"Gray, Robbie",31,13,5,18,4,2,0,5
Port Adelaide,"Hartlett, Hamish",27,17,5,10,1,1,1,2
Port Adelaide,"Hombsch, Jack",10,6,4,4,0,0,0,0
Port Adelaide,"Jonas, Tom",22,14,10,8,0,0,0,5
Port Adelaide,"Lobbe, Matthew",12,7,2,5,0,0,28,3
Port Adelaide,"Monfries, Angus",18,9,6,9,1,2,0,3
Port Adelaide,"Moore, Andrew",9,5,2,4,0,1,0,2
Port Adelaide,"Neade, Jake",14,11,7,3,3,2,0,1
Port Adelaide,"OShea, Cameron",18,4,3,14,0,0,0,2
Port Adelaide,"Pittard, Jasper",23,17,8,6,0,1,0,1
Port Adelaide,"Polec, Jared",24,13,3,11,0,3,0,3
Port Adelaide,"Schulz, Jay",13,8,7,5,2,2,0,0
Port Adelaide,"Trengove, Jackson",16,8,4,8,0,0,8,4
Port Adelaide,"Westhoff, Justin",21,15,9,6,3,0,0,0
Port Adelaide,"White, Matt",9,8,7,1,1,0,0,3
Port Adelaide,"Wines, Ollie",18,3,0,15,0,0,6,0
Port Adelaide,"Wingard, Chad",19,16,12,3,3,2,0,3
Port Adelaide,"Boak, Travis",22,5,2,17,0,0,0,4
Port Adelaide,"Broadbent, Matthew",12,9,2,3,0,0,0,2
Port Adelaide,"Carlile, Alipate",9,3,2,6,0,0,0,2
Port Adelaide,"Cornes, Kane",22,13,6,9,0,0,0,4
Port Adelaide,"Ebert, Brad",24,12,2,12,0,0,2,10
Port Adelaide,"Gray, Robbie",33,18,4,15,2,3,0,1
Port Adelaide,"Hartlett, Hamish",24,16,5,8,2,2,1,3
Port Adelaide,"Hombsch, Jack",13,8,3,5,0,0,0,1
Port Adelaide,"Impey, Jarman",7,3,0,4,0,0,0,2
Port Adelaide,"Jonas, Tom",15,8,4,7,0,0,0,1
Port Adelaide,"Lobbe, Matthew",10,4,1,6,0,0,29,7
Port Adelaide,"Monfries, Angus",3,0,0,3,0,0,0,1
Port Adelaide,"Moore, Andrew",19,13,9,6,0,1,1,4
Port Adelaide,"Neade, Jake",8,2,1,6,0,1,0,2
Port Adelaide,"Pittard, Jasper",11,8,2,3,0,0,0,2
Port Adelaide,"Polec, Jared",19,8,4,11,0,1,0,1
Port Adelaide,"Schulz, Jay",15,13,8,2,6,1,0,2
Port Adelaide,"Trengove, Jackson",10,1,3,9,0,0,1,4
Port Adelaide,"Westhoff, Justin",23,17,12,6,1,1,0,2
Port Adelaide,"White, Matt",10,5,1,5,1,0,0,3
Port Adelaide,"Wines, Ollie",23,10,3,13,0,0,2,3
Port Adelaide,"Wingard, Chad",15,9,7,6,2,2,0,8
Port Adelaide,"Boak, Travis",34,14,4,20,1,0,0,0
Port Adelaide,"Broadbent, Matthew",15,11,6,4,0,1,0,0
Port Adelaide,"Carlile, Alipate",11,7,1,4,0,0,0,1
Port Adelaide,"Cornes, Kane",22,13,8,9,0,0,0,4
Port Adelaide,"Ebert, Brad",19,14,4,5,2,0,0,5
Port Adelaide,"Gray, Robbie",25,8,2,17,1,2,0,3
Port Adelaide,"Hartlett, Hamish",15,11,4,4,0,1,1,2
Port Adelaide,"Hombsch, Jack",14,10,8,4,0,0,0,1
Port Adelaide,"Jonas, Tom",22,15,12,7,0,0,0,0
Port Adelaide,"Lobbe, Matthew",5,3,1,2,0,0,26,4
Port Adelaide,"Monfries, Angus",18,11,8,7,2,2,0,2
Port Adelaide,"Moore, Andrew",12,9,2,3,0,0,0,2
Port Adelaide,"Neade, Jake",11,7,3,4,3,0,0,2
Port Adelaide,"OShea, Cameron",17,9,4,8,0,0,0,2
Port Adelaide,"Pittard, Jasper",11,5,2,6,0,0,0,1
Port Adelaide,"Polec, Jared",16,10,5,6,2,0,1,1
Port Adelaide,"Schulz, Jay",10,8,5,2,2,1,0,0
Port Adelaide,"Trengove, Jackson",10,5,4,5,0,0,4,1
Port Adelaide,"Westhoff, Justin",21,15,4,6,2,1,4,2
Port Adelaide,"White, Matt",5,3,1,2,1,0,0,1
Port Adelaide,"Wines, Ollie",24,12,7,12,2,0,4,2
Port Adelaide,"Wingard, Chad",22,16,5,6,2,2,0,5
Port Adelaide,"Boak, Travis",16,6,3,10,0,1,0,3
Port Adelaide,"Broadbent, Matthew",20,15,4,5,0,2,0,0
Port Adelaide,"Carlile, Alipate",11,8,4,3,0,0,0,1
Port Adelaide,"Cornes, Kane",16,6,5,10,0,0,0,3
Port Adelaide,"Ebert, Brad",18,10,4,8,0,0,1,5
Port Adelaide,"Gray, Robbie",21,10,2,11,4,1,0,2
Port Adelaide,"Hartlett, Hamish",33,17,8,16,0,1,2,3
Port Adelaide,"Hombsch, Jack",16,12,7,4,0,1,0,2
Port Adelaide,"Jonas, Tom",6,6,5,0,0,0,0,2
Port Adelaide,"Lobbe, Matthew",5,2,1,3,0,0,27,9
Port Adelaide,"Monfries, Angus",11,7,3,4,1,1,0,4
Port Adelaide,"Moore, Andrew",8,7,3,1,0,1,0,2
Port Adelaide,"Neade, Jake",17,11,2,6,0,1,0,4
Port Adelaide,"OShea, Cameron",15,9,4,6,0,0,0,1
Port Adelaide,"Pittard, Jasper",16,13,7,3,0,0,0,3
Port Adelaide,"Polec, Jared",17,9,0,8,1,2,0,6
Port Adelaide,"Schulz, Jay",13,8,6,5,1,1,0,3
Port Adelaide,"Trengove, Jackson",13,6,5,7,0,0,4,2
Port Adelaide,"Westhoff, Justin",20,15,12,5,0,1,0,2
Port Adelaide,"White, Matt",11,8,4,3,1,0,0,3
Port Adelaide,"Wines, Ollie",26,13,4,13,3,0,0,5
Port Adelaide,"Wingard, Chad",18,14,2,4,4,0,0,2
Port Adelaide,"Boak, Travis",33,16,2,17,1,0,0,7
Port Adelaide,"Broadbent, Matthew",18,5,2,13,0,0,0,1
Port Adelaide,"Carlile, Alipate",22,6,4,16,0,0,0,7
Port Adelaide,"Cornes, Kane",21,8,3,13,0,0,0,4
Port Adelaide,"Ebert, Brad",25,14,7,11,0,1,0,6
Port Adelaide,"Gray, Robbie",25,9,2,16,3,0,0,0
Port Adelaide,"Hartlett, Hamish",17,13,5,4,0,0,1,4
Port Adelaide,"Hombsch, Jack",13,10,3,3,0,0,0,0
Port Adelaide,"Jonas, Tom",13,7,6,6,0,0,0,2
Port Adelaide,"Lobbe, Matthew",6,3,2,3,0,1,22,9
Port Adelaide,"Monfries, Angus",10,6,4,4,4,0,0,1
Port Adelaide,"Moore, Andrew",7,4,2,3,0,0,0,2
Port Adelaide,"Neade, Jake",7,3,0,4,1,0,0,2
Port Adelaide,"OShea, Cameron",13,8,6,5,0,0,0,1
Port Adelaide,"Pittard, Jasper",19,14,5,5,0,1,0,1
Port Adelaide,"Polec, Jared",19,11,3,8,1,2,0,6
Port Adelaide,"Schulz, Jay",20,10,8,10,1,2,0,0
Port Adelaide,"Trengove, Jackson",7,3,2,4,0,0,3,2
Port Adelaide,"Westhoff, Justin",16,8,6,8,1,1,2,1
Port Adelaide,"White, Matt",11,8,3,3,0,1,0,1
Port Adelaide,"Wines, Ollie",19,10,2,9,0,2,4,7
Port Adelaide,"Wingard, Chad",14,5,2,9,1,1,0,0
Richmond,"Astbury, David",14,5,5,9,0,0,0,4
Richmond,"Chaplin, Troy",12,9,3,3,0,0,0,1
Richmond,"Conca, Reece",23,9,4,14,0,0,0,8
Richmond,"Cotchin, Trent",38,25,3,13,1,0,0,3
Richmond,"Deledio, Brett",33,20,8,13,1,1,1,4
Richmond,"Edwards, Shane",18,10,2,8,1,2,0,1
Richmond,"Ellis, Brandon",16,10,2,6,0,0,0,1
Richmond,"Foley, Nathan",9,3,1,6,0,0,0,0
Richmond,"Griffiths, Ben",10,7,5,3,1,2,2,5
Richmond,"Grigg, Shaun",30,16,5,14,0,0,0,2
Richmond,"Hampson, Shaun",13,4,3,9,0,0,37,2
Richmond,"Houli, Bachar",21,9,6,12,0,0,0,1
Richmond,"Martin, Dustin",25,20,5,5,1,0,0,3
Richmond,"McDonough, Matt",11,4,0,7,0,0,0,3
Richmond,"Morris, Steven",16,5,1,11,0,0,0,1
Richmond,"Newman, Chris",15,12,6,3,0,1,0,2
Richmond,"Petterd, Ricky",20,11,6,9,1,0,0,2
Richmond,"Rance, Alex",14,9,3,5,0,0,0,4
Richmond,"Riewoldt, Jack",9,5,3,4,1,2,0,4
Richmond,"Thomas, Matt",29,8,7,21,0,0,0,7
Richmond,"Vickery, Ty",12,8,4,4,2,0,2,4
Richmond,"Vlastuin, Nick",18,9,5,9,1,0,0,2
Richmond,"Astbury, David",18,17,10,1,0,0,0,1
Richmond,"Chaplin, Troy",14,9,5,5,0,0,0,1
Richmond,"Conca, Reece",19,12,4,7,0,0,0,1
Richmond,"Cotchin, Trent",25,15,4,10,1,0,1,0
Richmond,"Deledio, Brett",20,10,3,10,1,0,0,3
Richmond,"Edwards, Shane",21,13,3,8,1,2,0,0
Richmond,"Ellis, Brandon",18,14,6,4,2,2,0,4
Richmond,"Foley, Nathan",11,4,2,7,0,0,0,1
Richmond,"Griffiths, Ben",11,8,7,3,1,1,7,5
Richmond,"Grigg, Shaun",22,9,4,13,0,0,0,2
Richmond,"Grimes, Dylan",4,2,3,2,0,0,0,1
Richmond,"Hampson, Shaun",14,4,2,10,0,0,26,3
Richmond,"Houli, Bachar",19,15,5,4,0,1,0,3
Richmond,"King, Jake",8,3,1,5,1,0,0,5
Richmond,"Martin, Dustin",21,18,5,3,2,1,0,1
Richmond,"Morris, Steven",7,2,1,5,0,0,0,1
Richmond,"Newman, Chris",17,13,5,4,0,0,0,1
Richmond,"Petterd, Ricky",24,16,6,8,0,0,0,2
Richmond,"Riewoldt, Jack",10,6,3,4,1,2,0,6
Richmond,"Thomas, Matt",21,11,5,10,0,0,1,11
Richmond,"Vickery, Ty",7,6,4,1,4,1,0,1
Richmond,"Vlastuin, Nick",19,13,6,6,0,0,0,2
Richmond,"Astbury, David",8,4,3,4,0,0,0,3
Richmond,"Chaplin, Troy",13,10,7,3,0,0,0,4
Richmond,"Conca, Reece",18,9,4,9,0,0,0,10
Richmond,"Cotchin, Trent",28,21,5,7,1,2,0,4
Richmond,"Edwards, Shane",13,4,2,9,0,0,0,6
Richmond,"Ellis, Brandon",15,9,4,6,0,0,0,4
Richmond,"Gordon, Nathan",15,8,2,7,1,0,0,1
Richmond,"Griffiths, Ben",10,7,4,3,2,0,19,5
Richmond,"Grigg, Shaun",13,7,1,6,1,0,1,2
Richmond,"Grimes, Dylan",9,6,6,3,0,0,0,2
Richmond,"Houli, Bachar",17,9,3,8,0,1,0,3
Richmond,"Jackson, Daniel",23,15,6,8,1,1,0,9
Richmond,"King, Jake",6,3,2,3,1,0,0,3
Richmond,"Martin, Dustin",18,13,5,5,1,0,0,1
Richmond,"Morris, Steven",18,8,3,10,0,0,0,3
Richmond,"Newman, Chris",11,8,4,3,0,0,0,3
Richmond,"Petterd, Ricky",12,10,3,2,1,0,0,4
Richmond,"Riewoldt, Jack",13,10,9,3,4,0,0,1
Richmond,"Stephenson, Orren",12,5,2,7,0,0,24,2
Richmond,"Thomas, Matt",21,7,4,14,0,0,0,5
Richmond,"Vickery, Ty",8,6,3,2,2,2,8,2
Richmond,"Vlastuin, Nick",5,1,3,4,0,0,0,1
Richmond,"Arnot, Matt",10,6,3,4,1,1,0,3
Richmond,"Astbury, David",8,5,4,3,0,0,0,1
Richmond,"Chaplin, Troy",14,5,4,9,0,0,0,1
Richmond,"Conca, Reece",25,9,4,16,0,0,0,7
Richmond,"Cotchin, Trent",13,11,1,2,0,1,0,6
Richmond,"Edwards, Shane",16,6,1,10,1,0,0,3
Richmond,"Ellis, Brandon",20,12,2,8,0,0,0,3
Richmond,"Gordon, Nathan",9,6,4,3,0,0,0,2
Richmond,"Griffiths, Ben",8,6,2,2,0,0,6,3
Richmond,"Grigg, Shaun",18,14,4,4,0,0,0,2
Richmond,"Grimes, Dylan",6,5,2,1,0,0,0,3
Richmond,"Hampson, Shaun",4,2,2,2,0,0,31,1
Richmond,"Houli, Bachar",22,18,4,4,0,0,0,6
Richmond,"Jackson, Daniel",27,19,3,8,0,1,0,4
Richmond,"Lloyd, Sam",22,13,3,9,3,0,0,5
Richmond,"Martin, Dustin",29,16,6,13,1,2,0,3
Richmond,"Morris, Steven",14,4,1,10,0,0,0,4
Richmond,"Newman, Chris",11,10,1,1,1,0,0,7
Richmond,"Riewoldt, Jack",13,9,5,4,2,2,0,3
Richmond,"Thomas, Matt",22,6,2,16,1,0,0,5
Richmond,"Vickery, Ty",2,0,0,2,0,0,3,0
Richmond,"Vlastuin, Nick",20,10,5,10,0,0,0,4
Richmond,"Arnot, Matt",13,7,4,6,1,2,0,6
Richmond,"Astbury, David",14,13,6,1,0,0,0,2
Richmond,"Chaplin, Troy",13,10,5,3,0,0,0,1
Richmond,"Conca, Reece",23,8,4,15,0,0,0,4
Richmond,"Cotchin, Trent",32,24,5,8,1,0,0,7
Richmond,"Edwards, Shane",15,8,1,7,2,0,0,5
Richmond,"Ellis, Brandon",22,13,6,9,0,1,0,5
Richmond,"Gordon, Nathan",7,6,3,1,3,0,0,4
Richmond,"Griffiths, Ben",11,7,4,4,0,0,14,6
Richmond,"Grigg, Shaun",29,16,9,13,0,1,0,0
Richmond,"Grimes, Dylan",10,6,4,4,0,1,0,1
Richmond,"Hampson, Shaun",8,1,0,7,0,0,52,1
Richmond,"Houli, Bachar",21,14,5,7,0,1,0,2
Richmond,"Jackson, Daniel",24,15,3,9,0,0,0,8
Richmond,"Lloyd, Sam",13,8,3,5,0,1,0,6
Richmond,"Martin, Dustin",18,14,5,4,3,3,0,3
Richmond,"Morris, Steven",16,9,4,7,0,0,0,4
Richmond,"Newman, Chris",13,10,4,3,0,0,0,2
Richmond,"Petterd, Ricky",28,18,9,10,1,0,0,1
Richmond,"Riewoldt, Jack",15,11,9,4,4,1,0,3
Richmond,"Thomas, Matt",11,2,4,9,0,0,0,8
Richmond,"Vlastuin, Nick",16,8,9,8,0,0,0,6
Richmond,"Arnot, Matt",8,4,1,4,0,0,0,9
Richmond,"Astbury, David",18,12,4,6,0,0,0,2
Richmond,"Chaplin, Troy",12,5,5,7,0,0,0,0
Richmond,"Conca, Reece",18,11,4,7,0,0,0,11
Richmond,"Cotchin, Trent",21,15,3,6,0,0,0,7
Richmond,"Edwards, Shane",20,8,3,12,1,0,0,3
Richmond,"Ellis, Brandon",32,21,9,11,1,1,0,2
Richmond,"Gordon, Nathan",18,15,8,3,0,2,0,5
Richmond,"Griffiths, Ben",8,4,3,4,0,0,12,2
Richmond,"Grigg, Shaun",28,14,10,14,0,0,0,0
Richmond,"Grimes, Dylan",9,6,4,3,0,0,0,2
Richmond,"Hampson, Shaun",6,1,0,5,0,0,30,3
Richmond,"Houli, Bachar",23,13,9,10,0,0,0,2
Richmond,"Jackson, Daniel",28,13,4,15,1,1,0,2
Richmond,"Lloyd, Sam",10,6,5,4,0,0,0,1
Richmond,"Martin, Dustin",21,13,3,8,1,0,0,1
Richmond,"McDonough, Matt",6,4,3,2,0,0,0,1
Richmond,"Morris, Steven",13,6,5,7,0,0,0,2
Richmond,"Newman, Chris",17,10,7,7,0,0,0,1
Richmond,"Petterd, Ricky",18,7,8,11,1,1,0,2
Richmond,"Riewoldt, Jack",16,12,6,4,2,3,1,2
Richmond,"Vlastuin, Nick",14,7,4,7,0,0,0,4
Richmond,"Astbury, David",18,11,7,7,0,0,0,2
Richmond,"Chaplin, Troy",15,6,7,9,0,0,0,1
Richmond,"Conca, Reece",28,18,4,10,0,0,0,9
Richmond,"Cotchin, Trent",23,19,1,4,1,0,1,5
Richmond,"Deledio, Brett",23,13,3,10,1,0,0,3
Richmond,"Edwards, Aaron",16,7,3,9,0,1,0,3
Richmond,"Edwards, Shane",9,4,4,5,2,0,0,2
Richmond,"Ellis, Brandon",27,17,5,10,0,0,0,2
Richmond,"Gordon, Nathan",1,1,1,0,0,0,0,2
Richmond,"Grigg, Shaun",20,14,3,6,0,0,0,5
Richmond,"Hampson, Shaun",9,1,1,8,0,0,37,0
Richmond,"Houli, Bachar",18,9,4,9,0,0,0,2
Richmond,"Jackson, Daniel",34,12,2,22,0,0,0,5
Richmond,"Lloyd, Sam",12,9,5,3,3,0,0,4
Richmond,"Martin, Dustin",28,16,6,12,1,0,0,0
Richmond,"McDonough, Matt",13,8,2,5,0,0,0,1
Richmond,"Morris, Steven",11,8,3,3,0,0,0,1
Richmond,"Newman, Chris",8,4,3,4,0,0,0,2
Richmond,"Rance, Alex",18,11,3,7,0,0,0,2
Richmond,"Riewoldt, Jack",16,11,5,5,2,1,0,2
Richmond,"Vickery, Ty",16,7,3,9,2,1,8,2
Richmond,"Vlastuin, Nick",22,9,5,13,0,0,0,4
Richmond,"Astbury, David",10,4,3,6,0,0,0,0
Richmond,"Chaplin, Troy",12,4,3,8,0,0,0,2
Richmond,"Conca, Reece",11,8,6,3,0,0,0,7
Richmond,"Cotchin, Trent",26,14,5,12,1,1,0,6
Richmond,"Deledio, Brett",24,12,6,12,0,1,0,1
Richmond,"Edwards, Shane",17,10,4,7,2,2,0,6
Richmond,"Ellis, Brandon",23,11,4,12,0,1,0,2
Richmond,"Foley, Nathan",14,5,0,9,0,0,0,8
Richmond,"Griffiths, Ben",6,5,4,1,0,3,6,7
Richmond,"Grigg, Shaun",23,12,4,11,0,3,0,6
Richmond,"Hampson, Shaun",5,2,1,3,0,0,21,0
Richmond,"Houli, Bachar",22,14,2,8,0,1,0,3
Richmond,"Jackson, Daniel",30,13,7,17,1,0,1,4
Richmond,"Lennon, Ben",8,6,3,2,2,1,0,0
Richmond,"Lloyd, Sam",13,6,2,7,1,1,0,6
Richmond,"Martin, Dustin",31,21,6,10,1,0,0,2
Richmond,"McDonough, Matt",12,6,3,6,0,0,0,1
Richmond,"Morris, Steven",7,2,2,5,0,0,0,6
Richmond,"Rance, Alex",17,6,5,11,0,0,0,4
Richmond,"Riewoldt, Jack",9,8,4,1,1,3,0,4
Richmond,"Vickery, Ty",12,5,3,7,0,0,8,5
Richmond,"Vlastuin, Nick",14,9,3,5,0,0,0,1
Richmond,"Chaplin, Troy",18,5,2,13,0,0,0,1
Richmond,"Conca, Reece",23,15,6,8,0,1,0,5
Richmond,"Cotchin, Trent",26,18,8,8,1,0,0,1
Richmond,"Dea, Matt",17,4,4,13,0,0,0,0
Richmond,"Deledio, Brett",34,19,7,15,0,0,0,0
Richmond,"Edwards, Shane",15,6,3,9,1,0,0,2
Richmond,"Ellis, Brandon",31,16,9,15,2,0,0,3
Richmond,"Foley, Nathan",21,13,3,8,1,0,0,5
Richmond,"Griffiths, Ben",8,7,7,1,2,2,2,2
Richmond,"Grigg, Shaun",15,8,4,7,1,0,1,4
Richmond,"Grimes, Dylan",9,4,3,5,0,0,0,3
Richmond,"Hampson, Shaun",10,5,4,5,0,1,30,1
Richmond,"Houli, Bachar",26,12,8,14,2,0,0,3
Richmond,"Jackson, Daniel",3,2,0,1,0,0,0,0
Richmond,"Lennon, Ben",16,13,8,3,0,1,0,3
Richmond,"Martin, Dustin",36,24,4,12,0,0,0,2
Richmond,"McDonough, Matt",17,10,3,7,1,1,0,2
Richmond,"Morris, Steven",7,1,0,6,0,1,0,1
Richmond,"Rance, Alex",21,3,6,18,0,0,0,2
Richmond,"Riewoldt, Jack",17,17,12,0,11,2,0,0
Richmond,"Thomas, Matt",28,7,3,21,0,0,0,10
Richmond,"Vickery, Ty",13,8,5,5,2,1,11,1
Richmond,"Chaplin, Troy",21,8,4,13,0,0,0,1
Richmond,"Conca, Reece",12,8,3,4,0,0,0,4
Richmond,"Cotchin, Trent",25,14,2,11,1,1,0,3
Richmond,"Dea, Matt",16,8,1,8,0,0,0,1
Richmond,"Deledio, Brett",20,11,5,9,0,1,0,3
Richmond,"Edwards, Shane",20,11,5,9,1,1,0,1
Richmond,"Ellis, Brandon",26,17,10,9,0,0,0,2
Richmond,"Foley, Nathan",8,3,2,5,0,0,0,2
Richmond,"Griffiths, Ben",6,4,1,2,0,0,3,2
Richmond,"Grigg, Shaun",15,5,4,10,0,0,0,4
Richmond,"Grimes, Dylan",12,5,3,7,0,0,0,4
Richmond,"Hampson, Shaun",9,3,2,6,0,1,18,0
Richmond,"Houli, Bachar",25,14,6,11,0,1,0,1
Richmond,"Jackson, Daniel",19,10,4,9,0,0,0,4
Richmond,"Lennon, Ben",16,11,7,5,0,0,0,0
Richmond,"Maric, Ivan",15,4,3,11,0,0,11,2
Richmond,"Martin, Dustin",28,16,4,12,2,1,0,2
Richmond,"McDonough, Matt",10,7,2,3,0,0,0,0
Richmond,"Morris, Steven",8,2,1,6,0,0,0,4
Richmond,"Rance, Alex",16,9,5,7,0,0,0,4
Richmond,"Riewoldt, Jack",13,11,7,2,3,0,0,0
Richmond,"Thomas, Matt",23,7,3,16,0,0,0,7
Richmond,"Batchelor, Jake",9,5,4,4,0,0,0,1
Richmond,"Chaplin, Troy",9,5,3,4,0,0,0,1
Richmond,"Cotchin, Trent",24,13,5,11,0,1,1,4
Richmond,"Dea, Matt",11,7,2,4,1,0,0,3
Richmond,"Deledio, Brett",18,9,4,9,0,0,0,4
Richmond,"Edwards, Shane",14,10,2,4,1,0,0,8
Richmond,"Ellis, Brandon",23,12,7,11,0,0,0,5
Richmond,"Foley, Nathan",19,6,0,13,0,0,0,5
Richmond,"Griffiths, Ben",2,2,1,0,0,1,1,3
Richmond,"Houli, Bachar",30,18,5,12,0,0,0,0
Richmond,"Lennon, Ben",3,1,0,2,0,0,0,0
Richmond,"Maric, Ivan",17,8,6,9,1,0,24,1
Richmond,"Martin, Dustin",28,19,6,9,4,1,0,4
Richmond,"McDonough, Matt",13,5,3,8,0,0,0,4
Richmond,"Miles, Anthony",19,12,4,7,0,0,0,6
Richmond,"Morris, Steven",12,3,4,9,1,0,0,2
Richmond,"Petterd, Ricky",18,12,7,6,0,0,0,1
Richmond,"Rance, Alex",18,8,6,10,0,0,0,0
Richmond,"Riewoldt, Jack",13,10,5,3,3,3,0,3
Richmond,"Thomas, Matt",24,8,8,16,1,0,0,4
Richmond,"Vickery, Ty",11,9,5,2,1,1,9,2
Richmond,"Vlastuin, Nick",20,9,6,11,0,0,0,3
Richmond,"Batchelor, Jake",13,6,2,7,1,0,0,2
Richmond,"Chaplin, Troy",14,8,4,6,0,0,0,2
Richmond,"Cotchin, Trent",27,16,1,11,0,0,0,8
Richmond,"Dea, Matt",15,8,3,7,0,0,0,0
Richmond,"Deledio, Brett",21,9,2,12,2,1,0,1
Richmond,"Edwards, Aaron",15,10,7,5,0,1,0,3
Richmond,"Edwards, Shane",19,11,3,8,0,0,0,5
Richmond,"Ellis, Brandon",29,15,6,14,1,0,0,2
Richmond,"Foley, Nathan",27,13,4,14,1,0,0,7
Richmond,"Grimes, Dylan",6,1,1,5,0,0,0,0
Richmond,"Hampson, Shaun",5,2,2,3,0,0,19,0
Richmond,"Houli, Bachar",25,13,6,12,0,0,0,3
Richmond,"Lennon, Ben",8,4,3,4,0,0,0,0
Richmond,"Maric, Ivan",10,2,2,8,1,0,10,2
Richmond,"Martin, Dustin",28,11,9,17,1,1,0,4
Richmond,"Miles, Anthony",30,15,1,15,1,0,0,4
Richmond,"Morris, Steven",19,9,6,10,0,0,0,1
Richmond,"Newman, Chris",16,12,6,4,1,0,0,2
Richmond,"Petterd, Ricky",23,9,4,14,2,1,0,7
Richmond,"Rance, Alex",29,13,10,16,0,0,0,1
Richmond,"Riewoldt, Jack",11,9,8,2,1,5,1,2
Richmond,"Vlastuin, Nick",17,9,5,8,0,0,0,5
Richmond,"Batchelor, Jake",11,6,4,5,0,0,0,3
Richmond,"Chaplin, Troy",23,7,7,16,0,0,0,1
Richmond,"Conca, Reece",19,10,2,9,0,0,0,1
Richmond,"Cotchin, Trent",33,20,8,13,0,2,0,2
Richmond,"Dea, Matt",11,6,4,5,0,0,0,4
Richmond,"Deledio, Brett",18,8,2,10,1,0,1,3
Richmond,"Edwards, Aaron",6,3,3,3,1,0,0,0
Richmond,"Edwards, Shane",12,3,1,9,0,0,0,3
Richmond,"Ellis, Brandon",35,23,6,12,0,0,0,2
Richmond,"Foley, Nathan",20,13,2,7,0,0,0,2
Richmond,"Grimes, Dylan",10,7,5,3,0,0,0,2
Richmond,"Hampson, Shaun",9,1,3,8,1,0,17,0
Richmond,"Houli, Bachar",33,21,6,12,0,0,0,2
Richmond,"Maric, Ivan",17,10,8,7,0,0,17,3
Richmond,"Martin, Dustin",36,22,5,14,0,1,0,4
Richmond,"Miles, Anthony",28,12,3,16,2,0,0,8
Richmond,"Morris, Steven",15,6,3,9,0,0,0,4
Richmond,"Petterd, Ricky",11,6,1,5,0,1,1,9
Richmond,"Rance, Alex",16,9,6,7,0,0,0,2
Richmond,"Riewoldt, Jack",10,7,5,3,2,2,0,3
Richmond,"Thomas, Matt",13,4,2,9,0,0,0,1
Richmond,"Vlastuin, Nick",14,8,8,6,0,1,0,2
Richmond,"Batchelor, Jake",8,4,2,4,0,0,0,3
Richmond,"Chaplin, Troy",14,7,5,7,0,0,0,0
Richmond,"Conca, Reece",26,14,7,12,1,1,0,2
Richmond,"Cotchin, Trent",31,16,6,15,5,1,0,2
Richmond,"Dea, Matt",5,3,3,2,0,0,0,2
Richmond,"Deledio, Brett",30,15,11,15,1,1,1,3
Richmond,"Edwards, Shane",20,7,4,13,1,0,0,2
Richmond,"Ellis, Brandon",36,19,6,17,1,2,0,0
Richmond,"Foley, Nathan",22,10,5,12,0,1,0,6
Richmond,"Grimes, Dylan",16,7,4,9,1,0,0,4
Richmond,"Houli, Bachar",17,8,4,9,0,0,0,0
Richmond,"Maric, Ivan",14,5,1,9,0,0,27,1
Richmond,"Martin, Dustin",24,18,4,6,0,0,0,1
Richmond,"Miles, Anthony",27,11,4,16,0,0,0,4
Richmond,"Morris, Steven",19,6,3,13,0,0,0,1
Richmond,"Newman, Chris",9,7,4,2,2,0,0,3
Richmond,"Petterd, Ricky",11,7,4,4,0,0,0,2
Richmond,"Rance, Alex",19,12,8,7,0,0,0,4
Richmond,"Riewoldt, Jack",12,9,6,3,2,1,0,1
Richmond,"Thomas, Matt",22,5,4,17,1,0,0,4
Richmond,"Vickery, Ty",11,8,7,3,2,2,10,4
Richmond,"Vlastuin, Nick",18,12,7,6,1,0,0,0
Richmond,"Arnot, Matt",8,3,3,5,1,0,0,2
Richmond,"Batchelor, Jake",16,10,6,6,1,0,0,2
Richmond,"Chaplin, Troy",20,7,3,13,0,0,0,3
Richmond,"Conca, Reece",17,6,2,11,1,0,0,6
Richmond,"Cotchin, Trent",37,16,3,21,0,1,0,3
Richmond,"Dea, Matt",14,9,5,5,0,0,0,0
Richmond,"Deledio, Brett",27,13,6,14,0,0,0,1
Richmond,"Edwards, Shane",27,10,2,17,2,0,0,3
Richmond,"Ellis, Brandon",32,19,6,13,0,1,0,3
Richmond,"Foley, Nathan",19,6,3,13,0,0,0,0
Richmond,"Grimes, Dylan",8,3,5,5,0,0,0,2
Richmond,"Houli, Bachar",15,10,2,5,0,1,0,3
Richmond,"Jackson, Daniel",24,15,4,9,0,0,0,2
Richmond,"Maric, Ivan",21,5,3,16,0,0,34,2
Richmond,"Martin, Dustin",34,19,5,15,0,1,0,3
Richmond,"Miles, Anthony",24,12,6,12,0,1,0,4
Richmond,"Newman, Chris",16,7,4,9,0,1,0,1
Richmond,"OHanlon, Brett",9,5,3,4,0,1,0,0
Richmond,"Petterd, Ricky",26,15,6,11,1,0,1,5
Richmond,"Rance, Alex",15,5,3,10,0,0,0,2
Richmond,"Riewoldt, Jack",13,7,5,6,2,0,0,2
Richmond,"Vickery, Ty",16,9,4,7,4,0,8,1
Richmond,"Batchelor, Jake",9,8,3,1,0,0,0,3
Richmond,"Chaplin, Troy",10,5,4,5,2,0,0,3
Richmond,"Conca, Reece",8,6,1,2,0,0,0,5
Richmond,"Cotchin, Trent",26,17,2,9,1,0,1,4
Richmond,"Deledio, Brett",26,16,4,10,1,2,1,2
Richmond,"Edwards, Shane",19,5,3,14,1,0,0,3
Richmond,"Ellis, Brandon",29,15,4,14,0,1,0,2
Richmond,"Foley, Nathan",10,2,2,8,0,0,0,1
Richmond,"Grimes, Dylan",7,6,1,1,0,0,0,4
Richmond,"Houli, Bachar",23,15,6,8,1,0,0,3
Richmond,"Jackson, Daniel",7,5,2,2,1,1,0,5
Richmond,"Lloyd, Sam",11,8,5,3,3,3,0,3
Richmond,"Maric, Ivan",9,7,1,2,0,0,40,7
Richmond,"Martin, Dustin",25,19,2,6,1,0,0,2
Richmond,"Miles, Anthony",28,16,2,12,0,1,0,4
Richmond,"Morris, Steven",5,1,1,4,0,0,0,1
Richmond,"Newman, Chris",11,8,2,3,0,0,0,5
Richmond,"Petterd, Ricky",22,18,4,4,2,0,1,9
Richmond,"Rance, Alex",12,6,5,6,0,0,0,3
Richmond,"Riewoldt, Jack",22,12,6,10,3,1,1,2
Richmond,"Vickery, Ty",12,9,6,3,2,2,5,2
Richmond,"Vlastuin, Nick",13,5,0,8,1,0,0,5
Richmond,"Batchelor, Jake",3,3,0,0,0,0,0,4
Richmond,"Chaplin, Troy",10,6,3,4,0,0,0,1
Richmond,"Conca, Reece",20,15,0,5,0,0,0,6
Richmond,"Cotchin, Trent",15,6,1,9,1,0,0,3
Richmond,"Deledio, Brett",26,16,3,10,0,2,1,5
Richmond,"Edwards, Shane",16,9,0,7,0,1,0,1
Richmond,"Ellis, Brandon",27,16,2,11,0,0,0,1
Richmond,"Foley, Nathan",25,12,1,13,0,0,0,10
Richmond,"Gordon, Nathan",5,4,2,1,0,1,0,3
Richmond,"Grimes, Dylan",12,10,0,2,0,0,0,6
Richmond,"Houli, Bachar",19,13,0,6,0,0,0,5
Richmond,"Lloyd, Sam",7,5,2,2,0,0,0,2
Richmond,"Maric, Ivan",14,9,3,5,0,0,29,5
Richmond,"Martin, Dustin",25,22,2,3,2,0,0,5
Richmond,"Miles, Anthony",21,13,1,8,1,0,0,6
Richmond,"Morris, Steven",11,5,0,6,0,0,0,6
Richmond,"Newman, Chris",12,10,1,2,0,0,0,4
Richmond,"Rance, Alex",8,5,0,3,0,0,0,6
Richmond,"Riewoldt, Jack",10,10,1,0,1,1,0,5
Richmond,"Thomas, Matt",21,6,1,15,0,0,0,10
Richmond,"Vickery, Ty",7,5,2,2,2,0,9,3
Richmond,"Vlastuin, Nick",13,9,2,4,1,0,0,2
Richmond,"Batchelor, Jake",6,3,2,3,0,0,0,0
Richmond,"Chaplin, Troy",11,8,2,3,0,1,0,2
Richmond,"Conca, Reece",19,13,4,6,0,0,0,1
Richmond,"Cotchin, Trent",30,19,5,11,1,0,0,2
Richmond,"Deledio, Brett",31,20,10,11,2,0,0,1
Richmond,"Edwards, Shane",21,10,4,11,1,1,0,2
Richmond,"Ellis, Brandon",34,19,5,15,1,0,0,1
Richmond,"Foley, Nathan",20,10,4,10,0,0,0,2
Richmond,"Gordon, Nathan",9,5,2,4,0,1,0,2
Richmond,"Griffiths, Ben",10,9,7,1,1,2,4,0
Richmond,"Grimes, Dylan",9,5,2,4,0,0,0,2
Richmond,"Houli, Bachar",19,7,4,12,1,0,0,3
Richmond,"Lloyd, Sam",7,3,2,4,0,0,0,1
Richmond,"Maric, Ivan",11,8,3,3,0,0,26,1
Richmond,"Martin, Dustin",15,12,6,3,2,2,0,2
Richmond,"Miles, Anthony",12,6,2,6,0,0,0,2
Richmond,"Newman, Chris",12,11,6,1,0,0,0,0
Richmond,"Petterd, Ricky",14,12,12,2,2,1,0,2
Richmond,"Rance, Alex",22,13,12,9,0,0,0,2
Richmond,"Riewoldt, Jack",12,8,6,4,1,0,0,0
Richmond,"Thomas, Matt",20,8,5,12,1,0,0,3
Richmond,"Vlastuin, Nick",14,12,6,2,0,0,0,0
Richmond,"Batchelor, Jake",6,6,3,0,0,0,0,4
Richmond,"Chaplin, Troy",12,5,3,7,0,0,0,2
Richmond,"Cotchin, Trent",22,16,7,6,1,0,0,6
Richmond,"Deledio, Brett",19,15,8,4,2,1,0,3
Richmond,"Edwards, Shane",19,7,3,12,2,1,0,3
Richmond,"Ellis, Brandon",28,19,8,9,1,0,0,5
Richmond,"Foley, Nathan",13,4,1,9,0,0,0,7
Richmond,"Gordon, Nathan",8,7,2,1,2,0,0,1
Richmond,"Griffiths, Ben",15,10,8,5,1,0,5,1
Richmond,"Grigg, Shaun",14,6,2,8,0,1,0,3
Richmond,"Grimes, Dylan",6,2,0,4,0,0,0,7
Richmond,"Houli, Bachar",18,13,4,5,1,0,0,4
Richmond,"Maric, Ivan",16,12,6,4,1,1,22,4
Richmond,"Martin, Dustin",21,16,8,5,1,1,0,4
Richmond,"Miles, Anthony",28,16,6,12,0,0,0,3
Richmond,"Morris, Steven",5,4,1,1,0,0,0,3
Richmond,"Newman, Chris",13,10,5,3,0,0,0,1
Richmond,"Petterd, Ricky",19,12,6,7,0,0,1,4
Richmond,"Rance, Alex",12,9,4,3,0,0,0,2
Richmond,"Riewoldt, Jack",15,12,9,3,2,3,0,0
Richmond,"Thomas, Matt",11,2,2,9,0,0,0,2
Richmond,"Vlastuin, Nick",8,4,2,4,0,0,0,1
Richmond,"Batchelor, Jake",6,4,0,2,0,0,0,1
Richmond,"Chaplin, Troy",13,5,1,8,0,0,0,1
Richmond,"Cotchin, Trent",28,17,1,11,1,1,0,10
Richmond,"Deledio, Brett",29,16,3,13,2,4,0,4
Richmond,"Edwards, Shane",19,10,1,9,1,2,0,8
Richmond,"Ellis, Brandon",31,16,3,15,0,2,0,2
Richmond,"Foley, Nathan",21,13,1,8,1,0,0,3
Richmond,"Gordon, Nathan",17,13,8,4,2,1,0,2
Richmond,"Griffiths, Ben",11,7,5,4,1,2,7,1
Richmond,"Grigg, Shaun",15,8,3,7,0,1,0,1
Richmond,"Grimes, Dylan",10,5,1,5,0,0,0,2
Richmond,"Houli, Bachar",15,9,3,6,0,0,0,3
Richmond,"Lennon, Ben",2,1,0,1,0,0,0,0
Richmond,"Maric, Ivan",12,7,2,5,0,1,26,6
Richmond,"Martin, Dustin",17,17,3,0,2,0,0,5
Richmond,"Miles, Anthony",26,15,3,11,0,0,0,5
Richmond,"Morris, Steven",13,8,1,5,0,0,0,2
Richmond,"Newman, Chris",12,11,1,1,0,0,0,4
Richmond,"Petterd, Ricky",19,14,4,5,0,1,0,7
Richmond,"Rance, Alex",21,12,5,9,0,0,0,6
Richmond,"Riewoldt, Jack",11,5,2,6,0,1,0,2
Richmond,"Vlastuin, Nick",18,13,1,5,0,1,1,9
Richmond,"Batchelor, Jake",22,17,7,5,1,0,0,3
Richmond,"Chaplin, Troy",29,20,15,9,0,0,0,1
Richmond,"Conca, Reece",19,12,5,7,0,0,0,5
Richmond,"Cotchin, Trent",22,7,2,15,0,0,0,1
Richmond,"Deledio, Brett",26,10,7,16,2,1,0,3
Richmond,"Edwards, Shane",20,11,1,9,0,1,0,3
Richmond,"Ellis, Brandon",20,13,8,7,1,0,0,0
Richmond,"Foley, Nathan",18,6,3,12,1,0,0,5
Richmond,"Gordon, Nathan",11,8,5,3,0,1,0,2
Richmond,"Griffiths, Ben",7,5,5,2,2,0,12,0
Richmond,"Grigg, Shaun",21,6,5,15,0,0,0,2
Richmond,"Grimes, Dylan",17,9,7,8,0,0,0,1
Richmond,"Houli, Bachar",29,16,6,13,0,0,0,1
Richmond,"Lennon, Ben",4,2,3,2,0,0,0,1
Richmond,"Maric, Ivan",17,9,2,8,1,0,25,1
Richmond,"Miles, Anthony",25,10,2,15,0,1,0,3
Richmond,"Morris, Steven",15,5,1,10,0,0,0,0
Richmond,"Newman, Chris",21,14,3,7,0,0,0,5
Richmond,"Petterd, Ricky",23,19,14,4,1,0,0,4
Richmond,"Rance, Alex",21,8,9,13,0,0,0,1
Richmond,"Riewoldt, Jack",11,10,6,1,6,2,0,0
Richmond,"Vlastuin, Nick",15,5,2,10,0,0,1,5
Richmond,"Batchelor, Jake",15,7,4,8,0,0,0,0
Richmond,"Chaplin, Troy",25,12,7,13,0,0,0,3
Richmond,"Conca, Reece",12,6,0,6,0,0,0,2
Richmond,"Cotchin, Trent",29,12,2,17,0,0,0,4
Richmond,"Deledio, Brett",29,14,5,15,3,0,0,5
Richmond,"Edwards, Shane",25,14,2,11,0,3,0,4
Richmond,"Ellis, Brandon",27,20,5,7,0,0,0,2
Richmond,"Foley, Nathan",15,9,2,6,0,2,0,7
Richmond,"Gordon, Nathan",12,6,4,6,1,0,0,1
Richmond,"Griffiths, Ben",11,7,5,4,0,0,15,1
Richmond,"Grigg, Shaun",24,6,3,18,0,0,0,2
Richmond,"Grimes, Dylan",10,6,2,4,0,0,0,3
Richmond,"Houli, Bachar",11,6,2,5,0,0,0,3
Richmond,"Maric, Ivan",17,10,3,7,0,0,45,2
Richmond,"Martin, Dustin",23,19,5,4,1,1,0,2
Richmond,"Miles, Anthony",25,15,1,10,1,0,0,3
Richmond,"Morris, Steven",14,5,1,9,0,0,0,4
Richmond,"Newman, Chris",14,8,2,6,0,0,0,1
Richmond,"Petterd, Ricky",5,2,2,3,0,0,0,2
Richmond,"Rance, Alex",16,8,7,8,0,0,0,3
Richmond,"Riewoldt, Jack",10,10,6,0,4,1,0,0
Richmond,"Vlastuin, Nick",13,10,3,3,0,1,0,3
Richmond,"Batchelor, Jake",1,1,1,0,0,0,0,1
Richmond,"Chaplin, Troy",9,5,4,4,0,0,1,2
Richmond,"Conca, Reece",16,11,3,5,1,1,0,2
Richmond,"Cotchin, Trent",16,9,0,7,0,0,0,4
Richmond,"Deledio, Brett",29,12,5,17,1,1,0,3
Richmond,"Edwards, Shane",11,5,0,6,1,0,0,1
Richmond,"Ellis, Brandon",20,9,3,11,0,0,0,3
Richmond,"Foley, Nathan",11,4,3,7,0,0,0,2
Richmond,"Gordon, Nathan",16,8,6,8,2,0,0,4
Richmond,"Griffiths, Ben",10,6,3,4,1,2,5,1
Richmond,"Grigg, Shaun",20,10,3,10,1,0,0,1
Richmond,"Grimes, Dylan",17,9,8,8,0,0,0,4
Richmond,"Houli, Bachar",27,14,4,13,0,0,0,1
Richmond,"Maric, Ivan",11,5,4,6,1,0,20,3
Richmond,"Martin, Dustin",29,20,4,9,0,0,0,2
Richmond,"Miles, Anthony",24,9,3,15,0,1,0,4
Richmond,"Morris, Steven",10,2,1,8,0,0,0,2
Richmond,"Newman, Chris",14,9,5,5,0,1,0,1
Richmond,"Petterd, Ricky",9,6,4,3,0,0,1,0
Richmond,"Rance, Alex",17,8,7,9,0,0,0,1
Richmond,"Riewoldt, Jack",12,10,8,2,3,2,0,3
Richmond,"Vlastuin, Nick",13,6,0,7,0,0,0,2
St Kilda,"Armitage, David",14,6,1,8,1,0,0,6
St Kilda,"Billings, Jack",4,2,1,2,0,1,0,0
St Kilda,"Curren, Tom",21,16,3,5,0,0,0,1
St Kilda,"Delaney, Luke",10,6,8,4,0,0,0,2
St Kilda,"Dempster, Sean",22,15,12,7,0,0,0,1
St Kilda,"Dunstan, Luke",21,15,7,6,0,1,1,7
St Kilda,"Geary, Jarryn",12,7,3,5,1,0,0,3
St Kilda,"Gilbert, Sam",15,10,4,5,0,0,0,1
St Kilda,"Gwilt, James",18,15,11,3,1,0,0,2
St Kilda,"Hickey, Tom",14,7,4,7,0,0,24,3
St Kilda,"Jones, Clinton",39,24,8,15,0,1,0,3
St Kilda,"Maister, Beau",9,4,4,5,0,0,0,2
St Kilda,"Newnes, Jack",19,12,7,7,0,0,0,3
St Kilda,"Ray, Farren",25,21,7,4,0,0,0,3
St Kilda,"Riewoldt, Nick",23,15,12,8,3,0,0,2
St Kilda,"Roberton, Dylan",13,8,9,5,0,0,0,3
St Kilda,"Saunders, Josh",19,10,3,9,1,1,0,7
St Kilda,"Savage, Shane",10,8,2,2,0,1,0,2
St Kilda,"Stanley, Rhys",8,6,3,2,2,0,9,0
St Kilda,"Templeton, Eli",10,6,4,4,1,1,0,0
St Kilda,"Webster, Jimmy",14,9,4,5,0,0,0,0
St Kilda,"Wright, Nathan",8,5,1,3,0,0,0,3
St Kilda,"Armitage, David",29,18,6,11,1,0,1,2
St Kilda,"Curren, Tom",9,4,1,5,0,0,0,7
St Kilda,"Delaney, Luke",12,5,5,7,0,0,0,6
St Kilda,"Dempster, Sean",21,16,7,5,1,0,0,3
St Kilda,"Dunstan, Luke",15,8,3,7,1,0,0,6
St Kilda,"Geary, Jarryn",17,6,4,11,0,0,0,5
St Kilda,"Gilbert, Sam",16,9,8,7,0,0,0,4
St Kilda,"Gwilt, James",20,13,6,7,0,0,0,2
St Kilda,"Hayes, Lenny",18,10,5,8,0,0,1,5
St Kilda,"Hickey, Tom",19,7,8,12,3,0,20,4
St Kilda,"Jones, Clinton",26,13,5,13,0,0,0,3
St Kilda,"Maister, Beau",9,5,7,4,0,1,0,2
St Kilda,"Montagna, Leigh",25,19,7,6,1,0,0,4
St Kilda,"Newnes, Jack",26,17,5,9,0,0,0,3
St Kilda,"Ray, Farren",26,19,6,7,1,0,0,1
St Kilda,"Riewoldt, Nick",24,17,14,7,5,1,0,3
St Kilda,"Roberton, Dylan",3,2,0,1,0,0,0,3
St Kilda,"Saunders, Josh",11,4,1,7,0,0,0,6
St Kilda,"Savage, Shane",5,5,0,0,0,0,0,1
St Kilda,"Stanley, Rhys",11,7,5,4,0,1,8,1
St Kilda,"Templeton, Eli",11,8,6,3,2,0,0,2
St Kilda,"Wright, Nathan",14,14,6,0,0,1,0,1
St Kilda,"Armitage, David",17,6,0,11,0,1,0,8
St Kilda,"Curren, Tom",12,8,0,4,0,1,0,3
St Kilda,"Delaney, Luke",10,6,6,4,0,0,0,3
St Kilda,"Dempster, Sean",13,6,8,7,0,0,2,2
St Kilda,"Dunstan, Luke",29,9,4,20,2,0,0,5
St Kilda,"Geary, Jarryn",16,7,3,9,0,0,0,4
St Kilda,"Gilbert, Sam",0,0,0,0,0,0,0,0
St Kilda,"Gwilt, James",14,6,3,8,0,0,0,5
St Kilda,"Hayes, Lenny",22,8,0,14,0,0,2,6
St Kilda,"Hickey, Tom",9,2,3,7,0,0,13,1
St Kilda,"Jones, Clinton",20,6,2,14,0,2,0,9
St Kilda,"Maister, Beau",13,5,3,8,1,1,0,1
St Kilda,"Montagna, Leigh",27,21,2,6,2,0,0,4
St Kilda,"Newnes, Jack",21,12,5,9,0,1,0,5
St Kilda,"Ray, Farren",26,17,4,9,0,0,0,3
St Kilda,"Riewoldt, Nick",14,10,8,4,2,2,0,2
St Kilda,"Saunders, Josh",10,5,0,5,0,1,0,5
St Kilda,"Savage, Shane",18,13,3,5,0,0,0,1
St Kilda,"Stanley, Rhys",14,5,7,9,0,0,12,2
St Kilda,"Templeton, Eli",13,8,4,5,1,1,0,1
St Kilda,"Webster, Jimmy",14,10,2,4,0,0,0,2
St Kilda,"Wright, Nathan",13,9,4,4,0,0,0,6
St Kilda,"Armitage, David",21,14,5,7,0,0,0,1
St Kilda,"Curren, Tom",10,5,0,5,0,0,0,4
St Kilda,"Delaney, Luke",4,1,0,3,0,0,0,3
St Kilda,"Dempster, Sean",21,15,6,6,0,0,0,1
St Kilda,"Dunstan, Luke",21,11,5,10,0,1,0,1
St Kilda,"Geary, Jarryn",15,11,2,4,0,0,0,2
St Kilda,"Gwilt, James",14,8,4,6,1,1,0,3
St Kilda,"Hayes, Lenny",24,9,0,15,0,1,2,8
St Kilda,"Jones, Clinton",21,12,7,9,0,0,0,3
St Kilda,"Longer, Billy",8,1,1,7,0,0,24,4
St Kilda,"Maister, Beau",8,3,3,5,0,1,0,0
St Kilda,"Montagna, Leigh",17,11,1,6,0,0,0,4
St Kilda,"Newnes, Jack",18,11,3,7,0,0,0,2
St Kilda,"Ray, Farren",23,13,7,10,0,0,0,5
St Kilda,"Riewoldt, Nick",23,14,12,9,2,1,1,0
St Kilda,"Saunders, Josh",20,6,2,14,1,0,0,4
St Kilda,"Savage, Shane",13,7,3,6,1,0,0,3
St Kilda,"Stanley, Rhys",13,9,9,4,1,1,3,1
St Kilda,"Steven, Jack",20,10,3,10,1,1,0,4
St Kilda,"Templeton, Eli",8,5,6,3,0,0,0,2
St Kilda,"Webster, Jimmy",13,7,0,6,0,0,0,2
St Kilda,"Wright, Nathan",2,2,0,0,0,0,0,0
St Kilda,"Billings, Jack",19,12,7,7,2,1,0,1
St Kilda,"Bruce, Josh",15,8,6,7,0,0,0,2
St Kilda,"Curren, Tom",14,7,4,7,0,0,0,3
St Kilda,"Delaney, Luke",8,4,5,4,0,0,0,1
St Kilda,"Dempster, Sean",17,10,7,7,0,0,0,1
St Kilda,"Dunstan, Luke",18,8,6,10,0,0,0,2
St Kilda,"Geary, Jarryn",22,14,6,8,1,1,0,1
St Kilda,"Gwilt, James",24,21,11,3,0,0,0,0
St Kilda,"Hayes, Lenny",32,13,7,19,0,0,2,5
St Kilda,"Hickey, Tom",11,1,1,10,0,0,29,2
St Kilda,"Jones, Clinton",15,3,3,12,0,0,0,7
St Kilda,"Montagna, Leigh",31,23,6,8,1,0,0,7
St Kilda,"Newnes, Jack",23,11,6,12,0,0,0,3
St Kilda,"Ray, Farren",25,19,4,6,0,1,0,1
St Kilda,"Riewoldt, Nick",17,14,10,3,5,1,0,0
St Kilda,"Ross, Sebastian",4,3,2,1,0,0,0,2
St Kilda,"Saunders, Josh",16,6,3,10,0,1,0,8
St Kilda,"Schneider, Adam",22,18,5,4,2,0,0,4
St Kilda,"Stanley, Rhys",21,14,13,7,0,0,7,1
St Kilda,"Steven, Jack",23,13,5,10,0,2,0,0
St Kilda,"Templeton, Eli",7,3,3,4,0,1,0,0
St Kilda,"Webster, Jimmy",21,11,3,10,0,0,0,1
St Kilda,"Billings, Jack",16,10,5,6,1,3,0,3
St Kilda,"Bruce, Josh",12,7,4,5,0,0,0,2
St Kilda,"Curren, Tom",14,9,3,5,1,0,0,1
St Kilda,"Delaney, Luke",8,3,3,5,0,0,0,1
St Kilda,"Dempster, Sean",23,16,9,7,1,0,0,0
St Kilda,"Dunstan, Luke",20,7,4,13,1,0,0,2
St Kilda,"Geary, Jarryn",24,13,6,11,0,0,0,4
St Kilda,"Gwilt, James",21,15,11,6,0,0,0,1
St Kilda,"Hayes, Lenny",34,18,3,16,0,2,2,8
St Kilda,"Hickey, Tom",7,3,3,4,0,0,41,6
St Kilda,"Jones, Clinton",17,6,0,11,2,0,0,5
St Kilda,"Montagna, Leigh",37,21,8,16,2,0,0,6
St Kilda,"Newnes, Jack",20,11,3,9,0,0,0,4
St Kilda,"Ray, Farren",21,14,6,7,0,1,0,3
St Kilda,"Riewoldt, Nick",12,10,5,2,1,0,4,1
St Kilda,"Ross, Sebastian",18,8,1,10,0,0,0,2
St Kilda,"Saunders, Josh",9,4,1,5,1,1,0,3
St Kilda,"Savage, Shane",17,8,3,9,0,1,0,7
St Kilda,"Stanley, Rhys",14,8,8,6,1,1,6,3
St Kilda,"Steven, Jack",31,18,3,13,0,3,0,4
St Kilda,"Templeton, Eli",0,0,0,0,0,0,0,1
St Kilda,"Webster, Jimmy",14,8,4,6,0,0,0,4
St Kilda,"Acres, Blake",15,6,1,9,0,0,0,3
St Kilda,"Billings, Jack",15,11,7,4,1,1,0,3
St Kilda,"Curren, Tom",11,7,2,4,0,0,0,6
St Kilda,"Delaney, Luke",5,2,3,3,0,0,0,0
St Kilda,"Dempster, Sean",19,9,4,10,0,0,2,2
St Kilda,"Geary, Jarryn",9,7,3,2,0,0,0,0
St Kilda,"Gwilt, James",9,7,3,2,0,0,0,1
St Kilda,"Hayes, Lenny",24,10,1,14,0,1,1,9
St Kilda,"Jones, Clinton",21,10,1,11,0,0,0,6
St Kilda,"Longer, Billy",7,1,1,6,0,0,28,2
St Kilda,"Montagna, Leigh",39,24,5,15,1,0,0,7
St Kilda,"Newnes, Jack",11,4,3,7,0,0,0,5
St Kilda,"Ray, Farren",24,14,5,10,0,0,0,2
St Kilda,"Riewoldt, Nick",10,6,4,4,0,0,0,1
St Kilda,"Saunders, Josh",11,0,0,11,0,0,0,5
St Kilda,"Savage, Shane",8,1,0,7,0,0,0,3
St Kilda,"Schneider, Adam",9,7,3,2,0,0,0,1
St Kilda,"Simpkin, Tom",13,7,4,6,0,0,0,2
St Kilda,"Stanley, Rhys",10,9,7,1,1,0,9,3
St Kilda,"Steven, Jack",29,15,1,14,1,0,0,7
St Kilda,"Webster, Jimmy",13,4,0,9,0,0,0,3
St Kilda,"Weller, Maverick",16,11,4,5,0,0,0,2
St Kilda,"Acres, Blake",10,5,2,5,1,0,0,5
St Kilda,"Billings, Jack",15,11,6,4,2,1,0,1
St Kilda,"Bruce, Josh",13,5,8,8,0,0,0,2
St Kilda,"Curren, Tom",19,11,2,8,0,0,0,1
St Kilda,"Delaney, Luke",7,1,2,6,0,0,0,0
St Kilda,"Dempster, Sean",15,12,3,3,0,0,0,1
St Kilda,"Dunstan, Luke",17,6,2,11,1,1,0,5
St Kilda,"Gwilt, James",13,9,3,4,0,0,0,1
St Kilda,"Hayes, Lenny",30,12,5,18,0,0,2,5
St Kilda,"Jones, Clinton",21,8,1,13,0,0,0,6
St Kilda,"Longer, Billy",14,7,1,7,0,0,26,6
St Kilda,"Montagna, Leigh",21,17,3,4,0,1,0,6
St Kilda,"Newnes, Jack",13,7,2,6,0,0,0,3
St Kilda,"Ray, Farren",20,10,3,10,0,0,0,2
St Kilda,"Riewoldt, Nick",17,12,7,5,4,0,0,1
St Kilda,"Schneider, Adam",26,19,5,7,1,2,0,4
St Kilda,"Shenton, Cameron",10,6,2,4,0,1,0,2
St Kilda,"Siposs, Arryn",10,7,4,3,0,3,0,3
St Kilda,"Stanley, Rhys",6,2,2,4,0,1,2,0
St Kilda,"Steven, Jack",15,4,2,11,0,1,0,8
St Kilda,"Webster, Jimmy",6,5,1,1,0,1,0,3
St Kilda,"Weller, Maverick",6,3,1,3,0,0,0,2
St Kilda,"Acres, Blake",1,0,0,1,0,0,0,0
St Kilda,"Billings, Jack",15,10,6,5,1,2,0,2
St Kilda,"Bruce, Josh",14,9,3,5,0,0,0,3
St Kilda,"Curren, Tom",16,10,1,6,0,0,0,1
St Kilda,"Delaney, Luke",5,3,3,2,0,0,0,1
St Kilda,"Dempster, Sean",23,15,6,8,0,0,0,2
St Kilda,"Dunstan, Luke",18,7,3,11,0,0,0,5
St Kilda,"Hayes, Lenny",32,18,4,14,0,1,2,6
St Kilda,"Jones, Clinton",20,11,2,9,0,0,0,6
St Kilda,"Longer, Billy",4,0,0,4,0,0,37,2
St Kilda,"Milera, Terry",18,9,3,9,2,0,0,5
St Kilda,"Montagna, Leigh",13,11,4,2,0,0,0,1
St Kilda,"Newnes, Jack",29,19,11,10,1,0,0,4
St Kilda,"Ray, Farren",24,18,4,6,1,0,0,3
St Kilda,"Riewoldt, Nick",13,11,5,2,2,1,0,0
St Kilda,"Schneider, Adam",17,11,6,6,1,1,0,3
St Kilda,"Shenton, Cameron",22,10,8,12,0,0,0,0
St Kilda,"Siposs, Arryn",14,6,3,8,1,2,0,1
St Kilda,"Stanley, Rhys",9,3,3,6,1,0,11,4
St Kilda,"Steven, Jack",31,20,3,11,2,0,0,5
St Kilda,"Webster, Jimmy",22,15,7,7,0,0,0,1
St Kilda,"Weller, Maverick",15,9,2,6,1,1,0,5
St Kilda,"Billings, Jack",12,10,3,2,0,1,0,0
St Kilda,"Bruce, Josh",13,9,6,4,0,0,0,1
St Kilda,"Curren, Tom",18,12,5,6,0,0,0,3
St Kilda,"Delaney, Luke",11,5,7,6,0,0,0,1
St Kilda,"Dempster, Sean",16,14,7,2,0,0,0,1
St Kilda,"Dunstan, Luke",20,10,4,10,1,1,0,5
St Kilda,"Hayes, Lenny",25,12,6,13,0,0,1,7
St Kilda,"Jones, Clinton",12,7,1,5,0,0,0,5
St Kilda,"Longer, Billy",8,1,0,7,0,0,31,4
St Kilda,"Milera, Terry",14,6,7,8,1,1,0,4
St Kilda,"Montagna, Leigh",27,14,7,13,0,1,0,3
St Kilda,"Murdoch, Brodie",15,10,3,5,0,0,0,3
St Kilda,"Newnes, Jack",26,13,5,13,0,0,0,5
St Kilda,"Ray, Farren",17,8,3,9,1,0,2,3
St Kilda,"Riewoldt, Nick",14,10,8,4,3,1,0,1
St Kilda,"Ross, Sebastian",19,9,2,10,0,0,2,4
St Kilda,"Schneider, Adam",7,3,2,4,0,0,0,5
St Kilda,"Shenton, Cameron",24,12,6,12,0,0,0,2
St Kilda,"Siposs, Arryn",13,9,7,4,1,0,0,0
St Kilda,"Stanley, Rhys",9,5,6,4,0,0,7,0
St Kilda,"Steven, Jack",18,12,2,6,1,1,0,4
St Kilda,"Weller, Maverick",1,0,0,1,0,0,0,0
St Kilda,"Billings, Jack",7,2,1,5,0,0,0,1
St Kilda,"Bruce, Josh",9,7,3,2,0,0,0,1
St Kilda,"Delaney, Luke",6,2,2,4,0,0,0,1
St Kilda,"Dempster, Sean",11,9,3,2,0,0,0,0
St Kilda,"Dunell, Sam",8,5,3,3,0,0,0,3
St Kilda,"Dunstan, Luke",24,12,3,12,1,0,0,4
St Kilda,"Hayes, Lenny",26,12,1,14,1,0,2,7
St Kilda,"Jones, Clinton",19,8,1,11,0,0,0,3
St Kilda,"Lee, Tom",12,6,4,6,0,1,1,3
St Kilda,"Longer, Billy",9,5,1,4,0,0,22,1
St Kilda,"Milera, Terry",17,8,3,9,1,1,0,2
St Kilda,"Montagna, Leigh",14,7,0,7,0,1,0,9
St Kilda,"Murdoch, Brodie",12,9,2,3,0,0,0,4
St Kilda,"Newnes, Jack",20,10,5,10,0,0,0,4
St Kilda,"Ray, Farren",12,4,0,8,0,0,0,2
St Kilda,"Riewoldt, Nick",11,10,9,1,4,1,0,1
St Kilda,"Ross, Sebastian",18,11,1,7,0,0,1,5
St Kilda,"Saunders, Josh",15,7,2,8,2,0,0,2
St Kilda,"Shenton, Cameron",13,5,2,8,0,0,0,3
St Kilda,"Simpkin, Tom",6,3,0,3,0,0,0,1
St Kilda,"Steven, Jack",29,13,2,16,0,0,0,6
St Kilda,"Weller, Maverick",17,4,0,13,0,0,0,4
St Kilda,"Armitage, David",21,7,4,14,1,0,0,5
St Kilda,"Billings, Jack",15,8,2,7,1,1,0,3
St Kilda,"Bruce, Josh",12,5,3,7,0,0,0,1
St Kilda,"Delaney, Luke",4,3,2,1,0,0,0,1
St Kilda,"Dempster, Sean",12,6,3,6,0,0,0,3
St Kilda,"Dunstan, Luke",10,4,2,6,0,1,0,1
St Kilda,"Hayes, Lenny",18,6,2,12,0,0,3,8
St Kilda,"Jones, Clinton",13,7,0,6,0,1,0,3
St Kilda,"Lee, Tom",2,1,1,1,0,0,1,1
St Kilda,"Longer, Billy",3,1,2,2,0,0,16,5
St Kilda,"Montagna, Leigh",17,8,2,9,0,0,0,4
St Kilda,"Murdoch, Brodie",10,5,6,5,0,1,0,1
St Kilda,"Newnes, Jack",14,6,4,8,0,0,0,2
St Kilda,"Ray, Farren",21,10,5,11,0,0,0,5
St Kilda,"Riewoldt, Nick",8,6,4,2,1,0,0,2
St Kilda,"Ross, Sebastian",28,16,5,12,0,0,0,3
St Kilda,"Saunders, Josh",5,2,0,3,0,0,0,3
St Kilda,"Shenton, Cameron",17,6,5,11,1,0,0,1
St Kilda,"Simpkin, Tom",17,9,5,8,0,0,1,1
St Kilda,"Steven, Jack",19,8,2,11,0,0,0,2
St Kilda,"Webster, Jimmy",20,12,7,8,0,0,0,3
St Kilda,"Weller, Maverick",17,6,3,11,1,0,0,8
St Kilda,"Armitage, David",19,10,4,9,0,0,0,5
St Kilda,"Billings, Jack",25,17,8,8,3,0,0,2
St Kilda,"Delaney, Luke",13,9,8,4,0,0,0,4
St Kilda,"Dempster, Sean",17,12,8,5,0,0,0,0
St Kilda,"Gwilt, James",11,9,3,2,0,0,0,2
St Kilda,"Hayes, Lenny",25,13,7,12,1,0,0,2
St Kilda,"Jones, Clinton",13,9,5,4,2,0,0,5
St Kilda,"Lee, Tom",10,7,6,3,1,1,1,3
St Kilda,"Longer, Billy",11,4,0,7,0,0,25,5
St Kilda,"Milera, Terry",9,6,3,3,0,2,0,1
St Kilda,"Minchington, Darren",12,7,2,5,1,1,0,2
St Kilda,"Murdoch, Brodie",5,3,3,2,0,0,0,0
St Kilda,"Newnes, Jack",24,11,7,13,0,0,0,6
St Kilda,"Ray, Farren",17,8,2,9,0,0,1,3
St Kilda,"Riewoldt, Nick",12,11,7,1,1,1,0,2
St Kilda,"Ross, Sebastian",16,9,5,7,0,0,0,5
St Kilda,"Savage, Shane",21,15,8,6,0,0,0,1
St Kilda,"Shenton, Cameron",15,7,4,8,0,0,0,2
St Kilda,"Simpkin, Tom",9,3,3,6,1,0,0,2
St Kilda,"Steven, Jack",26,11,3,15,0,0,0,3
St Kilda,"Webster, Jimmy",17,7,3,10,0,0,0,4
St Kilda,"Weller, Maverick",21,11,4,10,0,4,0,7
St Kilda,"Armitage, David",19,8,5,11,0,0,0,4
St Kilda,"Billings, Jack",12,7,4,5,0,0,0,6
St Kilda,"Delaney, Luke",8,4,7,4,0,0,0,0
St Kilda,"Dempster, Sean",19,15,8,4,0,0,0,1
St Kilda,"Dunstan, Luke",14,9,3,5,0,0,0,0
St Kilda,"Gwilt, James",20,11,11,9,0,0,0,1
St Kilda,"Hayes, Lenny",15,6,4,9,1,0,3,7
St Kilda,"Jones, Clinton",12,7,2,5,0,0,0,6
St Kilda,"Longer, Billy",11,4,3,7,1,0,23,7
St Kilda,"Milera, Terry",8,3,3,5,1,0,0,5
St Kilda,"Minchington, Darren",6,5,2,1,2,0,0,1
St Kilda,"Montagna, Leigh",27,20,4,7,0,0,0,5
St Kilda,"Newnes, Jack",9,5,3,4,0,1,0,7
St Kilda,"Riewoldt, Nick",14,9,6,5,1,2,0,0
St Kilda,"Ross, Sebastian",20,14,4,6,0,0,1,4
St Kilda,"Savage, Shane",26,16,7,10,0,0,0,2
St Kilda,"Shenton, Cameron",17,9,6,8,1,1,0,2
St Kilda,"Simpkin, Tom",5,4,1,1,1,1,0,3
St Kilda,"Stanley, Rhys",13,8,8,5,2,0,7,2
St Kilda,"Steven, Jack",23,11,3,12,1,0,0,8
St Kilda,"Webster, Jimmy",11,5,2,6,0,0,0,0
St Kilda,"Weller, Maverick",17,8,3,9,0,0,1,6
St Kilda,"Armitage, David",24,14,5,10,0,0,0,2
St Kilda,"Billings, Jack",20,11,7,9,1,2,0,0
St Kilda,"Delaney, Luke",9,4,2,5,0,0,0,4
St Kilda,"Dempster, Sean",9,3,1,6,0,0,0,2
St Kilda,"Dennis-Lane, Trent",6,5,2,1,0,2,0,1
St Kilda,"Dunell, Sam",1,1,0,0,0,0,0,0
St Kilda,"Dunstan, Luke",13,6,5,7,0,0,0,3
St Kilda,"Gwilt, James",15,12,4,3,0,0,0,5
St Kilda,"Longer, Billy",6,3,2,3,0,0,25,2
St Kilda,"Minchington, Darren",10,8,3,2,1,0,0,1
St Kilda,"Montagna, Leigh",13,6,0,7,0,0,0,1
St Kilda,"Newnes, Jack",20,9,4,11,0,0,0,3
St Kilda,"Ray, Farren",16,6,2,10,0,0,1,3
St Kilda,"Riewoldt, Nick",19,12,6,7,3,0,2,2
St Kilda,"Roberton, Dylan",10,5,2,5,0,0,0,0
St Kilda,"Ross, Sebastian",12,6,3,6,0,0,0,4
St Kilda,"Savage, Shane",25,13,1,12,2,0,0,4
St Kilda,"Schneider, Adam",17,11,3,6,1,1,0,3
St Kilda,"Shenton, Cameron",17,5,4,12,0,0,0,2
St Kilda,"Stanley, Rhys",10,6,4,4,2,0,5,2
St Kilda,"Steven, Jack",14,5,1,9,0,1,0,6
St Kilda,"Weller, Maverick",22,8,4,14,0,0,0,2
St Kilda,"Armitage, David",29,21,5,8,2,0,0,11
St Kilda,"Billings, Jack",14,10,5,4,0,1,0,2
St Kilda,"Curren, Tom",9,7,2,2,0,1,0,7
St Kilda,"Delaney, Luke",5,2,3,3,0,0,0,2
St Kilda,"Dempster, Sean",17,12,2,5,0,0,0,0
St Kilda,"Dunell, Sam",8,4,3,4,0,1,0,1
St Kilda,"Dunstan, Luke",19,9,4,10,0,0,0,6
St Kilda,"Fisher, Sam",15,8,6,7,0,0,0,6
St Kilda,"Gwilt, James",17,9,7,8,0,0,0,3
St Kilda,"Hayes, Lenny",24,10,5,14,0,1,2,5
St Kilda,"Hickey, Tom",10,3,5,7,0,1,17,3
St Kilda,"Montagna, Leigh",25,16,2,9,0,1,0,3
St Kilda,"Newnes, Jack",13,9,5,4,0,1,0,4
St Kilda,"Ray, Farren",17,10,5,7,0,1,0,0
St Kilda,"Riewoldt, Nick",19,11,8,8,1,3,1,3
St Kilda,"Roberton, Dylan",18,8,4,10,0,0,0,3
St Kilda,"Ross, Sebastian",5,1,0,4,0,0,0,2
St Kilda,"Savage, Shane",22,11,2,11,0,0,0,0
St Kilda,"Schneider, Adam",10,7,3,3,0,0,0,7
St Kilda,"Shenton, Cameron",6,4,3,2,0,1,1,0
St Kilda,"Stanley, Rhys",6,4,5,2,0,1,9,5
St Kilda,"Weller, Maverick",12,7,3,5,0,0,1,8
St Kilda,"Armitage, David",25,16,4,9,1,2,1,8
St Kilda,"Billings, Jack",21,15,6,6,0,1,0,4
St Kilda,"Bruce, Josh",6,5,4,1,0,0,0,0
St Kilda,"Curren, Tom",8,6,1,2,1,1,0,3
St Kilda,"Delaney, Luke",9,5,6,4,0,0,0,1
St Kilda,"Dempster, Sean",1,1,1,0,0,0,0,0
St Kilda,"Dunstan, Luke",26,14,4,12,2,1,0,5
St Kilda,"Fisher, Sam",21,17,11,4,0,0,0,1
St Kilda,"Gwilt, James",19,18,13,1,0,0,0,5
St Kilda,"Hayes, Lenny",24,14,5,10,0,0,0,9
St Kilda,"Longer, Billy",5,2,1,3,0,0,37,6
St Kilda,"Montagna, Leigh",27,18,4,9,1,0,1,0
St Kilda,"Murdoch, Brodie",11,10,6,1,1,3,0,1
St Kilda,"Newnes, Jack",25,11,8,14,0,0,0,8
St Kilda,"Ray, Farren",26,16,9,10,2,0,0,2
St Kilda,"Riewoldt, Nick",30,22,16,8,4,1,0,2
St Kilda,"Roberton, Dylan",19,13,8,6,0,1,0,1
St Kilda,"Savage, Shane",30,24,8,6,0,0,0,1
St Kilda,"Schneider, Adam",24,16,8,8,1,2,0,5
St Kilda,"Shenton, Cameron",14,7,6,7,1,0,0,2
St Kilda,"Stanley, Rhys",19,13,14,6,3,2,13,2
St Kilda,"Weller, Maverick",13,7,4,6,0,0,0,6
St Kilda,"Armitage, David",20,10,3,10,1,1,0,3
St Kilda,"Billings, Jack",11,6,4,5,1,0,0,0
St Kilda,"Bruce, Josh",11,9,6,2,3,1,0,2
St Kilda,"Curren, Tom",15,11,4,4,1,1,0,2
St Kilda,"Delaney, Luke",11,7,5,4,0,0,0,3
St Kilda,"Dempster, Sean",14,10,8,4,0,1,2,3
St Kilda,"Dunstan, Luke",15,8,0,7,0,0,0,3
St Kilda,"Fisher, Sam",12,7,6,5,0,0,0,1
St Kilda,"Gwilt, James",20,14,6,6,0,0,0,1
St Kilda,"Hayes, Lenny",24,9,6,15,0,0,5,9
St Kilda,"Longer, Billy",4,4,0,0,0,1,36,6
St Kilda,"Montagna, Leigh",16,11,4,5,0,1,0,1
St Kilda,"Murdoch, Brodie",0,0,0,0,0,0,0,0
St Kilda,"Newnes, Jack",25,16,7,9,0,0,0,5
St Kilda,"Ray, Farren",24,14,6,10,0,0,0,4
St Kilda,"Riewoldt, Nick",20,16,12,4,1,3,0,1
St Kilda,"Roberton, Dylan",12,7,2,5,0,0,0,3
St Kilda,"Savage, Shane",26,16,7,10,0,0,0,0
St Kilda,"Schneider, Adam",7,3,1,4,0,0,0,2
St Kilda,"Stanley, Rhys",11,4,5,7,2,0,6,3
St Kilda,"Steven, Jack",11,9,1,2,0,0,0,6
St Kilda,"Weller, Maverick",14,3,2,11,0,0,0,4
St Kilda,"Armitage, David",22,11,5,11,0,2,0,3
St Kilda,"Billings, Jack",12,7,4,5,1,0,0,0
St Kilda,"Bruce, Josh",9,5,2,4,1,0,0,2
St Kilda,"Curren, Tom",7,4,2,3,2,0,0,1
St Kilda,"Delaney, Luke",9,5,5,4,0,0,0,2
St Kilda,"Dempster, Sean",17,13,8,4,0,1,0,4
St Kilda,"Fisher, Sam",17,16,8,1,0,0,2,2
St Kilda,"Gilbert, Sam",17,12,7,5,0,0,0,2
St Kilda,"Gwilt, James",20,11,8,9,3,1,0,1
St Kilda,"Hayes, Lenny",17,8,1,9,1,0,2,4
St Kilda,"Longer, Billy",6,4,1,2,0,0,23,3
St Kilda,"Montagna, Leigh",24,16,5,8,0,0,0,4
St Kilda,"Murdoch, Brodie",4,3,2,1,1,0,0,0
St Kilda,"Newnes, Jack",19,11,7,8,1,0,0,3
St Kilda,"Ray, Farren",20,12,6,8,0,0,0,4
St Kilda,"Riewoldt, Nick",13,9,6,4,1,1,1,4
St Kilda,"Ross, Sebastian",19,12,5,7,1,0,1,4
St Kilda,"Savage, Shane",11,7,4,4,0,0,0,4
St Kilda,"Schneider, Adam",17,11,5,6,1,0,0,7
St Kilda,"Stanley, Rhys",5,3,2,2,0,2,5,2
St Kilda,"Steven, Jack",20,13,2,7,1,0,0,8
St Kilda,"Weller, Maverick",19,9,2,10,1,0,0,5
St Kilda,"Armitage, David",22,10,3,12,1,0,0,3
St Kilda,"Curren, Tom",10,7,3,3,0,0,0,1
St Kilda,"Delaney, Luke",13,10,2,3,0,0,0,0
St Kilda,"Dempster, Sean",21,14,6,7,0,0,1,0
St Kilda,"Fisher, Sam",17,10,6,7,0,0,1,1
St Kilda,"Gilbert, Sam",19,10,5,9,0,1,0,3
St Kilda,"Gwilt, James",5,3,1,2,1,0,0,0
St Kilda,"Hayes, Lenny",17,4,5,13,0,0,5,4
St Kilda,"Longer, Billy",8,1,0,7,0,0,25,1
St Kilda,"Montagna, Leigh",26,19,7,7,0,0,0,3
St Kilda,"Newnes, Jack",26,14,10,12,0,0,0,1
St Kilda,"Ray, Farren",27,15,10,12,0,0,0,2
St Kilda,"Riewoldt, Nick",20,16,11,4,3,0,2,1
St Kilda,"Ross, Sebastian",16,6,2,10,0,0,0,2
St Kilda,"Saunders, Josh",15,4,3,11,0,1,0,3
St Kilda,"Savage, Shane",20,13,3,7,0,0,0,1
St Kilda,"Schneider, Adam",20,17,5,3,0,2,0,4
St Kilda,"Shenton, Cameron",8,5,4,3,0,1,0,1
St Kilda,"Stanley, Rhys",14,11,8,3,2,1,2,1
St Kilda,"Steven, Jack",31,17,6,14,1,0,0,1
St Kilda,"Weller, Maverick",16,7,2,9,0,1,0,2
St Kilda,"Wright, Nathan",12,8,2,4,0,0,0,3
St Kilda,"Armitage, David",26,14,5,12,1,0,0,2
St Kilda,"Curren, Tom",13,6,4,7,0,1,0,2
St Kilda,"Delaney, Luke",5,2,1,3,0,0,0,2
St Kilda,"Dempster, Sean",17,13,9,4,0,0,0,2
St Kilda,"Fisher, Sam",16,14,5,2,1,0,2,4
St Kilda,"Gilbert, Sam",9,5,1,4,0,0,0,3
St Kilda,"Hayes, Lenny",14,6,4,8,0,0,5,4
St Kilda,"Jones, Clinton",12,6,1,6,0,0,0,2
St Kilda,"Longer, Billy",8,2,3,6,0,0,28,7
St Kilda,"Montagna, Leigh",21,14,5,7,0,0,0,3
St Kilda,"Murdoch, Brodie",3,2,1,1,1,1,0,0
St Kilda,"Newnes, Jack",15,12,6,3,1,1,0,2
St Kilda,"Ray, Farren",20,13,6,7,0,0,0,4
St Kilda,"Riewoldt, Nick",24,15,14,9,2,2,0,1
St Kilda,"Ross, Sebastian",17,7,2,10,0,0,0,1
St Kilda,"Schneider, Adam",13,9,3,4,0,1,0,3
St Kilda,"Shenton, Cameron",13,6,3,7,1,1,0,1
St Kilda,"Stanley, Rhys",5,3,4,2,0,0,6,4
St Kilda,"Steven, Jack",23,16,1,7,0,1,0,3
St Kilda,"Weller, Maverick",16,9,5,7,0,0,0,7
St Kilda,"White, Spencer",6,4,3,2,3,0,0,1
St Kilda,"Wright, Nathan",12,8,2,4,0,1,0,4
St Kilda,"Armitage, David",22,11,4,11,2,0,0,4
St Kilda,"Delaney, Luke",6,3,2,3,0,0,0,2
St Kilda,"Dempster, Sean",21,19,10,2,0,1,0,0
St Kilda,"Fisher, Sam",28,12,8,16,0,0,0,4
St Kilda,"Gwilt, James",15,9,3,6,0,0,0,2
St Kilda,"Hayes, Lenny",21,9,2,12,0,0,0,13
St Kilda,"Jones, Clinton",21,11,6,10,1,0,0,4
St Kilda,"Longer, Billy",4,0,1,4,0,0,8,2
St Kilda,"Montagna, Leigh",23,14,3,9,1,0,0,5
St Kilda,"Murdoch, Brodie",9,5,6,4,1,0,0,0
St Kilda,"Newnes, Jack",21,14,7,7,0,0,0,3
St Kilda,"Ray, Farren",16,11,8,5,1,0,0,1
St Kilda,"Riewoldt, Nick",10,6,7,4,0,0,0,1
St Kilda,"Roberton, Dylan",14,10,5,4,0,0,0,1
St Kilda,"Ross, Sebastian",14,10,3,4,0,2,0,5
St Kilda,"Schneider, Adam",16,9,7,7,1,1,0,1
St Kilda,"Shenton, Cameron",6,4,1,2,0,0,0,0
St Kilda,"Stanley, Rhys",15,9,8,6,1,0,21,2
St Kilda,"Steven, Jack",30,11,4,19,0,0,0,4
St Kilda,"Weller, Maverick",17,8,1,9,0,1,1,6
St Kilda,"White, Spencer",6,3,3,3,1,1,0,1
St Kilda,"Wright, Nathan",8,6,5,2,0,0,0,2
Sydney,"Bird, Craig",16,9,2,7,1,1,0,6
Sydney,"Cunningham, Harry",13,9,3,4,1,0,0,4
Sydney,"Franklin, Lance",7,4,4,3,1,1,0,5
Sydney,"Grundy, Heath",16,12,4,4,0,0,0,1
Sydney,"Hannebery, Dan",12,6,1,6,0,0,0,9
Sydney,"Jetta, Lewis",16,10,3,6,1,2,0,0
Sydney,"Kennedy, Josh",22,12,2,10,0,2,0,5
Sydney,"Laidler, Jeremy",16,7,2,9,0,0,0,3
Sydney,"Malceski, Nick",18,14,3,4,0,0,0,5
Sydney,"McGlynn, Ben",14,6,2,8,2,1,0,5
Sydney,"McVeigh, Jarrad",20,10,5,10,0,0,0,4
Sydney,"Mitchell, Tom",21,11,4,10,1,0,0,6
Sydney,"OKeefe, Ryan",7,6,1,1,0,0,0,0
Sydney,"Parker, Luke",23,11,4,12,0,0,0,6
Sydney,"Pyke, Mike",10,8,3,2,0,0,34,4
Sydney,"Rampe, Dane",16,10,3,6,0,0,0,1
Sydney,"Reid, Sam",10,4,1,6,1,0,1,1
Sydney,"Richards, Ted",13,11,6,2,0,0,0,1
Sydney,"Roberts-Thomson, Lewis",4,4,3,0,0,0,2,2
Sydney,"Rohan, Gary",9,5,2,4,1,1,0,4
Sydney,"Shaw, Rhyce",22,17,6,5,0,0,0,2
Sydney,"Smith, Nick",15,10,5,5,0,0,0,2
Sydney,"Bird, Craig",7,4,0,3,0,0,0,2
Sydney,"Cunningham, Harry",16,3,6,13,1,0,0,2
Sydney,"Derickx, Tom",5,3,0,2,0,0,20,4
Sydney,"Franklin, Lance",16,10,4,6,2,1,0,3
Sydney,"Grundy, Heath",16,8,4,8,0,0,0,5
Sydney,"Hannebery, Dan",29,12,3,17,1,0,0,2
Sydney,"Jack, Kieren",14,7,0,7,0,0,0,6
Sydney,"Jetta, Lewis",21,18,8,3,1,0,0,3
Sydney,"Kennedy, Josh",28,10,2,18,0,1,0,7
Sydney,"Malceski, Nick",19,14,3,5,1,0,0,2
Sydney,"McGlynn, Ben",20,14,6,6,1,1,0,4
Sydney,"McVeigh, Jarrad",27,15,6,12,0,1,0,1
Sydney,"Mitchell, Tom",26,15,2,11,0,1,0,5
Sydney,"OKeefe, Ryan",12,7,5,5,0,0,0,0
Sydney,"Parker, Luke",21,7,2,14,0,0,0,8
Sydney,"Pyke, Mike",16,12,6,4,1,0,23,1
Sydney,"Rampe, Dane",14,9,4,5,1,0,0,3
Sydney,"Reid, Sam",13,10,8,3,1,3,0,3
Sydney,"Richards, Ted",14,9,4,5,0,0,0,0
Sydney,"Rohan, Gary",8,6,1,2,0,1,0,6
Sydney,"Shaw, Rhyce",14,8,2,6,0,0,0,1
Sydney,"Smith, Nick",15,6,5,9,0,0,0,6
Sydney,"Cunningham, Harry",9,6,3,3,3,0,0,1
Sydney,"Derickx, Tom",7,2,0,5,0,0,18,0
Sydney,"Franklin, Lance",20,15,6,5,4,2,0,3
Sydney,"Grundy, Heath",17,9,7,8,0,0,0,3
Sydney,"Hannebery, Dan",18,12,2,6,2,0,0,3
Sydney,"Jack, Kieren",19,8,2,11,2,0,0,9
Sydney,"Jetta, Lewis",18,14,3,4,0,0,0,3
Sydney,"Kennedy, Josh",28,8,1,20,0,0,1,5
Sydney,"Laidler, Jeremy",13,7,3,6,1,0,0,3
Sydney,"Malceski, Nick",25,20,5,5,0,0,0,2
Sydney,"McGlynn, Ben",16,8,5,8,1,0,0,10
Sydney,"McVeigh, Jarrad",21,8,7,13,1,1,0,2
Sydney,"Mitchell, Tom",9,4,3,5,1,0,0,1
Sydney,"OKeefe, Ryan",14,6,2,8,0,0,0,5
Sydney,"Parker, Luke",26,14,6,12,4,0,0,3
Sydney,"Pyke, Mike",14,8,2,6,0,0,26,2
Sydney,"Rampe, Dane",14,10,5,4,0,0,0,2
Sydney,"Richards, Ted",14,6,5,8,0,0,0,3
Sydney,"Roberts-Thomson, Lewis",5,4,2,1,1,0,0,0
Sydney,"Rohan, Gary",5,5,3,0,1,1,0,0
Sydney,"Shaw, Rhyce",18,8,1,10,0,1,0,1
Sydney,"Smith, Nick",17,10,4,7,0,0,0,2
Sydney,"Cunningham, Harry",11,4,1,7,0,0,0,3
Sydney,"Derickx, Tom",4,0,0,4,0,0,14,3
Sydney,"Franklin, Lance",13,6,3,7,0,1,0,0
Sydney,"Grundy, Heath",11,4,2,7,1,0,0,1
Sydney,"Hannebery, Dan",15,3,1,12,0,0,0,6
Sydney,"Jack, Kieren",19,14,2,5,1,0,0,3
Sydney,"Jetta, Lewis",13,11,4,2,0,2,0,3
Sydney,"Kennedy, Josh",33,15,1,18,0,0,1,8
Sydney,"Laidler, Jeremy",14,10,3,4,2,0,0,1
Sydney,"Malceski, Nick",26,20,5,6,0,0,0,7
Sydney,"McGlynn, Ben",16,12,2,4,0,0,0,3
Sydney,"McVeigh, Jarrad",28,18,2,10,1,0,0,4
Sydney,"Mitchell, Tom",17,9,5,8,0,0,0,3
Sydney,"OKeefe, Ryan",11,5,3,6,1,0,0,6
Sydney,"Parker, Luke",26,17,5,9,0,1,0,4
Sydney,"Pyke, Mike",9,4,3,5,0,0,29,1
Sydney,"Rampe, Dane",22,16,6,6,0,0,0,6
Sydney,"Richards, Ted",12,10,2,2,0,1,0,5
Sydney,"Roberts-Thomson, Lewis",11,8,3,3,0,1,0,2
Sydney,"Rohan, Gary",3,2,1,1,0,1,0,3
Sydney,"Shaw, Rhyce",18,12,6,6,0,0,0,2
Sydney,"Smith, Nick",18,14,3,4,0,0,0,3
Sydney,"Bird, Craig",19,6,0,13,0,0,0,5
Sydney,"Cunningham, Harry",13,9,7,4,0,0,0,4
Sydney,"Derickx, Tom",8,1,1,7,0,0,7,5
Sydney,"Franklin, Lance",17,14,8,3,4,2,0,4
Sydney,"Grundy, Heath",10,5,1,5,0,0,0,7
Sydney,"Hannebery, Dan",29,10,1,19,0,0,0,10
Sydney,"Jack, Brandon",7,3,0,4,1,0,0,3
Sydney,"Jack, Kieren",20,12,3,8,0,0,0,9
Sydney,"Jetta, Lewis",17,16,6,1,1,2,0,3
Sydney,"Kennedy, Josh",38,13,4,25,1,2,0,3
Sydney,"Laidler, Jeremy",14,8,2,6,0,0,0,1
Sydney,"Lloyd, Jake",4,3,2,1,0,0,0,2
Sydney,"Malceski, Nick",27,15,1,12,1,2,0,2
Sydney,"McGlynn, Ben",24,14,10,10,2,2,0,12
Sydney,"McVeigh, Jarrad",29,10,4,19,1,1,0,5
Sydney,"Parker, Luke",19,8,3,11,1,0,0,10
Sydney,"Pyke, Mike",8,5,1,3,0,2,12,4
Sydney,"Rampe, Dane",22,11,4,11,0,0,0,2
Sydney,"Richards, Ted",19,9,7,10,0,0,0,1
Sydney,"Roberts-Thomson, Lewis",9,4,3,5,1,0,0,4
Sydney,"Shaw, Rhyce",29,16,7,13,0,0,0,3
Sydney,"Smith, Nick",16,12,6,4,0,0,0,3
Sydney,"Bird, Craig",23,13,3,10,0,0,0,10
Sydney,"Cunningham, Harry",12,10,6,2,1,0,0,5
Sydney,"Derickx, Tom",11,2,2,9,1,0,7,4
Sydney,"Franklin, Lance",7,6,4,1,1,1,0,1
Sydney,"Goodes, Adam",5,5,2,0,0,0,0,0
Sydney,"Grundy, Heath",21,12,11,9,0,0,0,2
Sydney,"Hannebery, Dan",34,17,5,17,1,0,0,3
Sydney,"Jack, Kieren",23,15,5,8,2,1,0,7
Sydney,"Jetta, Lewis",16,13,5,3,0,1,0,2
Sydney,"Kennedy, Josh",27,12,4,15,1,1,0,6
Sydney,"Laidler, Jeremy",19,11,4,8,0,1,0,3
Sydney,"Lloyd, Jake",14,5,4,9,0,0,0,1
Sydney,"Malceski, Nick",24,15,5,9,0,0,0,1
Sydney,"McGlynn, Ben",19,13,9,6,1,1,0,7
Sydney,"McVeigh, Jarrad",18,9,3,9,0,0,0,6
Sydney,"Parker, Luke",26,15,7,11,1,3,0,3
Sydney,"Pyke, Mike",8,4,1,4,0,1,19,1
Sydney,"Rampe, Dane",25,17,1,8,0,2,0,1
Sydney,"Richards, Ted",10,5,6,5,0,0,0,0
Sydney,"Roberts-Thomson, Lewis",4,1,2,3,0,0,0,1
Sydney,"Shaw, Rhyce",34,19,7,15,0,0,0,1
Sydney,"Smith, Nick",22,8,3,14,0,0,0,0
Sydney,"Bird, Craig",20,12,6,8,0,0,0,4
Sydney,"Cunningham, Harry",13,6,6,7,1,2,0,2
Sydney,"Derickx, Tom",13,7,3,6,1,0,26,2
Sydney,"Goodes, Adam",15,11,4,4,3,0,0,0
Sydney,"Grundy, Heath",16,9,6,7,0,0,0,2
Sydney,"Hannebery, Dan",31,16,6,15,0,2,0,6
Sydney,"Jack, Brandon",8,5,1,3,2,0,0,1
Sydney,"Jack, Kieren",26,17,6,9,2,2,0,1
Sydney,"Jetta, Lewis",22,17,5,5,1,3,0,4
Sydney,"Kennedy, Josh",34,14,5,20,2,2,0,2
Sydney,"Laidler, Jeremy",13,4,6,9,0,0,0,0
Sydney,"Lloyd, Jake",29,15,8,14,1,0,0,3
Sydney,"Malceski, Nick",21,15,2,6,0,0,0,3
Sydney,"McGlynn, Ben",24,8,2,16,0,0,0,7
Sydney,"McVeigh, Jarrad",35,16,7,19,1,1,0,2
Sydney,"Parker, Luke",25,8,6,17,2,0,0,3
Sydney,"Pyke, Mike",7,2,3,5,0,1,10,1
Sydney,"Rampe, Dane",21,18,10,3,0,0,0,6
Sydney,"Reid, Sam",4,4,2,0,1,0,0,3
Sydney,"Richards, Ted",11,5,6,6,0,0,0,1
Sydney,"Shaw, Rhyce",27,17,8,10,1,0,0,3
Sydney,"Smith, Nick",13,9,4,4,0,0,0,3
Sydney,"Bird, Craig",23,9,2,14,1,0,0,5
Sydney,"Cunningham, Harry",9,2,1,7,0,0,0,2
Sydney,"Derickx, Tom",4,2,2,2,0,0,24,6
Sydney,"Franklin, Lance",21,15,10,6,2,7,0,4
Sydney,"Goodes, Adam",10,5,1,5,0,0,0,1
Sydney,"Grundy, Heath",18,5,5,13,0,0,0,1
Sydney,"Hannebery, Dan",40,17,5,23,1,1,0,6
Sydney,"Jack, Kieren",29,19,3,10,1,1,0,6
Sydney,"Jetta, Lewis",23,12,7,11,1,1,0,5
Sydney,"Kennedy, Josh",36,15,2,21,0,1,0,11
Sydney,"Laidler, Jeremy",11,3,1,8,0,1,0,2
Sydney,"Lloyd, Jake",6,2,0,4,0,0,0,1
Sydney,"Malceski, Nick",22,15,3,7,2,0,0,0
Sydney,"McGlynn, Ben",19,8,3,11,0,1,0,7
Sydney,"McVeigh, Jarrad",25,15,6,10,1,1,0,7
Sydney,"Parker, Luke",26,14,4,12,2,0,0,8
Sydney,"Rampe, Dane",12,7,5,5,0,0,0,2
Sydney,"Reid, Sam",12,9,5,3,0,0,8,5
Sydney,"Richards, Ted",12,7,2,5,0,0,0,0
Sydney,"Shaw, Rhyce",13,9,1,4,0,0,0,3
Sydney,"Smith, Nick",7,2,1,5,0,0,0,2
Sydney,"Tippett, Kurt",15,10,5,5,4,0,4,1
Sydney,"Bird, Craig",31,18,6,13,1,0,0,7
Sydney,"Cunningham, Harry",12,4,3,8,0,0,0,2
Sydney,"Derickx, Tom",12,4,3,8,1,0,26,3
Sydney,"Franklin, Lance",18,14,8,4,5,1,0,2
Sydney,"Goodes, Adam",7,6,4,1,1,0,0,3
Sydney,"Grundy, Heath",15,4,2,11,0,0,0,0
Sydney,"Hannebery, Dan",28,16,3,12,0,1,0,4
Sydney,"Jack, Brandon",1,0,0,1,0,0,0,1
Sydney,"Jack, Kieren",32,16,5,16,0,1,0,3
Sydney,"Jetta, Lewis",15,12,4,3,0,0,0,2
Sydney,"Kennedy, Josh",39,17,6,22,1,1,0,5
Sydney,"Laidler, Jeremy",14,7,4,7,0,0,0,1
Sydney,"Lloyd, Jake",20,10,7,10,0,0,0,6
Sydney,"Malceski, Nick",24,19,9,5,0,0,0,2
Sydney,"McVeigh, Jarrad",14,7,3,7,3,0,0,2
Sydney,"Parker, Luke",26,14,6,12,2,0,0,8
Sydney,"Rampe, Dane",15,8,5,7,1,0,0,4
Sydney,"Reid, Sam",9,5,4,4,0,1,2,4
Sydney,"Richards, Ted",14,7,6,7,0,0,0,1
Sydney,"Shaw, Rhyce",21,14,8,7,0,0,0,1
Sydney,"Smith, Nick",14,6,5,8,0,0,0,1
Sydney,"Tippett, Kurt",11,6,4,5,3,0,4,5
Sydney,"Bird, Craig",33,18,7,15,1,0,0,5
Sydney,"Cunningham, Harry",10,5,1,5,0,0,0,1
Sydney,"Derickx, Tom",12,5,3,7,2,0,18,4
Sydney,"Franklin, Lance",23,16,6,7,4,3,0,2
Sydney,"Goodes, Adam",17,10,3,7,3,1,0,3
Sydney,"Grundy, Heath",22,10,7,12,0,0,0,1
Sydney,"Hannebery, Dan",30,13,4,17,2,0,0,2
Sydney,"Jack, Kieren",29,16,8,13,2,1,0,3
Sydney,"Jetta, Lewis",12,9,6,3,1,0,0,1
Sydney,"Kennedy, Josh",32,13,7,19,0,1,0,6
Sydney,"Laidler, Jeremy",16,4,3,12,0,0,0,0
Sydney,"Lloyd, Jake",18,6,2,12,1,0,0,4
Sydney,"Malceski, Nick",37,26,8,11,0,2,0,4
Sydney,"McGlynn, Ben",26,18,5,8,1,1,0,11
Sydney,"McVeigh, Jarrad",26,13,5,13,0,1,0,3
Sydney,"Parker, Luke",32,18,3,14,0,0,0,5
Sydney,"Rampe, Dane",11,5,0,6,0,0,0,2
Sydney,"Reid, Sam",14,8,4,6,0,0,1,6
Sydney,"Richards, Ted",11,4,3,7,0,0,0,3
Sydney,"Shaw, Rhyce",31,20,4,11,0,0,0,1
Sydney,"Smith, Nick",12,5,5,7,0,1,0,1
Sydney,"Tippett, Kurt",13,10,7,3,5,3,5,0
Sydney,"Bird, Craig",24,9,3,15,0,0,0,1
Sydney,"Cunningham, Harry",11,4,3,7,4,0,0,2
Sydney,"Derickx, Tom",9,6,1,3,0,0,26,2
Sydney,"Franklin, Lance",11,8,1,3,3,2,0,3
Sydney,"Goodes, Adam",13,9,5,4,0,3,0,0
Sydney,"Grundy, Heath",16,9,6,7,0,0,0,0
Sydney,"Hannebery, Dan",30,15,7,15,0,0,0,3
Sydney,"Jack, Kieren",31,18,3,13,0,1,0,4
Sydney,"Jetta, Lewis",18,11,3,7,2,0,0,0
Sydney,"Kennedy, Josh",28,9,3,19,2,0,0,4
Sydney,"Laidler, Jeremy",10,5,4,5,0,0,0,2
Sydney,"Lloyd, Jake",6,4,4,2,1,0,0,0
Sydney,"Malceski, Nick",24,16,3,8,0,0,0,4
Sydney,"McGlynn, Ben",22,10,1,12,0,1,0,9
Sydney,"McVeigh, Jarrad",26,16,4,10,0,0,0,3
Sydney,"Parker, Luke",22,7,7,15,2,0,1,4
Sydney,"Rampe, Dane",18,11,7,7,0,0,0,2
Sydney,"Reid, Sam",11,5,3,6,3,0,2,0
Sydney,"Richards, Ted",14,9,7,5,0,0,0,3
Sydney,"Shaw, Rhyce",24,18,4,6,0,0,0,0
Sydney,"Smith, Nick",10,6,4,4,0,0,0,4
Sydney,"Tippett, Kurt",6,3,3,3,0,0,2,1
Sydney,"Bird, Craig",25,15,3,10,0,0,0,3
Sydney,"Cunningham, Harry",16,6,3,10,0,0,0,2
Sydney,"Derickx, Tom",4,2,0,2,0,0,28,5
Sydney,"Franklin, Lance",23,14,6,9,5,4,0,2
Sydney,"Goodes, Adam",11,4,2,7,3,1,0,3
Sydney,"Grundy, Heath",22,13,4,9,0,0,0,2
Sydney,"Hannebery, Dan",13,3,1,10,1,0,0,5
Sydney,"Jack, Brandon",9,5,2,4,0,0,0,4
Sydney,"Jack, Kieren",26,19,4,7,1,0,0,7
Sydney,"Jetta, Lewis",13,10,3,3,1,1,0,5
Sydney,"Kennedy, Josh",20,8,2,12,1,1,0,8
Sydney,"Laidler, Jeremy",9,5,1,4,0,0,0,2
Sydney,"Lloyd, Jake",22,8,5,14,0,1,0,2
Sydney,"Malceski, Nick",25,17,0,8,0,0,0,5
Sydney,"McVeigh, Jarrad",24,14,3,10,2,0,0,2
Sydney,"Parker, Luke",17,7,4,10,0,1,0,6
Sydney,"Rampe, Dane",14,8,2,6,0,0,0,4
Sydney,"Reid, Sam",13,6,3,7,0,1,1,7
Sydney,"Richards, Ted",13,7,3,6,0,0,0,2
Sydney,"Rohan, Gary",0,0,0,0,0,0,0,0
Sydney,"Shaw, Rhyce",32,15,10,17,0,0,0,1
Sydney,"Smith, Nick",18,10,5,8,0,0,0,4
Sydney,"Bird, Craig",11,6,5,5,0,0,0,6
Sydney,"Cunningham, Harry",22,12,6,10,0,0,0,6
Sydney,"Derickx, Tom",4,2,0,2,0,0,20,2
Sydney,"Franklin, Lance",17,11,4,6,4,0,0,7
Sydney,"Goodes, Adam",16,7,5,9,0,1,0,2
Sydney,"Grundy, Heath",19,8,5,11,0,0,0,1
Sydney,"Jack, Brandon",17,7,5,10,0,1,0,5
Sydney,"Jack, Kieren",18,11,1,7,2,0,0,4
Sydney,"Jetta, Lewis",19,13,2,6,0,0,0,7
Sydney,"Jones, Zak",9,2,1,7,0,0,0,6
Sydney,"Kennedy, Josh",24,6,2,18,0,0,0,12
Sydney,"Laidler, Jeremy",16,6,3,10,0,1,0,1
Sydney,"Lloyd, Jake",11,4,1,7,0,1,0,4
Sydney,"Malceski, Nick",26,15,3,11,0,0,0,5
Sydney,"McVeigh, Jarrad",21,15,2,6,1,0,0,6
Sydney,"Parker, Luke",21,10,2,11,0,1,0,11
Sydney,"Pyke, Mike",5,1,1,4,0,0,18,4
Sydney,"Rampe, Dane",12,9,4,3,0,0,0,3
Sydney,"Reid, Sam",11,5,4,6,2,0,0,3
Sydney,"Richards, Ted",10,9,3,1,0,0,0,2
Sydney,"Shaw, Rhyce",8,5,2,3,0,0,0,0
Sydney,"Smith, Nick",13,5,1,8,0,0,0,2
Sydney,"Bird, Craig",17,10,4,7,1,1,0,5
Sydney,"Cunningham, Harry",17,8,7,9,0,0,0,0
Sydney,"Franklin, Lance",18,15,7,3,5,3,0,4
Sydney,"Goodes, Adam",16,11,4,5,0,1,0,1
Sydney,"Grundy, Heath",21,8,5,13,0,0,0,2
Sydney,"Jack, Brandon",2,0,0,2,0,0,0,2
Sydney,"Jack, Kieren",32,17,3,15,1,1,0,4
Sydney,"Jetta, Lewis",18,12,5,6,1,2,0,2
Sydney,"Jones, Zak",13,6,1,7,1,0,0,1
Sydney,"Kennedy, Josh",29,13,5,16,2,1,0,10
Sydney,"Laidler, Jeremy",19,10,2,9,0,1,0,3
Sydney,"Lloyd, Jake",20,11,3,9,0,2,0,3
Sydney,"Malceski, Nick",27,22,7,5,0,0,0,1
Sydney,"McGlynn, Ben",15,10,5,5,1,0,0,4
Sydney,"McVeigh, Jarrad",18,10,3,8,0,0,0,7
Sydney,"Parker, Luke",30,14,1,16,0,0,1,1
Sydney,"Pyke, Mike",7,2,3,5,0,0,22,3
Sydney,"Rampe, Dane",18,12,3,6,0,0,0,2
Sydney,"Reid, Sam",11,6,4,5,1,0,1,0
Sydney,"Richards, Ted",17,10,3,7,0,0,0,2
Sydney,"Smith, Nick",21,9,5,12,0,0,0,5
Sydney,"Tippett, Kurt",11,6,1,5,2,3,2,0
Sydney,"Bird, Craig",27,13,0,14,0,1,0,8
Sydney,"Cunningham, Harry",11,6,2,5,0,0,0,3
Sydney,"Franklin, Lance",13,8,2,5,1,2,0,8
Sydney,"Goodes, Adam",10,9,4,1,3,0,0,3
Sydney,"Grundy, Heath",13,8,4,5,0,0,0,3
Sydney,"Jack, Brandon",12,5,1,7,0,2,0,7
Sydney,"Jack, Kieren",19,8,2,11,0,0,0,3
Sydney,"Jetta, Lewis",22,14,2,8,0,2,0,5
Sydney,"Jones, Zak",2,1,0,1,0,0,0,0
Sydney,"Kennedy, Josh",25,12,1,13,0,1,0,9
Sydney,"Laidler, Jeremy",17,10,3,7,0,0,0,1
Sydney,"Lloyd, Jake",12,11,3,1,0,1,0,7
Sydney,"Malceski, Nick",23,20,2,3,0,0,0,4
Sydney,"McGlynn, Ben",27,19,3,8,2,3,0,5
Sydney,"McVeigh, Jarrad",27,19,2,8,0,0,0,10
Sydney,"Parker, Luke",33,12,3,21,2,0,4,6
Sydney,"Pyke, Mike",7,4,2,3,0,0,22,3
Sydney,"Rampe, Dane",22,15,5,7,1,0,0,0
Sydney,"Reid, Sam",16,5,3,11,1,0,4,3
Sydney,"Richards, Ted",12,9,4,3,0,0,0,3
Sydney,"Rohan, Gary",8,4,2,4,0,0,0,7
Sydney,"Smith, Nick",19,10,4,9,0,0,0,4
Sydney,"Bird, Craig",19,10,1,9,0,1,0,8
Sydney,"Cunningham, Harry",9,5,3,4,0,0,0,2
Sydney,"Franklin, Lance",18,15,7,3,6,2,0,3
Sydney,"Goodes, Adam",16,10,3,6,2,0,0,2
Sydney,"Grundy, Heath",18,13,6,5,0,0,0,0
Sydney,"Jack, Brandon",5,4,3,1,0,0,0,0
Sydney,"Jack, Kieren",27,16,7,11,0,0,0,7
Sydney,"Jetta, Lewis",13,10,6,3,0,1,0,5
Sydney,"Kennedy, Josh",41,18,2,23,0,2,0,5
Sydney,"Laidler, Jeremy",9,6,5,3,0,0,0,4
Sydney,"Lloyd, Jake",14,5,5,9,1,0,0,2
Sydney,"Malceski, Nick",23,20,6,3,1,0,0,3
Sydney,"McGlynn, Ben",24,16,7,8,0,1,0,6
Sydney,"McVeigh, Jarrad",29,15,8,14,1,0,0,5
Sydney,"Parker, Luke",27,12,3,15,2,2,1,5
Sydney,"Pyke, Mike",9,3,1,6,0,0,53,3
Sydney,"Rampe, Dane",5,4,2,1,0,0,0,5
Sydney,"Reid, Sam",13,7,5,6,4,0,5,4
Sydney,"Richards, Ted",14,9,3,5,0,0,0,2
Sydney,"Rohan, Gary",14,9,4,5,1,2,0,1
Sydney,"Smith, Nick",19,10,4,9,0,0,0,3
Sydney,"Towers, Dean",9,3,1,6,0,1,0,1
Sydney,"Bird, Craig",25,15,3,10,0,0,0,5
Sydney,"Cunningham, Harry",9,4,4,5,0,0,0,0
Sydney,"Franklin, Lance",18,13,7,5,3,5,0,4
Sydney,"Goodes, Adam",16,9,5,7,4,0,0,0
Sydney,"Grundy, Heath",12,9,1,3,0,0,0,2
Sydney,"Jack, Kieren",21,11,2,10,0,1,0,7
Sydney,"Jetta, Lewis",19,17,7,2,0,0,0,5
Sydney,"Kennedy, Josh",25,16,5,9,1,1,1,4
Sydney,"Laidler, Jeremy",11,5,4,6,0,0,0,1
Sydney,"Lloyd, Jake",17,8,4,9,0,0,0,2
Sydney,"Malceski, Nick",17,11,2,6,0,0,0,2
Sydney,"McGlynn, Ben",23,14,7,9,3,1,0,9
Sydney,"McVeigh, Jarrad",20,13,4,7,0,0,0,5
Sydney,"Parker, Luke",15,8,5,7,0,0,3,6
Sydney,"Pyke, Mike",5,2,1,3,0,0,21,4
Sydney,"Rampe, Dane",24,12,9,12,0,0,0,4
Sydney,"Reid, Sam",13,2,0,11,0,0,6,1
Sydney,"Richards, Ted",15,10,8,5,0,0,0,1
Sydney,"Rohan, Gary",9,6,3,3,0,0,0,1
Sydney,"Smith, Nick",15,10,1,5,0,0,0,0
Sydney,"Tippett, Kurt",9,7,6,2,2,2,1,0
Sydney,"Towers, Dean",7,2,2,5,0,0,0,2
Sydney,"Bird, Craig",26,11,5,15,0,0,0,5
Sydney,"Cunningham, Harry",12,7,8,5,0,1,0,6
Sydney,"Goodes, Adam",18,13,10,5,2,1,0,2
Sydney,"Grundy, Heath",22,14,7,8,0,0,0,3
Sydney,"Jack, Kieren",26,14,3,12,0,1,0,4
Sydney,"Jetta, Lewis",24,17,4,7,0,0,0,0
Sydney,"Kennedy, Josh",28,14,3,14,1,0,0,2
Sydney,"Lloyd, Jake",8,4,1,4,0,0,0,1
Sydney,"Malceski, Nick",27,20,7,7,0,1,0,3
Sydney,"McGlynn, Ben",25,16,5,9,2,1,0,4
Sydney,"McVeigh, Jarrad",24,15,2,9,1,0,0,7
Sydney,"Membrey, Tim",9,5,4,4,0,0,0,1
Sydney,"Parker, Luke",35,16,3,19,0,2,0,5
Sydney,"Pyke, Mike",12,3,4,9,1,0,49,6
Sydney,"Rampe, Dane",17,7,6,10,0,0,0,6
Sydney,"Reid, Sam",9,3,3,6,1,0,2,2
Sydney,"Richards, Ted",16,12,6,4,0,0,0,0
Sydney,"Rohan, Gary",15,6,3,9,1,1,0,3
Sydney,"Shaw, Rhyce",18,12,7,6,0,0,0,1
Sydney,"Smith, Nick",16,8,3,8,0,0,0,1
Sydney,"Tippett, Kurt",8,5,2,3,2,1,3,0
Sydney,"Towers, Dean",9,4,2,5,0,0,0,5
Sydney,"Bird, Craig",24,10,3,14,0,0,0,10
Sydney,"Cunningham, Harry",19,10,4,9,3,0,0,3
Sydney,"Franklin, Lance",15,10,7,5,2,1,0,2
Sydney,"Goodes, Adam",14,12,1,2,0,1,0,0
Sydney,"Grundy, Heath",12,6,1,6,0,0,0,1
Sydney,"Hannebery, Dan",13,4,1,9,0,0,0,5
Sydney,"Jack, Kieren",24,12,0,12,0,0,0,8
Sydney,"Jetta, Lewis",20,16,4,4,0,2,0,4
Sydney,"Kennedy, Josh",34,15,6,19,0,1,0,2
Sydney,"Laidler, Jeremy",18,6,4,12,0,0,0,2
Sydney,"Lloyd, Jake",8,7,3,1,1,0,0,0
Sydney,"Malceski, Nick",23,20,2,3,0,0,0,5
Sydney,"McGlynn, Ben",21,15,5,6,3,2,0,6
Sydney,"McVeigh, Jarrad",25,12,4,13,0,0,0,5
Sydney,"Parker, Luke",27,14,6,13,0,0,0,6
Sydney,"Pyke, Mike",5,2,0,3,0,0,27,2
Sydney,"Rampe, Dane",12,7,2,5,0,0,0,3
Sydney,"Reid, Sam",6,3,3,3,0,0,4,1
Sydney,"Richards, Ted",14,6,2,8,0,0,0,1
Sydney,"Rohan, Gary",13,8,3,5,1,0,0,0
Sydney,"Shaw, Rhyce",19,13,5,6,0,0,0,2
Sydney,"Tippett, Kurt",7,5,2,2,2,1,1,0
Sydney,"Biggs, Shane",24,14,3,10,0,0,0,6
Sydney,"Bird, Craig",15,5,1,10,0,1,0,1
Sydney,"Cunningham, Harry",9,5,3,4,1,0,0,4
Sydney,"Franklin, Lance",19,19,13,0,9,4,0,2
Sydney,"Goodes, Adam",12,7,4,5,0,0,0,2
Sydney,"Grundy, Heath",23,9,4,14,0,0,0,1
Sydney,"Hannebery, Dan",26,10,2,16,0,0,0,2
Sydney,"Jack, Kieren",25,11,4,14,0,1,0,5
Sydney,"Jetta, Lewis",11,8,3,3,1,1,0,4
Sydney,"Kennedy, Josh",8,3,0,5,0,0,0,0
Sydney,"Laidler, Jeremy",23,10,7,13,0,0,0,1
Sydney,"Lloyd, Jake",21,15,10,6,1,0,0,7
Sydney,"Malceski, Nick",19,15,2,4,1,0,0,0
Sydney,"McVeigh, Jarrad",28,20,10,8,1,0,0,4
Sydney,"Parker, Luke",33,9,5,24,1,0,0,6
Sydney,"Pyke, Mike",14,8,3,6,0,1,32,1
Sydney,"Rampe, Dane",21,10,2,11,0,0,0,1
Sydney,"Reid, Sam",5,1,1,4,0,0,2,0
Sydney,"Richards, Ted",21,6,6,15,0,0,0,0
Sydney,"Rohan, Gary",19,12,6,7,0,1,0,3
Sydney,"Tippett, Kurt",16,8,4,8,3,1,5,0
Sydney,"Towers, Dean",10,5,2,5,1,1,0,0
Sydney,"Biggs, Shane",17,10,4,7,0,0,0,3
Sydney,"Cunningham, Harry",15,9,8,6,0,0,0,3
Sydney,"Franklin, Lance",18,13,9,5,6,2,0,1
Sydney,"Goodes, Adam",14,10,6,4,2,0,1,0
Sydney,"Grundy, Heath",17,9,4,8,0,0,0,3
Sydney,"Hannebery, Dan",29,13,6,16,1,0,0,6
Sydney,"Jack, Kieren",25,14,5,11,0,0,0,4
Sydney,"Jetta, Lewis",16,9,4,7,1,0,0,4
Sydney,"Laidler, Jeremy",5,1,0,4,0,0,0,1
Sydney,"Lloyd, Jake",21,8,5,13,2,0,0,1
Sydney,"Malceski, Nick",23,21,6,2,2,1,0,4
Sydney,"McVeigh, Jarrad",33,15,2,18,0,2,0,6
Sydney,"Mitchell, Tom",23,8,3,15,0,1,0,6
Sydney,"Parker, Luke",32,9,3,23,1,1,0,11
Sydney,"Pyke, Mike",12,5,3,7,0,0,44,1
Sydney,"Rampe, Dane",17,12,5,5,0,0,0,5
Sydney,"Richards, Ted",12,7,6,5,0,1,0,1
Sydney,"Rohan, Gary",9,7,3,2,0,0,0,6
Sydney,"Shaw, Rhyce",11,3,0,8,0,0,0,0
Sydney,"Smith, Nick",19,10,5,9,0,0,0,4
Sydney,"Tippett, Kurt",10,8,4,2,4,1,8,1
Sydney,"Towers, Dean",13,5,3,8,1,0,1,4
Sydney,"Biggs, Shane",10,7,2,3,0,0,0,3
Sydney,"Cunningham, Harry",17,8,6,9,0,0,0,3
Sydney,"Goodes, Adam",15,12,5,3,1,0,0,2
Sydney,"Grundy, Heath",23,16,5,7,0,0,0,2
Sydney,"Hannebery, Dan",33,16,5,17,1,1,0,10
Sydney,"Jack, Kieren",25,18,4,7,0,0,0,10
Sydney,"Jetta, Lewis",21,12,3,9,0,0,0,3
Sydney,"Jones, Zak",5,2,1,3,0,0,0,0
Sydney,"Lloyd, Jake",20,12,10,8,0,0,0,0
Sydney,"Malceski, Nick",29,20,6,9,0,0,0,4
Sydney,"McVeigh, Jarrad",20,11,0,9,1,1,0,7
Sydney,"Mitchell, Tom",29,10,8,19,0,0,0,13
Sydney,"Naismith, Sam",6,0,1,6,0,0,16,3
Sydney,"Parker, Luke",28,11,4,17,1,1,1,9
Sydney,"Rampe, Dane",13,7,0,6,0,0,0,2
Sydney,"Reid, Sam",12,6,5,6,2,2,6,0
Sydney,"Richards, Ted",16,6,7,10,0,0,1,4
Sydney,"Rohan, Gary",17,8,3,9,1,0,0,1
Sydney,"Shaw, Rhyce",21,18,2,3,0,0,0,5
Sydney,"Smith, Nick",11,5,2,6,0,0,0,3
Sydney,"Tippett, Kurt",6,2,2,4,1,1,16,3
Sydney,"Towers, Dean",11,7,2,4,1,2,2,1
Sydney,"Bird, Craig",13,4,1,9,0,0,0,5
Sydney,"Cunningham, Harry",13,7,3,6,0,0,0,5
Sydney,"Franklin, Lance",18,12,7,6,3,3,0,3
Sydney,"Goodes, Adam",11,7,1,4,1,1,0,2
Sydney,"Grundy, Heath",19,12,7,7,0,0,0,2
Sydney,"Hannebery, Dan",27,13,4,14,1,1,0,6
Sydney,"Jack, Kieren",21,12,5,9,1,2,0,9
Sydney,"Jetta, Lewis",25,17,4,8,1,2,0,4
Sydney,"Kennedy, Josh",22,6,5,16,0,0,0,7
Sydney,"Lloyd, Jake",24,13,7,11,0,0,0,4
Sydney,"Malceski, Nick",3,2,0,1,0,1,0,0
Sydney,"McGlynn, Ben",19,13,2,6,3,0,0,3
Sydney,"McVeigh, Jarrad",19,12,4,7,0,0,0,3
Sydney,"Parker, Luke",32,15,3,17,1,1,2,6
Sydney,"Pyke, Mike",14,6,2,8,1,1,22,3
Sydney,"Rampe, Dane",13,8,1,5,0,0,0,3
Sydney,"Reid, Sam",8,5,3,3,0,0,0,2
Sydney,"Richards, Ted",18,9,5,9,0,0,0,2
Sydney,"Rohan, Gary",13,9,0,4,0,0,0,1
Sydney,"Shaw, Rhyce",23,13,3,10,0,0,0,1
Sydney,"Smith, Nick",25,10,4,15,0,0,0,0
Sydney,"Tippett, Kurt",13,5,4,8,1,1,8,0
Sydney,"Bird, Craig",9,4,2,5,1,0,0,1
Sydney,"Cunningham, Harry",14,7,4,7,0,2,0,4
Sydney,"Franklin, Lance",23,18,11,5,5,2,0,3
Sydney,"Goodes, Adam",17,10,5,7,3,1,0,2
Sydney,"Grundy, Heath",9,4,4,5,0,0,0,2
Sydney,"Hannebery, Dan",22,8,3,14,0,1,0,4
Sydney,"Jack, Kieren",23,13,3,10,1,0,0,4
Sydney,"Jetta, Lewis",11,9,5,2,1,0,0,3
Sydney,"Kennedy, Josh",27,12,2,15,0,2,0,7
Sydney,"Lloyd, Jake",14,6,4,8,0,0,0,3
Sydney,"Malceski, Nick",18,16,3,2,0,0,0,2
Sydney,"McGlynn, Ben",19,12,3,7,1,0,0,4
Sydney,"McVeigh, Jarrad",14,11,4,3,0,0,0,3
Sydney,"Parker, Luke",26,9,8,17,3,1,2,8
Sydney,"Pyke, Mike",10,5,1,5,0,0,30,1
Sydney,"Rampe, Dane",11,7,1,4,0,0,0,2
Sydney,"Reid, Sam",8,3,5,5,0,2,0,1
Sydney,"Richards, Ted",10,4,3,6,0,0,0,1
Sydney,"Rohan, Gary",23,12,5,11,0,0,0,0
Sydney,"Shaw, Rhyce",20,14,0,6,0,0,0,2
Sydney,"Smith, Nick",13,8,2,5,0,0,0,2
Sydney,"Tippett, Kurt",15,10,9,5,4,2,12,2
Sydney,"Bird, Craig",8,5,1,3,0,0,0,3
Sydney,"Cunningham, Harry",9,3,2,6,0,0,0,5
Sydney,"Franklin, Lance",14,11,5,3,4,2,1,1
Sydney,"Goodes, Adam",13,8,7,5,2,1,0,4
Sydney,"Grundy, Heath",11,8,5,3,0,0,1,1
Sydney,"Hannebery, Dan",20,12,4,8,0,1,0,5
Sydney,"Jack, Kieren",18,5,2,13,2,0,0,4
Sydney,"Jetta, Lewis",4,4,1,0,0,0,0,0
Sydney,"Kennedy, Josh",29,11,5,18,1,0,0,4
Sydney,"Lloyd, Jake",11,6,2,5,0,0,0,4
Sydney,"Malceski, Nick",26,19,5,7,0,0,0,2
Sydney,"McGlynn, Ben",11,7,1,4,1,0,0,5
Sydney,"McVeigh, Jarrad",11,8,5,3,0,0,0,1
Sydney,"Parker, Luke",20,7,1,13,0,0,2,3
Sydney,"Pyke, Mike",9,4,2,5,0,0,32,0
Sydney,"Rampe, Dane",8,5,1,3,0,0,0,5
Sydney,"Reid, Sam",8,3,2,5,0,0,1,2
Sydney,"Richards, Ted",11,6,4,5,0,0,0,1
Sydney,"Rohan, Gary",7,4,3,3,0,1,0,1
Sydney,"Shaw, Rhyce",25,17,2,8,0,0,0,0
Sydney,"Smith, Nick",9,5,2,4,0,0,0,4
Sydney,"Tippett, Kurt",16,9,5,7,1,1,6,2
West Coast,"Bennell, Jamie",16,5,1,11,0,0,0,2
West Coast,"Brown, Mitch",8,3,0,5,0,0,0,3
West Coast,"Cox, Dean",23,12,5,11,0,2,26,2
West Coast,"Cripps, Jamie",13,12,5,1,2,1,0,0
West Coast,"Darling, Jack",16,9,3,7,4,0,0,5
West Coast,"Ellis, Xavier",15,10,2,5,0,0,2,2
West Coast,"Gaff, Andrew",23,12,8,11,1,0,0,4
West Coast,"Glass, Darren",15,5,4,10,0,0,0,5
West Coast,"Hurn, Shannon",20,14,3,6,0,0,0,1
West Coast,"Kennedy, Josh",6,3,2,3,2,0,0,6
West Coast,"LeCras, Mark",27,15,10,12,5,1,0,3
West Coast,"Mackenzie, Eric",22,13,11,9,0,0,1,1
West Coast,"Masten, Chris",20,9,1,11,1,0,0,3
West Coast,"Naitanui, Nic",8,4,4,4,0,0,12,2
West Coast,"Priddis, Matt",28,14,5,14,1,0,0,5
West Coast,"Rosa, Matt",34,18,8,16,1,0,0,2
West Coast,"Selwood, Scott",29,15,6,14,1,1,0,5
West Coast,"Sheed, Dom",3,1,0,2,0,0,0,1
West Coast,"Shuey, Luke",14,6,0,8,2,0,0,3
West Coast,"Sinclair, Callum",12,9,3,3,0,1,12,4
West Coast,"Wellingham, Sharrod",23,13,5,10,1,1,0,1
West Coast,"Yeo, Elliot",13,6,4,7,0,0,0,10
West Coast,"Bennell, Jamie",10,7,6,3,0,0,0,1
West Coast,"Brown, Mitch",15,8,4,7,0,0,0,1
West Coast,"Cox, Dean",8,4,2,4,0,1,21,1
West Coast,"Cripps, Jamie",15,10,4,5,1,2,0,6
West Coast,"Darling, Jack",14,9,8,5,3,1,0,1
West Coast,"Ellis, Xavier",26,14,5,12,0,0,0,2
West Coast,"Gaff, Andrew",31,17,8,14,0,0,0,2
West Coast,"Glass, Darren",8,3,3,5,0,0,0,5
West Coast,"Hurn, Shannon",1,0,1,1,0,0,0,0
West Coast,"Kennedy, Josh",15,10,6,5,4,1,0,6
West Coast,"LeCras, Mark",19,11,4,8,2,0,0,4
West Coast,"Mackenzie, Eric",13,10,5,3,1,0,0,1
West Coast,"Masten, Chris",25,13,5,12,2,0,0,5
West Coast,"Naitanui, Nic",16,6,2,10,1,0,13,0
West Coast,"Priddis, Matt",24,15,1,9,0,0,0,9
West Coast,"Rosa, Matt",31,19,6,12,1,0,0,0
West Coast,"Selwood, Scott",21,9,1,12,0,0,0,2
West Coast,"Sheppard, Brad",17,10,3,7,0,0,0,1
West Coast,"Shuey, Luke",30,14,9,16,2,1,0,2
West Coast,"Sinclair, Callum",12,8,3,4,1,2,11,1
West Coast,"Wellingham, Sharrod",21,11,3,10,0,1,0,2
West Coast,"Yeo, Elliot",14,8,5,6,0,0,1,4
West Coast,"Bennell, Jamie",14,7,5,7,0,0,0,0
West Coast,"Brown, Mitch",10,5,2,5,1,0,0,3
West Coast,"Colledge, Brant",8,4,1,4,0,1,0,4
West Coast,"Cox, Dean",15,10,6,5,1,0,34,4
West Coast,"Cripps, Jamie",11,6,2,5,2,0,0,5
West Coast,"Darling, Jack",17,15,6,2,1,4,0,6
West Coast,"Ellis, Xavier",15,10,4,5,2,0,0,3
West Coast,"Gaff, Andrew",25,14,10,11,0,0,0,2
West Coast,"Glass, Darren",20,9,7,11,0,0,0,1
West Coast,"Kennedy, Josh",8,8,8,0,2,3,0,3
West Coast,"LeCras, Mark",3,2,0,1,0,0,0,2
West Coast,"Mackenzie, Eric",13,9,5,4,0,0,0,0
West Coast,"Masten, Chris",14,9,6,5,0,0,0,5
West Coast,"Naitanui, Nic",10,5,0,5,0,1,13,3
West Coast,"Priddis, Matt",28,14,2,14,1,0,0,5
West Coast,"Rosa, Matt",20,10,4,10,0,0,0,4
West Coast,"Schofield, Will",10,8,6,2,0,0,0,0
West Coast,"Selwood, Scott",23,10,2,13,0,0,0,9
West Coast,"Sheppard, Brad",21,16,6,5,0,0,0,0
West Coast,"Shuey, Luke",20,11,3,9,1,2,1,4
West Coast,"Sinclair, Callum",10,5,1,5,1,0,12,0
West Coast,"Yeo, Elliot",13,8,5,5,0,0,0,4
West Coast,"Bennell, Jamie",15,8,3,7,0,0,0,3
West Coast,"Brown, Mitch",13,8,4,5,0,0,0,1
West Coast,"Butler, Sam",13,4,1,9,0,0,0,2
West Coast,"Colledge, Brant",11,7,1,4,0,0,0,4
West Coast,"Cox, Dean",16,13,3,3,0,1,16,1
West Coast,"Cripps, Jamie",12,8,2,4,1,0,0,1
West Coast,"Darling, Jack",13,8,3,5,1,2,0,3
West Coast,"Ellis, Xavier",19,11,4,8,0,0,0,0
West Coast,"Gaff, Andrew",24,13,7,11,0,0,0,2
West Coast,"Hill, Josh",11,9,4,2,1,2,0,2
West Coast,"Kennedy, Josh",8,4,3,4,1,0,0,4
West Coast,"Lycett, Scott",11,1,2,10,0,0,11,5
West Coast,"Mackenzie, Eric",11,8,6,3,0,0,0,1
West Coast,"McGinnity, Patrick",5,4,0,1,0,0,0,1
West Coast,"Naitanui, Nic",6,2,0,4,0,1,6,0
West Coast,"Priddis, Matt",21,8,0,13,0,0,0,5
West Coast,"Schofield, Will",12,9,3,3,0,0,0,2
West Coast,"Selwood, Scott",23,9,1,14,0,0,0,2
West Coast,"Sheed, Dom",18,9,2,9,0,0,0,1
West Coast,"Sheppard, Brad",15,10,2,5,0,0,0,1
West Coast,"Wellingham, Sharrod",22,16,3,6,0,0,0,3
West Coast,"Yeo, Elliot",15,7,4,8,0,1,0,3
West Coast,"Bennell, Jamie",23,12,4,11,0,0,0,1
West Coast,"Brown, Mitch",12,6,0,6,0,1,0,1
West Coast,"Cox, Dean",16,7,6,9,1,0,19,4
West Coast,"Cripps, Jamie",8,3,1,5,1,0,0,2
West Coast,"Darling, Jack",19,14,8,5,2,3,0,3
West Coast,"Ellis, Xavier",1,0,0,1,0,0,0,0
West Coast,"Gaff, Andrew",24,17,6,7,0,0,0,2
West Coast,"Glass, Darren",13,5,5,8,0,0,0,3
West Coast,"Hill, Josh",9,5,0,4,0,0,0,4
West Coast,"Hutchings, Mark",17,13,2,4,0,1,0,5
West Coast,"Kennedy, Josh",14,12,4,2,1,5,0,2
West Coast,"Mackenzie, Eric",21,16,8,5,0,0,0,3
West Coast,"Masten, Chris",30,14,6,16,1,0,0,8
West Coast,"Naitanui, Nic",16,5,0,11,0,0,17,6
West Coast,"Priddis, Matt",33,11,3,22,0,1,0,6
West Coast,"Rosa, Matt",30,10,5,20,0,0,1,2
West Coast,"Selwood, Scott",16,5,0,11,0,0,0,5
West Coast,"Sheed, Dom",11,6,5,5,0,0,0,7
West Coast,"Sheppard, Brad",14,8,4,6,0,0,0,2
West Coast,"Shuey, Luke",28,12,0,16,0,1,0,5
West Coast,"Wellingham, Sharrod",13,9,2,4,1,0,0,4
West Coast,"Yeo, Elliot",12,8,4,4,0,0,0,2
West Coast,"Bennell, Jamie",11,9,2,2,1,0,0,1
West Coast,"Brown, Mitch",16,9,5,7,0,0,0,0
West Coast,"Cox, Dean",18,8,6,10,0,0,29,1
West Coast,"Cripps, Jamie",15,10,5,5,2,3,0,1
West Coast,"Darling, Jack",12,6,3,6,0,1,0,3
West Coast,"Gaff, Andrew",20,13,4,7,0,0,0,2
West Coast,"Hutchings, Mark",15,7,1,8,1,2,0,4
West Coast,"Kennedy, Josh",9,8,4,1,2,2,0,2
West Coast,"Lycett, Scott",8,3,3,5,1,1,1,2
West Coast,"Mackenzie, Eric",18,12,7,6,0,0,0,1
West Coast,"Masten, Chris",27,13,7,14,0,0,0,4
West Coast,"McGovern, Jeremy",8,6,4,2,1,0,1,2
West Coast,"Naitanui, Nic",10,2,1,8,0,0,24,3
West Coast,"Priddis, Matt",35,17,4,18,0,1,0,4
West Coast,"Rosa, Matt",21,10,4,11,0,2,0,1
West Coast,"Schofield, Will",13,6,1,7,0,0,0,2
West Coast,"Selwood, Scott",25,12,3,13,0,1,0,3
West Coast,"Sheed, Dom",7,3,2,4,1,0,0,0
West Coast,"Sheppard, Brad",19,15,6,4,0,0,0,1
West Coast,"Shuey, Luke",28,16,3,12,2,1,0,3
West Coast,"Wellingham, Sharrod",13,6,2,7,0,0,0,1
West Coast,"Yeo, Elliot",15,11,2,4,1,1,0,5
West Coast,"Bennell, Jamie",10,5,3,5,0,0,0,2
West Coast,"Brown, Mitch",10,4,2,6,0,0,0,3
West Coast,"Cox, Dean",12,5,3,7,0,0,13,4
West Coast,"Cripps, Jamie",11,7,4,4,2,2,0,5
West Coast,"Darling, Jack",14,11,7,3,2,1,0,2
West Coast,"Gaff, Andrew",18,11,0,7,0,0,0,3
West Coast,"Glass, Darren",8,2,4,6,0,0,0,2
West Coast,"Hurn, Shannon",21,16,7,5,0,0,0,4
West Coast,"Hutchings, Mark",24,15,4,9,0,2,0,5
West Coast,"Kennedy, Josh",11,8,6,3,1,1,0,2
West Coast,"Lycett, Scott",5,2,2,3,0,0,1,0
West Coast,"Mackenzie, Eric",11,8,6,3,0,0,0,2
West Coast,"Masten, Chris",12,5,2,7,0,0,0,6
West Coast,"Naitanui, Nic",9,2,2,7,0,1,13,4
West Coast,"Priddis, Matt",24,7,4,17,0,0,0,8
West Coast,"Rosa, Matt",21,13,3,8,1,1,0,7
West Coast,"Schofield, Will",8,2,3,6,0,0,0,1
West Coast,"Selwood, Scott",19,11,3,8,0,1,0,7
West Coast,"Sheppard, Brad",22,15,4,7,0,1,0,2
West Coast,"Shuey, Luke",18,6,5,12,0,1,0,4
West Coast,"Tunbridge, Simon",6,6,4,0,1,1,0,4
West Coast,"Yeo, Elliot",13,7,2,6,0,0,0,3
West Coast,"Bennell, Jamie",16,8,6,8,0,0,0,2
West Coast,"Brown, Mitch",16,10,6,6,0,0,0,5
West Coast,"Cox, Dean",18,11,7,7,2,0,30,3
West Coast,"Cripps, Jamie",11,7,2,4,2,1,0,1
West Coast,"Darling, Jack",16,10,5,6,3,1,0,4
West Coast,"Ellis, Xavier",7,4,2,3,0,1,0,1
West Coast,"Gaff, Andrew",15,11,5,4,1,0,0,0
West Coast,"Glass, Darren",11,8,5,3,0,0,0,0
West Coast,"Hurn, Shannon",27,20,12,7,0,0,0,3
West Coast,"Hutchings, Mark",13,6,1,7,2,0,0,6
West Coast,"Kennedy, Josh",17,14,11,3,11,0,0,3
West Coast,"LeCras, Mark",22,11,7,11,4,1,0,3
West Coast,"Mackenzie, Eric",10,8,8,2,0,0,0,0
West Coast,"Masten, Chris",26,18,6,8,0,1,0,1
West Coast,"Naitanui, Nic",12,3,0,9,1,0,20,4
West Coast,"Priddis, Matt",26,6,1,20,1,0,1,7
West Coast,"Rosa, Matt",25,15,11,10,0,0,0,1
West Coast,"Selwood, Scott",24,15,7,9,1,0,0,10
West Coast,"Sheppard, Brad",18,13,8,5,0,0,0,3
West Coast,"Shuey, Luke",23,14,5,9,1,0,0,1
West Coast,"Wellingham, Sharrod",18,12,4,6,1,0,0,3
West Coast,"Yeo, Elliot",23,9,4,14,0,0,0,3
West Coast,"Bennell, Jamie",15,10,6,5,0,0,0,1
West Coast,"Brown, Mitch",6,2,3,4,0,0,0,1
West Coast,"Cox, Dean",17,10,9,7,2,1,23,3
West Coast,"Cripps, Jamie",11,10,4,1,3,1,0,4
West Coast,"Darling, Jack",18,9,4,9,1,1,0,6
West Coast,"Ellis, Xavier",24,17,4,7,0,0,1,3
West Coast,"Gaff, Andrew",26,17,9,9,0,0,0,2
West Coast,"Glass, Darren",22,13,7,9,0,0,0,3
West Coast,"Hill, Josh",9,9,5,0,2,0,0,5
West Coast,"Hurn, Shannon",18,16,4,2,2,0,0,1
West Coast,"Hutchings, Mark",6,2,1,4,0,0,0,1
West Coast,"Kennedy, Josh",8,6,4,2,1,3,0,3
West Coast,"Mackenzie, Eric",13,11,8,2,0,0,0,0
West Coast,"Masten, Chris",25,13,6,12,0,0,0,4
West Coast,"Naitanui, Nic",17,5,0,12,0,0,24,3
West Coast,"Priddis, Matt",35,15,3,20,2,1,0,8
West Coast,"Rosa, Matt",22,14,7,8,0,0,0,3
West Coast,"Selwood, Scott",26,15,7,11,0,0,0,5
West Coast,"Sheppard, Brad",17,13,4,4,0,0,0,2
West Coast,"Shuey, Luke",15,8,6,7,0,1,0,5
West Coast,"Wellingham, Sharrod",21,10,3,11,1,1,0,6
West Coast,"Yeo, Elliot",19,11,7,8,1,1,0,2
West Coast,"Bennell, Jamie",16,10,3,6,0,0,0,5
West Coast,"Brown, Mitch",6,2,2,4,0,0,0,5
West Coast,"Cox, Dean",11,8,6,3,0,0,25,2
West Coast,"Cripps, Jamie",11,8,2,3,1,2,0,12
West Coast,"Darling, Jack",14,7,6,7,0,1,0,10
West Coast,"Ellis, Xavier",13,10,4,3,0,0,0,1
West Coast,"Gaff, Andrew",27,14,7,13,0,0,0,2
West Coast,"Hill, Josh",1,1,1,0,0,0,0,1
West Coast,"Hurn, Shannon",23,17,12,6,0,1,0,2
West Coast,"Kennedy, Josh",8,7,6,1,0,1,0,2
West Coast,"LeCras, Mark",20,12,6,8,2,2,0,12
West Coast,"Mackenzie, Eric",16,12,7,4,0,0,0,5
West Coast,"Masten, Chris",23,15,7,8,0,0,0,1
West Coast,"Naitanui, Nic",14,6,4,8,1,0,18,8
West Coast,"Priddis, Matt",32,15,5,17,2,0,0,9
West Coast,"Rosa, Matt",25,14,5,11,0,0,0,3
West Coast,"Schofield, Will",13,8,7,5,0,0,0,1
West Coast,"Selwood, Scott",12,7,4,5,0,0,0,1
West Coast,"Sheppard, Brad",17,13,4,4,0,0,0,2
West Coast,"Shuey, Luke",18,6,1,12,0,0,0,4
West Coast,"Wellingham, Sharrod",14,8,5,6,0,0,2,4
West Coast,"Yeo, Elliot",21,16,7,5,0,0,0,1
West Coast,"Bennell, Jamie",11,5,2,6,0,0,0,2
West Coast,"Brown, Mitch",8,2,0,6,0,0,0,5
West Coast,"Cox, Dean",11,5,3,6,0,0,26,2
West Coast,"Cripps, Jamie",3,2,2,1,0,0,0,2
West Coast,"Darling, Jack",11,10,2,1,1,0,0,5
West Coast,"Ellis, Xavier",8,5,1,3,2,0,2,7
West Coast,"Gaff, Andrew",26,23,8,3,3,0,0,5
West Coast,"Glass, Darren",10,3,2,7,0,0,0,0
West Coast,"Hurn, Shannon",18,13,3,5,1,0,0,1
West Coast,"Hutchings, Mark",28,18,9,10,0,0,0,5
West Coast,"LeCras, Mark",17,10,3,7,1,1,0,4
West Coast,"Mackenzie, Eric",11,8,6,3,0,0,0,2
West Coast,"Masten, Chris",19,10,2,9,1,0,0,1
West Coast,"McGovern, Jeremy",15,12,10,3,2,0,0,1
West Coast,"Naitanui, Nic",14,5,3,9,1,0,29,3
West Coast,"Priddis, Matt",27,12,2,15,0,0,0,8
West Coast,"Rosa, Matt",14,4,1,10,0,0,0,5
West Coast,"Schofield, Will",10,8,4,2,0,0,0,2
West Coast,"Selwood, Scott",19,7,4,12,0,1,0,7
West Coast,"Shuey, Luke",29,13,5,16,0,1,0,5
West Coast,"Wellingham, Sharrod",6,3,2,3,0,0,0,3
West Coast,"Yeo, Elliot",23,11,8,12,0,0,0,5
West Coast,"Bennell, Jamie",11,11,8,0,0,0,0,1
West Coast,"Brown, Mitch",5,3,1,2,0,0,0,1
West Coast,"Butler, Sam",4,3,1,1,0,0,0,3
West Coast,"Cripps, Jamie",5,5,0,0,1,0,0,2
West Coast,"Darling, Jack",11,7,4,4,0,2,0,6
West Coast,"Ellis, Xavier",17,13,7,4,0,0,0,3
West Coast,"Gaff, Andrew",19,17,5,2,0,0,0,3
West Coast,"Hurn, Shannon",26,19,12,7,0,0,0,1
West Coast,"Hutchings, Mark",22,16,4,6,1,0,0,2
West Coast,"Kennedy, Josh",15,12,9,3,7,0,0,1
West Coast,"LeCras, Mark",14,8,5,6,1,0,0,1
West Coast,"Lycett, Scott",16,9,6,7,1,1,18,1
West Coast,"Mackenzie, Eric",23,18,14,5,0,0,0,4
West Coast,"Masten, Chris",15,13,7,2,0,0,0,5
West Coast,"McGovern, Jeremy",14,11,10,3,3,3,1,1
West Coast,"Naitanui, Nic",22,7,2,15,0,0,34,6
West Coast,"Priddis, Matt",32,9,2,23,0,0,0,7
West Coast,"Rosa, Matt",24,9,8,15,0,0,0,2
West Coast,"Schofield, Will",12,7,2,5,0,0,0,1
West Coast,"Sheppard, Brad",16,10,3,6,0,0,0,5
West Coast,"Wellingham, Sharrod",26,13,4,13,1,0,0,5
West Coast,"Yeo, Elliot",6,5,1,1,0,0,0,2
West Coast,"Bennell, Jamie",3,1,1,2,0,0,0,0
West Coast,"Brown, Mitch",14,6,4,8,1,0,0,1
West Coast,"Butler, Sam",14,5,0,9,0,0,0,5
West Coast,"Cripps, Jamie",12,7,1,5,0,0,0,7
West Coast,"Darling, Jack",14,11,9,3,3,1,0,2
West Coast,"Ellis, Xavier",14,9,3,5,0,0,0,1
West Coast,"Gaff, Andrew",24,16,5,8,1,1,0,0
West Coast,"Hurn, Shannon",15,10,4,5,0,0,0,1
West Coast,"Hutchings, Mark",23,12,6,11,1,0,2,6
West Coast,"Kennedy, Josh",14,9,7,5,1,4,0,3
West Coast,"LeCras, Mark",25,18,4,7,1,3,0,5
West Coast,"Lycett, Scott",12,8,4,4,2,1,17,3
West Coast,"Mackenzie, Eric",14,5,3,9,0,0,0,1
West Coast,"Masten, Chris",20,12,3,8,0,0,0,2
West Coast,"McGovern, Jeremy",6,6,4,0,3,0,0,2
West Coast,"Naitanui, Nic",12,4,1,8,0,0,24,2
West Coast,"Priddis, Matt",30,9,3,21,1,0,0,4
West Coast,"Rosa, Matt",37,18,4,19,0,0,0,1
West Coast,"Schofield, Will",7,5,3,2,0,0,0,1
West Coast,"Sheppard, Brad",18,6,1,12,0,0,0,2
West Coast,"Shuey, Luke",22,11,4,11,1,0,0,1
West Coast,"Wellingham, Sharrod",16,10,6,6,0,0,0,3
West Coast,"Bennell, Jamie",9,4,3,5,0,0,0,1
West Coast,"Brown, Mitch",3,2,2,1,0,0,0,1
West Coast,"Butler, Sam",8,3,2,5,0,0,0,1
West Coast,"Cox, Dean",15,9,5,6,0,0,15,3
West Coast,"Darling, Jack",12,9,2,3,1,1,0,0
West Coast,"Ellis, Xavier",21,15,7,6,1,0,0,1
West Coast,"Gaff, Andrew",20,13,3,7,0,1,0,3
West Coast,"Hurn, Shannon",21,16,5,5,0,0,0,0
West Coast,"Hutchings, Mark",16,10,3,6,1,0,0,3
West Coast,"Kennedy, Josh",12,9,7,3,2,2,0,1
West Coast,"LeCras, Mark",22,16,6,6,2,2,0,5
West Coast,"Mackenzie, Eric",22,14,11,8,0,0,0,5
West Coast,"Masten, Chris",20,11,5,9,0,0,0,3
West Coast,"McGinnity, Patrick",15,11,4,4,1,1,0,4
West Coast,"McGovern, Jeremy",12,9,8,3,2,3,0,1
West Coast,"Naitanui, Nic",9,0,0,9,0,0,15,7
West Coast,"Priddis, Matt",24,15,3,9,0,0,0,9
West Coast,"Rosa, Matt",22,14,8,8,0,0,0,5
West Coast,"Schofield, Will",15,12,9,3,0,0,0,0
West Coast,"Sheppard, Brad",8,7,3,1,0,0,0,2
West Coast,"Shuey, Luke",21,8,3,13,1,1,0,2
West Coast,"Wellingham, Sharrod",17,6,2,11,0,0,0,3
West Coast,"Brennan, Jacob",10,8,3,2,0,0,0,6
West Coast,"Butler, Sam",9,4,1,5,0,0,0,4
West Coast,"Cox, Dean",13,9,3,4,0,1,34,3
West Coast,"Cripps, Jamie",11,5,2,6,1,0,0,4
West Coast,"Darling, Jack",17,10,1,7,1,1,1,9
West Coast,"Ellis, Xavier",21,16,5,5,0,0,2,6
West Coast,"Gaff, Andrew",25,17,7,8,0,0,0,3
West Coast,"Hurn, Shannon",15,14,4,1,0,0,0,3
West Coast,"Hutchings, Mark",21,13,3,8,0,1,0,6
West Coast,"Kennedy, Josh",11,5,1,6,2,1,0,5
West Coast,"LeCras, Mark",13,8,2,5,0,0,0,4
West Coast,"Lycett, Scott",11,8,3,3,1,0,32,4
West Coast,"Mackenzie, Eric",13,6,4,7,0,0,0,0
West Coast,"Masten, Chris",20,12,1,8,0,0,0,3
West Coast,"McGinnity, Patrick",13,7,1,6,0,2,0,7
West Coast,"McGovern, Jeremy",3,1,1,2,0,0,0,2
West Coast,"Priddis, Matt",28,16,2,12,1,0,0,8
West Coast,"Rosa, Matt",20,10,1,10,0,1,0,7
West Coast,"Schofield, Will",11,8,1,3,0,0,0,2
West Coast,"Sheppard, Brad",19,16,7,3,0,0,0,4
West Coast,"Shuey, Luke",24,14,1,10,1,0,0,6
West Coast,"Wellingham, Sharrod",17,7,0,10,0,0,0,0
West Coast,"Brennan, Jacob",10,6,2,4,0,0,0,0
West Coast,"Butler, Sam",18,8,2,10,0,0,0,3
West Coast,"Darling, Jack",16,12,7,4,1,1,0,1
West Coast,"Ellis, Xavier",19,12,4,7,0,0,0,4
West Coast,"Gaff, Andrew",21,9,2,12,0,0,0,1
West Coast,"Hurn, Shannon",17,14,6,3,0,1,0,6
West Coast,"Hutchings, Mark",13,10,3,3,1,0,0,5
West Coast,"LeCras, Mark",13,9,3,4,2,1,0,3
West Coast,"Lycett, Scott",19,12,7,7,0,0,17,3
West Coast,"Mackenzie, Eric",13,9,5,4,0,0,0,1
West Coast,"Masten, Chris",21,15,4,6,0,0,0,6
West Coast,"McGinnity, Patrick",12,8,4,4,1,0,0,8
West Coast,"McGovern, Jeremy",12,10,7,2,2,0,0,2
West Coast,"Naitanui, Nic",10,2,2,8,0,0,34,6
West Coast,"Priddis, Matt",25,12,2,13,0,2,0,6
West Coast,"Schofield, Will",13,8,4,5,0,0,0,1
West Coast,"Sheed, Dom",14,5,1,9,0,0,0,3
West Coast,"Shuey, Luke",30,16,2,14,2,1,0,2
West Coast,"Sinclair, Callum",6,2,1,4,0,0,0,1
West Coast,"Smith, Ashley",13,8,7,5,2,0,0,2
West Coast,"Tunbridge, Simon",5,4,2,1,0,3,0,1
West Coast,"Wilson, Blayne",14,6,6,8,0,0,0,0
West Coast,"Brown, Mitch",3,1,0,2,0,0,0,4
West Coast,"Butler, Sam",21,13,3,8,0,0,0,7
West Coast,"Cox, Dean",4,2,1,2,0,0,18,1
West Coast,"Darling, Jack",10,3,3,7,2,0,0,6
West Coast,"Ellis, Xavier",22,18,1,4,0,0,1,2
West Coast,"Gaff, Andrew",26,17,3,9,0,0,0,1
West Coast,"Hurn, Shannon",17,12,2,5,0,1,0,13
West Coast,"Hutchings, Mark",18,10,1,8,0,0,0,13
West Coast,"Kennedy, Josh",11,10,3,1,1,1,0,4
West Coast,"LeCras, Mark",20,13,3,7,1,1,0,5
West Coast,"Mackenzie, Eric",13,9,2,4,0,0,0,0
West Coast,"Masten, Chris",23,9,1,14,0,0,0,6
West Coast,"McGinnity, Patrick",10,6,0,4,1,0,0,10
West Coast,"McGovern, Jeremy",6,6,2,0,0,0,10,1
West Coast,"Naitanui, Nic",18,4,1,14,0,0,50,4
West Coast,"Priddis, Matt",30,17,1,13,0,0,0,18
West Coast,"Schofield, Will",9,8,2,1,0,0,0,2
West Coast,"Sheed, Dom",7,3,0,4,0,0,0,6
West Coast,"Sheppard, Brad",13,10,2,3,0,0,0,7
West Coast,"Shuey, Luke",25,18,3,7,0,0,0,11
West Coast,"Smith, Ashley",4,3,0,1,0,0,0,3
West Coast,"Tunbridge, Simon",6,5,2,1,1,0,0,2
West Coast,"Bennell, Jamie",14,7,2,7,0,0,0,1
West Coast,"Brown, Mitch",12,4,4,8,0,0,0,2
West Coast,"Butler, Sam",21,14,6,7,0,0,0,2
West Coast,"Cripps, Jamie",15,10,4,5,2,1,0,3
West Coast,"Darling, Jack",11,10,5,1,3,1,0,2
West Coast,"Ellis, Xavier",13,8,0,5,2,1,0,3
West Coast,"Gaff, Andrew",31,21,5,10,3,0,0,2
West Coast,"Hill, Josh",11,9,2,2,0,1,0,4
West Coast,"Hurn, Shannon",21,15,5,6,1,0,0,2
West Coast,"Hutchings, Mark",17,6,3,11,1,0,0,10
West Coast,"Kennedy, Josh",17,12,11,5,5,4,0,3
West Coast,"LeCras, Mark",14,9,4,5,1,0,0,3
West Coast,"Lycett, Scott",10,4,1,6,1,0,17,6
West Coast,"Mackenzie, Eric",14,10,9,4,1,0,0,3
West Coast,"Masten, Chris",23,9,2,14,0,1,0,5
West Coast,"McGinnity, Patrick",14,5,1,9,0,0,0,5
West Coast,"McGovern, Jeremy",24,14,6,10,0,0,0,0
West Coast,"Naitanui, Nic",16,5,2,11,0,2,27,5
West Coast,"Priddis, Matt",31,9,0,22,0,0,0,7
West Coast,"Schofield, Will",9,5,0,4,0,0,0,4
West Coast,"Sheed, Dom",8,4,1,4,0,2,0,0
West Coast,"Shuey, Luke",31,11,3,20,0,1,0,1
West Coast,"Bennell, Jamie",22,10,10,12,0,0,0,1
West Coast,"Brown, Mitch",10,1,1,9,1,0,0,1
West Coast,"Butler, Sam",32,20,14,12,0,0,0,3
West Coast,"Cox, Dean",19,10,6,9,1,0,31,3
West Coast,"Cripps, Jamie",16,9,4,7,1,1,0,7
West Coast,"Darling, Jack",18,12,7,6,4,2,0,3
West Coast,"Ellis, Xavier",3,2,0,1,0,0,0,1
West Coast,"Gaff, Andrew",34,24,6,10,0,0,0,2
West Coast,"Hill, Josh",16,12,9,4,1,0,0,4
West Coast,"Hurn, Shannon",20,12,4,8,0,0,0,2
West Coast,"Hutchings, Mark",31,12,2,19,0,1,0,11
West Coast,"Kennedy, Josh",11,8,6,3,3,1,0,1
West Coast,"Lycett, Scott",10,5,3,5,4,1,3,0
West Coast,"Mackenzie, Eric",21,14,8,7,0,0,0,2
West Coast,"Masten, Chris",32,18,6,14,0,0,0,1
West Coast,"McGinnity, Patrick",14,5,0,9,0,0,0,4
West Coast,"McGovern, Jeremy",16,10,12,6,0,0,1,1
West Coast,"Naitanui, Nic",8,6,3,2,2,1,20,2
West Coast,"Priddis, Matt",42,14,5,28,1,1,0,7
West Coast,"Schofield, Will",19,11,5,8,0,0,0,3
West Coast,"Sheed, Dom",16,8,2,8,0,1,0,2
West Coast,"Shuey, Luke",31,16,4,15,1,0,0,7
West Coast,"Bennell, Jamie",10,5,3,5,0,1,0,1
West Coast,"Brown, Mitch",9,7,7,2,0,0,0,2
West Coast,"Butler, Sam",18,15,7,3,0,0,0,1
West Coast,"Cox, Dean",14,9,3,5,1,0,26,0
West Coast,"Cripps, Jamie",14,8,7,6,3,0,0,3
West Coast,"Darling, Jack",14,10,8,4,2,0,0,2
West Coast,"Gaff, Andrew",23,13,2,10,0,0,0,2
West Coast,"Hill, Josh",15,9,6,6,0,1,0,3
West Coast,"Hurn, Shannon",23,20,10,3,0,0,0,2
West Coast,"Hutchings, Mark",19,10,2,9,0,0,0,3
West Coast,"Kennedy, Josh",12,11,5,1,3,2,0,2
West Coast,"Lycett, Scott",6,4,3,2,1,1,0,4
West Coast,"Mackenzie, Eric",18,13,10,5,0,0,0,2
West Coast,"Masten, Chris",24,17,8,7,0,0,0,4
West Coast,"McGinnity, Patrick",14,7,6,7,0,1,0,1
West Coast,"McGovern, Jeremy",16,11,9,5,0,0,1,3
West Coast,"Naitanui, Nic",10,5,1,5,0,0,17,3
West Coast,"Priddis, Matt",25,9,4,16,0,1,1,7
West Coast,"Schofield, Will",10,5,2,5,0,0,0,2
West Coast,"Sheed, Dom",13,7,2,6,0,0,0,5
West Coast,"Shuey, Luke",27,16,5,11,1,0,0,8
West Coast,"Tunbridge, Simon",1,1,0,0,0,0,0,0
West Coast,"Bennell, Jamie",17,11,5,6,0,1,0,1
West Coast,"Brown, Mitch",6,4,3,2,0,0,0,1
West Coast,"Butler, Sam",16,10,6,6,0,0,0,2
West Coast,"Carter, Adam",9,5,1,4,0,0,0,1
West Coast,"Cox, Dean",15,10,6,5,0,0,19,2
West Coast,"Cripps, Jamie",13,5,3,8,1,0,0,4
West Coast,"Darling, Jack",15,9,3,6,3,3,0,6
West Coast,"Gaff, Andrew",29,18,4,11,1,0,0,7
West Coast,"Hill, Josh",16,11,3,5,2,1,0,3
West Coast,"Hurn, Shannon",21,16,9,5,0,0,1,3
West Coast,"Hutchings, Mark",4,1,1,3,0,0,0,3
West Coast,"Kennedy, Josh",7,7,4,0,4,0,0,6
West Coast,"LeCras, Mark",23,18,8,5,4,2,0,6
West Coast,"Lycett, Scott",15,5,4,10,1,0,18,2
West Coast,"Mackenzie, Eric",19,12,10,7,0,0,0,2
West Coast,"Masten, Chris",32,19,9,13,0,0,0,2
West Coast,"McGinnity, Patrick",7,5,3,2,1,0,0,7
West Coast,"McGovern, Jeremy",14,9,4,5,0,0,0,1
West Coast,"Priddis, Matt",20,6,1,14,0,0,0,7
West Coast,"Schofield, Will",11,8,6,3,0,0,0,4
West Coast,"Sheed, Dom",10,5,2,5,0,0,0,2
West Coast,"Shuey, Luke",23,14,7,9,1,3,1,3
West Coast,"Bennell, Jamie",14,8,2,6,0,0,0,1
West Coast,"Butler, Sam",18,9,4,9,1,1,0,1
West Coast,"Carter, Adam",11,3,3,8,0,0,0,1
West Coast,"Cripps, Jamie",9,4,3,5,1,0,0,3
West Coast,"Darling, Jack",12,7,2,5,1,2,0,1
West Coast,"Gaff, Andrew",23,17,6,6,0,0,0,4
West Coast,"Hill, Josh",15,7,5,8,1,1,0,4
West Coast,"Hurn, Shannon",9,6,3,3,0,0,0,0
West Coast,"Kennedy, Josh",12,12,7,0,8,2,0,3
West Coast,"LeCras, Mark",20,15,4,5,4,0,0,3
West Coast,"Lycett, Scott",21,7,8,14,1,0,29,3
West Coast,"Mackenzie, Eric",8,7,6,1,0,0,0,1
West Coast,"Masten, Chris",28,18,7,10,0,0,0,1
West Coast,"McGinnity, Patrick",9,5,2,4,1,1,0,2
West Coast,"McGovern, Jeremy",14,9,7,5,0,0,0,1
West Coast,"Naitanui, Nic",12,7,3,5,3,1,28,6
West Coast,"Priddis, Matt",27,11,3,16,0,1,0,7
West Coast,"Schofield, Will",11,8,3,3,0,0,0,1
West Coast,"Selwood, Scott",14,5,2,9,1,0,0,4
West Coast,"Shuey, Luke",27,19,5,8,1,0,0,3
West Coast,"Wilson, Blayne",12,10,6,2,0,0,0,1
West Coast,"Yeo, Elliot",7,3,1,4,0,0,0,0
Western Bulldogs,"Boyd, Matthew",31,12,6,19,1,0,0,5
Western Bulldogs,"Campbell, Tom",7,2,0,5,0,0,4,3
Western Bulldogs,"Cooney, Adam",26,15,5,11,0,1,0,3
Western Bulldogs,"Crameri, Stewart",15,9,5,6,2,0,0,5
Western Bulldogs,"Dahlhaus, Luke",26,15,4,11,0,0,0,7
Western Bulldogs,"Dickson, Tory",11,3,0,8,0,0,0,2
Western Bulldogs,"Giansiracusa, Daniel",11,7,5,4,0,0,0,1
Western Bulldogs,"Goodes, Brett",14,9,5,5,0,0,0,2
Western Bulldogs,"Higgins, Shaun",23,13,3,10,2,0,0,0
Western Bulldogs,"Hunter, Lachie",24,13,5,11,2,1,0,4
Western Bulldogs,"Johannisen, Jason",11,8,3,3,0,0,0,2
Western Bulldogs,"Liberatore, Tom",27,11,2,16,0,0,0,3
Western Bulldogs,"Macrae, Jack",31,15,7,16,2,0,0,3
Western Bulldogs,"Minson, Will",8,5,0,3,0,0,27,3
Western Bulldogs,"Morris, Dale",7,2,2,5,0,0,0,1
Western Bulldogs,"Murphy, Robert",19,13,6,6,2,0,0,4
Western Bulldogs,"Picken, Liam",24,10,2,14,0,0,0,5
Western Bulldogs,"Roughead, Jordan",13,6,5,7,0,0,0,1
Western Bulldogs,"Stevens, Koby",24,8,4,16,0,0,0,5
Western Bulldogs,"Stringer, Jake",9,4,2,5,0,1,0,3
Western Bulldogs,"Wallis, Mitch",20,3,2,17,0,0,0,3
Western Bulldogs,"Wood, Easton",14,8,3,6,0,0,0,0
Western Bulldogs,"Boyd, Matthew",18,13,3,5,0,0,0,7
Western Bulldogs,"Cooney, Adam",23,14,6,9,1,0,0,8
Western Bulldogs,"Crameri, Stewart",10,7,3,3,1,0,0,1
Western Bulldogs,"Dahlhaus, Luke",25,15,3,10,1,3,0,3
Western Bulldogs,"Giansiracusa, Daniel",7,4,1,3,0,0,0,1
Western Bulldogs,"Griffen, Ryan",11,4,1,7,1,0,0,2
Western Bulldogs,"Higgins, Shaun",12,6,3,6,0,0,0,5
Western Bulldogs,"Hunter, Lachie",18,11,4,7,0,0,0,2
Western Bulldogs,"Johannisen, Jason",11,7,2,4,0,1,0,2
Western Bulldogs,"Jones, Liam",7,5,4,2,1,0,2,2
Western Bulldogs,"Jong, Lin",12,7,2,5,0,0,0,5
Western Bulldogs,"Liberatore, Tom",21,8,3,13,0,0,1,9
Western Bulldogs,"Macrae, Jack",22,14,7,8,1,0,0,0
Western Bulldogs,"Minson, Will",11,6,2,5,0,0,42,5
Western Bulldogs,"Morris, Dale",19,5,8,14,0,0,0,0
Western Bulldogs,"Murphy, Robert",25,15,3,10,0,0,0,1
Western Bulldogs,"Picken, Liam",25,10,4,15,0,0,0,1
Western Bulldogs,"Roughead, Jordan",12,6,7,6,0,0,0,2
Western Bulldogs,"Stevens, Koby",24,13,7,11,1,0,0,2
Western Bulldogs,"Stringer, Jake",7,5,3,2,1,2,0,1
Western Bulldogs,"Wallis, Mitch",8,3,1,5,0,0,0,2
Western Bulldogs,"Wood, Easton",18,8,6,10,0,0,0,0
Western Bulldogs,"Boyd, Matthew",29,14,4,15,0,1,0,7
Western Bulldogs,"Cooney, Adam",22,10,3,12,1,1,0,5
Western Bulldogs,"Crameri, Stewart",18,10,4,8,2,1,0,3
Western Bulldogs,"Dahlhaus, Luke",17,7,0,10,1,0,0,4
Western Bulldogs,"Giansiracusa, Daniel",4,2,0,2,2,0,0,1
Western Bulldogs,"Griffen, Ryan",12,6,2,6,0,1,0,3
Western Bulldogs,"Higgins, Shaun",18,11,6,7,1,0,0,6
Western Bulldogs,"Hunter, Lachie",16,10,3,6,1,2,0,6
Western Bulldogs,"Johannisen, Jason",4,3,1,1,0,0,0,3
Western Bulldogs,"Jones, Liam",14,8,6,6,3,0,1,1
Western Bulldogs,"Jong, Lin",10,8,3,2,2,0,0,2
Western Bulldogs,"Liberatore, Tom",24,17,4,7,0,0,0,12
Western Bulldogs,"Macrae, Jack",30,13,9,17,1,1,0,6
Western Bulldogs,"Minson, Will",7,4,1,3,0,0,55,3
Western Bulldogs,"Morris, Dale",11,8,5,3,0,0,0,0
Western Bulldogs,"Murphy, Robert",19,14,5,5,0,0,0,4
Western Bulldogs,"Picken, Liam",18,12,8,6,0,0,0,2
Western Bulldogs,"Roughead, Jordan",3,1,1,2,0,0,1,2
Western Bulldogs,"Stringer, Jake",6,5,3,1,1,2,0,2
Western Bulldogs,"Wallis, Mitch",7,5,1,2,0,0,0,5
Western Bulldogs,"Williams, Tom",13,8,4,5,0,0,0,3
Western Bulldogs,"Wood, Easton",11,4,5,7,0,0,0,3
Western Bulldogs,"Boyd, Matthew",39,18,7,21,1,1,0,3
Western Bulldogs,"Cooney, Adam",17,11,5,6,0,0,0,2
Western Bulldogs,"Crameri, Stewart",15,9,3,6,4,0,0,3
Western Bulldogs,"Giansiracusa, Daniel",17,10,7,7,1,1,0,2
Western Bulldogs,"Griffen, Ryan",20,12,5,8,1,1,0,2
Western Bulldogs,"Higgins, Shaun",29,19,12,10,1,0,0,2
Western Bulldogs,"Hunter, Lachie",14,9,4,5,1,2,0,4
Western Bulldogs,"Jones, Liam",13,7,5,6,3,0,2,1
Western Bulldogs,"Jong, Lin",12,5,1,7,0,1,0,4
Western Bulldogs,"Liberatore, Tom",20,15,6,5,0,0,0,4
Western Bulldogs,"Macrae, Jack",30,20,13,10,0,0,0,4
Western Bulldogs,"Minson, Will",14,5,1,9,0,1,32,3
Western Bulldogs,"Morris, Dale",3,3,2,0,0,0,0,1
Western Bulldogs,"Murphy, Robert",22,16,8,6,1,0,0,0
Western Bulldogs,"Picken, Liam",25,15,6,10,1,0,0,8
Western Bulldogs,"Stevens, Koby",21,8,5,13,0,1,0,0
Western Bulldogs,"Stringer, Jake",11,7,2,4,0,0,0,1
Western Bulldogs,"Tutt, Jason",10,7,3,3,2,0,0,3
Western Bulldogs,"Wallis, Mitch",16,6,3,10,0,0,0,5
Western Bulldogs,"Williams, Tom",19,11,8,8,0,0,0,0
Western Bulldogs,"Wood, Easton",22,13,4,9,0,0,0,2
Western Bulldogs,"Young, Tom",15,8,5,7,1,0,0,0
Western Bulldogs,"Bontempelli, Marcus",14,6,0,8,0,0,0,5
Western Bulldogs,"Boyd, Matthew",28,18,3,10,1,2,1,3
Western Bulldogs,"Cooney, Adam",15,10,2,5,1,1,0,1
Western Bulldogs,"Crameri, Stewart",16,9,5,7,4,2,0,3
Western Bulldogs,"Dahlhaus, Luke",28,9,4,19,2,1,0,6
Western Bulldogs,"Giansiracusa, Daniel",9,8,1,1,1,2,0,2
Western Bulldogs,"Griffen, Ryan",32,14,0,18,0,1,0,3
Western Bulldogs,"Higgins, Shaun",15,6,0,9,0,0,0,3
Western Bulldogs,"Jones, Liam",10,6,4,4,0,1,1,2
Western Bulldogs,"Jong, Lin",10,3,2,7,1,0,0,5
Western Bulldogs,"Liberatore, Tom",18,6,1,12,0,0,0,7
Western Bulldogs,"Macrae, Jack",30,13,7,17,0,1,0,5
Western Bulldogs,"Minson, Will",13,6,1,7,0,0,48,4
Western Bulldogs,"Murphy, Robert",16,10,3,6,0,0,0,0
Western Bulldogs,"Picken, Liam",18,10,3,8,0,0,0,5
Western Bulldogs,"Stevens, Koby",18,6,6,12,2,0,1,5
Western Bulldogs,"Stringer, Jake",13,5,2,8,0,0,0,4
Western Bulldogs,"Talia, Michael",11,4,2,7,0,0,0,1
Western Bulldogs,"Wallis, Mitch",9,4,1,5,1,0,0,5
Western Bulldogs,"Williams, Tom",6,3,2,3,0,0,0,0
Western Bulldogs,"Wood, Easton",13,4,1,9,0,0,0,4
Western Bulldogs,"Young, Tom",9,4,3,5,0,0,0,1
Western Bulldogs,"Boyd, Matthew",33,14,6,19,0,0,0,2
Western Bulldogs,"Campbell, Tom",7,4,2,3,1,1,8,3
Western Bulldogs,"Cooney, Adam",23,13,3,10,0,0,0,5
Western Bulldogs,"Crameri, Stewart",13,8,7,5,1,1,0,1
Western Bulldogs,"Dahlhaus, Luke",22,12,4,10,2,1,0,5
Western Bulldogs,"Dickson, Tory",14,10,5,4,3,1,0,3
Western Bulldogs,"Giansiracusa, Daniel",11,6,2,5,1,0,0,2
Western Bulldogs,"Griffen, Ryan",22,11,1,11,0,1,0,0
Western Bulldogs,"Higgins, Shaun",22,8,3,14,1,0,0,4
Western Bulldogs,"Hunter, Lachie",3,1,0,2,0,1,0,1
Western Bulldogs,"Jones, Liam",10,3,0,7,0,0,0,1
Western Bulldogs,"Jong, Lin",14,2,1,12,0,0,0,6
Western Bulldogs,"Liberatore, Tom",25,10,4,15,0,1,0,10
Western Bulldogs,"Macrae, Jack",27,14,5,13,0,1,0,1
Western Bulldogs,"Minson, Will",9,4,3,5,0,0,33,4
Western Bulldogs,"Murphy, Robert",23,16,1,7,0,0,0,2
Western Bulldogs,"Picken, Liam",17,12,10,5,0,0,0,0
Western Bulldogs,"Stevens, Koby",17,11,7,6,2,0,0,4
Western Bulldogs,"Stringer, Jake",17,9,3,8,1,1,0,3
Western Bulldogs,"Talia, Michael",13,9,4,4,0,0,0,0
Western Bulldogs,"Wood, Easton",21,10,5,11,0,1,0,2
Western Bulldogs,"Young, Tom",12,7,3,5,0,0,0,2
Western Bulldogs,"Bontempelli, Marcus",2,2,2,0,0,0,0,1
Western Bulldogs,"Boyd, Matthew",28,15,3,13,0,0,0,4
Western Bulldogs,"Cooney, Adam",26,15,8,11,1,1,0,4
Western Bulldogs,"Crameri, Stewart",11,5,1,6,0,1,0,3
Western Bulldogs,"Dahlhaus, Luke",32,18,8,14,2,2,0,0
Western Bulldogs,"Dickson, Tory",12,5,4,7,0,0,0,3
Western Bulldogs,"Griffen, Ryan",26,15,1,11,0,0,0,4
Western Bulldogs,"Higgins, Shaun",36,17,5,19,1,0,0,0
Western Bulldogs,"Hunter, Lachie",15,8,2,7,1,1,0,0
Western Bulldogs,"Johannisen, Jason",14,6,4,8,0,1,0,2
Western Bulldogs,"Jones, Liam",12,8,5,4,1,0,3,1
Western Bulldogs,"Liberatore, Tom",25,12,5,13,1,0,0,8
Western Bulldogs,"Macrae, Jack",25,8,1,17,1,0,0,5
Western Bulldogs,"Minson, Will",8,4,4,4,0,1,45,1
Western Bulldogs,"Morris, Dale",12,9,6,3,0,0,0,2
Western Bulldogs,"Murphy, Robert",21,11,5,10,0,0,0,2
Western Bulldogs,"Picken, Liam",14,9,5,5,0,1,0,4
Western Bulldogs,"Stevens, Koby",7,2,0,5,0,0,0,2
Western Bulldogs,"Stringer, Jake",18,6,5,12,1,0,0,1
Western Bulldogs,"Talia, Michael",12,5,4,7,0,0,0,0
Western Bulldogs,"Williams, Tom",9,7,5,2,0,0,0,1
Western Bulldogs,"Wood, Easton",13,7,5,6,0,0,0,1
Western Bulldogs,"Boyd, Matthew",19,13,0,6,0,0,0,10
Western Bulldogs,"Cooney, Adam",25,12,3,13,1,0,0,3
Western Bulldogs,"Crameri, Stewart",14,11,6,3,4,1,0,3
Western Bulldogs,"Dahlhaus, Luke",22,15,2,7,0,0,0,5
Western Bulldogs,"Dickson, Tory",2,0,0,2,0,0,0,1
Western Bulldogs,"Giansiracusa, Daniel",12,8,2,4,1,0,0,1
Western Bulldogs,"Griffen, Ryan",20,12,0,8,1,1,0,15
Western Bulldogs,"Higgins, Shaun",15,10,2,5,0,0,0,6
Western Bulldogs,"Hunter, Lachie",11,5,2,6,0,0,0,5
Western Bulldogs,"Johannisen, Jason",17,12,3,5,0,1,0,2
Western Bulldogs,"Jones, Liam",8,3,4,5,0,0,1,0
Western Bulldogs,"Liberatore, Tom",27,12,5,15,2,1,1,14
Western Bulldogs,"Macrae, Jack",15,9,1,6,0,0,0,11
Western Bulldogs,"Minson, Will",15,9,2,6,1,0,40,6
Western Bulldogs,"Morris, Dale",13,6,3,7,0,0,0,1
Western Bulldogs,"Murphy, Robert",15,8,2,7,0,0,0,2
Western Bulldogs,"Picken, Liam",13,4,0,9,0,0,0,8
Western Bulldogs,"Roberts, Fletcher",9,3,0,6,0,0,0,2
Western Bulldogs,"Stringer, Jake",14,9,4,5,0,0,0,2
Western Bulldogs,"Tutt, Jason",18,13,1,5,2,0,0,8
Western Bulldogs,"Williams, Tom",6,4,1,2,3,0,0,1
Western Bulldogs,"Wood, Easton",16,6,2,10,0,1,0,2
Western Bulldogs,"Bontempelli, Marcus",13,2,1,11,0,0,0,5
Western Bulldogs,"Boyd, Matthew",30,14,6,16,0,0,1,5
Western Bulldogs,"Cooney, Adam",19,8,1,11,2,0,0,3
Western Bulldogs,"Crameri, Stewart",11,6,3,5,0,1,0,2
Western Bulldogs,"Dahlhaus, Luke",27,11,5,16,1,0,0,5
Western Bulldogs,"Giansiracusa, Daniel",4,3,2,1,2,1,0,1
Western Bulldogs,"Goodes, Brett",7,6,1,1,0,0,0,1
Western Bulldogs,"Griffen, Ryan",28,15,1,13,1,1,0,8
Western Bulldogs,"Higgins, Shaun",20,14,3,6,0,1,0,5
Western Bulldogs,"Liberatore, Tom",27,10,1,17,0,0,0,12
Western Bulldogs,"Macrae, Jack",25,13,6,12,0,0,0,0
Western Bulldogs,"Minson, Will",14,5,2,9,0,0,42,5
Western Bulldogs,"Morris, Dale",11,7,5,4,0,0,0,2
Western Bulldogs,"Murphy, Robert",16,12,4,4,1,3,0,0
Western Bulldogs,"Picken, Liam",15,10,4,5,0,1,0,6
Western Bulldogs,"Roberts, Fletcher",6,2,2,4,0,0,4,2
Western Bulldogs,"Roughead, Jordan",13,9,8,4,0,0,0,2
Western Bulldogs,"Smith, Clay",13,8,1,5,0,1,0,2
Western Bulldogs,"Stevens, Koby",9,5,3,4,1,1,0,2
Western Bulldogs,"Stringer, Jake",10,8,3,2,0,0,0,3
Western Bulldogs,"Tutt, Jason",14,8,2,6,2,1,0,3
Western Bulldogs,"Wood, Easton",16,8,6,8,0,0,0,2
Western Bulldogs,"Bontempelli, Marcus",16,12,3,4,0,0,3,3
Western Bulldogs,"Cooney, Adam",26,12,2,14,0,1,0,5
Western Bulldogs,"Crameri, Stewart",21,11,3,10,1,1,0,3
Western Bulldogs,"Dahlhaus, Luke",20,13,1,7,1,0,0,5
Western Bulldogs,"Giansiracusa, Daniel",11,6,4,5,0,1,0,1
Western Bulldogs,"Griffen, Ryan",10,3,1,7,0,0,0,6
Western Bulldogs,"Higgins, Shaun",29,13,3,16,0,0,0,7
Western Bulldogs,"Howard, Christian",11,6,1,5,0,0,0,4
Western Bulldogs,"Hrovat, Nathan",18,7,4,11,1,1,0,3
Western Bulldogs,"Liberatore, Tom",31,10,5,21,0,1,0,10
Western Bulldogs,"Macrae, Jack",29,16,4,13,0,0,0,2
Western Bulldogs,"Minson, Will",19,11,3,8,0,1,24,3
Western Bulldogs,"Morris, Dale",14,3,4,11,0,0,0,1
Western Bulldogs,"Murphy, Robert",30,19,11,11,0,1,0,2
Western Bulldogs,"Picken, Liam",20,9,2,11,0,0,0,2
Western Bulldogs,"Roberts, Fletcher",7,4,3,3,0,1,0,1
Western Bulldogs,"Roughead, Jordan",16,7,6,9,0,1,0,2
Western Bulldogs,"Stevens, Koby",23,9,6,14,2,1,0,2
Western Bulldogs,"Tutt, Jason",15,11,3,4,0,0,0,5
Western Bulldogs,"Wallis, Mitch",20,6,3,14,0,0,0,6
Western Bulldogs,"Williams, Tom",9,7,3,2,1,1,2,1
Western Bulldogs,"Wood, Easton",19,8,1,11,0,0,0,0
Western Bulldogs,"Bontempelli, Marcus",15,7,4,8,0,2,1,5
Western Bulldogs,"Cooney, Adam",25,15,7,10,1,0,0,7
Western Bulldogs,"Crameri, Stewart",16,5,4,11,1,0,0,7
Western Bulldogs,"Dahlhaus, Luke",18,7,2,11,0,2,0,3
Western Bulldogs,"Giansiracusa, Daniel",10,8,4,2,2,1,0,1
Western Bulldogs,"Grant, Jarrad",7,4,4,3,1,0,0,1
Western Bulldogs,"Griffen, Ryan",21,7,2,14,1,1,0,10
Western Bulldogs,"Higgins, Shaun",15,8,5,7,0,1,0,1
Western Bulldogs,"Howard, Christian",4,2,0,2,0,0,0,1
Western Bulldogs,"Hrovat, Nathan",12,5,1,7,2,0,0,2
Western Bulldogs,"Liberatore, Tom",22,8,2,14,0,0,0,14
Western Bulldogs,"Macrae, Jack",35,18,8,17,0,0,0,6
Western Bulldogs,"Minson, Will",14,8,1,6,0,1,34,7
Western Bulldogs,"Morris, Dale",8,3,5,5,0,0,0,3
Western Bulldogs,"Murphy, Robert",21,17,5,4,0,0,0,3
Western Bulldogs,"Picken, Liam",19,9,4,10,1,0,0,6
Western Bulldogs,"Roughead, Jordan",12,6,2,6,0,0,0,2
Western Bulldogs,"Stevens, Koby",19,5,1,14,0,0,0,3
Western Bulldogs,"Tutt, Jason",16,6,0,10,1,0,0,5
Western Bulldogs,"Wallis, Mitch",14,5,1,9,0,0,0,6
Western Bulldogs,"Williams, Tom",12,8,5,4,2,0,2,1
Western Bulldogs,"Wood, Easton",7,5,3,2,1,0,0,3
Western Bulldogs,"Austin, Mark",11,4,1,7,0,0,0,1
Western Bulldogs,"Bontempelli, Marcus",22,11,5,11,1,2,1,4
Western Bulldogs,"Cooney, Adam",7,4,0,3,0,0,0,1
Western Bulldogs,"Crameri, Stewart",9,6,3,3,1,2,0,2
Western Bulldogs,"Dahlhaus, Luke",29,12,2,17,0,1,0,2
Western Bulldogs,"Giansiracusa, Daniel",22,10,2,12,1,0,0,3
Western Bulldogs,"Grant, Jarrad",20,10,4,10,1,0,0,3
Western Bulldogs,"Griffen, Ryan",27,19,1,8,2,0,0,6
Western Bulldogs,"Higgins, Shaun",19,6,3,13,0,0,0,3
Western Bulldogs,"Hrovat, Nathan",16,7,4,9,0,1,0,5
Western Bulldogs,"Jones, Liam",16,13,5,3,4,2,2,6
Western Bulldogs,"Liberatore, Tom",34,12,1,22,0,1,0,10
Western Bulldogs,"Macrae, Jack",28,13,5,15,0,0,0,8
Western Bulldogs,"Minson, Will",13,8,2,5,0,0,43,2
Western Bulldogs,"Morris, Dale",9,4,2,5,0,0,0,4
Western Bulldogs,"Murphy, Robert",17,9,1,8,0,0,0,1
Western Bulldogs,"Picken, Liam",15,5,1,10,0,0,0,6
Western Bulldogs,"Roughead, Jordan",14,7,4,7,0,0,0,3
Western Bulldogs,"Stevens, Koby",18,6,2,12,3,0,0,4
Western Bulldogs,"Tutt, Jason",14,12,3,2,2,0,0,5
Western Bulldogs,"Wallis, Mitch",21,10,2,11,1,0,0,7
Western Bulldogs,"Wood, Easton",13,4,1,9,0,0,0,2
Western Bulldogs,"Austin, Mark",12,8,5,4,0,0,0,3
Western Bulldogs,"Bontempelli, Marcus",24,9,5,15,1,0,0,1
Western Bulldogs,"Boyd, Matthew",25,12,1,13,0,1,1,6
Western Bulldogs,"Crameri, Stewart",11,5,2,6,0,0,0,1
Western Bulldogs,"Dahlhaus, Luke",16,5,2,11,0,0,0,5
Western Bulldogs,"Giansiracusa, Daniel",6,3,1,3,2,0,0,0
Western Bulldogs,"Grant, Jarrad",9,3,1,6,0,0,0,3
Western Bulldogs,"Griffen, Ryan",14,5,1,9,0,0,0,2
Western Bulldogs,"Higgins, Shaun",27,14,4,13,0,0,0,4
Western Bulldogs,"Hrovat, Nathan",20,6,3,14,1,0,0,7
Western Bulldogs,"Jones, Liam",9,6,2,3,0,1,0,2
Western Bulldogs,"Liberatore, Tom",19,10,2,9,1,0,0,7
Western Bulldogs,"Macrae, Jack",27,12,6,15,0,0,0,5
Western Bulldogs,"Minson, Will",15,11,0,4,1,1,29,4
Western Bulldogs,"Morris, Dale",10,2,3,8,0,0,0,1
Western Bulldogs,"Murphy, Robert",13,7,0,6,0,0,0,2
Western Bulldogs,"Picken, Liam",24,12,3,12,0,0,0,4
Western Bulldogs,"Roughead, Jordan",12,7,5,5,0,0,0,2
Western Bulldogs,"Stevens, Koby",21,9,4,12,1,2,0,4
Western Bulldogs,"Tutt, Jason",13,10,2,3,1,2,0,3
Western Bulldogs,"Wallis, Mitch",15,6,2,9,0,0,0,4
Western Bulldogs,"Wood, Easton",16,8,7,8,0,0,0,0
Western Bulldogs,"Austin, Mark",11,6,2,5,0,0,0,1
Western Bulldogs,"Bontempelli, Marcus",17,11,3,6,2,0,0,3
Western Bulldogs,"Boyd, Matthew",32,20,1,12,1,0,0,8
Western Bulldogs,"Crameri, Stewart",10,8,2,2,2,0,0,1
Western Bulldogs,"Dahlhaus, Luke",22,10,5,12,1,0,0,6
Western Bulldogs,"Darley, Sam",16,9,4,7,0,0,0,2
Western Bulldogs,"Higgins, Shaun",20,11,3,9,1,1,0,3
Western Bulldogs,"Honeychurch, Mitch",8,2,0,6,1,0,0,4
Western Bulldogs,"Hrovat, Nathan",7,4,1,3,0,0,0,2
Western Bulldogs,"Hunter, Lachie",14,7,5,7,1,0,0,2
Western Bulldogs,"Jones, Liam",1,0,0,1,0,0,1,3
Western Bulldogs,"Liberatore, Tom",12,5,0,7,0,0,1,9
Western Bulldogs,"Macrae, Jack",15,9,3,6,0,1,0,6
Western Bulldogs,"Minson, Will",11,8,2,3,1,0,34,7
Western Bulldogs,"Morris, Dale",10,6,3,4,0,0,0,5
Western Bulldogs,"Murphy, Robert",21,16,5,5,0,0,0,2
Western Bulldogs,"Picken, Liam",16,10,2,6,0,1,0,2
Western Bulldogs,"Roberts, Fletcher",8,6,3,2,0,0,2,3
Western Bulldogs,"Stevens, Koby",23,8,3,15,0,1,0,4
Western Bulldogs,"Stringer, Jake",13,10,5,3,4,2,0,3
Western Bulldogs,"Wallis, Mitch",18,7,0,11,0,0,0,7
Western Bulldogs,"Wood, Easton",17,10,5,7,0,0,0,3
Western Bulldogs,"Austin, Mark",2,1,0,1,0,0,0,0
Western Bulldogs,"Bontempelli, Marcus",21,13,2,8,2,1,1,10
Western Bulldogs,"Boyd, Matthew",20,9,1,11,0,0,0,1
Western Bulldogs,"Crameri, Stewart",17,8,3,9,2,1,0,1
Western Bulldogs,"Dahlhaus, Luke",16,13,2,3,1,2,0,7
Western Bulldogs,"Griffen, Ryan",32,17,0,15,1,0,0,6
Western Bulldogs,"Higgins, Shaun",11,10,1,1,0,0,0,4
Western Bulldogs,"Honeychurch, Mitch",10,4,2,6,0,1,0,7
Western Bulldogs,"Hrovat, Nathan",13,7,2,6,0,1,0,3
Western Bulldogs,"Hunter, Lachie",16,12,2,4,1,0,0,5
Western Bulldogs,"Liberatore, Tom",32,16,2,16,0,0,1,7
Western Bulldogs,"Macrae, Jack",17,11,2,6,0,0,0,4
Western Bulldogs,"Minson, Will",10,7,0,3,0,0,33,7
Western Bulldogs,"Morris, Dale",7,4,1,3,0,0,0,5
Western Bulldogs,"Murphy, Robert",17,13,1,4,0,0,0,3
Western Bulldogs,"Picken, Liam",22,14,2,8,0,1,0,4
Western Bulldogs,"Redpath, Jack",5,2,0,3,0,0,1,3
Western Bulldogs,"Roughead, Jordan",5,3,2,2,0,0,0,1
Western Bulldogs,"Stevens, Koby",18,8,0,10,0,0,0,3
Western Bulldogs,"Stringer, Jake",13,8,0,5,0,0,0,8
Western Bulldogs,"Wallis, Mitch",20,11,0,9,0,2,0,3
Western Bulldogs,"Wood, Easton",11,7,0,4,0,0,0,4
Western Bulldogs,"Austin, Mark",6,3,2,3,0,0,0,1
Western Bulldogs,"Bontempelli, Marcus",16,8,3,8,1,1,1,0
Western Bulldogs,"Boyd, Matthew",31,16,6,15,0,1,0,3
Western Bulldogs,"Crameri, Stewart",14,8,3,6,1,1,0,4
Western Bulldogs,"Dahlhaus, Luke",24,12,4,12,1,3,0,4
Western Bulldogs,"Darley, Sam",13,7,2,6,0,0,0,2
Western Bulldogs,"Honeychurch, Mitch",6,3,1,3,0,1,0,0
Western Bulldogs,"Hrovat, Nathan",27,17,5,10,1,2,0,4
Western Bulldogs,"Hunter, Lachie",15,12,5,3,2,1,0,5
Western Bulldogs,"Johannisen, Jason",25,17,3,8,1,0,0,3
Western Bulldogs,"Liberatore, Tom",28,16,5,12,1,0,0,2
Western Bulldogs,"Macrae, Jack",43,29,6,14,2,0,0,5
Western Bulldogs,"Minson, Will",17,10,2,7,0,0,39,2
Western Bulldogs,"Morris, Dale",13,8,3,5,0,0,0,2
Western Bulldogs,"Murphy, Robert",22,13,3,9,0,0,0,1
Western Bulldogs,"Picken, Liam",17,10,4,7,0,1,0,3
Western Bulldogs,"Redpath, Jack",9,4,3,5,1,0,3,2
Western Bulldogs,"Roughead, Jordan",14,9,6,5,0,0,0,2
Western Bulldogs,"Stevens, Koby",20,7,4,13,0,0,0,2
Western Bulldogs,"Stringer, Jake",12,4,1,8,2,0,0,4
Western Bulldogs,"Wallis, Mitch",28,8,3,20,0,0,0,2
Western Bulldogs,"Wood, Easton",20,10,4,10,0,0,0,4
Western Bulldogs,"Austin, Mark",12,9,5,3,0,0,0,1
Western Bulldogs,"Bontempelli, Marcus",13,8,8,5,2,1,1,3
Western Bulldogs,"Boyd, Matthew",22,9,3,13,1,1,0,1
Western Bulldogs,"Cooney, Adam",4,1,0,3,0,0,0,0
Western Bulldogs,"Crameri, Stewart",12,7,5,5,1,1,0,0
Western Bulldogs,"Dahlhaus, Luke",16,10,2,6,2,0,0,2
Western Bulldogs,"Griffen, Ryan",28,12,0,16,0,1,0,6
Western Bulldogs,"Hrovat, Nathan",17,9,2,8,1,0,0,1
Western Bulldogs,"Hunter, Lachie",17,12,5,5,0,1,0,2
Western Bulldogs,"Johannisen, Jason",21,14,6,7,0,0,0,6
Western Bulldogs,"Liberatore, Tom",20,8,2,12,0,0,0,5
Western Bulldogs,"Macrae, Jack",32,21,7,11,1,0,0,4
Western Bulldogs,"Minson, Will",11,8,2,3,0,0,33,4
Western Bulldogs,"Morris, Dale",14,9,5,5,0,0,0,6
Western Bulldogs,"Murphy, Robert",16,11,3,5,0,0,0,0
Western Bulldogs,"Picken, Liam",7,4,2,3,0,0,0,3
Western Bulldogs,"Redpath, Jack",6,3,3,3,1,0,5,0
Western Bulldogs,"Roughead, Jordan",14,8,3,6,0,0,0,1
Western Bulldogs,"Stevens, Koby",17,8,5,9,0,0,1,4
Western Bulldogs,"Stringer, Jake",10,7,1,3,5,0,0,0
Western Bulldogs,"Wallis, Mitch",18,3,0,15,0,0,0,2
Western Bulldogs,"Wood, Easton",9,3,1,6,0,0,0,5
Western Bulldogs,"Austin, Mark",10,5,4,5,0,0,0,4
Western Bulldogs,"Bontempelli, Marcus",13,5,1,8,0,0,0,2
Western Bulldogs,"Boyd, Matthew",19,10,4,9,0,1,0,3
Western Bulldogs,"Campbell, Tom",11,6,4,5,2,1,6,4
Western Bulldogs,"Cooney, Adam",7,4,1,3,0,0,0,3
Western Bulldogs,"Crameri, Stewart",9,4,1,5,1,0,0,4
Western Bulldogs,"Dahlhaus, Luke",19,10,3,9,1,2,0,3
Western Bulldogs,"Darley, Sam",9,7,2,2,0,0,0,6
Western Bulldogs,"Griffen, Ryan",29,16,6,13,0,0,0,4
Western Bulldogs,"Higgins, Shaun",14,6,5,8,1,0,0,2
Western Bulldogs,"Hrovat, Nathan",13,10,5,3,0,0,0,5
Western Bulldogs,"Hunter, Lachie",14,11,7,3,0,2,0,1
Western Bulldogs,"Johannisen, Jason",17,10,3,7,0,0,0,0
Western Bulldogs,"Liberatore, Tom",23,14,2,9,0,0,0,7
Western Bulldogs,"Macrae, Jack",31,21,4,10,0,0,0,2
Western Bulldogs,"Minson, Will",12,7,3,5,0,0,34,1
Western Bulldogs,"Morris, Dale",8,3,1,5,0,0,0,4
Western Bulldogs,"Murphy, Robert",32,19,6,13,0,1,0,4
Western Bulldogs,"Picken, Liam",12,5,2,7,0,0,0,7
Western Bulldogs,"Roughead, Jordan",13,8,5,5,0,0,3,2
Western Bulldogs,"Stevens, Koby",5,1,2,4,0,0,0,1
Western Bulldogs,"Stringer, Jake",12,9,4,3,1,1,0,3
Western Bulldogs,"Austin, Mark",14,10,6,4,0,0,0,0
Western Bulldogs,"Bontempelli, Marcus",15,10,3,5,1,1,1,3
Western Bulldogs,"Boyd, Matthew",17,9,3,8,0,0,0,2
Western Bulldogs,"Campbell, Tom",8,3,3,5,1,0,14,2
Western Bulldogs,"Cooney, Adam",25,14,5,11,3,0,0,3
Western Bulldogs,"Crameri, Stewart",20,12,5,8,3,3,0,1
Western Bulldogs,"Dahlhaus, Luke",17,10,2,7,0,2,0,3
Western Bulldogs,"Darley, Sam",17,9,2,8,1,0,0,0
Western Bulldogs,"Griffen, Ryan",20,9,3,11,0,0,0,4
Western Bulldogs,"Higgins, Shaun",26,10,2,16,1,0,0,3
Western Bulldogs,"Hrovat, Nathan",16,8,3,8,1,0,0,2
Western Bulldogs,"Hunter, Lachie",3,2,2,1,0,1,0,0
Western Bulldogs,"Liberatore, Tom",19,10,4,9,0,0,0,6
Western Bulldogs,"Macrae, Jack",20,9,2,11,1,0,0,4
Western Bulldogs,"Minson, Will",12,5,1,7,0,0,26,1
Western Bulldogs,"Morris, Dale",17,14,7,3,0,0,0,1
Western Bulldogs,"Murphy, Robert",18,12,3,6,0,0,0,1
Western Bulldogs,"Picken, Liam",18,10,4,8,1,0,0,2
Western Bulldogs,"Roughead, Jordan",13,8,6,5,0,0,0,2
Western Bulldogs,"Stevens, Koby",17,9,6,8,1,3,0,0
Western Bulldogs,"Stringer, Jake",16,13,3,3,4,1,0,1
Western Bulldogs,"Wood, Easton",17,8,3,9,0,0,0,5
Western Bulldogs,"Austin, Mark",7,4,2,3,0,0,0,1
Western Bulldogs,"Bontempelli, Marcus",23,8,2,15,2,1,3,8
Western Bulldogs,"Boyd, Matthew",22,9,2,13,1,1,0,5
Western Bulldogs,"Campbell, Tom",3,2,0,1,0,0,17,1
Western Bulldogs,"Cooney, Adam",23,12,5,11,1,1,0,3
Western Bulldogs,"Crameri, Stewart",12,8,4,4,2,0,0,3
Western Bulldogs,"Dahlhaus, Luke",18,11,3,7,1,2,0,4
Western Bulldogs,"Darley, Sam",13,8,1,5,0,0,0,2
Western Bulldogs,"Giansiracusa, Daniel",8,3,1,5,0,1,0,1
Western Bulldogs,"Grant, Jarrad",13,7,4,6,0,0,0,3
Western Bulldogs,"Griffen, Ryan",30,11,0,19,0,1,0,5
Western Bulldogs,"Higgins, Shaun",23,14,3,9,0,0,0,3
Western Bulldogs,"Hunter, Lachie",18,13,5,5,0,1,0,0
Western Bulldogs,"Johannisen, Jason",20,13,3,7,0,0,0,3
Western Bulldogs,"Liberatore, Tom",23,10,2,13,0,0,0,9
Western Bulldogs,"Minson, Will",8,5,1,3,0,1,34,5
Western Bulldogs,"Morris, Dale",11,4,3,7,0,0,0,3
Western Bulldogs,"Murphy, Robert",19,13,1,6,0,0,0,2
Western Bulldogs,"Picken, Liam",17,8,2,9,0,0,0,2
Western Bulldogs,"Roughead, Jordan",6,0,0,6,0,0,0,5
Western Bulldogs,"Stevens, Koby",19,5,3,14,1,0,0,0
Western Bulldogs,"Stringer, Jake",12,7,3,5,0,1,0,0
Western Bulldogs,"Austin, Mark",10,6,4,4,0,0,0,2
Western Bulldogs,"Bontempelli, Marcus",11,8,1,3,1,1,1,0
Western Bulldogs,"Boyd, Matthew",28,11,6,17,1,1,1,4
Western Bulldogs,"Campbell, Tom",2,1,1,1,0,0,4,3
Western Bulldogs,"Cooney, Adam",21,9,8,12,1,0,0,1
Western Bulldogs,"Cordy, Ayce",10,4,1,6,0,0,14,3
Western Bulldogs,"Crameri, Stewart",12,1,1,11,0,0,0,1
Western Bulldogs,"Dahlhaus, Luke",21,13,7,8,0,1,0,5
Western Bulldogs,"Giansiracusa, Daniel",11,9,4,2,0,1,0,0
Western Bulldogs,"Griffen, Ryan",16,9,4,7,1,0,0,8
Western Bulldogs,"Higgins, Shaun",17,11,4,6,0,1,0,2
Western Bulldogs,"Hrovat, Nathan",30,14,6,16,1,0,0,3
Western Bulldogs,"Johannisen, Jason",18,12,6,6,1,1,0,0
Western Bulldogs,"Jong, Lin",11,3,1,8,0,0,0,3
Western Bulldogs,"Liberatore, Tom",26,14,1,12,1,0,0,5
Western Bulldogs,"Macrae, Jack",30,15,10,15,0,1,0,2
Western Bulldogs,"Morris, Dale",16,11,7,5,0,0,0,2
Western Bulldogs,"Murphy, Robert",26,16,8,10,0,0,0,3
Western Bulldogs,"Picken, Liam",25,15,10,10,0,0,0,6
Western Bulldogs,"Roughead, Jordan",11,7,6,4,0,0,3,3
Western Bulldogs,"Stevens, Koby",18,10,4,8,0,0,0,2
Western Bulldogs,"Stringer, Jake",13,8,6,5,2,2,0,2
Western Bulldogs,"Austin, Mark",4,1,1,3,0,0,0,0
Western Bulldogs,"Bontempelli, Marcus",19,13,4,6,2,0,2,2
Western Bulldogs,"Boyd, Matthew",27,13,4,14,0,1,0,3
Western Bulldogs,"Campbell, Tom",8,4,3,4,0,0,16,3
Western Bulldogs,"Cooney, Adam",20,11,3,9,0,0,0,2
Western Bulldogs,"Crameri, Stewart",15,11,6,4,4,1,0,3
Western Bulldogs,"Dahlhaus, Luke",18,11,6,7,0,1,0,3
Western Bulldogs,"Giansiracusa, Daniel",20,13,5,7,2,2,0,1
Western Bulldogs,"Griffen, Ryan",38,22,6,16,1,1,0,5
Western Bulldogs,"Higgins, Shaun",17,5,2,12,0,0,0,1
Western Bulldogs,"Hrovat, Nathan",24,11,4,13,0,2,0,0
Western Bulldogs,"Johannisen, Jason",20,9,8,11,0,0,0,3
Western Bulldogs,"Liberatore, Tom",19,10,2,9,1,1,0,3
Western Bulldogs,"Macrae, Jack",20,9,6,11,0,0,0,3
Western Bulldogs,"Minson, Will",11,8,0,3,1,0,30,4
Western Bulldogs,"Morris, Dale",14,8,7,6,0,0,0,3
Western Bulldogs,"Murphy, Robert",24,14,7,10,0,0,0,0
Western Bulldogs,"Picken, Liam",21,14,5,7,0,1,0,2
Western Bulldogs,"Roberts, Fletcher",5,4,2,1,0,0,0,2
Western Bulldogs,"Stevens, Koby",9,4,1,5,0,0,0,1
Western Bulldogs,"Stringer, Jake",14,9,5,5,4,2,0,2
Western Bulldogs,"Young, Tom",11,3,1,8,0,0,0,1
Adelaide,"Brown, Luke",7,3,2,4,0,0,0,3
Adelaide,"Dangerfield, Patrick",17,10,1,7,0,1,0,2
Adelaide,"Douglas, Richard",19,13,5,6,2,1,0,2
Adelaide,"Henderson, Ricky",14,11,7,3,0,2,0,1
Adelaide,"Jacobs, Sam",10,9,2,1,0,1,37,1
Adelaide,"Jaensch, Matthew",13,7,2,6,0,0,0,1
Adelaide,"Jenkins, Josh",11,9,3,2,1,0,7,1
Adelaide,"Johncock, Graham",13,7,4,6,1,1,0,2
Adelaide,"Mackay, David",16,8,3,8,1,0,0,4
Adelaide,"Martin, Brodie",9,6,2,3,0,0,0,1
Adelaide,"Otten, Andy",15,6,3,9,0,0,0,0
Adelaide,"Petrenko, Jared",5,4,0,1,1,1,0,6
Adelaide,"Porplyzia, Jason",16,8,3,8,1,2,0,1
Adelaide,"Reilly, Brent",19,13,3,6,0,0,0,4
Adelaide,"Rutten, Ben",7,2,1,5,0,0,0,1
Adelaide,"Sloane, Rory",23,12,1,11,0,1,0,6
Adelaide,"Talia, Daniel",5,3,1,2,0,0,0,0
Adelaide,"Thompson, Scott",23,11,4,12,0,0,0,3
Adelaide,"Vince, Bernie",16,10,2,6,0,0,0,1
Adelaide,"Walker, Taylor",14,9,4,5,3,1,0,1
Adelaide,"Wright, Matthew",24,14,7,10,0,0,0,5
Adelaide,"van Berlo, Nathan",14,12,3,2,1,0,0,1
Adelaide,"Brown, Luke",19,12,5,7,0,0,0,2
Adelaide,"Callinan, Ian",6,2,0,4,0,0,0,2
Adelaide,"Crouch, Brad",18,7,3,11,0,0,0,3
Adelaide,"Dangerfield, Patrick",23,11,2,12,2,1,0,5
Adelaide,"Douglas, Richard",16,13,7,3,1,0,0,5
Adelaide,"Henderson, Ricky",9,6,5,3,1,2,0,1
Adelaide,"Jacobs, Sam",13,10,3,3,1,1,23,2
Adelaide,"Jaensch, Matthew",14,10,3,4,1,0,0,4
Adelaide,"Jenkins, Josh",16,15,12,1,2,2,6,1
Adelaide,"Mackay, David",17,8,2,9,0,0,0,3
Adelaide,"Otten, Andy",7,3,3,4,0,0,0,2
Adelaide,"Petrenko, Jared",11,7,4,4,2,0,0,4
Adelaide,"Porplyzia, Jason",13,9,5,4,0,0,0,1
Adelaide,"Reilly, Brent",9,6,4,3,1,0,0,4
Adelaide,"Rutten, Ben",15,9,8,6,0,0,0,0
Adelaide,"Sloane, Rory",22,15,11,7,1,1,0,2
Adelaide,"Talia, Daniel",10,7,5,3,0,0,0,3
Adelaide,"Thompson, Scott",31,25,3,6,0,0,0,5
Adelaide,"Vince, Bernie",11,8,2,3,0,2,0,3
Adelaide,"Walker, Taylor",12,12,7,0,2,2,0,3
Adelaide,"Wright, Matthew",17,8,0,9,0,0,0,3
Adelaide,"van Berlo, Nathan",22,13,3,9,0,0,0,1
Adelaide,"Brown, Luke",6,4,2,2,0,0,0,0
Adelaide,"Crouch, Brad",18,9,2,9,0,0,0,3
Adelaide,"Dangerfield, Patrick",20,16,6,4,1,0,0,4
Adelaide,"Douglas, Richard",26,17,4,9,2,0,0,4
Adelaide,"Henderson, Ricky",20,13,7,7,1,0,0,2
Adelaide,"Jacobs, Sam",12,6,1,6,0,0,27,3
Adelaide,"Jaensch, Matthew",16,12,3,4,0,0,0,5
Adelaide,"Jenkins, Josh",8,6,3,2,2,0,11,0
Adelaide,"Johncock, Graham",5,5,1,0,1,2,0,1
Adelaide,"Mackay, David",18,11,3,7,0,0,0,6
Adelaide,"Otten, Andy",14,8,5,6,1,0,0,3
Adelaide,"Petrenko, Jared",13,5,1,8,1,1,0,2
Adelaide,"Porplyzia, Jason",12,7,2,5,1,2,0,5
Adelaide,"Reilly, Brent",17,8,3,9,1,0,0,3
Adelaide,"Rutten, Ben",8,5,5,3,0,0,0,1
Adelaide,"Sloane, Rory",24,16,7,8,2,1,1,3
Adelaide,"Talia, Daniel",5,4,3,1,0,0,0,0
Adelaide,"Thompson, Scott",28,18,3,10,0,1,0,5
Adelaide,"Vince, Bernie",14,6,1,8,0,1,0,4
Adelaide,"Walker, Taylor",15,9,4,6,3,2,0,1
Adelaide,"Wright, Matthew",19,10,6,9,0,0,0,4
Adelaide,"van Berlo, Nathan",13,9,3,4,0,0,0,0
Adelaide,"Brown, Luke",13,6,2,7,0,0,0,6
Adelaide,"Crouch, Brad",22,11,2,11,1,0,0,6
Adelaide,"Dangerfield, Patrick",21,15,2,6,4,1,0,4
Adelaide,"Douglas, Richard",25,18,3,7,1,0,0,9
Adelaide,"Henderson, Ricky",22,17,4,5,1,0,0,2
Adelaide,"Jacobs, Sam",10,2,1,8,0,0,38,2
Adelaide,"Jaensch, Matthew",18,14,7,4,0,0,0,3
Adelaide,"Jenkins, Josh",15,9,3,6,1,0,11,6
Adelaide,"Kerridge, Sam",14,8,3,6,1,0,0,7
Adelaide,"Laird, Rory",8,4,0,4,0,0,0,5
Adelaide,"Lynch, Tom",19,10,6,9,1,0,0,4
Adelaide,"Mackay, David",19,9,0,10,1,0,0,3
Adelaide,"Otten, Andy",25,15,5,10,0,0,0,2
Adelaide,"Petrenko, Jared",14,6,1,8,0,1,0,8
Adelaide,"Porplyzia, Jason",4,3,0,1,0,0,0,0
Adelaide,"Reilly, Brent",18,10,3,8,0,0,0,6
Adelaide,"Rutten, Ben",15,8,5,7,0,0,0,4
Adelaide,"Sloane, Rory",29,21,4,8,0,0,1,7
Adelaide,"Talia, Daniel",9,7,6,2,0,0,0,3
Adelaide,"Thompson, Scott",30,12,5,18,0,1,0,4
Adelaide,"Walker, Taylor",14,6,4,8,1,0,0,3
Adelaide,"Wright, Matthew",19,14,3,5,0,0,0,5
Adelaide,"Brown, Luke",5,2,1,3,0,0,0,1
Adelaide,"Dangerfield, Patrick",20,14,2,6,0,1,4,2
Adelaide,"Douglas, Richard",22,16,8,6,1,0,0,2
Adelaide,"Henderson, Ricky",12,8,2,4,0,0,0,0
Adelaide,"Jacobs, Sam",8,5,4,3,1,1,24,4
Adelaide,"Jaensch, Matthew",13,11,5,2,3,1,0,2
Adelaide,"Jenkins, Josh",12,5,1,7,0,1,6,1
Adelaide,"Kerridge, Sam",3,2,0,1,0,0,0,7
Adelaide,"Laird, Rory",17,12,3,5,0,0,0,6
Adelaide,"Lynch, Tom",16,10,7,6,1,0,0,4
Adelaide,"Mackay, David",17,9,5,8,0,1,0,4
Adelaide,"Otten, Andy",16,8,11,8,3,1,0,1
Adelaide,"Petrenko, Jared",8,5,3,3,1,0,0,5
Adelaide,"Reilly, Brent",20,15,7,5,0,1,0,1
Adelaide,"Rutten, Ben",16,9,11,7,0,0,0,1
Adelaide,"Sloane, Rory",19,11,2,8,0,0,2,4
Adelaide,"Smith, Brodie",17,12,3,5,0,0,0,1
Adelaide,"Talia, Daniel",12,5,1,7,0,0,0,0
Adelaide,"Thompson, Scott",24,14,6,10,0,1,0,3
Adelaide,"Vince, Bernie",21,15,7,6,1,0,0,5
Adelaide,"Walker, Taylor",6,4,4,2,1,1,0,0
Adelaide,"Wright, Matthew",20,11,6,9,0,0,0,4
Adelaide,"Brown, Luke",10,7,4,3,0,0,0,0
Adelaide,"Dangerfield, Patrick",35,27,8,8,2,0,2,3
Adelaide,"Douglas, Richard",16,9,4,7,1,0,0,4
Adelaide,"Jacobs, Sam",9,6,3,3,1,0,25,0
Adelaide,"Jaensch, Matthew",13,8,7,5,0,1,0,4
Adelaide,"Jenkins, Josh",11,10,6,1,2,4,0,2
Adelaide,"Kerridge, Sam",13,8,7,5,2,2,0,1
Adelaide,"Lynch, Tom",15,10,11,5,0,1,0,2
Adelaide,"Lyons, Jarryd",10,6,1,4,0,0,0,3
Adelaide,"Mackay, David",22,12,6,10,0,0,0,4
Adelaide,"McKernan, Shaun",12,4,5,8,0,0,8,4
Adelaide,"Otten, Andy",10,7,5,3,0,0,0,4
Adelaide,"Porplyzia, Jason",12,7,3,5,0,0,0,0
Adelaide,"Reilly, Brent",23,14,8,9,0,0,0,0
Adelaide,"Rutten, Ben",17,9,8,8,0,0,0,1
Adelaide,"Sloane, Rory",25,15,8,10,0,0,0,3
Adelaide,"Smith, Brodie",21,14,2,7,0,0,0,3
Adelaide,"Talia, Daniel",13,6,1,7,0,0,0,2
Adelaide,"Tambling, Richard",12,7,4,5,0,0,0,4
Adelaide,"Thompson, Scott",24,11,5,13,2,0,0,5
Adelaide,"Vince, Bernie",20,14,5,6,1,1,0,5
Adelaide,"Wright, Matthew",7,3,3,4,0,0,0,0
Adelaide,"Brown, Luke",19,14,8,5,0,0,0,0
Adelaide,"Dangerfield, Patrick",28,20,9,8,4,2,1,2
Adelaide,"Douglas, Richard",22,14,7,8,1,0,0,3
Adelaide,"Jacobs, Sam",13,7,4,6,0,0,22,0
Adelaide,"Jenkins, Josh",11,8,7,3,4,3,0,1
Adelaide,"Kerridge, Sam",27,12,11,15,3,0,0,1
Adelaide,"Laird, Rory",17,8,5,9,0,0,0,3
Adelaide,"Lynch, Tom",21,17,11,4,10,2,0,2
Adelaide,"Lyons, Jarryd",19,10,3,9,0,0,0,1
Adelaide,"Mackay, David",20,11,6,9,1,0,0,3
Adelaide,"McKernan, Shaun",16,10,7,6,1,0,3,2
Adelaide,"Otten, Andy",15,10,7,5,0,0,0,2
Adelaide,"Porplyzia, Jason",18,6,2,12,0,1,0,1
Adelaide,"Reilly, Brent",27,18,9,9,0,0,0,3
Adelaide,"Rutten, Ben",14,5,5,9,0,0,0,0
Adelaide,"Sloane, Rory",19,10,7,9,1,0,0,4
Adelaide,"Smith, Brodie",14,6,3,8,1,0,0,1
Adelaide,"Talia, Daniel",9,5,3,4,1,0,0,1
Adelaide,"Thompson, Scott",32,21,8,11,0,1,0,0
Adelaide,"Vince, Bernie",26,14,8,12,2,0,0,2
Adelaide,"Wright, Matthew",27,13,8,14,0,0,0,3
Adelaide,"van Berlo, Nathan",21,15,10,6,0,2,0,2
Adelaide,"Brown, Luke",11,8,5,3,0,0,0,3
Adelaide,"Dangerfield, Patrick",20,10,4,10,0,0,3,3
Adelaide,"Douglas, Richard",26,15,11,11,1,1,1,4
Adelaide,"Jacobs, Sam",20,11,6,9,0,0,23,0
Adelaide,"Jenkins, Josh",14,12,9,2,2,4,0,2
Adelaide,"Kerridge, Sam",12,9,7,3,0,0,0,1
Adelaide,"Laird, Rory",14,8,6,6,0,0,0,3
Adelaide,"Lynch, Tom",15,14,11,1,2,1,0,1
Adelaide,"Lyons, Jarryd",17,11,4,6,0,1,0,2
Adelaide,"Mackay, David",23,20,9,3,1,1,0,2
Adelaide,"McKernan, Shaun",9,6,4,3,1,1,6,2
Adelaide,"Otten, Andy",13,8,4,5,0,0,0,3
Adelaide,"Porplyzia, Jason",12,7,5,5,1,0,0,1
Adelaide,"Reilly, Brent",21,14,7,7,0,0,0,1
Adelaide,"Rutten, Ben",10,9,7,1,0,0,0,0
Adelaide,"Sloane, Rory",25,16,12,9,0,1,1,3
Adelaide,"Smith, Brodie",21,12,4,9,0,0,0,2
Adelaide,"Talia, Daniel",18,9,9,9,1,0,0,2
Adelaide,"Thompson, Scott",25,13,11,12,1,0,1,4
Adelaide,"Vince, Bernie",20,14,5,6,1,0,0,4
Adelaide,"Wright, Matthew",11,8,2,3,0,1,0,2
Adelaide,"van Berlo, Nathan",20,12,5,8,1,1,0,2
Adelaide,"Brown, Luke",6,5,2,1,0,0,0,1
Adelaide,"Dangerfield, Patrick",30,18,6,12,0,1,2,6
Adelaide,"Douglas, Richard",28,20,9,8,2,0,0,4
Adelaide,"Jacobs, Sam",1,0,0,1,0,0,11,2
Adelaide,"Jenkins, Josh",13,8,5,5,3,2,4,0
Adelaide,"Kerridge, Sam",24,14,8,10,6,0,0,1
Adelaide,"Laird, Rory",17,5,2,12,0,0,0,3
Adelaide,"Lynch, Tom",19,12,8,7,0,0,0,1
Adelaide,"Lyons, Jarryd",21,11,1,10,0,1,0,4
Adelaide,"Mackay, David",15,8,3,7,0,2,0,1
Adelaide,"McKernan, Shaun",15,10,2,5,1,2,7,2
Adelaide,"Otten, Andy",8,4,3,4,0,0,0,3
Adelaide,"Petrenko, Jared",15,10,3,5,2,2,0,1
Adelaide,"Porplyzia, Jason",10,4,1,6,1,0,0,0
Adelaide,"Reilly, Brent",12,6,3,6,0,0,0,1
Adelaide,"Rutten, Ben",13,3,4,10,0,0,0,1
Adelaide,"Sloane, Rory",16,6,2,10,1,1,1,2
Adelaide,"Smith, Brodie",15,9,2,6,0,0,0,0
Adelaide,"Talia, Daniel",14,8,4,6,0,0,0,1
Adelaide,"Thompson, Scott",24,16,6,8,0,1,0,6
Adelaide,"Vince, Bernie",21,17,4,4,2,0,0,3
Adelaide,"van Berlo, Nathan",14,9,6,5,0,0,0,2
Adelaide,"Brown, Luke",19,10,2,9,0,0,0,3
Adelaide,"Dangerfield, Patrick",21,15,4,6,3,1,6,1
Adelaide,"Douglas, Richard",23,17,4,6,1,0,0,7
Adelaide,"Jacobs, Sam",11,9,2,2,0,0,50,3
Adelaide,"Jenkins, Josh",9,5,1,4,1,1,3,4
Adelaide,"Kerridge, Sam",10,5,3,5,0,1,0,3
Adelaide,"Laird, Rory",24,10,2,14,1,0,0,7
Adelaide,"Lynch, Tom",13,11,8,2,0,2,0,0
Adelaide,"Lyons, Jarryd",18,11,4,7,0,1,0,5
Adelaide,"Mackay, David",5,2,0,3,0,0,0,4
Adelaide,"Martin, Brodie",9,8,2,1,0,1,0,1
Adelaide,"Otten, Andy",16,10,4,6,0,0,0,4
Adelaide,"Petrenko, Jared",11,6,2,5,1,0,0,10
Adelaide,"Porplyzia, Jason",15,10,3,5,1,1,0,4
Adelaide,"Reilly, Brent",15,10,1,5,0,0,0,1
Adelaide,"Rutten, Ben",8,5,4,3,0,0,1,1
Adelaide,"Sloane, Rory",30,19,3,11,0,1,0,5
Adelaide,"Smith, Brodie",21,17,3,4,0,0,0,1
Adelaide,"Talia, Daniel",9,4,0,5,0,0,0,3
Adelaide,"Thompson, Scott",24,12,0,12,0,0,1,8
Adelaide,"Vince, Bernie",21,12,4,9,0,0,0,2
Adelaide,"van Berlo, Nathan",23,16,4,7,0,0,0,1
Adelaide,"Callinan, Ian",17,7,2,10,1,2,0,4
Adelaide,"Crouch, Brad",19,9,4,10,0,1,0,3
Adelaide,"Dangerfield, Patrick",27,16,3,11,1,0,2,2
Adelaide,"Douglas, Richard",29,17,7,12,0,3,0,6
Adelaide,"Henderson, Ricky",22,15,6,7,0,0,0,3
Adelaide,"Jacobs, Sam",14,5,3,9,0,0,24,3
Adelaide,"Jenkins, Josh",12,9,4,3,0,0,0,1
Adelaide,"Kerridge, Sam",10,2,3,8,0,0,0,4
Adelaide,"Laird, Rory",18,6,5,12,0,0,0,3
Adelaide,"Lynch, Tom",24,15,8,9,1,2,0,3
Adelaide,"McKernan, Shaun",16,6,4,10,2,1,6,2
Adelaide,"Otten, Andy",13,4,3,9,0,0,0,3
Adelaide,"Petrenko, Jared",7,4,1,3,0,1,0,0
Adelaide,"Porplyzia, Jason",16,8,4,8,0,0,1,2
Adelaide,"Reilly, Brent",16,10,3,6,0,0,0,4
Adelaide,"Rutten, Ben",19,7,6,12,0,0,0,1
Adelaide,"Sloane, Rory",31,12,3,19,0,0,0,4
Adelaide,"Smith, Brodie",18,13,0,5,0,2,0,5
Adelaide,"Talia, Daniel",20,8,4,12,0,0,0,2
Adelaide,"Thompson, Scott",21,8,1,13,0,0,0,6
Adelaide,"Vince, Bernie",25,17,2,8,1,1,0,7
Adelaide,"van Berlo, Nathan",16,7,1,9,0,0,0,6
Adelaide,"Brown, Luke",9,6,5,3,0,0,0,2
Adelaide,"Callinan, Ian",13,7,1,6,1,0,0,3
Adelaide,"Dangerfield, Patrick",28,17,1,11,2,4,6,4
Adelaide,"Douglas, Richard",23,19,7,4,0,0,0,2
Adelaide,"Henderson, Ricky",3,2,0,1,0,0,1,1
Adelaide,"Jacobs, Sam",8,6,4,2,0,0,36,1
Adelaide,"Jaensch, Matthew",19,13,7,6,0,0,0,2
Adelaide,"Jenkins, Josh",14,11,3,3,2,2,1,2
Adelaide,"Laird, Rory",11,6,4,5,0,0,0,2
Adelaide,"Lynch, Tom",19,11,5,8,1,2,0,1
Adelaide,"Mackay, David",20,7,4,13,1,0,0,4
Adelaide,"McKernan, Shaun",8,5,3,3,0,1,10,2
Adelaide,"Otten, Andy",13,6,3,7,0,0,0,5
Adelaide,"Porplyzia, Jason",21,12,3,9,1,0,0,7
Adelaide,"Rutten, Ben",14,9,6,5,0,0,0,1
Adelaide,"Sloane, Rory",23,10,4,13,0,1,1,4
Adelaide,"Smith, Brodie",12,8,3,4,0,0,0,2
Adelaide,"Talia, Daniel",12,7,5,5,0,0,0,3
Adelaide,"Thompson, Scott",29,14,6,15,1,0,0,5
Adelaide,"Vince, Bernie",19,15,1,4,0,0,0,3
Adelaide,"Wright, Matthew",20,6,5,14,0,0,0,1
Adelaide,"van Berlo, Nathan",14,11,2,3,1,1,0,2
Adelaide,"Brown, Luke",20,12,6,8,0,0,0,2
Adelaide,"Crouch, Brad",31,14,6,17,0,0,0,6
Adelaide,"Dangerfield, Patrick",27,16,7,11,1,1,1,4
Adelaide,"Douglas, Richard",22,14,5,8,1,1,0,2
Adelaide,"Henderson, Ricky",25,16,9,9,0,0,0,3
Adelaide,"Jacobs, Sam",16,8,4,8,0,0,38,2
Adelaide,"Jaensch, Matthew",9,6,3,3,0,0,0,2
Adelaide,"Jenkins, Josh",16,12,8,4,2,2,3,2
Adelaide,"Laird, Rory",29,19,10,10,0,0,0,0
Adelaide,"Lynch, Tom",17,11,7,6,2,1,0,3
Adelaide,"Otten, Andy",15,9,5,6,0,0,0,1
Adelaide,"Porplyzia, Jason",19,10,7,9,2,2,0,2
Adelaide,"Reilly, Brent",0,0,0,0,0,0,0,0
Adelaide,"Riley, Aidan",14,6,3,8,1,0,0,0
Adelaide,"Rutten, Ben",16,9,7,7,0,1,0,2
Adelaide,"Sloane, Rory",19,9,4,10,0,0,2,2
Adelaide,"Smith, Brodie",26,17,8,9,1,0,0,2
Adelaide,"Talia, Daniel",10,7,6,3,0,0,0,5
Adelaide,"Thompson, Scott",21,10,5,11,0,1,0,2
Adelaide,"Vince, Bernie",21,13,7,8,1,1,0,1
Adelaide,"Wright, Matthew",16,9,2,7,4,0,0,0
Adelaide,"van Berlo, Nathan",19,17,7,2,1,1,0,2
Adelaide,"Brown, Luke",9,8,4,1,0,0,0,0
Adelaide,"Crouch, Brad",26,15,5,11,0,0,0,2
Adelaide,"Dangerfield, Patrick",26,13,4,13,1,0,3,3
Adelaide,"Douglas, Richard",22,14,4,8,0,2,0,5
Adelaide,"Henderson, Ricky",21,17,10,4,0,0,0,0
Adelaide,"Jacobs, Sam",9,5,5,4,0,1,20,1
Adelaide,"Jaensch, Matthew",11,8,4,3,0,1,0,1
Adelaide,"Jenkins, Josh",8,3,2,5,1,0,0,1
Adelaide,"Laird, Rory",17,10,3,7,0,0,0,2
Adelaide,"Lynch, Tom",15,10,4,5,2,1,0,4
Adelaide,"McKernan, Shaun",13,8,4,5,1,2,12,4
Adelaide,"Otten, Andy",18,9,6,9,0,0,0,1
Adelaide,"Porplyzia, Jason",15,13,4,2,2,3,0,2
Adelaide,"Riley, Aidan",0,0,0,0,0,0,0,0
Adelaide,"Rutten, Ben",12,7,4,5,0,0,0,1
Adelaide,"Sloane, Rory",22,11,4,11,1,1,1,2
Adelaide,"Smith, Brodie",20,18,5,2,0,0,0,2
Adelaide,"Talia, Daniel",12,7,4,5,0,0,0,2
Adelaide,"Thompson, Scott",28,13,3,15,0,0,1,5
Adelaide,"Vince, Bernie",21,16,6,5,0,1,0,4
Adelaide,"Wright, Matthew",12,7,1,5,1,1,0,3
Adelaide,"van Berlo, Nathan",13,6,2,7,0,0,0,6
Adelaide,"Brown, Luke",19,11,6,8,0,0,0,3
Adelaide,"Crouch, Brad",22,13,7,9,0,1,0,7
Adelaide,"Dangerfield, Patrick",15,10,4,5,0,1,1,4
Adelaide,"Douglas, Richard",24,14,6,10,1,2,0,4
Adelaide,"Henderson, Ricky",25,18,7,7,0,0,0,4
Adelaide,"Jacobs, Sam",14,8,7,6,0,0,18,1
Adelaide,"Jaensch, Matthew",3,2,1,1,0,0,0,0
Adelaide,"Jenkins, Josh",7,6,4,1,0,3,6,2
Adelaide,"Laird, Rory",22,11,4,11,0,0,0,1
Adelaide,"Lynch, Tom",22,15,11,7,4,1,0,1
Adelaide,"Lyons, Jarryd",17,10,3,7,4,1,0,2
Adelaide,"Mackay, David",18,10,5,8,0,0,0,1
Adelaide,"Otten, Andy",4,3,3,1,0,0,0,2
Adelaide,"Porplyzia, Jason",19,13,7,6,3,1,0,2
Adelaide,"Rutten, Ben",12,10,4,2,0,0,0,0
Adelaide,"Sloane, Rory",18,8,6,10,0,0,0,5
Adelaide,"Smith, Brodie",20,16,10,4,0,0,0,1
Adelaide,"Talia, Daniel",9,5,4,4,0,0,0,0
Adelaide,"Thompson, Scott",23,10,4,13,0,0,0,4
Adelaide,"Vince, Bernie",21,17,6,4,0,0,0,3
Adelaide,"Wright, Matthew",10,2,3,8,0,0,0,1
Adelaide,"van Berlo, Nathan",14,12,4,2,0,1,0,8
Adelaide,"Brown, Luke",17,7,2,10,0,0,0,3
Adelaide,"Crouch, Brad",23,13,3,10,1,0,0,3
Adelaide,"Douglas, Richard",33,21,5,12,0,1,0,3
Adelaide,"Grigg, Mitch",12,5,1,7,0,0,0,2
Adelaide,"Henderson, Ricky",32,20,9,12,0,1,0,4
Adelaide,"Jacobs, Sam",11,5,3,6,0,1,25,7
Adelaide,"Jenkins, Josh",18,11,6,7,1,0,3,2
Adelaide,"Laird, Rory",21,10,3,11,0,0,0,2
Adelaide,"Lynch, Tom",14,10,5,4,3,1,0,2
Adelaide,"Lyons, Jarryd",16,10,1,6,0,1,0,2
Adelaide,"Mackay, David",25,12,4,13,0,0,0,2
Adelaide,"Otten, Andy",15,10,3,5,2,0,0,3
Adelaide,"Porplyzia, Jason",11,4,3,7,0,2,0,2
Adelaide,"Rutten, Ben",10,5,5,5,0,0,0,4
Adelaide,"Sloane, Rory",27,11,6,16,0,0,1,2
Adelaide,"Smith, Brodie",20,14,4,6,0,1,0,2
Adelaide,"Talia, Daniel",13,7,6,6,0,0,0,1
Adelaide,"Tambling, Richard",24,12,9,12,0,0,0,4
Adelaide,"Thompson, Scott",15,9,3,6,0,1,0,6
Adelaide,"Vince, Bernie",25,16,4,9,2,0,0,4
Adelaide,"Wright, Matthew",14,8,4,6,4,0,0,3
Adelaide,"van Berlo, Nathan",20,13,1,7,1,0,1,7
Adelaide,"Brown, Luke",17,11,9,6,0,0,0,0
Adelaide,"Crouch, Brad",28,9,5,19,0,0,0,5
Adelaide,"Douglas, Richard",16,11,2,5,0,1,0,4
Adelaide,"Hartigan, Kyle",19,10,7,9,0,0,0,1
Adelaide,"Henderson, Ricky",23,18,6,5,1,0,0,1
Adelaide,"Jacobs, Sam",13,6,3,7,0,0,15,0
Adelaide,"Jenkins, Josh",6,3,1,3,0,0,0,1
Adelaide,"Laird, Rory",21,13,6,8,0,0,0,3
Adelaide,"Lynch, Tom",20,13,8,7,2,3,0,2
Adelaide,"Lyons, Jarryd",20,10,4,10,1,0,0,2
Adelaide,"Mackay, David",21,11,6,10,0,1,0,6
Adelaide,"McKernan, Shaun",8,5,3,3,1,2,9,2
Adelaide,"Otten, Andy",18,8,4,10,0,0,0,2
Adelaide,"Porplyzia, Jason",11,5,2,6,0,0,0,1
Adelaide,"Sloane, Rory",30,7,7,23,0,2,0,7
Adelaide,"Smith, Brodie",21,10,6,11,0,0,0,1
Adelaide,"Talia, Daniel",17,7,4,10,0,0,0,3
Adelaide,"Tambling, Richard",7,3,2,4,0,0,0,1
Adelaide,"Thompson, Scott",21,10,5,11,1,0,0,6
Adelaide,"Vince, Bernie",25,20,6,5,1,1,0,6
Adelaide,"Wright, Matthew",19,9,6,10,0,1,0,3
Adelaide,"van Berlo, Nathan",21,11,3,10,0,0,1,6
Adelaide,"Brown, Luke",18,11,4,7,1,0,0,4
Adelaide,"Crouch, Brad",28,9,6,19,0,2,0,5
Adelaide,"Dangerfield, Patrick",17,14,4,3,4,0,1,3
Adelaide,"Douglas, Richard",12,11,3,1,0,0,0,6
Adelaide,"Grigg, Mitch",15,11,2,4,1,0,0,1
Adelaide,"Henderson, Ricky",18,10,5,8,1,0,0,2
Adelaide,"Jacobs, Sam",13,8,3,5,0,0,38,1
Adelaide,"Johnston, Lewis",17,13,7,4,4,1,0,1
Adelaide,"Laird, Rory",15,10,2,5,0,1,0,2
Adelaide,"Lynch, Tom",15,9,6,6,0,2,0,1
Adelaide,"Lyons, Jarryd",11,7,3,4,0,1,0,1
Adelaide,"Mackay, David",20,16,4,4,0,1,0,8
Adelaide,"McKernan, Shaun",9,8,3,1,0,1,12,2
Adelaide,"Otten, Andy",13,5,4,8,0,1,0,1
Adelaide,"Petrenko, Jared",13,9,3,4,2,1,0,3
Adelaide,"Rutten, Ben",19,6,4,13,0,0,0,1
Adelaide,"Smith, Brodie",15,13,3,2,0,0,0,0
Adelaide,"Talia, Daniel",6,6,3,0,0,0,0,1
Adelaide,"Thompson, Scott",17,8,2,9,0,0,0,9
Adelaide,"Vince, Bernie",24,14,5,10,0,2,1,2
Adelaide,"Wright, Matthew",22,11,9,11,2,0,0,3
Adelaide,"van Berlo, Nathan",17,11,5,6,0,0,0,7
Adelaide,"Brown, Luke",12,8,5,4,0,0,0,1
Adelaide,"Crouch, Brad",26,11,6,15,0,0,0,5
Adelaide,"Dangerfield, Patrick",25,20,5,5,1,2,3,1
Adelaide,"Douglas, Richard",27,14,3,13,2,1,0,3
Adelaide,"Grigg, Mitch",18,9,2,9,1,0,0,4
Adelaide,"Henderson, Ricky",24,17,8,7,0,0,0,2
Adelaide,"Jacobs, Sam",13,7,5,6,0,0,33,2
Adelaide,"Johnston, Lewis",11,6,1,5,1,1,2,4
Adelaide,"Laird, Rory",24,14,7,10,0,1,0,3
Adelaide,"Lynch, Tom",13,9,3,4,1,0,0,0
Adelaide,"Mackay, David",14,7,2,7,0,1,1,6
Adelaide,"Otten, Andy",16,8,4,8,2,0,6,2
Adelaide,"Petrenko, Jared",13,8,3,5,1,1,0,2
Adelaide,"Rutten, Ben",11,6,7,5,0,0,0,0
Adelaide,"Shaw, Sam",12,8,3,4,0,0,0,5
Adelaide,"Sloane, Rory",28,16,10,12,2,1,0,8
Adelaide,"Smith, Brodie",19,11,5,8,0,0,0,1
Adelaide,"Talia, Daniel",16,12,9,4,0,0,0,2
Adelaide,"Thompson, Scott",11,7,3,4,0,0,0,4
Adelaide,"Vince, Bernie",16,8,4,8,0,0,1,2
Adelaide,"Wright, Matthew",6,2,2,4,0,0,0,1
Adelaide,"van Berlo, Nathan",12,4,2,8,0,1,0,1
Adelaide,"Brown, Luke",13,8,4,5,0,0,0,3
Adelaide,"Callinan, Ian",14,6,5,8,3,0,0,1
Adelaide,"Crouch, Brad",22,9,3,13,0,0,0,4
Adelaide,"Dangerfield, Patrick",16,11,3,5,1,0,3,4
Adelaide,"Douglas, Richard",23,16,4,7,1,3,0,1
Adelaide,"Jacobs, Sam",8,5,2,3,0,0,24,2
Adelaide,"Jaensch, Matthew",11,5,5,6,0,0,0,3
Adelaide,"Johnston, Lewis",13,10,5,3,0,3,1,4
Adelaide,"Kerridge, Sam",3,1,0,2,0,0,0,0
Adelaide,"Laird, Rory",20,10,4,10,0,0,0,2
Adelaide,"Lynch, Tom",17,12,6,5,3,1,0,0
Adelaide,"Mackay, David",13,5,3,8,1,0,0,4
Adelaide,"Otten, Andy",13,8,7,5,3,1,0,1
Adelaide,"Petrenko, Jared",6,3,1,3,1,0,0,3
Adelaide,"Rutten, Ben",13,7,3,6,0,0,0,2
Adelaide,"Shaw, Sam",9,7,4,2,0,0,0,0
Adelaide,"Sloane, Rory",17,8,2,9,2,0,4,2
Adelaide,"Smith, Brodie",17,9,1,8,0,0,0,1
Adelaide,"Talia, Daniel",6,5,1,1,0,0,0,0
Adelaide,"Thompson, Scott",26,16,1,10,0,0,0,6
Adelaide,"Vince, Bernie",27,16,3,11,1,1,1,4
Adelaide,"van Berlo, Nathan",15,9,2,6,1,1,0,4
Adelaide,"Brown, Luke",24,12,6,12,0,0,0,0
Adelaide,"Callinan, Ian",12,7,3,5,2,0,0,4
Adelaide,"Crouch, Brad",31,15,5,16,0,1,0,5
Adelaide,"Dangerfield, Patrick",21,11,1,10,1,0,6,5
Adelaide,"Douglas, Richard",21,11,4,10,2,0,0,3
Adelaide,"Grigg, Mitch",21,16,7,5,1,2,0,7
Adelaide,"Hartigan, Kyle",19,10,9,9,0,0,0,0
Adelaide,"Jacobs, Sam",13,9,4,4,1,0,42,2
Adelaide,"Johnston, Lewis",13,12,6,1,6,2,2,2
Adelaide,"Kerridge, Sam",23,11,6,12,1,1,0,1
Adelaide,"Laird, Rory",22,16,8,6,0,0,0,3
Adelaide,"Mackay, David",6,2,1,4,0,0,0,1
Adelaide,"Otten, Andy",16,8,4,8,1,0,6,4
Adelaide,"Petrenko, Jared",4,2,2,2,0,0,0,4
Adelaide,"Rutten, Ben",13,5,5,8,0,0,0,1
Adelaide,"Sloane, Rory",24,11,5,13,0,1,1,6
Adelaide,"Smith, Brodie",18,8,3,10,0,0,0,0
Adelaide,"Talia, Daniel",11,7,8,4,1,0,0,1
Adelaide,"Tambling, Richard",25,7,5,18,0,0,0,2
Adelaide,"Thompson, Scott",33,17,7,16,1,1,0,7
Adelaide,"Vince, Bernie",14,10,2,4,0,0,2,2
Adelaide,"van Berlo, Nathan",20,11,3,9,1,0,0,4
Adelaide,"Brown, Luke",21,11,4,10,0,0,0,0
Adelaide,"Callinan, Ian",8,5,0,3,1,1,0,3
Adelaide,"Crouch, Brad",29,14,4,15,2,0,0,5
Adelaide,"Dangerfield, Patrick",29,18,8,11,3,2,4,2
Adelaide,"Douglas, Richard",26,12,4,14,0,1,0,3
Adelaide,"Grigg, Mitch",15,12,0,3,3,0,0,3
Adelaide,"Hartigan, Kyle",18,7,6,11,0,0,0,1
Adelaide,"Jacobs, Sam",9,6,2,3,0,0,29,3
Adelaide,"Johnston, Lewis",12,10,3,2,0,1,0,4
Adelaide,"Kerridge, Sam",22,10,7,12,0,1,0,5
Adelaide,"Laird, Rory",16,8,0,8,0,0,0,1
Adelaide,"Mackay, David",6,4,1,2,0,0,0,0
Adelaide,"Otten, Andy",20,9,6,11,3,1,2,1
Adelaide,"Rutten, Ben",10,5,5,5,0,0,0,1
Adelaide,"Sloane, Rory",23,13,5,10,2,0,0,2
Adelaide,"Smith, Brodie",29,16,4,13,1,0,0,0
Adelaide,"Talia, Daniel",10,7,6,3,0,0,0,0
Adelaide,"Tambling, Richard",12,7,3,5,1,0,0,4
Adelaide,"Thompson, Scott",33,18,4,15,2,1,0,5
Adelaide,"Vince, Bernie",24,12,3,12,0,0,0,1
Adelaide,"Wright, Matthew",15,11,5,4,0,0,0,3
Adelaide,"van Berlo, Nathan",15,11,3,4,1,1,0,0
Brisbane Lions,"Adcock, Jed",12,8,2,4,0,0,0,5
Brisbane Lions,"Beams, Claye",9,6,3,3,1,0,0,2
Brisbane Lions,"Bewick, Rohan",12,10,0,2,0,1,2,3
Brisbane Lions,"Brown, Jonathan",11,6,3,5,1,1,0,1
Brisbane Lions,"Cornelius, Aaron",10,6,4,4,1,3,0,1
Brisbane Lions,"Golby, Mitch",22,9,4,13,0,0,0,2
Brisbane Lions,"Green, Josh",15,9,0,6,0,1,0,6
Brisbane Lions,"Hanley, Pearce",22,14,3,8,0,0,0,5
Brisbane Lions,"Karnezis, Patrick",19,7,5,12,0,1,0,2
Brisbane Lions,"Longer, Billy",7,2,1,5,0,0,21,3
Brisbane Lions,"Maguire, Matt",5,3,2,2,0,0,0,2
Brisbane Lions,"Martin, Stefan",9,5,2,4,1,1,9,1
Brisbane Lions,"McGrath, Ashley",8,4,2,4,0,1,0,3
Brisbane Lions,"Merrett, Daniel",18,12,6,6,0,0,0,2
Brisbane Lions,"Moloney, Brent",23,13,5,10,1,0,0,5
Brisbane Lions,"Patfull, Joel",12,6,3,6,0,0,0,4
Brisbane Lions,"Polkinghorne, James",6,4,1,2,0,1,1,1
Brisbane Lions,"Redden, Jack",15,5,1,10,1,1,0,10
Brisbane Lions,"Rich, Daniel",8,5,1,3,1,1,0,3
Brisbane Lions,"Rockliff, Tom",33,15,4,18,0,0,1,5
Brisbane Lions,"Yeo, Elliot",16,9,1,7,0,0,0,3
Brisbane Lions,"Zorko, Dayne",12,10,1,2,0,2,0,4
Brisbane Lions,"Adcock, Jed",16,11,2,5,0,0,0,1
Brisbane Lions,"Beams, Claye",15,8,3,7,0,2,0,0
Brisbane Lions,"Bewick, Rohan",9,7,4,2,1,2,0,4
Brisbane Lions,"Brown, Jonathan",9,5,3,4,0,1,0,1
Brisbane Lions,"Golby, Mitch",19,9,4,10,0,1,0,2
Brisbane Lions,"Green, Josh",9,5,2,4,2,0,0,5
Brisbane Lions,"Hanley, Pearce",30,23,6,7,1,1,1,5
Brisbane Lions,"Karnezis, Patrick",1,1,0,0,0,1,0,2
Brisbane Lions,"Lester, Ryan",19,10,6,9,0,0,0,3
Brisbane Lions,"Leuenberger, Matthew",11,4,2,7,0,0,32,3
Brisbane Lions,"Martin, Stefan",6,5,1,1,2,1,18,2
Brisbane Lions,"McGrath, Ashley",6,2,0,4,0,0,0,0
Brisbane Lions,"Merrett, Daniel",19,13,6,6,0,0,0,3
Brisbane Lions,"Moloney, Brent",24,11,3,13,0,0,0,9
Brisbane Lions,"Patfull, Joel",8,3,2,5,0,0,0,2
Brisbane Lions,"Polkinghorne, James",13,9,5,4,1,1,0,0
Brisbane Lions,"Raines, Andrew",19,12,1,7,0,2,0,2
Brisbane Lions,"Redden, Jack",15,8,3,7,0,0,0,7
Brisbane Lions,"Rich, Daniel",16,9,1,7,0,0,0,2
Brisbane Lions,"Rockliff, Tom",20,9,3,11,1,1,0,4
Brisbane Lions,"Yeo, Elliot",13,8,3,5,0,0,0,4
Brisbane Lions,"Zorko, Dayne",13,10,6,3,2,1,0,4
Brisbane Lions,"Adcock, Jed",12,10,4,2,0,0,0,6
Brisbane Lions,"Bewick, Rohan",18,10,3,8,1,1,0,4
Brisbane Lions,"Brown, Jonathan",19,14,8,5,5,1,0,1
Brisbane Lions,"Golby, Mitch",16,10,2,6,0,0,0,0
Brisbane Lions,"Green, Josh",14,9,3,5,2,1,0,5
Brisbane Lions,"Hanley, Pearce",26,18,6,8,1,0,0,5
Brisbane Lions,"Leuenberger, Matthew",11,7,1,4,1,0,30,4
Brisbane Lions,"Martin, Stefan",9,4,1,5,1,0,2,2
Brisbane Lions,"Mayes, Sam",21,15,10,6,0,0,0,2
Brisbane Lions,"McGrath, Ashley",12,8,1,4,0,0,0,1
Brisbane Lions,"McKeever, Niall",9,5,2,4,0,0,3,1
Brisbane Lions,"Merrett, Daniel",14,8,2,6,0,0,0,2
Brisbane Lions,"Moloney, Brent",21,11,4,10,0,0,0,5
Brisbane Lions,"Patfull, Joel",9,5,3,4,0,0,0,2
Brisbane Lions,"Polec, Jared",9,4,0,5,0,0,0,2
Brisbane Lions,"Polkinghorne, James",8,6,3,2,1,0,0,0
Brisbane Lions,"Raines, Andrew",21,11,0,10,0,0,0,4
Brisbane Lions,"Redden, Jack",26,13,3,13,0,0,0,9
Brisbane Lions,"Rich, Daniel",27,17,1,10,0,1,0,3
Brisbane Lions,"Rockliff, Tom",22,13,2,9,1,1,0,6
Brisbane Lions,"Yeo, Elliot",13,8,4,5,0,0,0,1
Brisbane Lions,"Zorko, Dayne",18,10,1,8,0,0,0,3
Brisbane Lions,"Adcock, Jed",29,18,6,11,0,0,0,6
Brisbane Lions,"Bewick, Rohan",15,8,6,7,2,1,0,1
Brisbane Lions,"Brown, Jonathan",11,9,8,2,0,2,0,0
Brisbane Lions,"Docherty, Sam",20,7,2,13,0,0,0,1
Brisbane Lions,"Golby, Mitch",17,6,4,11,0,0,0,2
Brisbane Lions,"Green, Josh",10,8,4,2,1,0,0,4
Brisbane Lions,"Hanley, Pearce",17,12,5,5,0,0,0,1
Brisbane Lions,"Harwood, Ryan",11,6,1,5,0,0,0,3
Brisbane Lions,"Leuenberger, Matthew",19,6,6,13,0,1,21,1
Brisbane Lions,"Martin, Stefan",7,4,3,3,0,1,4,0
Brisbane Lions,"Mayes, Sam",18,12,5,6,0,0,0,3
Brisbane Lions,"McGrath, Ashley",0,0,0,0,0,0,0,0
Brisbane Lions,"McKeever, Niall",10,2,3,8,1,0,0,3
Brisbane Lions,"Merrett, Daniel",9,5,5,4,0,0,0,1
Brisbane Lions,"Moloney, Brent",22,10,1,12,0,0,0,3
Brisbane Lions,"Paparone, Marco",10,8,7,2,3,0,0,1
Brisbane Lions,"Patfull, Joel",12,6,6,6,0,0,0,3
Brisbane Lions,"Raines, Andrew",12,3,3,9,0,0,0,4
Brisbane Lions,"Redden, Jack",23,16,6,7,0,0,0,5
Brisbane Lions,"Rich, Daniel",15,12,1,3,0,1,0,1
Brisbane Lions,"Rockliff, Tom",34,20,5,14,1,0,0,2
Brisbane Lions,"Zorko, Dayne",21,10,2,11,1,1,0,5
Brisbane Lions,"Adcock, Jed",24,15,6,9,1,0,0,0
Brisbane Lions,"Bewick, Rohan",21,11,7,10,1,3,0,2
Brisbane Lions,"Brown, Jonathan",19,12,6,7,3,1,0,0
Brisbane Lions,"Clarke, Justin",7,4,3,3,0,0,0,3
Brisbane Lions,"Cornelius, Aaron",10,6,5,4,2,1,0,1
Brisbane Lions,"Docherty, Sam",5,3,1,2,0,0,0,2
Brisbane Lions,"Golby, Mitch",27,14,3,13,0,1,0,3
Brisbane Lions,"Green, Josh",10,8,2,2,0,1,0,5
Brisbane Lions,"Leuenberger, Matthew",16,9,4,7,3,0,23,1
Brisbane Lions,"Longer, Billy",5,2,2,3,0,0,20,1
Brisbane Lions,"Mayes, Sam",28,19,9,9,0,0,0,2
Brisbane Lions,"McGrath, Ashley",23,13,4,10,0,0,0,4
Brisbane Lions,"Merrett, Daniel",11,5,4,6,0,0,0,0
Brisbane Lions,"Moloney, Brent",36,10,2,26,0,2,0,3
Brisbane Lions,"Paparone, Marco",11,7,3,4,1,1,0,0
Brisbane Lions,"Patfull, Joel",13,9,7,4,0,0,0,1
Brisbane Lions,"Polkinghorne, James",30,17,8,13,1,1,0,1
Brisbane Lions,"Raines, Andrew",20,8,3,12,0,1,0,3
Brisbane Lions,"Redden, Jack",24,9,4,15,1,1,0,4
Brisbane Lions,"Rockliff, Tom",34,13,4,21,1,0,0,7
Brisbane Lions,"Yeo, Elliot",17,9,2,8,0,1,0,1
Brisbane Lions,"Zorko, Dayne",29,16,2,13,3,4,0,6
Brisbane Lions,"Adcock, Jed",21,13,3,8,0,1,0,8
Brisbane Lions,"Bewick, Rohan",12,5,2,7,0,0,1,2
Brisbane Lions,"Brown, Jonathan",15,7,6,8,1,0,0,2
Brisbane Lions,"Clarke, Justin",10,6,3,4,0,0,0,1
Brisbane Lions,"Cornelius, Aaron",3,3,1,0,0,0,0,2
Brisbane Lions,"Golby, Mitch",22,11,6,11,0,0,0,2
Brisbane Lions,"Green, Josh",9,7,1,2,2,0,0,1
Brisbane Lions,"Hanley, Pearce",25,16,4,9,1,0,0,4
Brisbane Lions,"Lester, Ryan",27,10,3,17,1,0,0,6
Brisbane Lions,"Leuenberger, Matthew",13,7,2,6,1,1,22,0
Brisbane Lions,"Longer, Billy",10,5,1,5,0,1,11,4
Brisbane Lions,"Mayes, Sam",18,12,5,6,0,0,0,0
Brisbane Lions,"McGrath, Ashley",11,6,2,5,0,0,0,2
Brisbane Lions,"Merrett, Daniel",16,8,3,8,0,0,1,1
Brisbane Lions,"Moloney, Brent",23,13,3,10,0,0,0,4
Brisbane Lions,"Paparone, Marco",11,4,0,7,0,1,0,2
Brisbane Lions,"Patfull, Joel",12,5,3,7,0,0,0,1
Brisbane Lions,"Polkinghorne, James",25,12,5,13,0,1,0,1
Brisbane Lions,"Redden, Jack",23,11,5,12,1,1,0,7
Brisbane Lions,"Rockliff, Tom",22,9,2,13,0,0,0,6
Brisbane Lions,"Yeo, Elliot",17,8,5,9,0,0,0,3
Brisbane Lions,"Zorko, Dayne",11,4,2,7,1,0,0,6
Brisbane Lions,"Adcock, Jed",18,14,3,4,0,0,0,4
Brisbane Lions,"Bewick, Rohan",11,6,4,5,2,1,0,2
Brisbane Lions,"Black, Simon",12,10,1,2,1,0,0,1
Brisbane Lions,"Brown, Jonathan",6,5,5,1,2,0,0,0
Brisbane Lions,"Clarke, Justin",22,14,12,8,0,0,0,0
Brisbane Lions,"Golby, Mitch",22,14,10,8,2,0,0,3
Brisbane Lions,"Green, Josh",11,4,1,7,0,2,0,3
Brisbane Lions,"Hanley, Pearce",31,24,11,7,0,1,1,2
Brisbane Lions,"Lester, Ryan",16,10,1,6,0,0,0,2
Brisbane Lions,"Leuenberger, Matthew",16,11,5,5,1,0,33,0
Brisbane Lions,"Lisle, Jordan",12,6,2,6,1,0,7,3
Brisbane Lions,"Mayes, Sam",15,6,2,9,0,0,0,3
Brisbane Lions,"McGrath, Ashley",14,10,2,4,1,1,0,2
Brisbane Lions,"Merrett, Daniel",14,8,9,6,0,0,0,1
Brisbane Lions,"Moloney, Brent",26,15,3,11,0,0,0,9
Brisbane Lions,"Patfull, Joel",15,10,8,5,0,0,0,1
Brisbane Lions,"Polkinghorne, James",20,13,5,7,0,0,0,4
Brisbane Lions,"Raines, Andrew",16,7,4,9,0,0,0,2
Brisbane Lions,"Redden, Jack",16,10,2,6,1,0,0,6
Brisbane Lions,"Rockliff, Tom",34,13,2,21,0,0,0,9
Brisbane Lions,"Yeo, Elliot",16,8,3,8,0,0,0,4
Brisbane Lions,"Zorko, Dayne",11,5,5,6,1,1,0,9
Brisbane Lions,"Adcock, Jed",20,16,6,4,0,0,0,4
Brisbane Lions,"Bewick, Rohan",15,12,9,3,0,1,0,4
Brisbane Lions,"Black, Simon",16,9,3,7,1,0,0,3
Brisbane Lions,"Brown, Jonathan",15,13,11,2,2,2,0,2
Brisbane Lions,"Clarke, Justin",10,6,2,4,0,0,0,1
Brisbane Lions,"Golby, Mitch",14,7,4,7,0,0,0,10
Brisbane Lions,"Hanley, Pearce",19,17,11,2,1,0,0,2
Brisbane Lions,"Lester, Ryan",16,11,4,5,0,2,0,0
Brisbane Lions,"Leuenberger, Matthew",7,5,2,2,1,0,43,1
Brisbane Lions,"Lisle, Jordan",15,10,8,5,1,2,2,1
Brisbane Lions,"Mayes, Sam",6,6,3,0,0,0,0,1
Brisbane Lions,"McGrath, Ashley",13,8,3,5,0,0,0,4
Brisbane Lions,"Merrett, Daniel",12,8,7,4,0,0,0,1
Brisbane Lions,"Moloney, Brent",15,9,2,6,1,0,0,7
Brisbane Lions,"Patfull, Joel",13,10,9,3,0,0,0,3
Brisbane Lions,"Polkinghorne, James",21,11,2,10,1,0,0,1
Brisbane Lions,"Raines, Andrew",14,5,2,9,1,0,0,2
Brisbane Lions,"Redden, Jack",22,11,2,11,1,1,0,12
Brisbane Lions,"Rockliff, Tom",17,10,6,7,0,3,0,4
Brisbane Lions,"Staker, Brent",12,10,6,2,1,1,0,1
Brisbane Lions,"Yeo, Elliot",14,9,4,5,0,0,0,2
Brisbane Lions,"Zorko, Dayne",19,13,3,6,3,0,0,6
Brisbane Lions,"Adcock, Jed",18,9,4,9,0,0,0,5
Brisbane Lions,"Bewick, Rohan",14,8,4,6,3,1,0,3
Brisbane Lions,"Black, Simon",22,8,3,14,0,1,0,4
Brisbane Lions,"Brown, Jonathan",11,10,8,1,1,3,0,4
Brisbane Lions,"Docherty, Sam",15,10,3,5,0,0,0,2
Brisbane Lions,"Green, Josh",6,4,1,2,1,0,0,1
Brisbane Lions,"Hanley, Pearce",19,16,6,3,1,0,0,0
Brisbane Lions,"Lester, Ryan",17,10,6,7,0,1,0,4
Brisbane Lions,"Leuenberger, Matthew",8,4,2,4,0,1,28,2
Brisbane Lions,"Lisle, Jordan",9,3,2,6,0,0,0,3
Brisbane Lions,"Mayes, Sam",10,8,3,2,0,0,0,2
Brisbane Lions,"McGrath, Ashley",8,5,2,3,0,0,0,2
Brisbane Lions,"Michael, Sam",4,0,1,4,0,0,0,1
Brisbane Lions,"Moloney, Brent",17,12,6,5,2,0,0,4
Brisbane Lions,"Patfull, Joel",12,11,7,1,0,0,0,5
Brisbane Lions,"Polkinghorne, James",16,7,3,9,1,1,0,0
Brisbane Lions,"Raines, Andrew",14,6,2,8,0,1,0,2
Brisbane Lions,"Redden, Jack",19,9,5,10,1,0,0,7
Brisbane Lions,"Rockliff, Tom",19,12,5,7,1,1,0,0
Brisbane Lions,"Staker, Brent",17,12,6,5,1,0,0,1
Brisbane Lions,"Yeo, Elliot",11,10,5,1,0,0,0,2
Brisbane Lions,"Zorko, Dayne",8,2,2,6,0,1,0,5
Brisbane Lions,"Adcock, Jed",19,14,4,5,0,0,0,2
Brisbane Lions,"Bewick, Rohan",7,6,4,1,1,0,0,0
Brisbane Lions,"Black, Simon",33,20,3,13,0,1,0,6
Brisbane Lions,"Clarke, Justin",12,11,4,1,0,0,0,2
Brisbane Lions,"Crisp, Jack",6,5,1,1,0,0,0,5
Brisbane Lions,"Docherty, Sam",10,6,3,4,0,1,0,2
Brisbane Lions,"Hanley, Pearce",10,6,1,4,0,1,0,2
Brisbane Lions,"Harwood, Ryan",19,9,6,10,0,0,0,2
Brisbane Lions,"Karnezis, Patrick",18,12,6,6,0,2,0,3
Brisbane Lions,"Lester, Ryan",14,6,3,8,0,0,0,4
Brisbane Lions,"Longer, Billy",6,2,2,4,0,0,18,5
Brisbane Lions,"McGrath, Ashley",11,8,6,3,3,1,0,3
Brisbane Lions,"Michael, Sam",3,2,1,1,0,0,7,1
Brisbane Lions,"Moloney, Brent",9,6,0,3,0,0,0,0
Brisbane Lions,"Paparone, Marco",15,10,6,5,1,1,0,1
Brisbane Lions,"Patfull, Joel",12,10,4,2,0,0,0,1
Brisbane Lions,"Polkinghorne, James",11,6,3,5,0,0,0,1
Brisbane Lions,"Raines, Andrew",11,4,3,7,0,0,0,2
Brisbane Lions,"Redden, Jack",22,14,3,8,1,0,2,9
Brisbane Lions,"Staker, Brent",10,9,4,1,1,1,0,2
Brisbane Lions,"Yeo, Elliot",13,5,3,8,0,0,0,0
Brisbane Lions,"Zorko, Dayne",21,9,5,12,0,0,0,8
Brisbane Lions,"Adcock, Jed",18,12,5,6,0,0,0,8
Brisbane Lions,"Bewick, Rohan",15,10,4,5,0,2,0,2
Brisbane Lions,"Black, Simon",13,7,2,6,0,0,0,2
Brisbane Lions,"Clarke, Justin",13,6,5,7,0,0,0,2
Brisbane Lions,"Docherty, Sam",6,4,3,2,0,0,0,0
Brisbane Lions,"Golby, Mitch",29,17,5,12,0,0,0,2
Brisbane Lions,"Hanley, Pearce",18,12,3,6,0,1,0,4
Brisbane Lions,"Harwood, Ryan",23,12,7,11,0,0,0,2
Brisbane Lions,"Lester, Ryan",25,10,6,15,0,0,0,3
Brisbane Lions,"Leuenberger, Matthew",11,8,5,3,0,1,25,5
Brisbane Lions,"Lisle, Jordan",11,10,7,1,3,0,0,0
Brisbane Lions,"Mayes, Sam",25,15,7,10,0,0,0,3
Brisbane Lions,"McGrath, Ashley",8,8,5,0,2,3,0,4
Brisbane Lions,"McKeever, Niall",10,4,3,6,0,0,9,3
Brisbane Lions,"Patfull, Joel",16,9,5,7,0,0,0,1
Brisbane Lions,"Raines, Andrew",7,3,0,4,0,0,0,2
Brisbane Lions,"Redden, Jack",24,12,5,12,0,0,0,4
Brisbane Lions,"Rich, Daniel",19,11,2,8,0,1,0,2
Brisbane Lions,"Rockliff, Tom",20,13,5,7,1,0,0,2
Brisbane Lions,"Staker, Brent",11,6,3,5,0,0,0,1
Brisbane Lions,"Yeo, Elliot",9,6,4,3,0,0,0,0
Brisbane Lions,"Zorko, Dayne",14,7,1,7,0,0,0,6
Brisbane Lions,"Adcock, Jed",19,11,3,8,1,0,0,2
Brisbane Lions,"Black, Simon",33,8,2,25,0,2,0,6
Brisbane Lions,"Brown, Jonathan",14,10,8,4,1,2,0,1
Brisbane Lions,"Clarke, Justin",8,5,3,3,0,0,0,0
Brisbane Lions,"Docherty, Sam",18,10,0,8,0,0,0,2
Brisbane Lions,"Golby, Mitch",16,9,1,7,1,0,0,2
Brisbane Lions,"Hanley, Pearce",19,9,1,10,1,0,0,0
Brisbane Lions,"Harwood, Ryan",5,4,0,1,0,0,0,2
Brisbane Lions,"Lester, Ryan",16,5,2,11,0,0,0,4
Brisbane Lions,"Leuenberger, Matthew",14,8,3,6,0,2,33,2
Brisbane Lions,"Lisle, Jordan",12,6,4,6,1,1,6,1
Brisbane Lions,"Mayes, Sam",5,4,1,1,0,0,0,0
Brisbane Lions,"McGrath, Ashley",8,5,2,3,3,0,0,3
Brisbane Lions,"Merrett, Daniel",19,10,5,9,0,0,0,5
Brisbane Lions,"Moloney, Brent",22,11,5,11,3,1,0,6
Brisbane Lions,"Patfull, Joel",16,9,5,7,1,0,0,1
Brisbane Lions,"Redden, Jack",24,12,4,12,0,1,3,7
Brisbane Lions,"Rich, Daniel",25,12,3,13,2,1,0,2
Brisbane Lions,"Rockliff, Tom",21,12,2,9,0,0,0,4
Brisbane Lions,"Staker, Brent",16,13,5,3,0,0,0,1
Brisbane Lions,"Yeo, Elliot",20,10,8,10,0,0,0,1
Brisbane Lions,"Zorko, Dayne",17,13,3,4,1,1,0,4
Brisbane Lions,"Adcock, Jed",23,11,5,12,0,0,0,3
Brisbane Lions,"Black, Simon",22,5,0,17,1,0,0,3
Brisbane Lions,"Brown, Jonathan",14,10,8,4,4,1,0,0
Brisbane Lions,"Clarke, Justin",6,3,3,3,0,0,0,1
Brisbane Lions,"Docherty, Sam",7,5,2,2,0,0,0,2
Brisbane Lions,"Golby, Mitch",13,10,2,3,2,0,0,2
Brisbane Lions,"Hanley, Pearce",23,17,4,6,1,1,0,1
Brisbane Lions,"Harwood, Ryan",7,3,0,4,0,0,0,3
Brisbane Lions,"Lester, Ryan",22,8,2,14,0,0,0,4
Brisbane Lions,"Leuenberger, Matthew",15,8,3,7,0,1,34,3
Brisbane Lions,"Lisle, Jordan",13,7,5,6,1,1,3,2
Brisbane Lions,"Maguire, Matt",14,12,8,2,0,0,0,5
Brisbane Lions,"McGrath, Ashley",7,6,1,1,0,0,0,5
Brisbane Lions,"Moloney, Brent",25,17,4,8,0,1,0,6
Brisbane Lions,"Patfull, Joel",10,1,0,9,0,0,0,1
Brisbane Lions,"Polkinghorne, James",9,2,2,7,0,0,0,2
Brisbane Lions,"Redden, Jack",18,11,1,7,0,0,2,8
Brisbane Lions,"Rich, Daniel",26,16,1,10,1,0,0,1
Brisbane Lions,"Rockliff, Tom",18,7,3,11,1,1,0,1
Brisbane Lions,"Staker, Brent",10,7,3,3,0,1,0,5
Brisbane Lions,"Yeo, Elliot",8,5,2,3,1,0,0,5
Brisbane Lions,"Zorko, Dayne",7,6,2,1,0,2,0,8
Brisbane Lions,"Adcock, Jed",27,13,5,14,0,0,0,3
Brisbane Lions,"Bewick, Rohan",9,6,5,3,1,1,0,5
Brisbane Lions,"Brown, Jonathan",14,11,10,3,3,1,0,1
Brisbane Lions,"Clarke, Justin",12,8,6,4,0,0,0,1
Brisbane Lions,"Golby, Mitch",20,17,10,3,0,0,0,1
Brisbane Lions,"Green, Josh",9,6,3,3,1,0,0,3
Brisbane Lions,"Hanley, Pearce",25,21,6,4,1,0,0,7
Brisbane Lions,"Harwood, Ryan",18,10,6,8,0,0,0,2
Brisbane Lions,"Lester, Ryan",10,3,2,7,0,1,0,1
Brisbane Lions,"Leuenberger, Matthew",20,12,5,8,0,1,29,7
Brisbane Lions,"Maguire, Matt",21,17,15,4,0,0,1,0
Brisbane Lions,"Mayes, Sam",25,16,4,9,1,0,0,1
Brisbane Lions,"McGrath, Ashley",5,4,0,1,0,1,0,3
Brisbane Lions,"Merrett, Daniel",8,6,3,2,2,1,1,2
Brisbane Lions,"Moloney, Brent",9,6,0,3,0,1,0,2
Brisbane Lions,"Patfull, Joel",15,9,6,6,0,0,0,1
Brisbane Lions,"Raines, Andrew",14,6,2,8,1,0,0,5
Brisbane Lions,"Redden, Jack",25,15,4,10,0,1,1,6
Brisbane Lions,"Rich, Daniel",13,8,2,5,1,1,0,4
Brisbane Lions,"Rockliff, Tom",23,12,2,11,0,1,0,5
Brisbane Lions,"Staker, Brent",16,11,9,5,3,1,0,1
Brisbane Lions,"Zorko, Dayne",11,9,1,2,3,1,0,8
Brisbane Lions,"Adcock, Jed",18,14,6,4,0,0,0,3
Brisbane Lions,"Bewick, Rohan",18,7,5,11,0,0,0,4
Brisbane Lions,"Brown, Jonathan",8,7,4,1,3,0,0,0
Brisbane Lions,"Clarke, Justin",8,4,2,4,0,0,0,1
Brisbane Lions,"Golby, Mitch",13,9,2,4,0,0,0,3
Brisbane Lions,"Green, Josh",6,5,2,1,1,0,0,3
Brisbane Lions,"Hanley, Pearce",15,12,4,3,3,0,0,3
Brisbane Lions,"Harwood, Ryan",14,7,4,7,0,0,0,4
Brisbane Lions,"Lester, Ryan",13,6,2,7,1,0,0,3
Brisbane Lions,"Leuenberger, Matthew",9,4,2,5,0,1,37,2
Brisbane Lions,"Maguire, Matt",14,11,7,3,0,1,0,1
Brisbane Lions,"Mayes, Sam",21,15,7,6,3,0,2,1
Brisbane Lions,"McGrath, Ashley",9,8,3,1,3,1,0,1
Brisbane Lions,"Merrett, Daniel",5,4,3,1,1,0,1,3
Brisbane Lions,"Patfull, Joel",10,7,4,3,0,0,0,2
Brisbane Lions,"Polkinghorne, James",3,1,1,2,0,0,0,1
Brisbane Lions,"Raines, Andrew",14,7,0,7,0,1,0,3
Brisbane Lions,"Redden, Jack",20,8,4,12,0,0,3,4
Brisbane Lions,"Rich, Daniel",22,15,4,7,0,1,0,5
Brisbane Lions,"Rockliff, Tom",28,18,5,10,0,0,0,11
Brisbane Lions,"Staker, Brent",14,10,6,4,2,0,0,4
Brisbane Lions,"Zorko, Dayne",13,7,2,6,1,0,0,3
Brisbane Lions,"Adcock, Jed",15,12,2,3,0,0,0,5
Brisbane Lions,"Bewick, Rohan",14,4,3,10,0,1,0,2
Brisbane Lions,"Clarke, Justin",11,5,3,6,0,0,0,0
Brisbane Lions,"Docherty, Sam",14,9,5,5,0,0,0,4
Brisbane Lions,"Green, Josh",14,8,2,6,3,1,0,2
Brisbane Lions,"Hanley, Pearce",27,18,8,9,0,1,0,0
Brisbane Lions,"Harwood, Ryan",16,12,5,4,0,0,0,4
Brisbane Lions,"Lester, Ryan",11,5,0,6,0,0,0,2
Brisbane Lions,"Leuenberger, Matthew",19,11,9,8,0,0,38,2
Brisbane Lions,"Lisle, Jordan",8,4,2,4,1,0,3,3
Brisbane Lions,"Maguire, Matt",15,10,6,5,0,0,0,0
Brisbane Lions,"Mayes, Sam",18,13,6,5,1,0,0,1
Brisbane Lions,"McGrath, Ashley",6,4,0,2,0,1,0,3
Brisbane Lions,"Merrett, Daniel",11,8,4,3,2,1,1,4
Brisbane Lions,"Patfull, Joel",15,10,5,5,0,0,0,3
Brisbane Lions,"Raines, Andrew",16,10,1,6,0,1,0,3
Brisbane Lions,"Redden, Jack",26,14,8,12,2,0,1,4
Brisbane Lions,"Rich, Daniel",18,10,1,8,0,0,0,5
Brisbane Lions,"Rockliff, Tom",34,21,8,13,0,0,0,4
Brisbane Lions,"Staker, Brent",21,11,3,10,3,2,0,4
Brisbane Lions,"Yeo, Elliot",15,8,2,7,0,0,0,2
Brisbane Lions,"Zorko, Dayne",13,8,3,5,1,2,0,5
Brisbane Lions,"Adcock, Jed",18,12,3,6,0,0,0,5
Brisbane Lions,"Bewick, Rohan",20,12,5,8,1,2,0,3
Brisbane Lions,"Brown, Jonathan",16,8,5,8,2,0,0,1
Brisbane Lions,"Clarke, Justin",12,4,5,8,0,0,0,2
Brisbane Lions,"Crisp, Jack",9,6,4,3,1,1,0,4
Brisbane Lions,"Docherty, Sam",6,2,0,4,0,0,0,1
Brisbane Lions,"Golby, Mitch",23,16,8,7,0,0,0,2
Brisbane Lions,"Green, Josh",10,5,0,5,1,0,0,2
Brisbane Lions,"Leuenberger, Matthew",12,6,4,6,0,0,38,1
Brisbane Lions,"Maguire, Matt",19,13,6,6,0,0,1,2
Brisbane Lions,"Mayes, Sam",17,11,6,6,0,2,0,1
Brisbane Lions,"McGrath, Ashley",8,5,2,3,0,0,0,1
Brisbane Lions,"Merrett, Daniel",7,4,3,3,1,1,4,3
Brisbane Lions,"Moloney, Brent",20,11,1,9,1,0,0,5
Brisbane Lions,"Patfull, Joel",17,8,9,9,0,0,0,3
Brisbane Lions,"Raines, Andrew",16,8,2,8,0,0,0,1
Brisbane Lions,"Redden, Jack",24,12,4,12,0,0,1,4
Brisbane Lions,"Rich, Daniel",14,5,1,9,0,0,0,4
Brisbane Lions,"Rockliff, Tom",28,17,3,11,0,0,0,6
Brisbane Lions,"Staker, Brent",14,8,3,6,0,0,0,3
Brisbane Lions,"Yeo, Elliot",15,8,6,7,0,0,0,3
Brisbane Lions,"Zorko, Dayne",18,13,3,5,2,2,0,2
Brisbane Lions,"Adcock, Jed",29,15,4,14,0,1,0,3
Brisbane Lions,"Bewick, Rohan",15,11,6,4,0,2,0,2
Brisbane Lions,"Brown, Jonathan",2,1,1,1,0,0,0,0
Brisbane Lions,"Clarke, Justin",13,9,10,4,0,0,0,1
Brisbane Lions,"Docherty, Sam",16,8,3,8,1,0,0,0
Brisbane Lions,"Golby, Mitch",18,9,4,9,0,0,0,1
Brisbane Lions,"Green, Josh",10,7,1,3,1,0,0,5
Brisbane Lions,"Hanley, Pearce",27,15,8,12,2,1,0,2
Brisbane Lions,"Harwood, Ryan",21,14,4,7,0,0,0,2
Brisbane Lions,"Leuenberger, Matthew",14,7,6,7,0,0,39,2
Brisbane Lions,"Maguire, Matt",18,14,8,4,1,1,2,3
Brisbane Lions,"Mayes, Sam",15,8,6,7,0,0,0,5
Brisbane Lions,"Merrett, Daniel",18,10,7,8,3,1,1,0
Brisbane Lions,"OBrien, Jesse",14,9,4,5,1,1,0,4
Brisbane Lions,"Patfull, Joel",20,11,8,9,0,0,0,2
Brisbane Lions,"Raines, Andrew",10,3,2,7,0,0,0,2
Brisbane Lions,"Redden, Jack",32,18,10,14,0,0,1,4
Brisbane Lions,"Rich, Daniel",19,10,2,9,3,0,0,3
Brisbane Lions,"Rockliff, Tom",39,18,5,21,0,0,0,8
Brisbane Lions,"Staker, Brent",7,6,4,1,3,0,0,0
Brisbane Lions,"Yeo, Elliot",17,12,8,5,0,0,0,1
Brisbane Lions,"Zorko, Dayne",12,7,3,5,1,2,1,2
Brisbane Lions,"Adcock, Jed",18,12,3,6,0,0,0,7
Brisbane Lions,"Clarke, Justin",6,2,3,4,0,0,0,0
Brisbane Lions,"Docherty, Sam",11,7,3,4,0,0,0,4
Brisbane Lions,"Green, Josh",14,7,4,7,2,0,0,4
Brisbane Lions,"Hanley, Pearce",24,15,5,9,2,0,2,2
Brisbane Lions,"Harwood, Ryan",15,6,1,9,0,0,0,3
Brisbane Lions,"Lester, Ryan",16,6,2,10,0,1,0,1
Brisbane Lions,"Leuenberger, Matthew",8,4,1,4,0,0,26,5
Brisbane Lions,"Maguire, Matt",12,10,3,2,0,0,0,2
Brisbane Lions,"Martin, Stefan",6,1,4,5,0,0,10,3
Brisbane Lions,"Mayes, Sam",12,9,2,3,3,0,0,4
Brisbane Lions,"Merrett, Daniel",7,7,6,0,1,1,0,0
Brisbane Lions,"Moloney, Brent",5,2,0,3,0,0,0,7
Brisbane Lions,"OBrien, Jesse",11,7,3,4,0,0,0,8
Brisbane Lions,"Patfull, Joel",14,6,3,8,0,0,0,1
Brisbane Lions,"Raines, Andrew",11,5,1,6,0,1,0,0
Brisbane Lions,"Redden, Jack",21,11,5,10,0,0,1,10
Brisbane Lions,"Rich, Daniel",20,7,0,13,1,1,0,5
Brisbane Lions,"Rockliff, Tom",34,15,4,19,0,0,0,5
Brisbane Lions,"Staker, Brent",10,8,6,2,2,0,0,4
Brisbane Lions,"Yeo, Elliot",9,5,3,4,0,0,0,2
Brisbane Lions,"Zorko, Dayne",12,10,3,2,0,2,0,3
Brisbane Lions,"Adcock, Jed",22,16,8,6,0,1,0,4
Brisbane Lions,"Bewick, Rohan",9,6,1,3,0,0,0,2
Brisbane Lions,"Black, Simon",28,10,3,18,0,1,0,4
Brisbane Lions,"Docherty, Sam",27,15,5,12,0,0,0,2
Brisbane Lions,"Golby, Mitch",22,11,6,11,0,0,0,1
Brisbane Lions,"Green, Josh",15,12,4,3,3,0,0,2
Brisbane Lions,"Hanley, Pearce",11,8,1,3,1,1,0,2
Brisbane Lions,"Harwood, Ryan",27,14,4,13,0,0,0,3
Brisbane Lions,"Lester, Ryan",13,5,4,8,0,0,0,0
Brisbane Lions,"Leuenberger, Matthew",21,12,4,9,0,0,24,2
Brisbane Lions,"Maguire, Matt",12,5,5,7,0,0,1,2
Brisbane Lions,"Mayes, Sam",21,15,4,6,4,3,0,5
Brisbane Lions,"McGrath, Ashley",17,10,4,7,1,1,0,1
Brisbane Lions,"Merrett, Daniel",14,9,6,5,2,3,3,0
Brisbane Lions,"Patfull, Joel",20,9,8,11,0,0,0,4
Brisbane Lions,"Raines, Andrew",14,3,1,11,0,0,0,1
Brisbane Lions,"Redden, Jack",16,5,3,11,0,0,3,11
Brisbane Lions,"Rich, Daniel",20,12,1,8,2,1,0,1
Brisbane Lions,"Rockliff, Tom",25,9,6,16,0,0,0,6
Brisbane Lions,"Staker, Brent",15,10,5,5,3,0,2,0
Brisbane Lions,"Yeo, Elliot",24,13,8,11,0,1,0,3
Brisbane Lions,"Zorko, Dayne",17,6,3,11,2,0,1,5
Brisbane Lions,"Adcock, Jed",24,17,3,7,0,0,0,4
Brisbane Lions,"Bewick, Rohan",8,5,5,3,1,2,0,1
Brisbane Lions,"Docherty, Sam",19,10,9,9,0,1,0,3
Brisbane Lions,"Golby, Mitch",17,11,6,6,0,0,0,3
Brisbane Lions,"Green, Josh",9,5,0,4,2,0,0,2
Brisbane Lions,"Hanley, Pearce",22,11,0,11,0,0,0,1
Brisbane Lions,"Harwood, Ryan",16,10,6,6,0,0,0,4
Brisbane Lions,"Lester, Ryan",16,8,2,8,0,0,0,1
Brisbane Lions,"Leuenberger, Matthew",17,12,4,5,2,0,22,3
Brisbane Lions,"Maguire, Matt",16,10,3,6,0,0,0,0
Brisbane Lions,"Mayes, Sam",13,5,4,8,0,0,0,6
Brisbane Lions,"McGrath, Ashley",8,4,2,4,0,0,0,2
Brisbane Lions,"Merrett, Daniel",7,6,5,1,2,0,4,0
Brisbane Lions,"Paparone, Marco",6,5,4,1,0,2,0,1
Brisbane Lions,"Patfull, Joel",21,14,5,7,0,0,1,4
Brisbane Lions,"Raines, Andrew",16,8,4,8,2,0,0,2
Brisbane Lions,"Redden, Jack",22,11,2,11,0,0,6,4
Brisbane Lions,"Rich, Daniel",11,5,3,6,2,0,0,2
Brisbane Lions,"Rockliff, Tom",33,20,10,13,0,0,0,7
Brisbane Lions,"Staker, Brent",9,6,3,3,2,0,2,1
Brisbane Lions,"Yeo, Elliot",14,9,4,5,0,0,0,4
Brisbane Lions,"Zorko, Dayne",18,13,1,5,2,3,0,7
Brisbane Lions,"Adcock, Jed",23,17,6,6,0,0,0,4
Brisbane Lions,"Bewick, Rohan",7,1,0,6,1,0,0,0
Brisbane Lions,"Golby, Mitch",23,13,2,10,1,0,0,5
Brisbane Lions,"Green, Josh",5,4,2,1,2,0,0,0
Brisbane Lions,"Hanley, Pearce",20,12,5,8,0,1,0,2
Brisbane Lions,"Harwood, Ryan",17,9,5,8,0,0,0,5
Brisbane Lions,"Lester, Ryan",18,9,1,9,2,0,0,3
Brisbane Lions,"Leuenberger, Matthew",10,4,1,6,0,0,31,2
Brisbane Lions,"Lisle, Jordan",10,6,5,4,3,1,0,1
Brisbane Lions,"Maguire, Matt",14,9,8,5,0,0,0,1
Brisbane Lions,"Mayes, Sam",13,9,3,4,0,0,0,5
Brisbane Lions,"McGrath, Ashley",12,11,3,1,6,1,0,1
Brisbane Lions,"Michael, Sam",10,4,4,6,0,0,11,3
Brisbane Lions,"Moloney, Brent",19,3,2,16,0,0,0,9
Brisbane Lions,"Patfull, Joel",14,10,4,4,0,0,0,4
Brisbane Lions,"Raines, Andrew",21,7,3,14,0,1,0,1
Brisbane Lions,"Redden, Jack",24,11,5,13,0,1,1,5
Brisbane Lions,"Rich, Daniel",23,12,3,11,0,0,0,2
Brisbane Lions,"Rockliff, Tom",37,15,9,22,0,0,0,6
Brisbane Lions,"Staker, Brent",10,6,3,4,0,1,0,1
Brisbane Lions,"Yeo, Elliot",14,9,6,5,0,0,0,2
Brisbane Lions,"Zorko, Dayne",17,5,3,12,2,2,0,8
Carlton,"Armfield, Dennis",17,10,2,7,0,1,0,1
Carlton,"Betts, Eddie",19,10,0,9,2,0,0,2
Carlton,"Bootsma, Josh",9,4,3,5,0,0,0,2
Carlton,"Carrazzo, Andrew",24,6,2,18,0,1,0,6
Carlton,"Casboult, Levi",4,2,1,2,0,0,5,1
Carlton,"Duigan, Nick",10,7,4,3,0,0,0,2
Carlton,"Garlett, Jeff",12,8,2,4,2,0,0,2
Carlton,"Gibbs, Bryce",34,23,4,11,2,1,0,4
Carlton,"Hampson, Shaun",13,7,8,6,1,2,8,0
Carlton,"Henderson, Lachie",10,8,3,2,0,0,0,5
Carlton,"Jamison, Michael",10,6,2,4,0,0,0,4
Carlton,"Joseph, Aaron",7,2,1,5,0,0,0,2
Carlton,"Judd, Chris",27,13,3,14,2,1,0,1
Carlton,"Kreuzer, Matthew",18,13,6,5,2,2,20,4
Carlton,"Lucas, Kane",19,3,3,16,0,0,0,0
Carlton,"McLean, Brock",16,8,5,8,0,0,0,2
Carlton,"Murphy, Marc",19,14,6,5,2,0,0,5
Carlton,"Robinson, Mitch",6,3,1,3,0,1,0,1
Carlton,"Simpson, Kade",22,13,4,9,0,2,0,1
Carlton,"Tuohy, Zach",9,7,2,2,0,0,0,2
Carlton,"Walker, Andrew",26,20,3,6,0,0,0,2
Carlton,"Yarran, Chris",16,11,2,5,1,3,1,0
Carlton,"Armfield, Dennis",11,6,0,5,0,0,0,3
Carlton,"Bell, Tom",16,5,1,11,1,0,0,3
Carlton,"Bootsma, Josh",3,1,1,2,0,0,0,3
Carlton,"Carrazzo, Andrew",17,6,1,11,0,0,0,2
Carlton,"Casboult, Levi",6,2,3,4,0,0,1,1
Carlton,"Davies, Marcus",8,5,1,3,0,0,0,3
Carlton,"Garlett, Jeff",20,17,6,3,3,1,0,8
Carlton,"Gibbs, Bryce",20,11,5,9,0,0,0,5
Carlton,"Henderson, Lachie",12,8,4,4,1,0,0,1
Carlton,"Jamison, Michael",11,6,3,5,0,0,0,3
Carlton,"Judd, Chris",25,12,1,13,0,1,0,4
Carlton,"Kreuzer, Matthew",13,9,2,4,0,0,34,4
Carlton,"Laidler, Jeremy",4,3,1,1,0,0,0,5
Carlton,"Lucas, Kane",18,12,6,6,1,0,0,1
Carlton,"McLean, Brock",9,3,0,6,0,0,0,2
Carlton,"Murphy, Marc",26,16,1,10,1,2,0,1
Carlton,"Robinson, Mitch",18,15,3,3,0,1,0,3
Carlton,"Rowe, Sam",11,7,4,4,1,0,8,1
Carlton,"Simpson, Kade",17,11,5,6,1,0,0,2
Carlton,"Tuohy, Zach",8,7,1,1,0,0,0,4
Carlton,"Walker, Andrew",10,8,2,2,3,1,0,3
Carlton,"Yarran, Chris",16,12,4,4,3,2,0,2
Carlton,"Armfield, Dennis",16,6,3,10,1,0,0,1
Carlton,"Buckley, Dylan",5,2,0,3,1,0,0,1
Carlton,"Carrazzo, Andrew",14,5,4,9,0,0,0,0
Carlton,"Davies, Marcus",6,3,1,3,0,0,0,6
Carlton,"Garlett, Jeff",12,10,3,2,1,3,0,4
Carlton,"Gibbs, Bryce",20,14,6,6,0,0,0,5
Carlton,"Hampson, Shaun",6,1,0,5,1,0,16,0
Carlton,"Henderson, Lachie",11,7,3,4,0,0,0,1
Carlton,"Jamison, Michael",17,12,7,5,0,0,0,2
Carlton,"Joseph, Aaron",12,7,1,5,0,0,0,5
Carlton,"Judd, Chris",28,16,5,12,1,0,0,2
Carlton,"Kreuzer, Matthew",1,1,1,0,0,0,7,2
Carlton,"Lucas, Kane",16,7,8,9,2,0,0,2
Carlton,"McLean, Brock",26,14,5,12,2,1,0,3
Carlton,"Murphy, Marc",27,17,4,10,1,1,0,6
Carlton,"Robinson, Mitch",20,13,3,7,0,0,0,6
Carlton,"Rowe, Sam",10,7,4,3,2,2,9,2
Carlton,"Scotland, Heath",19,10,5,9,1,0,0,3
Carlton,"Simpson, Kade",12,7,5,5,0,2,0,2
Carlton,"Tuohy, Zach",20,10,2,10,0,1,0,2
Carlton,"Walker, Andrew",33,18,2,15,0,0,0,2
Carlton,"Yarran, Chris",14,14,6,0,2,2,0,3
Carlton,"Armfield, Dennis",7,1,0,6,1,0,0,2
Carlton,"Carrazzo, Andrew",22,10,2,12,0,0,0,5
Carlton,"Curnow, Ed",22,6,0,16,0,0,0,4
Carlton,"Garlett, Jeff",21,12,1,9,1,3,0,7
Carlton,"Gibbs, Bryce",23,14,6,9,0,1,0,3
Carlton,"Hampson, Shaun",15,10,4,5,0,0,14,2
Carlton,"Henderson, Lachie",11,7,4,4,0,0,0,2
Carlton,"Jamison, Michael",15,8,5,7,0,0,0,1
Carlton,"Joseph, Aaron",3,1,1,2,0,0,0,0
Carlton,"Judd, Chris",18,8,1,10,0,1,0,1
Carlton,"Lucas, Kane",20,11,5,9,1,2,0,2
Carlton,"McLean, Brock",29,12,5,17,1,1,0,4
Carlton,"Murphy, Marc",28,17,6,11,0,0,0,9
Carlton,"Robinson, Mitch",17,9,2,8,1,0,0,3
Carlton,"Rowe, Sam",11,7,6,4,1,3,1,1
Carlton,"Scotland, Heath",23,12,5,11,0,1,0,4
Carlton,"Simpson, Kade",21,8,2,13,1,0,0,2
Carlton,"Tuohy, Zach",17,11,2,6,0,0,0,3
Carlton,"Walker, Andrew",21,15,5,6,1,0,0,0
Carlton,"Warnock, Robert",9,6,2,3,0,0,17,3
Carlton,"White, Simon",9,5,3,4,0,0,0,0
Carlton,"Yarran, Chris",14,13,2,1,4,1,0,5
Carlton,"Armfield, Dennis",16,11,3,5,1,0,0,2
Carlton,"Betts, Eddie",8,7,3,1,1,1,0,0
Carlton,"Carrazzo, Andrew",25,16,1,9,1,0,0,3
Carlton,"Curnow, Ed",16,9,5,7,0,0,0,2
Carlton,"Garlett, Jeff",15,9,3,6,4,1,0,4
Carlton,"Gibbs, Bryce",15,8,3,7,1,0,0,0
Carlton,"Hampson, Shaun",8,4,2,4,0,0,9,4
Carlton,"Henderson, Lachie",18,10,6,8,0,0,0,0
Carlton,"Jamison, Michael",12,6,3,6,0,0,0,4
Carlton,"Judd, Chris",23,13,0,10,1,2,0,2
Carlton,"Lucas, Kane",20,14,4,6,0,2,0,2
Carlton,"McLean, Brock",29,13,7,16,2,1,0,3
Carlton,"Murphy, Marc",26,12,5,14,1,0,0,7
Carlton,"Robinson, Mitch",29,14,1,15,0,0,0,2
Carlton,"Rowe, Sam",6,3,1,3,0,1,3,2
Carlton,"Scotland, Heath",26,12,5,14,1,0,0,2
Carlton,"Simpson, Kade",27,13,5,14,1,0,0,2
Carlton,"Tuohy, Zach",12,7,3,5,0,1,0,3
Carlton,"Walker, Andrew",32,24,3,8,0,0,0,2
Carlton,"Warnock, Robert",14,4,1,10,0,0,25,3
Carlton,"White, Simon",10,7,5,3,0,0,0,2
Carlton,"Yarran, Chris",11,10,3,1,3,1,0,5
Carlton,"Armfield, Dennis",13,5,3,8,2,1,0,3
Carlton,"Betts, Eddie",11,6,5,5,4,0,0,9
Carlton,"Cachia, Jaryd",8,5,0,3,0,1,0,1
Carlton,"Curnow, Ed",24,12,5,12,1,1,0,5
Carlton,"Ellard, David",16,11,4,5,0,0,0,9
Carlton,"Garlett, Jeff",15,11,1,4,4,0,0,7
Carlton,"Hampson, Shaun",12,9,8,3,0,1,16,3
Carlton,"Henderson, Lachie",15,10,7,5,0,0,0,4
Carlton,"Jamison, Michael",13,7,7,6,0,0,0,3
Carlton,"Judd, Chris",13,5,1,8,0,0,0,4
Carlton,"Lucas, Kane",29,13,7,16,0,1,0,3
Carlton,"McLean, Brock",22,9,5,13,0,0,0,2
Carlton,"Murphy, Marc",28,19,6,9,3,0,0,3
Carlton,"Robinson, Mitch",22,15,5,7,1,0,0,5
Carlton,"Scotland, Heath",28,14,8,14,0,0,0,0
Carlton,"Simpson, Kade",24,12,6,12,0,0,0,2
Carlton,"Tuohy, Zach",15,8,3,7,0,0,0,2
Carlton,"Waite, Jarrad",14,12,10,2,2,2,0,1
Carlton,"Walker, Andrew",21,19,3,2,1,0,0,4
Carlton,"Warnock, Robert",8,4,2,4,0,0,44,2
Carlton,"White, Simon",18,13,8,5,0,0,0,2
Carlton,"Yarran, Chris",9,7,3,2,0,1,0,5
Carlton,"Armfield, Dennis",25,16,3,9,0,0,0,2
Carlton,"Betts, Eddie",11,6,3,5,0,1,0,4
Carlton,"Cachia, Jaryd",19,9,2,10,0,0,0,3
Carlton,"Curnow, Ed",14,8,3,6,0,0,0,7
Carlton,"Ellard, David",2,2,0,0,0,0,0,1
Carlton,"Garlett, Jeff",17,8,6,9,2,1,0,4
Carlton,"Hampson, Shaun",9,7,4,2,1,2,7,3
Carlton,"Henderson, Lachie",16,11,10,5,3,1,0,1
Carlton,"Jamison, Michael",7,6,4,1,0,0,0,1
Carlton,"Judd, Chris",27,14,0,13,0,0,0,7
Carlton,"Kreuzer, Matthew",6,3,2,3,0,0,6,4
Carlton,"Lucas, Kane",14,5,3,9,0,0,0,2
Carlton,"McLean, Brock",18,8,4,10,1,3,0,1
Carlton,"Murphy, Marc",17,9,3,8,0,1,0,0
Carlton,"Robinson, Mitch",17,9,3,8,0,1,0,8
Carlton,"Scotland, Heath",21,14,7,7,0,0,0,4
Carlton,"Simpson, Kade",12,7,5,5,1,1,0,0
Carlton,"Tuohy, Zach",9,5,1,4,0,1,0,2
Carlton,"Walker, Andrew",20,15,2,5,1,0,0,1
Carlton,"Warnock, Robert",14,6,5,8,0,0,42,5
Carlton,"White, Simon",9,7,4,2,0,0,0,1
Carlton,"Yarran, Chris",1,0,0,1,0,0,0,0
Carlton,"Armfield, Dennis",19,11,2,8,1,0,0,2
Carlton,"Bell, Tom",15,7,1,8,2,0,0,7
Carlton,"Bootsma, Josh",11,9,3,2,1,0,0,3
Carlton,"Cachia, Jaryd",16,8,4,8,0,0,0,10
Carlton,"Curnow, Ed",17,7,4,10,0,0,0,7
Carlton,"Garlett, Jeff",10,10,5,0,4,1,0,3
Carlton,"Henderson, Lachie",21,12,9,9,0,0,0,2
Carlton,"Jamison, Michael",14,10,6,4,0,0,0,0
Carlton,"Judd, Chris",25,11,3,14,0,0,0,4
Carlton,"Kreuzer, Matthew",17,8,7,9,0,3,12,2
Carlton,"Lucas, Kane",21,12,5,9,0,1,0,5
Carlton,"McLean, Brock",17,11,5,6,0,1,0,5
Carlton,"Menzel, Troy",1,1,0,0,0,0,0,1
Carlton,"Murphy, Marc",24,13,5,11,3,0,0,3
Carlton,"Robinson, Mitch",23,12,3,11,2,1,0,4
Carlton,"Scotland, Heath",20,12,3,8,2,0,0,2
Carlton,"Simpson, Kade",17,13,3,4,0,0,0,2
Carlton,"Tuohy, Zach",13,7,1,6,0,0,0,2
Carlton,"Waite, Jarrad",12,10,6,2,1,2,0,5
Carlton,"Walker, Andrew",21,15,5,6,0,0,0,4
Carlton,"Warnock, Robert",7,2,1,5,0,0,30,2
Carlton,"White, Simon",13,7,5,6,0,0,0,2
Carlton,"Armfield, Dennis",18,12,4,6,1,0,0,1
Carlton,"Bell, Tom",16,9,2,7,0,2,0,4
Carlton,"Bootsma, Josh",3,2,2,1,0,0,0,1
Carlton,"Cachia, Jaryd",20,12,6,8,0,0,0,5
Carlton,"Curnow, Ed",19,8,3,11,0,0,0,1
Carlton,"Garlett, Jeff",12,11,4,1,2,2,0,0
Carlton,"Gibbs, Bryce",20,17,3,3,0,1,0,4
Carlton,"Henderson, Lachie",13,10,8,3,0,1,0,2
Carlton,"Jamison, Michael",15,11,10,4,0,0,0,2
Carlton,"Judd, Chris",26,13,2,13,1,0,0,2
Carlton,"Kreuzer, Matthew",12,7,5,5,0,3,16,4
Carlton,"Lucas, Kane",20,14,8,6,3,0,0,2
Carlton,"McLean, Brock",25,8,4,17,0,0,0,2
Carlton,"Murphy, Marc",22,11,4,11,1,0,0,0
Carlton,"Robinson, Mitch",22,13,4,9,2,3,0,1
Carlton,"Scotland, Heath",21,13,6,8,0,1,0,0
Carlton,"Simpson, Kade",21,16,8,5,0,1,0,1
Carlton,"Tuohy, Zach",10,6,3,4,0,0,0,2
Carlton,"Waite, Jarrad",16,14,12,2,3,3,0,3
Carlton,"Walker, Andrew",12,10,4,2,0,0,0,0
Carlton,"Warnock, Robert",1,1,0,0,0,0,33,1
Carlton,"White, Simon",0,0,0,0,0,0,0,1
Carlton,"Armfield, Dennis",15,10,3,5,2,1,0,1
Carlton,"Bell, Tom",4,3,0,1,0,0,0,1
Carlton,"Bootsma, Josh",12,6,4,6,0,0,0,4
Carlton,"Cachia, Jaryd",16,10,4,6,0,1,0,4
Carlton,"Casboult, Levi",12,8,8,4,1,3,13,2
Carlton,"Curnow, Ed",22,13,7,9,1,0,0,3
Carlton,"Garlett, Jeff",19,13,5,6,4,1,0,3
Carlton,"Gibbs, Bryce",28,15,4,13,1,0,0,1
Carlton,"Henderson, Lachie",16,11,6,5,2,1,0,2
Carlton,"Jamison, Michael",10,6,5,4,0,0,0,0
Carlton,"Kreuzer, Matthew",14,5,3,9,1,0,37,8
Carlton,"McLean, Brock",27,15,12,12,0,0,0,4
Carlton,"Menzel, Troy",12,8,4,4,2,2,0,2
Carlton,"Murphy, Marc",20,6,1,14,0,0,0,5
Carlton,"Robinson, Mitch",29,14,3,15,0,0,0,3
Carlton,"Scotland, Heath",17,12,3,5,0,0,0,1
Carlton,"Simpson, Kade",27,22,7,5,0,0,0,1
Carlton,"Tuohy, Zach",17,10,3,7,2,0,0,4
Carlton,"Waite, Jarrad",8,7,6,1,3,2,0,4
Carlton,"Walker, Andrew",34,20,7,14,0,0,0,3
Carlton,"White, Simon",21,11,6,10,0,0,0,3
Carlton,"Yarran, Chris",15,9,2,6,3,1,0,7
Carlton,"Armfield, Dennis",10,6,2,4,0,1,0,2
Carlton,"Betts, Eddie",6,2,1,4,1,0,0,2
Carlton,"Cachia, Jaryd",15,7,3,8,0,0,0,7
Carlton,"Casboult, Levi",15,9,10,6,1,0,5,1
Carlton,"Curnow, Ed",14,9,1,5,0,0,0,5
Carlton,"Garlett, Jeff",15,9,10,6,0,2,0,0
Carlton,"Gibbs, Bryce",26,16,6,10,0,1,0,9
Carlton,"Henderson, Lachie",18,16,10,2,0,0,0,1
Carlton,"Jamison, Michael",7,5,3,2,0,0,0,1
Carlton,"Judd, Chris",20,14,3,6,0,1,0,6
Carlton,"Kreuzer, Matthew",13,8,3,5,0,1,35,6
Carlton,"Lucas, Kane",20,14,3,6,0,1,0,2
Carlton,"McLean, Brock",24,15,10,9,0,1,0,5
Carlton,"Murphy, Marc",31,16,5,15,1,0,0,1
Carlton,"Robinson, Mitch",12,6,2,6,0,0,0,1
Carlton,"Scotland, Heath",19,10,5,9,0,0,0,3
Carlton,"Simpson, Kade",25,16,8,9,0,0,0,2
Carlton,"Tuohy, Zach",16,10,3,6,0,0,0,2
Carlton,"Waite, Jarrad",19,15,14,4,7,1,0,2
Carlton,"Walker, Andrew",28,23,6,5,0,0,0,0
Carlton,"White, Simon",9,7,6,2,0,0,0,1
Carlton,"Yarran, Chris",3,2,1,1,0,0,0,0
Carlton,"Armfield, Dennis",9,8,4,1,1,0,0,3
Carlton,"Betts, Eddie",15,8,4,7,3,1,0,5
Carlton,"Bootsma, Josh",7,7,1,0,0,0,0,1
Carlton,"Cachia, Jaryd",22,13,5,9,0,0,0,4
Carlton,"Casboult, Levi",8,7,6,1,1,1,6,2
Carlton,"Curnow, Ed",14,9,5,5,0,1,0,5
Carlton,"Garlett, Jeff",8,5,2,3,0,0,0,1
Carlton,"Gibbs, Bryce",28,20,5,8,1,0,0,8
Carlton,"Henderson, Lachie",13,10,7,3,0,0,0,1
Carlton,"Jamison, Michael",10,6,4,4,0,0,0,2
Carlton,"Judd, Chris",29,15,4,14,1,1,0,5
Carlton,"Kreuzer, Matthew",8,5,4,3,1,0,32,5
Carlton,"Lucas, Kane",12,8,2,4,0,0,0,0
Carlton,"McLean, Brock",34,18,7,16,0,1,0,3
Carlton,"Murphy, Marc",6,2,2,4,0,0,0,1
Carlton,"Robinson, Mitch",13,10,5,3,1,0,0,4
Carlton,"Rowe, Sam",9,7,4,2,1,0,6,1
Carlton,"Scotland, Heath",24,9,2,15,0,0,0,4
Carlton,"Simpson, Kade",23,13,4,10,0,0,0,4
Carlton,"Tuohy, Zach",13,7,0,6,1,1,0,5
Carlton,"Waite, Jarrad",11,7,2,4,2,0,0,2
Carlton,"Walker, Andrew",18,11,2,7,0,1,0,1
Carlton,"Armfield, Dennis",13,9,1,4,1,0,0,5
Carlton,"Betts, Eddie",6,3,1,3,0,0,0,3
Carlton,"Bootsma, Josh",9,7,2,2,1,0,0,1
Carlton,"Cachia, Jaryd",14,10,1,4,0,0,0,5
Carlton,"Casboult, Levi",7,4,1,3,0,0,12,3
Carlton,"Curnow, Ed",18,12,0,6,0,0,0,10
Carlton,"Garlett, Jeff",9,5,0,4,0,0,0,5
Carlton,"Gibbs, Bryce",26,21,2,5,1,0,0,8
Carlton,"Henderson, Lachie",21,16,9,5,0,1,0,2
Carlton,"Jamison, Michael",7,3,4,4,0,0,0,3
Carlton,"Judd, Chris",22,11,2,11,0,1,0,9
Carlton,"Kreuzer, Matthew",16,13,2,3,0,0,40,3
Carlton,"Lucas, Kane",19,13,3,6,1,2,0,6
Carlton,"McLean, Brock",14,11,1,3,0,0,0,3
Carlton,"Robinson, Mitch",15,11,1,4,0,1,0,5
Carlton,"Scotland, Heath",17,12,1,5,0,0,0,5
Carlton,"Simpson, Kade",22,16,4,6,0,0,0,3
Carlton,"Tuohy, Zach",12,8,2,4,1,0,0,4
Carlton,"Waite, Jarrad",9,6,2,3,0,1,0,3
Carlton,"Walker, Andrew",19,18,4,1,0,1,0,6
Carlton,"White, Simon",7,5,3,2,0,0,0,1
Carlton,"Yarran, Chris",5,4,1,1,0,1,0,7
Carlton,"Armfield, Dennis",10,5,2,5,0,0,0,4
Carlton,"Betts, Eddie",4,3,1,1,1,0,0,2
Carlton,"Cachia, Jaryd",14,11,6,3,1,0,0,2
Carlton,"Carrazzo, Andrew",24,14,6,10,0,0,0,2
Carlton,"Casboult, Levi",8,6,3,2,1,0,9,4
Carlton,"Curnow, Ed",12,7,6,5,0,0,0,5
Carlton,"Garlett, Jeff",7,3,1,4,2,0,0,1
Carlton,"Gibbs, Bryce",16,7,4,9,0,0,0,2
Carlton,"Henderson, Lachie",12,8,6,4,1,0,0,0
Carlton,"Jamison, Michael",12,7,6,5,0,0,0,2
Carlton,"Judd, Chris",29,13,1,16,0,0,0,5
Carlton,"Kreuzer, Matthew",14,8,5,6,2,1,28,3
Carlton,"Lucas, Kane",33,15,8,18,1,0,0,1
Carlton,"McInnes, Andrew",10,8,3,2,1,0,0,4
Carlton,"McLean, Brock",25,15,2,10,1,1,1,6
Carlton,"Murphy, Marc",18,10,3,8,0,0,0,3
Carlton,"Robinson, Mitch",18,9,3,9,0,1,0,5
Carlton,"Simpson, Kade",19,13,4,6,0,0,0,3
Carlton,"Tuohy, Zach",12,4,1,8,0,1,0,1
Carlton,"Waite, Jarrad",1,0,0,1,0,0,0,0
Carlton,"Walker, Andrew",25,19,4,6,0,0,0,1
Carlton,"Yarran, Chris",11,6,0,5,1,1,0,4
Carlton,"Armfield, Dennis",15,11,2,4,0,0,0,1
Carlton,"Betts, Eddie",11,7,4,4,0,1,0,0
Carlton,"Cachia, Jaryd",20,12,10,8,0,1,0,6
Carlton,"Carrazzo, Andrew",7,5,2,2,0,0,0,0
Carlton,"Curnow, Ed",16,6,4,10,0,0,0,5
Carlton,"Garlett, Jeff",7,7,1,0,3,1,0,3
Carlton,"Gibbs, Bryce",20,12,4,8,0,1,0,3
Carlton,"Henderson, Lachie",16,14,12,2,4,2,0,0
Carlton,"Jamison, Michael",8,4,4,4,0,0,0,1
Carlton,"Judd, Chris",26,18,5,8,1,1,0,1
Carlton,"Kreuzer, Matthew",14,4,4,10,1,0,33,3
Carlton,"Lucas, Kane",14,9,5,5,0,1,0,3
Carlton,"McInnes, Andrew",16,10,6,6,0,0,0,2
Carlton,"McLean, Brock",16,9,6,7,1,0,0,2
Carlton,"Murphy, Marc",20,8,4,12,1,0,0,0
Carlton,"Rowe, Sam",12,9,6,3,3,0,6,2
Carlton,"Scotland, Heath",15,11,6,4,0,0,0,1
Carlton,"Simpson, Kade",28,19,9,9,0,0,0,1
Carlton,"Tuohy, Zach",10,7,1,3,1,0,0,3
Carlton,"Walker, Andrew",16,13,6,3,1,0,0,2
Carlton,"Watson, Matthew",16,12,6,4,0,0,0,0
Carlton,"Yarran, Chris",12,10,7,2,0,0,0,4
Carlton,"Armfield, Dennis",12,8,6,4,0,2,0,1
Carlton,"Betts, Eddie",11,5,2,6,2,0,0,2
Carlton,"Cachia, Jaryd",3,1,0,2,0,0,0,5
Carlton,"Carrazzo, Andrew",18,8,2,10,0,0,0,8
Carlton,"Curnow, Ed",18,9,2,9,2,0,0,2
Carlton,"Garlett, Jeff",11,8,4,3,4,2,0,2
Carlton,"Gibbs, Bryce",11,7,4,4,0,0,0,7
Carlton,"Henderson, Lachie",11,9,4,2,3,0,0,3
Carlton,"Jamison, Michael",9,7,3,2,0,0,0,2
Carlton,"Judd, Chris",17,10,2,7,0,1,0,1
Carlton,"Kreuzer, Matthew",17,11,5,6,0,0,29,4
Carlton,"Lucas, Kane",12,5,4,7,0,1,0,1
Carlton,"McInnes, Andrew",8,3,2,5,0,0,0,2
Carlton,"McLean, Brock",12,8,2,4,0,1,0,4
Carlton,"Murphy, Marc",18,14,1,4,1,1,0,7
Carlton,"Rowe, Sam",7,4,4,3,0,0,10,2
Carlton,"Scotland, Heath",13,12,2,1,0,0,0,1
Carlton,"Simpson, Kade",28,18,5,10,0,0,0,3
Carlton,"Tuohy, Zach",12,10,4,2,2,0,0,2
Carlton,"Walker, Andrew",23,20,2,3,0,0,0,3
Carlton,"Watson, Matthew",11,8,2,3,0,0,0,1
Carlton,"Yarran, Chris",8,6,4,2,2,2,0,8
Carlton,"Armfield, Dennis",18,11,3,7,2,1,0,0
Carlton,"Betts, Eddie",16,8,4,8,3,2,0,3
Carlton,"Cachia, Jaryd",7,4,2,3,0,1,0,1
Carlton,"Carrazzo, Andrew",25,11,4,14,0,0,0,1
Carlton,"Curnow, Ed",22,12,6,10,0,0,0,3
Carlton,"Garlett, Jeff",13,10,3,3,1,4,0,5
Carlton,"Gibbs, Bryce",26,16,9,10,0,0,0,3
Carlton,"Henderson, Lachie",16,14,7,2,4,3,0,3
Carlton,"Jamison, Michael",12,8,6,4,0,0,0,0
Carlton,"Judd, Chris",18,11,1,7,1,1,0,0
Carlton,"Kreuzer, Matthew",12,8,4,4,0,0,42,3
Carlton,"Lucas, Kane",7,3,0,4,0,0,0,3
Carlton,"McLean, Brock",27,16,7,11,2,1,1,2
Carlton,"Murphy, Marc",27,10,1,17,0,1,0,2
Carlton,"Robinson, Mitch",17,9,1,8,0,1,0,5
Carlton,"Rowe, Sam",7,5,5,2,0,1,7,2
Carlton,"Scotland, Heath",33,23,10,10,0,0,0,2
Carlton,"Simpson, Kade",28,20,13,8,0,0,0,3
Carlton,"Tuohy, Zach",16,7,3,9,0,0,0,3
Carlton,"Walker, Andrew",25,19,13,6,0,0,0,2
Carlton,"Watson, Matthew",8,6,2,2,1,0,0,2
Carlton,"Yarran, Chris",8,5,3,3,2,0,0,5
Carlton,"Armfield, Dennis",15,9,3,6,1,0,0,7
Carlton,"Betts, Eddie",7,4,1,3,0,0,0,4
Carlton,"Cachia, Jaryd",13,8,3,5,0,0,0,9
Carlton,"Carrazzo, Andrew",4,3,1,1,0,0,0,3
Carlton,"Curnow, Ed",8,3,1,5,0,0,0,4
Carlton,"Garlett, Jeff",10,8,3,2,2,2,0,5
Carlton,"Gibbs, Bryce",21,11,6,10,0,0,0,1
Carlton,"Henderson, Lachie",14,10,7,4,2,2,0,3
Carlton,"Jamison, Michael",15,10,8,5,0,0,0,2
Carlton,"Judd, Chris",18,11,4,7,1,0,0,6
Carlton,"Kreuzer, Matthew",13,8,1,5,0,1,23,4
Carlton,"Lucas, Kane",14,6,1,8,0,0,0,1
Carlton,"McLean, Brock",17,10,4,7,1,0,0,5
Carlton,"Murphy, Marc",13,4,1,9,0,0,0,5
Carlton,"Robinson, Mitch",23,11,5,12,0,0,1,7
Carlton,"Rowe, Sam",9,6,5,3,1,0,15,4
Carlton,"Scotland, Heath",31,21,12,10,0,1,0,2
Carlton,"Simpson, Kade",30,21,8,9,0,0,0,3
Carlton,"Tuohy, Zach",16,9,6,7,3,0,0,3
Carlton,"Walker, Andrew",26,15,4,11,0,0,0,2
Carlton,"Watson, Matthew",13,9,7,4,1,1,0,1
Carlton,"Yarran, Chris",12,7,3,5,0,1,0,2
Carlton,"Armfield, Dennis",15,9,3,6,1,1,0,0
Carlton,"Betts, Eddie",18,11,6,7,2,1,0,8
Carlton,"Bootsma, Josh",7,6,1,1,0,0,0,5
Carlton,"Cachia, Jaryd",15,7,3,8,0,0,0,6
Carlton,"Curnow, Ed",19,13,8,6,1,1,0,6
Carlton,"Garlett, Jeff",7,5,2,2,0,1,0,4
Carlton,"Gibbs, Bryce",19,11,5,8,0,0,0,3
Carlton,"Henderson, Lachie",10,7,3,3,2,1,0,1
Carlton,"Jamison, Michael",13,8,3,5,0,0,0,5
Carlton,"Judd, Chris",22,6,3,16,1,0,0,2
Carlton,"McLean, Brock",25,17,4,8,1,0,0,7
Carlton,"Menzel, Troy",10,9,6,1,2,1,0,1
Carlton,"Murphy, Marc",23,13,3,10,0,0,0,4
Carlton,"Rowe, Sam",11,4,2,7,0,0,8,2
Carlton,"Scotland, Heath",31,20,6,11,0,1,0,0
Carlton,"Simpson, Kade",12,7,3,5,0,0,0,2
Carlton,"Tuohy, Zach",9,4,2,5,1,0,0,1
Carlton,"Waite, Jarrad",11,8,4,3,1,1,0,1
Carlton,"Walker, Andrew",22,19,6,3,0,0,0,3
Carlton,"Warnock, Robert",11,6,0,5,0,0,48,3
Carlton,"Watson, Matthew",7,6,3,1,0,0,0,1
Carlton,"Yarran, Chris",8,6,2,2,1,0,0,4
Carlton,"Armfield, Dennis",18,11,0,7,0,0,0,0
Carlton,"Bell, Tom",16,9,1,7,0,0,0,6
Carlton,"Betts, Eddie",14,7,1,7,0,0,0,7
Carlton,"Bootsma, Josh",2,1,0,1,0,0,0,3
Carlton,"Casboult, Levi",15,9,5,6,3,2,8,2
Carlton,"Curnow, Ed",17,12,2,5,0,0,0,6
Carlton,"Gibbs, Bryce",23,12,6,11,2,0,0,1
Carlton,"Graham, Nick",9,7,2,2,0,0,0,2
Carlton,"Henderson, Lachie",9,6,4,3,3,0,0,2
Carlton,"Jamison, Michael",8,2,1,6,0,0,0,0
Carlton,"McInnes, Andrew",7,4,1,3,0,0,0,5
Carlton,"McLean, Brock",27,18,6,9,3,1,0,7
Carlton,"Menzel, Troy",10,8,4,2,2,0,0,5
Carlton,"Murphy, Marc",23,12,2,11,0,0,0,6
Carlton,"Robinson, Mitch",25,17,9,8,1,0,0,5
Carlton,"Scotland, Heath",22,10,3,12,0,1,0,3
Carlton,"Simpson, Kade",25,18,8,7,1,2,0,3
Carlton,"Tuohy, Zach",11,6,1,5,1,0,0,6
Carlton,"Waite, Jarrad",14,12,5,2,0,1,0,2
Carlton,"Walker, Andrew",27,19,6,8,0,0,0,1
Carlton,"Warnock, Robert",9,5,1,4,0,0,39,5
Carlton,"Yarran, Chris",12,11,2,1,0,1,0,4
Carlton,"Armfield, Dennis",14,6,4,8,1,0,0,4
Carlton,"Bell, Tom",24,16,4,8,0,1,0,3
Carlton,"Betts, Eddie",13,9,2,4,1,3,0,1
Carlton,"Casboult, Levi",11,7,5,4,0,0,4,1
Carlton,"Curnow, Ed",15,8,2,7,0,0,0,3
Carlton,"Duigan, Nick",13,6,2,7,0,2,0,3
Carlton,"Gibbs, Bryce",18,12,4,6,1,1,0,0
Carlton,"Graham, Nick",14,11,4,3,0,0,0,0
Carlton,"Henderson, Lachie",9,8,5,1,1,2,0,2
Carlton,"Jamison, Michael",13,6,4,7,0,0,0,1
Carlton,"Joseph, Aaron",6,5,1,1,0,0,0,5
Carlton,"McInnes, Andrew",15,8,3,7,0,0,0,5
Carlton,"McLean, Brock",3,3,2,0,0,0,0,2
Carlton,"Menzel, Troy",11,8,5,3,2,2,0,2
Carlton,"Murphy, Marc",22,11,4,11,0,0,0,2
Carlton,"Robinson, Mitch",22,10,1,12,0,1,0,5
Carlton,"Scotland, Heath",22,12,6,10,0,1,0,3
Carlton,"Simpson, Kade",33,23,5,10,0,1,0,3
Carlton,"Tuohy, Zach",13,9,1,4,1,3,0,1
Carlton,"Waite, Jarrad",12,8,4,4,0,0,0,0
Carlton,"Warnock, Robert",11,8,2,3,0,0,37,1
Carlton,"Yarran, Chris",20,13,3,7,2,3,0,3
Carlton,"Armfield, Dennis",15,6,2,9,0,0,0,1
Carlton,"Bell, Tom",11,7,2,4,1,0,0,1
Carlton,"Betts, Eddie",19,10,3,9,2,3,0,2
Carlton,"Casboult, Levi",6,5,4,1,0,1,0,0
Carlton,"Curnow, Ed",19,11,6,8,1,0,0,6
Carlton,"Duigan, Nick",10,5,2,5,0,1,0,0
Carlton,"Ellard, David",12,6,0,6,0,0,0,7
Carlton,"Garlett, Jeff",15,11,3,4,2,1,0,2
Carlton,"Gibbs, Bryce",26,19,3,7,1,0,0,1
Carlton,"Henderson, Lachie",6,6,5,0,0,0,0,1
Carlton,"Jamison, Michael",6,4,2,2,0,0,0,1
Carlton,"Kreuzer, Matthew",3,2,2,1,1,0,12,8
Carlton,"McInnes, Andrew",6,5,2,1,0,0,0,3
Carlton,"Menzel, Troy",5,4,0,1,0,1,0,2
Carlton,"Murphy, Marc",23,14,5,9,3,0,0,5
Carlton,"Robinson, Mitch",11,8,2,3,0,0,0,4
Carlton,"Simpson, Kade",14,10,3,4,1,0,0,2
Carlton,"Tuohy, Zach",7,4,0,3,0,0,0,2
Carlton,"Waite, Jarrad",14,10,8,4,1,2,0,4
Carlton,"Walker, Andrew",25,22,7,3,0,0,0,3
Carlton,"Warnock, Robert",10,8,0,2,0,0,35,1
Carlton,"Yarran, Chris",13,12,6,1,2,2,0,2
Carlton,"Armfield, Dennis",10,4,0,6,0,0,0,0
Carlton,"Bell, Tom",17,11,3,6,0,1,0,4
Carlton,"Betts, Eddie",12,12,7,0,3,2,0,4
Carlton,"Curnow, Ed",17,6,0,11,0,0,0,10
Carlton,"Duigan, Nick",15,10,7,5,4,0,0,1
Carlton,"Garlett, Jeff",10,6,1,4,2,2,0,3
Carlton,"Gibbs, Bryce",27,21,2,6,0,0,0,5
Carlton,"Henderson, Lachie",9,8,5,1,0,0,0,2
Carlton,"Jamison, Michael",7,2,2,5,0,0,0,3
Carlton,"Judd, Chris",25,14,4,11,1,0,0,3
Carlton,"Kreuzer, Matthew",4,3,0,1,0,0,22,4
Carlton,"McInnes, Andrew",5,2,2,3,0,0,0,2
Carlton,"Menzel, Troy",2,1,0,1,0,0,0,0
Carlton,"Murphy, Marc",26,19,8,7,0,0,0,4
Carlton,"Robinson, Mitch",21,15,3,6,2,0,0,4
Carlton,"Scotland, Heath",15,7,4,8,1,0,0,3
Carlton,"Simpson, Kade",18,14,6,4,0,0,0,4
Carlton,"Tuohy, Zach",13,8,3,5,0,0,0,1
Carlton,"Waite, Jarrad",11,8,6,3,4,0,0,6
Carlton,"Walker, Andrew",14,12,1,2,0,0,0,0
Carlton,"Warnock, Robert",6,6,0,0,1,1,30,1
Carlton,"Yarran, Chris",8,4,2,4,0,0,0,3
Carlton,"Armfield, Dennis",9,5,0,4,1,1,1,0
Carlton,"Bell, Tom",16,9,3,7,0,0,0,2
Carlton,"Betts, Eddie",9,7,1,2,2,0,0,3
Carlton,"Casboult, Levi",8,4,2,4,0,0,5,1
Carlton,"Curnow, Ed",4,2,2,2,0,0,0,0
Carlton,"Duigan, Nick",7,4,3,3,0,0,0,4
Carlton,"Garlett, Jeff",3,3,0,0,0,1,0,3
Carlton,"Gibbs, Bryce",22,15,1,7,1,0,0,2
Carlton,"Henderson, Lachie",22,16,9,6,0,0,0,0
Carlton,"Jamison, Michael",8,5,0,3,0,0,0,2
Carlton,"Judd, Chris",15,8,3,7,0,1,0,3
Carlton,"McInnes, Andrew",12,9,4,3,0,0,0,2
Carlton,"McLean, Brock",22,13,2,9,0,0,0,3
Carlton,"Murphy, Marc",25,17,7,8,0,1,0,0
Carlton,"Robinson, Mitch",27,14,4,13,1,1,1,1
Carlton,"Scotland, Heath",18,13,4,5,0,0,0,3
Carlton,"Simpson, Kade",28,20,10,8,0,0,0,0
Carlton,"Tuohy, Zach",15,11,3,4,0,1,0,1
Carlton,"Waite, Jarrad",12,10,5,2,3,2,0,1
Carlton,"Walker, Andrew",30,24,5,6,0,0,0,3
Carlton,"Warnock, Robert",10,6,1,4,0,0,34,2
Carlton,"Yarran, Chris",23,16,10,7,0,3,0,3
Collingwood,"Blair, Jarryd",17,6,1,11,1,0,0,7
Collingwood,"Brown, Nathan",8,4,4,4,0,1,0,1
Collingwood,"Clarke, Martin",14,10,5,4,0,1,0,1
Collingwood,"Cloke, Travis",18,13,8,5,4,3,0,0
Collingwood,"Dwyer, Sam",9,7,3,2,0,0,0,0
Collingwood,"Elliott, Jamie",13,7,3,6,0,2,0,3
Collingwood,"Frost, Jack",12,9,2,3,0,0,0,3
Collingwood,"Goldsack, Tyson",9,5,3,4,2,0,0,4
Collingwood,"Johnson, Ben",11,3,1,8,0,0,0,1
Collingwood,"Jolly, Darren",10,4,6,6,0,0,22,2
Collingwood,"Lumumba, Heritier",24,17,9,7,0,1,0,3
Collingwood,"Lynch, Quinten",11,10,8,1,2,0,4,1
Collingwood,"Macaffer, Brent",12,6,5,6,1,0,0,2
Collingwood,"Maxwell, Nick",18,12,3,6,0,0,0,4
Collingwood,"Pendlebury, Scott",30,19,5,11,1,0,0,5
Collingwood,"Reid, Ben",8,6,1,2,0,0,0,0
Collingwood,"Russell, Jordan",11,6,1,5,0,0,0,2
Collingwood,"Sidebottom, Steele",21,19,9,2,3,1,0,1
Collingwood,"Sinclair, Ben",7,6,2,1,0,0,0,8
Collingwood,"Swan, Dane",31,19,10,12,1,1,0,1
Collingwood,"Thomas, Josh",18,11,2,7,0,1,0,3
Collingwood,"Toovey, Alan",15,11,1,4,0,0,0,5
Collingwood,"Blair, Jarryd",20,14,4,6,2,0,0,6
Collingwood,"Brown, Nathan",3,2,2,1,0,0,1,0
Collingwood,"Clarke, Martin",22,11,5,11,1,0,0,2
Collingwood,"Cloke, Travis",14,9,7,5,0,2,0,2
Collingwood,"Dwyer, Sam",23,10,6,13,1,1,0,2
Collingwood,"Elliott, Jamie",20,16,10,4,5,1,0,3
Collingwood,"Goldsack, Tyson",13,7,2,6,1,2,0,4
Collingwood,"Johnson, Ben",16,12,2,4,0,0,0,4
Collingwood,"Jolly, Darren",2,1,0,1,0,0,0,0
Collingwood,"Lumumba, Heritier",22,16,5,6,0,0,0,1
Collingwood,"Lynch, Quinten",24,11,5,13,0,0,19,1
Collingwood,"Macaffer, Brent",11,6,4,5,0,1,0,6
Collingwood,"Maxwell, Nick",14,8,5,6,0,0,0,2
Collingwood,"Pendlebury, Scott",23,14,3,9,2,0,0,6
Collingwood,"Reid, Ben",13,5,3,8,0,0,0,1
Collingwood,"Russell, Jordan",15,10,5,5,0,0,0,4
Collingwood,"Seedsman, Paul",8,3,1,5,0,0,0,1
Collingwood,"Shaw, Heath",25,20,5,5,1,3,0,2
Collingwood,"Sidebottom, Steele",25,21,4,4,1,0,0,5
Collingwood,"Sinclair, Ben",14,9,3,5,2,0,0,5
Collingwood,"Swan, Dane",26,22,6,4,1,0,1,5
Collingwood,"Toovey, Alan",6,6,1,0,0,0,0,0
Collingwood,"Blair, Jarryd",23,10,1,13,1,1,0,3
Collingwood,"Brown, Nathan",11,3,4,8,1,0,0,3
Collingwood,"Clarke, Martin",18,11,3,7,0,0,0,4
Collingwood,"Cloke, Travis",18,15,12,3,5,3,0,0
Collingwood,"Dwyer, Sam",19,7,2,12,0,0,0,0
Collingwood,"Elliott, Jamie",12,9,1,3,3,1,0,3
Collingwood,"Fasolo, Alex",12,10,3,2,1,0,0,1
Collingwood,"Frost, Jack",4,1,1,3,0,0,0,6
Collingwood,"Goldsack, Tyson",10,5,2,5,0,1,0,1
Collingwood,"Hudson, Ben",22,10,3,12,1,0,25,2
Collingwood,"Johnson, Ben",21,14,3,7,0,0,0,7
Collingwood,"Lumumba, Heritier",17,10,3,7,0,0,0,0
Collingwood,"Lynch, Quinten",17,12,3,5,1,0,12,1
Collingwood,"Pendlebury, Scott",29,18,3,11,0,1,0,8
Collingwood,"Reid, Ben",16,5,2,11,0,0,0,2
Collingwood,"Russell, Jordan",14,7,1,7,0,0,0,7
Collingwood,"Shaw, Heath",13,7,5,6,0,1,0,5
Collingwood,"Sidebottom, Steele",14,9,0,5,0,0,0,5
Collingwood,"Sinclair, Ben",9,2,3,7,0,1,0,4
Collingwood,"Swan, Dane",33,17,2,16,0,2,0,5
Collingwood,"Thomas, Dale",19,14,7,5,0,1,0,2
Collingwood,"Toovey, Alan",15,11,2,4,0,0,0,5
Collingwood,"Blair, Jarryd",17,10,3,7,0,0,0,4
Collingwood,"Brown, Nathan",8,5,4,3,0,0,0,1
Collingwood,"Clarke, Martin",20,14,7,6,1,0,0,1
Collingwood,"Cloke, Travis",20,17,14,3,7,2,0,2
Collingwood,"Dwyer, Sam",18,10,4,8,1,1,0,2
Collingwood,"Elliott, Jamie",14,10,8,4,1,3,0,0
Collingwood,"Fasolo, Alex",14,9,6,5,0,2,0,4
Collingwood,"Hudson, Ben",10,4,3,6,0,0,20,5
Collingwood,"Lumumba, Heritier",20,17,8,3,1,0,0,1
Collingwood,"Lynch, Quinten",19,16,14,3,0,0,6,1
Collingwood,"Macaffer, Brent",12,9,5,3,0,0,0,4
Collingwood,"Pendlebury, Scott",27,11,4,16,0,0,0,2
Collingwood,"Reid, Ben",18,11,9,7,0,0,0,3
Collingwood,"Russell, Jordan",10,8,8,2,0,0,0,2
Collingwood,"Seedsman, Paul",13,9,4,4,0,1,0,0
Collingwood,"Shaw, Heath",15,11,3,4,0,0,0,4
Collingwood,"Sidebottom, Steele",21,16,6,5,4,3,0,1
Collingwood,"Sinclair, Ben",9,4,2,5,0,0,0,1
Collingwood,"Swan, Dane",35,22,6,13,1,2,0,3
Collingwood,"Thomas, Dale",10,8,2,2,0,0,0,1
Collingwood,"Thomas, Josh",10,5,3,5,0,0,0,1
Collingwood,"Toovey, Alan",9,8,4,1,0,0,0,5
Collingwood,"Blair, Jarryd",12,5,3,7,2,0,0,5
Collingwood,"Brown, Nathan",13,5,4,8,0,0,0,1
Collingwood,"Clarke, Martin",21,11,4,10,0,0,0,2
Collingwood,"Cloke, Travis",12,10,6,2,2,3,0,0
Collingwood,"Dwyer, Sam",12,5,5,7,0,1,0,2
Collingwood,"Elliott, Jamie",9,3,3,6,1,0,0,5
Collingwood,"Fasolo, Alex",7,5,3,2,0,0,0,0
Collingwood,"Goldsack, Tyson",8,4,1,4,2,0,0,1
Collingwood,"Hudson, Ben",15,4,3,11,0,1,12,2
Collingwood,"Lumumba, Heritier",14,8,4,6,0,0,0,1
Collingwood,"Lynch, Quinten",22,13,8,9,0,2,8,1
Collingwood,"Macaffer, Brent",17,7,5,10,0,0,0,1
Collingwood,"Pendlebury, Scott",29,18,2,11,2,0,1,3
Collingwood,"Reid, Ben",24,13,12,11,0,0,0,1
Collingwood,"Russell, Jordan",15,8,4,7,0,1,0,5
Collingwood,"Seedsman, Paul",11,10,4,1,0,1,0,1
Collingwood,"Shaw, Heath",24,20,11,4,0,0,0,2
Collingwood,"Sidebottom, Steele",31,21,9,10,1,2,0,6
Collingwood,"Sinclair, Ben",5,1,1,4,0,0,0,0
Collingwood,"Swan, Dane",30,21,4,9,0,1,0,6
Collingwood,"Thomas, Dale",21,10,1,11,0,1,0,3
Collingwood,"Toovey, Alan",13,7,2,6,0,0,0,2
Collingwood,"Blair, Jarryd",14,4,5,10,1,0,0,7
Collingwood,"Brown, Nathan",11,8,7,3,0,0,0,3
Collingwood,"Clarke, Martin",18,12,8,6,1,0,0,2
Collingwood,"Cloke, Travis",16,15,10,1,4,5,0,3
Collingwood,"Dwyer, Sam",10,6,2,4,1,0,0,1
Collingwood,"Elliott, Jamie",13,6,6,7,0,1,0,2
Collingwood,"Goldsack, Tyson",16,12,5,4,0,0,0,2
Collingwood,"Jolly, Darren",19,8,10,11,2,0,22,1
Collingwood,"Kennedy, Ben",8,5,2,3,0,0,0,0
Collingwood,"Krakouer, Andrew",9,7,0,2,1,0,0,2
Collingwood,"Lumumba, Heritier",27,20,8,7,1,0,0,5
Collingwood,"Lynch, Quinten",11,7,4,4,0,1,8,0
Collingwood,"Macaffer, Brent",16,10,7,6,0,0,0,1
Collingwood,"Pendlebury, Scott",28,16,8,12,2,1,0,4
Collingwood,"Reid, Ben",18,12,7,6,0,0,0,5
Collingwood,"Seedsman, Paul",17,11,5,6,2,0,0,1
Collingwood,"Shaw, Heath",22,19,9,3,0,1,0,5
Collingwood,"Sidebottom, Steele",10,6,3,4,0,1,0,3
Collingwood,"Swan, Dane",26,19,11,7,0,0,0,2
Collingwood,"Thomas, Dale",34,16,8,18,0,0,0,3
Collingwood,"Thomas, Josh",15,8,3,7,0,1,0,6
Collingwood,"Witts, Jarrod",5,2,4,3,0,0,5,1
Collingwood,"Blair, Jarryd",16,11,5,5,1,1,0,8
Collingwood,"Brown, Nathan",11,6,5,5,0,0,0,1
Collingwood,"Clarke, Martin",6,4,4,2,0,0,0,0
Collingwood,"Cloke, Travis",10,8,5,2,0,4,0,1
Collingwood,"Dwyer, Sam",25,13,6,12,2,1,0,1
Collingwood,"Elliott, Jamie",7,4,4,3,0,0,0,2
Collingwood,"Jolly, Darren",15,8,7,7,0,0,31,3
Collingwood,"Kennedy, Ben",11,6,2,5,1,0,0,3
Collingwood,"Krakouer, Andrew",12,8,3,4,2,1,0,2
Collingwood,"Lumumba, Heritier",17,12,5,5,0,0,0,2
Collingwood,"Lynch, Quinten",13,6,5,7,0,0,7,1
Collingwood,"Macaffer, Brent",16,13,7,3,0,0,0,4
Collingwood,"Maxwell, Nick",8,6,5,2,0,0,0,3
Collingwood,"Mooney, Caolan",8,3,2,5,1,0,0,3
Collingwood,"Pendlebury, Scott",23,11,0,12,0,0,0,8
Collingwood,"Reid, Ben",17,15,12,2,0,0,0,1
Collingwood,"Seedsman, Paul",19,16,13,3,0,1,0,2
Collingwood,"Shaw, Heath",23,18,7,5,0,0,0,2
Collingwood,"Sidebottom, Steele",33,18,4,15,1,0,0,4
Collingwood,"Swan, Dane",27,12,3,15,2,0,0,6
Collingwood,"Thomas, Dale",25,13,6,12,0,0,0,0
Collingwood,"Thomas, Josh",28,14,7,14,0,1,0,4
Collingwood,"Ball, Luke",15,8,4,7,0,0,0,6
Collingwood,"Blair, Jarryd",23,10,7,13,0,0,0,5
Collingwood,"Brown, Nathan",14,8,6,6,0,0,0,0
Collingwood,"Cloke, Travis",17,15,13,2,1,2,0,1
Collingwood,"Dwyer, Sam",27,16,4,11,3,0,0,1
Collingwood,"Elliott, Jamie",17,11,4,6,3,0,0,4
Collingwood,"Jolly, Darren",12,6,5,6,0,2,26,8
Collingwood,"Kennedy, Ben",5,2,1,3,0,0,0,1
Collingwood,"Krakouer, Andrew",19,12,5,7,3,1,0,4
Collingwood,"Lumumba, Heritier",31,19,9,12,0,1,0,3
Collingwood,"Lynch, Quinten",10,6,2,4,1,1,1,0
Collingwood,"Macaffer, Brent",14,11,6,3,0,0,0,4
Collingwood,"Maxwell, Nick",16,10,7,6,0,0,0,4
Collingwood,"Pendlebury, Scott",31,16,8,15,2,1,0,3
Collingwood,"Reid, Ben",16,9,5,7,0,0,0,1
Collingwood,"Russell, Jordan",12,7,2,5,0,1,0,2
Collingwood,"Seedsman, Paul",19,10,5,9,1,0,0,2
Collingwood,"Sidebottom, Steele",23,13,3,10,1,0,0,4
Collingwood,"Swan, Dane",29,18,4,11,0,1,0,1
Collingwood,"Thomas, Josh",16,7,0,9,0,0,0,3
Collingwood,"Williams, Marley",5,4,1,1,0,0,0,3
Collingwood,"Witts, Jarrod",7,2,2,5,0,0,7,3
Collingwood,"Ball, Luke",28,15,5,13,0,0,0,9
Collingwood,"Blair, Jarryd",16,7,2,9,0,0,0,11
Collingwood,"Brown, Nathan",7,3,3,4,0,0,0,3
Collingwood,"Clarke, Martin",17,6,3,11,0,1,0,1
Collingwood,"Cloke, Travis",12,10,8,2,3,2,0,0
Collingwood,"Dwyer, Sam",12,6,3,6,1,0,0,5
Collingwood,"Elliott, Jamie",17,7,5,10,2,0,0,6
Collingwood,"Jolly, Darren",9,5,2,4,0,0,26,7
Collingwood,"Kennedy, Ben",10,2,0,8,0,0,0,3
Collingwood,"Krakouer, Andrew",13,5,1,8,0,0,0,4
Collingwood,"Lumumba, Heritier",21,13,6,8,0,0,0,0
Collingwood,"Lynch, Quinten",10,5,4,5,0,0,3,1
Collingwood,"Macaffer, Brent",15,9,2,6,0,0,0,9
Collingwood,"Maxwell, Nick",14,6,4,8,0,0,0,2
Collingwood,"Pendlebury, Scott",28,9,3,19,0,0,0,5
Collingwood,"Reid, Ben",24,15,9,9,0,0,0,0
Collingwood,"Russell, Jordan",17,11,5,6,0,0,0,8
Collingwood,"Seedsman, Paul",22,13,7,9,1,1,0,3
Collingwood,"Sidebottom, Steele",27,17,4,10,0,0,0,4
Collingwood,"Swan, Dane",23,16,1,7,0,0,0,5
Collingwood,"Williams, Marley",14,9,0,5,0,0,0,4
Collingwood,"Witts, Jarrod",6,4,2,2,1,0,4,0
Collingwood,"Ball, Luke",23,13,7,10,0,1,0,8
Collingwood,"Blair, Jarryd",18,6,7,12,1,0,0,4
Collingwood,"Brown, Nathan",12,4,5,8,0,0,0,1
Collingwood,"Clarke, Martin",17,6,3,11,0,0,0,1
Collingwood,"Didak, Alan",11,5,0,6,0,0,0,2
Collingwood,"Elliott, Jamie",12,9,5,3,2,0,0,0
Collingwood,"Jolly, Darren",18,8,6,10,1,1,40,3
Collingwood,"Kennedy, Ben",20,11,3,9,2,3,0,3
Collingwood,"Krakouer, Andrew",14,9,7,5,0,3,0,3
Collingwood,"Lumumba, Heritier",24,15,4,9,0,0,0,0
Collingwood,"Lynch, Quinten",12,6,6,6,0,2,11,1
Collingwood,"Macaffer, Brent",19,13,7,6,0,1,0,8
Collingwood,"Martin, Kyle",19,7,5,12,2,2,0,6
Collingwood,"Maxwell, Nick",14,4,3,10,0,0,0,3
Collingwood,"Pendlebury, Scott",28,12,4,16,0,1,0,3
Collingwood,"Reid, Ben",13,9,4,4,3,0,0,2
Collingwood,"Seedsman, Paul",28,15,8,13,0,0,0,3
Collingwood,"Shaw, Heath",23,11,3,12,0,0,0,0
Collingwood,"Sidebottom, Steele",31,17,4,14,0,0,0,6
Collingwood,"Swan, Dane",36,21,4,15,2,0,0,4
Collingwood,"Thomas, Josh",25,15,3,10,1,0,0,5
Collingwood,"Williams, Marley",18,14,5,4,0,0,0,1
Collingwood,"Ball, Luke",31,8,3,23,0,0,0,5
Collingwood,"Blair, Jarryd",17,7,3,10,0,0,0,4
Collingwood,"Brown, Nathan",10,2,3,8,0,0,0,1
Collingwood,"Cloke, Travis",19,14,13,5,3,3,0,1
Collingwood,"Didak, Alan",25,15,5,10,1,2,0,0
Collingwood,"Jolly, Darren",12,4,1,8,0,0,14,4
Collingwood,"Kennedy, Ben",17,8,3,9,3,2,0,3
Collingwood,"Lumumba, Heritier",18,12,4,6,1,1,0,3
Collingwood,"Lynch, Quinten",22,12,8,10,1,3,6,1
Collingwood,"Macaffer, Brent",17,13,10,4,1,0,0,4
Collingwood,"Martin, Kyle",13,10,5,3,3,1,0,3
Collingwood,"Maxwell, Nick",15,7,5,8,0,0,0,4
Collingwood,"Oxley, Adam",6,3,1,3,0,0,0,1
Collingwood,"Pendlebury, Scott",34,12,5,22,1,0,0,5
Collingwood,"Reid, Ben",15,10,5,5,0,1,0,2
Collingwood,"Seedsman, Paul",17,10,8,7,0,3,0,1
Collingwood,"Shaw, Heath",24,18,9,6,0,0,0,4
Collingwood,"Sidebottom, Steele",19,10,2,9,0,0,0,4
Collingwood,"Sinclair, Ben",14,7,3,7,0,0,0,2
Collingwood,"Swan, Dane",39,22,6,17,1,1,0,1
Collingwood,"Thomas, Josh",27,15,7,12,2,0,0,2
Collingwood,"Williams, Marley",19,7,7,12,0,0,0,2
Collingwood,"Blair, Jarryd",19,9,1,10,1,0,0,8
Collingwood,"Brown, Nathan",8,2,5,6,0,0,0,4
Collingwood,"Cloke, Travis",20,14,12,6,5,1,0,1
Collingwood,"Dwyer, Sam",14,7,2,7,1,0,0,0
Collingwood,"Elliott, Jamie",17,8,2,9,2,1,0,8
Collingwood,"Jolly, Darren",9,4,3,5,1,1,28,4
Collingwood,"Kennedy, Ben",15,6,2,9,1,0,0,2
Collingwood,"Lumumba, Heritier",30,15,3,15,0,2,0,2
Collingwood,"Lynch, Quinten",11,6,5,5,0,0,9,1
Collingwood,"Macaffer, Brent",12,9,5,3,0,0,0,3
Collingwood,"Martin, Kyle",22,9,7,13,1,0,0,3
Collingwood,"Maxwell, Nick",17,9,6,8,0,0,0,4
Collingwood,"Oxley, Adam",4,3,2,1,0,0,0,0
Collingwood,"Pendlebury, Scott",35,18,4,17,1,1,0,6
Collingwood,"Reid, Ben",12,2,5,10,0,0,0,2
Collingwood,"Seedsman, Paul",15,11,7,4,1,0,0,3
Collingwood,"Shaw, Heath",22,15,11,7,0,0,0,3
Collingwood,"Sidebottom, Steele",24,13,7,11,0,0,0,2
Collingwood,"Sinclair, Ben",12,5,1,7,0,0,0,6
Collingwood,"Swan, Dane",38,24,8,14,0,1,0,3
Collingwood,"Thomas, Josh",21,8,0,13,1,1,0,5
Collingwood,"Williams, Marley",17,13,6,4,0,0,0,4
Collingwood,"Ball, Luke",23,9,2,14,0,0,0,8
Collingwood,"Blair, Jarryd",16,8,3,8,0,0,0,7
Collingwood,"Brown, Nathan",13,2,4,11,0,0,0,3
Collingwood,"Cloke, Travis",11,8,6,3,2,0,0,1
Collingwood,"Dwyer, Sam",16,11,7,5,2,1,0,2
Collingwood,"Elliott, Jamie",8,6,4,2,1,2,0,1
Collingwood,"Hudson, Ben",17,6,2,11,0,0,24,3
Collingwood,"Kennedy, Ben",7,2,0,5,1,0,0,0
Collingwood,"Lumumba, Heritier",20,10,3,10,0,0,0,4
Collingwood,"Lynch, Quinten",12,5,4,7,0,0,3,0
Collingwood,"Macaffer, Brent",16,8,3,8,0,0,0,3
Collingwood,"Martin, Kyle",11,5,4,6,0,0,0,2
Collingwood,"Maxwell, Nick",28,14,6,14,1,0,0,4
Collingwood,"Pendlebury, Scott",28,14,3,14,0,0,0,8
Collingwood,"Russell, Jordan",25,12,5,13,0,0,0,3
Collingwood,"Seedsman, Paul",34,22,15,12,0,2,0,3
Collingwood,"Shaw, Heath",12,10,1,2,0,0,0,4
Collingwood,"Sidebottom, Steele",21,14,5,7,0,0,1,3
Collingwood,"Sinclair, Ben",19,7,5,12,0,0,0,4
Collingwood,"Swan, Dane",23,11,4,12,0,0,0,1
Collingwood,"Thomas, Josh",25,14,7,11,0,0,0,2
Collingwood,"Williams, Marley",19,11,5,8,0,1,0,7
Collingwood,"Ball, Luke",24,10,1,14,0,1,0,6
Collingwood,"Blair, Jarryd",16,4,0,12,0,1,0,7
Collingwood,"Brown, Nathan",8,3,3,5,0,0,0,2
Collingwood,"Cloke, Travis",16,12,7,4,5,1,0,2
Collingwood,"Dwyer, Sam",18,9,3,9,1,1,0,3
Collingwood,"Elliott, Jamie",21,11,4,10,0,0,0,2
Collingwood,"Hudson, Ben",11,6,3,5,0,0,25,5
Collingwood,"Kennedy, Ben",6,2,1,4,0,0,0,1
Collingwood,"Krakouer, Andrew",14,9,4,5,1,0,0,4
Collingwood,"Macaffer, Brent",14,10,5,4,1,0,0,5
Collingwood,"Maxwell, Nick",19,9,8,10,0,0,0,1
Collingwood,"Pendlebury, Scott",33,14,3,19,1,0,0,9
Collingwood,"Reid, Ben",14,10,8,4,4,0,0,1
Collingwood,"Seedsman, Paul",20,12,3,8,1,2,0,1
Collingwood,"Shaw, Heath",24,21,5,3,0,0,0,4
Collingwood,"Sidebottom, Steele",23,10,2,13,0,1,0,3
Collingwood,"Sinclair, Ben",17,8,3,9,0,0,0,1
Collingwood,"Swan, Dane",41,25,7,16,0,3,0,8
Collingwood,"Thomas, Josh",19,11,3,8,1,0,0,4
Collingwood,"Williams, Marley",14,10,2,4,0,1,0,0
Collingwood,"Witts, Jarrod",9,6,6,3,2,2,16,4
Collingwood,"Young, Clinton",8,4,2,4,0,0,0,1
Collingwood,"Ball, Luke",30,14,2,16,1,0,0,5
Collingwood,"Beams, Dayne",25,10,2,15,0,0,0,4
Collingwood,"Blair, Jarryd",18,6,4,12,0,0,0,4
Collingwood,"Brown, Nathan",7,4,3,3,0,0,0,2
Collingwood,"Cloke, Travis",18,15,11,3,2,5,0,0
Collingwood,"Dwyer, Sam",24,11,5,13,0,1,0,2
Collingwood,"Elliott, Jamie",7,3,1,4,0,0,0,3
Collingwood,"Hudson, Ben",12,6,3,6,0,0,20,6
Collingwood,"Krakouer, Andrew",14,8,3,6,3,0,0,2
Collingwood,"Macaffer, Brent",17,9,2,8,2,0,0,1
Collingwood,"Maxwell, Nick",13,6,1,7,0,0,0,5
Collingwood,"Pendlebury, Scott",42,19,6,23,2,1,0,5
Collingwood,"Reid, Ben",19,12,8,7,2,1,0,2
Collingwood,"Seedsman, Paul",14,8,4,6,0,0,0,2
Collingwood,"Shaw, Heath",23,17,8,6,0,0,0,2
Collingwood,"Sidebottom, Steele",28,18,8,10,1,0,0,1
Collingwood,"Sinclair, Ben",9,6,0,3,0,0,0,3
Collingwood,"Swan, Dane",31,17,2,14,2,0,0,3
Collingwood,"Thomas, Josh",8,3,3,5,0,0,0,2
Collingwood,"Williams, Marley",15,11,4,4,1,0,0,4
Collingwood,"Witts, Jarrod",12,7,7,5,1,0,8,1
Collingwood,"Young, Clinton",21,13,6,8,0,0,0,2
Collingwood,"Ball, Luke",21,13,1,8,0,0,0,8
Collingwood,"Beams, Dayne",34,15,6,19,1,1,0,6
Collingwood,"Cloke, Travis",15,10,6,5,2,4,0,3
Collingwood,"Dwyer, Sam",31,16,8,15,1,0,0,1
Collingwood,"Elliott, Jamie",6,4,3,2,2,0,0,6
Collingwood,"Goldsack, Tyson",10,6,1,4,1,1,0,5
Collingwood,"Hudson, Ben",11,5,2,6,0,0,21,1
Collingwood,"Keeffe, Lachlan",13,9,6,4,0,0,0,1
Collingwood,"Krakouer, Andrew",6,1,0,5,0,0,0,0
Collingwood,"Macaffer, Brent",13,9,3,4,0,0,0,1
Collingwood,"Maxwell, Nick",18,8,8,10,0,0,0,3
Collingwood,"Mooney, Caolan",3,1,0,2,0,0,0,3
Collingwood,"Pendlebury, Scott",28,13,4,15,0,0,0,7
Collingwood,"Reid, Ben",19,13,10,6,0,1,0,1
Collingwood,"Seedsman, Paul",19,7,4,12,1,0,0,4
Collingwood,"Shaw, Heath",18,14,5,4,0,0,0,1
Collingwood,"Sidebottom, Steele",25,17,3,8,1,0,0,4
Collingwood,"Sinclair, Ben",19,12,5,7,0,0,0,4
Collingwood,"Swan, Dane",32,19,7,13,2,1,0,3
Collingwood,"Thomas, Josh",21,11,4,10,0,0,0,7
Collingwood,"Williams, Marley",22,17,7,5,0,0,0,5
Collingwood,"Witts, Jarrod",7,2,0,5,0,0,19,5
Collingwood,"Beams, Dayne",37,19,6,18,1,2,0,4
Collingwood,"Blair, Jarryd",19,9,3,10,0,1,0,7
Collingwood,"Brown, Nathan",9,4,5,5,0,0,0,0
Collingwood,"Cloke, Travis",14,12,8,2,3,2,0,3
Collingwood,"Dwyer, Sam",14,7,1,7,0,0,0,2
Collingwood,"Elliott, Jamie",10,4,5,6,1,0,0,1
Collingwood,"Goldsack, Tyson",18,8,7,10,0,0,0,4
Collingwood,"Grundy, Brodie",14,6,5,8,0,1,12,7
Collingwood,"Keeffe, Lachlan",11,9,6,2,0,0,0,0
Collingwood,"Kennedy, Ben",5,3,1,2,0,0,0,2
Collingwood,"Lumumba, Heritier",21,13,6,8,1,0,0,3
Collingwood,"Macaffer, Brent",16,10,9,6,0,0,0,2
Collingwood,"Maxwell, Nick",8,5,2,3,0,0,0,5
Collingwood,"Pendlebury, Scott",25,12,2,13,0,0,0,1
Collingwood,"Reid, Ben",10,6,4,4,2,1,0,1
Collingwood,"Shaw, Heath",27,19,10,8,0,1,0,1
Collingwood,"Sidebottom, Steele",31,22,8,9,3,0,0,4
Collingwood,"Sinclair, Ben",15,8,4,7,0,0,0,1
Collingwood,"Swan, Dane",39,23,9,16,3,3,0,3
Collingwood,"Thomas, Josh",16,9,2,7,0,0,0,4
Collingwood,"Williams, Marley",16,9,3,7,0,0,0,2
Collingwood,"Witts, Jarrod",18,6,2,12,1,1,15,6
Collingwood,"Ball, Luke",22,12,2,10,1,0,0,7
Collingwood,"Beams, Dayne",27,19,8,8,1,0,0,3
Collingwood,"Blair, Jarryd",15,9,1,6,2,1,0,8
Collingwood,"Brown, Nathan",14,9,9,5,0,0,0,1
Collingwood,"Cloke, Travis",14,13,7,1,5,0,0,0
Collingwood,"Dwyer, Sam",19,8,5,11,0,1,0,1
Collingwood,"Elliott, Jamie",11,7,4,4,3,0,0,3
Collingwood,"Goldsack, Tyson",12,6,2,6,0,0,0,4
Collingwood,"Grundy, Brodie",11,5,4,6,0,0,19,1
Collingwood,"Keeffe, Lachlan",16,14,7,2,0,0,0,3
Collingwood,"Lumumba, Heritier",27,17,8,10,1,2,1,2
Collingwood,"Lynch, Quinten",21,13,6,8,1,0,7,5
Collingwood,"Macaffer, Brent",9,5,2,4,1,0,0,5
Collingwood,"Maxwell, Nick",15,8,3,7,0,0,0,5
Collingwood,"Pendlebury, Scott",27,13,4,14,1,1,0,6
Collingwood,"Reid, Ben",14,10,8,4,3,3,0,3
Collingwood,"Shaw, Heath",18,16,3,2,0,0,0,8
Collingwood,"Sidebottom, Steele",30,19,11,11,1,0,0,2
Collingwood,"Sinclair, Ben",20,14,7,6,0,0,0,1
Collingwood,"Swan, Dane",30,21,4,9,0,0,0,6
Collingwood,"Thomas, Josh",5,5,0,0,0,0,0,2
Collingwood,"Williams, Marley",21,12,5,9,0,0,0,5
Collingwood,"Ball, Luke",31,15,4,16,0,2,0,6
Collingwood,"Beams, Dayne",32,17,4,15,0,0,0,3
Collingwood,"Blair, Jarryd",12,5,0,7,0,1,0,3
Collingwood,"Brown, Nathan",6,2,2,4,0,0,0,1
Collingwood,"Cloke, Travis",11,9,6,2,2,3,1,2
Collingwood,"Dwyer, Sam",7,2,2,5,0,0,0,1
Collingwood,"Elliott, Jamie",16,11,5,5,3,4,0,2
Collingwood,"Goldsack, Tyson",9,4,3,5,0,0,0,7
Collingwood,"Grundy, Brodie",13,3,0,10,1,0,21,2
Collingwood,"Keeffe, Lachlan",14,8,6,6,0,0,0,1
Collingwood,"Lumumba, Heritier",23,14,5,9,1,1,0,6
Collingwood,"Lynch, Quinten",11,7,7,4,0,1,10,1
Collingwood,"Macaffer, Brent",17,13,3,4,0,1,0,5
Collingwood,"Maxwell, Nick",13,6,6,7,0,0,0,2
Collingwood,"Pendlebury, Scott",35,11,2,24,1,0,0,7
Collingwood,"Reid, Ben",11,7,4,4,2,1,0,0
Collingwood,"Shaw, Heath",15,8,5,7,0,0,0,0
Collingwood,"Sidebottom, Steele",23,16,4,7,2,0,0,5
Collingwood,"Sinclair, Ben",16,9,4,7,0,0,0,2
Collingwood,"Swan, Dane",31,13,1,18,0,0,0,4
Collingwood,"Thomas, Josh",21,13,4,8,2,0,0,2
Collingwood,"Williams, Marley",21,13,6,8,0,0,0,2
Collingwood,"Ball, Luke",19,13,5,6,0,0,0,7
Collingwood,"Beams, Dayne",25,14,3,11,2,0,0,2
Collingwood,"Blair, Jarryd",11,5,0,6,2,0,0,2
Collingwood,"Brown, Nathan",9,2,2,7,0,0,0,4
Collingwood,"Cloke, Travis",11,8,7,3,3,1,0,3
Collingwood,"Dwyer, Sam",8,1,1,7,0,0,0,0
Collingwood,"Elliott, Jamie",10,8,6,2,1,0,0,4
Collingwood,"Goldsack, Tyson",14,9,6,5,0,0,0,2
Collingwood,"Grundy, Brodie",20,7,2,13,0,0,28,2
Collingwood,"Keeffe, Lachlan",10,6,1,4,0,0,0,3
Collingwood,"Lumumba, Heritier",20,9,6,11,1,1,0,6
Collingwood,"Lynch, Quinten",11,6,4,5,1,0,9,2
Collingwood,"Macaffer, Brent",9,8,1,1,0,0,0,5
Collingwood,"Maxwell, Nick",10,6,3,4,0,0,0,2
Collingwood,"Pendlebury, Scott",31,10,1,21,0,2,0,4
Collingwood,"Reid, Ben",14,9,7,5,0,2,0,3
Collingwood,"Shaw, Heath",9,6,1,3,0,0,0,4
Collingwood,"Sidebottom, Steele",23,16,6,7,0,0,0,2
Collingwood,"Sinclair, Ben",3,2,1,1,0,0,0,0
Collingwood,"Swan, Dane",35,23,7,12,1,1,0,3
Collingwood,"Thomas, Josh",21,14,5,7,1,0,0,2
Collingwood,"Williams, Marley",14,10,2,4,0,1,0,2
Collingwood,"Ball, Luke",18,10,2,8,0,0,0,3
Collingwood,"Blair, Jarryd",17,2,1,15,0,0,0,5
Collingwood,"Brown, Nathan",11,5,7,6,0,0,0,3
Collingwood,"Cloke, Travis",16,13,10,3,3,1,0,0
Collingwood,"Didak, Alan",15,8,5,7,1,1,0,1
Collingwood,"Dwyer, Sam",12,6,5,6,0,0,0,3
Collingwood,"Goldsack, Tyson",17,9,5,8,0,0,0,2
Collingwood,"Grundy, Brodie",11,5,3,6,0,2,23,3
Collingwood,"Keeffe, Lachlan",16,7,7,9,0,0,0,1
Collingwood,"Kennedy, Ben",19,12,3,7,1,1,0,1
Collingwood,"Lumumba, Heritier",30,13,3,17,0,1,0,3
Collingwood,"Lynch, Quinten",15,7,5,8,2,0,4,2
Collingwood,"Macaffer, Brent",14,7,4,7,0,0,0,6
Collingwood,"Maxwell, Nick",14,7,4,7,0,0,1,7
Collingwood,"Pendlebury, Scott",37,18,5,19,0,0,0,5
Collingwood,"Reid, Ben",15,9,3,6,4,1,0,0
Collingwood,"Seedsman, Paul",30,16,6,14,1,0,0,5
Collingwood,"Shaw, Heath",26,13,7,13,0,0,0,4
Collingwood,"Sidebottom, Steele",25,16,9,9,0,0,0,3
Collingwood,"Swan, Dane",34,16,7,18,2,1,0,1
Collingwood,"Thomas, Josh",35,19,8,16,1,2,0,3
Collingwood,"Williams, Marley",27,19,7,8,0,0,0,4
Collingwood,"Beams, Dayne",19,4,2,15,0,0,0,1
Collingwood,"Blair, Jarryd",9,5,2,4,0,0,0,2
Collingwood,"Brown, Nathan",4,2,1,2,0,0,0,0
Collingwood,"Cloke, Travis",10,8,7,2,5,3,0,2
Collingwood,"Didak, Alan",24,13,7,11,1,1,0,1
Collingwood,"Dwyer, Sam",17,9,4,8,1,1,0,5
Collingwood,"Goldsack, Tyson",12,8,2,4,0,0,0,1
Collingwood,"Grundy, Brodie",13,7,2,6,0,0,23,3
Collingwood,"Keeffe, Lachlan",11,6,3,5,0,0,0,1
Collingwood,"Kennedy, Ben",18,7,2,11,0,0,0,1
Collingwood,"Lynch, Quinten",6,1,1,5,0,0,2,0
Collingwood,"Macaffer, Brent",10,7,3,3,0,1,0,1
Collingwood,"Maxwell, Nick",16,9,5,7,0,0,1,3
Collingwood,"Pendlebury, Scott",33,14,6,19,2,0,0,4
Collingwood,"Reid, Ben",12,7,7,5,5,0,0,1
Collingwood,"Russell, Jordan",7,5,3,2,0,0,0,2
Collingwood,"Seedsman, Paul",21,10,5,11,1,0,0,1
Collingwood,"Shaw, Heath",17,8,3,9,0,0,0,2
Collingwood,"Sidebottom, Steele",18,13,3,5,0,1,1,1
Collingwood,"Swan, Dane",26,20,7,6,0,0,0,2
Collingwood,"Thomas, Josh",21,8,3,13,2,1,0,2
Collingwood,"Williams, Marley",14,11,4,3,0,1,0,3
Collingwood,"Ball, Luke",19,8,3,11,0,0,0,6
Collingwood,"Beams, Dayne",29,11,6,18,1,0,0,8
Collingwood,"Blair, Jarryd",13,4,2,9,0,0,0,9
Collingwood,"Brown, Nathan",7,2,1,5,0,0,0,2
Collingwood,"Cloke, Travis",11,10,7,1,2,1,0,2
Collingwood,"Didak, Alan",10,7,1,3,0,0,0,0
Collingwood,"Dwyer, Sam",13,7,4,6,0,0,0,2
Collingwood,"Elliott, Jamie",11,8,7,3,0,1,0,0
Collingwood,"Goldsack, Tyson",12,6,2,6,0,0,0,7
Collingwood,"Grundy, Brodie",6,2,2,4,0,0,25,4
Collingwood,"Keeffe, Lachlan",7,6,4,1,1,0,1,1
Collingwood,"Lumumba, Heritier",18,13,6,5,0,0,0,2
Collingwood,"Macaffer, Brent",11,9,1,2,1,0,0,5
Collingwood,"Maxwell, Nick",15,9,4,6,0,0,0,7
Collingwood,"Pendlebury, Scott",24,17,3,7,0,0,0,5
Collingwood,"Reid, Ben",8,6,2,2,0,0,0,2
Collingwood,"Seedsman, Paul",15,8,1,7,0,0,0,2
Collingwood,"Shaw, Heath",11,7,3,4,0,0,0,3
Collingwood,"Sidebottom, Steele",29,20,6,9,0,1,0,4
Collingwood,"Swan, Dane",22,15,11,7,3,3,0,3
Collingwood,"Thomas, Josh",11,8,1,3,0,1,0,3
Collingwood,"Williams, Marley",14,11,4,3,1,0,0,4
Essendon,"Baguley, Mark",7,6,4,1,0,0,0,3
Essendon,"Bellchambers, Tom",8,5,2,3,1,1,26,1
Essendon,"Carlisle, Jake",13,9,9,4,0,0,0,3
Essendon,"Crameri, Stewart",4,3,2,1,1,1,0,2
Essendon,"Davey, Alwyn",12,3,0,9,3,0,0,3
Essendon,"Dempsey, Courtenay",20,15,7,5,1,0,0,5
Essendon,"Fletcher, Dustin",16,16,5,0,0,0,0,2
Essendon,"Goddard, Brendon",14,13,7,1,1,0,0,2
Essendon,"Heppell, Dyson",23,14,3,9,0,0,0,2
Essendon,"Hibberd, Michael",17,12,5,5,1,0,0,1
Essendon,"Hocking, Heath",13,11,4,2,1,0,0,10
Essendon,"Hooker, Cale",16,10,7,6,0,0,0,1
Essendon,"Howlett, Ben",25,16,5,9,4,1,0,6
Essendon,"Hurley, Michael",15,9,4,6,0,2,0,1
Essendon,"Kommer, Nick",16,9,1,7,1,1,0,2
Essendon,"Melksham, Jake",17,8,2,9,1,0,0,5
Essendon,"Merrett, Jackson",16,8,4,8,0,0,0,3
Essendon,"Myers, David",22,12,2,10,1,0,0,3
Essendon,"Ryder, Paddy",4,2,1,2,0,0,11,5
Essendon,"Stanton, Brent",26,17,5,9,1,0,0,6
Essendon,"Watson, Jobe",34,23,3,11,1,1,0,3
Essendon,"Zaharakis, David",6,3,0,3,0,1,0,4
Essendon,"Baguley, Mark",18,12,7,6,0,0,0,5
Essendon,"Bellchambers, Tom",12,9,7,3,4,0,21,1
Essendon,"Carlisle, Jake",22,15,13,7,0,0,0,1
Essendon,"Crameri, Stewart",16,13,8,3,6,0,0,2
Essendon,"Davey, Alwyn",11,6,1,5,2,3,0,3
Essendon,"Dempsey, Courtenay",23,17,7,6,1,0,0,2
Essendon,"Fletcher, Dustin",18,13,7,5,0,0,0,1
Essendon,"Goddard, Brendon",30,16,11,14,1,0,0,2
Essendon,"Heppell, Dyson",36,19,9,17,2,2,1,4
Essendon,"Hibberd, Michael",25,17,9,8,0,0,0,0
Essendon,"Hocking, Heath",11,7,3,4,0,0,0,10
Essendon,"Hooker, Cale",17,8,7,9,0,0,0,1
Essendon,"Howlett, Ben",25,10,6,15,2,0,0,6
Essendon,"Hurley, Michael",19,14,8,5,2,1,0,0
Essendon,"Kommer, Nick",9,3,2,6,0,1,0,0
Essendon,"Melksham, Jake",19,8,3,11,0,1,1,1
Essendon,"Merrett, Jackson",9,6,2,3,2,1,0,7
Essendon,"Myers, David",23,12,6,11,0,0,0,4
Essendon,"Ryder, Paddy",12,7,3,5,1,0,17,6
Essendon,"Stanton, Brent",33,26,11,7,2,1,0,1
Essendon,"Watson, Jobe",38,19,6,19,3,2,0,3
Essendon,"Zaharakis, David",26,14,8,12,0,1,0,1
Essendon,"Bellchambers, Tom",7,3,2,4,0,0,33,1
Essendon,"Carlisle, Jake",18,13,6,5,0,0,0,0
Essendon,"Colyer, Travis",11,9,0,2,0,0,0,3
Essendon,"Crameri, Stewart",12,8,2,4,3,1,0,0
Essendon,"Davey, Alwyn",10,6,1,4,0,0,0,1
Essendon,"Dempsey, Courtenay",16,13,3,3,0,0,0,4
Essendon,"Fletcher, Dustin",8,4,1,4,0,0,0,1
Essendon,"Goddard, Brendon",26,16,4,10,0,1,0,6
Essendon,"Heppell, Dyson",15,7,2,8,1,0,1,9
Essendon,"Hibberd, Michael",25,19,5,6,0,0,0,1
Essendon,"Hocking, Heath",14,10,1,4,0,0,0,8
Essendon,"Hooker, Cale",20,8,3,12,0,0,0,1
Essendon,"Howlett, Ben",16,12,0,4,1,0,0,9
Essendon,"Hurley, Michael",16,9,6,7,2,3,0,3
Essendon,"Kavanagh, Elliott",10,4,1,6,1,0,0,3
Essendon,"Kommer, Nick",16,8,4,8,1,0,0,3
Essendon,"Melksham, Jake",17,8,6,9,0,0,0,4
Essendon,"Myers, David",15,9,1,6,0,1,0,5
Essendon,"Ryder, Paddy",13,8,2,5,1,0,25,6
Essendon,"Stanton, Brent",22,18,2,4,0,1,0,8
Essendon,"Watson, Jobe",20,6,0,14,0,2,0,4
Essendon,"Zaharakis, David",20,10,3,10,0,2,0,5
Essendon,"Baguley, Mark",19,8,9,11,0,0,0,0
Essendon,"Bellchambers, Tom",14,10,6,4,2,1,16,2
Essendon,"Carlisle, Jake",11,6,6,5,0,0,0,2
Essendon,"Davey, Alwyn",9,6,1,3,2,1,0,4
Essendon,"Dempsey, Courtenay",17,13,7,4,1,1,0,1
Essendon,"Goddard, Brendon",23,14,4,9,1,1,0,6
Essendon,"Gumbleton, Scott",18,12,12,6,4,2,0,0
Essendon,"Heppell, Dyson",28,15,8,13,0,0,0,2
Essendon,"Hibberd, Michael",24,20,11,4,0,1,0,3
Essendon,"Hille, David",16,9,3,7,0,1,25,1
Essendon,"Hocking, Heath",16,10,6,6,0,1,0,0
Essendon,"Hooker, Cale",19,11,9,8,0,0,0,1
Essendon,"Howlett, Ben",18,10,1,8,1,0,0,7
Essendon,"Hurley, Michael",13,11,8,2,3,0,0,1
Essendon,"Melksham, Jake",23,11,6,12,0,0,0,1
Essendon,"Merrett, Jackson",9,6,1,3,1,0,0,3
Essendon,"Myers, David",21,17,4,4,0,0,0,7
Essendon,"Pears, Tayte",16,10,5,6,0,0,0,1
Essendon,"Stanton, Brent",28,22,6,6,2,0,0,5
Essendon,"Watson, Jobe",37,15,2,22,2,1,0,1
Essendon,"Winderlich, Jason",5,4,3,1,0,0,0,1
Essendon,"Zaharakis, David",27,13,6,14,0,1,0,1
Essendon,"Baguley, Mark",11,8,2,3,0,0,0,2
Essendon,"Bellchambers, Tom",15,8,5,7,2,1,32,3
Essendon,"Carlisle, Jake",7,6,3,1,0,0,0,0
Essendon,"Colyer, Travis",5,3,2,2,0,0,0,3
Essendon,"Crameri, Stewart",15,8,6,7,1,1,0,2
Essendon,"Davey, Alwyn",11,7,1,4,2,1,0,3
Essendon,"Dempsey, Courtenay",18,16,5,2,0,0,1,3
Essendon,"Goddard, Brendon",27,18,5,9,0,2,2,4
Essendon,"Gumbleton, Scott",10,6,5,4,2,0,0,0
Essendon,"Hardingham, Kyle",8,3,3,5,0,0,0,0
Essendon,"Heppell, Dyson",25,15,6,10,0,1,0,4
Essendon,"Hibberd, Michael",21,16,9,5,0,0,0,3
Essendon,"Hille, David",10,4,3,6,0,1,15,0
Essendon,"Hocking, Heath",11,5,5,6,0,0,0,6
Essendon,"Hooker, Cale",12,5,7,7,0,0,0,3
Essendon,"Howlett, Ben",11,4,1,7,0,0,0,5
Essendon,"Merrett, Jackson",11,5,2,6,2,0,0,6
Essendon,"Myers, David",10,10,6,0,0,0,0,1
Essendon,"Stanton, Brent",31,22,6,9,0,2,0,2
Essendon,"Watson, Jobe",31,12,5,19,2,1,0,2
Essendon,"Winderlich, Jason",19,13,8,6,3,1,0,3
Essendon,"Zaharakis, David",34,21,4,13,4,1,0,1
Essendon,"Baguley, Mark",23,15,6,8,1,1,0,2
Essendon,"Bellchambers, Tom",12,6,4,6,1,1,10,1
Essendon,"Crameri, Stewart",16,11,2,5,4,3,0,1
Essendon,"Davey, Alwyn",16,10,4,6,4,2,0,6
Essendon,"Dempsey, Courtenay",26,16,6,10,0,1,0,2
Essendon,"Goddard, Brendon",25,13,5,12,1,0,1,7
Essendon,"Gumbleton, Scott",9,5,5,4,3,1,0,4
Essendon,"Hardingham, Kyle",17,8,7,9,1,0,0,0
Essendon,"Hibberd, Michael",29,18,9,11,0,0,0,1
Essendon,"Hille, David",18,11,4,7,1,2,18,2
Essendon,"Hocking, Heath",10,8,3,2,1,1,0,1
Essendon,"Hooker, Cale",21,13,10,8,0,0,0,2
Essendon,"Howlett, Ben",16,10,4,6,0,0,0,5
Essendon,"Jetta, Leroy",12,5,2,7,0,1,0,5
Essendon,"Kommer, Nick",10,3,2,7,0,0,0,3
Essendon,"Melksham, Jake",17,11,4,6,0,0,0,4
Essendon,"Merrett, Jackson",13,10,4,3,0,1,0,5
Essendon,"Myers, David",24,16,12,8,0,0,1,5
Essendon,"Pears, Tayte",18,9,5,9,0,0,0,1
Essendon,"Stanton, Brent",8,6,3,2,0,0,0,5
Essendon,"Watson, Jobe",21,7,2,14,0,1,0,1
Essendon,"Zaharakis, David",27,17,3,10,0,1,0,4
Essendon,"Baguley, Mark",11,8,5,3,0,0,0,2
Essendon,"Bellchambers, Tom",14,10,4,4,1,0,31,1
Essendon,"Carlisle, Jake",16,12,9,4,0,0,0,4
Essendon,"Crameri, Stewart",9,6,6,3,1,0,0,4
Essendon,"Davey, Alwyn",8,4,4,4,1,2,0,4
Essendon,"Fletcher, Dustin",18,14,5,4,0,0,0,2
Essendon,"Goddard, Brendon",29,19,7,10,1,0,0,0
Essendon,"Gumbleton, Scott",7,3,3,4,2,0,3,1
Essendon,"Hardingham, Kyle",15,8,5,7,0,0,0,3
Essendon,"Heppell, Dyson",21,9,3,12,0,0,0,5
Essendon,"Hibberd, Michael",20,15,9,5,1,0,0,1
Essendon,"Hocking, Heath",19,8,2,11,1,1,0,3
Essendon,"Hooker, Cale",15,9,6,6,0,0,0,3
Essendon,"Howlett, Ben",19,11,6,8,0,1,0,7
Essendon,"Hurley, Michael",14,10,5,4,1,0,0,0
Essendon,"Kommer, Nick",14,6,1,8,0,1,0,7
Essendon,"Lovett-Murray, Nathan",7,4,0,3,0,0,0,2
Essendon,"Melksham, Jake",21,12,5,9,0,2,0,2
Essendon,"Myers, David",19,11,5,8,2,1,0,3
Essendon,"Watson, Jobe",30,21,2,9,0,2,0,5
Essendon,"Winderlich, Jason",10,5,4,5,0,1,0,4
Essendon,"Zaharakis, David",31,21,9,10,0,2,0,4
Essendon,"Baguley, Mark",15,6,3,9,0,0,0,3
Essendon,"Bellchambers, Tom",8,4,6,4,2,0,19,1
Essendon,"Carlisle, Jake",23,10,7,13,0,0,0,1
Essendon,"Crameri, Stewart",15,8,6,7,2,1,0,3
Essendon,"Fletcher, Dustin",13,10,4,3,0,0,0,2
Essendon,"Goddard, Brendon",32,23,5,9,0,0,0,1
Essendon,"Heppell, Dyson",26,15,4,11,2,2,0,1
Essendon,"Hibberd, Michael",24,15,5,9,0,0,0,1
Essendon,"Hocking, Heath",23,11,5,12,1,1,0,7
Essendon,"Hooker, Cale",23,10,8,13,0,0,0,0
Essendon,"Howlett, Ben",16,9,3,7,1,0,0,4
Essendon,"Hurley, Michael",0,0,0,0,0,0,0,0
Essendon,"Kavanagh, Elliott",18,10,6,8,1,0,0,2
Essendon,"Kommer, Nick",9,6,3,3,0,1,0,7
Essendon,"Melksham, Jake",19,13,3,6,0,1,0,2
Essendon,"Merrett, Jackson",11,5,3,6,0,0,0,0
Essendon,"Myers, David",16,7,3,9,1,0,0,1
Essendon,"Ryder, Paddy",17,9,6,8,1,0,23,3
Essendon,"Stanton, Brent",20,12,4,8,0,1,0,4
Essendon,"Watson, Jobe",29,15,7,14,1,3,0,4
Essendon,"Winderlich, Jason",15,7,4,8,0,2,0,2
Essendon,"Zaharakis, David",26,17,2,9,0,0,0,0
Essendon,"Baguley, Mark",9,5,2,4,0,0,0,2
Essendon,"Bellchambers, Tom",7,1,3,6,0,0,25,0
Essendon,"Carlisle, Jake",13,10,8,3,0,0,0,1
Essendon,"Crameri, Stewart",9,7,7,2,3,1,0,1
Essendon,"Dempsey, Courtenay",28,20,8,8,0,0,0,7
Essendon,"Fletcher, Dustin",12,11,8,1,0,0,0,0
Essendon,"Goddard, Brendon",34,22,11,12,0,0,0,2
Essendon,"Heppell, Dyson",27,12,4,15,0,2,1,4
Essendon,"Hibberd, Michael",29,19,8,10,1,0,0,1
Essendon,"Hocking, Heath",18,7,6,11,0,0,0,5
Essendon,"Hooker, Cale",12,7,3,5,0,0,0,1
Essendon,"Howlett, Ben",15,9,4,6,1,0,0,8
Essendon,"Hurley, Michael",5,3,3,2,0,1,0,0
Essendon,"Jetta, Leroy",11,4,0,7,0,2,0,3
Essendon,"Kommer, Nick",16,10,7,6,0,0,0,3
Essendon,"Melksham, Jake",7,4,4,3,1,0,0,1
Essendon,"Myers, David",18,7,2,11,0,0,0,2
Essendon,"Ryder, Paddy",17,10,7,7,0,0,16,2
Essendon,"Stanton, Brent",39,28,6,11,1,1,0,4
Essendon,"Watson, Jobe",28,15,4,13,3,1,0,5
Essendon,"Winderlich, Jason",11,9,7,2,1,0,0,4
Essendon,"Zaharakis, David",18,14,4,4,2,0,0,5
Essendon,"Baguley, Mark",15,9,5,6,0,0,0,3
Essendon,"Bellchambers, Tom",8,6,3,2,1,1,37,2
Essendon,"Carlisle, Jake",12,11,5,1,2,1,0,2
Essendon,"Crameri, Stewart",13,9,2,4,2,1,0,2
Essendon,"Dempsey, Courtenay",11,10,3,1,0,0,0,1
Essendon,"Fletcher, Dustin",15,14,3,1,0,0,0,1
Essendon,"Goddard, Brendon",18,11,5,7,2,0,0,4
Essendon,"Gumbleton, Scott",1,0,0,1,0,0,0,0
Essendon,"Hams, Will",4,1,0,3,0,0,0,1
Essendon,"Heppell, Dyson",27,17,3,10,0,0,4,5
Essendon,"Hibberd, Michael",30,18,3,12,1,0,0,2
Essendon,"Hocking, Heath",15,7,0,8,0,0,0,4
Essendon,"Hooker, Cale",15,9,7,6,0,0,0,2
Essendon,"Jetta, Leroy",14,10,2,4,0,0,0,7
Essendon,"Kommer, Nick",8,4,2,4,0,0,0,3
Essendon,"Melksham, Jake",20,15,2,5,1,1,0,3
Essendon,"Myers, David",15,8,2,7,0,0,0,5
Essendon,"Ryder, Paddy",8,5,2,3,0,0,28,0
Essendon,"Stanton, Brent",36,28,7,8,0,0,0,6
Essendon,"Watson, Jobe",23,13,2,10,0,0,0,5
Essendon,"Winderlich, Jason",14,7,5,7,1,1,0,2
Essendon,"Zaharakis, David",27,16,2,11,0,1,0,4
Essendon,"Baguley, Mark",21,13,5,8,0,0,0,2
Essendon,"Carlisle, Jake",23,20,13,3,1,0,0,1
Essendon,"Crameri, Stewart",20,10,6,10,1,1,0,2
Essendon,"Daniher, Joe",15,10,5,5,0,2,1,1
Essendon,"Davey, Alwyn",4,3,1,1,0,0,0,0
Essendon,"Fletcher, Dustin",15,12,6,3,0,0,0,0
Essendon,"Goddard, Brendon",23,9,3,14,0,0,0,7
Essendon,"Hams, Will",3,0,0,3,0,0,0,1
Essendon,"Heppell, Dyson",28,20,10,8,0,3,1,3
Essendon,"Hibberd, Michael",15,9,3,6,0,0,1,2
Essendon,"Hocking, Heath",16,6,2,10,1,0,0,7
Essendon,"Hooker, Cale",13,4,6,9,0,0,0,1
Essendon,"Howlett, Ben",10,7,3,3,1,0,0,3
Essendon,"Hurley, Michael",18,9,5,9,1,1,0,0
Essendon,"Kommer, Nick",9,8,3,1,1,0,0,2
Essendon,"Melksham, Jake",21,15,7,6,3,0,0,1
Essendon,"Myers, David",17,8,5,9,1,0,0,0
Essendon,"Ryder, Paddy",15,10,5,5,0,0,34,6
Essendon,"Stanton, Brent",13,9,2,4,1,0,0,1
Essendon,"Watson, Jobe",22,12,3,10,0,1,0,2
Essendon,"Winderlich, Jason",17,8,8,9,0,2,0,0
Essendon,"Zaharakis, David",23,12,2,11,0,0,0,3
Essendon,"Baguley, Mark",17,7,5,10,0,0,0,2
Essendon,"Carlisle, Jake",19,11,11,8,0,0,0,0
Essendon,"Crameri, Stewart",22,11,7,11,3,1,0,2
Essendon,"Daniher, Joe",17,8,8,9,3,1,0,1
Essendon,"Davey, Alwyn",7,4,1,3,1,0,0,7
Essendon,"Goddard, Brendon",38,28,12,10,1,0,1,2
Essendon,"Heppell, Dyson",27,23,7,4,0,0,0,6
Essendon,"Hibberd, Michael",25,15,6,10,1,0,0,0
Essendon,"Hocking, Heath",19,9,4,10,0,0,0,4
Essendon,"Hooker, Cale",23,10,14,13,0,0,0,2
Essendon,"Howlett, Ben",24,7,3,17,1,1,0,7
Essendon,"Hurley, Michael",11,4,3,7,2,0,0,0
Essendon,"Kommer, Nick",16,8,5,8,1,1,0,0
Essendon,"Melksham, Jake",15,9,6,6,0,3,0,2
Essendon,"Merrett, Jackson",7,4,2,3,0,0,0,1
Essendon,"Myers, David",20,11,6,9,1,1,0,1
Essendon,"Pears, Tayte",27,15,8,12,0,0,0,1
Essendon,"Ryder, Paddy",18,13,6,5,2,0,26,2
Essendon,"Stanton, Brent",30,18,7,12,1,1,0,0
Essendon,"Watson, Jobe",31,13,5,18,0,1,0,1
Essendon,"Winderlich, Jason",20,11,6,9,0,1,0,1
Essendon,"Zaharakis, David",30,13,2,17,0,0,0,2
Essendon,"Baguley, Mark",15,11,7,4,0,0,0,3
Essendon,"Bellchambers, Tom",3,3,0,0,0,0,9,1
Essendon,"Carlisle, Jake",17,10,8,7,2,0,0,2
Essendon,"Crameri, Stewart",10,4,3,6,1,0,0,1
Essendon,"Davey, Alwyn",10,8,2,2,2,1,0,4
Essendon,"Dempsey, Courtenay",19,14,6,5,1,1,0,1
Essendon,"Goddard, Brendon",20,14,8,6,1,0,2,2
Essendon,"Heppell, Dyson",21,12,6,9,1,0,0,2
Essendon,"Hibberd, Michael",19,10,4,9,0,0,0,2
Essendon,"Hooker, Cale",12,8,3,4,0,0,0,3
Essendon,"Howlett, Ben",15,9,2,6,0,0,0,4
Essendon,"Hurley, Michael",10,6,2,4,0,0,0,1
Essendon,"Kommer, Nick",15,8,4,7,0,1,0,3
Essendon,"Melksham, Jake",24,13,4,11,0,1,0,3
Essendon,"Merrett, Jackson",9,7,3,2,1,1,0,3
Essendon,"Myers, David",9,7,2,2,0,0,0,3
Essendon,"Pears, Tayte",11,7,2,4,0,0,0,4
Essendon,"Ryder, Paddy",8,7,3,1,1,0,29,3
Essendon,"Stanton, Brent",27,18,3,9,0,0,0,5
Essendon,"Watson, Jobe",29,16,5,13,2,0,1,5
Essendon,"Winderlich, Jason",17,9,10,8,3,0,0,2
Essendon,"Zaharakis, David",26,12,4,14,0,2,0,6
Essendon,"Baguley, Mark",18,11,9,7,0,0,0,2
Essendon,"Bellchambers, Tom",17,10,10,7,5,1,11,1
Essendon,"Carlisle, Jake",8,4,6,4,0,1,0,6
Essendon,"Colyer, Travis",12,8,2,4,0,1,0,0
Essendon,"Dempsey, Courtenay",21,15,6,6,0,0,0,4
Essendon,"Fletcher, Dustin",24,15,7,9,0,0,0,3
Essendon,"Goddard, Brendon",29,16,8,13,1,0,1,5
Essendon,"Heppell, Dyson",24,12,7,12,0,0,0,2
Essendon,"Hibberd, Michael",25,19,3,6,0,0,0,0
Essendon,"Hooker, Cale",30,11,13,19,0,0,0,3
Essendon,"Howlett, Ben",20,12,7,8,1,0,0,6
Essendon,"Hurley, Michael",13,9,5,4,3,0,0,0
Essendon,"Kommer, Nick",10,5,2,5,0,0,0,4
Essendon,"Melksham, Jake",24,15,9,9,0,0,0,3
Essendon,"Merrett, Jackson",13,11,2,2,0,0,0,0
Essendon,"Myers, David",20,12,8,8,0,3,0,4
Essendon,"Pears, Tayte",23,12,6,11,0,0,0,4
Essendon,"Ryder, Paddy",16,11,4,5,1,1,26,5
Essendon,"Stanton, Brent",23,18,7,5,2,0,0,8
Essendon,"Watson, Jobe",4,2,2,2,0,0,0,0
Essendon,"Winderlich, Jason",18,11,9,7,3,0,0,4
Essendon,"Zaharakis, David",27,19,3,8,2,1,0,5
Essendon,"Baguley, Mark",13,9,4,4,0,0,0,5
Essendon,"Bellchambers, Tom",14,9,5,5,2,0,29,3
Essendon,"Carlisle, Jake",19,14,10,5,1,1,0,2
Essendon,"Colyer, Travis",22,11,6,11,0,1,0,1
Essendon,"Dempsey, Courtenay",24,18,7,6,3,0,0,2
Essendon,"Fletcher, Dustin",18,12,7,6,0,0,0,0
Essendon,"Goddard, Brendon",27,11,3,16,1,0,0,1
Essendon,"Heppell, Dyson",27,20,5,7,2,0,0,5
Essendon,"Hibberd, Michael",20,14,5,6,0,0,0,2
Essendon,"Hooker, Cale",18,8,7,10,0,0,0,3
Essendon,"Howlett, Ben",11,6,2,5,0,0,0,8
Essendon,"Hurley, Michael",15,7,8,8,0,2,0,0
Essendon,"Kommer, Nick",12,8,4,4,0,0,0,0
Essendon,"Melksham, Jake",18,13,2,5,2,0,0,4
Essendon,"Merrett, Jackson",4,2,1,2,0,0,0,5
Essendon,"Myers, David",16,13,3,3,1,1,0,9
Essendon,"OBrien, Nick",10,7,1,3,0,0,0,1
Essendon,"Pears, Tayte",20,9,7,11,0,0,0,1
Essendon,"Ryder, Paddy",15,6,5,9,1,0,25,3
Essendon,"Stanton, Brent",29,22,5,7,1,3,0,2
Essendon,"Winderlich, Jason",24,14,13,10,4,0,0,7
Essendon,"Zaharakis, David",11,5,0,6,0,1,0,0
Essendon,"Baguley, Mark",20,6,5,14,0,0,0,3
Essendon,"Bellchambers, Tom",7,4,1,3,1,1,25,2
Essendon,"Carlisle, Jake",11,7,4,4,0,0,0,3
Essendon,"Colyer, Travis",16,13,5,3,4,0,0,1
Essendon,"Crameri, Stewart",12,2,1,10,0,0,0,5
Essendon,"DellOlio, Cory",19,11,2,8,1,1,0,9
Essendon,"Dempsey, Courtenay",15,7,2,8,0,0,0,4
Essendon,"Fletcher, Dustin",17,13,4,4,0,0,0,1
Essendon,"Goddard, Brendon",19,10,6,9,1,0,0,4
Essendon,"Heppell, Dyson",23,16,5,7,0,0,0,6
Essendon,"Hibberd, Michael",28,14,7,14,0,0,0,1
Essendon,"Hooker, Cale",19,10,8,9,1,0,0,2
Essendon,"Hurley, Michael",14,7,3,7,2,0,0,0
Essendon,"Jetta, Leroy",15,9,2,6,1,1,0,5
Essendon,"Kommer, Nick",8,4,1,4,1,0,0,7
Essendon,"Lovett-Murray, Nathan",8,4,2,4,0,0,1,2
Essendon,"Melksham, Jake",23,14,3,9,2,0,0,2
Essendon,"Merrett, Jackson",10,1,1,9,0,0,0,4
Essendon,"Myers, David",23,16,6,7,1,0,0,5
Essendon,"OBrien, Nick",16,7,1,9,1,0,0,3
Essendon,"Ryder, Paddy",9,6,1,3,0,1,24,3
Essendon,"Stanton, Brent",23,14,1,9,2,0,0,1
Essendon,"Baguley, Mark",18,7,4,11,0,0,1,3
Essendon,"Bellchambers, Tom",11,7,6,4,2,2,15,0
Essendon,"Carlisle, Jake",12,9,5,3,0,0,0,4
Essendon,"Colyer, Travis",15,7,7,8,1,0,0,1
Essendon,"Daniher, Joe",3,2,2,1,0,0,0,0
Essendon,"DellOlio, Cory",6,5,0,1,1,1,0,1
Essendon,"Dempsey, Courtenay",17,13,4,4,0,0,0,3
Essendon,"Goddard, Brendon",24,16,8,8,1,0,1,2
Essendon,"Heppell, Dyson",25,12,2,13,0,0,0,6
Essendon,"Hibberd, Michael",26,10,8,16,0,0,0,0
Essendon,"Hocking, Heath",10,7,2,3,0,0,0,2
Essendon,"Hooker, Cale",19,10,6,9,0,0,0,3
Essendon,"Howlett, Ben",15,8,0,7,0,0,0,7
Essendon,"Hurley, Michael",14,12,5,2,3,3,0,0
Essendon,"Jetta, Leroy",6,4,2,2,1,0,0,3
Essendon,"Kommer, Nick",9,3,3,6,1,0,0,5
Essendon,"Melksham, Jake",25,10,5,15,0,0,0,2
Essendon,"Myers, David",18,9,2,9,1,1,0,3
Essendon,"Pears, Tayte",15,10,6,5,0,0,0,4
Essendon,"Ryder, Paddy",13,9,7,4,1,0,19,2
Essendon,"Stanton, Brent",22,15,4,7,1,0,0,3
Essendon,"Zaharakis, David",17,9,4,8,0,1,0,3
Essendon,"Baguley, Mark",15,5,2,10,0,0,0,5
Essendon,"Bellchambers, Tom",13,8,2,5,1,1,19,1
Essendon,"Carlisle, Jake",8,4,1,4,0,0,0,2
Essendon,"Colyer, Travis",8,6,4,2,0,1,0,1
Essendon,"DellOlio, Cory",14,7,2,7,1,0,0,3
Essendon,"Dempsey, Courtenay",1,0,0,1,0,0,0,1
Essendon,"Fletcher, Dustin",10,7,1,3,0,0,0,0
Essendon,"Goddard, Brendon",27,17,6,10,1,0,1,1
Essendon,"Gumbleton, Scott",11,6,7,5,1,1,0,0
Essendon,"Hardingham, Kyle",11,8,1,3,1,0,0,1
Essendon,"Heppell, Dyson",22,11,0,11,0,1,0,3
Essendon,"Hibberd, Michael",22,9,3,13,0,0,0,4
Essendon,"Hocking, Heath",20,9,1,11,0,0,0,9
Essendon,"Hooker, Cale",25,9,4,16,0,0,0,0
Essendon,"Jetta, Leroy",11,2,3,9,0,1,0,2
Essendon,"Kommer, Nick",8,5,1,3,1,1,0,3
Essendon,"Melksham, Jake",17,12,4,5,1,0,0,3
Essendon,"Myers, David",25,14,4,11,0,1,1,4
Essendon,"Ryder, Paddy",18,8,4,10,0,0,25,2
Essendon,"Stanton, Brent",19,9,2,10,0,0,0,5
Essendon,"Watson, Jobe",31,19,6,12,0,1,0,3
Essendon,"Zaharakis, David",19,7,1,12,0,1,0,0
Essendon,"Baguley, Mark",19,7,7,12,1,0,0,3
Essendon,"Bellchambers, Tom",6,3,3,3,1,1,11,2
Essendon,"Carlisle, Jake",10,6,2,4,0,0,0,2
Essendon,"Davey, Alwyn",9,6,3,3,0,0,0,5
Essendon,"Fletcher, Dustin",14,10,5,4,0,0,0,1
Essendon,"Goddard, Brendon",27,18,10,9,3,0,0,2
Essendon,"Gumbleton, Scott",11,6,5,5,0,2,0,4
Essendon,"Hardingham, Kyle",18,13,10,5,0,1,0,0
Essendon,"Heppell, Dyson",27,14,2,13,0,0,2,4
Essendon,"Hibberd, Michael",30,22,8,8,0,0,0,3
Essendon,"Hocking, Heath",22,9,2,13,0,1,0,8
Essendon,"Hooker, Cale",15,8,4,7,1,0,0,3
Essendon,"Howlett, Ben",9,7,3,2,0,1,0,7
Essendon,"Kommer, Nick",8,4,2,4,1,1,0,4
Essendon,"Melksham, Jake",28,15,5,13,0,1,0,7
Essendon,"Myers, David",17,10,2,7,0,1,0,1
Essendon,"Pears, Tayte",24,16,10,8,0,0,0,2
Essendon,"Ryder, Paddy",14,7,1,7,0,0,27,0
Essendon,"Stanton, Brent",27,14,9,13,0,0,0,2
Essendon,"Watson, Jobe",32,15,8,17,0,0,0,4
Essendon,"Winderlich, Jason",7,5,2,2,2,0,0,0
Essendon,"Zaharakis, David",23,11,6,12,0,0,0,3
Essendon,"Baguley, Mark",21,6,8,15,0,0,0,4
Essendon,"Bellchambers, Tom",9,7,3,2,2,0,26,0
Essendon,"Carlisle, Jake",21,13,8,8,0,0,0,0
Essendon,"Crameri, Stewart",10,6,1,4,0,2,0,2
Essendon,"Dalgleish, Lauchlan",13,9,3,4,0,0,0,1
Essendon,"Daniher, Joe",11,7,6,4,0,4,1,1
Essendon,"Davey, Alwyn",10,6,3,4,2,0,0,2
Essendon,"Goddard, Brendon",30,15,5,15,0,0,0,2
Essendon,"Hardingham, Kyle",14,9,7,5,1,2,0,3
Essendon,"Heppell, Dyson",9,6,2,3,0,0,0,1
Essendon,"Hibberd, Michael",26,15,6,11,0,0,0,0
Essendon,"Hocking, Heath",15,5,5,10,0,1,1,3
Essendon,"Hooker, Cale",18,9,5,9,0,0,0,3
Essendon,"Howlett, Ben",15,8,1,7,0,1,0,0
Essendon,"Jetta, Leroy",14,5,2,9,0,1,0,3
Essendon,"Kommer, Nick",11,6,3,5,1,0,0,1
Essendon,"Melksham, Jake",19,13,4,6,3,2,0,4
Essendon,"OBrien, Nick",6,2,2,4,0,0,0,2
Essendon,"Pears, Tayte",11,5,2,6,0,0,0,2
Essendon,"Stanton, Brent",23,17,6,6,0,1,0,3
Essendon,"Watson, Jobe",31,14,5,17,0,0,0,7
Essendon,"Zaharakis, David",18,8,1,10,0,0,0,2
Essendon,"Baguley, Mark",18,12,6,6,0,0,0,1
Essendon,"Carlisle, Jake",13,10,5,3,0,0,0,1
Essendon,"Crameri, Stewart",11,7,5,4,2,0,0,2
Essendon,"Dalgleish, Lauchlan",16,12,5,4,0,0,0,1
Essendon,"Daniher, Joe",15,9,6,6,0,2,1,0
Essendon,"Davey, Alwyn",4,2,1,2,0,1,0,3
Essendon,"Goddard, Brendon",27,12,8,15,1,0,1,6
Essendon,"Hardingham, Kyle",15,9,6,6,0,0,0,5
Essendon,"Hibberd, Michael",14,8,2,6,0,1,0,3
Essendon,"Hocking, Heath",22,9,2,13,0,1,0,5
Essendon,"Hooker, Cale",21,13,10,8,0,0,0,2
Essendon,"Howlett, Ben",11,8,1,3,0,0,0,5
Essendon,"Hurley, Michael",13,11,9,2,3,2,0,1
Essendon,"Kommer, Nick",13,6,5,7,1,0,0,5
Essendon,"Melksham, Jake",17,15,4,2,0,0,0,2
Essendon,"Merrett, Jackson",13,9,4,4,0,0,0,4
Essendon,"Myers, David",19,11,5,8,1,0,1,2
Essendon,"Pears, Tayte",20,13,9,7,0,0,0,5
Essendon,"Ryder, Paddy",13,11,5,2,1,0,20,5
Essendon,"Stanton, Brent",12,6,2,6,0,0,0,6
Essendon,"Watson, Jobe",27,14,2,13,2,1,0,4
Essendon,"Zaharakis, David",24,17,4,7,1,1,0,4
Essendon,"Baguley, Mark",13,6,6,7,0,0,0,4
Essendon,"Carlisle, Jake",7,5,2,2,0,0,0,0
Essendon,"Crameri, Stewart",14,9,7,5,0,0,0,1
Essendon,"Dalgleish, Lauchlan",13,10,6,3,1,0,0,0
Essendon,"Davey, Alwyn",12,7,2,5,0,1,0,1
Essendon,"Goddard, Brendon",25,16,10,9,0,1,0,5
Essendon,"Hardingham, Kyle",9,6,4,3,0,0,0,1
Essendon,"Hibberd, Michael",26,20,7,6,0,1,0,2
Essendon,"Hille, David",15,8,3,7,0,0,4,1
Essendon,"Hooker, Cale",12,7,4,5,0,0,0,4
Essendon,"Howlett, Ben",10,8,3,2,1,0,0,5
Essendon,"Hurley, Michael",13,8,7,5,2,1,0,0
Essendon,"Jetta, Leroy",7,4,1,3,2,0,0,2
Essendon,"Kavanagh, Elliott",12,5,2,7,0,0,0,4
Essendon,"Lovett-Murray, Nathan",23,10,8,13,1,2,1,0
Essendon,"Melksham, Jake",20,12,9,8,2,0,0,2
Essendon,"Merrett, Jackson",17,11,7,6,0,1,0,0
Essendon,"Pears, Tayte",9,5,5,4,0,0,0,1
Essendon,"Ryder, Paddy",10,7,5,3,0,1,13,2
Essendon,"Stanton, Brent",33,23,14,10,0,0,0,4
Essendon,"Watson, Jobe",25,8,5,17,0,0,0,1
Essendon,"Zaharakis, David",16,7,5,9,0,0,0,5
Fremantle,"Ballantyne, Hayden",7,5,3,2,1,0,0,4
Fremantle,"Barlow, Michael",27,14,4,13,1,1,2,9
Fremantle,"Bradley, Kepler",13,8,3,5,2,0,10,0
Fremantle,"Crowley, Ryan",12,6,2,6,1,0,1,3
Fremantle,"Dawson, Zac",7,3,1,4,0,0,0,2
Fremantle,"Duffield, Paul",16,14,6,2,0,1,0,2
Fremantle,"Fyfe, Nat",21,14,6,7,0,0,0,2
Fremantle,"Griffin, Jonathon",12,4,4,8,0,0,20,5
Fremantle,"Hill, Stephen",26,17,3,9,0,1,0,4
Fremantle,"Johnson, Michael",10,7,5,3,0,0,0,2
Fremantle,"Mayne, Chris",19,12,8,7,2,0,0,4
Fremantle,"McPharlin, Luke",9,5,3,4,0,0,0,3
Fremantle,"Mundy, David",27,15,4,12,0,1,0,10
Fremantle,"Mzungu, Tendai",13,5,5,8,0,1,1,3
Fremantle,"Pavlich, Matthew",14,8,3,6,0,3,1,2
Fremantle,"Pearce, Clancee",17,11,5,6,0,0,0,3
Fremantle,"Pearce, Danyle",23,13,2,10,2,1,0,5
Fremantle,"Spurr, Lee",13,11,6,2,0,0,0,3
Fremantle,"Suban, Nick",19,13,4,6,3,0,0,5
Fremantle,"Sutcliffe, Cam",2,1,1,1,0,0,0,1
Fremantle,"Walters, Michael",16,13,5,3,3,2,0,1
Fremantle,"de Boer, Matt",12,7,4,5,1,0,0,1
Fremantle,"Barlow, Michael",19,11,4,8,1,0,1,7
Fremantle,"Bradley, Kepler",10,7,4,3,2,0,2,2
Fremantle,"Crowley, Ryan",4,2,1,2,0,0,0,2
Fremantle,"Crozier, Hayden",8,7,3,1,2,0,0,2
Fremantle,"Dawson, Zac",7,2,1,5,0,0,0,4
Fremantle,"Duffield, Paul",18,14,9,4,0,0,0,1
Fremantle,"Fyfe, Nat",25,13,4,12,1,0,3,5
Fremantle,"Griffin, Jonathon",13,9,6,4,0,1,23,3
Fremantle,"Hill, Stephen",16,9,3,7,1,0,0,1
Fremantle,"Johnson, Michael",16,12,7,4,0,0,0,2
Fremantle,"Mayne, Chris",11,6,3,5,1,1,0,4
Fremantle,"McPharlin, Luke",24,21,15,3,0,0,0,0
Fremantle,"Mundy, David",17,9,4,8,0,1,0,4
Fremantle,"Mzungu, Tendai",22,15,9,7,1,0,0,2
Fremantle,"Pavlich, Matthew",15,12,8,3,2,3,0,2
Fremantle,"Pearce, Clancee",15,8,1,7,0,0,0,2
Fremantle,"Pearce, Danyle",16,11,4,5,0,1,0,6
Fremantle,"Spurr, Lee",9,6,5,3,0,0,0,4
Fremantle,"Suban, Nick",20,14,6,6,0,1,0,1
Fremantle,"Sutcliffe, Cam",9,6,5,3,1,0,0,0
Fremantle,"Walters, Michael",14,11,6,3,3,1,0,5
Fremantle,"de Boer, Matt",13,4,4,9,1,0,0,4
Fremantle,"Ballantyne, Hayden",17,13,4,4,1,3,0,2
Fremantle,"Barlow, Michael",22,13,4,9,0,0,2,6
Fremantle,"Bradley, Kepler",9,6,2,3,0,1,8,3
Fremantle,"Crowley, Ryan",6,4,0,2,0,0,0,2
Fremantle,"Dawson, Zac",5,1,0,4,0,0,0,2
Fremantle,"Duffield, Paul",17,15,7,2,1,1,0,3
Fremantle,"Fyfe, Nat",27,21,4,6,2,0,2,3
Fremantle,"Griffin, Jonathon",14,12,0,2,0,0,32,5
Fremantle,"Hill, Stephen",15,6,0,9,0,0,0,5
Fremantle,"Johnson, Michael",18,16,7,2,0,0,0,2
Fremantle,"Mayne, Chris",16,9,4,7,3,2,0,3
Fremantle,"McPharlin, Luke",0,0,0,0,0,0,0,0
Fremantle,"Mundy, David",19,11,3,8,0,0,0,7
Fremantle,"Mzungu, Tendai",13,10,5,3,0,0,0,4
Fremantle,"Pavlich, Matthew",10,6,2,4,0,0,0,4
Fremantle,"Pearce, Clancee",20,13,6,7,0,1,0,4
Fremantle,"Pearce, Danyle",21,17,3,4,0,2,0,4
Fremantle,"Spurr, Lee",15,12,3,3,0,1,0,3
Fremantle,"Suban, Nick",10,6,1,4,0,0,0,4
Fremantle,"Sutcliffe, Cam",13,9,3,4,0,0,0,5
Fremantle,"Walters, Michael",15,10,5,5,2,3,0,7
Fremantle,"de Boer, Matt",16,8,3,8,0,0,0,10
Fremantle,"Ballantyne, Hayden",11,8,4,3,1,1,0,1
Fremantle,"Barlow, Michael",25,7,2,18,0,0,2,4
Fremantle,"Bradley, Kepler",13,8,3,5,3,0,1,0
Fremantle,"Crowley, Ryan",21,13,7,8,1,2,0,1
Fremantle,"Dawson, Zac",6,0,1,6,0,0,0,0
Fremantle,"Duffield, Paul",21,18,4,3,0,0,0,3
Fremantle,"Fyfe, Nat",27,16,3,11,0,0,4,4
Fremantle,"Griffin, Jonathon",6,4,0,2,0,1,22,5
Fremantle,"Hill, Stephen",14,9,2,5,0,0,0,3
Fremantle,"Johnson, Michael",10,6,1,4,0,0,1,2
Fremantle,"Mayne, Chris",18,7,8,11,2,0,1,3
Fremantle,"Mundy, David",26,16,4,10,1,0,3,5
Fremantle,"Mzungu, Tendai",14,10,4,4,0,0,0,1
Fremantle,"Neale, Lachie",14,7,2,7,1,1,0,1
Fremantle,"Pearce, Clancee",15,7,4,8,0,0,0,0
Fremantle,"Pearce, Danyle",23,15,4,8,0,0,0,3
Fremantle,"Smith, Tanner",8,4,4,4,0,0,0,2
Fremantle,"Spurr, Lee",15,9,6,6,0,0,0,2
Fremantle,"Suban, Nick",2,1,1,1,0,0,0,2
Fremantle,"Sutcliffe, Cam",10,5,2,5,1,0,0,3
Fremantle,"Walters, Michael",18,14,7,4,1,1,0,3
Fremantle,"de Boer, Matt",11,5,4,6,0,0,0,4
Fremantle,"Ballantyne, Hayden",16,12,1,4,4,0,0,0
Fremantle,"Barlow, Michael",31,18,5,13,0,1,2,6
Fremantle,"Bradley, Kepler",6,4,1,2,0,1,0,0
Fremantle,"Crowley, Ryan",11,6,3,5,1,0,0,4
Fremantle,"Dawson, Zac",9,3,5,6,0,0,1,1
Fremantle,"Fyfe, Nat",23,14,5,9,0,0,2,6
Fremantle,"Griffin, Jonathon",21,12,5,9,0,1,23,1
Fremantle,"Hannath, Jack",4,2,1,2,0,0,11,1
Fremantle,"Hill, Stephen",23,13,1,10,1,0,0,5
Fremantle,"Ibbotson, Garrick",24,16,11,8,0,0,0,2
Fremantle,"Johnson, Michael",18,14,10,4,0,0,0,4
Fremantle,"Mayne, Chris",10,9,4,1,3,0,0,3
Fremantle,"McPharlin, Luke",17,13,10,4,0,0,0,2
Fremantle,"Mundy, David",17,12,4,5,0,0,0,4
Fremantle,"Mzungu, Tendai",18,10,4,8,0,0,0,0
Fremantle,"Neale, Lachie",12,4,2,8,0,0,0,0
Fremantle,"Pearce, Clancee",24,13,10,11,0,0,0,3
Fremantle,"Pearce, Danyle",12,9,3,3,0,0,0,5
Fremantle,"Spurr, Lee",23,17,7,6,0,0,0,3
Fremantle,"Suban, Nick",16,15,8,1,1,1,0,4
Fremantle,"Walters, Michael",15,13,6,2,2,3,0,1
Fremantle,"de Boer, Matt",18,7,5,11,0,1,0,9
Fremantle,"Ballantyne, Hayden",11,9,4,2,0,1,0,2
Fremantle,"Barlow, Michael",20,8,5,12,0,0,1,4
Fremantle,"Crowley, Ryan",9,4,2,5,0,1,0,4
Fremantle,"Crozier, Hayden",14,11,2,3,2,0,0,3
Fremantle,"Dawson, Zac",12,5,5,7,0,0,1,1
Fremantle,"Duffield, Paul",17,11,6,6,0,1,0,8
Fremantle,"Griffin, Jonathon",9,4,3,5,3,0,31,4
Fremantle,"Hannath, Jack",10,5,3,5,1,0,9,2
Fremantle,"Ibbotson, Garrick",22,18,9,4,0,0,0,1
Fremantle,"Johnson, Michael",17,10,6,7,0,0,0,1
Fremantle,"Mayne, Chris",14,11,7,3,1,0,0,5
Fremantle,"McPharlin, Luke",21,18,10,3,0,0,1,1
Fremantle,"Mundy, David",22,12,3,10,0,0,4,6
Fremantle,"Mzungu, Tendai",16,12,6,4,0,2,0,2
Fremantle,"Pearce, Clancee",20,10,6,10,1,0,0,1
Fremantle,"Pearce, Danyle",16,9,0,7,0,1,0,2
Fremantle,"Silvagni, Alex",7,4,2,3,1,0,0,5
Fremantle,"Spurr, Lee",17,13,8,4,0,0,0,3
Fremantle,"Suban, Nick",22,15,2,7,1,1,0,3
Fremantle,"Sutcliffe, Cam",7,6,1,1,1,0,0,1
Fremantle,"Walters, Michael",17,13,3,4,4,1,0,1
Fremantle,"de Boer, Matt",14,7,1,7,0,0,0,8
Fremantle,"Ballantyne, Hayden",13,9,5,4,1,1,0,1
Fremantle,"Barlow, Michael",28,15,3,13,0,0,3,4
Fremantle,"Crowley, Ryan",12,3,0,9,0,0,1,7
Fremantle,"Crozier, Hayden",14,10,4,4,1,0,0,0
Fremantle,"Dawson, Zac",12,6,3,6,0,0,6,2
Fremantle,"Duffield, Paul",30,22,7,8,0,1,0,1
Fremantle,"Griffin, Jonathon",2,1,1,1,0,0,3,0
Fremantle,"Hannath, Jack",9,4,2,5,1,0,14,1
Fremantle,"Ibbotson, Garrick",29,21,12,8,0,0,0,5
Fremantle,"Johnson, Michael",15,12,5,3,0,0,0,3
Fremantle,"Mayne, Chris",13,5,6,8,2,0,1,5
Fremantle,"McPharlin, Luke",22,15,10,7,0,0,0,1
Fremantle,"Mundy, David",20,11,4,9,1,0,1,6
Fremantle,"Mzungu, Tendai",17,10,4,7,1,0,0,3
Fremantle,"Pearce, Clancee",21,13,7,8,1,0,0,1
Fremantle,"Pearce, Danyle",17,9,3,8,0,2,0,2
Fremantle,"Silvagni, Alex",13,7,8,6,1,3,0,6
Fremantle,"Spurr, Lee",17,6,4,11,0,0,0,1
Fremantle,"Suban, Nick",18,12,2,6,0,0,0,6
Fremantle,"Sutcliffe, Cam",19,12,6,7,1,0,0,0
Fremantle,"Walters, Michael",19,14,6,5,4,2,0,5
Fremantle,"de Boer, Matt",10,6,2,4,1,0,0,3
Fremantle,"Ballantyne, Hayden",11,8,2,3,2,2,0,3
Fremantle,"Barlow, Michael",28,14,7,14,0,1,3,7
Fremantle,"Clarke, Zac",16,4,7,12,1,0,27,4
Fremantle,"Crowley, Ryan",15,6,2,9,0,0,0,3
Fremantle,"Dawson, Zac",4,0,2,4,0,0,0,2
Fremantle,"Duffield, Paul",24,18,9,6,1,0,0,3
Fremantle,"Fyfe, Nat",23,16,5,7,2,2,2,6
Fremantle,"Hannath, Jack",5,2,1,3,0,0,6,4
Fremantle,"Ibbotson, Garrick",16,12,4,4,0,1,0,2
Fremantle,"Johnson, Michael",25,17,7,8,1,0,0,1
Fremantle,"Mayne, Chris",15,9,5,6,1,2,0,1
Fremantle,"McPharlin, Luke",16,11,10,5,0,0,0,2
Fremantle,"Mundy, David",24,11,5,13,0,0,1,8
Fremantle,"Mzungu, Tendai",7,3,0,4,0,0,0,2
Fremantle,"Pearce, Clancee",19,13,9,6,0,0,0,3
Fremantle,"Pearce, Danyle",21,13,5,8,0,0,0,6
Fremantle,"Silvagni, Alex",4,1,0,3,0,0,0,0
Fremantle,"Spurr, Lee",19,12,3,7,0,0,0,5
Fremantle,"Suban, Nick",14,9,2,5,1,1,0,4
Fremantle,"Sutcliffe, Cam",14,9,5,5,0,1,0,2
Fremantle,"Walters, Michael",13,9,4,4,0,1,0,1
Fremantle,"de Boer, Matt",19,13,6,6,0,1,0,10
Fremantle,"Ballantyne, Hayden",15,13,7,2,3,3,0,4
Fremantle,"Barlow, Michael",32,13,7,19,1,0,1,11
Fremantle,"Clarke, Zac",15,5,5,10,0,1,21,5
Fremantle,"Crowley, Ryan",14,8,5,6,1,1,1,4
Fremantle,"Crozier, Hayden",13,11,7,2,2,3,0,1
Fremantle,"Dawson, Zac",11,3,6,8,0,0,0,1
Fremantle,"Duffield, Paul",27,19,11,8,0,0,0,3
Fremantle,"Fyfe, Nat",32,14,5,18,1,0,0,1
Fremantle,"Hannath, Jack",12,9,5,3,1,0,5,1
Fremantle,"Ibbotson, Garrick",28,18,14,10,1,0,0,2
Fremantle,"Johnson, Michael",29,19,10,10,0,0,0,1
Fremantle,"Mayne, Chris",23,11,10,12,2,0,0,3
Fremantle,"McPharlin, Luke",17,15,10,2,0,0,2,0
Fremantle,"Mundy, David",34,23,7,11,1,2,2,3
Fremantle,"Mzungu, Tendai",24,14,10,10,3,0,1,6
Fremantle,"Pearce, Clancee",31,18,10,13,0,0,0,2
Fremantle,"Pearce, Danyle",23,15,4,8,2,2,0,2
Fremantle,"Silvagni, Alex",12,9,5,3,1,0,0,3
Fremantle,"Spurr, Lee",28,18,11,10,0,0,0,2
Fremantle,"Suban, Nick",8,5,4,3,0,0,0,2
Fremantle,"Sutcliffe, Cam",21,14,7,7,0,0,0,3
Fremantle,"de Boer, Matt",22,12,7,10,0,0,0,8
Fremantle,"Ballantyne, Hayden",16,11,4,5,1,1,0,4
Fremantle,"Barlow, Michael",32,15,1,17,1,1,1,8
Fremantle,"Clarke, Zac",9,3,1,6,1,0,29,6
Fremantle,"Crowley, Ryan",6,5,0,1,0,0,0,3
Fremantle,"Crozier, Hayden",10,6,3,4,1,0,0,7
Fremantle,"Dawson, Zac",9,4,3,5,0,0,4,2
Fremantle,"Duffield, Paul",18,16,5,2,0,0,0,3
Fremantle,"Fyfe, Nat",23,14,4,9,1,0,0,3
Fremantle,"Hannath, Jack",2,1,0,1,0,0,1,1
Fremantle,"Hill, Stephen",24,13,4,11,0,1,1,2
Fremantle,"Ibbotson, Garrick",17,13,6,4,0,0,0,1
Fremantle,"Johnson, Michael",19,14,9,5,0,0,0,4
Fremantle,"Mayne, Chris",16,8,5,8,1,0,0,4
Fremantle,"McPharlin, Luke",16,14,7,2,0,0,0,4
Fremantle,"Mundy, David",20,16,0,4,0,0,1,4
Fremantle,"Mzungu, Tendai",17,14,2,3,1,0,1,3
Fremantle,"Pearce, Clancee",21,12,6,9,0,0,0,3
Fremantle,"Pearce, Danyle",21,16,3,5,0,0,0,4
Fremantle,"Spurr, Lee",15,11,5,4,0,0,0,3
Fremantle,"Suban, Nick",15,11,1,4,2,1,0,6
Fremantle,"Sutcliffe, Cam",7,4,1,3,1,0,0,0
Fremantle,"de Boer, Matt",18,9,4,9,0,0,0,9
Fremantle,"Ballantyne, Hayden",14,11,6,3,0,3,0,1
Fremantle,"Barlow, Michael",32,12,7,20,0,2,3,4
Fremantle,"Clarke, Zac",10,5,3,5,1,0,28,1
Fremantle,"Crowley, Ryan",19,11,7,8,1,0,1,2
Fremantle,"Crozier, Hayden",7,5,3,2,0,0,0,1
Fremantle,"Dawson, Zac",8,4,7,4,0,0,0,0
Fremantle,"Duffield, Paul",18,12,4,6,0,0,0,3
Fremantle,"Fyfe, Nat",20,15,2,5,0,0,2,3
Fremantle,"Hannath, Jack",8,5,6,3,1,1,6,1
Fremantle,"Hill, Stephen",17,11,3,6,1,1,0,2
Fremantle,"Ibbotson, Garrick",28,20,11,8,0,0,0,3
Fremantle,"Johnson, Michael",20,17,10,3,2,0,1,1
Fremantle,"Mayne, Chris",15,10,8,5,2,1,0,2
Fremantle,"McPharlin, Luke",19,14,10,5,0,0,0,3
Fremantle,"Mundy, David",27,18,6,9,2,1,0,5
Fremantle,"Mzungu, Tendai",27,17,9,10,0,0,1,3
Fremantle,"Pearce, Clancee",27,12,8,15,0,0,0,3
Fremantle,"Pearce, Danyle",25,19,7,6,1,2,0,0
Fremantle,"Silvagni, Alex",5,3,3,2,0,0,0,1
Fremantle,"Spurr, Lee",17,11,7,6,0,0,0,2
Fremantle,"Suban, Nick",13,8,3,5,0,1,0,4
Fremantle,"de Boer, Matt",13,7,5,6,1,0,0,3
Fremantle,"Ballantyne, Hayden",11,7,2,4,0,0,0,3
Fremantle,"Barlow, Michael",31,17,3,14,1,0,1,7
Fremantle,"Clarke, Zac",17,11,6,6,0,0,28,4
Fremantle,"Crowley, Ryan",14,6,3,8,0,1,0,0
Fremantle,"Crozier, Hayden",7,7,4,0,1,0,0,0
Fremantle,"Dawson, Zac",7,1,2,6,0,0,0,2
Fremantle,"Duffield, Paul",19,12,4,7,0,0,0,2
Fremantle,"Fyfe, Nat",28,22,7,6,1,1,3,3
Fremantle,"Hannath, Jack",5,4,2,1,1,0,2,3
Fremantle,"Hill, Stephen",17,7,0,10,0,0,1,3
Fremantle,"Ibbotson, Garrick",27,16,10,11,0,0,0,1
Fremantle,"Johnson, Michael",22,20,11,2,1,1,0,1
Fremantle,"Mayne, Chris",17,6,4,11,1,0,0,6
Fremantle,"McPharlin, Luke",24,16,13,8,0,0,2,0
Fremantle,"Mzungu, Tendai",17,9,3,8,0,0,1,3
Fremantle,"Pearce, Clancee",12,9,4,3,0,0,1,3
Fremantle,"Pearce, Danyle",15,10,0,5,0,1,0,6
Fremantle,"Spurr, Lee",19,10,5,9,0,0,0,3
Fremantle,"Suban, Nick",14,9,1,5,2,0,0,5
Fremantle,"Taberner, Matthew",8,2,1,6,0,0,0,6
Fremantle,"Walters, Michael",12,7,3,5,1,0,0,6
Fremantle,"de Boer, Matt",20,10,3,10,1,1,0,11
Fremantle,"Ballantyne, Hayden",8,5,4,3,0,0,0,7
Fremantle,"Clarke, Zac",14,7,6,7,0,0,24,2
Fremantle,"Crowley, Ryan",15,9,4,6,0,0,0,3
Fremantle,"Crozier, Hayden",12,9,4,3,0,0,0,5
Fremantle,"Dawson, Zac",9,2,2,7,0,0,0,1
Fremantle,"Duffield, Paul",10,9,3,1,0,0,0,3
Fremantle,"Fyfe, Nat",23,11,1,12,0,0,2,5
Fremantle,"Hannath, Jack",2,0,0,2,0,0,6,3
Fremantle,"Hill, Stephen",13,9,4,4,0,0,0,1
Fremantle,"Ibbotson, Garrick",19,13,7,6,0,0,0,6
Fremantle,"Johnson, Michael",18,12,3,6,0,0,1,5
Fremantle,"Mayne, Chris",12,5,3,7,1,0,0,5
Fremantle,"McPharlin, Luke",21,17,11,4,0,0,0,2
Fremantle,"Michie, Viv",13,7,1,6,0,0,0,3
Fremantle,"Mzungu, Tendai",19,14,9,5,1,0,0,4
Fremantle,"Pearce, Clancee",19,9,7,10,0,0,0,1
Fremantle,"Pearce, Danyle",24,16,5,8,0,1,0,7
Fremantle,"Sheridan, Tom",15,8,1,7,1,0,0,4
Fremantle,"Suban, Nick",15,9,2,6,0,0,0,6
Fremantle,"Taberner, Matthew",6,5,4,1,1,0,0,3
Fremantle,"Walters, Michael",14,9,2,5,3,0,0,1
Fremantle,"de Boer, Matt",15,6,3,9,0,0,0,5
Fremantle,"Ballantyne, Hayden",16,14,8,2,5,1,0,2
Fremantle,"Barlow, Michael",32,17,6,15,0,1,1,3
Fremantle,"Clarke, Zac",13,2,1,11,0,0,17,3
Fremantle,"Crowley, Ryan",23,13,7,10,0,0,0,1
Fremantle,"Dawson, Zac",12,2,4,10,0,0,3,4
Fremantle,"Fyfe, Nat",35,17,4,18,0,1,3,2
Fremantle,"Hill, Stephen",12,5,3,7,0,1,0,2
Fremantle,"Ibbotson, Garrick",22,13,6,9,0,0,0,1
Fremantle,"Johnson, Michael",29,20,12,9,0,0,0,1
Fremantle,"Mayne, Chris",20,10,8,10,2,0,0,2
Fremantle,"McPharlin, Luke",17,10,5,7,0,0,0,0
Fremantle,"Mundy, David",26,17,5,9,2,0,3,4
Fremantle,"Mzungu, Tendai",29,17,5,12,1,0,0,4
Fremantle,"Pavlich, Matthew",21,11,9,10,2,1,0,1
Fremantle,"Pearce, Clancee",25,15,10,10,0,1,0,0
Fremantle,"Pearce, Danyle",22,13,3,9,1,1,0,3
Fremantle,"Sandilands, Aaron",6,1,2,5,0,0,11,1
Fremantle,"Sheridan, Tom",5,3,2,2,0,0,0,1
Fremantle,"Spurr, Lee",25,15,9,10,0,0,0,1
Fremantle,"Suban, Nick",19,9,3,10,0,1,0,4
Fremantle,"Walters, Michael",13,6,6,7,1,0,0,2
Fremantle,"de Boer, Matt",17,7,8,10,1,0,0,5
Fremantle,"Ballantyne, Hayden",13,8,5,5,0,1,0,3
Fremantle,"Barlow, Michael",26,9,2,17,2,0,0,6
Fremantle,"Clarke, Zac",12,3,3,9,0,0,13,0
Fremantle,"Crowley, Ryan",25,16,3,9,1,2,0,1
Fremantle,"Dawson, Zac",6,2,0,4,0,0,0,1
Fremantle,"Fyfe, Nat",30,21,8,9,1,0,1,4
Fremantle,"Hill, Stephen",26,13,4,13,2,0,0,2
Fremantle,"Ibbotson, Garrick",20,13,8,7,0,0,0,1
Fremantle,"Johnson, Michael",21,13,4,8,0,1,1,1
Fremantle,"Mayne, Chris",21,9,6,12,3,0,0,9
Fremantle,"Mundy, David",28,18,4,10,0,1,0,6
Fremantle,"Mzungu, Tendai",18,14,4,4,1,0,1,2
Fremantle,"Pavlich, Matthew",11,8,6,3,3,0,0,3
Fremantle,"Pearce, Clancee",6,2,1,4,0,0,0,1
Fremantle,"Pearce, Danyle",11,5,3,6,1,0,0,0
Fremantle,"Sandilands, Aaron",10,1,1,9,0,0,32,0
Fremantle,"Sheridan, Tom",15,8,3,7,1,0,0,5
Fremantle,"Silvagni, Alex",7,6,5,1,0,0,0,0
Fremantle,"Spurr, Lee",16,9,4,7,0,0,0,4
Fremantle,"Sutcliffe, Cam",10,6,1,4,1,0,0,3
Fremantle,"Walters, Michael",17,14,7,3,3,1,0,1
Fremantle,"de Boer, Matt",16,4,2,12,0,0,0,6
Fremantle,"Barlow, Michael",22,11,7,11,0,1,1,7
Fremantle,"Clarke, Zac",13,4,5,9,0,0,25,4
Fremantle,"Crowley, Ryan",6,4,3,2,0,0,0,2
Fremantle,"Dawson, Zac",12,3,4,9,0,0,0,3
Fremantle,"Duffield, Paul",10,6,3,4,0,0,0,3
Fremantle,"Fyfe, Nat",27,16,2,11,0,2,0,3
Fremantle,"Hannath, Jack",10,6,5,4,0,0,2,1
Fremantle,"Hill, Stephen",11,6,2,5,0,1,0,4
Fremantle,"Ibbotson, Garrick",18,11,4,7,0,0,0,3
Fremantle,"Johnson, Michael",21,11,5,10,0,0,0,2
Fremantle,"Mayne, Chris",16,6,7,10,2,0,0,5
Fremantle,"Mundy, David",24,14,4,10,0,0,1,8
Fremantle,"Mzungu, Tendai",21,14,4,7,3,0,1,4
Fremantle,"Neale, Lachie",21,9,4,12,0,1,0,1
Fremantle,"Pearce, Clancee",13,10,6,3,0,1,0,6
Fremantle,"Pearce, Danyle",20,12,6,8,0,1,0,1
Fremantle,"Sheridan, Tom",12,5,3,7,0,0,0,2
Fremantle,"Silvagni, Alex",8,5,2,3,1,0,0,3
Fremantle,"Spurr, Lee",19,12,8,7,0,0,0,4
Fremantle,"Sutcliffe, Cam",8,5,4,3,0,0,0,3
Fremantle,"Walters, Michael",20,13,8,7,1,0,0,2
Fremantle,"de Boer, Matt",14,5,4,9,1,1,0,2
Fremantle,"Barlow, Michael",26,9,3,17,0,1,1,6
Fremantle,"Clarke, Zac",15,4,3,11,1,0,10,2
Fremantle,"Crowley, Ryan",14,6,2,8,0,0,1,4
Fremantle,"Dawson, Zac",16,4,6,12,0,0,0,0
Fremantle,"Duffield, Paul",19,14,9,5,0,0,0,0
Fremantle,"Fyfe, Nat",29,19,9,10,4,2,0,1
Fremantle,"Hill, Stephen",27,15,6,12,1,1,1,2
Fremantle,"Ibbotson, Garrick",12,7,4,5,0,0,0,4
Fremantle,"Johnson, Michael",24,18,6,6,0,0,0,3
Fremantle,"Mayne, Chris",16,10,10,6,2,0,0,4
Fremantle,"Mundy, David",23,11,6,12,0,0,0,4
Fremantle,"Mzungu, Tendai",17,12,6,5,0,0,0,0
Fremantle,"Neale, Lachie",26,9,4,17,0,0,0,1
Fremantle,"Pearce, Clancee",25,16,8,9,0,0,0,5
Fremantle,"Pearce, Danyle",15,11,4,4,0,1,0,4
Fremantle,"Sandilands, Aaron",12,2,3,10,0,0,26,1
Fremantle,"Spurr, Lee",15,9,4,6,0,0,0,4
Fremantle,"Suban, Nick",20,14,5,6,0,1,0,3
Fremantle,"Sutcliffe, Cam",4,3,2,1,0,0,0,1
Fremantle,"Taberner, Matthew",6,4,1,2,0,0,0,0
Fremantle,"Walters, Michael",14,11,5,3,2,1,0,1
Fremantle,"de Boer, Matt",16,9,4,7,1,0,0,7
Fremantle,"Ballantyne, Hayden",17,15,4,2,3,3,0,3
Fremantle,"Barlow, Michael",26,12,5,14,1,0,0,5
Fremantle,"Clarke, Zac",11,2,3,9,0,2,17,6
Fremantle,"Crowley, Ryan",9,6,1,3,0,0,1,5
Fremantle,"Dawson, Zac",9,0,2,9,0,0,0,3
Fremantle,"Duffield, Paul",9,9,0,0,0,0,0,5
Fremantle,"Fyfe, Nat",30,19,4,11,0,0,1,3
Fremantle,"Hill, Stephen",14,10,3,4,2,0,0,2
Fremantle,"Johnson, Michael",13,10,3,3,0,0,0,3
Fremantle,"Mayne, Chris",18,8,7,10,0,1,1,5
Fremantle,"Mundy, David",20,13,5,7,0,1,2,5
Fremantle,"Mzungu, Tendai",21,13,5,8,1,0,0,5
Fremantle,"Neale, Lachie",24,13,3,11,2,0,0,2
Fremantle,"Pearce, Clancee",8,3,1,5,0,0,0,3
Fremantle,"Pearce, Danyle",20,13,4,7,1,1,0,6
Fremantle,"Sandilands, Aaron",14,4,4,10,1,1,28,1
Fremantle,"Sheridan, Tom",3,1,1,2,0,0,0,0
Fremantle,"Spurr, Lee",12,6,5,6,0,0,0,2
Fremantle,"Suban, Nick",18,14,4,4,2,1,0,3
Fremantle,"Sutcliffe, Cam",14,11,4,3,0,0,0,1
Fremantle,"Walters, Michael",17,12,4,5,4,1,0,2
Fremantle,"de Boer, Matt",20,8,2,12,0,1,0,5
Fremantle,"Ballantyne, Hayden",12,9,4,3,2,2,0,4
Fremantle,"Barlow, Michael",27,12,3,15,1,0,0,7
Fremantle,"Clarke, Zac",21,10,5,11,1,0,20,3
Fremantle,"Crowley, Ryan",19,6,4,13,1,0,1,6
Fremantle,"Dawson, Zac",14,2,1,12,0,0,0,0
Fremantle,"Duffield, Paul",18,17,9,1,1,0,0,1
Fremantle,"Fyfe, Nat",19,12,4,7,2,0,2,2
Fremantle,"Johnson, Michael",26,17,7,9,0,0,0,1
Fremantle,"Mayne, Chris",18,7,3,11,2,1,0,11
Fremantle,"Mundy, David",24,14,2,10,0,0,1,3
Fremantle,"Mzungu, Tendai",23,13,9,10,2,1,0,2
Fremantle,"Neale, Lachie",26,11,4,15,3,0,0,3
Fremantle,"Pavlich, Matthew",11,7,6,4,2,3,0,1
Fremantle,"Pearce, Danyle",25,15,6,10,0,2,0,3
Fremantle,"Sandilands, Aaron",6,0,0,6,0,0,28,0
Fremantle,"Sheridan, Tom",15,8,3,7,1,0,0,2
Fremantle,"Silvagni, Alex",12,11,8,1,0,0,0,2
Fremantle,"Spurr, Lee",20,15,7,5,0,1,0,1
Fremantle,"Suban, Nick",26,20,8,6,2,0,0,2
Fremantle,"Sutcliffe, Cam",4,4,1,0,1,0,0,0
Fremantle,"Walters, Michael",13,10,4,3,2,1,0,2
Fremantle,"de Boer, Matt",15,7,4,8,1,1,0,4
Fremantle,"Ballantyne, Hayden",14,10,4,4,4,2,0,5
Fremantle,"Barlow, Michael",28,16,5,12,0,0,2,7
Fremantle,"Clarke, Zac",22,9,8,13,1,0,20,3
Fremantle,"Crowley, Ryan",22,7,4,15,0,0,1,1
Fremantle,"Dawson, Zac",11,2,1,9,0,0,0,3
Fremantle,"Duffield, Paul",22,18,11,4,0,1,0,0
Fremantle,"Fyfe, Nat",22,13,4,9,1,2,1,0
Fremantle,"Hill, Stephen",25,18,8,7,2,0,0,4
Fremantle,"Johnson, Michael",19,13,10,6,0,0,0,1
Fremantle,"Mayne, Chris",16,8,7,8,2,1,0,3
Fremantle,"Mundy, David",34,18,8,16,0,0,1,2
Fremantle,"Mzungu, Tendai",19,10,6,9,0,0,0,5
Fremantle,"Neale, Lachie",30,17,10,13,0,0,0,4
Fremantle,"Pavlich, Matthew",18,13,8,5,4,1,0,1
Fremantle,"Pearce, Danyle",32,17,7,15,1,0,0,4
Fremantle,"Sandilands, Aaron",1,1,1,0,1,0,3,0
Fremantle,"Sheridan, Tom",23,15,6,8,1,1,0,1
Fremantle,"Silvagni, Alex",10,5,6,5,1,0,3,3
Fremantle,"Spurr, Lee",17,10,2,7,1,0,0,1
Fremantle,"Suban, Nick",19,13,2,6,0,0,0,4
Fremantle,"Walters, Michael",23,14,11,9,1,1,0,4
Fremantle,"de Boer, Matt",24,12,6,12,0,0,0,2
Fremantle,"Ballantyne, Hayden",19,15,5,4,4,1,0,3
Fremantle,"Barlow, Michael",22,10,1,12,1,0,0,4
Fremantle,"Clarke, Zac",15,7,5,8,2,0,30,2
Fremantle,"Crowley, Ryan",18,12,4,6,1,1,0,6
Fremantle,"Dawson, Zac",7,4,4,3,0,0,0,2
Fremantle,"Duffield, Paul",18,13,9,5,0,0,0,2
Fremantle,"Fyfe, Nat",25,14,6,11,0,1,3,4
Fremantle,"Hannath, Jack",8,4,1,4,1,0,8,0
Fremantle,"Hill, Stephen",21,10,2,11,0,0,0,1
Fremantle,"Johnson, Michael",17,13,5,4,1,0,0,0
Fremantle,"Mayne, Chris",21,9,4,12,0,0,0,3
Fremantle,"Mundy, David",25,13,2,12,0,0,0,7
Fremantle,"Mzungu, Tendai",18,9,4,9,0,0,1,4
Fremantle,"Neale, Lachie",28,13,3,15,1,1,0,2
Fremantle,"Pavlich, Matthew",18,7,8,11,4,1,0,2
Fremantle,"Pearce, Danyle",25,18,4,7,0,1,0,1
Fremantle,"Sheridan, Tom",17,10,4,7,2,0,0,2
Fremantle,"Spurr, Lee",14,12,6,2,0,0,0,0
Fremantle,"Suban, Nick",5,1,0,4,0,0,0,1
Fremantle,"Sutcliffe, Cam",18,8,5,10,1,0,0,2
Fremantle,"Walters, Michael",14,10,4,4,3,1,0,2
Fremantle,"de Boer, Matt",15,5,2,10,0,0,0,11
Fremantle,"Barlow, Michael",21,8,1,13,0,1,0,2
Fremantle,"Crichton, Jesse",15,10,5,5,0,0,0,5
Fremantle,"Crowley, Ryan",28,15,8,13,0,0,0,2
Fremantle,"Crozier, Hayden",15,9,3,6,1,1,0,2
Fremantle,"Duffield, Paul",9,8,3,1,0,0,0,2
Fremantle,"Faulks, Peter",9,6,5,3,0,0,0,0
Fremantle,"Forster, Alex",9,4,1,5,0,0,0,3
Fremantle,"Hannath, Jack",11,7,5,4,1,0,0,1
Fremantle,"Mellington, Josh",17,8,5,9,0,0,0,1
Fremantle,"Moller, Craig",5,1,0,4,0,0,3,0
Fremantle,"Mzungu, Tendai",18,10,4,8,0,1,0,0
Fremantle,"Neale, Lachie",17,8,2,9,0,1,0,4
Fremantle,"Pavlich, Matthew",10,9,3,1,1,0,0,1
Fremantle,"Pearce, Clancee",1,1,1,0,0,0,0,0
Fremantle,"Pearce, Danyle",18,13,2,5,0,0,0,2
Fremantle,"Sandilands, Aaron",8,0,1,8,0,0,42,1
Fremantle,"Sheridan, Tom",10,5,1,5,0,0,0,2
Fremantle,"Silvagni, Alex",10,5,4,5,0,0,0,3
Fremantle,"Simpson, Josh",14,8,4,6,1,0,0,1
Fremantle,"Sutcliffe, Cam",20,13,4,7,0,0,0,3
Fremantle,"Taberner, Matthew",9,7,5,2,1,0,0,0
Fremantle,"de Boer, Matt",17,8,0,9,1,0,0,7
Fremantle,"Ballantyne, Hayden",8,6,2,2,1,1,0,4
Fremantle,"Barlow, Michael",32,15,6,17,3,1,0,2
Fremantle,"Clarke, Zac",6,3,2,3,0,0,19,6
Fremantle,"Crowley, Ryan",11,6,2,5,0,0,0,3
Fremantle,"Dawson, Zac",8,3,5,5,0,0,0,2
Fremantle,"Duffield, Paul",17,15,0,2,0,0,0,8
Fremantle,"Fyfe, Nat",25,12,3,13,0,1,1,5
Fremantle,"Hill, Stephen",21,11,2,10,2,0,0,2
Fremantle,"Mayne, Chris",13,6,3,7,1,1,0,3
Fremantle,"McPharlin, Luke",12,6,7,6,0,0,0,2
Fremantle,"Mundy, David",18,13,4,5,0,0,1,8
Fremantle,"Mzungu, Tendai",11,8,4,3,0,0,0,3
Fremantle,"Neale, Lachie",21,10,3,11,0,0,0,2
Fremantle,"Pavlich, Matthew",14,9,5,5,2,3,1,1
Fremantle,"Pearce, Danyle",20,13,2,7,0,1,0,3
Fremantle,"Sandilands, Aaron",9,5,3,4,1,0,31,2
Fremantle,"Sheridan, Tom",3,2,2,1,0,0,0,0
Fremantle,"Spurr, Lee",29,22,10,7,1,0,0,3
Fremantle,"Suban, Nick",10,9,2,1,0,0,0,1
Fremantle,"Sutcliffe, Cam",18,13,7,5,0,0,0,3
Fremantle,"Walters, Michael",15,9,5,6,1,1,0,0
Fremantle,"de Boer, Matt",10,3,0,7,0,1,0,5
Fremantle,"Ballantyne, Hayden",13,8,1,5,1,2,0,8
Fremantle,"Barlow, Michael",24,12,6,12,1,1,0,8
Fremantle,"Clarke, Zac",12,4,4,8,0,0,19,3
Fremantle,"Crowley, Ryan",22,12,4,10,1,0,0,5
Fremantle,"Dawson, Zac",10,4,4,6,0,0,0,0
Fremantle,"Duffield, Paul",29,26,9,3,1,0,0,1
Fremantle,"Fyfe, Nat",27,13,5,14,2,0,0,3
Fremantle,"Hill, Stephen",21,14,2,7,0,0,0,4
Fremantle,"Johnson, Michael",20,17,8,3,0,0,0,1
Fremantle,"Mayne, Chris",17,5,6,12,0,2,0,13
Fremantle,"McPharlin, Luke",15,11,9,4,0,0,0,1
Fremantle,"Mundy, David",29,14,3,15,0,1,0,3
Fremantle,"Mzungu, Tendai",18,10,2,8,0,0,1,5
Fremantle,"Neale, Lachie",11,5,1,6,1,0,0,0
Fremantle,"Pavlich, Matthew",15,6,5,9,2,2,0,3
Fremantle,"Pearce, Danyle",26,13,3,13,0,0,0,2
Fremantle,"Sandilands, Aaron",13,2,6,11,0,0,33,0
Fremantle,"Spurr, Lee",14,8,5,6,0,0,0,2
Fremantle,"Suban, Nick",14,11,3,3,2,1,0,4
Fremantle,"Sutcliffe, Cam",17,12,5,5,0,0,0,0
Fremantle,"Walters, Michael",14,13,3,1,3,2,0,2
Fremantle,"de Boer, Matt",7,0,1,7,0,0,0,3
Fremantle,"Ballantyne, Hayden",14,8,3,6,0,2,0,2
Fremantle,"Barlow, Michael",23,14,3,9,0,1,0,8
Fremantle,"Clarke, Zac",5,1,1,4,0,0,8,3
Fremantle,"Crowley, Ryan",15,6,2,9,0,2,1,0
Fremantle,"Dawson, Zac",7,0,3,7,0,0,0,2
Fremantle,"Duffield, Paul",17,12,2,5,0,0,0,6
Fremantle,"Fyfe, Nat",28,13,3,15,0,1,0,6
Fremantle,"Hill, Stephen",21,10,0,11,0,1,0,0
Fremantle,"Johnson, Michael",20,13,8,7,0,0,1,2
Fremantle,"Mayne, Chris",13,4,5,9,1,0,0,4
Fremantle,"McPharlin, Luke",16,9,7,7,0,0,0,0
Fremantle,"Mundy, David",28,19,3,9,0,1,1,8
Fremantle,"Mzungu, Tendai",19,14,4,5,1,0,0,1
Fremantle,"Neale, Lachie",7,5,2,2,0,0,0,0
Fremantle,"Pavlich, Matthew",13,12,6,1,3,2,0,3
Fremantle,"Pearce, Danyle",17,11,3,6,1,0,0,4
Fremantle,"Sandilands, Aaron",13,2,1,11,0,0,44,1
Fremantle,"Spurr, Lee",10,8,4,2,0,0,0,4
Fremantle,"Suban, Nick",12,5,3,7,0,1,0,4
Fremantle,"Sutcliffe, Cam",8,6,0,2,0,0,0,1
Fremantle,"Walters, Michael",11,6,4,5,2,0,0,3
Fremantle,"de Boer, Matt",16,3,3,13,0,0,0,3
Gold Coast,"Ablett, Gary",34,22,3,12,4,1,0,4
Gold Coast,"Bennell, Harley",18,16,2,2,1,1,0,0
Gold Coast,"Brennan, Jared",17,8,0,9,0,0,2,4
Gold Coast,"Broughton, Greg",16,8,2,8,0,0,0,1
Gold Coast,"Day, Sam",11,4,4,7,1,1,0,2
Gold Coast,"Dixon, Charlie",16,9,5,7,2,2,9,5
Gold Coast,"Hall, Aaron",15,11,1,4,1,1,0,2
Gold Coast,"Harbrow, Jarrod",26,17,4,9,0,0,0,0
Gold Coast,"Hunt, Karmichael",6,3,1,3,0,0,0,3
Gold Coast,"Matera, Brandon",13,11,5,2,0,0,0,3
Gold Coast,"May, Steven",8,7,2,1,0,1,0,1
Gold Coast,"Murphy, Tom",13,9,5,4,0,0,0,3
Gold Coast,"OMeara, Jaeger",12,8,5,4,1,1,0,6
Gold Coast,"Prestia, Dion",22,17,8,5,0,0,0,1
Gold Coast,"Rischitelli, Michael",15,9,1,6,0,1,0,3
Gold Coast,"Russell, Luke",12,7,3,5,2,1,1,3
Gold Coast,"Shaw, Matt",15,7,3,8,1,1,0,1
Gold Coast,"Smith, Zac",6,3,2,3,0,0,20,2
Gold Coast,"Swallow, David",20,11,1,9,0,0,0,2
Gold Coast,"Thompson, Rory",16,7,8,9,0,0,0,2
Gold Coast,"Warnock, Matthew",13,5,5,8,0,0,0,1
Gold Coast,"Wilkinson, Joel",11,3,3,8,0,0,0,5
Gold Coast,"Ablett, Gary",24,15,2,9,0,1,0,4
Gold Coast,"Bennell, Harley",14,10,2,4,0,0,0,0
Gold Coast,"Brennan, Jared",7,5,1,2,0,0,0,2
Gold Coast,"Day, Sam",9,7,4,2,1,1,0,1
Gold Coast,"Dixon, Charlie",18,12,4,6,3,0,21,1
Gold Coast,"Hall, Aaron",15,13,2,2,2,1,0,5
Gold Coast,"Harbrow, Jarrod",23,16,5,7,0,1,0,2
Gold Coast,"Hunt, Karmichael",11,4,1,7,0,0,0,4
Gold Coast,"Hutchins, Jack",13,9,3,4,1,0,0,1
Gold Coast,"Matera, Brandon",15,14,3,1,1,2,0,3
Gold Coast,"May, Steven",12,4,2,8,1,0,0,1
Gold Coast,"Murphy, Tom",17,13,3,4,0,0,0,1
Gold Coast,"OMeara, Jaeger",25,12,5,13,0,0,0,7
Gold Coast,"Prestia, Dion",22,13,1,9,0,0,0,2
Gold Coast,"Rischitelli, Michael",17,11,4,6,0,0,2,8
Gold Coast,"Russell, Luke",10,8,2,2,0,0,0,4
Gold Coast,"Shaw, Matt",12,5,3,7,1,0,0,3
Gold Coast,"Smith, Zac",6,3,1,3,1,0,15,1
Gold Coast,"Swallow, David",21,12,2,9,0,0,0,8
Gold Coast,"Thompson, Rory",4,3,2,1,0,0,0,1
Gold Coast,"Warnock, Matthew",13,10,4,3,0,0,0,1
Gold Coast,"Wilkinson, Joel",9,2,1,7,0,0,0,3
Gold Coast,"Ablett, Gary",27,15,0,12,0,0,0,9
Gold Coast,"Allen, Jackson",7,6,1,1,0,0,0,5
Gold Coast,"Bennell, Harley",27,20,4,7,3,2,1,3
Gold Coast,"Brennan, Jared",30,17,4,13,0,1,0,5
Gold Coast,"Broughton, Greg",22,14,5,8,1,0,0,4
Gold Coast,"Day, Sam",8,2,1,6,1,0,0,6
Gold Coast,"Dixon, Charlie",14,6,2,8,0,0,11,4
Gold Coast,"Hall, Aaron",17,13,3,4,1,2,0,4
Gold Coast,"Harbrow, Jarrod",24,12,2,12,0,1,0,4
Gold Coast,"Hunt, Karmichael",14,6,1,8,0,0,0,9
Gold Coast,"Hutchins, Jack",13,11,3,2,0,0,0,8
Gold Coast,"Matera, Brandon",14,13,7,1,2,2,0,0
Gold Coast,"May, Steven",9,6,2,3,2,0,0,2
Gold Coast,"OMeara, Jaeger",15,9,3,6,0,0,0,1
Gold Coast,"Rischitelli, Michael",15,5,0,10,1,0,0,1
Gold Coast,"Russell, Luke",7,6,2,1,1,1,0,0
Gold Coast,"Shaw, Matt",15,11,4,4,0,1,0,0
Gold Coast,"Smith, Zac",15,11,1,4,0,1,28,2
Gold Coast,"Swallow, David",17,12,2,5,0,1,0,6
Gold Coast,"Thompson, Rory",9,7,5,2,1,0,1,3
Gold Coast,"Warnock, Matthew",5,3,1,2,0,0,1,1
Gold Coast,"Wilkinson, Joel",13,9,3,4,0,0,0,6
Gold Coast,"Ablett, Gary",35,19,3,16,0,2,0,6
Gold Coast,"Brennan, Jared",22,13,3,9,1,1,1,3
Gold Coast,"Broughton, Greg",24,9,3,15,0,0,0,1
Gold Coast,"Day, Sam",9,4,6,5,0,0,0,2
Gold Coast,"Dixon, Charlie",18,8,2,10,0,1,9,1
Gold Coast,"Hall, Aaron",12,9,6,3,1,0,0,3
Gold Coast,"Harbrow, Jarrod",27,20,4,7,1,1,0,3
Gold Coast,"Hunt, Karmichael",14,5,4,9,0,0,0,1
Gold Coast,"Hutchins, Jack",15,10,6,5,0,0,0,2
Gold Coast,"Matera, Brandon",22,18,5,4,1,2,0,1
Gold Coast,"May, Steven",10,3,1,7,1,0,0,0
Gold Coast,"Murphy, Tom",12,8,5,4,0,0,0,2
Gold Coast,"OMeara, Jaeger",20,11,2,9,1,0,0,2
Gold Coast,"Prestia, Dion",18,13,3,5,0,0,0,6
Gold Coast,"Rischitelli, Michael",17,12,4,5,0,0,0,0
Gold Coast,"Russell, Luke",12,7,5,5,0,1,0,1
Gold Coast,"Shaw, Matt",17,9,2,8,0,0,0,2
Gold Coast,"Smith, Zac",12,5,1,7,1,0,16,1
Gold Coast,"Swallow, David",17,11,6,6,0,0,0,1
Gold Coast,"Thompson, Rory",13,12,8,1,2,1,0,3
Gold Coast,"Warnock, Matthew",4,1,1,3,0,0,0,1
Gold Coast,"Wilkinson, Joel",5,3,1,2,0,0,0,0
Gold Coast,"Ablett, Gary",32,19,5,13,3,1,0,3
Gold Coast,"Brennan, Jared",15,8,4,7,1,1,0,1
Gold Coast,"Broughton, Greg",14,7,6,7,0,0,0,0
Gold Coast,"Day, Sam",12,7,6,5,0,0,0,0
Gold Coast,"Dixon, Charlie",16,13,9,3,6,2,6,2
Gold Coast,"Hall, Aaron",9,6,1,3,0,0,0,5
Gold Coast,"Harbrow, Jarrod",26,15,2,11,0,3,0,2
Gold Coast,"Hunt, Karmichael",15,8,6,7,0,0,0,1
Gold Coast,"Hutchins, Jack",6,6,3,0,0,0,0,1
Gold Coast,"Lynch, Tom",15,11,8,4,2,1,2,3
Gold Coast,"Matera, Brandon",13,9,3,4,1,1,0,0
Gold Coast,"May, Steven",13,7,3,6,1,1,0,1
Gold Coast,"McKenzie, Trent",24,19,9,5,0,2,0,4
Gold Coast,"Murphy, Tom",17,13,7,4,0,0,0,4
Gold Coast,"OMeara, Jaeger",25,17,5,8,2,3,0,4
Gold Coast,"Prestia, Dion",21,13,7,8,1,1,0,4
Gold Coast,"Rischitelli, Michael",22,8,5,14,0,0,0,4
Gold Coast,"Shaw, Matt",26,17,9,9,0,1,0,0
Gold Coast,"Smith, Zac",14,10,4,4,3,1,21,1
Gold Coast,"Stanley, Danny",15,8,6,7,1,0,0,2
Gold Coast,"Swallow, David",24,13,2,11,0,1,0,3
Gold Coast,"Thompson, Rory",12,9,5,3,0,0,0,1
Gold Coast,"Ablett, Gary",28,12,4,16,1,0,0,6
Gold Coast,"Bennell, Harley",16,9,4,7,1,0,2,0
Gold Coast,"Brennan, Jared",19,11,5,8,0,0,2,3
Gold Coast,"Broughton, Greg",20,10,3,10,0,0,0,4
Gold Coast,"Day, Sam",16,8,4,8,0,0,0,3
Gold Coast,"Dixon, Charlie",6,4,3,2,0,1,8,4
Gold Coast,"Hall, Aaron",7,3,1,4,0,0,0,2
Gold Coast,"Harbrow, Jarrod",32,20,4,12,1,0,0,3
Gold Coast,"Hunt, Karmichael",6,3,4,3,1,1,0,6
Gold Coast,"Lonergan, Jesse",9,4,1,5,0,0,0,7
Gold Coast,"Lynch, Tom",6,4,3,2,0,1,4,3
Gold Coast,"Matera, Brandon",6,4,2,2,0,0,0,2
Gold Coast,"McKenzie, Trent",17,8,7,9,0,0,0,4
Gold Coast,"Murphy, Tom",20,12,4,8,0,0,0,0
Gold Coast,"OMeara, Jaeger",18,8,2,10,2,0,0,9
Gold Coast,"Prestia, Dion",21,12,5,9,1,0,0,3
Gold Coast,"Rischitelli, Michael",18,8,3,10,0,1,1,5
Gold Coast,"Shaw, Matt",24,15,5,9,0,2,0,2
Gold Coast,"Smith, Zac",8,4,2,4,0,1,20,1
Gold Coast,"Stanley, Danny",22,14,10,8,0,1,0,4
Gold Coast,"Swallow, David",20,11,4,9,0,0,0,1
Gold Coast,"Thompson, Rory",10,7,2,3,0,1,0,2
Gold Coast,"Ablett, Gary",38,18,5,20,0,0,0,6
Gold Coast,"Bennell, Harley",32,18,4,14,1,3,0,3
Gold Coast,"Brennan, Jared",19,12,6,7,0,1,2,7
Gold Coast,"Broughton, Greg",17,11,7,6,0,0,0,3
Gold Coast,"Brown, Campbell",12,9,7,3,3,3,0,0
Gold Coast,"Day, Sam",19,12,5,7,1,0,7,1
Gold Coast,"Hall, Aaron",13,8,3,5,2,3,0,4
Gold Coast,"Harbrow, Jarrod",16,9,4,7,1,0,0,1
Gold Coast,"Hutchins, Jack",11,7,2,4,0,0,1,3
Gold Coast,"Lonergan, Jesse",10,5,2,5,0,1,0,6
Gold Coast,"Lynch, Tom",13,8,3,5,2,2,1,2
Gold Coast,"Matera, Brandon",12,9,4,3,0,0,0,2
Gold Coast,"May, Steven",7,4,1,3,1,1,0,2
Gold Coast,"McKenzie, Trent",17,12,6,5,1,0,0,3
Gold Coast,"Murphy, Tom",17,11,5,6,0,0,0,1
Gold Coast,"OMeara, Jaeger",23,12,5,11,0,1,1,6
Gold Coast,"Prestia, Dion",30,17,5,13,0,0,0,7
Gold Coast,"Shaw, Matt",27,12,6,15,1,0,0,2
Gold Coast,"Smith, Zac",18,11,4,7,3,0,28,3
Gold Coast,"Stanley, Danny",17,7,6,10,0,0,0,2
Gold Coast,"Swallow, David",24,11,5,13,0,0,0,4
Gold Coast,"Thompson, Rory",18,12,11,6,0,0,0,3
Gold Coast,"Ablett, Gary",31,23,9,8,0,2,0,5
Gold Coast,"Bennell, Harley",16,12,6,4,1,0,1,2
Gold Coast,"Brennan, Jared",12,8,5,4,0,0,2,6
Gold Coast,"Broughton, Greg",20,13,6,7,0,0,0,5
Gold Coast,"Brown, Campbell",10,8,6,2,3,1,0,1
Gold Coast,"Day, Sam",9,4,4,5,1,1,2,1
Gold Coast,"Hall, Aaron",12,7,3,5,2,1,0,3
Gold Coast,"Harbrow, Jarrod",15,14,4,1,1,0,0,4
Gold Coast,"Hutchins, Jack",11,7,3,4,0,1,0,1
Gold Coast,"Lonergan, Jesse",17,7,6,10,0,2,0,4
Gold Coast,"Lynch, Tom",14,11,10,3,0,0,4,0
Gold Coast,"Matera, Brandon",10,10,4,0,1,2,0,4
Gold Coast,"May, Steven",8,5,3,3,1,0,0,1
Gold Coast,"McKenzie, Trent",21,14,5,7,0,0,0,2
Gold Coast,"OMeara, Jaeger",26,13,5,13,1,2,2,2
Gold Coast,"Prestia, Dion",22,13,4,9,0,2,0,4
Gold Coast,"Russell, Luke",10,8,3,2,0,0,1,2
Gold Coast,"Shaw, Matt",16,9,4,7,1,1,0,1
Gold Coast,"Smith, Zac",4,2,1,2,0,0,6,2
Gold Coast,"Stanley, Danny",20,9,10,11,1,0,0,2
Gold Coast,"Swallow, David",16,9,3,7,0,0,0,0
Gold Coast,"Thompson, Rory",14,8,5,6,0,0,0,2
Gold Coast,"Ablett, Gary",37,14,4,23,3,1,0,5
Gold Coast,"Brennan, Jared",10,6,2,4,0,0,3,2
Gold Coast,"Broughton, Greg",16,3,3,13,1,0,0,5
Gold Coast,"Brown, Campbell",15,5,4,10,1,1,0,5
Gold Coast,"Day, Sam",9,5,3,4,0,0,6,1
Gold Coast,"Gorringe, Daniel",12,6,3,6,0,0,17,3
Gold Coast,"Hall, Aaron",15,9,2,6,5,0,0,2
Gold Coast,"Harbrow, Jarrod",21,12,2,9,0,0,0,4
Gold Coast,"Hutchins, Jack",14,11,6,3,0,0,0,2
Gold Coast,"Lonergan, Jesse",6,3,1,3,0,0,0,1
Gold Coast,"Lynch, Tom",17,9,6,8,1,0,1,3
Gold Coast,"Matera, Brandon",21,18,7,3,1,1,0,3
Gold Coast,"May, Steven",11,6,4,5,0,0,0,2
Gold Coast,"McKenzie, Trent",23,16,3,7,0,0,0,1
Gold Coast,"Murphy, Tom",12,8,3,4,0,0,0,2
Gold Coast,"OMeara, Jaeger",21,10,5,11,0,0,0,7
Gold Coast,"Prestia, Dion",32,18,4,14,1,1,0,4
Gold Coast,"Russell, Luke",15,10,5,5,0,0,0,1
Gold Coast,"Shaw, Matt",18,6,2,12,0,0,0,1
Gold Coast,"Stanley, Danny",19,9,3,10,0,1,1,3
Gold Coast,"Swallow, David",18,6,2,12,1,0,0,3
Gold Coast,"Thompson, Rory",12,9,6,3,0,0,0,1
Gold Coast,"Ablett, Gary",34,18,5,16,2,2,0,6
Gold Coast,"Brown, Campbell",10,7,2,3,3,0,0,0
Gold Coast,"Day, Sam",3,2,2,1,0,0,0,0
Gold Coast,"Gorringe, Daniel",11,7,3,4,0,0,10,1
Gold Coast,"Hall, Aaron",15,8,3,7,0,2,0,2
Gold Coast,"Harbrow, Jarrod",16,11,1,5,1,0,0,4
Gold Coast,"Horsley, Kyal",9,4,0,5,0,0,0,3
Gold Coast,"Lynch, Tom",14,7,5,7,1,1,0,1
Gold Coast,"Matera, Brandon",18,15,8,3,0,3,0,2
Gold Coast,"McKenzie, Trent",21,17,5,4,0,1,0,4
Gold Coast,"Murphy, Tom",9,9,2,0,0,0,0,4
Gold Coast,"Nicholls, Tom",11,2,1,9,0,0,27,7
Gold Coast,"OMeara, Jaeger",23,8,5,15,1,0,1,2
Gold Coast,"Prestia, Dion",29,17,5,12,0,0,0,12
Gold Coast,"Rischitelli, Michael",17,9,2,8,1,1,1,1
Gold Coast,"Russell, Luke",20,12,5,8,1,0,0,2
Gold Coast,"Shaw, Matt",16,7,4,9,0,0,0,1
Gold Coast,"Stanley, Danny",25,13,1,12,0,0,0,5
Gold Coast,"Sumner, Timmy",10,8,3,2,0,0,0,1
Gold Coast,"Swallow, David",13,6,2,7,0,0,1,5
Gold Coast,"Thompson, Rory",12,5,3,7,0,0,0,3
Gold Coast,"Wilkinson, Joel",16,4,1,12,0,0,0,2
Gold Coast,"Ablett, Gary",33,18,0,15,2,3,0,5
Gold Coast,"Brown, Campbell",19,15,3,4,0,3,0,3
Gold Coast,"Day, Sam",11,10,4,1,0,0,0,4
Gold Coast,"Dixon, Charlie",9,5,0,4,0,0,7,3
Gold Coast,"Hall, Aaron",14,9,0,5,1,0,0,10
Gold Coast,"Harbrow, Jarrod",30,15,2,15,1,1,0,5
Gold Coast,"Hutchins, Jack",1,0,0,1,0,0,0,2
Gold Coast,"Lynch, Tom",15,6,6,9,2,1,0,1
Gold Coast,"McKenzie, Trent",25,21,9,4,0,0,0,4
Gold Coast,"Murphy, Tom",21,15,7,6,0,0,0,8
Gold Coast,"Nicholls, Tom",16,2,3,14,0,0,33,10
Gold Coast,"OMeara, Jaeger",25,9,3,16,0,0,0,6
Gold Coast,"Patrick, Liam",6,5,1,1,0,0,0,4
Gold Coast,"Prestia, Dion",28,16,5,12,0,0,0,6
Gold Coast,"Rischitelli, Michael",16,7,2,9,0,0,0,7
Gold Coast,"Russell, Luke",24,11,3,13,2,0,0,3
Gold Coast,"Shaw, Matt",22,5,1,17,1,0,0,4
Gold Coast,"Stanley, Danny",17,10,2,7,0,0,0,5
Gold Coast,"Sumner, Timmy",6,3,1,3,0,0,1,6
Gold Coast,"Swallow, David",18,15,3,3,0,0,0,2
Gold Coast,"Thompson, Rory",13,9,2,4,0,1,0,2
Gold Coast,"Wilkinson, Joel",9,7,0,2,0,0,0,1
Gold Coast,"Ablett, Gary",36,16,4,20,1,0,0,7
Gold Coast,"Brown, Campbell",11,7,4,4,2,0,0,0
Gold Coast,"Day, Sam",14,7,6,7,1,0,2,2
Gold Coast,"Gorringe, Daniel",8,2,1,6,0,0,7,2
Gold Coast,"Hall, Aaron",22,18,6,4,0,1,0,2
Gold Coast,"Harbrow, Jarrod",22,14,6,8,1,0,0,2
Gold Coast,"Hutchins, Jack",10,7,2,3,1,0,0,1
Gold Coast,"Lynch, Tom",3,1,1,2,0,0,0,0
Gold Coast,"McKenzie, Trent",27,17,5,10,0,1,0,2
Gold Coast,"Murphy, Tom",14,6,2,8,0,0,0,2
Gold Coast,"Nicholls, Tom",8,4,4,4,2,0,19,4
Gold Coast,"OMeara, Jaeger",30,12,7,18,0,0,0,4
Gold Coast,"Patrick, Liam",8,3,2,5,0,0,0,0
Gold Coast,"Prestia, Dion",21,11,4,10,1,0,0,3
Gold Coast,"Rischitelli, Michael",10,4,2,6,2,0,0,5
Gold Coast,"Russell, Luke",21,8,5,13,0,0,0,1
Gold Coast,"Shaw, Matt",21,8,7,13,0,0,0,1
Gold Coast,"Stanley, Danny",22,9,5,13,0,0,0,4
Gold Coast,"Sumner, Timmy",14,9,5,5,0,3,0,1
Gold Coast,"Swallow, David",21,15,4,6,0,0,0,2
Gold Coast,"Thompson, Rory",19,9,6,10,0,0,0,2
Gold Coast,"Wilkinson, Joel",11,3,1,8,0,0,0,1
Gold Coast,"Ablett, Gary",30,13,1,17,2,2,0,5
Gold Coast,"Boston, Andrew",4,2,0,2,0,0,0,0
Gold Coast,"Broughton, Greg",19,10,1,9,0,0,0,1
Gold Coast,"Brown, Campbell",9,6,3,3,2,1,0,5
Gold Coast,"Day, Sam",15,4,2,11,0,1,0,0
Gold Coast,"Gorringe, Daniel",7,3,1,4,2,0,4,1
Gold Coast,"Hall, Aaron",19,13,2,6,1,3,0,1
Gold Coast,"Harbrow, Jarrod",31,16,4,15,0,1,0,2
Gold Coast,"Hunt, Karmichael",2,1,1,1,0,1,0,3
Gold Coast,"May, Steven",8,4,4,4,2,0,0,1
Gold Coast,"McKenzie, Trent",14,10,4,4,0,0,0,3
Gold Coast,"Murphy, Tom",9,6,3,3,0,0,0,3
Gold Coast,"Nicholls, Tom",17,2,2,15,0,0,16,3
Gold Coast,"OMeara, Jaeger",32,14,5,18,0,2,0,1
Gold Coast,"Prestia, Dion",42,24,7,18,2,1,0,4
Gold Coast,"Shaw, Matt",18,9,4,9,0,0,0,2
Gold Coast,"Stanley, Danny",27,12,7,15,0,0,0,3
Gold Coast,"Sumner, Timmy",14,10,6,4,0,2,0,1
Gold Coast,"Swallow, David",15,8,2,7,0,0,0,1
Gold Coast,"Thompson, Rory",14,7,6,7,0,0,0,2
Gold Coast,"Weller, Maverick",15,5,2,10,0,0,0,3
Gold Coast,"Wilkinson, Joel",15,6,2,9,0,0,0,1
Gold Coast,"Bennell, Harley",28,10,3,18,2,0,0,1
Gold Coast,"Boston, Andrew",2,2,2,0,0,0,0,0
Gold Coast,"Brennan, Jared",21,15,5,6,3,0,1,3
Gold Coast,"Broughton, Greg",12,5,3,7,0,0,0,1
Gold Coast,"Brown, Campbell",10,8,6,2,2,1,0,2
Gold Coast,"Day, Sam",6,4,4,2,0,0,0,1
Gold Coast,"Gorringe, Daniel",6,2,2,4,0,0,7,1
Gold Coast,"Hall, Aaron",15,11,3,4,1,2,0,1
Gold Coast,"Harbrow, Jarrod",20,11,7,9,1,1,0,5
Gold Coast,"May, Steven",8,7,3,1,1,1,1,0
Gold Coast,"McKenzie, Trent",19,16,7,3,0,0,0,1
Gold Coast,"Murphy, Tom",15,10,5,5,0,0,0,2
Gold Coast,"Nicholls, Tom",17,4,0,13,0,0,27,2
Gold Coast,"OMeara, Jaeger",15,9,4,6,1,0,0,5
Gold Coast,"Prestia, Dion",22,14,3,8,0,0,0,2
Gold Coast,"Russell, Luke",12,8,6,4,0,1,0,4
Gold Coast,"Shaw, Matt",22,11,7,11,1,0,0,1
Gold Coast,"Stanley, Danny",20,9,3,11,0,2,0,3
Gold Coast,"Sumner, Timmy",10,5,2,5,0,2,0,1
Gold Coast,"Swallow, David",23,14,2,9,0,0,0,4
Gold Coast,"Thompson, Rory",18,13,6,5,0,0,0,1
Gold Coast,"Wilkinson, Joel",14,7,3,7,0,0,0,3
Gold Coast,"Ablett, Gary",26,20,1,6,0,1,0,7
Gold Coast,"Bennell, Harley",18,10,4,8,1,1,0,3
Gold Coast,"Boston, Andrew",5,4,1,1,0,1,0,2
Gold Coast,"Brennan, Jared",14,9,5,5,0,0,0,1
Gold Coast,"Broughton, Greg",24,11,4,13,0,0,0,9
Gold Coast,"Brown, Campbell",12,8,3,4,1,0,0,4
Gold Coast,"Day, Sam",16,8,5,8,1,0,1,2
Gold Coast,"Hall, Aaron",10,5,4,5,0,1,0,0
Gold Coast,"Hall, Josh",11,4,5,7,0,1,4,1
Gold Coast,"Harbrow, Jarrod",18,8,6,10,0,0,0,3
Gold Coast,"May, Steven",5,4,1,1,0,0,0,3
Gold Coast,"McKenzie, Trent",24,21,2,3,1,0,0,2
Gold Coast,"Murphy, Tom",13,6,3,7,0,0,0,1
Gold Coast,"Nicholls, Tom",18,8,6,10,0,0,25,5
Gold Coast,"OMeara, Jaeger",21,8,5,13,1,1,0,5
Gold Coast,"Prestia, Dion",27,13,2,14,0,1,0,5
Gold Coast,"Russell, Luke",20,10,5,10,0,0,0,4
Gold Coast,"Shaw, Matt",22,8,7,14,1,0,0,2
Gold Coast,"Stanley, Danny",17,6,2,11,0,0,0,4
Gold Coast,"Swallow, David",15,7,1,8,0,0,0,4
Gold Coast,"Tape, Seb",8,5,4,3,0,0,0,6
Gold Coast,"Thompson, Rory",4,3,0,1,0,0,0,0
Gold Coast,"Ablett, Gary",49,22,7,27,2,1,0,2
Gold Coast,"Bennell, Harley",23,12,3,11,0,1,1,6
Gold Coast,"Boston, Andrew",11,8,2,3,0,0,0,2
Gold Coast,"Brennan, Jared",12,8,4,4,3,0,0,5
Gold Coast,"Broughton, Greg",20,10,7,10,0,0,0,3
Gold Coast,"Brown, Campbell",18,14,7,4,0,0,0,1
Gold Coast,"Day, Sam",7,5,2,2,2,0,0,2
Gold Coast,"Hall, Aaron",8,6,3,2,0,2,0,2
Gold Coast,"Hall, Josh",10,7,3,3,0,0,2,0
Gold Coast,"Harbrow, Jarrod",21,12,2,9,1,1,0,2
Gold Coast,"May, Steven",11,10,6,1,0,0,1,2
Gold Coast,"McKenzie, Trent",24,18,10,6,0,1,0,4
Gold Coast,"Nicholls, Tom",12,6,2,6,0,0,33,8
Gold Coast,"OMeara, Jaeger",23,11,7,12,3,0,1,8
Gold Coast,"Prestia, Dion",19,9,2,10,1,0,0,2
Gold Coast,"Russell, Luke",18,10,6,8,0,1,0,2
Gold Coast,"Sexton, Alex",4,2,1,2,0,0,0,0
Gold Coast,"Shaw, Matt",22,12,4,10,0,0,0,3
Gold Coast,"Stanley, Danny",22,8,3,14,0,0,0,3
Gold Coast,"Tape, Seb",8,6,3,2,1,0,0,3
Gold Coast,"Thompson, Rory",11,7,4,4,0,0,0,0
Gold Coast,"Weller, Maverick",14,7,3,7,0,0,0,2
Gold Coast,"Ablett, Gary",32,17,3,15,1,0,0,5
Gold Coast,"Bennell, Harley",17,11,2,6,1,1,1,0
Gold Coast,"Boston, Andrew",10,8,2,2,0,0,0,0
Gold Coast,"Brennan, Jared",5,5,4,0,0,1,0,4
Gold Coast,"Broughton, Greg",11,9,6,2,0,0,0,3
Gold Coast,"Brown, Campbell",17,13,4,4,1,0,0,0
Gold Coast,"Day, Sam",10,7,3,3,2,2,7,4
Gold Coast,"Dixon, Charlie",17,10,6,7,2,0,10,2
Gold Coast,"Gillbee, Jacob",9,2,1,7,0,0,0,2
Gold Coast,"Hall, Aaron",14,11,6,3,2,0,0,6
Gold Coast,"Harbrow, Jarrod",20,14,5,6,0,0,0,1
Gold Coast,"May, Steven",12,6,1,6,0,0,0,0
Gold Coast,"McKenzie, Trent",16,9,2,7,0,0,0,3
Gold Coast,"Nicholls, Tom",5,2,1,3,0,1,7,1
Gold Coast,"OMeara, Jaeger",23,8,5,15,0,0,0,6
Gold Coast,"Russell, Luke",17,7,5,10,0,0,0,2
Gold Coast,"Sexton, Alex",8,7,1,1,0,1,0,4
Gold Coast,"Shaw, Matt",22,10,8,12,1,0,0,3
Gold Coast,"Stanley, Danny",19,7,4,12,1,0,0,8
Gold Coast,"Sumner, Timmy",13,8,3,5,0,1,0,1
Gold Coast,"Tape, Seb",9,3,2,6,0,0,0,5
Gold Coast,"Weller, Maverick",13,7,6,6,0,0,0,4
Gold Coast,"Ablett, Gary",27,12,1,15,2,1,0,2
Gold Coast,"Bennell, Harley",27,15,6,12,2,1,1,2
Gold Coast,"Bock, Nathan",10,7,5,3,2,1,0,2
Gold Coast,"Broughton, Greg",12,5,1,7,0,0,0,0
Gold Coast,"Brown, Campbell",17,11,5,6,2,1,0,1
Gold Coast,"Day, Sam",9,4,2,5,0,1,6,1
Gold Coast,"Dixon, Charlie",12,3,1,9,1,0,15,2
Gold Coast,"Gorringe, Daniel",15,8,5,7,0,0,11,1
Gold Coast,"Hall, Aaron",12,7,2,5,2,1,0,2
Gold Coast,"Harbrow, Jarrod",19,9,5,10,1,0,0,0
Gold Coast,"May, Steven",15,13,7,2,0,0,0,2
Gold Coast,"McKenzie, Trent",12,9,5,3,0,0,0,5
Gold Coast,"OMeara, Jaeger",16,8,4,8,0,0,0,10
Gold Coast,"Prestia, Dion",28,15,3,13,0,1,0,2
Gold Coast,"Russell, Luke",18,10,3,8,0,0,0,0
Gold Coast,"Sexton, Alex",11,8,3,3,3,1,0,2
Gold Coast,"Shaw, Matt",13,3,3,10,0,0,0,1
Gold Coast,"Stanley, Danny",15,10,3,5,1,1,0,3
Gold Coast,"Sumner, Timmy",2,2,1,0,0,1,0,0
Gold Coast,"Swallow, David",21,11,3,10,1,0,0,3
Gold Coast,"Tape, Seb",12,3,1,9,0,0,0,3
Gold Coast,"Thompson, Rory",8,5,3,3,0,0,0,4
Gold Coast,"Ablett, Gary",19,13,3,6,1,1,0,2
Gold Coast,"Bennell, Harley",27,12,3,15,1,4,1,2
Gold Coast,"Bock, Nathan",1,0,0,1,0,0,0,1
Gold Coast,"Broughton, Greg",20,8,4,12,0,0,0,4
Gold Coast,"Brown, Campbell",15,9,5,6,3,0,0,5
Gold Coast,"Day, Sam",4,2,1,2,1,0,1,0
Gold Coast,"Dixon, Charlie",11,5,3,6,1,0,4,2
Gold Coast,"Gorringe, Daniel",16,5,2,11,0,0,23,3
Gold Coast,"Hall, Aaron",20,15,4,5,1,4,0,4
Gold Coast,"Harbrow, Jarrod",20,11,5,9,0,0,0,3
Gold Coast,"May, Steven",12,11,7,1,0,1,0,2
Gold Coast,"McKenzie, Trent",18,13,3,5,0,0,0,0
Gold Coast,"Murphy, Tom",11,8,7,3,0,0,0,2
Gold Coast,"OMeara, Jaeger",19,13,6,6,0,0,2,6
Gold Coast,"Prestia, Dion",23,11,2,12,0,0,0,8
Gold Coast,"Russell, Luke",15,9,4,6,0,0,1,1
Gold Coast,"Sexton, Alex",5,3,2,2,0,2,0,2
Gold Coast,"Stanley, Danny",21,11,5,10,1,0,1,3
Gold Coast,"Sumner, Timmy",6,3,3,3,2,0,0,1
Gold Coast,"Swallow, David",28,16,2,12,1,0,1,5
Gold Coast,"Tape, Seb",14,4,3,10,0,0,0,3
Gold Coast,"Thompson, Rory",11,9,7,2,1,0,0,2
Gold Coast,"Ablett, Gary",22,12,5,10,0,3,0,4
Gold Coast,"Allen, Jackson",3,3,1,0,0,0,0,0
Gold Coast,"Bennell, Harley",28,18,4,10,3,3,0,4
Gold Coast,"Boston, Andrew",14,8,6,6,3,0,0,4
Gold Coast,"Broughton, Greg",17,7,4,10,0,0,0,3
Gold Coast,"Dixon, Charlie",10,7,3,3,1,0,11,2
Gold Coast,"Gorringe, Daniel",22,10,6,12,1,0,12,0
Gold Coast,"Hall, Aaron",12,9,6,3,0,0,0,4
Gold Coast,"Hall, Josh",4,3,2,1,1,0,0,4
Gold Coast,"Harbrow, Jarrod",14,11,6,3,0,0,0,3
Gold Coast,"Hutchins, Jack",4,3,1,1,1,1,0,2
Gold Coast,"May, Steven",6,5,3,1,0,1,2,5
Gold Coast,"McKenzie, Trent",10,9,3,1,0,1,0,5
Gold Coast,"Murphy, Tom",9,5,5,4,0,0,0,3
Gold Coast,"OMeara, Jaeger",20,10,4,10,1,0,1,3
Gold Coast,"Prestia, Dion",23,14,1,9,0,1,0,3
Gold Coast,"Russell, Luke",10,7,3,3,0,0,0,5
Gold Coast,"Stanley, Danny",26,9,4,17,2,0,0,6
Gold Coast,"Sumner, Timmy",6,6,3,0,1,2,0,3
Gold Coast,"Swallow, David",16,7,1,9,0,0,0,7
Gold Coast,"Tape, Seb",4,2,1,2,0,0,0,1
Gold Coast,"Thompson, Rory",5,3,0,2,0,0,0,4
Gold Coast,"Ablett, Gary",28,7,3,21,0,0,0,0
Gold Coast,"Allen, Jackson",14,12,10,2,0,0,0,0
Gold Coast,"Bennell, Harley",22,13,5,9,0,0,0,0
Gold Coast,"Boston, Andrew",5,4,2,1,0,0,0,1
Gold Coast,"Brennan, Jared",14,7,4,7,0,0,0,0
Gold Coast,"Broughton, Greg",13,5,3,8,0,0,0,0
Gold Coast,"Dixon, Charlie",13,8,4,5,2,1,10,2
Gold Coast,"Gillbee, Jacob",12,7,1,5,0,0,0,0
Gold Coast,"Gorringe, Daniel",9,3,1,6,0,0,11,1
Gold Coast,"Hall, Aaron",16,13,6,3,1,2,0,1
Gold Coast,"Hunt, Karmichael",10,3,1,7,0,0,0,2
Gold Coast,"May, Steven",17,11,7,6,0,0,0,1
Gold Coast,"McKenzie, Trent",20,14,7,6,0,0,0,2
Gold Coast,"Murphy, Tom",14,6,6,8,0,0,0,4
Gold Coast,"OMeara, Jaeger",19,8,2,11,2,0,0,5
Gold Coast,"Osborne, Leigh",9,4,3,5,0,0,0,1
Gold Coast,"Prestia, Dion",26,14,3,12,1,0,0,1
Gold Coast,"Rischitelli, Michael",13,6,2,7,0,1,1,3
Gold Coast,"Russell, Luke",11,7,1,4,0,0,0,1
Gold Coast,"Stanley, Danny",27,15,10,12,0,2,0,2
Gold Coast,"Sumner, Timmy",9,8,3,1,3,1,0,1
Gold Coast,"Thompson, Rory",12,7,8,5,1,0,2,0
Gold Coast,"Ablett, Gary",33,18,5,15,4,1,0,3
Gold Coast,"Bennell, Harley",27,12,3,15,2,1,0,5
Gold Coast,"Boston, Andrew",17,8,5,9,4,0,0,0
Gold Coast,"Brennan, Jared",18,12,7,6,0,3,9,4
Gold Coast,"Day, Sam",8,6,4,2,0,1,4,2
Gold Coast,"Dixon, Charlie",6,3,0,3,1,0,14,1
Gold Coast,"Gillbee, Jacob",14,5,1,9,1,2,0,2
Gold Coast,"Hall, Aaron",22,10,6,12,1,1,0,1
Gold Coast,"Harbrow, Jarrod",17,13,2,4,2,0,0,1
Gold Coast,"Hunt, Karmichael",8,3,2,5,1,0,0,0
Gold Coast,"McKenzie, Trent",14,11,7,3,0,0,0,3
Gold Coast,"Murphy, Tom",17,13,5,4,0,0,0,1
Gold Coast,"OMeara, Jaeger",25,13,3,12,0,1,0,6
Gold Coast,"Prestia, Dion",33,18,4,15,1,0,0,7
Gold Coast,"Rischitelli, Michael",25,12,7,13,2,2,0,6
Gold Coast,"Russell, Luke",13,8,8,5,0,0,0,3
Gold Coast,"Stanley, Danny",25,13,5,12,3,0,1,4
Gold Coast,"Sumner, Timmy",6,0,0,6,0,0,0,1
Gold Coast,"Tape, Seb",12,5,3,7,0,0,1,6
Gold Coast,"Thompson, Rory",11,6,8,5,0,0,1,1
Gold Coast,"Weller, Maverick",27,15,11,12,0,1,0,2
Gold Coast,"Wilkinson, Joel",13,10,4,3,0,0,0,1
Geelong,"Bartel, Jimmy",22,14,8,8,0,1,2,1
Geelong,"Blicavs, Mark",9,1,0,8,0,0,11,2
Geelong,"Caddy, Josh",15,9,4,6,0,1,0,1
Geelong,"Chapman, Paul",25,17,5,8,1,0,0,5
Geelong,"Christensen, Allen",18,9,3,9,1,1,0,3
Geelong,"Duncan, Mitch",18,13,8,5,2,1,0,1
Geelong,"Enright, Corey",21,12,2,9,0,0,0,1
Geelong,"Hawkins, Tom",15,7,5,8,2,1,1,2
Geelong,"Horlin-Smith, George",4,2,2,2,0,0,0,0
Geelong,"Hunt, Taylor",22,15,5,7,0,0,0,5
Geelong,"Lonergan, Tom",8,2,4,6,0,0,0,4
Geelong,"Mackie, Andrew",25,17,9,8,1,0,0,3
Geelong,"Motlop, Steven",18,13,4,5,0,2,0,5
Geelong,"Murdoch, Jordan",8,2,1,6,0,0,0,6
Geelong,"Podsiadly, James",15,10,8,5,2,2,0,4
Geelong,"Rivers, Jared",14,7,3,7,0,0,0,3
Geelong,"Selwood, Joel",33,13,8,20,1,0,2,6
Geelong,"Smedts, Billie",13,7,4,6,2,1,0,1
Geelong,"Stokes, Mathew",29,13,5,16,0,1,1,3
Geelong,"Taylor, Harry",17,10,6,7,0,0,0,1
Geelong,"Varcoe, Travis",13,8,1,5,1,0,0,4
Geelong,"West, Trent",9,6,2,3,0,0,11,0
Geelong,"Bartel, Jimmy",19,10,1,9,1,0,0,11
Geelong,"Blicavs, Mark",12,4,6,8,0,1,4,2
Geelong,"Brown, Mitch",5,2,0,3,0,0,0,0
Geelong,"Caddy, Josh",15,10,4,5,1,0,0,3
Geelong,"Chapman, Paul",23,12,1,11,2,3,0,6
Geelong,"Christensen, Allen",19,8,4,11,3,2,0,4
Geelong,"Corey, Joel",22,7,1,15,0,0,1,3
Geelong,"Duncan, Mitch",17,10,4,7,1,1,0,5
Geelong,"Enright, Corey",22,10,3,12,0,0,0,2
Geelong,"Hawkins, Tom",16,9,5,7,3,1,1,0
Geelong,"Hunt, Taylor",15,6,4,9,0,0,0,3
Geelong,"Kelly, James",25,8,1,17,0,0,0,7
Geelong,"Lonergan, Tom",11,5,4,6,1,0,0,3
Geelong,"Mackie, Andrew",17,13,2,4,0,1,0,1
Geelong,"Motlop, Steven",22,14,2,8,2,3,0,0
Geelong,"Podsiadly, James",13,10,2,3,1,1,0,3
Geelong,"Selwood, Joel",26,14,2,12,1,1,1,8
Geelong,"Smedts, Billie",9,3,2,6,0,1,0,2
Geelong,"Stokes, Mathew",16,7,5,9,0,0,0,2
Geelong,"Taylor, Harry",5,4,3,1,0,0,0,2
Geelong,"Varcoe, Travis",15,4,1,11,0,1,0,4
Geelong,"West, Trent",6,3,0,3,0,0,28,1
Geelong,"Bartel, Jimmy",25,15,4,10,0,0,0,4
Geelong,"Blicavs, Mark",11,3,0,8,0,0,11,2
Geelong,"Caddy, Josh",11,5,2,6,0,0,0,2
Geelong,"Chapman, Paul",21,14,6,7,0,1,0,2
Geelong,"Christensen, Allen",24,9,3,15,2,0,0,5
Geelong,"Corey, Joel",18,9,4,9,0,0,0,6
Geelong,"Duncan, Mitch",24,11,9,13,0,0,0,4
Geelong,"Enright, Corey",20,14,8,6,0,0,0,2
Geelong,"Hawkins, Tom",17,10,5,7,3,1,0,1
Geelong,"Hunt, Taylor",17,9,4,8,3,0,0,7
Geelong,"Johnson, Steve",26,16,5,10,0,2,0,1
Geelong,"Lonergan, Tom",6,4,5,2,0,0,0,3
Geelong,"Mackie, Andrew",19,10,6,9,0,0,0,1
Geelong,"Motlop, Steven",22,17,3,5,2,2,0,1
Geelong,"Murdoch, Jordan",6,4,1,2,0,1,0,4
Geelong,"Podsiadly, James",16,9,5,7,1,1,1,1
Geelong,"Selwood, Joel",14,5,3,9,1,0,0,4
Geelong,"Smedts, Billie",7,4,1,3,2,1,0,3
Geelong,"Stokes, Mathew",30,17,14,13,1,0,0,0
Geelong,"Taylor, Harry",20,12,11,8,2,0,0,1
Geelong,"Varcoe, Travis",2,1,1,1,0,0,0,1
Geelong,"West, Trent",15,11,2,4,1,1,22,0
Geelong,"Bartel, Jimmy",17,9,7,8,0,0,0,2
Geelong,"Blicavs, Mark",7,1,1,6,0,0,11,1
Geelong,"Caddy, Josh",5,3,0,2,0,1,0,0
Geelong,"Chapman, Paul",22,10,2,12,2,0,0,4
Geelong,"Christensen, Allen",20,13,2,7,1,1,0,2
Geelong,"Corey, Joel",24,6,1,18,0,0,1,2
Geelong,"Duncan, Mitch",23,13,6,10,0,1,1,3
Geelong,"Enright, Corey",19,12,6,7,0,1,0,1
Geelong,"Hawkins, Tom",9,5,5,4,3,0,0,2
Geelong,"Horlin-Smith, George",23,10,1,13,1,0,0,2
Geelong,"Hunt, Taylor",20,10,2,10,1,0,0,2
Geelong,"Johnson, Steve",23,16,5,7,1,0,0,6
Geelong,"Lonergan, Tom",6,5,3,1,0,1,0,2
Geelong,"Mackie, Andrew",23,16,10,7,0,0,0,1
Geelong,"Motlop, Steven",15,10,4,5,3,0,0,2
Geelong,"Podsiadly, James",16,11,9,5,1,0,1,1
Geelong,"Rivers, Jared",11,4,1,7,0,0,0,4
Geelong,"Selwood, Joel",31,12,2,19,1,1,1,10
Geelong,"Smedts, Billie",6,4,2,2,1,0,0,1
Geelong,"Stokes, Mathew",31,15,3,16,2,0,0,2
Geelong,"Taylor, Harry",20,17,7,3,2,3,0,3
Geelong,"West, Trent",8,3,0,5,0,0,23,2
Geelong,"Bartel, Jimmy",24,12,3,12,0,0,0,3
Geelong,"Blicavs, Mark",4,1,2,3,0,0,9,1
Geelong,"Caddy, Josh",7,3,1,4,0,0,0,1
Geelong,"Christensen, Allen",18,8,2,10,1,1,0,2
Geelong,"Corey, Joel",22,6,4,16,0,1,0,2
Geelong,"Duncan, Mitch",22,13,6,9,0,0,0,1
Geelong,"Enright, Corey",26,16,6,10,0,0,0,2
Geelong,"Guthrie, Cameron",14,8,2,6,0,0,0,2
Geelong,"Horlin-Smith, George",21,10,7,11,0,0,0,2
Geelong,"Hunt, Taylor",15,9,2,6,0,1,0,2
Geelong,"Johnson, Steve",30,19,4,11,1,3,0,10
Geelong,"Kelly, James",27,15,3,12,1,0,0,4
Geelong,"Lonergan, Tom",13,5,6,8,0,0,0,1
Geelong,"Mackie, Andrew",24,15,8,9,0,1,0,1
Geelong,"Motlop, Steven",19,12,10,7,3,0,0,0
Geelong,"Podsiadly, James",15,9,6,6,1,0,0,2
Geelong,"Rivers, Jared",2,1,0,1,0,0,0,0
Geelong,"Selwood, Joel",20,10,5,10,2,0,1,2
Geelong,"Smedts, Billie",15,9,4,6,1,1,0,5
Geelong,"Stokes, Mathew",24,11,6,13,0,1,0,2
Geelong,"Taylor, Harry",14,10,11,4,5,2,0,2
Geelong,"West, Trent",14,9,4,5,0,0,15,2
Geelong,"Bartel, Jimmy",27,19,10,8,2,1,0,5
Geelong,"Blicavs, Mark",12,6,4,6,1,0,12,2
Geelong,"Christensen, Allen",28,15,4,13,3,1,0,6
Geelong,"Corey, Joel",23,10,2,13,0,0,0,2
Geelong,"Duncan, Mitch",27,18,11,9,2,1,0,1
Geelong,"Enright, Corey",28,20,11,8,1,0,0,2
Geelong,"Guthrie, Cameron",12,7,5,5,0,0,0,3
Geelong,"Hawkins, Tom",6,6,4,0,2,0,0,0
Geelong,"Horlin-Smith, George",5,2,2,3,0,0,0,0
Geelong,"Hunt, Taylor",14,7,3,7,0,0,0,3
Geelong,"Johnson, Steve",31,21,9,10,2,0,0,5
Geelong,"Kelly, James",21,13,2,8,0,1,0,12
Geelong,"Lonergan, Tom",13,4,5,9,0,0,0,0
Geelong,"Mackie, Andrew",16,12,4,4,0,0,0,0
Geelong,"Motlop, Steven",11,6,2,5,0,1,0,2
Geelong,"Murdoch, Jordan",5,3,1,2,1,0,0,2
Geelong,"Podsiadly, James",16,9,9,7,0,3,0,1
Geelong,"Selwood, Joel",23,10,5,13,1,1,2,4
Geelong,"Smedts, Billie",13,4,3,9,2,0,0,1
Geelong,"Stokes, Mathew",28,11,3,17,2,0,0,0
Geelong,"Taylor, Harry",18,15,11,3,0,0,0,0
Geelong,"West, Trent",13,8,4,5,1,0,31,0
Geelong,"Bartel, Jimmy",18,12,4,6,1,0,0,3
Geelong,"Blicavs, Mark",7,4,5,3,2,1,12,3
Geelong,"Christensen, Allen",16,6,3,10,1,0,0,2
Geelong,"Duncan, Mitch",16,10,7,6,1,0,1,0
Geelong,"Enright, Corey",23,20,11,3,0,0,0,0
Geelong,"Guthrie, Cameron",12,8,4,4,0,0,0,5
Geelong,"Hawkins, Tom",9,5,3,4,2,1,1,1
Geelong,"Horlin-Smith, George",18,7,6,11,0,1,0,4
Geelong,"Hunt, Taylor",3,1,0,2,0,0,0,1
Geelong,"Johnson, Steve",36,15,5,21,0,0,0,2
Geelong,"Kelly, James",23,7,1,16,0,0,0,8
Geelong,"Lonergan, Tom",13,6,5,7,2,0,0,1
Geelong,"Mackie, Andrew",17,12,6,5,0,0,0,0
Geelong,"Motlop, Steven",28,18,8,10,1,4,0,2
Geelong,"Podsiadly, James",17,11,6,6,0,0,1,2
Geelong,"Schroder, Jordan",8,4,1,4,1,1,0,4
Geelong,"Selwood, Joel",19,9,4,10,1,0,0,8
Geelong,"Smedts, Billie",15,6,3,9,2,0,0,6
Geelong,"Stokes, Mathew",24,15,11,9,3,0,0,1
Geelong,"Taylor, Harry",13,7,7,6,0,0,0,3
Geelong,"Thurlow, Jackson",17,8,5,9,0,1,0,4
Geelong,"West, Trent",8,4,0,4,0,0,15,3
Geelong,"Bartel, Jimmy",23,18,8,5,2,0,1,5
Geelong,"Blicavs, Mark",7,3,2,4,0,0,10,4
Geelong,"Caddy, Josh",13,6,1,7,0,2,1,3
Geelong,"Christensen, Allen",18,9,1,9,2,0,0,4
Geelong,"Corey, Joel",30,9,9,21,0,0,0,4
Geelong,"Duncan, Mitch",18,13,7,5,0,0,0,2
Geelong,"Enright, Corey",24,13,12,11,0,0,0,1
Geelong,"Guthrie, Cameron",11,8,4,3,0,0,0,2
Geelong,"Hawkins, Tom",11,9,7,2,4,0,0,0
Geelong,"Horlin-Smith, George",15,4,0,11,0,0,0,4
Geelong,"Hunt, Josh",10,8,3,2,0,0,0,0
Geelong,"Lonergan, Tom",7,1,3,6,0,0,0,0
Geelong,"Mackie, Andrew",28,17,7,11,1,0,0,2
Geelong,"Motlop, Steven",17,11,2,6,2,3,0,4
Geelong,"Podsiadly, James",16,11,9,5,2,1,0,1
Geelong,"Schroder, Jordan",11,3,5,8,0,2,0,3
Geelong,"Selwood, Joel",20,6,2,14,0,0,2,4
Geelong,"Smedts, Billie",3,3,1,0,0,1,0,2
Geelong,"Stokes, Mathew",31,19,2,12,0,0,0,4
Geelong,"Taylor, Harry",21,15,6,6,0,0,0,1
Geelong,"Thurlow, Jackson",16,9,2,7,0,0,0,2
Geelong,"West, Trent",9,7,0,2,1,1,25,2
Geelong,"Bartel, Jimmy",27,19,8,8,1,1,1,3
Geelong,"Blicavs, Mark",13,6,5,7,0,0,20,4
Geelong,"Brown, Mitch",13,9,7,4,0,1,0,0
Geelong,"Burbury, George",9,6,0,3,1,1,0,5
Geelong,"Christensen, Allen",27,11,5,16,0,1,0,7
Geelong,"Corey, Joel",15,6,5,9,0,0,0,3
Geelong,"Duncan, Mitch",21,12,7,9,0,0,1,5
Geelong,"Enright, Corey",25,16,10,9,0,0,0,1
Geelong,"Guthrie, Cameron",19,9,3,10,0,0,0,2
Geelong,"Hawkins, Tom",10,7,5,3,6,1,0,2
Geelong,"Hunt, Josh",1,0,0,1,0,0,0,0
Geelong,"Johnson, Steve",33,17,7,16,1,0,0,9
Geelong,"Lonergan, Tom",8,0,0,8,0,0,0,1
Geelong,"Mackie, Andrew",23,12,9,11,0,0,0,0
Geelong,"Motlop, Steven",21,16,3,5,2,0,0,0
Geelong,"Podsiadly, James",14,11,5,3,4,0,1,1
Geelong,"Schroder, Jordan",11,5,0,6,2,1,0,3
Geelong,"Selwood, Joel",18,10,2,8,0,0,2,5
Geelong,"Stokes, Mathew",28,11,6,17,0,0,0,5
Geelong,"Taylor, Harry",29,20,10,9,0,0,0,1
Geelong,"Thurlow, Jackson",8,4,1,4,1,0,0,0
Geelong,"West, Trent",11,6,3,5,0,1,17,0
Geelong,"Bartel, Jimmy",30,19,5,11,3,1,0,2
Geelong,"Blicavs, Mark",20,7,2,13,1,1,13,5
Geelong,"Brown, Mitch",9,6,2,3,0,1,0,1
Geelong,"Burbury, George",13,4,3,9,1,1,0,4
Geelong,"Christensen, Allen",15,5,4,10,0,1,0,0
Geelong,"Corey, Joel",24,11,6,13,0,0,1,4
Geelong,"Duncan, Mitch",30,21,8,9,1,0,0,7
Geelong,"Enright, Corey",21,15,5,6,0,0,0,4
Geelong,"Guthrie, Cameron",8,5,2,3,2,0,0,3
Geelong,"Hawkins, Tom",9,5,5,4,2,1,0,1
Geelong,"Hunt, Josh",17,9,6,8,1,0,0,3
Geelong,"Johnson, Steve",22,17,6,5,0,2,0,4
Geelong,"Kelly, James",25,19,3,6,0,0,0,5
Geelong,"Lonergan, Tom",9,3,3,6,0,0,0,2
Geelong,"Mackie, Andrew",21,13,9,8,0,0,0,3
Geelong,"Motlop, Steven",12,9,1,3,2,2,0,2
Geelong,"Schroder, Jordan",5,2,0,3,0,0,0,1
Geelong,"Selwood, Joel",20,9,5,11,0,0,1,5
Geelong,"Stokes, Mathew",27,11,4,16,0,1,0,0
Geelong,"Taylor, Harry",16,9,5,7,0,0,1,1
Geelong,"Vardy, Nathan",10,5,4,5,4,0,5,1
Geelong,"West, Trent",12,10,4,2,1,0,10,1
Geelong,"Bartel, Jimmy",18,8,1,10,1,0,1,7
Geelong,"Brown, Mitch",11,8,3,3,0,0,0,3
Geelong,"Christensen, Allen",23,10,3,13,1,2,0,4
Geelong,"Corey, Joel",21,7,2,14,1,0,0,8
Geelong,"Duncan, Mitch",9,7,3,2,1,0,0,0
Geelong,"Enright, Corey",22,14,11,8,0,2,0,2
Geelong,"Guthrie, Cameron",10,6,3,4,0,0,0,5
Geelong,"Hawkins, Tom",6,3,3,3,2,1,0,1
Geelong,"Hunt, Josh",23,11,7,12,2,0,0,6
Geelong,"Johnson, Steve",24,13,4,11,1,1,0,5
Geelong,"Kelly, James",28,12,6,16,1,0,0,8
Geelong,"Lonergan, Tom",8,4,5,4,0,0,0,1
Geelong,"Mackie, Andrew",18,13,4,5,1,0,0,2
Geelong,"Murdoch, Jordan",14,7,6,7,3,0,0,7
Geelong,"Podsiadly, James",13,9,4,4,5,0,2,5
Geelong,"Selwood, Joel",29,13,6,16,2,1,2,7
Geelong,"Smedts, Billie",14,7,6,7,0,2,0,5
Geelong,"Stokes, Mathew",28,10,2,18,1,0,0,5
Geelong,"Stringer, Jesse",14,4,3,10,1,0,0,5
Geelong,"Thurlow, Jackson",19,10,7,9,0,0,0,3
Geelong,"Vardy, Nathan",5,3,1,2,0,1,6,2
Geelong,"West, Trent",8,4,2,4,1,0,42,0
Geelong,"Bartel, Jimmy",31,22,10,9,0,1,0,3
Geelong,"Blicavs, Mark",17,9,6,8,1,0,8,2
Geelong,"Christensen, Allen",18,11,3,7,2,1,0,2
Geelong,"Corey, Joel",18,6,2,12,0,0,0,4
Geelong,"Duncan, Mitch",18,6,4,12,0,0,0,6
Geelong,"Enright, Corey",23,16,3,7,0,0,0,3
Geelong,"Guthrie, Cameron",9,6,3,3,1,0,0,1
Geelong,"Hawkins, Tom",9,8,3,1,3,2,0,2
Geelong,"Hunt, Josh",23,14,7,9,0,0,0,1
Geelong,"Hunt, Taylor",13,8,3,5,0,1,0,1
Geelong,"Johnson, Steve",31,19,6,12,2,2,0,4
Geelong,"Kelly, James",18,6,1,12,0,0,0,5
Geelong,"Lonergan, Tom",6,4,3,2,0,0,0,1
Geelong,"Mackie, Andrew",20,14,6,6,1,0,0,2
Geelong,"Motlop, Steven",11,9,2,2,2,2,0,4
Geelong,"Murdoch, Jordan",9,6,3,3,1,0,0,2
Geelong,"Podsiadly, James",14,11,7,3,1,1,0,4
Geelong,"Selwood, Joel",31,16,6,15,0,2,0,5
Geelong,"Simpson, Dawson",8,5,4,3,0,0,24,0
Geelong,"Stokes, Mathew",31,13,11,18,0,0,0,2
Geelong,"Stringer, Jesse",4,2,0,2,0,0,0,3
Geelong,"Taylor, Harry",18,10,10,8,0,0,0,2
Geelong,"Bartel, Jimmy",24,17,8,7,1,1,0,3
Geelong,"Blicavs, Mark",10,3,4,7,0,0,6,5
Geelong,"Caddy, Josh",16,9,2,7,0,1,0,8
Geelong,"Christensen, Allen",36,19,6,17,0,2,0,6
Geelong,"Corey, Joel",22,7,2,15,2,0,0,10
Geelong,"Duncan, Mitch",29,11,4,18,0,1,0,4
Geelong,"Enright, Corey",26,19,7,7,0,0,0,0
Geelong,"Guthrie, Cameron",15,9,5,6,0,1,0,2
Geelong,"Hawkins, Tom",11,6,2,5,2,1,0,3
Geelong,"Hunt, Josh",16,7,4,9,0,0,0,2
Geelong,"Hunt, Taylor",15,8,3,7,1,0,0,2
Geelong,"Kelly, James",27,14,1,13,0,2,0,7
Geelong,"Lonergan, Tom",7,2,0,5,0,1,0,1
Geelong,"Mackie, Andrew",27,17,7,10,0,0,0,1
Geelong,"Motlop, Steven",17,10,2,7,2,0,0,1
Geelong,"Murdoch, Jordan",6,4,1,2,1,1,0,4
Geelong,"Podsiadly, James",15,9,2,6,1,1,0,7
Geelong,"Selwood, Joel",13,6,1,7,0,1,0,1
Geelong,"Simpson, Dawson",13,6,6,7,1,0,34,3
Geelong,"Stokes, Mathew",27,17,4,10,0,2,0,3
Geelong,"Stringer, Jesse",18,6,4,12,0,0,0,5
Geelong,"Taylor, Harry",28,18,10,10,0,0,0,2
Geelong,"Bartel, Jimmy",22,15,3,7,0,0,0,2
Geelong,"Blicavs, Mark",12,9,6,3,1,0,12,5
Geelong,"Caddy, Josh",16,10,7,6,1,1,0,7
Geelong,"Christensen, Allen",17,9,2,8,0,0,0,4
Geelong,"Corey, Joel",19,3,1,16,0,0,0,4
Geelong,"Duncan, Mitch",22,18,9,4,0,3,0,5
Geelong,"Enright, Corey",22,17,9,5,0,0,0,1
Geelong,"Guthrie, Cameron",11,7,4,4,0,0,0,3
Geelong,"Hawkins, Tom",9,6,5,3,0,1,0,1
Geelong,"Hunt, Josh",20,14,10,6,0,0,0,1
Geelong,"Hunt, Taylor",8,6,1,2,1,1,0,4
Geelong,"Kelly, James",23,14,4,9,1,1,0,7
Geelong,"Lonergan, Tom",6,5,5,1,0,0,0,4
Geelong,"Mackie, Andrew",22,17,8,5,0,0,0,4
Geelong,"Motlop, Steven",13,10,5,3,1,2,0,1
Geelong,"Murdoch, Jordan",17,10,4,7,3,2,0,4
Geelong,"Podsiadly, James",12,11,6,1,1,0,1,3
Geelong,"Selwood, Joel",34,16,2,18,1,0,0,7
Geelong,"Simpson, Dawson",5,1,2,4,0,0,23,4
Geelong,"Stokes, Mathew",19,10,3,9,0,0,0,3
Geelong,"Stringer, Jesse",3,3,2,0,1,0,0,1
Geelong,"Taylor, Harry",16,12,6,4,0,0,0,2
Geelong,"Bartel, Jimmy",16,15,3,1,0,0,1,3
Geelong,"Blicavs, Mark",11,6,1,5,0,0,11,2
Geelong,"Caddy, Josh",22,16,3,6,2,1,0,7
Geelong,"Duncan, Mitch",18,9,4,9,1,0,1,4
Geelong,"Guthrie, Cameron",4,3,1,1,0,0,0,3
Geelong,"Hawkins, Tom",8,5,4,3,2,0,0,0
Geelong,"Horlin-Smith, George",16,7,0,9,2,1,0,6
Geelong,"Hunt, Josh",14,11,2,3,0,0,0,4
Geelong,"Hunt, Taylor",9,4,1,5,0,0,0,4
Geelong,"Johnson, Steve",38,23,6,15,1,2,1,8
Geelong,"Kelly, James",21,15,2,6,0,1,0,11
Geelong,"Lonergan, Tom",14,8,4,6,0,1,0,0
Geelong,"Mackie, Andrew",6,5,2,1,0,0,0,2
Geelong,"Motlop, Steven",16,12,0,4,1,0,0,5
Geelong,"Murdoch, Jordan",8,6,0,2,0,1,0,7
Geelong,"Podsiadly, James",21,16,6,5,2,2,2,3
Geelong,"Selwood, Joel",29,20,1,9,0,1,0,10
Geelong,"Simpson, Dawson",14,3,3,11,0,1,55,3
Geelong,"Smedts, Billie",15,12,3,3,1,1,0,4
Geelong,"Stringer, Jesse",12,9,0,3,1,1,0,7
Geelong,"Taylor, Harry",14,10,6,4,0,0,1,0
Geelong,"Varcoe, Travis",8,4,3,4,0,0,0,9
Geelong,"Bartel, Jimmy",21,12,1,9,0,1,0,2
Geelong,"Blicavs, Mark",11,6,5,5,1,0,5,3
Geelong,"Caddy, Josh",18,14,2,4,3,0,0,3
Geelong,"Corey, Joel",27,9,2,18,0,0,0,4
Geelong,"Duncan, Mitch",24,14,2,10,0,1,0,3
Geelong,"Enright, Corey",19,14,4,5,0,0,0,1
Geelong,"Guthrie, Cameron",13,7,5,6,0,0,0,1
Geelong,"Hawkins, Tom",11,10,8,1,2,1,0,0
Geelong,"Hunt, Josh",10,7,2,3,0,0,0,0
Geelong,"Kelly, James",14,9,1,5,2,0,0,6
Geelong,"Lonergan, Tom",7,5,5,2,1,0,0,1
Geelong,"Mackie, Andrew",20,12,3,8,0,0,0,4
Geelong,"Motlop, Steven",15,11,2,4,2,1,0,1
Geelong,"Murdoch, Jordan",2,2,0,0,0,1,0,2
Geelong,"Podsiadly, James",10,4,3,6,0,0,0,3
Geelong,"Selwood, Joel",22,17,6,5,3,1,0,8
Geelong,"Simpson, Dawson",18,7,6,11,0,0,33,2
Geelong,"Smedts, Billie",11,7,5,4,0,0,0,5
Geelong,"Stokes, Mathew",20,7,4,13,0,0,0,3
Geelong,"Stringer, Jesse",9,7,2,2,0,0,0,3
Geelong,"Taylor, Harry",12,10,6,2,0,1,0,0
Geelong,"Varcoe, Travis",4,2,0,2,0,0,0,3
Geelong,"Brown, Mitch",20,12,10,8,0,0,0,0
Geelong,"Caddy, Josh",19,8,3,11,0,0,1,3
Geelong,"Corey, Joel",16,8,3,8,0,0,1,5
Geelong,"Duncan, Mitch",27,16,12,11,0,1,0,2
Geelong,"Enright, Corey",22,15,10,7,0,0,0,3
Geelong,"Guthrie, Cameron",12,6,3,6,0,0,0,4
Geelong,"Hawkins, Tom",11,10,6,1,5,0,1,0
Geelong,"Horlin-Smith, George",16,9,5,7,0,0,0,0
Geelong,"Hunt, Taylor",16,1,2,15,0,0,0,2
Geelong,"Johnson, Steve",29,17,3,12,2,0,0,4
Geelong,"Kelly, James",21,10,3,11,1,2,0,5
Geelong,"Lonergan, Tom",4,3,2,1,0,0,0,1
Geelong,"Mackie, Andrew",24,18,7,6,1,0,0,1
Geelong,"Motlop, Steven",29,12,6,17,4,0,0,2
Geelong,"Podsiadly, James",15,13,11,2,2,1,1,1
Geelong,"Selwood, Joel",32,17,6,15,3,1,0,4
Geelong,"Simpson, Dawson",1,0,0,1,0,0,10,0
Geelong,"Smedts, Billie",15,8,5,7,0,0,0,3
Geelong,"Stokes, Mathew",19,5,1,14,0,0,0,4
Geelong,"Taylor, Harry",19,12,6,7,0,0,0,1
Geelong,"Varcoe, Travis",15,5,3,10,2,1,0,8
Geelong,"Vardy, Nathan",16,11,7,5,1,0,19,4
Geelong,"Bartel, Jimmy",25,14,4,11,0,0,1,3
Geelong,"Blicavs, Mark",7,2,3,5,0,1,8,2
Geelong,"Caddy, Josh",16,10,5,6,0,0,0,4
Geelong,"Corey, Joel",16,6,1,10,0,0,0,3
Geelong,"Duncan, Mitch",23,15,6,8,2,0,0,3
Geelong,"Enright, Corey",24,17,8,7,0,0,0,3
Geelong,"Guthrie, Cameron",16,6,1,10,0,0,0,4
Geelong,"Hawkins, Tom",10,5,2,5,1,2,0,0
Geelong,"Hunt, Josh",15,10,5,5,0,0,0,0
Geelong,"Hunt, Taylor",8,3,1,5,0,0,0,1
Geelong,"Johnson, Steve",28,16,7,12,1,0,0,3
Geelong,"Kelly, James",15,10,2,5,0,1,0,14
Geelong,"Lonergan, Tom",2,2,2,0,0,0,0,3
Geelong,"Mackie, Andrew",15,12,3,3,0,1,0,3
Geelong,"Motlop, Steven",21,14,4,7,3,0,0,1
Geelong,"Selwood, Joel",24,17,2,7,0,0,0,7
Geelong,"Smedts, Billie",4,1,1,3,1,0,0,2
Geelong,"Stokes, Mathew",24,7,4,17,1,0,0,5
Geelong,"Taylor, Harry",15,9,8,6,1,1,0,0
Geelong,"Varcoe, Travis",8,4,1,4,1,0,0,6
Geelong,"Vardy, Nathan",9,4,1,5,2,1,4,1
Geelong,"West, Trent",7,4,1,3,0,0,14,0
Geelong,"Bartel, Jimmy",14,8,3,6,1,0,0,1
Geelong,"Caddy, Josh",18,7,4,11,1,1,0,1
Geelong,"Christensen, Allen",22,10,5,12,2,0,0,9
Geelong,"Corey, Joel",28,13,5,15,0,1,1,5
Geelong,"Duncan, Mitch",0,0,0,0,0,0,0,0
Geelong,"Enright, Corey",27,15,7,12,0,0,0,3
Geelong,"Guthrie, Cameron",17,10,5,7,1,0,0,3
Geelong,"Hawkins, Tom",6,5,3,1,1,0,0,1
Geelong,"Johnson, Steve",32,15,8,17,0,1,0,2
Geelong,"Kelly, James",18,11,3,7,1,1,0,9
Geelong,"Lonergan, Tom",8,4,3,4,0,0,0,4
Geelong,"Mackie, Andrew",26,22,10,4,0,0,0,1
Geelong,"Motlop, Steven",23,14,4,9,2,0,0,1
Geelong,"Podsiadly, James",15,13,10,2,2,0,1,2
Geelong,"Rivers, Jared",6,2,3,4,0,0,0,4
Geelong,"Selwood, Joel",28,19,12,9,4,2,2,5
Geelong,"Stokes, Mathew",19,11,10,8,0,0,0,2
Geelong,"Stringer, Jesse",7,5,2,2,0,1,0,7
Geelong,"Taylor, Harry",22,14,10,8,3,0,1,1
Geelong,"Varcoe, Travis",7,3,2,4,1,0,0,7
Geelong,"Vardy, Nathan",10,3,3,7,0,0,17,1
Geelong,"Walker, Josh",11,7,5,4,1,0,6,3
Geelong,"Bartel, Jimmy",32,22,5,10,0,0,0,4
Geelong,"Blicavs, Mark",17,6,4,11,0,2,18,6
Geelong,"Caddy, Josh",21,11,5,10,0,1,0,4
Geelong,"Christensen, Allen",29,8,2,21,1,0,0,6
Geelong,"Corey, Joel",23,9,4,14,0,0,0,3
Geelong,"Duncan, Mitch",27,13,9,14,0,2,0,1
Geelong,"Enright, Corey",19,15,4,4,0,0,0,2
Geelong,"Guthrie, Cameron",15,9,6,6,0,1,0,1
Geelong,"Johnson, Steve",37,17,7,20,0,2,0,7
Geelong,"Kelly, James",23,16,2,7,2,0,0,7
Geelong,"Lonergan, Tom",7,4,2,3,0,0,0,1
Geelong,"Mackie, Andrew",27,17,7,10,0,1,0,2
Geelong,"Motlop, Steven",16,9,1,7,2,0,0,0
Geelong,"Murdoch, Jordan",7,5,2,2,1,0,0,3
Geelong,"Podsiadly, James",13,8,4,5,2,0,0,2
Geelong,"Rivers, Jared",15,10,4,5,0,0,0,1
Geelong,"Selwood, Joel",29,15,7,14,4,1,0,5
Geelong,"Stokes, Mathew",30,16,6,14,2,0,0,4
Geelong,"Taylor, Harry",11,9,4,2,0,0,0,3
Geelong,"Varcoe, Travis",18,6,2,12,0,0,0,3
Geelong,"Vardy, Nathan",11,3,2,8,1,0,13,3
Geelong,"Walker, Josh",7,4,1,3,1,0,1,5
Geelong,"Bartel, Jimmy",22,12,8,10,0,0,0,3
Geelong,"Blicavs, Mark",12,7,3,5,0,2,11,5
Geelong,"Caddy, Josh",17,5,2,12,0,0,1,1
Geelong,"Chapman, Paul",14,6,2,8,1,0,0,4
Geelong,"Christensen, Allen",23,9,4,14,0,0,0,5
Geelong,"Corey, Joel",20,7,4,13,0,0,0,10
Geelong,"Duncan, Mitch",30,16,9,14,0,0,0,6
Geelong,"Enright, Corey",29,16,10,13,0,0,0,5
Geelong,"Guthrie, Cameron",20,8,7,12,0,0,0,2
Geelong,"Hawkins, Tom",7,6,4,1,0,3,0,0
Geelong,"Johnson, Steve",26,16,6,10,4,3,0,5
Geelong,"Kelly, James",28,17,2,11,0,1,0,9
Geelong,"Lonergan, Tom",12,7,5,5,0,0,0,5
Geelong,"Mackie, Andrew",24,18,7,6,0,1,0,1
Geelong,"Motlop, Steven",19,12,6,7,3,0,0,3
Geelong,"Podsiadly, James",15,8,6,7,1,1,0,3
Geelong,"Rivers, Jared",14,6,4,8,0,0,0,5
Geelong,"Selwood, Joel",24,14,2,10,2,1,3,6
Geelong,"Stokes, Mathew",37,10,2,27,0,0,0,7
Geelong,"Taylor, Harry",21,15,9,6,0,0,0,4
Geelong,"Varcoe, Travis",15,8,6,7,1,1,0,5
Geelong,"Vardy, Nathan",4,3,0,1,1,0,9,1
Geelong,"Bartel, Jimmy",35,25,8,10,1,0,0,2
Geelong,"Blicavs, Mark",9,2,0,7,0,0,20,4
Geelong,"Caddy, Josh",18,11,2,7,2,3,0,4
Geelong,"Chapman, Paul",26,13,4,13,2,1,0,2
Geelong,"Christensen, Allen",18,11,3,7,1,0,0,6
Geelong,"Corey, Joel",11,6,4,5,0,0,0,1
Geelong,"Duncan, Mitch",23,13,7,10,1,1,0,0
Geelong,"Enright, Corey",16,8,4,8,0,1,0,0
Geelong,"Hawkins, Tom",7,3,2,4,1,1,0,2
Geelong,"Hunt, Taylor",14,6,1,8,0,0,0,6
Geelong,"Johnson, Steve",23,10,2,13,1,3,0,3
Geelong,"Kelly, James",21,10,1,11,1,1,0,8
Geelong,"Lonergan, Tom",11,6,4,5,0,0,0,0
Geelong,"Mackie, Andrew",21,12,7,9,0,0,0,2
Geelong,"Motlop, Steven",4,1,1,3,0,0,0,1
Geelong,"Podsiadly, James",13,8,7,5,1,0,0,0
Geelong,"Rivers, Jared",13,6,3,7,0,1,0,0
Geelong,"Selwood, Joel",25,10,2,15,1,2,1,6
Geelong,"Stokes, Mathew",35,17,6,18,0,1,0,1
Geelong,"Taylor, Harry",13,8,6,5,1,2,0,2
Geelong,"Varcoe, Travis",15,10,1,5,2,1,0,2
Geelong,"West, Trent",7,1,1,6,0,0,25,1
Geelong,"Bartel, Jimmy",29,17,8,12,0,0,0,2
Geelong,"Blicavs, Mark",15,4,2,11,0,0,7,4
Geelong,"Caddy, Josh",9,5,1,4,0,1,0,0
Geelong,"Chapman, Paul",11,6,3,5,0,0,0,5
Geelong,"Christensen, Allen",14,8,3,6,0,1,0,1
Geelong,"Corey, Joel",22,8,4,14,1,0,0,11
Geelong,"Duncan, Mitch",22,15,9,7,1,1,1,3
Geelong,"Enright, Corey",12,10,1,2,0,0,0,2
Geelong,"Guthrie, Cameron",17,9,8,8,0,0,0,4
Geelong,"Johnson, Steve",20,12,1,8,2,1,0,2
Geelong,"Kelly, James",18,11,3,7,0,1,0,9
Geelong,"Lonergan, Tom",5,3,1,2,0,0,0,4
Geelong,"Mackie, Andrew",25,21,7,4,0,1,0,1
Geelong,"Motlop, Steven",20,15,3,5,1,1,0,1
Geelong,"Podsiadly, James",13,7,2,6,3,2,1,1
Geelong,"Rivers, Jared",13,6,3,7,0,1,0,2
Geelong,"Selwood, Joel",21,9,4,12,0,0,1,4
Geelong,"Stokes, Mathew",27,9,5,18,0,0,0,3
Geelong,"Taylor, Harry",14,8,8,6,0,0,0,1
Geelong,"Varcoe, Travis",20,4,0,16,0,0,0,2
Geelong,"Vardy, Nathan",8,4,4,4,1,0,6,1
Geelong,"Walker, Josh",7,3,2,4,0,1,0,3
Geelong,"Bartel, Jimmy",21,12,5,9,1,2,0,6
Geelong,"Blicavs, Mark",8,3,1,5,0,0,11,3
Geelong,"Chapman, Paul",20,13,4,7,4,2,0,6
Geelong,"Christensen, Allen",24,14,3,10,1,0,0,3
Geelong,"Corey, Joel",21,10,2,11,1,1,1,2
Geelong,"Duncan, Mitch",19,10,6,9,1,2,0,3
Geelong,"Guthrie, Cameron",12,5,3,7,0,0,0,4
Geelong,"Hawkins, Tom",8,6,3,2,2,1,1,2
Geelong,"Hunt, Josh",13,9,5,4,0,1,0,0
Geelong,"Hunt, Taylor",5,5,5,0,0,0,0,0
Geelong,"Johnson, Steve",25,14,9,11,0,0,0,3
Geelong,"Kelly, James",28,11,7,17,0,0,0,7
Geelong,"Lonergan, Tom",13,8,4,5,0,0,0,2
Geelong,"Mackie, Andrew",18,13,7,5,0,0,0,3
Geelong,"Motlop, Steven",25,18,1,7,2,2,0,2
Geelong,"Podsiadly, James",5,4,3,1,0,1,1,1
Geelong,"Rivers, Jared",6,3,2,3,0,0,0,3
Geelong,"Selwood, Joel",27,10,3,17,1,0,0,5
Geelong,"Stokes, Mathew",28,10,1,18,0,0,0,3
Geelong,"Taylor, Harry",12,5,5,7,0,0,1,2
Geelong,"Varcoe, Travis",20,9,3,11,0,1,0,4
Geelong,"Vardy, Nathan",10,5,5,5,0,0,17,4
Geelong,"Bartel, Jimmy",16,8,4,8,1,0,0,4
Geelong,"Blicavs, Mark",8,3,1,5,0,0,8,2
Geelong,"Caddy, Josh",12,8,3,4,1,0,0,1
Geelong,"Christensen, Allen",16,10,3,6,1,0,0,4
Geelong,"Corey, Joel",16,7,4,9,0,0,0,7
Geelong,"Duncan, Mitch",19,13,4,6,0,0,0,3
Geelong,"Guthrie, Cameron",10,7,1,3,1,0,0,1
Geelong,"Hawkins, Tom",10,5,4,5,1,1,0,1
Geelong,"Hunt, Josh",10,5,3,5,0,0,0,1
Geelong,"Johnson, Steve",32,22,8,10,4,1,0,4
Geelong,"Kelly, James",12,6,2,6,0,0,0,5
Geelong,"Lonergan, Tom",6,4,2,2,0,0,0,2
Geelong,"Mackie, Andrew",13,9,1,4,0,0,0,2
Geelong,"Motlop, Steven",14,9,2,5,2,0,0,4
Geelong,"Murdoch, Jordan",10,6,4,4,1,0,0,3
Geelong,"Podsiadly, James",8,6,5,2,0,1,0,1
Geelong,"Rivers, Jared",9,5,3,4,0,0,0,2
Geelong,"Selwood, Joel",23,10,4,13,1,0,0,4
Geelong,"Stokes, Mathew",21,13,5,8,0,0,0,1
Geelong,"Taylor, Harry",13,7,5,6,1,0,0,1
Geelong,"Varcoe, Travis",9,6,1,3,0,1,0,1
Geelong,"Vardy, Nathan",5,4,2,1,1,0,17,1
Greater Western Sydney,"Adams, Taylor",5,2,1,3,0,0,0,0
Greater Western Sydney,"Brogan, Dean",13,8,2,5,0,1,22,2
Greater Western Sydney,"Bugg, Tomas",18,9,7,9,0,0,0,3
Greater Western Sydney,"Cameron, Jeremy",10,6,3,4,1,1,0,3
Greater Western Sydney,"Coniglio, Stephen",22,14,2,8,0,0,0,5
Greater Western Sydney,"Davis, Phil",14,11,4,3,0,0,0,1
Greater Western Sydney,"Giles, Jonathan",14,11,2,3,1,1,14,0
Greater Western Sydney,"Gilham, Stephen",11,6,3,5,0,0,0,1
Greater Western Sydney,"Greene, Toby",11,7,1,4,1,1,0,1
Greater Western Sydney,"Hampton, Curtly",21,15,9,6,0,0,0,0
Greater Western Sydney,"Hoskin-Elliott, Will",19,15,7,4,0,1,0,1
Greater Western Sydney,"Kennedy, Adam",12,7,3,5,0,0,0,0
Greater Western Sydney,"Mohr, Tim",17,13,3,4,0,0,0,2
Greater Western Sydney,"Patton, Jonathon",8,6,4,2,3,0,0,3
Greater Western Sydney,"Plowman, Lachie",14,10,6,4,0,0,0,1
Greater Western Sydney,"Scully, Tom",18,10,3,8,0,1,0,5
Greater Western Sydney,"Shiel, Dylan",26,11,5,15,1,0,0,5
Greater Western Sydney,"Smith, Devon",12,9,2,3,1,1,0,6
Greater Western Sydney,"Sumner, Liam",16,10,4,6,2,1,0,5
Greater Western Sydney,"Treloar, Adam",27,10,3,17,1,1,0,5
Greater Western Sydney,"Ward, Callan",23,10,4,13,0,0,0,4
Greater Western Sydney,"Whitfield, Lachie",15,7,3,8,0,0,0,0
Greater Western Sydney,"Brogan, Dean",8,5,3,3,1,0,16,4
Greater Western Sydney,"Bugg, Tomas",17,7,3,10,0,0,0,1
Greater Western Sydney,"Cameron, Jeremy",8,7,4,1,3,2,0,2
Greater Western Sydney,"Coniglio, Stephen",22,13,2,9,1,1,0,5
Greater Western Sydney,"Davis, Phil",13,7,5,6,0,0,0,2
Greater Western Sydney,"Giles, Jonathan",11,10,2,1,1,1,10,3
Greater Western Sydney,"Gilham, Stephen",10,8,4,2,0,0,0,2
Greater Western Sydney,"Greene, Toby",22,14,4,8,0,0,0,2
Greater Western Sydney,"Hampton, Curtly",7,4,3,3,0,0,0,1
Greater Western Sydney,"Hoskin-Elliott, Will",7,4,2,3,0,1,0,1
Greater Western Sydney,"Kennedy, Adam",10,6,2,4,0,0,0,0
Greater Western Sydney,"Mohr, Tim",17,11,3,6,0,0,0,0
Greater Western Sydney,"Palmer, Rhys",10,6,1,4,0,0,0,4
Greater Western Sydney,"Patton, Jonathon",13,8,2,5,1,3,0,4
Greater Western Sydney,"Plowman, Lachie",6,4,2,2,0,0,0,1
Greater Western Sydney,"Scully, Tom",17,10,2,7,0,0,0,1
Greater Western Sydney,"Shiel, Dylan",19,10,1,9,1,2,0,3
Greater Western Sydney,"Smith, Devon",12,6,4,6,1,0,0,3
Greater Western Sydney,"Sumner, Liam",13,7,2,6,0,0,0,3
Greater Western Sydney,"Treloar, Adam",20,13,5,7,1,0,0,1
Greater Western Sydney,"Ward, Callan",26,14,5,12,0,0,2,6
Greater Western Sydney,"Whitfield, Lachie",20,15,9,5,1,1,0,4
Greater Western Sydney,"Brogan, Dean",8,2,3,6,2,0,24,1
Greater Western Sydney,"Bugg, Tomas",20,10,5,10,0,3,0,4
Greater Western Sydney,"Cameron, Jeremy",11,3,3,8,1,0,0,3
Greater Western Sydney,"Coniglio, Stephen",16,8,3,8,0,1,0,0
Greater Western Sydney,"Davis, Phil",17,11,8,6,0,0,0,0
Greater Western Sydney,"Giles, Jonathan",12,10,4,2,2,2,14,0
Greater Western Sydney,"Gilham, Stephen",14,8,5,6,0,0,0,1
Greater Western Sydney,"Greene, Toby",18,8,1,10,0,0,0,1
Greater Western Sydney,"Hampton, Curtly",11,8,5,3,0,0,0,2
Greater Western Sydney,"Hoskin-Elliott, Will",13,11,5,2,0,1,0,2
Greater Western Sydney,"Kennedy, Adam",14,11,4,3,0,0,0,0
Greater Western Sydney,"Mohr, Tim",11,9,4,2,0,0,0,0
Greater Western Sydney,"Patton, Jonathon",2,2,1,0,1,0,0,0
Greater Western Sydney,"Plowman, Lachie",5,5,1,0,0,0,0,1
Greater Western Sydney,"Reid, Sam",9,6,3,3,0,0,0,2
Greater Western Sydney,"Scully, Tom",11,9,3,2,0,0,0,3
Greater Western Sydney,"Shiel, Dylan",15,6,2,9,0,0,0,4
Greater Western Sydney,"Smith, Devon",15,10,1,5,2,0,0,3
Greater Western Sydney,"Sumner, Liam",9,6,3,3,0,0,0,4
Greater Western Sydney,"Treloar, Adam",21,14,4,7,2,0,0,3
Greater Western Sydney,"Ward, Callan",28,18,4,10,0,1,0,6
Greater Western Sydney,"Whitfield, Lachie",12,2,2,10,0,0,0,1
Greater Western Sydney,"Bugg, Tomas",20,8,1,12,0,1,0,2
Greater Western Sydney,"Cameron, Jeremy",8,6,3,2,1,0,1,1
Greater Western Sydney,"Coniglio, Stephen",23,11,3,12,0,0,0,6
Greater Western Sydney,"Davis, Phil",15,7,5,8,0,0,0,2
Greater Western Sydney,"Frost, Sam",8,3,1,5,0,0,2,0
Greater Western Sydney,"Giles, Jonathan",10,8,0,2,1,0,29,5
Greater Western Sydney,"Gilham, Stephen",15,5,2,10,0,0,0,0
Greater Western Sydney,"Greene, Toby",27,14,3,13,1,1,0,5
Greater Western Sydney,"Haynes, Nick",9,6,5,3,0,0,0,0
Greater Western Sydney,"Kennedy, Adam",19,11,5,8,0,0,0,1
Greater Western Sydney,"Miles, Anthony",5,4,0,1,0,0,0,0
Greater Western Sydney,"Mohr, Tim",13,9,1,4,0,0,1,0
Greater Western Sydney,"OhAilpin, Setanta",14,12,2,2,5,3,0,0
Greater Western Sydney,"Palmer, Rhys",18,10,2,8,2,1,0,5
Greater Western Sydney,"Reid, Sam",18,8,1,10,0,0,0,6
Greater Western Sydney,"Scully, Tom",26,18,4,8,1,0,1,6
Greater Western Sydney,"Shiel, Dylan",29,10,1,19,1,0,0,2
Greater Western Sydney,"Sumner, Liam",9,5,3,4,1,2,0,3
Greater Western Sydney,"Townsend, Jacob",11,4,2,7,0,0,0,2
Greater Western Sydney,"Treloar, Adam",30,13,5,17,1,0,0,2
Greater Western Sydney,"Ward, Callan",23,10,3,13,1,0,1,3
Greater Western Sydney,"Whitfield, Lachie",24,10,4,14,0,1,0,4
Greater Western Sydney,"Bugg, Tomas",2,2,0,0,1,0,0,2
Greater Western Sydney,"Cameron, Jeremy",13,10,8,3,3,1,0,0
Greater Western Sydney,"Coniglio, Stephen",17,12,6,5,1,0,0,3
Greater Western Sydney,"Davis, Phil",13,7,3,6,0,0,0,0
Greater Western Sydney,"Giles, Jonathan",12,9,0,3,0,0,18,2
Greater Western Sydney,"Greene, Toby",21,14,3,7,0,0,0,6
Greater Western Sydney,"Haynes, Nick",7,5,3,2,0,0,0,3
Greater Western Sydney,"Kennedy, Adam",7,3,4,4,0,0,0,1
Greater Western Sydney,"Mohr, Tim",20,18,9,2,0,0,0,1
Greater Western Sydney,"OhAilpin, Setanta",13,9,2,4,3,1,1,0
Greater Western Sydney,"Palmer, Rhys",22,11,4,11,2,0,0,6
Greater Western Sydney,"Plowman, Lachie",14,8,5,6,0,0,0,0
Greater Western Sydney,"Reid, Sam",13,7,7,6,0,0,0,5
Greater Western Sydney,"Scully, Tom",15,8,5,7,1,1,0,3
Greater Western Sydney,"Shiel, Dylan",24,10,5,14,1,1,0,4
Greater Western Sydney,"Smith, Devon",26,18,3,8,3,2,0,4
Greater Western Sydney,"Thornton, Bret",14,12,11,2,0,0,1,0
Greater Western Sydney,"Tomlinson, Adam",8,5,4,3,1,0,0,3
Greater Western Sydney,"Treloar, Adam",15,4,2,11,0,0,0,2
Greater Western Sydney,"Ward, Callan",31,16,8,15,0,0,2,2
Greater Western Sydney,"Whitfield, Lachie",17,7,5,10,0,0,0,3
Greater Western Sydney,"Williams, Zac",13,5,2,8,0,0,0,3
Greater Western Sydney,"Adams, Taylor",24,17,9,7,2,0,0,4
Greater Western Sydney,"Bruce, Josh",11,7,4,4,1,0,0,1
Greater Western Sydney,"Bugg, Tomas",11,8,4,3,0,0,0,1
Greater Western Sydney,"Cameron, Jeremy",12,10,8,2,6,0,0,0
Greater Western Sydney,"Coniglio, Stephen",18,12,5,6,0,1,0,2
Greater Western Sydney,"Corr, Aidan",7,4,2,3,0,0,0,1
Greater Western Sydney,"Frost, Sam",11,4,3,7,0,0,2,2
Greater Western Sydney,"Giles, Jonathan",14,6,1,8,0,0,36,4
Greater Western Sydney,"Gilham, Stephen",22,15,12,7,0,0,0,1
Greater Western Sydney,"Greene, Toby",23,19,4,4,0,0,0,2
Greater Western Sydney,"Hampton, Curtly",13,7,3,6,0,0,0,1
Greater Western Sydney,"Mohr, Tim",24,19,8,5,0,1,0,1
Greater Western Sydney,"Palmer, Rhys",21,13,8,8,0,2,0,2
Greater Western Sydney,"Reid, Sam",15,6,1,9,0,0,0,7
Greater Western Sydney,"Scully, Tom",18,12,7,6,2,0,0,7
Greater Western Sydney,"Shiel, Dylan",15,5,2,10,0,0,1,1
Greater Western Sydney,"Smith, Devon",13,6,4,7,0,1,0,2
Greater Western Sydney,"Tomlinson, Adam",12,8,5,4,0,0,0,0
Greater Western Sydney,"Townsend, Jacob",16,11,5,5,0,0,1,5
Greater Western Sydney,"Treloar, Adam",26,14,7,12,1,0,1,4
Greater Western Sydney,"Ward, Callan",15,10,4,5,0,2,0,2
Greater Western Sydney,"Williams, Zac",7,5,0,2,0,0,0,1
Greater Western Sydney,"Adams, Taylor",22,16,8,6,0,1,0,2
Greater Western Sydney,"Brogan, Dean",4,1,2,3,0,0,11,1
Greater Western Sydney,"Bruce, Josh",12,5,2,7,0,0,0,1
Greater Western Sydney,"Cameron, Jeremy",11,6,5,5,3,1,0,3
Greater Western Sydney,"Coniglio, Stephen",18,13,4,5,0,1,0,1
Greater Western Sydney,"Corr, Aidan",8,2,2,6,0,0,0,0
Greater Western Sydney,"Giles, Jonathan",8,4,0,4,1,0,23,0
Greater Western Sydney,"Gilham, Stephen",19,14,7,5,0,0,0,2
Greater Western Sydney,"Greene, Toby",22,13,5,9,0,0,0,0
Greater Western Sydney,"Kennedy, Adam",11,8,4,3,0,0,0,3
Greater Western Sydney,"Mohr, Tim",15,12,7,3,0,0,0,1
Greater Western Sydney,"Palmer, Rhys",9,3,3,6,0,1,0,3
Greater Western Sydney,"Reid, Sam",18,9,4,9,0,0,0,3
Greater Western Sydney,"Scully, Tom",12,6,3,6,0,0,0,2
Greater Western Sydney,"Shiel, Dylan",17,6,5,11,0,1,0,2
Greater Western Sydney,"Smith, Devon",12,8,3,4,0,0,0,4
Greater Western Sydney,"Tomlinson, Adam",21,17,14,4,0,1,1,0
Greater Western Sydney,"Townsend, Jacob",9,7,3,2,0,0,0,4
Greater Western Sydney,"Treloar, Adam",24,15,9,9,1,1,0,0
Greater Western Sydney,"Ward, Callan",22,12,5,10,2,0,3,0
Greater Western Sydney,"Whitfield, Lachie",17,9,7,8,0,0,1,2
Greater Western Sydney,"Williams, Zac",9,3,2,6,0,1,0,1
Greater Western Sydney,"Adams, Taylor",26,16,5,10,1,1,0,9
Greater Western Sydney,"Brogan, Dean",12,8,0,4,0,1,16,4
Greater Western Sydney,"Bruce, Josh",9,7,4,2,0,0,0,0
Greater Western Sydney,"Bugg, Tomas",7,5,2,2,1,0,0,4
Greater Western Sydney,"Cameron, Jeremy",11,8,4,3,4,0,0,0
Greater Western Sydney,"Coniglio, Stephen",28,9,3,19,0,0,1,4
Greater Western Sydney,"Corr, Aidan",6,1,0,5,0,0,0,4
Greater Western Sydney,"Giles, Jonathan",8,6,2,2,0,0,20,0
Greater Western Sydney,"Gilham, Stephen",13,9,2,4,0,0,0,1
Greater Western Sydney,"Golds, Tim",9,5,3,4,0,0,0,2
Greater Western Sydney,"Greene, Toby",20,13,2,7,0,0,0,1
Greater Western Sydney,"Kennedy, Adam",22,12,2,10,0,0,0,0
Greater Western Sydney,"Miles, Anthony",18,13,6,5,1,0,0,7
Greater Western Sydney,"Mohr, Tim",13,9,3,4,0,0,0,5
Greater Western Sydney,"Palmer, Rhys",22,17,8,5,1,0,0,3
Greater Western Sydney,"Scully, Tom",20,7,7,13,1,0,0,7
Greater Western Sydney,"Shiel, Dylan",13,4,2,9,0,0,0,7
Greater Western Sydney,"Smith, Devon",18,10,2,8,0,0,1,9
Greater Western Sydney,"Tomlinson, Adam",16,13,9,3,0,1,0,1
Greater Western Sydney,"Ward, Callan",25,14,2,11,0,0,0,6
Greater Western Sydney,"Whiley, Mark",2,2,2,0,0,0,0,5
Greater Western Sydney,"Whitfield, Lachie",11,2,1,9,0,0,0,3
Greater Western Sydney,"Adams, Taylor",28,17,6,11,0,0,0,4
Greater Western Sydney,"Bruce, Josh",17,10,4,7,0,0,0,2
Greater Western Sydney,"Buntine, Matt",10,4,1,6,0,0,0,3
Greater Western Sydney,"Cameron, Jeremy",9,8,8,1,3,0,0,2
Greater Western Sydney,"Coniglio, Stephen",21,9,3,12,0,0,0,4
Greater Western Sydney,"Corr, Aidan",5,2,1,3,0,0,0,1
Greater Western Sydney,"Giles, Jonathan",14,8,1,6,0,0,17,1
Greater Western Sydney,"Gilham, Stephen",21,11,7,10,0,0,0,1
Greater Western Sydney,"Greene, Toby",25,10,4,15,0,0,0,1
Greater Western Sydney,"Hampton, Curtly",7,4,1,3,0,0,1,4
Greater Western Sydney,"Kennedy, Adam",12,4,2,8,0,0,0,4
Greater Western Sydney,"Miles, Anthony",15,6,6,9,0,1,0,6
Greater Western Sydney,"Mohr, Tim",16,12,4,4,0,0,0,0
Greater Western Sydney,"OhAilpin, Setanta",2,1,0,1,1,0,3,1
Greater Western Sydney,"Palmer, Rhys",17,5,5,12,0,0,0,1
Greater Western Sydney,"Scully, Tom",18,6,4,12,1,1,0,2
Greater Western Sydney,"Shiel, Dylan",18,10,2,8,0,0,0,3
Greater Western Sydney,"Smith, Devon",16,13,4,3,1,1,1,7
Greater Western Sydney,"Tomlinson, Adam",14,8,6,6,0,0,0,0
Greater Western Sydney,"Treloar, Adam",25,12,2,13,0,1,0,1
Greater Western Sydney,"Ward, Callan",13,9,5,4,2,0,0,9
Greater Western Sydney,"Whitfield, Lachie",15,10,5,5,0,0,0,2
Greater Western Sydney,"Adams, Taylor",22,11,2,11,0,0,0,6
Greater Western Sydney,"Bruce, Josh",9,4,4,5,0,0,0,0
Greater Western Sydney,"Buntine, Matt",9,6,2,3,0,0,0,2
Greater Western Sydney,"Cameron, Jeremy",10,7,6,3,2,0,0,1
Greater Western Sydney,"Coniglio, Stephen",25,16,6,9,2,0,1,2
Greater Western Sydney,"Corr, Aidan",10,5,5,5,0,0,0,2
Greater Western Sydney,"Giles, Jonathan",6,5,0,1,0,0,29,3
Greater Western Sydney,"Greene, Toby",28,13,6,15,0,0,0,0
Greater Western Sydney,"Hampton, Curtly",13,9,5,4,1,1,0,5
Greater Western Sydney,"Kennedy, Adam",22,7,7,15,0,0,0,1
Greater Western Sydney,"Mohr, Tim",13,10,4,3,0,0,0,1
Greater Western Sydney,"OhAilpin, Setanta",1,0,0,1,0,0,5,2
Greater Western Sydney,"Palmer, Rhys",24,14,7,10,1,0,0,4
Greater Western Sydney,"Scully, Tom",20,11,4,9,0,0,0,5
Greater Western Sydney,"Shiel, Dylan",13,7,0,6,0,0,0,2
Greater Western Sydney,"Smith, Devon",16,9,3,7,0,0,1,5
Greater Western Sydney,"Tomlinson, Adam",15,9,6,6,0,0,0,1
Greater Western Sydney,"Townsend, Jacob",12,7,1,5,0,1,0,2
Greater Western Sydney,"Treloar, Adam",26,14,7,12,0,0,0,5
Greater Western Sydney,"Ward, Callan",33,18,9,15,1,0,0,2
Greater Western Sydney,"Whitfield, Lachie",21,12,7,9,1,0,0,5
Greater Western Sydney,"Wilson, Nathan",7,4,4,3,0,0,0,3
Greater Western Sydney,"Adams, Taylor",22,16,3,6,0,1,0,1
Greater Western Sydney,"Bruce, Josh",12,7,5,5,0,0,0,4
Greater Western Sydney,"Cameron, Jeremy",18,16,9,2,4,4,0,0
Greater Western Sydney,"Coniglio, Stephen",12,8,2,4,0,0,1,3
Greater Western Sydney,"Corr, Aidan",7,5,3,2,0,0,0,1
Greater Western Sydney,"Giles, Jonathan",16,13,1,3,0,0,41,7
Greater Western Sydney,"Gilham, Stephen",14,8,5,6,0,0,0,1
Greater Western Sydney,"Hampton, Curtly",15,10,4,5,0,0,0,7
Greater Western Sydney,"Kennedy, Adam",11,3,2,8,0,0,0,2
Greater Western Sydney,"Mohr, Tim",14,12,5,2,0,0,0,2
Greater Western Sydney,"Palmer, Rhys",19,14,10,5,3,0,1,1
Greater Western Sydney,"Plowman, Lachie",11,5,1,6,1,1,0,3
Greater Western Sydney,"Reid, Sam",13,6,1,7,1,0,0,11
Greater Western Sydney,"Scully, Tom",13,8,1,5,2,0,0,7
Greater Western Sydney,"Shiel, Dylan",12,3,2,9,1,0,0,7
Greater Western Sydney,"Smith, Devon",18,10,3,8,0,0,1,6
Greater Western Sydney,"Tomlinson, Adam",12,11,6,1,1,0,1,5
Greater Western Sydney,"Townsend, Jacob",14,6,4,8,0,0,0,6
Greater Western Sydney,"Treloar, Adam",27,17,3,10,1,0,1,4
Greater Western Sydney,"Ugle, Gerald",12,5,2,7,0,0,0,3
Greater Western Sydney,"Ward, Callan",30,14,8,16,1,0,2,1
Greater Western Sydney,"Whitfield, Lachie",7,2,0,5,0,0,0,0
Greater Western Sydney,"Adams, Taylor",19,9,1,10,1,0,0,3
Greater Western Sydney,"Bruce, Josh",12,9,2,3,0,0,0,2
Greater Western Sydney,"Cameron, Jeremy",10,9,5,1,2,2,0,3
Greater Western Sydney,"Coniglio, Stephen",22,13,4,9,0,0,1,4
Greater Western Sydney,"Corr, Aidan",14,5,5,9,0,0,0,2
Greater Western Sydney,"Giles, Jonathan",14,11,3,3,0,0,29,2
Greater Western Sydney,"Greene, Toby",27,14,4,13,0,0,0,2
Greater Western Sydney,"Hampton, Curtly",21,11,4,10,0,0,0,2
Greater Western Sydney,"Hoskin-Elliott, Will",13,6,2,7,1,1,0,3
Greater Western Sydney,"Kennedy, Adam",19,7,5,12,0,1,0,1
Greater Western Sydney,"Mohr, Tim",13,7,2,6,0,0,0,4
Greater Western Sydney,"Plowman, Lachie",6,3,1,3,0,0,0,0
Greater Western Sydney,"Reid, Sam",15,12,3,3,0,1,1,4
Greater Western Sydney,"Scully, Tom",30,17,9,13,0,1,0,3
Greater Western Sydney,"Shiel, Dylan",18,8,5,10,0,1,0,3
Greater Western Sydney,"Smith, Devon",13,6,3,7,0,1,0,5
Greater Western Sydney,"Tomlinson, Adam",20,14,12,6,0,1,4,2
Greater Western Sydney,"Townsend, Jacob",18,7,4,11,0,0,0,5
Greater Western Sydney,"Treloar, Adam",24,13,4,11,0,0,0,7
Greater Western Sydney,"Ward, Callan",22,8,3,14,0,1,3,5
Greater Western Sydney,"Whitfield, Lachie",21,12,8,9,1,1,0,3
Greater Western Sydney,"Williams, Zac",8,6,2,2,1,0,0,2
Greater Western Sydney,"Adams, Taylor",21,15,7,6,0,0,0,2
Greater Western Sydney,"Corr, Aidan",7,4,3,3,1,0,0,2
Greater Western Sydney,"Giles, Jonathan",7,4,1,3,0,0,34,4
Greater Western Sydney,"Gilham, Stephen",23,19,10,4,0,0,0,0
Greater Western Sydney,"Greene, Toby",25,17,12,8,0,1,0,2
Greater Western Sydney,"Hampton, Curtly",14,7,5,7,0,0,0,0
Greater Western Sydney,"Haynes, Nick",14,9,4,5,0,0,0,2
Greater Western Sydney,"Hoskin-Elliott, Will",17,9,7,8,1,0,0,0
Greater Western Sydney,"Kennedy, Adam",11,7,4,4,0,0,0,4
Greater Western Sydney,"Mohr, Tim",9,6,2,3,0,0,0,1
Greater Western Sydney,"OhAilpin, Setanta",18,11,7,7,2,1,2,0
Greater Western Sydney,"Reid, Sam",7,3,2,4,1,0,0,3
Greater Western Sydney,"Scully, Tom",20,10,9,10,0,0,0,2
Greater Western Sydney,"Shiel, Dylan",20,13,5,7,0,1,0,3
Greater Western Sydney,"Smith, Devon",11,8,2,3,0,1,0,2
Greater Western Sydney,"Sumner, Liam",8,4,3,4,1,1,0,0
Greater Western Sydney,"Tomlinson, Adam",18,15,8,3,0,1,3,1
Greater Western Sydney,"Townsend, Jacob",7,4,1,3,0,0,0,0
Greater Western Sydney,"Treloar, Adam",24,14,10,10,0,0,0,4
Greater Western Sydney,"Ward, Callan",17,9,3,8,0,1,0,2
Greater Western Sydney,"Whitfield, Lachie",17,9,8,8,0,0,0,1
Greater Western Sydney,"Williams, Zac",9,4,2,5,0,0,0,2
Greater Western Sydney,"Adams, Taylor",12,8,2,4,0,0,0,4
Greater Western Sydney,"Cameron, Jeremy",7,6,2,1,3,1,0,0
Greater Western Sydney,"Coniglio, Stephen",15,8,1,7,0,0,0,7
Greater Western Sydney,"Corr, Aidan",7,4,3,3,0,0,0,2
Greater Western Sydney,"Giles, Jonathan",12,9,0,3,0,0,30,3
Greater Western Sydney,"Gilham, Stephen",17,11,8,6,0,0,0,1
Greater Western Sydney,"Hampton, Curtly",10,6,2,4,0,1,0,5
Greater Western Sydney,"Haynes, Nick",18,12,8,6,0,0,0,5
Greater Western Sydney,"Hoskin-Elliott, Will",10,7,4,3,1,2,0,5
Greater Western Sydney,"Kennedy, Adam",6,1,1,5,0,0,0,2
Greater Western Sydney,"Mohr, Tim",18,14,9,4,0,0,0,1
Greater Western Sydney,"OhAilpin, Setanta",6,2,2,4,2,0,2,0
Greater Western Sydney,"Palmer, Rhys",9,4,1,5,0,1,0,1
Greater Western Sydney,"Reid, Sam",9,5,2,4,0,0,0,6
Greater Western Sydney,"Scully, Tom",23,11,4,12,0,1,0,4
Greater Western Sydney,"Shiel, Dylan",25,14,6,11,3,0,0,4
Greater Western Sydney,"Smith, Devon",24,15,3,9,2,1,0,4
Greater Western Sydney,"Tomlinson, Adam",8,2,4,6,0,1,10,3
Greater Western Sydney,"Townsend, Jacob",6,4,1,2,0,0,0,1
Greater Western Sydney,"Treloar, Adam",21,11,3,10,0,0,0,5
Greater Western Sydney,"Ward, Callan",14,9,1,5,0,0,1,4
Greater Western Sydney,"Whitfield, Lachie",21,13,9,8,1,0,0,4
Greater Western Sydney,"Bugg, Tomas",5,2,0,3,0,2,0,0
Greater Western Sydney,"Cameron, Jeremy",16,13,7,3,3,1,0,1
Greater Western Sydney,"Corr, Aidan",9,4,0,5,0,0,0,1
Greater Western Sydney,"Darley, Sam",20,16,2,4,1,0,0,2
Greater Western Sydney,"Davis, Phil",17,14,5,3,0,0,0,1
Greater Western Sydney,"Edwards, Shaun",10,3,4,7,0,0,0,0
Greater Western Sydney,"Giles, Jonathan",4,3,1,1,0,0,36,2
Greater Western Sydney,"Gilham, Stephen",12,7,3,5,0,0,0,3
Greater Western Sydney,"Hampton, Curtly",13,7,2,6,0,0,0,5
Greater Western Sydney,"Haynes, Nick",14,9,5,5,0,0,0,3
Greater Western Sydney,"Hoskin-Elliott, Will",6,5,2,1,0,2,0,1
Greater Western Sydney,"Mohr, Tim",10,5,3,5,0,0,1,2
Greater Western Sydney,"ORourke, Jonathan",7,5,2,2,0,0,0,3
Greater Western Sydney,"OhAilpin, Setanta",11,8,5,3,0,0,3,0
Greater Western Sydney,"Palmer, Rhys",12,6,2,6,0,0,0,2
Greater Western Sydney,"Scully, Tom",3,3,1,0,0,1,0,0
Greater Western Sydney,"Shiel, Dylan",22,15,5,7,0,1,0,2
Greater Western Sydney,"Smith, Devon",19,10,0,9,1,0,1,2
Greater Western Sydney,"Treloar, Adam",25,11,5,14,0,1,0,5
Greater Western Sydney,"Tyson, Dom",12,7,4,5,0,0,0,4
Greater Western Sydney,"Ward, Callan",23,11,4,12,0,0,5,8
Greater Western Sydney,"Whitfield, Lachie",24,13,4,11,0,0,0,1
Greater Western Sydney,"Adams, Taylor",28,14,3,14,0,0,0,2
Greater Western Sydney,"Brogan, Dean",12,5,3,7,0,0,19,1
Greater Western Sydney,"Bruce, Josh",13,11,5,2,0,0,0,4
Greater Western Sydney,"Bugg, Tomas",15,9,2,6,0,0,0,4
Greater Western Sydney,"Cameron, Jeremy",13,10,5,3,4,5,0,3
Greater Western Sydney,"Darley, Sam",16,8,2,8,0,0,0,3
Greater Western Sydney,"Davis, Phil",11,5,5,6,0,1,0,1
Greater Western Sydney,"Giles, Jonathan",10,8,3,2,4,0,27,1
Greater Western Sydney,"Greene, Toby",28,16,4,12,0,1,0,4
Greater Western Sydney,"Hampton, Curtly",17,4,3,13,0,0,0,3
Greater Western Sydney,"Haynes, Nick",13,12,5,1,0,0,0,3
Greater Western Sydney,"Hoskin-Elliott, Will",9,6,1,3,0,1,0,1
Greater Western Sydney,"Mohr, Tim",21,15,4,6,0,0,0,3
Greater Western Sydney,"Shiel, Dylan",28,11,0,17,0,1,1,2
Greater Western Sydney,"Smith, Devon",13,9,4,4,0,0,0,5
Greater Western Sydney,"Tomlinson, Adam",23,13,9,10,1,0,0,4
Greater Western Sydney,"Treloar, Adam",17,9,4,8,1,0,0,3
Greater Western Sydney,"Ugle, Gerald",8,5,2,3,0,0,0,2
Greater Western Sydney,"Ward, Callan",19,9,4,10,0,0,2,5
Greater Western Sydney,"Whiley, Mark",10,9,1,1,0,0,0,12
Greater Western Sydney,"Whitfield, Lachie",13,7,7,6,1,0,0,0
Greater Western Sydney,"Williams, Zac",18,7,1,11,0,0,0,4
Greater Western Sydney,"Adams, Taylor",23,12,3,11,0,0,0,3
Greater Western Sydney,"Brogan, Dean",9,4,3,5,0,0,20,2
Greater Western Sydney,"Bruce, Josh",9,8,6,1,0,0,0,2
Greater Western Sydney,"Bugg, Tomas",19,6,3,13,0,0,0,4
Greater Western Sydney,"Cameron, Jeremy",11,10,5,1,7,1,0,1
Greater Western Sydney,"Darley, Sam",19,11,1,8,0,0,0,0
Greater Western Sydney,"Davis, Phil",4,2,3,2,0,0,0,0
Greater Western Sydney,"Giles, Jonathan",10,8,1,2,0,0,20,1
Greater Western Sydney,"Greene, Toby",26,10,3,16,0,0,0,3
Greater Western Sydney,"Hampton, Curtly",31,18,7,13,0,1,0,2
Greater Western Sydney,"Haynes, Nick",15,12,7,3,0,0,0,2
Greater Western Sydney,"Hoskin-Elliott, Will",11,8,3,3,0,0,0,1
Greater Western Sydney,"Kennedy, Adam",15,9,5,6,0,0,0,6
Greater Western Sydney,"Mohr, Tim",2,1,0,1,0,0,0,1
Greater Western Sydney,"Scully, Tom",16,6,4,10,1,0,0,6
Greater Western Sydney,"Shiel, Dylan",26,17,3,9,1,0,0,1
Greater Western Sydney,"Smith, Devon",14,6,1,8,1,0,0,2
Greater Western Sydney,"Tomlinson, Adam",15,13,9,2,0,0,0,0
Greater Western Sydney,"Treloar, Adam",26,12,2,14,0,0,0,4
Greater Western Sydney,"Ward, Callan",32,14,9,18,0,0,6,7
Greater Western Sydney,"Whiley, Mark",9,5,1,4,0,0,0,10
Greater Western Sydney,"Williams, Zac",22,7,4,15,0,0,0,3
Greater Western Sydney,"Adams, Taylor",22,12,6,10,1,2,0,0
Greater Western Sydney,"Brogan, Dean",13,8,7,5,0,0,10,4
Greater Western Sydney,"Bruce, Josh",16,9,7,7,0,0,0,5
Greater Western Sydney,"Bugg, Tomas",17,12,4,5,1,0,0,6
Greater Western Sydney,"Cameron, Jeremy",10,9,6,1,4,1,1,2
Greater Western Sydney,"Coniglio, Stephen",10,5,1,5,0,0,0,2
Greater Western Sydney,"Davis, Phil",10,7,5,3,0,1,0,2
Greater Western Sydney,"Giles, Jonathan",15,8,2,7,2,1,16,2
Greater Western Sydney,"Greene, Toby",11,4,2,7,0,0,1,1
Greater Western Sydney,"Hampton, Curtly",24,15,7,9,0,0,0,3
Greater Western Sydney,"Haynes, Nick",15,10,6,5,0,0,0,0
Greater Western Sydney,"Kennedy, Adam",18,8,2,10,0,0,0,4
Greater Western Sydney,"Mohr, Tim",13,12,10,1,0,0,0,0
Greater Western Sydney,"Scully, Tom",29,11,11,18,0,0,0,5
Greater Western Sydney,"Shiel, Dylan",10,6,1,4,1,0,0,2
Greater Western Sydney,"Smith, Devon",25,17,4,8,3,2,0,2
Greater Western Sydney,"Tomlinson, Adam",18,11,5,7,1,0,0,1
Greater Western Sydney,"Treloar, Adam",30,14,6,16,0,1,0,0
Greater Western Sydney,"Ward, Callan",31,17,5,14,4,0,3,4
Greater Western Sydney,"Whiley, Mark",4,3,0,1,0,0,0,5
Greater Western Sydney,"Whitfield, Lachie",26,17,10,9,2,1,0,2
Greater Western Sydney,"Williams, Zac",21,11,5,10,0,0,0,3
Greater Western Sydney,"Adams, Taylor",14,8,4,6,0,0,0,4
Greater Western Sydney,"Bruce, Josh",12,8,3,4,0,0,0,6
Greater Western Sydney,"Bugg, Tomas",21,7,4,14,0,0,0,4
Greater Western Sydney,"Cameron, Jeremy",7,6,4,1,4,2,0,0
Greater Western Sydney,"Coniglio, Stephen",14,5,1,9,0,0,0,7
Greater Western Sydney,"Darley, Sam",13,8,3,5,0,0,0,3
Greater Western Sydney,"Davis, Phil",12,6,5,6,0,0,0,5
Greater Western Sydney,"Downie, Tom",4,3,1,1,0,0,2,5
Greater Western Sydney,"Giles, Jonathan",6,3,0,3,0,1,16,4
Greater Western Sydney,"Greene, Toby",23,9,1,14,0,0,0,6
Greater Western Sydney,"Hampton, Curtly",18,7,3,11,1,0,0,7
Greater Western Sydney,"Kennedy, Adam",8,4,3,4,0,0,0,2
Greater Western Sydney,"Mohr, Tim",15,12,5,3,0,0,0,2
Greater Western Sydney,"Scully, Tom",18,6,1,12,0,0,0,5
Greater Western Sydney,"Smith, Devon",18,11,3,7,1,1,0,10
Greater Western Sydney,"Tomlinson, Adam",9,6,4,3,0,0,0,0
Greater Western Sydney,"Treloar, Adam",23,10,2,13,0,0,0,7
Greater Western Sydney,"Ward, Callan",29,11,5,18,0,1,5,7
Greater Western Sydney,"Whiley, Mark",9,6,0,3,0,0,0,9
Greater Western Sydney,"Whitfield, Lachie",11,5,5,6,0,0,0,4
Greater Western Sydney,"Williams, Zac",19,9,6,10,0,0,0,8
Greater Western Sydney,"Wilson, Nathan",3,2,1,1,0,1,0,2
Greater Western Sydney,"Brogan, Dean",11,7,3,4,0,1,20,3
Greater Western Sydney,"Bugg, Tomas",13,7,3,6,0,0,0,2
Greater Western Sydney,"Cameron, Jeremy",13,9,6,4,2,2,0,0
Greater Western Sydney,"Coniglio, Stephen",28,17,8,11,1,0,0,5
Greater Western Sydney,"Davis, Phil",14,11,8,3,0,0,0,2
Greater Western Sydney,"Giles, Jonathan",7,4,1,3,1,0,17,0
Greater Western Sydney,"Gilham, Stephen",11,8,5,3,0,0,0,3
Greater Western Sydney,"Greene, Toby",31,14,3,17,1,1,0,2
Greater Western Sydney,"Hampton, Curtly",12,10,2,2,0,0,0,1
Greater Western Sydney,"Haynes, Nick",8,6,4,2,0,0,0,5
Greater Western Sydney,"Kennedy, Adam",10,6,5,4,0,0,0,3
Greater Western Sydney,"Mohr, Tim",10,8,5,2,0,0,0,1
Greater Western Sydney,"Scully, Tom",16,10,2,6,1,0,0,3
Greater Western Sydney,"Shiel, Dylan",16,9,4,7,0,1,0,4
Greater Western Sydney,"Sumner, Liam",6,4,2,2,0,1,0,1
Greater Western Sydney,"Tomlinson, Adam",15,10,8,5,0,0,0,1
Greater Western Sydney,"Treloar, Adam",27,11,5,16,0,0,0,4
Greater Western Sydney,"Ward, Callan",15,8,1,7,0,0,3,2
Greater Western Sydney,"Whiley, Mark",12,4,0,8,1,0,0,4
Greater Western Sydney,"Whitfield, Lachie",19,9,4,10,1,0,0,1
Greater Western Sydney,"Williams, Zac",9,8,3,1,1,0,0,5
Greater Western Sydney,"Wilson, Nathan",5,5,1,0,0,0,0,4
Greater Western Sydney,"Adams, Taylor",23,16,6,7,1,0,0,6
Greater Western Sydney,"Brogan, Dean",15,7,5,8,0,0,21,1
Greater Western Sydney,"Bugg, Tomas",11,5,2,6,0,0,0,1
Greater Western Sydney,"Cameron, Jeremy",2,2,1,0,0,0,0,0
Greater Western Sydney,"Coniglio, Stephen",18,10,4,8,0,0,0,0
Greater Western Sydney,"Davis, Phil",12,8,7,4,0,0,0,1
Greater Western Sydney,"Giles, Jonathan",9,6,2,3,0,0,16,1
Greater Western Sydney,"Greene, Toby",23,12,4,11,1,0,0,1
Greater Western Sydney,"Hampton, Curtly",17,11,3,6,0,0,0,5
Greater Western Sydney,"Haynes, Nick",10,4,5,6,0,0,0,0
Greater Western Sydney,"Jaksch, Kristian",10,6,6,4,1,0,0,1
Greater Western Sydney,"Kennedy, Adam",14,10,3,4,0,0,0,0
Greater Western Sydney,"Mohr, Tim",10,10,5,0,0,0,0,2
Greater Western Sydney,"Scully, Tom",22,12,4,10,1,0,0,3
Greater Western Sydney,"Shiel, Dylan",23,8,4,15,1,1,0,3
Greater Western Sydney,"Sumner, Liam",5,5,1,0,1,0,0,3
Greater Western Sydney,"Tomlinson, Adam",22,12,6,10,0,1,1,3
Greater Western Sydney,"Treloar, Adam",22,9,1,13,0,1,0,2
Greater Western Sydney,"Tyson, Dom",10,3,0,7,0,0,0,1
Greater Western Sydney,"Ward, Callan",18,6,3,12,0,0,1,9
Greater Western Sydney,"Williams, Zac",14,6,1,8,0,0,0,1
Greater Western Sydney,"Wilson, Nathan",8,5,4,3,0,0,0,3
Greater Western Sydney,"Adams, Taylor",30,20,3,10,1,1,0,2
Greater Western Sydney,"Buntine, Matt",22,13,9,9,0,0,0,1
Greater Western Sydney,"Cameron, Jeremy",14,9,4,5,2,3,0,2
Greater Western Sydney,"Coniglio, Stephen",19,9,7,10,1,1,1,7
Greater Western Sydney,"Davis, Phil",15,9,8,6,0,0,0,3
Greater Western Sydney,"Edwards, Shaun",15,7,2,8,0,1,0,2
Greater Western Sydney,"Giles, Jonathan",12,6,3,6,1,0,43,1
Greater Western Sydney,"Gilham, Stephen",11,11,8,0,0,0,0,2
Greater Western Sydney,"Greene, Toby",23,5,3,18,0,0,0,2
Greater Western Sydney,"Hampton, Curtly",17,11,4,6,1,0,0,5
Greater Western Sydney,"Haynes, Nick",17,9,8,8,0,0,0,3
Greater Western Sydney,"Jaksch, Kristian",5,4,2,1,0,0,0,0
Greater Western Sydney,"Kennedy, Adam",19,15,8,4,1,0,0,1
Greater Western Sydney,"Mohr, Tim",20,15,8,5,0,0,0,1
Greater Western Sydney,"Scully, Tom",13,7,4,6,0,0,0,5
Greater Western Sydney,"Shiel, Dylan",22,11,2,11,0,1,0,6
Greater Western Sydney,"Stewart, James",2,1,1,1,0,0,0,1
Greater Western Sydney,"Sumner, Liam",9,5,2,4,1,1,1,4
Greater Western Sydney,"Tomlinson, Adam",22,12,12,10,1,0,2,2
Greater Western Sydney,"Tyson, Dom",18,10,4,8,0,1,0,2
Greater Western Sydney,"Whiley, Mark",7,4,1,3,0,0,0,1
Greater Western Sydney,"Whitfield, Lachie",21,13,5,8,0,0,0,2
Hawthorn,"Anderson, Jed",6,5,2,1,0,0,0,1
Hawthorn,"Bailey, Max",9,3,2,6,0,0,18,2
Hawthorn,"Birchall, Grant",29,20,6,9,0,0,0,2
Hawthorn,"Breust, Luke",14,6,1,8,2,3,0,4
Hawthorn,"Burgoyne, Shaun",26,15,4,11,0,0,0,2
Hawthorn,"Franklin, Lance",14,11,5,3,2,2,0,3
Hawthorn,"Gibson, Josh",15,2,1,13,0,0,0,2
Hawthorn,"Guerra, Brent",24,15,3,9,1,1,0,2
Hawthorn,"Gunston, Jack",8,4,1,4,0,1,0,2
Hawthorn,"Hale, David",10,5,4,5,1,0,9,2
Hawthorn,"Hill, Bradley",14,11,4,3,0,0,0,2
Hawthorn,"Lewis, Jordan",27,12,6,15,1,1,0,1
Hawthorn,"Mitchell, Sam",37,19,6,18,0,0,0,4
Hawthorn,"Puopolo, Paul",28,10,4,18,0,0,0,5
Hawthorn,"Rioli, Cyril",20,13,4,7,1,1,0,5
Hawthorn,"Roughead, Jarryd",15,9,4,6,1,2,5,1
Hawthorn,"Savage, Shane",13,8,2,5,2,1,0,3
Hawthorn,"Schoenmakers, Ryan",20,10,6,10,0,0,0,1
Hawthorn,"Sewell, Brad",33,15,3,18,0,0,0,1
Hawthorn,"Shiels, Liam",7,4,5,3,0,1,0,0
Hawthorn,"Smith, Isaac",23,11,6,12,1,0,0,3
Hawthorn,"Stratton, Ben",13,8,3,5,0,0,0,5
Hawthorn,"Anderson, Jed",10,6,3,4,0,0,0,4
Hawthorn,"Bailey, Max",15,8,3,7,0,0,28,2
Hawthorn,"Birchall, Grant",31,22,7,9,2,0,0,1
Hawthorn,"Breust, Luke",14,9,4,5,4,1,0,5
Hawthorn,"Burgoyne, Shaun",21,15,4,6,1,0,0,2
Hawthorn,"Franklin, Lance",14,12,3,2,5,1,0,4
Hawthorn,"Gibson, Josh",13,6,2,7,0,0,0,1
Hawthorn,"Guerra, Brent",15,7,1,8,0,0,0,2
Hawthorn,"Hale, David",11,7,7,4,2,1,15,0
Hawthorn,"Hill, Bradley",13,10,2,3,2,0,0,2
Hawthorn,"Hodge, Luke",25,12,6,13,0,0,0,4
Hawthorn,"Lewis, Jordan",18,11,2,7,0,0,1,5
Hawthorn,"Mitchell, Sam",31,17,4,14,0,0,0,6
Hawthorn,"Puopolo, Paul",9,2,2,7,0,0,0,2
Hawthorn,"Rioli, Cyril",16,11,3,5,4,1,1,1
Hawthorn,"Roughead, Jarryd",16,11,4,5,2,1,2,1
Hawthorn,"Savage, Shane",7,4,1,3,0,0,0,3
Hawthorn,"Schoenmakers, Ryan",18,8,6,10,0,0,0,4
Hawthorn,"Sewell, Brad",15,6,1,9,0,0,0,5
Hawthorn,"Shiels, Liam",20,14,4,6,0,1,0,1
Hawthorn,"Smith, Isaac",18,9,3,9,1,0,0,5
Hawthorn,"Stratton, Ben",8,6,5,2,0,0,0,5
Hawthorn,"Anderson, Jed",16,11,1,5,1,2,0,3
Hawthorn,"Bailey, Max",5,2,1,3,0,0,16,4
Hawthorn,"Birchall, Grant",28,19,4,9,1,0,0,3
Hawthorn,"Breust, Luke",13,6,2,7,3,0,0,3
Hawthorn,"Burgoyne, Shaun",23,14,5,9,3,0,0,7
Hawthorn,"Duryea, Taylor",15,10,3,5,0,1,0,2
Hawthorn,"Franklin, Lance",21,13,5,8,4,1,0,4
Hawthorn,"Gibson, Josh",20,9,6,11,0,0,0,2
Hawthorn,"Guerra, Brent",13,9,4,4,0,0,0,2
Hawthorn,"Gunston, Jack",5,2,0,3,0,0,0,1
Hawthorn,"Hale, David",10,2,2,8,1,0,16,1
Hawthorn,"Hill, Bradley",13,10,2,3,2,0,0,1
Hawthorn,"Hodge, Luke",31,21,4,10,2,1,0,6
Hawthorn,"Lewis, Jordan",17,8,4,9,1,0,1,4
Hawthorn,"Mitchell, Sam",27,15,1,12,0,0,1,6
Hawthorn,"Puopolo, Paul",10,6,1,4,1,0,0,7
Hawthorn,"Rioli, Cyril",24,17,4,7,0,3,0,5
Hawthorn,"Roughead, Jarryd",10,6,2,4,3,1,9,2
Hawthorn,"Schoenmakers, Ryan",10,7,2,3,0,0,0,1
Hawthorn,"Shiels, Liam",28,20,3,8,0,1,0,5
Hawthorn,"Smith, Isaac",20,8,2,12,0,0,0,4
Hawthorn,"Stratton, Ben",13,9,9,4,0,0,0,2
Hawthorn,"Bailey, Max",12,5,3,7,0,0,33,4
Hawthorn,"Birchall, Grant",37,23,12,14,1,0,0,3
Hawthorn,"Breust, Luke",21,10,5,11,2,0,0,5
Hawthorn,"Burgoyne, Shaun",28,16,6,12,2,1,0,3
Hawthorn,"Duryea, Taylor",17,13,7,4,0,0,0,1
Hawthorn,"Franklin, Lance",20,9,8,11,4,1,1,3
Hawthorn,"Gibson, Josh",16,7,4,9,0,0,0,2
Hawthorn,"Gunston, Jack",14,10,8,4,1,0,0,2
Hawthorn,"Hale, David",13,5,7,8,0,1,13,1
Hawthorn,"Hill, Bradley",11,3,0,8,0,0,0,3
Hawthorn,"Hodge, Luke",15,9,1,6,0,1,0,4
Hawthorn,"Lewis, Jordan",20,10,7,10,1,1,0,1
Hawthorn,"Mitchell, Sam",25,14,5,11,0,0,0,3
Hawthorn,"Osborne, Michael",10,8,3,2,0,0,0,2
Hawthorn,"Puopolo, Paul",15,8,4,7,0,1,0,3
Hawthorn,"Rioli, Cyril",17,9,3,8,3,0,1,7
Hawthorn,"Roughead, Jarryd",21,13,8,8,4,2,0,3
Hawthorn,"Savage, Shane",9,8,4,1,0,0,0,2
Hawthorn,"Schoenmakers, Ryan",5,2,2,3,0,0,0,0
Hawthorn,"Shiels, Liam",23,13,4,10,0,0,0,4
Hawthorn,"Smith, Isaac",23,16,10,7,0,1,0,5
Hawthorn,"Stratton, Ben",15,10,5,5,0,0,0,6
Hawthorn,"Bailey, Max",11,9,2,2,3,0,3,4
Hawthorn,"Birchall, Grant",19,9,8,10,0,0,0,3
Hawthorn,"Breust, Luke",12,8,3,4,0,2,0,5
Hawthorn,"Burgoyne, Shaun",20,11,4,9,1,0,0,8
Hawthorn,"Franklin, Lance",12,10,5,2,0,5,0,4
Hawthorn,"Gibson, Josh",13,6,6,7,0,0,0,1
Hawthorn,"Guerra, Brent",19,14,3,5,0,0,0,3
Hawthorn,"Gunston, Jack",18,9,7,9,1,0,0,0
Hawthorn,"Hale, David",9,5,3,4,0,3,17,2
Hawthorn,"Hill, Bradley",21,16,7,5,1,1,0,3
Hawthorn,"Hodge, Luke",16,10,6,6,0,0,0,0
Hawthorn,"Lake, Brian",11,7,3,4,0,0,0,0
Hawthorn,"Lewis, Jordan",25,17,7,8,0,2,0,2
Hawthorn,"Mitchell, Sam",28,18,7,10,1,0,1,2
Hawthorn,"Osborne, Michael",16,11,6,5,1,0,1,2
Hawthorn,"Puopolo, Paul",7,3,1,4,0,0,0,0
Hawthorn,"Rioli, Cyril",20,13,5,7,4,0,0,2
Hawthorn,"Roughead, Jarryd",12,10,5,2,1,0,4,2
Hawthorn,"Savage, Shane",0,0,0,0,0,0,0,1
Hawthorn,"Shiels, Liam",15,6,5,9,0,0,0,3
Hawthorn,"Smith, Isaac",15,9,4,6,1,1,0,1
Hawthorn,"Stratton, Ben",11,3,2,8,0,0,0,1
Hawthorn,"Birchall, Grant",18,11,1,7,0,0,0,0
Hawthorn,"Breust, Luke",16,9,2,7,2,2,0,7
Hawthorn,"Burgoyne, Shaun",13,6,2,7,0,0,0,3
Hawthorn,"Duryea, Taylor",14,8,3,6,0,0,0,0
Hawthorn,"Franklin, Lance",17,9,2,8,0,2,0,2
Hawthorn,"Gibson, Josh",23,12,6,11,0,0,0,1
Hawthorn,"Guerra, Brent",22,11,5,11,0,0,0,1
Hawthorn,"Gunston, Jack",8,6,1,2,3,0,0,3
Hawthorn,"Hale, David",11,3,0,8,0,0,21,1
Hawthorn,"Hill, Bradley",17,10,4,7,2,0,0,2
Hawthorn,"Hodge, Luke",29,16,5,13,1,1,0,3
Hawthorn,"Lake, Brian",11,8,5,3,0,0,0,0
Hawthorn,"Lewis, Jordan",26,11,8,15,1,1,2,1
Hawthorn,"Mitchell, Sam",29,16,6,13,0,0,0,1
Hawthorn,"Osborne, Michael",7,3,2,4,1,0,1,2
Hawthorn,"Puopolo, Paul",17,7,1,10,1,1,0,3
Hawthorn,"Roughead, Jarryd",17,10,4,7,1,0,11,4
Hawthorn,"Sewell, Brad",17,6,1,11,0,0,0,4
Hawthorn,"Shiels, Liam",16,9,3,7,0,0,0,4
Hawthorn,"Simpkin, Jonathan",9,8,2,1,0,1,0,0
Hawthorn,"Smith, Isaac",17,14,8,3,1,2,0,6
Hawthorn,"Stratton, Ben",21,14,9,7,0,0,0,2
Hawthorn,"Bailey, Max",5,4,1,1,1,0,32,0
Hawthorn,"Birchall, Grant",26,16,4,10,0,1,0,0
Hawthorn,"Breust, Luke",22,11,5,11,1,2,0,5
Hawthorn,"Burgoyne, Shaun",15,12,6,3,1,0,0,1
Hawthorn,"Duryea, Taylor",17,9,6,8,0,0,0,2
Hawthorn,"Franklin, Lance",9,5,1,4,3,1,0,3
Hawthorn,"Gibson, Josh",27,16,12,11,0,0,0,1
Hawthorn,"Gunston, Jack",18,11,7,7,3,0,0,3
Hawthorn,"Hale, David",14,9,6,5,3,1,15,2
Hawthorn,"Hill, Bradley",9,7,1,2,0,0,0,1
Hawthorn,"Hodge, Luke",32,24,4,8,1,0,0,5
Hawthorn,"Lake, Brian",18,12,8,6,0,0,0,1
Hawthorn,"Lewis, Jordan",17,9,4,8,0,1,6,5
Hawthorn,"Mitchell, Sam",30,15,5,15,0,0,0,4
Hawthorn,"Osborne, Michael",11,5,3,6,1,0,0,5
Hawthorn,"Puopolo, Paul",21,9,4,12,0,0,0,7
Hawthorn,"Roughead, Jarryd",27,18,8,9,4,2,0,2
Hawthorn,"Sewell, Brad",21,10,3,11,0,0,0,8
Hawthorn,"Shiels, Liam",13,9,2,4,0,0,0,5
Hawthorn,"Simpkin, Jonathan",9,5,5,4,0,0,0,0
Hawthorn,"Smith, Isaac",16,8,4,8,0,1,0,1
Hawthorn,"Stratton, Ben",23,9,10,14,0,0,0,3
Hawthorn,"Bailey, Max",11,6,0,5,1,0,29,2
Hawthorn,"Birchall, Grant",14,7,1,7,0,0,0,1
Hawthorn,"Breust, Luke",13,4,1,9,0,0,0,2
Hawthorn,"Burgoyne, Shaun",23,13,6,10,2,1,1,3
Hawthorn,"Duryea, Taylor",17,8,4,9,0,0,0,4
Hawthorn,"Franklin, Lance",17,12,6,5,2,2,0,1
Hawthorn,"Guerra, Brent",21,7,6,14,0,0,0,1
Hawthorn,"Gunston, Jack",20,13,10,7,3,1,0,3
Hawthorn,"Hale, David",17,7,4,10,1,1,20,3
Hawthorn,"Hodge, Luke",18,15,4,3,1,1,0,4
Hawthorn,"Lake, Brian",17,12,9,5,0,1,0,4
Hawthorn,"Lewis, Jordan",27,13,4,14,1,0,1,4
Hawthorn,"Mitchell, Sam",35,15,0,20,1,1,0,3
Hawthorn,"Osborne, Michael",5,2,1,3,0,0,0,2
Hawthorn,"Puopolo, Paul",12,5,3,7,1,0,0,1
Hawthorn,"Roughead, Jarryd",22,15,6,7,5,2,0,2
Hawthorn,"Sewell, Brad",22,11,2,11,1,0,0,3
Hawthorn,"Shiels, Liam",19,11,5,8,1,1,0,6
Hawthorn,"Simpkin, Jonathan",23,9,2,14,0,1,0,1
Hawthorn,"Smith, Isaac",19,10,4,9,1,0,1,2
Hawthorn,"Spangher, Matthew",17,10,6,7,0,0,0,3
Hawthorn,"Stratton, Ben",18,8,2,10,0,1,0,1
Hawthorn,"Bailey, Max",15,6,4,9,1,0,33,4
Hawthorn,"Breust, Luke",15,6,3,9,1,0,0,3
Hawthorn,"Burgoyne, Shaun",22,8,0,14,3,0,0,3
Hawthorn,"Cheney, Kyle",11,7,3,4,0,0,0,5
Hawthorn,"Duryea, Taylor",2,2,2,0,0,0,0,1
Hawthorn,"Franklin, Lance",21,14,6,7,5,2,0,2
Hawthorn,"Gibson, Josh",27,15,6,12,0,0,0,3
Hawthorn,"Grimley, Sam",14,7,7,7,1,0,11,2
Hawthorn,"Guerra, Brent",16,7,3,9,0,0,0,2
Hawthorn,"Gunston, Jack",24,12,11,12,1,1,0,4
Hawthorn,"Hill, Bradley",21,14,2,7,0,0,0,5
Hawthorn,"Hodge, Luke",24,17,2,7,1,1,0,3
Hawthorn,"Lake, Brian",14,9,7,5,0,0,0,1
Hawthorn,"Lewis, Jordan",31,13,9,18,0,0,7,3
Hawthorn,"Mitchell, Sam",36,16,2,20,1,0,0,2
Hawthorn,"Puopolo, Paul",16,5,3,11,1,0,0,3
Hawthorn,"Roughead, Jarryd",20,9,5,11,3,0,7,1
Hawthorn,"Sewell, Brad",18,9,1,9,0,0,0,6
Hawthorn,"Shiels, Liam",23,17,8,6,0,2,0,4
Hawthorn,"Simpkin, Jonathan",33,16,4,17,0,0,0,3
Hawthorn,"Smith, Isaac",23,9,4,14,0,1,1,4
Hawthorn,"Stratton, Ben",22,10,8,12,0,0,0,6
Hawthorn,"Birchall, Grant",25,13,4,12,1,0,0,0
Hawthorn,"Breust, Luke",15,10,5,5,5,3,0,3
Hawthorn,"Burgoyne, Shaun",22,11,3,11,1,0,0,2
Hawthorn,"Cheney, Kyle",6,4,1,2,0,0,0,0
Hawthorn,"Duryea, Taylor",17,12,5,5,0,0,0,3
Hawthorn,"Franklin, Lance",17,8,1,9,2,3,0,1
Hawthorn,"Gibson, Josh",13,4,4,9,0,0,0,0
Hawthorn,"Grimley, Sam",15,6,4,9,1,1,9,0
Hawthorn,"Guerra, Brent",20,9,2,11,0,0,0,0
Hawthorn,"Hale, David",17,5,5,12,0,1,24,5
Hawthorn,"Hill, Bradley",20,11,3,9,2,0,0,1
Hawthorn,"Hodge, Luke",18,10,1,8,0,1,1,2
Hawthorn,"Lake, Brian",20,10,10,10,0,0,0,4
Hawthorn,"Lewis, Jordan",29,19,3,10,1,1,8,3
Hawthorn,"Mitchell, Sam",24,8,0,16,0,0,0,3
Hawthorn,"Puopolo, Paul",25,14,1,11,2,0,0,3
Hawthorn,"Roughead, Jarryd",12,6,4,6,3,1,1,7
Hawthorn,"Sewell, Brad",31,17,3,14,0,0,0,6
Hawthorn,"Shiels, Liam",13,7,3,6,0,0,0,1
Hawthorn,"Simpkin, Jonathan",25,17,5,8,1,1,0,1
Hawthorn,"Smith, Isaac",19,11,4,8,2,1,0,5
Hawthorn,"Stratton, Ben",16,6,5,10,0,0,0,2
Hawthorn,"Bailey, Max",5,3,0,2,0,0,25,3
Hawthorn,"Birchall, Grant",23,14,1,9,0,0,0,1
Hawthorn,"Breust, Luke",8,4,2,4,0,1,0,6
Hawthorn,"Burgoyne, Shaun",13,5,1,8,0,1,0,2
Hawthorn,"Duryea, Taylor",12,8,2,4,0,0,0,1
Hawthorn,"Franklin, Lance",14,10,6,4,4,2,0,3
Hawthorn,"Gibson, Josh",18,6,4,12,0,0,0,2
Hawthorn,"Guerra, Brent",11,6,3,5,0,0,0,0
Hawthorn,"Gunston, Jack",14,7,5,7,3,0,0,6
Hawthorn,"Hale, David",11,3,2,8,1,0,17,4
Hawthorn,"Hill, Bradley",16,13,4,3,1,0,0,1
Hawthorn,"Hodge, Luke",15,10,4,5,1,0,1,2
Hawthorn,"Lake, Brian",19,11,8,8,0,0,0,1
Hawthorn,"Lewis, Jordan",14,8,2,6,0,0,3,3
Hawthorn,"Mitchell, Sam",24,15,4,9,1,2,0,3
Hawthorn,"Puopolo, Paul",17,10,1,7,0,2,0,4
Hawthorn,"Roughead, Jarryd",13,9,3,4,4,0,5,3
Hawthorn,"Sewell, Brad",17,12,1,5,0,0,0,4
Hawthorn,"Shiels, Liam",13,9,2,4,0,0,0,4
Hawthorn,"Simpkin, Jonathan",9,4,1,5,0,0,0,0
Hawthorn,"Smith, Isaac",11,6,3,5,0,1,0,1
Hawthorn,"Stratton, Ben",18,10,3,8,0,0,0,1
Hawthorn,"Bailey, Max",14,9,5,5,0,0,18,4
Hawthorn,"Birchall, Grant",9,4,2,5,0,0,0,1
Hawthorn,"Breust, Luke",15,7,2,8,3,0,0,3
Hawthorn,"Burgoyne, Shaun",17,9,2,8,0,0,0,2
Hawthorn,"Duryea, Taylor",12,8,2,4,0,0,0,1
Hawthorn,"Ellis, Xavier",5,4,1,1,0,1,0,2
Hawthorn,"Franklin, Lance",12,9,2,3,2,3,0,6
Hawthorn,"Gibson, Josh",13,5,2,8,0,0,0,3
Hawthorn,"Guerra, Brent",12,6,2,6,0,0,0,7
Hawthorn,"Gunston, Jack",17,11,4,6,5,1,0,2
Hawthorn,"Hale, David",9,4,1,5,0,1,7,1
Hawthorn,"Hill, Bradley",15,11,2,4,0,1,0,2
Hawthorn,"Hodge, Luke",25,18,7,7,0,0,1,4
Hawthorn,"Lake, Brian",15,8,8,7,0,0,0,5
Hawthorn,"Lewis, Jordan",24,10,5,14,1,0,6,3
Hawthorn,"Mitchell, Sam",24,9,2,15,0,0,0,2
Hawthorn,"Roughead, Jarryd",20,13,6,7,5,1,0,2
Hawthorn,"Savage, Shane",16,11,4,5,2,0,0,5
Hawthorn,"Sewell, Brad",11,8,1,3,0,0,0,5
Hawthorn,"Shiels, Liam",17,13,1,4,0,0,0,4
Hawthorn,"Simpkin, Jonathan",15,9,3,6,1,1,0,7
Hawthorn,"Stratton, Ben",17,11,4,6,0,0,0,4
Hawthorn,"Breust, Luke",18,9,3,9,3,1,0,5
Hawthorn,"Burgoyne, Shaun",13,6,0,7,0,0,0,2
Hawthorn,"Ceglar, Jonathon",9,7,2,2,0,1,22,3
Hawthorn,"Duryea, Taylor",16,13,3,3,0,0,0,4
Hawthorn,"Ellis, Xavier",7,5,2,2,0,1,0,2
Hawthorn,"Franklin, Lance",17,13,4,4,4,2,0,3
Hawthorn,"Gibson, Josh",12,6,0,6,0,0,0,3
Hawthorn,"Gunston, Jack",19,11,3,8,1,1,0,2
Hawthorn,"Hale, David",7,4,3,3,1,1,15,3
Hawthorn,"Hill, Bradley",15,11,3,4,1,0,0,6
Hawthorn,"Hodge, Luke",21,18,7,3,0,1,0,1
Hawthorn,"Lake, Brian",14,6,6,8,0,0,0,0
Hawthorn,"Lewis, Jordan",16,8,2,8,1,0,2,2
Hawthorn,"Mitchell, Sam",26,18,4,8,0,1,0,4
Hawthorn,"Roughead, Jarryd",18,13,8,5,4,1,1,4
Hawthorn,"Savage, Shane",21,12,5,9,3,1,0,2
Hawthorn,"Sewell, Brad",27,16,6,11,0,1,0,5
Hawthorn,"Shiels, Liam",12,7,2,5,1,0,0,1
Hawthorn,"Simpkin, Jonathan",18,9,2,9,1,0,0,4
Hawthorn,"Smith, Isaac",21,16,2,5,1,3,0,8
Hawthorn,"Stratton, Ben",10,6,3,4,0,0,0,2
Hawthorn,"Whitecross, Brendan",10,8,5,2,0,0,0,3
Hawthorn,"Bailey, Max",6,2,2,4,0,0,10,0
Hawthorn,"Breust, Luke",15,8,2,7,1,2,0,5
Hawthorn,"Burgoyne, Shaun",14,11,3,3,0,0,0,5
Hawthorn,"Duryea, Taylor",10,9,1,1,0,0,0,7
Hawthorn,"Franklin, Lance",14,9,3,5,1,2,0,1
Hawthorn,"Gibson, Josh",13,4,0,9,0,0,0,1
Hawthorn,"Gunston, Jack",22,14,7,8,1,0,1,4
Hawthorn,"Hale, David",19,10,4,9,2,1,20,1
Hawthorn,"Hill, Bradley",18,13,1,5,0,0,0,2
Hawthorn,"Hodge, Luke",16,13,5,3,0,2,1,3
Hawthorn,"Lake, Brian",17,13,10,4,0,0,0,0
Hawthorn,"Lewis, Jordan",21,11,3,10,0,0,3,4
Hawthorn,"Mitchell, Sam",36,24,6,12,0,0,0,4
Hawthorn,"Puopolo, Paul",14,6,1,8,1,0,0,3
Hawthorn,"Rioli, Cyril",9,5,2,4,0,0,0,1
Hawthorn,"Roughead, Jarryd",17,10,3,7,2,2,3,2
Hawthorn,"Savage, Shane",9,5,1,4,1,0,0,6
Hawthorn,"Sewell, Brad",12,8,2,4,0,1,0,7
Hawthorn,"Simpkin, Jonathan",17,7,3,10,1,0,0,3
Hawthorn,"Smith, Isaac",19,11,2,8,0,0,1,3
Hawthorn,"Stratton, Ben",11,5,5,6,0,0,0,1
Hawthorn,"Whitecross, Brendan",19,16,9,3,0,0,0,1
Hawthorn,"Bailey, Max",2,1,1,1,0,0,29,7
Hawthorn,"Breust, Luke",14,8,7,6,0,2,0,5
Hawthorn,"Burgoyne, Shaun",18,8,3,10,0,0,0,5
Hawthorn,"Cheney, Kyle",16,10,5,6,0,0,0,2
Hawthorn,"Duryea, Taylor",18,14,5,4,0,0,0,2
Hawthorn,"Gibson, Josh",18,11,5,7,0,0,0,1
Hawthorn,"Guerra, Brent",20,11,2,9,0,0,0,4
Hawthorn,"Gunston, Jack",14,12,8,2,5,1,0,1
Hawthorn,"Hale, David",6,1,1,5,0,1,7,4
Hawthorn,"Hill, Bradley",21,9,0,12,0,1,0,1
Hawthorn,"Hodge, Luke",26,20,4,6,1,0,2,4
Hawthorn,"Lake, Brian",16,9,8,7,0,0,0,3
Hawthorn,"Lewis, Jordan",23,10,2,13,1,0,8,7
Hawthorn,"Mitchell, Sam",24,11,2,13,0,0,1,0
Hawthorn,"Puopolo, Paul",16,12,0,4,0,0,0,2
Hawthorn,"Rioli, Cyril",14,6,3,8,1,1,0,3
Hawthorn,"Roughead, Jarryd",12,10,7,2,5,2,0,2
Hawthorn,"Savage, Shane",16,13,7,3,3,0,0,6
Hawthorn,"Simpkin, Jonathan",16,10,5,6,0,1,0,4
Hawthorn,"Smith, Isaac",26,18,8,8,3,0,0,9
Hawthorn,"Stratton, Ben",5,3,1,2,0,0,0,4
Hawthorn,"Whitecross, Brendan",19,9,4,10,0,0,0,1
Hawthorn,"Bailey, Max",6,1,4,5,0,0,20,3
Hawthorn,"Breust, Luke",15,10,3,5,1,1,1,1
Hawthorn,"Cheney, Kyle",20,9,5,11,0,1,0,2
Hawthorn,"Duryea, Taylor",13,11,5,2,0,0,0,5
Hawthorn,"Gibson, Josh",19,8,5,11,0,0,0,3
Hawthorn,"Guerra, Brent",13,11,3,2,0,1,0,1
Hawthorn,"Gunston, Jack",19,14,9,5,0,3,0,2
Hawthorn,"Hale, David",18,10,8,8,0,2,17,4
Hawthorn,"Hill, Bradley",24,15,7,9,0,0,0,1
Hawthorn,"Hodge, Luke",18,14,4,4,2,0,0,7
Hawthorn,"Lake, Brian",13,8,3,5,0,0,0,2
Hawthorn,"Langford, Will",4,3,1,1,0,1,0,3
Hawthorn,"Lewis, Jordan",25,13,5,12,2,0,2,3
Hawthorn,"Puopolo, Paul",14,7,1,7,1,0,0,5
Hawthorn,"Rioli, Cyril",7,7,5,0,1,0,0,9
Hawthorn,"Roughead, Jarryd",13,10,4,3,3,3,0,4
Hawthorn,"Savage, Shane",18,12,3,6,0,0,0,4
Hawthorn,"Sewell, Brad",24,10,3,14,0,0,0,6
Hawthorn,"Simpkin, Jonathan",8,6,1,2,2,0,0,1
Hawthorn,"Smith, Isaac",27,17,8,10,0,1,1,3
Hawthorn,"Stratton, Ben",17,6,7,11,0,0,0,3
Hawthorn,"Whitecross, Brendan",10,7,3,3,1,1,3,1
Hawthorn,"Bailey, Max",12,6,2,6,0,0,23,2
Hawthorn,"Breust, Luke",14,8,6,6,2,1,0,2
Hawthorn,"Duryea, Taylor",10,6,4,4,0,0,0,0
Hawthorn,"Franklin, Lance",19,14,6,5,8,3,0,1
Hawthorn,"Gibson, Josh",25,6,4,19,0,0,0,0
Hawthorn,"Guerra, Brent",27,20,9,7,0,0,0,1
Hawthorn,"Gunston, Jack",16,12,5,4,2,2,0,3
Hawthorn,"Hale, David",15,6,6,9,1,1,15,3
Hawthorn,"Hill, Bradley",22,7,3,15,0,0,0,1
Hawthorn,"Hodge, Luke",30,20,12,10,0,1,0,2
Hawthorn,"Lake, Brian",17,11,9,6,0,0,0,3
Hawthorn,"Lewis, Jordan",21,15,8,6,2,1,3,5
Hawthorn,"Mitchell, Sam",31,21,7,10,0,1,0,1
Hawthorn,"Puopolo, Paul",23,12,2,11,2,0,0,10
Hawthorn,"Rioli, Cyril",14,9,3,5,1,0,0,5
Hawthorn,"Roughead, Jarryd",16,8,4,8,4,0,0,1
Hawthorn,"Savage, Shane",23,19,8,4,0,0,0,3
Hawthorn,"Sewell, Brad",25,15,3,10,0,1,0,4
Hawthorn,"Simpkin, Jonathan",20,10,7,10,0,0,0,2
Hawthorn,"Smith, Isaac",23,13,8,10,0,0,0,0
Hawthorn,"Stratton, Ben",17,9,5,8,0,0,0,2
Hawthorn,"Whitecross, Brendan",18,10,10,8,0,0,0,2
Hawthorn,"Breust, Luke",11,4,4,7,0,0,1,4
Hawthorn,"Burgoyne, Shaun",19,14,4,5,1,1,0,7
Hawthorn,"Ceglar, Jonathon",2,1,1,1,1,0,5,0
Hawthorn,"Duryea, Taylor",13,6,5,7,0,0,0,3
Hawthorn,"Franklin, Lance",11,8,3,3,1,2,0,2
Hawthorn,"Gibson, Josh",15,11,5,4,0,0,0,6
Hawthorn,"Guerra, Brent",17,13,5,4,1,0,0,3
Hawthorn,"Gunston, Jack",8,7,4,1,0,2,0,0
Hawthorn,"Hale, David",13,7,3,6,0,2,29,3
Hawthorn,"Hill, Bradley",12,4,0,8,0,0,0,1
Hawthorn,"Hodge, Luke",17,10,6,7,1,0,0,5
Hawthorn,"Lake, Brian",19,9,10,10,0,0,0,3
Hawthorn,"Lewis, Jordan",17,8,5,9,1,0,3,3
Hawthorn,"Mitchell, Sam",26,19,6,7,0,0,0,5
Hawthorn,"Puopolo, Paul",18,9,3,9,2,0,0,7
Hawthorn,"Rioli, Cyril",7,6,2,1,0,1,0,5
Hawthorn,"Roughead, Jarryd",15,9,2,6,0,2,3,6
Hawthorn,"Savage, Shane",21,17,6,4,0,1,2,3
Hawthorn,"Sewell, Brad",18,6,2,12,0,0,0,5
Hawthorn,"Smith, Isaac",29,17,4,12,1,0,0,4
Hawthorn,"Stratton, Ben",12,6,6,6,0,0,0,5
Hawthorn,"Whitecross, Brendan",12,6,4,6,0,0,0,1
Hawthorn,"Breust, Luke",18,8,5,10,1,1,0,7
Hawthorn,"Burgoyne, Shaun",29,17,7,12,0,0,0,3
Hawthorn,"Duryea, Taylor",21,10,8,11,0,1,0,2
Hawthorn,"Gibson, Josh",26,10,8,16,0,0,0,0
Hawthorn,"Grimley, Sam",10,8,5,2,1,1,4,0
Hawthorn,"Guerra, Brent",21,18,11,3,0,0,0,3
Hawthorn,"Gunston, Jack",12,7,4,5,2,0,0,0
Hawthorn,"Hale, David",15,3,1,12,0,1,27,2
Hawthorn,"Hill, Bradley",12,7,2,5,1,0,0,1
Hawthorn,"Lake, Brian",13,8,9,5,0,0,0,2
Hawthorn,"Lewis, Jordan",23,15,5,8,1,1,2,3
Hawthorn,"Mitchell, Sam",24,16,1,8,0,0,0,3
Hawthorn,"Puopolo, Paul",20,12,5,8,0,1,0,3
Hawthorn,"Rioli, Cyril",18,7,4,11,0,2,0,1
Hawthorn,"Roughead, Jarryd",14,10,4,4,5,0,0,3
Hawthorn,"Savage, Shane",30,22,9,8,0,1,0,1
Hawthorn,"Sewell, Brad",18,9,4,9,1,0,0,6
Hawthorn,"Simpkin, Jonathan",19,9,7,10,0,0,0,5
Hawthorn,"Smith, Isaac",23,15,3,8,1,1,1,4
Hawthorn,"Spangher, Matthew",11,7,6,4,1,3,0,1
Hawthorn,"Stratton, Ben",17,9,7,8,0,0,0,2
Hawthorn,"Whitecross, Brendan",21,12,7,9,0,0,0,3
Hawthorn,"Bailey, Max",8,5,3,3,0,1,14,4
Hawthorn,"Birchall, Grant",26,12,1,14,0,0,0,2
Hawthorn,"Breust, Luke",16,7,4,9,1,2,0,5
Hawthorn,"Burgoyne, Shaun",14,8,1,6,0,0,0,4
Hawthorn,"Duryea, Taylor",8,6,3,2,0,1,0,6
Hawthorn,"Franklin, Lance",20,11,5,9,4,0,0,1
Hawthorn,"Gibson, Josh",21,8,3,13,0,0,0,2
Hawthorn,"Gunston, Jack",15,10,2,5,2,0,0,4
Hawthorn,"Hale, David",15,9,5,6,1,3,19,4
Hawthorn,"Hill, Bradley",11,7,2,4,1,0,0,3
Hawthorn,"Hodge, Luke",28,22,8,6,0,0,0,3
Hawthorn,"Lake, Brian",10,5,3,5,0,0,0,3
Hawthorn,"Lewis, Jordan",23,10,5,13,1,0,2,3
Hawthorn,"Mitchell, Sam",24,14,2,10,0,0,0,4
Hawthorn,"Puopolo, Paul",22,9,3,13,1,1,1,6
Hawthorn,"Rioli, Cyril",12,7,3,5,1,0,0,5
Hawthorn,"Roughead, Jarryd",13,7,0,6,1,1,1,1
Hawthorn,"Savage, Shane",6,3,1,3,0,0,0,4
Hawthorn,"Sewell, Brad",27,9,2,18,0,0,0,4
Hawthorn,"Smith, Isaac",21,12,5,9,3,0,0,0
Hawthorn,"Stratton, Ben",16,10,3,6,0,0,0,2
Hawthorn,"Whitecross, Brendan",17,13,8,4,2,0,0,2
Hawthorn,"Anderson, Jed",16,6,2,10,0,0,0,3
Hawthorn,"Bailey, Max",8,5,3,3,0,0,22,1
Hawthorn,"Birchall, Grant",16,9,2,7,0,0,0,3
Hawthorn,"Breust, Luke",12,7,5,5,3,0,0,5
Hawthorn,"Burgoyne, Shaun",20,12,6,8,0,1,0,4
Hawthorn,"Franklin, Lance",14,9,3,5,5,1,0,1
Hawthorn,"Gibson, Josh",8,5,1,3,0,0,0,3
Hawthorn,"Guerra, Brent",22,11,6,11,0,1,0,1
Hawthorn,"Gunston, Jack",13,7,4,6,0,0,0,5
Hawthorn,"Hale, David",10,3,2,7,1,2,15,3
Hawthorn,"Hill, Bradley",12,7,2,5,1,0,0,4
Hawthorn,"Hodge, Luke",21,15,8,6,0,0,0,3
Hawthorn,"Lake, Brian",18,12,10,6,0,0,0,1
Hawthorn,"Mitchell, Sam",27,14,4,13,0,0,0,4
Hawthorn,"Rioli, Cyril",16,9,3,7,2,1,0,4
Hawthorn,"Roughead, Jarryd",16,14,5,2,4,2,0,1
Hawthorn,"Savage, Shane",15,12,6,3,0,0,0,4
Hawthorn,"Sewell, Brad",14,10,1,4,0,2,0,4
Hawthorn,"Shiels, Liam",1,0,0,1,0,0,0,0
Hawthorn,"Smith, Isaac",22,12,5,10,1,1,2,5
Hawthorn,"Stratton, Ben",14,8,5,6,0,0,0,3
Hawthorn,"Whitecross, Brendan",11,4,4,7,0,0,0,3
Hawthorn,"Anderson, Jed",3,2,0,1,1,0,0,2
Hawthorn,"Birchall, Grant",25,15,4,10,1,0,0,2
Hawthorn,"Breust, Luke",12,6,4,6,2,1,0,3
Hawthorn,"Burgoyne, Shaun",27,12,3,15,0,0,0,5
Hawthorn,"Duryea, Taylor",11,7,4,4,0,0,0,1
Hawthorn,"Franklin, Lance",12,9,2,3,2,1,0,1
Hawthorn,"Gibson, Josh",18,7,4,11,0,0,0,2
Hawthorn,"Gunston, Jack",18,11,7,7,2,0,0,3
Hawthorn,"Hale, David",20,9,4,11,1,1,24,1
Hawthorn,"Hill, Bradley",20,16,6,4,0,0,0,1
Hawthorn,"Hodge, Luke",16,9,1,7,0,0,0,9
Hawthorn,"Lake, Brian",14,8,9,6,1,0,0,3
Hawthorn,"Lewis, Jordan",21,16,4,5,1,0,3,10
Hawthorn,"Mitchell, Sam",26,12,1,14,1,0,0,3
Hawthorn,"Puopolo, Paul",24,10,3,14,1,0,0,4
Hawthorn,"Roughead, Jarryd",19,11,6,8,4,3,1,1
Hawthorn,"Savage, Shane",5,3,3,2,0,0,0,2
Hawthorn,"Sewell, Brad",27,9,5,18,0,0,0,5
Hawthorn,"Smith, Isaac",15,10,2,5,0,1,0,6
Hawthorn,"Spangher, Matthew",15,9,4,6,0,1,5,3
Hawthorn,"Stratton, Ben",12,4,2,8,0,0,0,1
Hawthorn,"Whitecross, Brendan",17,10,3,7,0,0,0,3
Hawthorn,"Anderson, Jed",6,5,3,1,1,1,0,2
Hawthorn,"Bailey, Max",7,4,2,3,1,0,16,1
Hawthorn,"Birchall, Grant",26,14,6,12,0,1,0,1
Hawthorn,"Breust, Luke",13,8,4,5,1,2,0,7
Hawthorn,"Burgoyne, Shaun",26,12,3,14,0,0,0,3
Hawthorn,"Gibson, Josh",27,13,9,14,0,0,0,3
Hawthorn,"Guerra, Brent",27,21,10,6,0,0,0,4
Hawthorn,"Gunston, Jack",16,13,10,3,3,1,0,3
Hawthorn,"Hale, David",16,8,6,8,2,0,14,4
Hawthorn,"Hill, Bradley",17,10,7,7,1,1,0,3
Hawthorn,"Hodge, Luke",24,17,8,7,0,1,0,3
Hawthorn,"Lake, Brian",15,10,7,5,1,0,0,1
Hawthorn,"Lewis, Jordan",19,10,3,9,0,0,0,3
Hawthorn,"Mitchell, Sam",29,15,3,14,0,0,0,2
Hawthorn,"Puopolo, Paul",20,9,0,11,1,0,0,5
Hawthorn,"Roughead, Jarryd",14,9,5,5,2,2,4,1
Hawthorn,"Sewell, Brad",30,15,1,15,0,0,0,4
Hawthorn,"Shiels, Liam",14,9,6,5,1,1,0,1
Hawthorn,"Smith, Isaac",13,7,2,6,0,0,0,0
Hawthorn,"Spangher, Matthew",11,6,3,5,1,0,1,2
Hawthorn,"Stratton, Ben",16,9,7,7,0,0,0,2
Hawthorn,"Whitecross, Brendan",21,13,9,8,0,0,0,5
Hawthorn,"Bailey, Max",11,7,2,4,0,0,18,2
Hawthorn,"Birchall, Grant",27,16,7,11,0,0,0,0
Hawthorn,"Breust, Luke",16,11,5,5,1,3,0,4
Hawthorn,"Burgoyne, Shaun",24,16,7,8,3,0,0,6
Hawthorn,"Franklin, Lance",16,10,4,6,1,0,0,2
Hawthorn,"Gibson, Josh",17,11,7,6,0,0,0,4
Hawthorn,"Guerra, Brent",25,23,10,2,1,0,0,2
Hawthorn,"Gunston, Jack",21,12,5,9,4,2,0,2
Hawthorn,"Hale, David",15,8,7,7,2,2,18,4
Hawthorn,"Hill, Bradley",18,14,3,4,2,1,0,0
Hawthorn,"Hodge, Luke",15,12,5,3,0,0,3,2
Hawthorn,"Lake, Brian",15,7,6,8,0,0,0,1
Hawthorn,"Lewis, Jordan",14,9,5,5,0,1,2,9
Hawthorn,"Mitchell, Sam",38,22,5,16,0,0,0,2
Hawthorn,"Puopolo, Paul",18,10,4,8,0,0,0,7
Hawthorn,"Rioli, Cyril",16,9,4,7,0,2,0,3
Hawthorn,"Roughead, Jarryd",11,5,1,6,0,1,1,1
Hawthorn,"Sewell, Brad",16,6,2,10,0,0,0,4
Hawthorn,"Shiels, Liam",15,8,4,7,0,1,0,2
Hawthorn,"Smith, Isaac",18,14,5,4,0,0,1,0
Hawthorn,"Stratton, Ben",11,5,3,6,0,0,0,4
Hawthorn,"Whitecross, Brendan",6,4,1,2,0,0,0,1
Hawthorn,"Bailey, Max",7,2,1,5,0,0,9,3
Hawthorn,"Birchall, Grant",26,16,11,10,0,0,0,0
Hawthorn,"Breust, Luke",13,8,4,5,1,0,0,6
Hawthorn,"Burgoyne, Shaun",14,7,1,7,0,1,0,4
Hawthorn,"Franklin, Lance",18,9,6,9,1,1,0,4
Hawthorn,"Gibson, Josh",19,16,9,3,0,0,0,0
Hawthorn,"Guerra, Brent",9,9,5,0,0,0,0,4
Hawthorn,"Gunston, Jack",16,13,6,3,4,1,0,2
Hawthorn,"Hale, David",12,6,7,6,0,0,11,2
Hawthorn,"Hill, Bradley",15,10,4,5,1,0,0,3
Hawthorn,"Hodge, Luke",21,17,3,4,0,0,0,2
Hawthorn,"Lake, Brian",22,16,10,6,0,0,0,1
Hawthorn,"Lewis, Jordan",26,14,8,12,0,0,4,4
Hawthorn,"Mitchell, Sam",12,8,0,4,0,0,0,7
Hawthorn,"Puopolo, Paul",10,7,1,3,0,0,0,6
Hawthorn,"Rioli, Cyril",15,8,3,7,1,2,0,7
Hawthorn,"Roughead, Jarryd",20,14,4,6,2,3,2,1
Hawthorn,"Sewell, Brad",13,8,4,5,0,1,1,7
Hawthorn,"Shiels, Liam",11,8,4,3,0,0,0,9
Hawthorn,"Simpkin, Jonathan",6,4,2,2,0,0,0,0
Hawthorn,"Smith, Isaac",18,13,6,5,1,1,0,3
Hawthorn,"Stratton, Ben",14,8,4,6,0,0,0,5
Melbourne,"Blease, Sam",8,7,2,1,0,0,0,0
Melbourne,"Byrnes, Shannon",14,8,2,6,1,0,0,4
Melbourne,"Clark, Mitch",4,3,2,1,2,0,0,3
Melbourne,"Dunn, Lynden",14,10,3,4,0,0,2,4
Melbourne,"Frawley, James",14,12,7,2,0,0,0,2
Melbourne,"Garland, Colin",17,10,6,7,0,0,0,3
Melbourne,"Gillies, Tom",9,6,4,3,0,0,0,0
Melbourne,"Grimes, Jack",25,10,3,15,0,0,0,4
Melbourne,"Howe, Jeremy",11,6,4,5,2,1,0,3
Melbourne,"Jamar, Mark",14,4,4,10,0,0,35,1
Melbourne,"Jones, Matt",22,9,5,13,0,0,0,2
Melbourne,"Jones, Nathan",21,10,1,11,0,0,0,2
Melbourne,"McKenzie, Jordie",20,9,2,11,1,0,0,4
Melbourne,"Nicholson, Daniel",10,10,5,0,0,0,0,4
Melbourne,"Pedersen, Cameron",10,5,4,5,1,0,0,3
Melbourne,"Rodan, David",12,7,3,5,0,0,0,3
Melbourne,"Sellar, James",6,3,1,3,0,0,4,2
Melbourne,"Sylvia, Colin",20,11,6,9,0,1,0,3
Melbourne,"Tapscott, Luke",7,6,2,1,0,0,0,2
Melbourne,"Toumpas, Jimmy",9,6,3,3,0,1,0,2
Melbourne,"Viney, Jack",22,16,4,6,1,1,0,2
Melbourne,"Watts, Jack",7,2,0,5,0,0,0,1
Melbourne,"Blease, Sam",7,5,0,2,0,0,0,1
Melbourne,"Byrnes, Shannon",11,5,3,6,0,0,0,2
Melbourne,"Clark, Mitch",9,5,2,4,1,0,0,0
Melbourne,"Davey, Aaron",11,10,1,1,2,0,0,1
Melbourne,"Frawley, James",21,15,8,6,0,0,0,2
Melbourne,"Garland, Colin",14,9,3,5,0,1,0,3
Melbourne,"Gillies, Tom",7,3,1,4,0,0,0,0
Melbourne,"Grimes, Jack",13,9,2,4,1,0,0,3
Melbourne,"Howe, Jeremy",23,16,14,7,0,0,1,0
Melbourne,"Jamar, Mark",8,0,3,8,0,0,26,2
Melbourne,"Jones, Matt",16,6,3,10,0,0,0,1
Melbourne,"Jones, Nathan",25,18,2,7,1,0,0,1
Melbourne,"McDonald, Tom",12,6,4,6,0,0,0,1
Melbourne,"Nicholson, Daniel",10,4,1,6,0,0,0,3
Melbourne,"Rodan, David",6,3,2,3,0,0,0,1
Melbourne,"Sellar, James",7,3,4,4,0,0,6,2
Melbourne,"Sylvia, Colin",7,5,5,2,0,1,0,1
Melbourne,"Terlich, Dean",12,9,4,3,0,0,0,2
Melbourne,"Toumpas, Jimmy",6,2,2,4,0,0,0,3
Melbourne,"Trengove, Jack",12,5,4,7,0,1,0,2
Melbourne,"Viney, Jack",14,9,4,5,0,1,0,3
Melbourne,"Watts, Jack",11,5,2,6,0,1,0,1
Melbourne,"Bail, Rohan",16,7,3,9,0,0,0,1
Melbourne,"Byrnes, Shannon",14,8,2,6,1,0,0,2
Melbourne,"Clark, Mitch",13,11,6,2,3,1,0,2
Melbourne,"Davey, Aaron",8,5,3,3,1,1,0,3
Melbourne,"Evans, Michael",14,7,2,7,1,1,0,3
Melbourne,"Frawley, James",12,7,1,5,0,0,0,0
Melbourne,"Garland, Colin",14,8,2,6,0,0,0,3
Melbourne,"Grimes, Jack",20,12,4,8,0,0,0,3
Melbourne,"Howe, Jeremy",16,8,3,8,1,0,3,2
Melbourne,"Jamar, Mark",5,1,0,4,0,0,38,6
Melbourne,"Jetta, Neville",10,5,1,5,0,1,0,4
Melbourne,"Jones, Matt",24,12,6,12,0,0,0,2
Melbourne,"Jones, Nathan",28,10,4,18,0,1,0,1
Melbourne,"McDonald, Tom",20,11,6,9,0,0,0,1
Melbourne,"Pedersen, Cameron",8,3,3,5,0,0,2,1
Melbourne,"Sellar, James",9,4,4,5,1,0,2,2
Melbourne,"Sylvia, Colin",20,16,7,4,2,0,1,3
Melbourne,"Tapscott, Luke",17,14,5,3,1,0,0,1
Melbourne,"Terlich, Dean",21,13,2,8,0,0,0,4
Melbourne,"Toumpas, Jimmy",3,1,0,2,0,0,0,2
Melbourne,"Trengove, Jack",15,9,5,6,2,0,0,5
Melbourne,"Viney, Jack",17,7,3,10,0,0,0,5
Melbourne,"Bail, Rohan",14,10,5,4,1,0,0,8
Melbourne,"Byrnes, Shannon",23,14,8,9,3,1,0,3
Melbourne,"Clark, Mitch",9,6,4,3,1,1,2,1
Melbourne,"Davey, Aaron",5,5,1,0,2,0,0,1
Melbourne,"Evans, Michael",20,15,7,5,3,1,0,3
Melbourne,"Frawley, James",17,10,4,7,0,0,0,5
Melbourne,"Garland, Colin",24,11,5,13,0,0,0,2
Melbourne,"Gawn, Max",13,3,6,10,2,0,13,2
Melbourne,"Grimes, Jack",29,17,7,12,0,1,0,7
Melbourne,"Howe, Jeremy",13,9,7,4,4,1,0,2
Melbourne,"Jamar, Mark",16,6,3,10,1,0,31,5
Melbourne,"Jetta, Neville",12,7,0,5,0,0,0,6
Melbourne,"Jones, Matt",21,9,5,12,0,0,0,7
Melbourne,"Jones, Nathan",28,16,2,12,1,0,0,3
Melbourne,"McDonald, Tom",16,8,3,8,0,0,0,2
Melbourne,"Pedersen, Cameron",8,4,4,4,2,1,3,6
Melbourne,"Sylvia, Colin",19,13,4,6,1,1,1,5
Melbourne,"Tapscott, Luke",11,8,4,3,0,1,0,1
Melbourne,"Terlich, Dean",16,12,3,4,0,1,0,2
Melbourne,"Trengove, Jack",22,15,4,7,1,1,0,10
Melbourne,"Viney, Jack",5,3,0,2,0,0,0,2
Melbourne,"Watts, Jack",19,9,1,10,0,0,0,2
Melbourne,"Bail, Rohan",15,11,2,4,1,3,0,3
Melbourne,"Blease, Sam",7,6,2,1,0,0,0,1
Melbourne,"Byrnes, Shannon",21,17,11,4,0,1,0,4
Melbourne,"Davey, Aaron",3,2,1,1,0,0,0,1
Melbourne,"Evans, Michael",16,11,4,5,0,0,0,3
Melbourne,"Frawley, James",11,10,8,1,0,0,0,2
Melbourne,"Garland, Colin",11,6,2,5,0,0,0,3
Melbourne,"Gawn, Max",12,5,2,7,2,0,11,0
Melbourne,"Grimes, Jack",19,13,3,6,0,0,0,4
Melbourne,"Howe, Jeremy",13,8,3,5,2,2,0,1
Melbourne,"Jamar, Mark",7,5,2,2,1,0,28,1
Melbourne,"Jones, Matt",17,11,4,6,0,0,0,2
Melbourne,"Jones, Nathan",15,4,0,11,1,0,0,7
Melbourne,"McDonald, Tom",15,8,3,7,0,0,0,1
Melbourne,"McKenzie, Jordie",13,4,2,9,1,0,0,2
Melbourne,"Pedersen, Cameron",9,3,3,6,1,0,3,1
Melbourne,"Rodan, David",11,5,0,6,1,0,0,4
Melbourne,"Sylvia, Colin",19,13,4,6,0,2,0,5
Melbourne,"Tapscott, Luke",11,8,3,3,2,1,0,2
Melbourne,"Terlich, Dean",24,14,6,10,0,0,0,2
Melbourne,"Trengove, Jack",17,9,1,8,0,0,1,10
Melbourne,"Watts, Jack",16,12,9,4,2,0,0,0
Melbourne,"Bail, Rohan",9,4,2,5,1,1,0,1
Melbourne,"Byrnes, Shannon",9,6,2,3,0,0,0,3
Melbourne,"Dunn, Lynden",13,11,3,2,1,0,0,6
Melbourne,"Evans, Michael",19,15,7,4,0,0,0,2
Melbourne,"Frawley, James",18,12,7,6,0,0,0,3
Melbourne,"Garland, Colin",18,11,4,7,1,0,0,3
Melbourne,"Gawn, Max",6,4,3,2,0,0,12,1
Melbourne,"Grimes, Jack",4,3,0,1,0,0,0,0
Melbourne,"Howe, Jeremy",6,4,3,2,0,1,0,3
Melbourne,"Jones, Matt",27,12,4,15,1,1,0,4
Melbourne,"Jones, Nathan",19,7,1,12,0,1,0,3
Melbourne,"Kent, Dean",3,3,0,0,1,1,0,3
Melbourne,"McDonald, Tom",17,10,5,7,0,0,0,2
Melbourne,"McKenzie, Jordie",13,4,2,9,0,0,0,7
Melbourne,"Nicholson, Daniel",17,13,6,4,0,1,0,4
Melbourne,"Spencer, Jake",8,5,2,3,0,0,18,3
Melbourne,"Strauss, James",7,4,1,3,0,0,0,2
Melbourne,"Sylvia, Colin",18,12,3,6,2,1,0,2
Melbourne,"Tapscott, Luke",12,9,3,3,1,0,0,2
Melbourne,"Terlich, Dean",12,6,3,6,0,0,0,2
Melbourne,"Trengove, Jack",6,4,2,2,0,1,0,3
Melbourne,"Viney, Jack",9,8,2,1,0,2,0,5
Melbourne,"Bail, Rohan",8,6,4,2,0,0,0,0
Melbourne,"Byrnes, Shannon",12,5,1,7,0,0,0,1
Melbourne,"Davey, Aaron",6,6,0,0,0,1,0,0
Melbourne,"Dawes, Chris",9,5,4,4,0,0,0,0
Melbourne,"Dunn, Lynden",12,10,3,2,0,0,1,2
Melbourne,"Evans, Michael",16,10,5,6,0,1,0,1
Melbourne,"Frawley, James",15,8,5,7,0,0,0,1
Melbourne,"Garland, Colin",12,6,1,6,0,0,0,4
Melbourne,"Gawn, Max",10,3,2,7,2,1,10,1
Melbourne,"Howe, Jeremy",17,12,8,5,3,3,0,1
Melbourne,"Jones, Matt",25,10,3,15,0,1,0,0
Melbourne,"Jones, Nathan",20,12,1,8,0,3,0,3
Melbourne,"Kent, Dean",4,4,3,0,0,0,0,2
Melbourne,"McKenzie, Jordie",14,6,2,8,0,0,0,3
Melbourne,"Nicholson, Daniel",21,9,7,12,0,0,0,0
Melbourne,"Sellar, James",9,6,2,3,0,0,0,4
Melbourne,"Spencer, Jake",9,4,3,5,0,1,28,0
Melbourne,"Strauss, James",13,10,3,3,1,0,0,0
Melbourne,"Sylvia, Colin",24,16,7,8,1,1,3,6
Melbourne,"Tapscott, Luke",7,6,5,1,0,0,0,1
Melbourne,"Terlich, Dean",23,13,1,10,0,0,0,3
Melbourne,"Viney, Jack",23,11,3,12,0,0,0,6
Melbourne,"Bail, Rohan",5,3,1,2,1,1,0,2
Melbourne,"Davey, Aaron",19,15,7,4,3,1,0,4
Melbourne,"Dawes, Chris",9,7,7,2,2,1,0,2
Melbourne,"Dunn, Lynden",11,8,3,3,2,0,0,3
Melbourne,"Evans, Michael",15,10,5,5,1,1,0,3
Melbourne,"Frawley, James",12,8,4,4,0,0,0,2
Melbourne,"Garland, Colin",12,10,3,2,0,0,0,6
Melbourne,"Gawn, Max",5,5,2,0,0,0,10,3
Melbourne,"Howe, Jeremy",16,12,9,4,1,0,2,0
Melbourne,"Jamar, Mark",6,3,2,3,0,0,44,4
Melbourne,"Jetta, Neville",8,5,3,3,0,0,0,3
Melbourne,"Jones, Matt",18,12,4,6,0,0,0,3
Melbourne,"Jones, Nathan",22,9,3,13,0,0,0,4
Melbourne,"Magner, James",20,10,1,10,0,1,0,6
Melbourne,"McKenzie, Jordie",12,4,0,8,0,0,0,2
Melbourne,"Nicholson, Daniel",12,7,7,5,1,0,0,0
Melbourne,"Sellar, James",11,7,3,4,0,0,0,1
Melbourne,"Strauss, James",6,5,3,1,0,0,0,1
Melbourne,"Tapscott, Luke",11,7,6,4,0,1,0,2
Melbourne,"Terlich, Dean",21,14,7,7,0,0,0,10
Melbourne,"Toumpas, Jimmy",4,2,0,2,0,0,0,3
Melbourne,"Trengove, Jack",15,7,3,8,0,0,1,4
Melbourne,"Bail, Rohan",4,3,1,1,0,1,0,0
Melbourne,"Byrnes, Shannon",8,6,4,2,0,0,0,1
Melbourne,"Davey, Aaron",18,12,4,6,0,0,0,5
Melbourne,"Dawes, Chris",8,5,3,3,0,0,0,3
Melbourne,"Dunn, Lynden",18,8,2,10,0,1,0,2
Melbourne,"Evans, Michael",13,9,4,4,0,0,0,4
Melbourne,"Frawley, James",17,11,9,6,0,0,0,1
Melbourne,"Garland, Colin",10,7,3,3,0,0,0,5
Melbourne,"Gawn, Max",5,0,1,5,0,0,13,2
Melbourne,"Howe, Jeremy",27,19,11,8,2,0,1,2
Melbourne,"Jamar, Mark",1,1,0,0,0,0,34,6
Melbourne,"Jetta, Neville",3,2,1,1,0,0,0,3
Melbourne,"Jones, Matt",20,13,9,7,1,0,0,3
Melbourne,"Jones, Nathan",20,8,2,12,0,0,0,7
Melbourne,"Magner, James",21,12,4,9,0,0,0,6
Melbourne,"McKenzie, Jordie",24,6,0,18,0,0,0,5
Melbourne,"Nicholson, Daniel",18,7,3,11,0,1,0,3
Melbourne,"Sellar, James",11,6,6,5,0,0,1,1
Melbourne,"Tapscott, Luke",8,1,1,7,0,0,0,4
Melbourne,"Terlich, Dean",17,8,3,9,0,0,0,4
Melbourne,"Trengove, Jack",20,13,6,7,2,0,1,6
Melbourne,"Watts, Jack",15,8,6,7,1,0,0,1
Melbourne,"Bail, Rohan",15,7,5,8,0,1,0,3
Melbourne,"Davey, Aaron",18,15,6,3,1,1,0,1
Melbourne,"Dawes, Chris",21,14,12,7,1,1,1,1
Melbourne,"Dunn, Lynden",10,8,4,2,0,0,0,7
Melbourne,"Evans, Michael",11,5,4,6,1,0,0,3
Melbourne,"Fitzpatrick, Jack",11,5,4,6,0,2,10,2
Melbourne,"Frawley, James",12,9,6,3,0,0,0,3
Melbourne,"Garland, Colin",17,16,6,1,0,0,0,5
Melbourne,"Howe, Jeremy",18,13,6,5,1,0,4,1
Melbourne,"Jamar, Mark",4,1,2,3,0,0,35,2
Melbourne,"Jones, Matt",7,5,3,2,0,0,0,3
Melbourne,"Jones, Nathan",28,11,0,17,0,0,0,3
Melbourne,"Kent, Dean",14,9,4,5,1,0,0,4
Melbourne,"Macdonald, Joel",14,4,6,10,0,1,0,2
Melbourne,"McKenzie, Jordie",20,6,3,14,0,0,1,7
Melbourne,"Pedersen, Cameron",14,7,5,7,0,0,0,2
Melbourne,"Rodan, David",24,10,2,14,0,1,0,11
Melbourne,"Strauss, James",11,7,4,4,0,0,0,4
Melbourne,"Tapscott, Luke",8,6,4,2,0,0,0,1
Melbourne,"Terlich, Dean",22,13,3,9,0,0,0,3
Melbourne,"Trengove, Jack",16,8,4,8,0,1,1,7
Melbourne,"Watts, Jack",14,10,8,4,1,1,0,0
Melbourne,"Blease, Sam",14,12,4,2,1,2,0,2
Melbourne,"Davey, Aaron",11,10,3,1,2,1,0,1
Melbourne,"Dawes, Chris",4,4,3,0,0,1,0,1
Melbourne,"Dunn, Lynden",20,12,3,8,0,0,0,1
Melbourne,"Evans, Michael",16,7,4,9,0,0,0,0
Melbourne,"Fitzpatrick, Jack",13,7,5,6,0,1,7,2
Melbourne,"Garland, Colin",21,16,2,5,0,0,0,3
Melbourne,"Howe, Jeremy",11,4,4,7,0,1,2,0
Melbourne,"Jamar, Mark",12,5,5,7,0,0,27,1
Melbourne,"Jones, Matt",24,11,4,13,0,0,0,1
Melbourne,"Jones, Nathan",30,11,5,19,0,0,0,0
Melbourne,"Kent, Dean",9,4,1,5,0,0,0,5
Melbourne,"McDonald, Tom",13,8,3,5,0,0,0,1
Melbourne,"McKenzie, Jordie",18,4,1,14,0,0,0,3
Melbourne,"Pedersen, Cameron",23,10,8,13,0,0,0,1
Melbourne,"Rodan, David",12,2,1,10,0,0,0,3
Melbourne,"Sylvia, Colin",19,10,3,9,0,0,1,8
Melbourne,"Tapscott, Luke",4,2,2,2,0,0,0,1
Melbourne,"Terlich, Dean",20,11,6,9,0,0,0,1
Melbourne,"Toumpas, Jimmy",13,9,4,4,0,0,0,2
Melbourne,"Trengove, Jack",17,11,7,6,2,0,1,4
Melbourne,"Watts, Jack",16,7,4,9,0,2,0,2
Melbourne,"Blease, Sam",12,11,4,1,1,1,0,1
Melbourne,"Byrnes, Shannon",17,8,5,9,1,1,0,3
Melbourne,"Clisby, Mitch",24,12,3,12,0,0,0,1
Melbourne,"Davey, Aaron",12,10,2,2,0,0,0,3
Melbourne,"Dawes, Chris",4,3,1,1,1,0,0,1
Melbourne,"Dunn, Lynden",17,11,7,6,0,0,0,2
Melbourne,"Fitzpatrick, Jack",10,7,5,3,1,1,9,1
Melbourne,"Garland, Colin",28,19,9,9,0,0,0,3
Melbourne,"Howe, Jeremy",13,4,6,9,2,0,1,1
Melbourne,"Jones, Matt",19,9,5,10,0,1,0,1
Melbourne,"Jones, Nathan",23,13,6,10,1,0,0,3
Melbourne,"Kent, Dean",8,7,2,1,1,0,0,1
Melbourne,"McDonald, Tom",17,9,8,8,0,0,1,1
Melbourne,"Nicholson, Daniel",8,5,3,3,0,1,0,1
Melbourne,"Pedersen, Cameron",17,7,7,10,0,0,1,1
Melbourne,"Rodan, David",17,3,0,14,0,1,0,5
Melbourne,"Spencer, Jake",15,1,6,14,0,0,27,2
Melbourne,"Sylvia, Colin",28,16,4,12,0,1,2,6
Melbourne,"Terlich, Dean",28,16,7,12,0,0,0,3
Melbourne,"Toumpas, Jimmy",17,13,7,4,0,0,0,2
Melbourne,"Trengove, Jack",17,11,5,6,0,0,0,3
Melbourne,"Watts, Jack",15,10,6,5,2,2,0,2
Melbourne,"Blease, Sam",8,4,0,4,1,0,0,0
Melbourne,"Byrnes, Shannon",4,1,0,3,0,0,0,4
Melbourne,"Clisby, Mitch",18,11,5,7,0,1,0,3
Melbourne,"Davey, Aaron",14,10,2,4,0,0,0,2
Melbourne,"Dawes, Chris",12,10,7,2,3,0,1,2
Melbourne,"Dunn, Lynden",14,9,4,5,0,0,0,2
Melbourne,"Fitzpatrick, Jack",12,10,5,2,2,1,3,0
Melbourne,"Frawley, James",20,14,8,6,0,0,0,3
Melbourne,"Garland, Colin",13,10,4,3,0,0,0,8
Melbourne,"Gawn, Max",10,6,5,4,1,0,33,6
Melbourne,"Howe, Jeremy",17,12,7,5,2,3,1,2
Melbourne,"Jones, Matt",17,9,6,8,0,0,0,4
Melbourne,"Jones, Nathan",26,10,2,16,1,0,0,2
Melbourne,"Kent, Dean",10,7,1,3,0,0,0,1
Melbourne,"McDonald, Tom",20,5,2,15,0,0,0,3
Melbourne,"Nicholson, Daniel",17,14,6,3,0,0,0,11
Melbourne,"Rodan, David",21,13,2,8,1,1,0,4
Melbourne,"Sylvia, Colin",18,7,4,11,0,1,0,7
Melbourne,"Terlich, Dean",24,18,8,6,0,0,0,5
Melbourne,"Toumpas, Jimmy",14,7,3,7,0,0,0,2
Melbourne,"Trengove, Jack",21,12,4,9,0,0,0,7
Melbourne,"Watts, Jack",15,11,9,4,4,1,0,3
Melbourne,"Byrnes, Shannon",7,5,5,2,0,1,0,0
Melbourne,"Clisby, Mitch",19,10,5,9,0,1,0,0
Melbourne,"Davey, Aaron",11,9,1,2,1,1,0,2
Melbourne,"Dawes, Chris",9,8,7,1,2,0,0,3
Melbourne,"Dunn, Lynden",17,11,3,6,0,0,0,4
Melbourne,"Fitzpatrick, Jack",17,12,8,5,3,1,6,2
Melbourne,"Frawley, James",14,6,6,8,0,0,0,2
Melbourne,"Garland, Colin",15,13,8,2,0,0,0,8
Melbourne,"Gawn, Max",18,6,8,12,0,0,25,1
Melbourne,"Grimes, Jack",19,12,8,7,0,0,0,4
Melbourne,"Howe, Jeremy",13,12,8,1,2,0,1,3
Melbourne,"Jones, Matt",22,11,5,11,0,0,0,3
Melbourne,"Jones, Nathan",20,12,4,8,1,0,0,3
Melbourne,"Kent, Dean",11,7,2,4,0,0,0,0
Melbourne,"McDonald, Tom",18,5,6,13,0,0,1,3
Melbourne,"Nicholson, Daniel",14,10,6,4,1,1,0,3
Melbourne,"Rodan, David",15,11,5,4,0,0,0,6
Melbourne,"Sylvia, Colin",21,9,6,12,0,0,0,5
Melbourne,"Terlich, Dean",27,17,10,10,0,0,0,2
Melbourne,"Toumpas, Jimmy",14,8,4,6,0,0,0,3
Melbourne,"Trengove, Jack",20,12,4,8,1,0,0,2
Melbourne,"Watts, Jack",14,9,6,5,2,1,0,2
Melbourne,"Blease, Sam",5,3,0,2,0,0,0,3
Melbourne,"Byrnes, Shannon",19,6,0,13,2,0,0,4
Melbourne,"Clisby, Mitch",16,9,2,7,0,0,0,5
Melbourne,"Davey, Aaron",7,7,0,0,0,2,0,5
Melbourne,"Dawes, Chris",4,2,2,2,1,0,0,2
Melbourne,"Dunn, Lynden",19,13,4,6,0,0,0,4
Melbourne,"Fitzpatrick, Jack",2,1,1,1,0,0,5,0
Melbourne,"Frawley, James",12,7,3,5,0,0,0,5
Melbourne,"Garland, Colin",14,11,4,3,0,0,0,5
Melbourne,"Gawn, Max",9,4,0,5,0,0,48,7
Melbourne,"Grimes, Jack",13,8,4,5,0,0,0,12
Melbourne,"Howe, Jeremy",6,5,1,1,1,1,1,0
Melbourne,"Jones, Matt",24,16,3,8,0,0,0,8
Melbourne,"Jones, Nathan",31,15,1,16,0,0,0,7
Melbourne,"Kent, Dean",10,8,1,2,0,0,0,3
Melbourne,"McDonald, Tom",17,8,2,9,0,0,1,5
Melbourne,"Nicholson, Daniel",17,6,1,11,0,0,0,9
Melbourne,"Sylvia, Colin",16,9,0,7,0,0,0,6
Melbourne,"Terlich, Dean",11,5,2,6,0,1,0,3
Melbourne,"Toumpas, Jimmy",20,14,2,6,0,1,0,7
Melbourne,"Trengove, Jack",20,10,3,10,0,0,0,5
Melbourne,"Watts, Jack",10,1,1,9,0,0,0,1
Melbourne,"Blease, Sam",8,5,0,3,2,1,0,1
Melbourne,"Byrnes, Shannon",20,9,4,11,1,1,0,2
Melbourne,"Clisby, Mitch",15,8,3,7,0,0,0,2
Melbourne,"Davey, Aaron",16,10,0,6,2,0,0,1
Melbourne,"Dawes, Chris",10,9,5,1,1,1,0,3
Melbourne,"Dunn, Lynden",16,12,3,4,0,0,0,2
Melbourne,"Fitzpatrick, Jack",11,10,3,1,4,0,3,4
Melbourne,"Frawley, James",18,11,6,7,0,0,0,1
Melbourne,"Garland, Colin",11,9,3,2,0,0,0,1
Melbourne,"Gawn, Max",5,1,0,4,0,0,34,3
Melbourne,"Grimes, Jack",15,11,6,4,0,0,0,4
Melbourne,"Howe, Jeremy",13,10,5,3,0,1,2,0
Melbourne,"Jones, Matt",15,11,2,4,0,0,0,1
Melbourne,"Jones, Nathan",16,9,2,7,1,0,0,5
Melbourne,"Kent, Dean",6,4,1,2,0,0,0,0
Melbourne,"McDonald, Tom",8,6,4,2,0,0,0,2
Melbourne,"Sylvia, Colin",27,10,1,17,0,0,0,3
Melbourne,"Terlich, Dean",16,9,4,7,0,0,0,5
Melbourne,"Toumpas, Jimmy",2,0,1,2,0,0,0,1
Melbourne,"Trengove, Jack",19,8,3,11,0,1,0,12
Melbourne,"Viney, Jack",21,14,5,7,0,0,0,1
Melbourne,"Watts, Jack",21,15,10,6,0,2,6,2
Melbourne,"Blease, Sam",4,2,0,2,0,0,0,2
Melbourne,"Byrnes, Shannon",18,8,5,10,1,0,0,1
Melbourne,"Clisby, Mitch",17,12,8,5,0,0,0,0
Melbourne,"Davey, Aaron",6,3,1,3,0,0,0,1
Melbourne,"Dawes, Chris",7,5,6,2,1,0,0,2
Melbourne,"Dunn, Lynden",16,12,3,4,0,0,2,7
Melbourne,"Fitzpatrick, Jack",5,4,3,1,1,0,4,2
Melbourne,"Frawley, James",12,10,6,2,0,0,0,1
Melbourne,"Gawn, Max",17,8,6,9,0,1,20,4
Melbourne,"Grimes, Jack",9,3,3,6,0,0,0,6
Melbourne,"Howe, Jeremy",10,5,3,5,0,0,0,2
Melbourne,"Jones, Matt",17,9,4,8,0,0,0,4
Melbourne,"Jones, Nathan",24,10,2,14,0,1,0,5
Melbourne,"Kent, Dean",2,1,2,1,0,0,0,0
Melbourne,"McDonald, Tom",22,13,8,9,0,1,0,3
Melbourne,"Pedersen, Cameron",16,11,11,5,0,0,1,0
Melbourne,"Sylvia, Colin",21,12,2,9,0,0,0,8
Melbourne,"Tapscott, Luke",9,5,2,4,1,1,0,3
Melbourne,"Toumpas, Jimmy",17,9,4,8,0,0,0,1
Melbourne,"Trengove, Jack",18,4,5,14,0,0,1,3
Melbourne,"Viney, Jack",14,6,1,8,0,0,0,7
Melbourne,"Watts, Jack",9,6,4,3,0,0,5,7
Melbourne,"Byrnes, Shannon",18,6,5,12,1,0,0,1
Melbourne,"Clisby, Mitch",22,14,2,8,1,1,0,4
Melbourne,"Davey, Aaron",8,5,1,3,0,1,0,1
Melbourne,"Dunn, Lynden",14,9,5,5,0,0,0,0
Melbourne,"Fitzpatrick, Jack",10,7,3,3,2,1,5,1
Melbourne,"Garland, Colin",13,7,4,6,0,0,0,3
Melbourne,"Gawn, Max",5,3,3,2,0,0,6,2
Melbourne,"Grimes, Jack",19,9,4,10,0,1,0,4
Melbourne,"Howe, Jeremy",8,6,3,2,1,1,0,1
Melbourne,"Jones, Matt",20,11,5,9,0,1,0,0
Melbourne,"Jones, Nathan",29,10,2,19,0,0,0,2
Melbourne,"Kent, Dean",15,10,5,5,2,1,0,2
Melbourne,"McDonald, Tom",14,9,3,5,0,0,0,2
Melbourne,"Pedersen, Cameron",23,12,7,11,1,1,0,3
Melbourne,"Spencer, Jake",11,3,3,8,1,0,22,2
Melbourne,"Sylvia, Colin",13,8,1,5,0,0,0,1
Melbourne,"Tapscott, Luke",11,9,4,2,0,1,0,2
Melbourne,"Terlich, Dean",14,10,4,4,0,0,0,4
Melbourne,"Toumpas, Jimmy",12,7,4,5,0,0,0,2
Melbourne,"Trengove, Jack",15,6,4,9,1,0,0,2
Melbourne,"Viney, Jack",22,9,4,13,0,0,0,2
Melbourne,"Watts, Jack",15,9,8,6,2,1,0,1
Melbourne,"Byrnes, Shannon",21,13,3,8,1,5,0,2
Melbourne,"Clisby, Mitch",19,10,6,9,0,0,0,3
Melbourne,"Davey, Aaron",6,5,0,1,1,0,0,0
Melbourne,"Davis, Troy",6,4,2,2,0,2,1,3
Melbourne,"Dunn, Lynden",15,11,3,4,0,0,0,3
Melbourne,"Fitzpatrick, Jack",11,7,4,4,1,2,14,0
Melbourne,"Garland, Colin",18,13,7,5,0,0,0,1
Melbourne,"Grimes, Jack",24,12,6,12,0,1,0,3
Melbourne,"Jones, Matt",16,7,1,9,0,0,0,1
Melbourne,"Jones, Nathan",29,15,2,14,0,0,0,2
Melbourne,"Kent, Dean",19,13,4,6,2,2,0,1
Melbourne,"McDonald, Tom",14,8,5,6,0,0,0,3
Melbourne,"McKenzie, Jordie",16,5,2,11,1,0,0,5
Melbourne,"Nicholson, Daniel",11,5,3,6,0,2,0,0
Melbourne,"Spencer, Jake",9,5,4,4,0,0,41,2
Melbourne,"Strauss, James",12,6,3,6,0,0,0,4
Melbourne,"Sylvia, Colin",23,15,7,8,1,1,0,2
Melbourne,"Tapscott, Luke",15,11,5,4,1,0,0,3
Melbourne,"Terlich, Dean",24,15,7,9,0,0,0,3
Melbourne,"Trengove, Jack",21,9,4,12,0,0,0,2
Melbourne,"Viney, Jack",24,7,2,17,0,0,0,1
Melbourne,"Watts, Jack",21,13,6,8,2,0,0,0
Melbourne,"Blease, Sam",2,1,1,1,0,0,0,2
Melbourne,"Byrnes, Shannon",7,2,2,5,0,1,0,1
Melbourne,"Davey, Aaron",13,10,2,3,0,1,0,1
Melbourne,"Davis, Troy",6,4,3,2,1,0,0,1
Melbourne,"Dunn, Lynden",24,16,5,8,0,1,0,2
Melbourne,"Fitzpatrick, Jack",7,4,5,3,1,0,6,3
Melbourne,"Garland, Colin",13,6,2,7,0,0,0,3
Melbourne,"Grimes, Jack",19,9,7,10,0,0,0,2
Melbourne,"Howe, Jeremy",11,7,6,4,1,0,0,1
Melbourne,"Jones, Matt",19,9,4,10,0,0,0,2
Melbourne,"Jones, Nathan",13,3,0,10,0,0,0,6
Melbourne,"Kent, Dean",14,12,5,2,1,0,0,1
Melbourne,"McDonald, Tom",20,11,4,9,0,0,0,0
Melbourne,"McKenzie, Jordie",17,4,2,13,0,1,0,8
Melbourne,"Spencer, Jake",11,1,0,10,0,1,22,2
Melbourne,"Strauss, James",9,5,3,4,0,0,0,0
Melbourne,"Sylvia, Colin",26,17,4,9,0,1,1,3
Melbourne,"Tapscott, Luke",12,7,3,5,0,0,0,1
Melbourne,"Terlich, Dean",26,17,11,9,0,0,0,6
Melbourne,"Trengove, Jack",27,14,8,13,0,0,0,3
Melbourne,"Viney, Jack",28,14,5,14,1,0,0,5
Melbourne,"Watts, Jack",24,14,6,10,0,0,0,1
Melbourne,"Davey, Aaron",9,4,2,5,0,1,0,2
Melbourne,"Dawes, Chris",13,10,6,3,0,2,0,2
Melbourne,"Dunn, Lynden",24,14,3,10,0,0,0,6
Melbourne,"Frawley, James",11,5,4,6,0,0,0,1
Melbourne,"Garland, Colin",15,11,4,4,0,0,0,2
Melbourne,"Grimes, Jack",23,10,5,13,0,0,0,4
Melbourne,"Howe, Jeremy",7,7,4,0,2,1,0,1
Melbourne,"Jones, Matt",18,7,2,11,0,0,0,4
Melbourne,"Jones, Nathan",23,11,1,12,0,0,0,3
Melbourne,"Kent, Dean",13,10,5,3,0,0,0,1
Melbourne,"McDonald, Tom",17,8,5,9,0,0,0,2
Melbourne,"McKenzie, Jordie",11,2,3,9,0,0,0,2
Melbourne,"Pedersen, Cameron",7,4,5,3,0,0,5,5
Melbourne,"Rodan, David",7,2,0,5,0,0,0,0
Melbourne,"Spencer, Jake",11,4,5,7,0,1,30,6
Melbourne,"Sylvia, Colin",16,6,2,10,2,0,1,7
Melbourne,"Tapscott, Luke",6,4,4,2,1,1,0,5
Melbourne,"Terlich, Dean",20,15,6,5,0,0,0,2
Melbourne,"Toumpas, Jimmy",22,8,5,14,0,1,0,4
Melbourne,"Trengove, Jack",22,14,7,8,0,0,1,0
Melbourne,"Viney, Jack",12,6,3,6,0,0,0,9
Melbourne,"Watts, Jack",18,11,6,7,2,1,0,2
Melbourne,"Davey, Aaron",14,9,2,5,0,1,0,7
Melbourne,"Dunn, Lynden",14,10,6,4,1,0,0,2
Melbourne,"Frawley, James",15,10,5,5,0,1,0,0
Melbourne,"Garland, Colin",19,12,7,7,1,0,0,2
Melbourne,"Gawn, Max",1,0,0,1,0,0,7,0
Melbourne,"Grimes, Jack",23,12,7,11,0,0,0,3
Melbourne,"Howe, Jeremy",15,8,5,7,1,0,2,1
Melbourne,"Jetta, Neville",11,7,4,4,0,0,0,4
Melbourne,"Jones, Matt",16,7,4,9,1,0,0,3
Melbourne,"Jones, Nathan",19,9,3,10,1,1,0,4
Melbourne,"Kent, Dean",10,7,4,3,2,1,0,2
Melbourne,"McDonald, Tom",16,9,1,7,0,0,0,2
Melbourne,"McKenzie, Jordie",15,6,1,9,0,0,0,2
Melbourne,"Sellar, James",8,7,3,1,1,2,0,3
Melbourne,"Spencer, Jake",6,0,2,6,0,0,25,2
Melbourne,"Sylvia, Colin",14,7,5,7,0,0,2,4
Melbourne,"Tapscott, Luke",7,4,3,3,0,2,0,4
Melbourne,"Terlich, Dean",17,9,6,8,0,0,0,4
Melbourne,"Toumpas, Jimmy",15,7,4,8,0,0,0,1
Melbourne,"Trengove, Jack",17,9,3,8,0,0,1,4
Melbourne,"Viney, Jack",16,8,1,8,1,0,0,6
Melbourne,"Watts, Jack",7,5,3,2,4,0,0,1
North Melbourne,"Adams, Leigh",12,4,2,8,0,1,0,3
North Melbourne,"Anthony, Liam",10,4,2,6,0,0,0,0
North Melbourne,"Atley, Shaun",14,7,1,7,0,0,0,1
North Melbourne,"Bastinac, Ryan",19,11,3,8,1,0,0,3
North Melbourne,"Cunnington, Ben",23,10,3,13,1,0,0,2
North Melbourne,"Firrito, Michael",19,13,7,6,0,0,0,1
North Melbourne,"Gibson, Sam",16,7,5,9,1,0,0,1
North Melbourne,"Goldstein, Todd",15,9,5,6,1,1,38,1
North Melbourne,"Grima, Nathan",13,9,2,4,0,0,0,0
North Melbourne,"Hansen, Lachlan",14,9,6,5,2,1,0,1
North Melbourne,"Harper, Kieran",3,2,1,1,0,0,0,7
North Melbourne,"Jacobs, Ben",12,3,1,9,0,1,0,0
North Melbourne,"Macmillan, Jamie",16,10,2,6,0,1,0,1
North Melbourne,"Mullett, Aaron",22,18,5,4,1,0,0,1
North Melbourne,"Petrie, Drew",13,10,4,3,1,1,2,0
North Melbourne,"Swallow, Andrew",34,18,5,16,0,2,0,9
North Melbourne,"Tarrant, Robbie",16,10,6,6,1,0,0,1
North Melbourne,"Thomas, Lindsay",12,10,0,2,4,1,0,2
North Melbourne,"Thompson, Scott",19,13,6,6,0,0,0,0
North Melbourne,"Wells, Daniel",25,17,4,8,0,0,4,0
North Melbourne,"Wright, Sam",7,2,1,5,0,0,0,0
North Melbourne,"Ziebell, Jack",19,13,2,6,0,0,0,5
North Melbourne,"Adams, Leigh",18,10,4,8,1,0,0,2
North Melbourne,"Anthony, Liam",23,11,2,12,1,0,0,4
North Melbourne,"Atley, Shaun",16,10,4,6,1,0,0,6
North Melbourne,"Bastinac, Ryan",29,19,9,10,1,1,0,7
North Melbourne,"Cunnington, Ben",12,5,0,7,0,0,0,4
North Melbourne,"Firrito, Michael",15,10,7,5,0,0,0,1
North Melbourne,"Gibson, Sam",26,21,12,5,0,0,0,0
North Melbourne,"Goldstein, Todd",9,5,4,4,0,0,42,4
North Melbourne,"Grima, Nathan",16,15,7,1,0,0,0,5
North Melbourne,"Hansen, Lachlan",7,3,3,4,0,0,4,1
North Melbourne,"Harper, Kieran",6,3,1,3,0,0,0,4
North Melbourne,"Jacobs, Ben",8,5,3,3,0,1,0,0
North Melbourne,"Macmillan, Jamie",11,6,4,5,0,0,0,4
North Melbourne,"McMahon, Scott",15,12,9,3,0,0,0,6
North Melbourne,"Mullett, Aaron",21,13,5,8,1,0,0,6
North Melbourne,"Petrie, Drew",14,11,6,3,4,1,2,0
North Melbourne,"Swallow, Andrew",29,18,7,11,0,0,0,5
North Melbourne,"Tarrant, Robbie",8,5,5,3,2,0,1,1
North Melbourne,"Thomas, Lindsay",12,11,4,1,5,1,0,3
North Melbourne,"Thompson, Scott",19,12,5,7,0,0,0,3
North Melbourne,"Wells, Daniel",18,10,4,8,1,0,4,1
North Melbourne,"Ziebell, Jack",23,17,2,6,0,1,0,5
North Melbourne,"Adams, Leigh",15,11,5,4,0,0,0,4
North Melbourne,"Atley, Shaun",15,11,3,4,0,0,0,1
North Melbourne,"Bastinac, Ryan",16,12,3,4,0,1,0,0
North Melbourne,"Cunnington, Ben",23,13,5,10,2,0,0,4
North Melbourne,"Firrito, Michael",19,14,5,5,0,0,0,1
North Melbourne,"Gibson, Sam",21,10,7,11,0,0,0,0
North Melbourne,"Goldstein, Todd",12,9,5,3,1,0,39,4
North Melbourne,"Grima, Nathan",15,8,6,7,0,0,0,2
North Melbourne,"Hansen, Lachlan",11,10,4,1,2,1,3,1
North Melbourne,"Harper, Kieran",6,5,1,1,0,1,0,7
North Melbourne,"Hine, Taylor",13,7,3,6,0,0,0,3
North Melbourne,"Macmillan, Jamie",19,12,7,7,1,0,0,2
North Melbourne,"McMahon, Scott",17,9,5,8,0,0,0,2
North Melbourne,"Mullett, Aaron",26,20,6,6,0,1,0,2
North Melbourne,"Petrie, Drew",6,4,3,2,0,0,0,2
North Melbourne,"Swallow, Andrew",28,18,3,10,0,0,0,11
North Melbourne,"Tarrant, Robbie",7,5,3,2,2,1,3,1
North Melbourne,"Thomas, Lindsay",5,5,3,0,3,1,0,2
North Melbourne,"Thompson, Scott",19,12,9,7,0,0,0,1
North Melbourne,"Wells, Daniel",24,13,4,11,1,0,0,4
North Melbourne,"Wright, Sam",7,5,2,2,1,0,0,0
North Melbourne,"Ziebell, Jack",15,7,2,8,0,0,0,5
North Melbourne,"Adams, Leigh",20,11,1,9,1,1,0,3
North Melbourne,"Anthony, Liam",14,11,8,3,0,0,0,1
North Melbourne,"Atley, Shaun",18,10,4,8,0,0,0,1
North Melbourne,"Bastinac, Ryan",24,13,5,11,0,3,0,2
North Melbourne,"Cunnington, Ben",15,8,1,7,0,0,0,4
North Melbourne,"Daw, Majak",3,2,2,1,1,1,1,0
North Melbourne,"Firrito, Michael",20,14,6,6,0,0,0,0
North Melbourne,"Gibson, Sam",30,16,9,14,1,2,0,2
North Melbourne,"Goldstein, Todd",11,3,2,8,0,0,36,2
North Melbourne,"Grima, Nathan",16,11,6,5,0,0,0,2
North Melbourne,"Hansen, Lachlan",7,4,3,3,1,1,0,0
North Melbourne,"Hine, Taylor",17,11,7,6,0,0,0,2
North Melbourne,"Macmillan, Jamie",23,16,8,7,1,1,0,1
North Melbourne,"McMahon, Scott",19,11,8,8,0,0,0,2
North Melbourne,"Mullett, Aaron",22,14,6,8,1,0,0,1
North Melbourne,"Petrie, Drew",18,9,5,9,4,2,2,2
North Melbourne,"Swallow, Andrew",18,6,3,12,0,0,0,5
North Melbourne,"Thomas, Lindsay",20,14,2,6,4,2,0,2
North Melbourne,"Thompson, Scott",25,15,10,10,1,0,0,1
North Melbourne,"Wells, Daniel",24,12,4,12,1,0,0,3
North Melbourne,"Wright, Sam",15,7,1,8,1,1,0,2
North Melbourne,"Ziebell, Jack",22,17,8,5,1,1,0,3
North Melbourne,"Adams, Leigh",17,8,2,9,1,1,0,1
North Melbourne,"Anthony, Liam",4,2,1,2,0,0,0,1
North Melbourne,"Atley, Shaun",19,7,3,12,0,0,0,0
North Melbourne,"Bastinac, Ryan",16,10,3,6,0,1,1,2
North Melbourne,"Black, Aaron",11,5,3,6,2,1,0,8
North Melbourne,"Cunnington, Ben",22,5,1,17,0,1,0,3
North Melbourne,"Daw, Majak",7,5,2,2,0,3,7,2
North Melbourne,"Firrito, Michael",13,11,3,2,0,0,0,1
North Melbourne,"Gibson, Sam",23,17,6,6,1,0,0,1
North Melbourne,"Goldstein, Todd",6,3,1,3,0,0,38,3
North Melbourne,"Grima, Nathan",13,10,5,3,0,0,0,2
North Melbourne,"Hine, Taylor",10,4,3,6,0,0,0,3
North Melbourne,"Macmillan, Jamie",19,15,7,4,0,0,0,1
North Melbourne,"McMahon, Scott",14,11,4,3,0,0,0,3
North Melbourne,"Mullett, Aaron",17,12,1,5,1,0,0,0
North Melbourne,"Petrie, Drew",15,12,8,3,1,1,1,1
North Melbourne,"Swallow, Andrew",35,17,5,18,0,1,0,3
North Melbourne,"Thomas, Lindsay",6,6,2,0,5,1,0,3
North Melbourne,"Thompson, Scott",20,10,6,10,0,0,0,1
North Melbourne,"Wells, Daniel",27,19,1,8,1,1,0,2
North Melbourne,"Wright, Sam",10,8,4,2,0,2,0,1
North Melbourne,"Ziebell, Jack",26,19,1,7,1,0,0,2
North Melbourne,"Adams, Leigh",17,8,4,9,2,0,0,3
North Melbourne,"Atley, Shaun",19,12,6,7,0,0,0,1
North Melbourne,"Bastinac, Ryan",27,12,5,15,0,0,0,2
North Melbourne,"Black, Aaron",12,7,2,5,2,2,0,3
North Melbourne,"Cunnington, Ben",25,15,2,10,0,0,0,2
North Melbourne,"Daw, Majak",9,7,3,2,1,0,9,1
North Melbourne,"Firrito, Michael",18,12,6,6,0,0,0,6
North Melbourne,"Gibson, Sam",15,10,5,5,0,0,0,5
North Melbourne,"Goldstein, Todd",11,4,2,7,1,0,37,3
North Melbourne,"Grima, Nathan",10,6,3,4,0,0,0,1
North Melbourne,"Hine, Taylor",5,2,0,3,0,0,0,1
North Melbourne,"Macmillan, Jamie",13,9,7,4,0,0,0,2
North Melbourne,"McMahon, Scott",10,6,1,4,0,0,0,2
North Melbourne,"Mullett, Aaron",18,12,4,6,0,0,0,0
North Melbourne,"Petrie, Drew",11,9,5,2,3,1,2,4
North Melbourne,"Sierakowski, Will",11,5,1,6,0,0,0,3
North Melbourne,"Swallow, Andrew",26,14,1,12,0,0,0,6
North Melbourne,"Thomas, Lindsay",10,8,2,2,2,2,0,5
North Melbourne,"Thompson, Scott",18,12,7,6,0,0,0,3
North Melbourne,"Wells, Daniel",23,15,1,8,1,1,2,3
North Melbourne,"Wright, Sam",11,5,3,6,1,0,0,2
North Melbourne,"Ziebell, Jack",17,10,5,7,1,2,0,8
North Melbourne,"Adams, Leigh",17,8,1,9,0,0,0,4
North Melbourne,"Atley, Shaun",12,9,4,3,1,0,0,4
North Melbourne,"Bastinac, Ryan",21,12,5,9,1,1,0,2
North Melbourne,"Black, Aaron",17,10,7,7,2,3,0,3
North Melbourne,"Cunnington, Ben",18,5,1,13,0,0,0,4
North Melbourne,"Daw, Majak",18,13,8,5,6,4,4,4
North Melbourne,"Firrito, Michael",14,6,4,8,0,0,0,0
North Melbourne,"Gibson, Sam",24,13,7,11,0,1,0,4
North Melbourne,"Goldstein, Todd",17,8,5,9,2,0,33,6
North Melbourne,"Hansen, Lachlan",16,9,8,7,0,0,0,0
North Melbourne,"Harvey, Brent",19,14,2,5,1,0,0,3
North Melbourne,"Macmillan, Jamie",15,9,7,6,1,0,0,3
North Melbourne,"McMahon, Scott",12,8,4,4,0,0,0,2
North Melbourne,"Mullett, Aaron",6,5,1,1,0,0,0,2
North Melbourne,"Petrie, Drew",15,13,8,2,3,1,0,6
North Melbourne,"Sierakowski, Will",12,8,2,4,1,0,0,4
North Melbourne,"Swallow, Andrew",18,8,3,10,0,0,0,8
North Melbourne,"Thomas, Lindsay",15,14,3,1,2,4,0,5
North Melbourne,"Thompson, Scott",15,10,2,5,0,0,0,2
North Melbourne,"Wells, Daniel",6,5,1,1,0,1,0,0
North Melbourne,"Wright, Sam",15,10,5,5,0,0,0,2
North Melbourne,"Ziebell, Jack",27,18,5,9,2,0,0,3
North Melbourne,"Adams, Leigh",9,6,1,3,0,1,0,1
North Melbourne,"Atley, Shaun",17,13,7,4,0,0,0,0
North Melbourne,"Bastinac, Ryan",18,12,3,6,0,0,0,0
North Melbourne,"Black, Aaron",14,8,5,6,3,1,0,0
North Melbourne,"Cunnington, Ben",21,14,5,7,1,1,0,7
North Melbourne,"Daw, Majak",4,2,1,2,1,0,3,3
North Melbourne,"Firrito, Michael",15,12,3,3,0,0,0,1
North Melbourne,"Gibson, Sam",9,4,4,5,0,0,0,0
North Melbourne,"Goldstein, Todd",10,4,4,6,0,0,23,3
North Melbourne,"Grima, Nathan",10,8,2,2,0,0,0,1
North Melbourne,"Hansen, Lachlan",20,14,15,6,0,0,1,0
North Melbourne,"Harvey, Brent",24,15,8,9,2,0,0,3
North Melbourne,"Macmillan, Jamie",10,6,4,4,0,0,0,2
North Melbourne,"McMahon, Scott",16,12,7,4,0,0,0,1
North Melbourne,"Mullett, Aaron",20,16,6,4,0,0,0,1
North Melbourne,"Petrie, Drew",12,10,5,2,1,1,0,2
North Melbourne,"Swallow, Andrew",19,8,5,11,1,0,0,5
North Melbourne,"Thomas, Lindsay",3,3,1,0,0,2,0,2
North Melbourne,"Thompson, Scott",17,14,10,3,1,0,0,2
North Melbourne,"Wells, Daniel",23,17,8,6,1,0,0,1
North Melbourne,"Wright, Sam",6,6,2,0,1,1,0,0
North Melbourne,"Ziebell, Jack",17,12,6,5,1,0,0,7
North Melbourne,"Adams, Leigh",21,6,4,15,0,0,0,2
North Melbourne,"Atley, Shaun",16,6,3,10,0,0,0,2
North Melbourne,"Bastinac, Ryan",19,12,7,7,0,0,0,5
North Melbourne,"Black, Aaron",12,8,6,4,1,2,0,1
North Melbourne,"Cunnington, Ben",19,12,3,7,3,0,0,6
North Melbourne,"Daw, Majak",2,0,0,2,0,0,4,1
North Melbourne,"Firrito, Michael",9,6,7,3,0,0,0,1
North Melbourne,"Gibson, Sam",30,15,10,15,2,0,0,2
North Melbourne,"Goldstein, Todd",11,2,2,9,0,0,39,2
North Melbourne,"Grima, Nathan",10,3,4,7,0,0,0,0
North Melbourne,"Hansen, Lachlan",15,9,7,6,0,0,0,0
North Melbourne,"Harvey, Brent",23,16,5,7,1,1,0,2
North Melbourne,"Macmillan, Jamie",18,14,5,4,1,0,0,5
North Melbourne,"McMahon, Scott",12,10,5,2,0,1,0,2
North Melbourne,"Mullett, Aaron",18,12,7,6,0,0,0,2
North Melbourne,"Petrie, Drew",14,9,4,5,2,0,3,6
North Melbourne,"Swallow, Andrew",22,12,1,10,1,0,0,9
North Melbourne,"Thomas, Lindsay",11,10,4,1,5,0,0,1
North Melbourne,"Thompson, Scott",13,8,4,5,0,0,0,4
North Melbourne,"Wells, Daniel",20,12,6,8,1,1,0,2
North Melbourne,"Wright, Sam",4,3,0,1,0,1,0,2
North Melbourne,"Ziebell, Jack",23,16,6,7,2,1,0,10
North Melbourne,"Adams, Leigh",23,9,6,14,0,1,0,4
North Melbourne,"Atley, Shaun",19,12,7,7,0,1,0,4
North Melbourne,"Bastinac, Ryan",26,16,7,10,1,0,0,3
North Melbourne,"Black, Aaron",17,10,7,7,5,3,1,4
North Melbourne,"Cunnington, Ben",21,12,2,9,0,0,0,7
North Melbourne,"Firrito, Michael",15,11,9,4,0,0,0,0
North Melbourne,"Gibson, Sam",19,13,6,6,0,1,0,3
North Melbourne,"Goldstein, Todd",19,6,5,13,0,0,48,2
North Melbourne,"Grima, Nathan",20,14,10,6,0,0,0,2
North Melbourne,"Hansen, Lachlan",27,18,12,9,0,0,0,1
North Melbourne,"Harvey, Brent",23,17,5,6,4,4,0,0
North Melbourne,"Hine, Taylor",2,2,1,0,0,1,0,0
North Melbourne,"Macmillan, Jamie",19,12,3,7,0,1,0,0
North Melbourne,"McMahon, Scott",17,9,7,8,0,0,0,0
North Melbourne,"Mullett, Aaron",31,21,11,10,1,0,0,0
North Melbourne,"Petrie, Drew",22,16,9,6,4,4,8,2
North Melbourne,"Sierakowski, Will",7,4,0,3,0,0,0,2
North Melbourne,"Swallow, Andrew",25,16,9,9,0,0,0,5
North Melbourne,"Thomas, Lindsay",12,10,4,2,3,0,0,6
North Melbourne,"Thompson, Scott",21,13,11,8,0,0,0,1
North Melbourne,"Wells, Daniel",24,10,2,14,0,0,1,3
North Melbourne,"Wright, Sam",6,4,3,2,1,0,0,2
North Melbourne,"Adams, Leigh",11,4,0,7,0,0,0,11
North Melbourne,"Atley, Shaun",13,6,2,7,0,0,0,3
North Melbourne,"Bastinac, Ryan",11,3,2,8,0,0,0,3
North Melbourne,"Black, Aaron",11,7,1,4,2,0,0,4
North Melbourne,"Cunnington, Ben",25,13,1,12,0,0,0,13
North Melbourne,"Firrito, Michael",12,7,5,5,0,0,0,1
North Melbourne,"Gibson, Sam",20,12,2,8,1,0,0,6
North Melbourne,"Goldstein, Todd",10,6,2,4,0,0,59,3
North Melbourne,"Grima, Nathan",21,14,2,7,0,0,0,4
North Melbourne,"Hansen, Lachlan",1,1,1,0,0,0,0,3
North Melbourne,"Harvey, Brent",21,11,1,10,0,0,0,4
North Melbourne,"Hine, Taylor",9,5,1,4,0,0,0,2
North Melbourne,"Macmillan, Jamie",14,11,0,3,0,0,0,1
North Melbourne,"McMahon, Scott",11,10,2,1,0,0,0,4
North Melbourne,"Mullett, Aaron",20,13,2,7,0,0,0,3
North Melbourne,"Petrie, Drew",10,6,3,4,2,0,1,6
North Melbourne,"Sierakowski, Will",6,4,0,2,0,0,0,1
North Melbourne,"Swallow, Andrew",10,4,1,6,0,0,0,12
North Melbourne,"Thomas, Lindsay",9,6,2,3,2,2,0,3
North Melbourne,"Thompson, Scott",20,16,6,4,0,0,0,7
North Melbourne,"Wells, Daniel",21,19,5,2,1,0,1,6
North Melbourne,"Wright, Sam",15,8,1,7,0,0,0,6
North Melbourne,"Adams, Leigh",10,7,4,3,0,0,0,4
North Melbourne,"Anthony, Liam",12,5,3,7,0,0,0,4
North Melbourne,"Atley, Shaun",20,12,5,8,0,0,0,0
North Melbourne,"Bastinac, Ryan",28,15,7,13,0,0,0,4
North Melbourne,"Black, Aaron",11,5,4,6,1,0,0,3
North Melbourne,"Firrito, Michael",14,10,3,4,0,0,0,4
North Melbourne,"Gibson, Sam",24,8,4,16,0,0,0,3
North Melbourne,"Goldstein, Todd",9,3,3,6,0,0,46,3
North Melbourne,"Greenwood, Levi",21,9,3,12,0,0,0,8
North Melbourne,"Grima, Nathan",19,11,5,8,0,0,0,5
North Melbourne,"Hansen, Lachlan",18,11,11,7,0,0,0,5
North Melbourne,"Harvey, Brent",11,5,6,6,1,0,0,2
North Melbourne,"Hine, Taylor",11,6,0,5,0,0,0,6
North Melbourne,"Macmillan, Jamie",21,13,5,8,1,0,0,2
North Melbourne,"McKenzie, Brad",12,10,5,2,0,0,0,1
North Melbourne,"Mullett, Aaron",16,13,5,3,1,0,0,0
North Melbourne,"Petrie, Drew",12,8,2,4,0,0,6,5
North Melbourne,"Swallow, Andrew",33,22,4,11,0,1,0,8
North Melbourne,"Thomas, Lindsay",4,2,2,2,0,0,0,2
North Melbourne,"Thompson, Scott",16,8,2,8,0,0,0,4
North Melbourne,"Wells, Daniel",15,10,3,5,0,1,0,7
North Melbourne,"Wright, Sam",10,4,1,6,0,1,0,2
North Melbourne,"Adams, Leigh",19,9,7,10,1,0,0,6
North Melbourne,"Atley, Shaun",19,10,11,9,0,0,0,2
North Melbourne,"Bastinac, Ryan",22,12,4,10,1,1,0,2
North Melbourne,"Black, Aaron",7,2,2,5,0,1,0,2
North Melbourne,"Firrito, Michael",15,7,5,8,0,0,0,1
North Melbourne,"Gibson, Sam",26,13,5,13,0,1,0,4
North Melbourne,"Goldstein, Todd",11,7,4,4,1,0,26,2
North Melbourne,"Greenwood, Levi",12,5,3,7,0,0,0,7
North Melbourne,"Grima, Nathan",20,14,8,6,0,0,0,3
North Melbourne,"Hansen, Lachlan",24,14,12,10,0,0,0,1
North Melbourne,"Harvey, Brent",24,13,7,11,3,2,0,0
North Melbourne,"Hine, Taylor",20,14,7,6,0,0,0,1
North Melbourne,"Macmillan, Jamie",5,5,1,0,1,0,1,1
North Melbourne,"McKenzie, Brad",19,11,7,8,0,1,1,3
North Melbourne,"Mullett, Aaron",16,11,6,5,1,0,0,0
North Melbourne,"Petrie, Drew",11,10,6,1,5,1,2,3
North Melbourne,"Swallow, Andrew",24,11,3,13,0,1,0,5
North Melbourne,"Tarrant, Robbie",13,6,5,7,1,2,0,0
North Melbourne,"Thomas, Lindsay",12,12,7,0,4,0,0,1
North Melbourne,"Thompson, Scott",28,16,9,12,0,0,0,0
North Melbourne,"Wells, Daniel",23,12,6,11,0,0,0,1
North Melbourne,"Ziebell, Jack",16,10,2,6,1,1,0,5
North Melbourne,"Adams, Leigh",29,14,10,15,0,1,0,5
North Melbourne,"Atley, Shaun",17,8,1,9,0,1,0,3
North Melbourne,"Bastinac, Ryan",21,8,2,13,2,1,0,1
North Melbourne,"Black, Aaron",15,12,6,3,3,1,0,4
North Melbourne,"Cunnington, Ben",15,9,3,6,1,0,0,3
North Melbourne,"Firrito, Michael",10,6,1,4,0,0,0,3
North Melbourne,"Gibson, Sam",17,8,3,9,1,0,0,1
North Melbourne,"Goldstein, Todd",12,5,1,7,0,2,44,3
North Melbourne,"Greenwood, Levi",26,14,6,12,1,0,4,5
North Melbourne,"Grima, Nathan",20,16,9,4,0,0,0,1
North Melbourne,"Hansen, Lachlan",19,14,15,5,0,1,0,1
North Melbourne,"Harvey, Brent",27,16,4,11,2,1,0,5
North Melbourne,"Hine, Taylor",11,6,2,5,0,0,0,3
North Melbourne,"Macmillan, Jamie",19,6,1,13,0,0,0,3
North Melbourne,"McKenzie, Brad",6,3,1,3,0,1,0,0
North Melbourne,"Mullett, Aaron",15,10,1,5,2,0,0,3
North Melbourne,"Petrie, Drew",17,14,8,3,1,1,5,2
North Melbourne,"Swallow, Andrew",26,11,1,15,0,0,0,2
North Melbourne,"Tarrant, Robbie",8,5,2,3,4,0,0,4
North Melbourne,"Thompson, Scott",21,12,5,9,0,0,0,6
North Melbourne,"Wells, Daniel",25,14,3,11,0,1,3,1
North Melbourne,"Ziebell, Jack",25,16,5,9,2,1,0,3
North Melbourne,"Adams, Leigh",20,8,4,12,0,0,0,1
North Melbourne,"Atley, Shaun",20,13,7,7,0,0,0,4
North Melbourne,"Bastinac, Ryan",18,11,2,7,1,1,0,8
North Melbourne,"Black, Aaron",10,5,3,5,3,0,0,0
North Melbourne,"Cunnington, Ben",17,10,3,7,2,0,0,7
North Melbourne,"Firrito, Michael",9,6,4,3,0,0,0,2
North Melbourne,"Gibson, Sam",28,16,7,12,0,0,0,1
North Melbourne,"Goldstein, Todd",6,5,2,1,0,0,41,2
North Melbourne,"Greenwood, Levi",18,8,0,10,0,0,0,7
North Melbourne,"Grima, Nathan",17,14,4,3,0,0,0,0
North Melbourne,"Hansen, Lachlan",0,0,0,0,0,0,0,0
North Melbourne,"Harvey, Brent",23,11,2,12,1,0,0,4
North Melbourne,"Hine, Taylor",11,8,0,3,0,1,0,1
North Melbourne,"Macmillan, Jamie",17,13,4,4,0,0,0,2
North Melbourne,"McKenzie, Brad",18,5,3,13,0,0,0,2
North Melbourne,"Mullett, Aaron",16,11,5,5,1,0,0,1
North Melbourne,"Petrie, Drew",14,11,7,3,5,1,2,1
North Melbourne,"Swallow, Andrew",22,10,2,12,0,0,0,6
North Melbourne,"Tarrant, Robbie",6,4,4,2,3,0,0,0
North Melbourne,"Thompson, Scott",14,7,6,7,0,0,0,0
North Melbourne,"Wells, Daniel",18,9,5,9,1,0,3,5
North Melbourne,"Ziebell, Jack",21,14,2,7,0,0,0,2
North Melbourne,"Adams, Leigh",25,16,4,9,0,0,0,2
North Melbourne,"Atley, Shaun",15,7,3,8,0,0,0,3
North Melbourne,"Bastinac, Ryan",18,11,5,7,1,2,0,6
North Melbourne,"Black, Aaron",14,8,3,6,0,2,0,2
North Melbourne,"Cunnington, Ben",21,15,4,6,0,0,0,3
North Melbourne,"Gibson, Sam",12,6,2,6,0,0,0,2
North Melbourne,"Goldstein, Todd",8,3,1,5,0,0,41,3
North Melbourne,"Grima, Nathan",16,12,7,4,0,0,0,3
North Melbourne,"Hansen, Lachlan",20,13,11,7,0,0,0,2
North Melbourne,"Harvey, Brent",26,12,3,14,1,0,0,4
North Melbourne,"Hine, Taylor",10,7,3,3,0,1,0,4
North Melbourne,"Macmillan, Jamie",14,10,5,4,1,0,0,2
North Melbourne,"McKenzie, Brad",10,7,3,3,1,0,0,3
North Melbourne,"McMahon, Scott",8,7,4,1,0,0,0,0
North Melbourne,"Mullett, Aaron",10,9,0,1,0,0,0,1
North Melbourne,"Petrie, Drew",16,11,9,5,4,1,2,4
North Melbourne,"Swallow, Andrew",20,12,2,8,0,3,0,5
North Melbourne,"Tarrant, Robbie",15,7,4,8,0,0,1,1
North Melbourne,"Thomas, Lindsay",10,9,1,1,6,1,0,2
North Melbourne,"Thompson, Scott",23,13,8,10,0,0,0,1
North Melbourne,"Wells, Daniel",14,7,0,7,1,0,0,3
North Melbourne,"Ziebell, Jack",19,15,3,4,1,0,0,7
North Melbourne,"Adams, Leigh",21,11,5,10,2,1,0,5
North Melbourne,"Atley, Shaun",17,13,7,4,0,0,0,2
North Melbourne,"Bastinac, Ryan",20,10,1,10,4,1,0,5
North Melbourne,"Black, Aaron",16,13,9,3,4,1,1,3
North Melbourne,"Cunnington, Ben",34,16,6,18,2,1,0,7
North Melbourne,"Delaney, Cameron",19,15,12,4,0,0,0,1
North Melbourne,"Gibson, Sam",28,10,4,18,0,1,0,2
North Melbourne,"Goldstein, Todd",20,6,3,14,2,1,49,5
North Melbourne,"Grima, Nathan",18,10,6,8,0,0,0,4
North Melbourne,"Hansen, Lachlan",26,13,10,13,0,0,0,2
North Melbourne,"Harvey, Brent",35,19,8,16,1,0,0,2
North Melbourne,"Hine, Taylor",8,4,1,4,0,0,0,3
North Melbourne,"Macmillan, Jamie",26,11,9,15,0,0,0,1
North Melbourne,"McKenzie, Brad",14,9,3,5,0,1,0,1
North Melbourne,"Mullett, Aaron",19,12,5,7,2,0,0,6
North Melbourne,"Petrie, Drew",9,7,7,2,2,1,8,3
North Melbourne,"Swallow, Andrew",15,5,1,10,0,0,0,3
North Melbourne,"Tarrant, Robbie",17,11,10,6,0,3,0,1
North Melbourne,"Thomas, Lindsay",11,8,4,3,0,2,0,2
North Melbourne,"Thompson, Scott",23,13,7,10,0,0,0,1
North Melbourne,"Wells, Daniel",25,16,3,9,2,2,1,1
North Melbourne,"Ziebell, Jack",18,14,1,4,1,0,0,8
North Melbourne,"Adams, Leigh",25,11,5,14,2,0,0,4
North Melbourne,"Atley, Shaun",23,12,7,11,0,0,0,1
North Melbourne,"Bastinac, Ryan",23,13,4,10,3,1,0,2
North Melbourne,"Black, Aaron",19,7,4,12,0,1,0,1
North Melbourne,"Cunnington, Ben",21,8,2,13,0,0,0,4
North Melbourne,"Delaney, Luke",13,3,3,10,0,0,0,2
North Melbourne,"Gibson, Sam",21,6,2,15,0,0,0,3
North Melbourne,"Goldstein, Todd",12,5,4,7,0,0,42,0
North Melbourne,"Hansen, Lachlan",30,16,10,14,1,0,0,1
North Melbourne,"Harvey, Brent",37,12,4,25,0,0,0,5
North Melbourne,"Hine, Taylor",21,10,3,11,0,0,0,0
North Melbourne,"Jacobs, Ben",18,5,0,13,1,0,0,1
North Melbourne,"Macmillan, Jamie",18,4,4,14,0,0,2,2
North Melbourne,"McKenzie, Brad",3,2,1,1,0,0,0,0
North Melbourne,"Mullett, Aaron",32,26,7,6,1,0,0,3
North Melbourne,"Petrie, Drew",13,9,3,4,1,0,13,5
North Melbourne,"Tarrant, Robbie",5,3,3,2,0,1,0,1
North Melbourne,"Thomas, Lindsay",14,10,2,4,1,1,0,3
North Melbourne,"Thompson, Scott",23,15,6,8,0,0,0,3
North Melbourne,"Wells, Daniel",18,15,3,3,4,0,0,1
North Melbourne,"Wright, Sam",20,7,3,13,0,0,0,4
North Melbourne,"Ziebell, Jack",23,15,3,8,1,0,0,6
North Melbourne,"Adams, Leigh",17,7,0,10,3,0,0,0
North Melbourne,"Atley, Shaun",21,13,6,8,0,0,0,3
North Melbourne,"Bastinac, Ryan",18,11,3,7,0,0,0,4
North Melbourne,"Black, Aaron",9,5,3,4,1,0,0,1
North Melbourne,"Cunnington, Ben",21,10,4,11,0,0,0,7
North Melbourne,"Delaney, Luke",15,9,4,6,0,1,0,3
North Melbourne,"Garner, Taylor",1,0,0,1,0,0,0,0
North Melbourne,"Gibson, Sam",29,18,7,11,0,1,1,0
North Melbourne,"Goldstein, Todd",7,3,1,4,1,0,22,2
North Melbourne,"Hansen, Lachlan",15,10,5,5,0,0,0,1
North Melbourne,"Harvey, Brent",16,9,6,7,0,0,0,3
North Melbourne,"Hine, Taylor",10,5,1,5,0,0,0,2
North Melbourne,"Jacobs, Ben",15,3,1,12,0,0,0,4
North Melbourne,"Macmillan, Jamie",19,9,3,10,1,1,0,5
North Melbourne,"Mullett, Aaron",17,13,4,4,0,0,0,1
North Melbourne,"Petrie, Drew",9,8,5,1,0,0,1,2
North Melbourne,"Tarrant, Robbie",6,5,3,1,0,1,0,3
North Melbourne,"Thomas, Lindsay",9,8,3,1,2,1,0,2
North Melbourne,"Thompson, Scott",18,9,5,9,0,0,1,2
North Melbourne,"Wells, Daniel",30,18,4,12,2,1,0,1
North Melbourne,"Wright, Sam",16,12,9,4,0,0,0,4
North Melbourne,"Ziebell, Jack",14,9,2,5,0,1,0,9
North Melbourne,"Adams, Leigh",15,5,4,10,0,1,0,1
North Melbourne,"Atley, Shaun",13,9,3,4,0,0,0,4
North Melbourne,"Bastinac, Ryan",21,15,6,6,1,0,0,1
North Melbourne,"Black, Aaron",17,11,8,6,0,2,1,2
North Melbourne,"Cunnington, Ben",24,14,4,10,1,0,0,5
North Melbourne,"Delaney, Luke",9,7,7,2,0,0,0,1
North Melbourne,"Gibson, Sam",10,8,3,2,1,0,0,2
North Melbourne,"Goldstein, Todd",14,3,3,11,0,0,30,6
North Melbourne,"Greenwood, Levi",38,13,2,25,0,0,0,4
North Melbourne,"Grima, Nathan",16,11,5,5,1,0,0,0
North Melbourne,"Hansen, Lachlan",24,14,9,10,0,0,0,1
North Melbourne,"Harvey, Brent",20,12,4,8,0,1,0,1
North Melbourne,"Jacobs, Ben",19,10,2,9,0,2,0,5
North Melbourne,"Macmillan, Jamie",16,8,4,8,1,0,0,2
North Melbourne,"McKenzie, Brad",18,13,6,5,0,0,0,2
North Melbourne,"Mullett, Aaron",16,9,2,7,0,0,0,1
North Melbourne,"Petrie, Drew",20,18,10,2,3,1,6,5
North Melbourne,"Sierakowski, Will",0,0,0,0,0,0,0,1
North Melbourne,"Tarrant, Robbie",10,6,4,4,3,2,0,1
North Melbourne,"Thomas, Lindsay",14,10,4,4,1,1,0,4
North Melbourne,"Wells, Daniel",17,14,5,3,4,0,0,2
North Melbourne,"Wright, Sam",25,15,9,10,1,1,0,0
North Melbourne,"Atley, Shaun",19,10,4,9,0,0,0,4
North Melbourne,"Bastinac, Ryan",19,9,3,10,2,1,0,2
North Melbourne,"Black, Aaron",18,10,5,8,2,1,0,0
North Melbourne,"Cunnington, Ben",25,8,4,17,0,0,0,2
North Melbourne,"Delaney, Luke",10,7,6,3,0,0,0,2
North Melbourne,"Firrito, Michael",18,8,2,10,0,0,0,2
North Melbourne,"Gibson, Sam",28,13,8,15,0,0,0,2
North Melbourne,"Goldstein, Todd",19,10,5,9,2,0,24,4
North Melbourne,"Greenwood, Levi",16,11,2,5,0,0,1,2
North Melbourne,"Hansen, Lachlan",24,12,10,12,0,0,0,3
North Melbourne,"Harvey, Brent",25,13,7,12,1,0,0,1
North Melbourne,"Jacobs, Ben",6,3,1,3,1,0,0,2
North Melbourne,"Macmillan, Jamie",17,9,3,8,1,0,0,3
North Melbourne,"McKenzie, Brad",3,2,1,1,0,0,0,2
North Melbourne,"Mullett, Aaron",20,17,7,3,1,0,0,0
North Melbourne,"Petrie, Drew",17,9,3,8,0,0,3,1
North Melbourne,"Sierakowski, Will",16,11,4,5,0,0,0,2
North Melbourne,"Tarrant, Robbie",9,4,1,5,0,1,0,1
North Melbourne,"Thomas, Lindsay",7,4,2,3,1,1,0,2
North Melbourne,"Wells, Daniel",27,16,6,11,1,1,0,2
North Melbourne,"Wright, Sam",17,9,5,8,1,2,0,2
North Melbourne,"Ziebell, Jack",27,18,5,9,2,0,0,4
North Melbourne,"Atley, Shaun",25,15,8,10,0,0,0,1
North Melbourne,"Bastinac, Ryan",34,17,6,17,1,1,0,6
North Melbourne,"Black, Aaron",19,11,8,8,2,2,2,2
North Melbourne,"Cunnington, Ben",18,13,0,5,1,0,0,2
North Melbourne,"Delaney, Luke",6,5,3,1,0,0,0,2
North Melbourne,"Firrito, Michael",17,9,6,8,0,0,0,3
North Melbourne,"Garner, Taylor",16,7,4,9,0,0,0,4
North Melbourne,"Gibson, Sam",20,12,11,8,0,0,0,0
North Melbourne,"Goldstein, Todd",14,4,2,10,2,0,25,2
North Melbourne,"Hansen, Lachlan",16,9,5,7,0,0,0,1
North Melbourne,"Harvey, Brent",31,15,3,16,1,0,0,4
North Melbourne,"Jacobs, Ben",7,5,0,2,0,0,0,1
North Melbourne,"Macmillan, Jamie",23,11,8,12,1,0,0,1
North Melbourne,"McKenzie, Brad",13,5,3,8,0,0,0,1
North Melbourne,"Mullett, Aaron",16,10,4,6,0,0,0,1
North Melbourne,"Petrie, Drew",21,16,13,5,2,1,3,1
North Melbourne,"Sierakowski, Will",12,9,1,3,0,0,0,1
North Melbourne,"Tarrant, Robbie",12,7,8,5,0,4,1,0
North Melbourne,"Thomas, Lindsay",15,8,1,7,3,0,0,1
North Melbourne,"Wells, Daniel",21,11,2,10,2,0,0,3
North Melbourne,"Wright, Sam",4,2,1,2,0,0,0,1
North Melbourne,"Ziebell, Jack",27,19,7,8,4,0,0,5
Port Adelaide,"Boak, Travis",26,19,3,7,0,1,0,6
Port Adelaide,"Broadbent, Matthew",14,9,4,5,0,0,0,2
Port Adelaide,"Cornes, Kane",29,15,1,14,1,2,0,9
Port Adelaide,"Ebert, Brad",30,24,12,6,0,0,0,4
Port Adelaide,"Hartlett, Hamish",29,17,5,12,2,0,0,2
Port Adelaide,"Heath, Campbell",10,9,6,1,1,0,0,2
Port Adelaide,"Jonas, Tom",11,5,1,6,0,0,0,0
Port Adelaide,"Lobbe, Matthew",15,6,7,9,0,0,11,2
Port Adelaide,"Mitchell, Kane",7,2,1,5,0,1,0,1
Port Adelaide,"Monfries, Angus",18,11,3,7,3,3,1,3
Port Adelaide,"Moore, Andrew",9,4,3,5,1,0,0,3
Port Adelaide,"Neade, Jake",11,6,4,5,0,0,0,4
Port Adelaide,"OShea, Cameron",15,10,4,5,0,0,0,4
Port Adelaide,"Pittard, Jasper",14,12,6,2,1,0,0,0
Port Adelaide,"Redden, Jarrad",8,1,0,7,0,0,19,2
Port Adelaide,"Schulz, Jay",20,12,6,8,4,0,0,5
Port Adelaide,"Stevenson, Lewis",19,12,4,7,0,0,0,3
Port Adelaide,"Stewart, Paul",15,8,5,7,3,2,0,1
Port Adelaide,"Trengove, Jackson",14,6,3,8,0,0,1,2
Port Adelaide,"Westhoff, Justin",19,13,9,6,1,4,0,3
Port Adelaide,"Wines, Ollie",24,12,7,12,1,1,0,3
Port Adelaide,"Wingard, Chad",20,13,4,7,1,1,0,1
Port Adelaide,"Boak, Travis",27,17,7,10,1,0,0,5
Port Adelaide,"Broadbent, Matthew",19,12,6,7,2,1,0,1
Port Adelaide,"Carlile, Alipate",19,10,10,9,0,0,0,1
Port Adelaide,"Cornes, Kane",30,16,4,14,0,0,0,6
Port Adelaide,"Ebert, Brad",25,13,4,12,1,1,0,8
Port Adelaide,"Hartlett, Hamish",10,4,1,6,1,0,0,1
Port Adelaide,"Heath, Campbell",19,13,5,6,0,0,0,2
Port Adelaide,"Jonas, Tom",12,6,2,6,0,0,0,3
Port Adelaide,"Lobbe, Matthew",11,3,5,8,0,0,11,1
Port Adelaide,"Mitchell, Kane",6,3,0,3,1,1,0,0
Port Adelaide,"Monfries, Angus",18,11,5,7,0,1,0,8
Port Adelaide,"Neade, Jake",15,7,5,8,2,1,0,2
Port Adelaide,"OShea, Cameron",19,10,2,9,1,0,0,0
Port Adelaide,"Pittard, Jasper",27,12,5,15,0,0,0,0
Port Adelaide,"Redden, Jarrad",5,2,2,3,0,0,11,2
Port Adelaide,"Schulz, Jay",7,6,3,1,1,2,0,2
Port Adelaide,"Stevenson, Lewis",22,15,6,7,0,0,0,0
Port Adelaide,"Stewart, Paul",18,12,9,6,1,2,0,3
Port Adelaide,"Trengove, Jackson",14,8,3,6,0,0,1,1
Port Adelaide,"Westhoff, Justin",25,20,14,5,5,2,2,3
Port Adelaide,"Wines, Ollie",19,9,5,10,0,1,1,5
Port Adelaide,"Wingard, Chad",22,16,7,6,3,2,0,1
Port Adelaide,"Boak, Travis",30,18,4,12,3,1,0,2
Port Adelaide,"Broadbent, Matthew",21,15,4,6,1,1,0,3
Port Adelaide,"Carlile, Alipate",14,8,5,6,0,0,0,0
Port Adelaide,"Cornes, Kane",30,22,8,8,0,0,0,6
Port Adelaide,"Ebert, Brad",20,12,4,8,0,0,0,2
Port Adelaide,"Hartlett, Hamish",28,19,6,9,0,2,0,3
Port Adelaide,"Heath, Campbell",12,9,4,3,0,0,0,1
Port Adelaide,"Jonas, Tom",14,4,2,10,0,0,0,2
Port Adelaide,"Lobbe, Matthew",12,3,2,9,0,0,24,4
Port Adelaide,"Mitchell, Kane",12,7,2,5,0,1,0,1
Port Adelaide,"Monfries, Angus",22,13,4,9,2,1,0,2
Port Adelaide,"Neade, Jake",9,6,0,3,1,0,0,8
Port Adelaide,"OShea, Cameron",15,9,5,6,0,0,0,4
Port Adelaide,"Pittard, Jasper",11,9,1,2,0,0,0,0
Port Adelaide,"Renouf, Brent",8,4,3,4,0,0,22,2
Port Adelaide,"Schulz, Jay",9,4,4,5,1,1,0,1
Port Adelaide,"Stevenson, Lewis",15,7,2,8,0,0,0,0
Port Adelaide,"Stewart, Paul",4,1,0,3,0,0,0,2
Port Adelaide,"Trengove, Jackson",9,3,1,6,0,0,0,2
Port Adelaide,"Westhoff, Justin",24,15,8,9,4,4,0,6
Port Adelaide,"Wines, Ollie",25,17,9,8,2,0,0,5
Port Adelaide,"Wingard, Chad",25,10,6,15,3,0,0,2
Port Adelaide,"Boak, Travis",30,20,10,10,0,0,0,1
Port Adelaide,"Broadbent, Matthew",19,9,3,10,0,0,0,6
Port Adelaide,"Carlile, Alipate",25,16,9,9,0,0,0,0
Port Adelaide,"Cassisi, Domenic",18,9,2,9,0,0,1,9
Port Adelaide,"Cornes, Kane",35,25,16,10,0,0,0,3
Port Adelaide,"Ebert, Brad",22,15,6,7,0,0,0,2
Port Adelaide,"Gray, Robbie",7,4,2,3,0,0,0,2
Port Adelaide,"Hartlett, Hamish",29,16,7,13,3,1,0,1
Port Adelaide,"Heath, Campbell",16,12,6,4,0,0,0,4
Port Adelaide,"Jonas, Tom",10,4,5,6,0,0,0,2
Port Adelaide,"Lobbe, Matthew",9,3,2,6,0,0,16,0
Port Adelaide,"Monfries, Angus",22,6,5,16,0,0,0,3
Port Adelaide,"Neade, Jake",10,9,1,1,2,0,0,2
Port Adelaide,"OShea, Cameron",17,10,7,7,0,0,0,1
Port Adelaide,"Pittard, Jasper",22,15,8,7,0,0,0,3
Port Adelaide,"Renouf, Brent",7,3,2,4,1,0,16,0
Port Adelaide,"Schulz, Jay",17,8,5,9,4,1,0,2
Port Adelaide,"Stevenson, Lewis",17,13,4,4,0,0,0,2
Port Adelaide,"Trengove, Jackson",13,6,4,7,0,0,0,4
Port Adelaide,"Westhoff, Justin",20,15,11,5,3,3,0,3
Port Adelaide,"Wines, Ollie",25,16,8,9,0,0,0,3
Port Adelaide,"Wingard, Chad",16,10,4,6,3,0,0,2
Port Adelaide,"Boak, Travis",20,11,4,9,2,0,0,4
Port Adelaide,"Broadbent, Matthew",15,11,5,4,1,0,0,3
Port Adelaide,"Carlile, Alipate",15,5,2,10,0,0,0,3
Port Adelaide,"Cassisi, Domenic",17,9,1,8,0,0,0,3
Port Adelaide,"Cornes, Kane",26,12,8,14,1,0,0,3
Port Adelaide,"Ebert, Brad",22,15,6,7,0,1,0,2
Port Adelaide,"Gray, Robbie",12,6,2,6,0,0,0,1
Port Adelaide,"Hartlett, Hamish",23,18,4,5,2,2,0,6
Port Adelaide,"Heath, Campbell",16,13,1,3,0,0,0,5
Port Adelaide,"Jonas, Tom",14,5,2,9,0,0,0,4
Port Adelaide,"Lobbe, Matthew",16,7,4,9,0,0,13,1
Port Adelaide,"Monfries, Angus",12,7,1,5,2,2,0,3
Port Adelaide,"Neade, Jake",13,13,4,0,1,2,0,3
Port Adelaide,"OShea, Cameron",23,13,4,10,0,1,0,4
Port Adelaide,"Renouf, Brent",11,3,2,8,0,0,15,3
Port Adelaide,"Schulz, Jay",12,8,1,4,0,2,0,2
Port Adelaide,"Stevenson, Lewis",21,12,5,9,0,0,0,3
Port Adelaide,"Stewart, Paul",11,6,4,5,1,0,1,3
Port Adelaide,"Trengove, Jackson",7,2,1,5,0,0,0,3
Port Adelaide,"Westhoff, Justin",13,8,2,5,0,1,2,1
Port Adelaide,"Wines, Ollie",22,6,3,16,0,0,0,4
Port Adelaide,"Wingard, Chad",25,12,2,13,2,1,0,3
Port Adelaide,"Boak, Travis",30,19,4,11,0,0,0,5
Port Adelaide,"Broadbent, Matthew",14,9,2,5,1,0,1,1
Port Adelaide,"Carlile, Alipate",9,3,1,6,0,0,0,2
Port Adelaide,"Cassisi, Domenic",18,10,7,8,0,0,0,4
Port Adelaide,"Cornes, Kane",29,12,3,17,0,1,0,7
Port Adelaide,"Ebert, Brad",19,11,5,8,0,0,0,5
Port Adelaide,"Gray, Robbie",20,12,2,8,1,3,0,5
Port Adelaide,"Hartlett, Hamish",7,4,0,3,0,0,0,5
Port Adelaide,"Heath, Campbell",6,3,1,3,0,0,0,7
Port Adelaide,"Jonas, Tom",10,4,1,6,0,0,0,3
Port Adelaide,"Lobbe, Matthew",10,4,3,6,1,0,17,2
Port Adelaide,"Mitchell, Kane",15,5,1,10,0,0,0,0
Port Adelaide,"Monfries, Angus",17,7,2,10,1,0,0,6
Port Adelaide,"Neade, Jake",10,6,2,4,1,1,0,5
Port Adelaide,"OShea, Cameron",10,6,4,4,0,0,0,5
Port Adelaide,"Renouf, Brent",3,1,0,2,1,0,12,1
Port Adelaide,"Schulz, Jay",15,9,7,6,3,0,0,4
Port Adelaide,"Stevenson, Lewis",9,6,2,3,0,0,0,2
Port Adelaide,"Stewart, Paul",5,3,2,2,0,0,0,2
Port Adelaide,"Westhoff, Justin",11,5,3,6,0,2,1,0
Port Adelaide,"Wines, Ollie",18,8,2,10,1,0,0,6
Port Adelaide,"Wingard, Chad",22,12,4,10,2,1,0,1
Port Adelaide,"Boak, Travis",24,14,1,10,0,0,0,7
Port Adelaide,"Broadbent, Matthew",16,6,4,10,1,1,0,3
Port Adelaide,"Carlile, Alipate",9,3,2,6,0,0,0,2
Port Adelaide,"Colquhoun, Sam",17,7,2,10,0,0,0,1
Port Adelaide,"Cornes, Kane",29,13,4,16,0,0,0,4
Port Adelaide,"Ebert, Brad",19,8,4,11,0,0,2,7
Port Adelaide,"Gray, Robbie",14,8,6,6,1,0,0,3
Port Adelaide,"Hartlett, Hamish",10,8,1,2,0,1,0,2
Port Adelaide,"Heath, Campbell",8,4,3,4,0,0,0,1
Port Adelaide,"Jonas, Tom",15,5,4,10,0,0,0,2
Port Adelaide,"Mitchell, Kane",13,5,3,8,2,1,0,1
Port Adelaide,"Monfries, Angus",15,7,5,8,1,0,0,3
Port Adelaide,"Moore, Andrew",13,9,3,4,1,0,0,2
Port Adelaide,"Neade, Jake",7,3,1,4,0,1,0,2
Port Adelaide,"OShea, Cameron",12,9,6,3,0,0,0,3
Port Adelaide,"Redden, Jarrad",14,7,7,7,0,0,25,2
Port Adelaide,"Schulz, Jay",17,11,7,6,3,1,0,1
Port Adelaide,"Stevenson, Lewis",12,6,1,6,0,0,0,3
Port Adelaide,"Stewart, Daniel",4,2,2,2,0,1,1,0
Port Adelaide,"Westhoff, Justin",15,10,2,5,0,1,5,2
Port Adelaide,"Wines, Ollie",17,7,2,10,0,0,0,3
Port Adelaide,"Wingard, Chad",18,8,5,10,1,2,0,0
Port Adelaide,"Boak, Travis",18,12,2,6,1,1,0,3
Port Adelaide,"Broadbent, Matthew",13,9,4,4,0,0,0,5
Port Adelaide,"Carlile, Alipate",12,9,4,3,1,0,0,2
Port Adelaide,"Cassisi, Domenic",10,4,1,6,0,0,0,2
Port Adelaide,"Cornes, Kane",23,13,5,10,0,0,0,8
Port Adelaide,"Ebert, Brad",19,13,5,6,1,0,1,6
Port Adelaide,"Gray, Robbie",16,6,0,10,2,0,0,7
Port Adelaide,"Hartlett, Hamish",14,7,0,7,0,0,1,7
Port Adelaide,"Jonas, Tom",14,5,5,9,0,0,0,4
Port Adelaide,"Lobbe, Matthew",9,2,3,7,0,0,20,2
Port Adelaide,"Mitchell, Kane",11,7,4,4,0,1,0,1
Port Adelaide,"Monfries, Angus",19,10,4,9,1,3,0,4
Port Adelaide,"Moore, Andrew",13,10,7,3,3,0,0,5
Port Adelaide,"Neade, Jake",13,7,0,6,0,0,0,2
Port Adelaide,"OShea, Cameron",14,8,3,6,0,0,0,6
Port Adelaide,"Redden, Jarrad",9,5,3,4,1,1,16,4
Port Adelaide,"Schulz, Jay",10,3,1,7,2,0,0,2
Port Adelaide,"Stevenson, Lewis",12,7,3,5,0,0,0,4
Port Adelaide,"Stewart, Paul",5,3,1,2,0,1,0,2
Port Adelaide,"Westhoff, Justin",19,8,4,11,1,0,2,1
Port Adelaide,"Wines, Ollie",18,7,4,11,0,0,0,5
Port Adelaide,"Wingard, Chad",22,15,4,7,1,0,1,0
Port Adelaide,"Boak, Travis",28,11,6,17,0,2,0,6
Port Adelaide,"Broadbent, Matthew",10,5,0,5,0,0,0,0
Port Adelaide,"Butcher, John",11,4,4,7,0,0,0,2
Port Adelaide,"Carlile, Alipate",15,10,6,5,0,0,0,1
Port Adelaide,"Colquhoun, Sam",15,7,5,8,0,0,0,0
Port Adelaide,"Cornes, Kane",21,12,5,9,0,0,0,2
Port Adelaide,"Ebert, Brad",17,16,4,1,0,0,0,5
Port Adelaide,"Gray, Robbie",23,13,2,10,0,1,0,4
Port Adelaide,"Hartlett, Hamish",21,18,4,3,0,0,0,2
Port Adelaide,"Heath, Campbell",13,10,3,3,0,0,0,1
Port Adelaide,"Jonas, Tom",16,8,4,8,0,0,0,3
Port Adelaide,"Logan, Tom",18,6,3,12,0,0,0,4
Port Adelaide,"Mitchell, Kane",10,5,3,5,2,0,0,2
Port Adelaide,"Monfries, Angus",20,9,6,11,1,2,0,2
Port Adelaide,"Moore, Andrew",8,6,4,2,0,0,0,3
Port Adelaide,"OShea, Cameron",16,4,3,12,0,0,0,3
Port Adelaide,"Redden, Jarrad",11,4,3,7,1,1,22,2
Port Adelaide,"Schulz, Jay",16,11,5,5,3,1,0,1
Port Adelaide,"Thomas, Matt",18,6,3,12,2,0,0,3
Port Adelaide,"Westhoff, Justin",19,10,7,9,0,1,8,4
Port Adelaide,"Wines, Ollie",21,10,2,11,0,1,0,2
Port Adelaide,"Wingard, Chad",26,13,8,13,0,3,0,3
Port Adelaide,"Boak, Travis",14,8,1,6,1,1,0,6
Port Adelaide,"Broadbent, Matthew",12,7,2,5,0,0,0,6
Port Adelaide,"Butcher, John",7,5,2,2,1,0,0,0
Port Adelaide,"Carlile, Alipate",10,6,0,4,0,0,0,2
Port Adelaide,"Cornes, Kane",28,19,5,9,0,0,0,5
Port Adelaide,"Ebert, Brad",23,14,3,9,1,0,1,7
Port Adelaide,"Gray, Robbie",6,3,1,3,0,1,0,5
Port Adelaide,"Hartlett, Hamish",21,14,2,7,0,0,3,3
Port Adelaide,"Heath, Campbell",7,4,1,3,0,0,0,3
Port Adelaide,"Hitchcock, Cameron",13,10,2,3,1,1,0,3
Port Adelaide,"Hombsch, Jack",22,9,4,13,0,0,0,5
Port Adelaide,"Jonas, Tom",16,9,4,7,0,0,0,3
Port Adelaide,"Logan, Tom",22,11,3,11,1,0,0,4
Port Adelaide,"Mitchell, Kane",7,4,1,3,0,0,0,7
Port Adelaide,"Monfries, Angus",21,10,7,11,0,1,0,4
Port Adelaide,"Neade, Jake",7,5,0,2,0,0,0,6
Port Adelaide,"OShea, Cameron",25,11,8,14,0,0,1,4
Port Adelaide,"Redden, Jarrad",12,5,4,7,0,0,26,2
Port Adelaide,"Schulz, Jay",10,9,8,1,0,3,0,1
Port Adelaide,"Westhoff, Justin",18,8,4,10,1,1,7,10
Port Adelaide,"Wines, Ollie",18,9,1,9,0,1,0,4
Port Adelaide,"Wingard, Chad",22,18,2,4,2,1,0,7
Port Adelaide,"Boak, Travis",29,18,8,11,3,0,0,1
Port Adelaide,"Broadbent, Matthew",21,11,3,10,0,0,0,2
Port Adelaide,"Butcher, John",10,7,3,3,2,2,0,1
Port Adelaide,"Carlile, Alipate",16,8,5,8,0,0,0,4
Port Adelaide,"Cornes, Kane",34,19,6,15,1,0,0,3
Port Adelaide,"Ebert, Brad",30,15,12,15,0,1,1,1
Port Adelaide,"Gray, Robbie",7,4,3,3,0,0,0,1
Port Adelaide,"Hartlett, Hamish",27,12,4,15,1,0,1,4
Port Adelaide,"Hitchcock, Cameron",7,3,1,4,0,0,0,2
Port Adelaide,"Hombsch, Jack",26,15,9,11,0,0,0,0
Port Adelaide,"Jonas, Tom",17,7,3,10,0,0,0,1
Port Adelaide,"Lobbe, Matthew",12,8,2,4,0,0,34,3
Port Adelaide,"Logan, Tom",19,6,4,13,2,0,0,1
Port Adelaide,"Monfries, Angus",30,13,1,17,3,0,0,2
Port Adelaide,"Neade, Jake",11,7,2,4,0,0,0,2
Port Adelaide,"OShea, Cameron",30,9,4,21,2,0,1,4
Port Adelaide,"Schulz, Jay",19,12,11,7,3,1,0,3
Port Adelaide,"Stewart, Paul",18,11,7,7,0,0,0,3
Port Adelaide,"Thomas, Matt",17,5,3,12,0,1,0,4
Port Adelaide,"Westhoff, Justin",15,6,4,9,1,0,5,3
Port Adelaide,"Wines, Ollie",24,10,2,14,0,2,1,3
Port Adelaide,"Wingard, Chad",31,18,2,13,1,1,0,5
Port Adelaide,"Broadbent, Matthew",23,18,10,5,1,3,0,3
Port Adelaide,"Carlile, Alipate",8,5,1,3,0,0,0,5
Port Adelaide,"Cassisi, Domenic",20,8,0,12,0,0,0,8
Port Adelaide,"Cornes, Kane",21,10,2,11,0,0,0,3
Port Adelaide,"Ebert, Brad",26,17,2,9,0,0,2,9
Port Adelaide,"Gray, Robbie",24,16,3,8,1,0,1,5
Port Adelaide,"Hartlett, Hamish",21,11,1,10,0,1,0,8
Port Adelaide,"Heath, Campbell",10,8,4,2,0,0,0,3
Port Adelaide,"Hombsch, Jack",14,9,2,5,0,0,0,5
Port Adelaide,"Jonas, Tom",12,7,3,5,0,0,0,2
Port Adelaide,"Lobbe, Matthew",9,5,2,4,0,0,37,11
Port Adelaide,"Logan, Tom",18,9,5,9,0,2,0,5
Port Adelaide,"Monfries, Angus",17,9,4,8,2,1,0,2
Port Adelaide,"Moore, Andrew",20,13,2,7,0,0,1,5
Port Adelaide,"Neade, Jake",12,6,0,6,1,1,0,5
Port Adelaide,"OShea, Cameron",16,10,6,6,0,0,0,4
Port Adelaide,"Pittard, Jasper",6,4,2,2,0,0,0,0
Port Adelaide,"Schulz, Jay",19,10,5,9,1,2,0,1
Port Adelaide,"Thomas, Matt",7,3,2,4,0,0,0,5
Port Adelaide,"Westhoff, Justin",21,16,4,5,1,1,4,4
Port Adelaide,"Wines, Ollie",20,14,2,6,0,0,1,1
Port Adelaide,"Wingard, Chad",20,17,4,3,3,0,0,4
Port Adelaide,"Boak, Travis",29,18,3,11,1,0,0,5
Port Adelaide,"Broadbent, Matthew",34,22,7,12,0,2,0,1
Port Adelaide,"Carlile, Alipate",16,9,3,7,0,0,0,0
Port Adelaide,"Cassisi, Domenic",4,1,0,3,0,0,0,1
Port Adelaide,"Cornes, Kane",31,17,5,14,0,0,0,6
Port Adelaide,"Ebert, Brad",30,22,9,8,1,0,2,6
Port Adelaide,"Gray, Robbie",20,13,9,7,0,1,0,1
Port Adelaide,"Hartlett, Hamish",23,14,6,9,0,0,0,3
Port Adelaide,"Hombsch, Jack",12,10,10,2,0,0,0,2
Port Adelaide,"Jonas, Tom",16,9,5,7,0,0,0,4
Port Adelaide,"Lobbe, Matthew",8,3,0,5,0,0,23,7
Port Adelaide,"Logan, Tom",16,5,2,11,0,0,0,2
Port Adelaide,"Monfries, Angus",14,7,2,7,2,1,0,4
Port Adelaide,"Moore, Andrew",25,9,3,16,0,0,0,6
Port Adelaide,"Neade, Jake",12,4,2,8,0,0,0,2
Port Adelaide,"OShea, Cameron",19,11,7,8,0,1,0,3
Port Adelaide,"Pittard, Jasper",10,6,5,4,0,0,0,4
Port Adelaide,"Schulz, Jay",17,10,7,7,3,1,0,2
Port Adelaide,"Trengove, Jackson",16,7,4,9,0,0,3,2
Port Adelaide,"Westhoff, Justin",20,12,7,8,3,0,1,1
Port Adelaide,"Wines, Ollie",26,13,4,13,1,0,1,5
Port Adelaide,"Wingard, Chad",21,13,2,8,2,2,0,3
Port Adelaide,"Boak, Travis",23,11,6,12,0,2,0,5
Port Adelaide,"Broadbent, Matthew",15,12,3,3,0,0,0,2
Port Adelaide,"Carlile, Alipate",13,8,2,5,0,0,0,0
Port Adelaide,"Cornes, Kane",23,8,3,15,0,0,0,8
Port Adelaide,"Ebert, Brad",36,27,8,9,0,0,1,4
Port Adelaide,"Gray, Robbie",20,13,6,7,3,1,0,5
Port Adelaide,"Hartlett, Hamish",20,12,1,8,2,1,0,5
Port Adelaide,"Hombsch, Jack",8,3,1,5,0,0,0,0
Port Adelaide,"Jonas, Tom",8,3,0,5,0,0,0,4
Port Adelaide,"Lobbe, Matthew",12,4,0,8,0,0,42,5
Port Adelaide,"Logan, Tom",8,1,2,7,0,0,0,3
Port Adelaide,"Monfries, Angus",18,12,5,6,4,2,0,5
Port Adelaide,"Moore, Andrew",20,14,4,6,0,0,0,1
Port Adelaide,"Neade, Jake",4,3,0,1,0,0,0,2
Port Adelaide,"OShea, Cameron",15,6,3,9,0,0,0,1
Port Adelaide,"Pittard, Jasper",10,5,0,5,0,1,0,1
Port Adelaide,"Schulz, Jay",15,11,10,4,0,1,0,2
Port Adelaide,"Stewart, Paul",7,1,3,6,0,1,0,1
Port Adelaide,"Trengove, Jackson",13,8,3,5,1,1,2,1
Port Adelaide,"Westhoff, Justin",17,11,6,6,0,2,2,1
Port Adelaide,"Wines, Ollie",24,9,4,15,0,2,1,6
Port Adelaide,"Wingard, Chad",17,13,7,4,2,0,0,1
Port Adelaide,"Boak, Travis",34,13,2,21,1,0,0,4
Port Adelaide,"Broadbent, Matthew",20,10,2,10,0,0,0,1
Port Adelaide,"Butcher, John",10,7,6,3,1,2,0,1
Port Adelaide,"Carlile, Alipate",12,5,4,7,0,0,0,3
Port Adelaide,"Cornes, Kane",25,10,5,15,1,0,0,3
Port Adelaide,"Ebert, Brad",27,15,6,12,1,1,1,1
Port Adelaide,"Gray, Robbie",19,11,2,8,1,1,0,3
Port Adelaide,"Hartlett, Hamish",12,5,0,7,0,2,0,5
Port Adelaide,"Jonas, Tom",15,8,2,7,0,0,0,3
Port Adelaide,"Lobbe, Matthew",8,6,0,2,0,0,25,6
Port Adelaide,"Logan, Tom",9,3,1,6,0,0,0,2
Port Adelaide,"Monfries, Angus",15,10,4,5,2,0,0,1
Port Adelaide,"Moore, Andrew",17,8,3,9,0,0,1,4
Port Adelaide,"Neade, Jake",3,2,2,1,2,0,0,2
Port Adelaide,"OShea, Cameron",17,10,3,7,0,0,1,6
Port Adelaide,"Pittard, Jasper",14,6,4,8,0,0,0,2
Port Adelaide,"Schulz, Jay",18,11,5,7,1,0,0,0
Port Adelaide,"Stewart, Paul",17,2,2,15,0,0,0,3
Port Adelaide,"Thomas, Matt",21,4,4,17,1,0,1,2
Port Adelaide,"Trengove, Jackson",13,7,3,6,0,0,3,0
Port Adelaide,"Wines, Ollie",15,4,2,11,0,0,0,5
Port Adelaide,"Wingard, Chad",22,12,2,10,1,0,0,2
Port Adelaide,"Boak, Travis",18,4,0,14,0,0,0,3
Port Adelaide,"Broadbent, Matthew",25,20,5,5,0,0,0,1
Port Adelaide,"Butcher, John",7,5,4,2,3,1,0,0
Port Adelaide,"Carlile, Alipate",5,3,3,2,0,0,0,2
Port Adelaide,"Colquhoun, Sam",8,4,3,4,0,0,0,2
Port Adelaide,"Ebert, Brad",20,15,6,5,0,0,1,2
Port Adelaide,"Gray, Robbie",19,9,2,10,1,4,0,4
Port Adelaide,"Hartlett, Hamish",20,13,5,7,0,2,0,7
Port Adelaide,"Jonas, Tom",8,8,3,0,0,0,0,4
Port Adelaide,"Lobbe, Matthew",17,10,5,7,1,0,40,7
Port Adelaide,"Mitchell, Kane",10,6,3,4,1,0,0,1
Port Adelaide,"Monfries, Angus",13,7,4,6,1,0,0,2
Port Adelaide,"Moore, Andrew",11,3,2,8,0,0,0,2
Port Adelaide,"Neade, Jake",2,1,0,1,0,0,0,3
Port Adelaide,"OShea, Cameron",15,10,4,5,0,0,1,4
Port Adelaide,"Pittard, Jasper",16,14,5,2,2,1,0,2
Port Adelaide,"Schulz, Jay",12,6,6,6,1,1,0,3
Port Adelaide,"Stewart, Paul",15,12,7,3,0,1,0,1
Port Adelaide,"Trengove, Jackson",9,2,2,7,0,0,0,4
Port Adelaide,"Westhoff, Justin",18,9,7,9,2,1,2,3
Port Adelaide,"Wines, Ollie",8,4,0,4,0,0,1,3
Port Adelaide,"Wingard, Chad",22,14,9,8,2,1,1,2
Port Adelaide,"Boak, Travis",27,14,5,13,0,1,0,6
Port Adelaide,"Broadbent, Matthew",22,17,3,5,0,0,0,1
Port Adelaide,"Butcher, John",14,4,2,10,1,1,0,1
Port Adelaide,"Carlile, Alipate",11,5,3,6,0,0,0,0
Port Adelaide,"Cassisi, Domenic",12,5,1,7,0,0,0,3
Port Adelaide,"Colquhoun, Sam",7,4,2,3,0,0,0,0
Port Adelaide,"Cornes, Kane",20,13,4,7,0,1,0,5
Port Adelaide,"Ebert, Brad",18,12,3,6,0,0,1,6
Port Adelaide,"Gray, Robbie",12,4,1,8,0,2,0,7
Port Adelaide,"Hartlett, Hamish",26,16,5,10,0,3,0,4
Port Adelaide,"Lobbe, Matthew",8,4,3,4,0,0,21,6
Port Adelaide,"Mitchell, Kane",19,13,4,6,1,2,0,5
Port Adelaide,"Monfries, Angus",17,8,3,9,1,0,0,4
Port Adelaide,"Moore, Andrew",25,11,2,14,1,0,0,3
Port Adelaide,"OShea, Cameron",21,11,8,10,0,0,0,3
Port Adelaide,"Pittard, Jasper",18,8,4,10,0,0,0,0
Port Adelaide,"Schulz, Jay",21,12,9,9,2,0,1,2
Port Adelaide,"Stewart, Paul",17,11,4,6,0,1,0,3
Port Adelaide,"Trengove, Jackson",8,3,2,5,0,0,0,5
Port Adelaide,"Westhoff, Justin",16,9,3,7,1,1,8,4
Port Adelaide,"Wines, Ollie",20,11,5,9,1,0,0,5
Port Adelaide,"Wingard, Chad",22,13,1,9,1,2,0,1
Port Adelaide,"Boak, Travis",29,13,3,16,0,0,0,3
Port Adelaide,"Broadbent, Matthew",13,10,3,3,0,0,0,2
Port Adelaide,"Butcher, John",6,1,0,5,1,0,0,2
Port Adelaide,"Carlile, Alipate",10,7,4,3,0,0,0,5
Port Adelaide,"Cassisi, Domenic",10,4,2,6,0,0,0,3
Port Adelaide,"Colquhoun, Sam",16,12,4,4,1,0,0,0
Port Adelaide,"Cornes, Kane",31,16,7,15,0,0,0,2
Port Adelaide,"Ebert, Brad",18,7,2,11,0,0,0,6
Port Adelaide,"Gray, Robbie",19,10,2,9,3,1,0,4
Port Adelaide,"Hartlett, Hamish",25,16,5,9,3,0,0,5
Port Adelaide,"Lobbe, Matthew",15,10,1,5,0,0,32,2
Port Adelaide,"Mitchell, Kane",12,6,2,6,0,0,0,9
Port Adelaide,"Monfries, Angus",12,6,4,6,2,0,0,2
Port Adelaide,"Moore, Andrew",16,9,2,7,0,0,0,5
Port Adelaide,"OShea, Cameron",16,9,2,7,0,0,2,4
Port Adelaide,"Pittard, Jasper",14,8,5,6,0,0,0,3
Port Adelaide,"Schulz, Jay",16,13,7,3,2,1,0,5
Port Adelaide,"Stewart, Paul",0,0,1,0,0,0,0,0
Port Adelaide,"Trengove, Jackson",15,5,3,10,0,0,5,2
Port Adelaide,"Westhoff, Justin",11,6,3,5,0,0,3,1
Port Adelaide,"Wines, Ollie",11,6,2,5,0,0,3,7
Port Adelaide,"Wingard, Chad",24,15,6,9,5,0,0,0
Port Adelaide,"Blee, Nathan",18,9,4,9,0,0,0,5
Port Adelaide,"Boak, Travis",30,15,9,15,1,1,0,3
Port Adelaide,"Broadbent, Matthew",12,7,2,5,0,0,0,1
Port Adelaide,"Butcher, John",2,0,0,2,0,0,0,2
Port Adelaide,"Carlile, Alipate",7,2,3,5,0,0,0,0
Port Adelaide,"Cassisi, Domenic",14,8,2,6,0,0,0,2
Port Adelaide,"Colquhoun, Sam",18,14,8,4,1,0,0,0
Port Adelaide,"Cornes, Kane",26,11,5,15,0,0,0,5
Port Adelaide,"Ebert, Brad",24,10,3,14,1,0,0,9
Port Adelaide,"Gray, Robbie",24,13,4,11,0,0,0,1
Port Adelaide,"Hartlett, Hamish",16,9,2,7,1,3,0,8
Port Adelaide,"Lobbe, Matthew",17,8,5,9,1,0,59,6
Port Adelaide,"Mitchell, Kane",5,4,3,1,0,1,0,0
Port Adelaide,"Monfries, Angus",19,12,8,7,7,0,0,1
Port Adelaide,"Moore, Andrew",12,7,2,5,1,1,0,6
Port Adelaide,"OShea, Cameron",20,14,7,6,0,0,0,1
Port Adelaide,"Pittard, Jasper",17,9,4,8,0,0,0,3
Port Adelaide,"Schulz, Jay",15,9,7,6,2,1,0,2
Port Adelaide,"Trengove, Jackson",11,3,2,8,0,0,0,1
Port Adelaide,"Westhoff, Justin",20,15,10,5,0,0,5,6
Port Adelaide,"Wines, Ollie",12,6,3,6,0,0,0,3
Port Adelaide,"Wingard, Chad",21,12,2,9,1,0,0,0
Port Adelaide,"Blee, Nathan",11,3,3,8,0,0,0,0
Port Adelaide,"Boak, Travis",35,19,9,16,3,1,0,4
Port Adelaide,"Broadbent, Matthew",26,20,7,6,0,2,0,2
Port Adelaide,"Carlile, Alipate",17,12,5,5,0,0,0,1
Port Adelaide,"Cornes, Kane",26,15,5,11,1,0,0,4
Port Adelaide,"Ebert, Brad",29,15,2,14,1,0,0,7
Port Adelaide,"Gray, Robbie",21,7,4,14,0,0,0,3
Port Adelaide,"Hartlett, Hamish",20,10,5,10,0,0,0,4
Port Adelaide,"Heath, Campbell",13,9,5,4,2,1,0,1
Port Adelaide,"Hitchcock, Cameron",5,3,1,2,0,1,0,0
Port Adelaide,"Jonas, Tom",8,4,1,4,0,0,0,0
Port Adelaide,"Lobbe, Matthew",11,7,3,4,0,0,42,3
Port Adelaide,"Monfries, Angus",24,13,9,11,0,0,0,3
Port Adelaide,"Moore, Andrew",18,10,6,8,1,3,0,6
Port Adelaide,"OShea, Cameron",20,10,5,10,0,0,0,4
Port Adelaide,"Pittard, Jasper",9,8,5,1,0,0,0,0
Port Adelaide,"Schulz, Jay",16,10,8,6,3,2,0,1
Port Adelaide,"Trengove, Jackson",19,8,7,11,0,0,2,4
Port Adelaide,"Westhoff, Justin",13,9,5,4,2,1,1,3
Port Adelaide,"Wines, Ollie",15,7,0,8,0,1,0,1
Port Adelaide,"Wingard, Chad",19,13,7,6,2,1,0,2
Port Adelaide,"Young, Aaron",16,6,5,10,1,1,0,1
Port Adelaide,"Boak, Travis",18,8,0,10,0,0,1,5
Port Adelaide,"Broadbent, Matthew",17,8,5,9,0,0,0,3
Port Adelaide,"Carlile, Alipate",6,0,0,6,0,0,0,1
Port Adelaide,"Colquhoun, Sam",16,12,6,4,0,0,0,6
Port Adelaide,"Cornes, Kane",29,17,6,12,0,0,0,2
Port Adelaide,"Ebert, Brad",15,10,6,5,1,0,0,3
Port Adelaide,"Gray, Robbie",28,19,6,9,1,0,0,5
Port Adelaide,"Heath, Campbell",9,4,1,5,0,1,0,4
Port Adelaide,"Jonas, Tom",15,7,3,8,0,1,0,1
Port Adelaide,"Lobbe, Matthew",14,8,1,6,0,1,43,15
Port Adelaide,"Mitchell, Kane",16,10,2,6,1,0,0,5
Port Adelaide,"Monfries, Angus",17,8,5,9,1,1,0,2
Port Adelaide,"Moore, Andrew",20,11,2,9,1,0,0,6
Port Adelaide,"Neade, Jake",8,5,1,3,1,0,0,6
Port Adelaide,"OShea, Cameron",14,3,0,11,0,0,0,4
Port Adelaide,"Pittard, Jasper",23,13,9,10,0,0,0,7
Port Adelaide,"Schulz, Jay",8,6,6,2,1,0,0,2
Port Adelaide,"Trengove, Jackson",7,4,3,3,0,0,1,1
Port Adelaide,"Westhoff, Justin",22,11,6,11,0,0,2,2
Port Adelaide,"Wines, Ollie",21,9,2,12,0,0,0,6
Port Adelaide,"Wingard, Chad",20,11,5,9,1,0,0,1
Port Adelaide,"Young, Aaron",10,4,3,6,1,0,0,1
Port Adelaide,"Boak, Travis",22,15,4,7,1,0,0,4
Port Adelaide,"Broadbent, Matthew",21,13,5,8,0,1,0,4
Port Adelaide,"Cassisi, Domenic",18,5,3,13,0,0,0,3
Port Adelaide,"Colquhoun, Sam",20,10,9,10,0,0,0,0
Port Adelaide,"Cornes, Kane",35,21,12,14,0,0,0,4
Port Adelaide,"Ebert, Brad",23,17,5,6,4,1,0,3
Port Adelaide,"Hombsch, Jack",15,10,7,5,0,0,0,1
Port Adelaide,"Jonas, Tom",7,2,3,5,0,0,0,2
Port Adelaide,"Lobbe, Matthew",11,4,3,7,0,1,21,5
Port Adelaide,"Logan, Tom",19,13,8,6,1,0,0,2
Port Adelaide,"Monfries, Angus",17,8,5,9,1,3,0,2
Port Adelaide,"Moore, Andrew",16,12,4,4,0,0,0,2
Port Adelaide,"OShea, Cameron",24,13,6,11,0,0,1,1
Port Adelaide,"Pittard, Jasper",8,6,2,2,0,0,0,2
Port Adelaide,"Renouf, Brent",4,1,1,3,0,0,14,2
Port Adelaide,"Schulz, Jay",17,10,8,7,4,1,0,1
Port Adelaide,"Stevenson, Lewis",5,3,1,2,0,0,0,2
Port Adelaide,"Trengove, Jackson",14,5,3,9,0,0,0,1
Port Adelaide,"Westhoff, Justin",21,14,6,7,2,0,0,3
Port Adelaide,"Wines, Ollie",16,5,5,11,0,0,0,5
Port Adelaide,"Wingard, Chad",14,10,2,4,1,1,0,4
Port Adelaide,"Young, Aaron",18,8,7,10,1,1,0,2
Port Adelaide,"Boak, Travis",14,9,3,5,2,1,0,3
Port Adelaide,"Broadbent, Matthew",16,12,2,4,0,1,0,0
Port Adelaide,"Carlile, Alipate",10,8,5,2,0,0,0,0
Port Adelaide,"Cassisi, Domenic",12,6,2,6,0,0,1,6
Port Adelaide,"Colquhoun, Sam",11,5,2,6,0,0,0,0
Port Adelaide,"Cornes, Kane",28,17,5,11,0,0,0,5
Port Adelaide,"Ebert, Brad",24,18,5,6,0,1,0,9
Port Adelaide,"Gray, Robbie",8,5,2,3,0,0,0,2
Port Adelaide,"Hartlett, Hamish",21,12,3,9,0,1,1,0
Port Adelaide,"Jonas, Tom",16,7,8,9,0,0,0,1
Port Adelaide,"Lobbe, Matthew",14,8,5,6,0,0,29,6
Port Adelaide,"Logan, Tom",24,14,10,10,0,0,0,3
Port Adelaide,"Monfries, Angus",15,12,6,3,1,2,0,1
Port Adelaide,"Moore, Andrew",19,9,4,10,0,0,0,1
Port Adelaide,"OShea, Cameron",25,15,14,10,0,0,0,1
Port Adelaide,"Pittard, Jasper",15,12,6,3,0,0,0,3
Port Adelaide,"Schulz, Jay",15,10,8,5,3,3,0,4
Port Adelaide,"Trengove, Jackson",5,4,3,1,0,0,5,1
Port Adelaide,"Westhoff, Justin",10,7,6,3,1,1,0,4
Port Adelaide,"Wines, Ollie",18,9,4,9,2,0,0,3
Port Adelaide,"Wingard, Chad",19,12,7,7,3,1,0,0
Port Adelaide,"Young, Aaron",13,7,6,6,0,0,1,3
Port Adelaide,"Boak, Travis",26,9,5,17,0,1,0,5
Port Adelaide,"Broadbent, Matthew",23,13,2,10,1,0,0,1
Port Adelaide,"Carlile, Alipate",12,8,4,4,0,0,0,1
Port Adelaide,"Cassisi, Domenic",13,10,3,3,0,0,0,4
Port Adelaide,"Colquhoun, Sam",13,7,6,6,0,1,0,1
Port Adelaide,"Cornes, Kane",21,8,3,13,0,0,0,4
Port Adelaide,"Ebert, Brad",19,13,6,6,1,0,2,5
Port Adelaide,"Gray, Robbie",18,11,3,7,1,0,0,4
Port Adelaide,"Hartlett, Hamish",19,12,6,7,1,1,0,2
Port Adelaide,"Jonas, Tom",11,8,5,3,0,0,0,1
Port Adelaide,"Lobbe, Matthew",9,4,1,5,1,0,28,9
Port Adelaide,"Logan, Tom",17,8,7,9,1,1,0,0
Port Adelaide,"Monfries, Angus",16,7,4,9,1,0,0,3
Port Adelaide,"Moore, Andrew",18,11,7,7,0,1,1,7
Port Adelaide,"OShea, Cameron",19,11,6,8,0,0,0,2
Port Adelaide,"Pittard, Jasper",11,4,3,7,0,0,1,1
Port Adelaide,"Schulz, Jay",9,5,2,4,2,1,0,3
Port Adelaide,"Trengove, Jackson",12,4,3,8,0,0,0,1
Port Adelaide,"Westhoff, Justin",19,16,5,3,3,0,2,4
Port Adelaide,"Wines, Ollie",14,7,2,7,0,1,1,0
Port Adelaide,"Wingard, Chad",19,9,2,10,0,0,0,2
Port Adelaide,"Young, Aaron",3,0,0,3,0,0,0,0
Richmond,"Batchelor, Jake",12,10,5,2,0,0,0,3
Richmond,"Chaplin, Troy",10,4,2,6,0,0,0,1
Richmond,"Conca, Reece",19,12,1,7,1,0,0,2
Richmond,"Cotchin, Trent",33,22,3,11,0,1,0,2
Richmond,"Deledio, Brett",17,10,3,7,3,1,0,2
Richmond,"Edwards, Shane",19,9,0,10,0,2,1,1
Richmond,"Ellis, Brandon",8,6,1,2,0,0,0,0
Richmond,"Griffiths, Ben",6,3,3,3,0,0,0,2
Richmond,"Grigg, Shaun",23,17,8,6,0,0,0,2
Richmond,"Houli, Bachar",13,7,4,6,1,1,0,0
Richmond,"Jackson, Daniel",24,15,6,9,1,0,0,4
Richmond,"King, Jake",7,6,1,1,2,0,0,2
Richmond,"Maric, Ivan",16,6,3,10,0,0,30,3
Richmond,"Martin, Dustin",21,12,1,9,1,2,0,3
Richmond,"McGuane, Luke",12,6,3,6,2,1,0,4
Richmond,"Morris, Steven",7,4,1,3,0,0,0,1
Richmond,"Nahas, Robin",3,2,0,1,0,0,0,0
Richmond,"Newman, Chris",16,9,4,7,0,0,0,1
Richmond,"Rance, Alex",19,13,7,6,0,0,0,3
Richmond,"Riewoldt, Jack",15,11,1,4,0,4,0,1
Richmond,"Tuck, Shane",27,18,3,9,0,3,0,0
Richmond,"Vickery, Ty",15,10,9,5,3,1,6,3
Richmond,"Batchelor, Jake",9,7,4,2,0,0,0,2
Richmond,"Chaplin, Troy",22,13,10,9,0,1,0,1
Richmond,"Conca, Reece",25,16,4,9,1,3,0,3
Richmond,"Cotchin, Trent",31,20,5,11,0,0,0,5
Richmond,"Deledio, Brett",27,15,10,12,0,0,0,2
Richmond,"Edwards, Shane",17,8,2,9,0,0,0,3
Richmond,"Ellis, Brandon",5,5,3,0,0,0,0,1
Richmond,"Grigg, Shaun",21,9,4,12,0,0,3,0
Richmond,"Grimes, Dylan",8,6,2,2,0,0,0,0
Richmond,"Houli, Bachar",15,5,2,10,0,0,0,0
Richmond,"Jackson, Daniel",16,12,3,4,0,0,0,3
Richmond,"King, Jake",12,6,3,6,1,0,0,5
Richmond,"Maric, Ivan",13,6,3,7,1,0,25,1
Richmond,"Martin, Dustin",24,17,3,7,0,3,0,4
Richmond,"McGuane, Luke",15,10,4,5,2,3,1,1
Richmond,"Morris, Steven",11,6,3,5,0,0,0,1
Richmond,"Newman, Chris",15,11,7,4,1,2,0,1
Richmond,"Petterd, Ricky",20,11,8,9,0,0,0,0
Richmond,"Rance, Alex",12,6,5,6,0,0,0,2
Richmond,"Riewoldt, Jack",10,10,3,0,7,2,0,4
Richmond,"Tuck, Shane",21,9,3,12,0,0,0,1
Richmond,"Vickery, Ty",10,4,2,6,1,0,2,1
Richmond,"Chaplin, Troy",11,8,9,3,0,0,0,3
Richmond,"Conca, Reece",19,12,7,7,0,1,0,5
Richmond,"Cotchin, Trent",36,25,6,11,0,1,0,1
Richmond,"Deledio, Brett",27,16,11,11,3,1,1,4
Richmond,"Edwards, Shane",16,7,2,9,2,1,0,5
Richmond,"Ellis, Brandon",4,2,1,2,0,0,0,0
Richmond,"Grigg, Shaun",26,12,8,14,0,0,0,5
Richmond,"Grimes, Dylan",11,10,8,1,0,0,0,1
Richmond,"Houli, Bachar",26,16,6,10,1,0,0,2
Richmond,"Jackson, Daniel",20,12,1,8,1,1,0,6
Richmond,"King, Jake",19,9,6,10,0,0,0,0
Richmond,"Knights, Chris",15,11,5,4,1,0,3,2
Richmond,"Maric, Ivan",18,6,9,12,1,1,16,2
Richmond,"Martin, Dustin",35,20,10,15,2,1,0,3
Richmond,"McGuane, Luke",14,10,5,4,3,1,0,2
Richmond,"Morris, Steven",6,4,2,2,0,0,0,1
Richmond,"Newman, Chris",19,11,4,8,0,0,0,0
Richmond,"Petterd, Ricky",16,11,3,5,0,0,0,1
Richmond,"Rance, Alex",15,11,8,4,0,0,0,4
Richmond,"Riewoldt, Jack",15,13,9,2,5,2,0,1
Richmond,"Tuck, Shane",22,11,4,11,1,1,0,2
Richmond,"Vickery, Ty",10,4,3,6,0,2,5,0
Richmond,"Chaplin, Troy",7,5,5,2,0,0,0,0
Richmond,"Conca, Reece",19,13,6,6,0,0,0,5
Richmond,"Cotchin, Trent",27,14,6,13,0,1,0,3
Richmond,"Deledio, Brett",25,8,3,17,0,1,1,3
Richmond,"Edwards, Shane",16,7,3,9,1,0,0,3
Richmond,"Ellis, Brandon",13,6,1,7,0,1,0,0
Richmond,"Grigg, Shaun",22,11,3,11,0,2,2,1
Richmond,"Grimes, Dylan",15,6,5,9,0,0,0,1
Richmond,"Houli, Bachar",24,13,2,11,1,0,0,1
Richmond,"Jackson, Daniel",17,9,2,8,0,0,0,0
Richmond,"King, Jake",10,4,2,6,1,1,0,1
Richmond,"Knights, Chris",20,11,5,9,0,2,0,2
Richmond,"Maric, Ivan",15,8,5,7,1,1,25,3
Richmond,"Martin, Dustin",17,15,0,2,0,1,0,2
Richmond,"McGuane, Luke",10,8,3,2,2,1,0,1
Richmond,"Morris, Steven",10,6,2,4,0,0,0,0
Richmond,"Newman, Chris",12,5,2,7,0,0,0,1
Richmond,"Petterd, Ricky",11,8,3,3,0,0,0,3
Richmond,"Rance, Alex",6,6,3,0,0,0,0,0
Richmond,"Riewoldt, Jack",14,12,5,2,3,0,0,2
Richmond,"Tuck, Shane",14,6,1,8,0,0,1,1
Richmond,"Vickery, Ty",11,6,3,5,2,0,7,0
Richmond,"Batchelor, Jake",8,4,3,4,0,0,0,1
Richmond,"Cotchin, Trent",26,18,1,8,0,1,0,4
Richmond,"Deledio, Brett",20,10,3,10,0,0,0,6
Richmond,"Edwards, Shane",22,8,2,14,0,0,0,8
Richmond,"Ellis, Brandon",25,14,4,11,0,0,0,2
Richmond,"Grigg, Shaun",19,14,3,5,1,0,2,1
Richmond,"Grimes, Dylan",10,8,2,2,0,0,0,2
Richmond,"Helbig, Brad",6,2,1,4,0,0,0,2
Richmond,"Houli, Bachar",23,13,5,10,0,0,0,1
Richmond,"Jackson, Daniel",21,15,7,6,0,0,0,8
Richmond,"Knights, Chris",19,11,4,8,3,1,0,3
Richmond,"Maric, Ivan",15,7,4,8,0,0,26,2
Richmond,"Martin, Dustin",22,17,2,5,1,2,0,6
Richmond,"McGuane, Luke",10,4,3,6,2,0,0,2
Richmond,"Nahas, Robin",3,2,1,1,0,0,0,0
Richmond,"Newman, Chris",12,8,4,4,0,0,0,2
Richmond,"Petterd, Ricky",18,12,6,6,0,0,0,6
Richmond,"Rance, Alex",17,11,6,6,0,0,0,4
Richmond,"Riewoldt, Jack",10,6,2,4,1,0,0,2
Richmond,"Vickery, Ty",13,12,8,1,3,0,10,1
Richmond,"Vlastuin, Nick",11,4,3,7,0,0,0,4
Richmond,"White, Matt",11,7,2,4,1,0,0,6
Richmond,"Chaplin, Troy",13,8,3,5,0,0,0,2
Richmond,"Cotchin, Trent",17,9,4,8,0,0,0,3
Richmond,"Deledio, Brett",20,10,3,10,0,0,0,1
Richmond,"Edwards, Shane",30,11,1,19,0,0,0,2
Richmond,"Ellis, Brandon",18,10,8,8,1,1,0,2
Richmond,"Grigg, Shaun",25,14,6,11,1,0,0,4
Richmond,"Grimes, Dylan",8,6,4,2,0,0,0,4
Richmond,"Houli, Bachar",17,7,4,10,0,1,0,9
Richmond,"Jackson, Daniel",23,14,2,9,0,1,3,1
Richmond,"King, Jake",20,14,7,6,4,1,0,1
Richmond,"Knights, Chris",24,15,9,9,1,2,0,1
Richmond,"Maric, Ivan",12,5,4,7,0,0,20,2
Richmond,"Martin, Dustin",22,16,7,6,2,0,0,3
Richmond,"McGuane, Luke",9,5,3,4,1,0,4,3
Richmond,"Morris, Steven",8,4,3,4,0,0,0,2
Richmond,"Newman, Chris",19,14,5,5,0,0,0,2
Richmond,"Petterd, Ricky",16,10,5,6,0,0,0,2
Richmond,"Rance, Alex",10,5,4,5,0,0,0,1
Richmond,"Riewoldt, Jack",11,8,6,3,3,0,1,1
Richmond,"Vickery, Ty",5,2,1,3,0,0,7,0
Richmond,"Vlastuin, Nick",20,8,4,12,0,0,0,5
Richmond,"White, Matt",5,4,2,1,0,1,0,2
Richmond,"Batchelor, Jake",12,11,5,1,0,0,0,0
Richmond,"Chaplin, Troy",8,5,3,3,0,0,0,1
Richmond,"Deledio, Brett",32,22,10,10,0,1,0,4
Richmond,"Edwards, Shane",21,13,3,8,0,0,0,8
Richmond,"Ellis, Brandon",23,20,13,3,0,0,0,6
Richmond,"Foley, Nathan",13,8,5,5,0,0,0,1
Richmond,"Grigg, Shaun",16,12,8,4,2,0,0,4
Richmond,"Houli, Bachar",24,19,9,5,0,0,0,0
Richmond,"Jackson, Daniel",18,15,9,3,0,0,0,3
Richmond,"King, Jake",18,11,4,7,3,1,0,0
Richmond,"Knights, Chris",8,6,2,2,1,0,0,0
Richmond,"Maric, Ivan",9,3,3,6,0,0,16,5
Richmond,"Martin, Dustin",33,23,13,10,1,1,0,2
Richmond,"McGuane, Luke",11,8,8,3,1,1,0,1
Richmond,"Morris, Steven",12,8,4,4,0,0,0,3
Richmond,"Nahas, Robin",9,6,4,3,1,1,0,4
Richmond,"Newman, Chris",19,13,10,6,2,0,0,4
Richmond,"Rance, Alex",22,17,13,5,0,0,0,2
Richmond,"Riewoldt, Jack",14,9,6,5,5,1,0,0
Richmond,"Stephenson, Orren",11,5,5,6,0,0,28,2
Richmond,"Tuck, Shane",15,5,0,10,1,0,0,6
Richmond,"Vlastuin, Nick",23,14,11,9,1,0,0,1
Richmond,"Batchelor, Jake",14,9,5,5,0,0,0,3
Richmond,"Chaplin, Troy",15,12,7,3,1,0,0,1
Richmond,"Cotchin, Trent",26,19,3,7,0,1,0,2
Richmond,"Dea, Matt",9,4,5,5,0,0,0,3
Richmond,"Deledio, Brett",27,19,7,8,1,2,0,5
Richmond,"Edwards, Shane",23,9,4,14,0,0,0,3
Richmond,"Ellis, Brandon",39,25,11,14,1,0,0,3
Richmond,"Foley, Nathan",13,4,1,9,0,0,0,10
Richmond,"Grigg, Shaun",24,13,8,11,0,1,1,6
Richmond,"Houli, Bachar",24,19,13,5,0,0,0,3
Richmond,"Jackson, Daniel",23,13,8,10,0,0,1,4
Richmond,"King, Jake",12,5,3,7,2,2,0,2
Richmond,"Martin, Dustin",17,13,3,4,3,0,0,5
Richmond,"McGuane, Luke",2,1,1,1,0,0,0,1
Richmond,"Morris, Steven",15,11,7,4,1,0,0,2
Richmond,"Nahas, Robin",7,5,2,2,1,0,0,2
Richmond,"Rance, Alex",15,13,11,2,0,0,0,0
Richmond,"Riewoldt, Jack",13,9,6,4,3,3,0,0
Richmond,"Stephenson, Orren",7,3,0,4,0,0,17,4
Richmond,"Vickery, Ty",18,12,9,6,0,4,17,1
Richmond,"Vlastuin, Nick",25,19,16,6,1,0,0,2
Richmond,"White, Matt",7,6,3,1,1,0,0,3
Richmond,"Batchelor, Jake",14,10,3,4,0,0,0,2
Richmond,"Chaplin, Troy",22,12,13,10,0,0,0,3
Richmond,"Cotchin, Trent",23,16,3,7,1,0,0,5
Richmond,"Deledio, Brett",17,8,1,9,0,0,0,2
Richmond,"Edwards, Shane",21,11,3,10,1,0,0,0
Richmond,"Foley, Nathan",17,4,3,13,0,0,0,4
Richmond,"Grigg, Shaun",27,15,11,12,0,0,0,1
Richmond,"Houli, Bachar",25,15,9,10,0,0,0,0
Richmond,"Jackson, Daniel",29,15,5,14,0,1,0,5
Richmond,"King, Jake",6,4,1,2,1,0,0,1
Richmond,"Lonergan, Sam",13,4,3,9,0,0,0,5
Richmond,"Maric, Ivan",15,6,4,9,0,1,16,2
Richmond,"Martin, Dustin",22,15,5,7,1,4,0,0
Richmond,"McGuane, Luke",11,6,1,5,1,1,2,2
Richmond,"Morris, Steven",9,4,3,5,0,0,0,0
Richmond,"Nahas, Robin",16,9,7,7,1,0,0,4
Richmond,"Newman, Chris",27,20,5,7,0,0,0,3
Richmond,"Rance, Alex",19,12,8,7,0,0,0,5
Richmond,"Riewoldt, Jack",8,8,5,0,2,1,0,1
Richmond,"Vickery, Ty",6,1,3,5,0,0,3,1
Richmond,"Vlastuin, Nick",22,12,3,10,1,0,0,2
Richmond,"White, Matt",6,4,0,2,0,0,0,1
Richmond,"Batchelor, Jake",9,5,3,4,0,0,0,4
Richmond,"Chaplin, Troy",10,9,4,1,0,0,0,1
Richmond,"Cotchin, Trent",23,11,2,12,0,0,0,3
Richmond,"Dea, Matt",16,12,6,4,0,0,0,1
Richmond,"Deledio, Brett",25,15,4,10,0,0,1,6
Richmond,"Edwards, Aaron",11,7,6,4,1,1,0,4
Richmond,"Edwards, Shane",16,8,3,8,2,0,0,1
Richmond,"Foley, Nathan",22,12,3,10,0,0,0,4
Richmond,"Grigg, Shaun",24,14,9,10,0,0,1,5
Richmond,"Houli, Bachar",25,14,6,11,0,0,0,2
Richmond,"Jackson, Daniel",22,17,6,5,1,0,1,5
Richmond,"King, Jake",11,7,5,4,1,1,0,1
Richmond,"Lonergan, Sam",9,7,1,2,0,0,0,1
Richmond,"Maric, Ivan",11,4,2,7,0,0,19,4
Richmond,"Martin, Dustin",25,17,5,8,1,0,0,2
Richmond,"Morris, Steven",9,4,4,5,0,0,0,1
Richmond,"Newman, Chris",11,7,3,4,2,0,0,5
Richmond,"Rance, Alex",13,7,5,6,0,0,0,4
Richmond,"Riewoldt, Jack",11,6,3,5,2,0,0,5
Richmond,"Vickery, Ty",13,7,6,6,2,1,5,0
Richmond,"Vlastuin, Nick",16,9,2,7,3,1,0,6
Richmond,"White, Matt",19,15,9,4,1,2,0,5
Richmond,"Astbury, David",6,3,3,3,0,0,0,0
Richmond,"Chaplin, Troy",17,10,6,7,0,0,0,0
Richmond,"Conca, Reece",17,13,2,4,0,2,0,3
Richmond,"Cotchin, Trent",22,11,1,11,1,1,0,2
Richmond,"Deledio, Brett",28,23,9,5,0,2,0,5
Richmond,"Edwards, Aaron",5,2,0,3,0,0,0,3
Richmond,"Edwards, Shane",20,12,4,8,1,0,0,1
Richmond,"Ellis, Brandon",23,16,5,7,2,2,0,6
Richmond,"Foley, Nathan",25,10,0,15,0,0,0,8
Richmond,"Grigg, Shaun",18,14,9,4,2,1,0,7
Richmond,"Houli, Bachar",26,17,10,9,0,1,0,3
Richmond,"Jackson, Daniel",23,8,5,15,0,1,1,5
Richmond,"King, Jake",10,5,2,5,1,0,0,5
Richmond,"Maric, Ivan",14,10,3,4,1,0,22,2
Richmond,"Martin, Dustin",19,15,6,4,4,2,0,3
Richmond,"Morris, Steven",6,1,1,5,0,0,0,0
Richmond,"Newman, Chris",13,9,3,4,1,0,0,2
Richmond,"Rance, Alex",13,8,4,5,0,0,0,4
Richmond,"Riewoldt, Jack",13,11,3,2,3,1,1,3
Richmond,"Vickery, Ty",7,3,4,4,0,1,8,3
Richmond,"Vlastuin, Nick",22,14,5,8,0,0,0,4
Richmond,"White, Matt",6,5,1,1,0,0,0,3
Richmond,"Astbury, David",4,4,2,0,0,0,0,0
Richmond,"Chaplin, Troy",12,7,4,5,0,0,0,1
Richmond,"Conca, Reece",21,17,6,4,2,1,0,1
Richmond,"Cotchin, Trent",17,12,3,5,1,0,0,4
Richmond,"Deledio, Brett",25,17,4,8,0,1,0,0
Richmond,"Edwards, Aaron",18,13,9,5,1,2,0,2
Richmond,"Edwards, Shane",16,10,1,6,0,2,0,5
Richmond,"Ellis, Brandon",16,10,4,6,0,0,0,2
Richmond,"Foley, Nathan",17,8,3,9,1,0,0,3
Richmond,"Grigg, Shaun",21,16,10,5,2,2,3,3
Richmond,"Houli, Bachar",25,16,4,9,1,1,0,0
Richmond,"Jackson, Daniel",23,12,7,11,1,1,0,1
Richmond,"King, Jake",9,3,0,6,0,0,0,3
Richmond,"Maric, Ivan",10,6,2,4,0,0,22,2
Richmond,"Martin, Dustin",23,16,5,7,1,0,1,1
Richmond,"Morris, Steven",13,4,4,9,0,0,0,3
Richmond,"Newman, Chris",14,10,6,4,0,2,0,2
Richmond,"Rance, Alex",13,10,5,3,0,0,0,1
Richmond,"Riewoldt, Jack",15,10,7,5,3,2,0,0
Richmond,"Vickery, Ty",15,7,4,8,2,1,7,0
Richmond,"Vlastuin, Nick",5,2,2,3,1,0,0,2
Richmond,"White, Matt",12,9,4,3,1,0,0,3
Richmond,"Arnot, Matt",11,5,1,6,0,0,0,7
Richmond,"Batchelor, Jake",14,10,6,4,0,1,0,1
Richmond,"Chaplin, Troy",8,4,4,4,0,0,0,1
Richmond,"Conca, Reece",22,19,1,3,1,0,0,4
Richmond,"Cotchin, Trent",24,13,5,11,0,0,0,2
Richmond,"Deledio, Brett",24,15,5,9,2,1,0,2
Richmond,"Edwards, Aaron",19,10,9,9,1,0,0,0
Richmond,"Edwards, Shane",21,14,3,7,0,1,0,3
Richmond,"Ellis, Brandon",18,11,5,7,1,0,0,1
Richmond,"Foley, Nathan",23,13,8,10,2,0,0,2
Richmond,"Grigg, Shaun",17,12,4,5,2,0,1,2
Richmond,"Houli, Bachar",19,7,4,12,0,0,0,2
Richmond,"Jackson, Daniel",21,15,2,6,3,1,0,3
Richmond,"King, Jake",6,4,2,2,1,0,0,2
Richmond,"Martin, Dustin",23,16,4,7,0,1,1,1
Richmond,"Morris, Steven",6,3,1,3,0,0,0,4
Richmond,"Newman, Chris",16,13,8,3,0,0,0,1
Richmond,"Rance, Alex",18,13,6,5,0,0,0,2
Richmond,"Riewoldt, Jack",18,18,8,0,3,5,0,4
Richmond,"Stephenson, Orren",12,4,4,8,0,0,30,0
Richmond,"Vickery, Ty",18,14,11,4,1,1,16,3
Richmond,"White, Matt",9,6,3,3,0,0,0,3
Richmond,"Batchelor, Jake",12,9,6,3,0,0,0,1
Richmond,"Chaplin, Troy",9,7,5,2,0,0,0,2
Richmond,"Conca, Reece",15,11,4,4,0,1,0,3
Richmond,"Cotchin, Trent",25,17,3,8,0,0,0,6
Richmond,"Dea, Matt",6,2,1,4,0,0,0,1
Richmond,"Deledio, Brett",16,11,3,5,0,2,1,5
Richmond,"Edwards, Aaron",11,6,2,5,0,1,0,5
Richmond,"Edwards, Shane",15,9,0,6,0,1,0,6
Richmond,"Ellis, Brandon",4,1,1,3,1,0,0,0
Richmond,"Foley, Nathan",24,16,4,8,0,0,0,6
Richmond,"Grigg, Shaun",24,10,3,14,0,0,1,5
Richmond,"Jackson, Daniel",17,8,4,9,1,0,0,3
Richmond,"King, Jake",13,10,3,3,0,2,0,3
Richmond,"Martin, Dustin",23,12,3,11,0,2,0,5
Richmond,"Morris, Steven",13,7,2,6,2,0,0,5
Richmond,"Newman, Chris",11,7,2,4,0,1,0,1
Richmond,"Rance, Alex",17,6,7,11,0,0,0,0
Richmond,"Riewoldt, Jack",5,5,0,0,2,1,0,3
Richmond,"Stephenson, Orren",7,3,2,4,0,1,22,5
Richmond,"Vickery, Ty",10,6,3,4,0,2,14,3
Richmond,"Vlastuin, Nick",6,4,0,2,0,0,0,3
Richmond,"White, Matt",19,12,2,7,2,1,0,2
Richmond,"Arnot, Matt",15,6,1,9,1,1,0,2
Richmond,"Chaplin, Troy",19,12,5,7,0,0,0,1
Richmond,"Conca, Reece",11,6,3,5,0,0,0,4
Richmond,"Cotchin, Trent",29,19,9,10,0,1,0,3
Richmond,"Deledio, Brett",24,11,3,13,0,0,0,4
Richmond,"Edwards, Aaron",12,6,4,6,0,0,0,3
Richmond,"Edwards, Shane",16,6,0,10,0,2,0,6
Richmond,"Ellis, Brandon",18,7,3,11,1,0,0,4
Richmond,"Foley, Nathan",16,8,0,8,1,1,0,6
Richmond,"Grigg, Shaun",3,3,2,0,0,0,0,1
Richmond,"Jackson, Daniel",24,19,2,5,2,0,0,4
Richmond,"King, Jake",9,7,4,2,0,1,0,4
Richmond,"Maric, Ivan",13,6,2,7,0,0,32,0
Richmond,"Martin, Dustin",31,23,5,8,0,2,0,4
Richmond,"Morris, Steven",10,6,2,4,0,0,0,3
Richmond,"Newman, Chris",15,13,6,2,0,2,0,3
Richmond,"Petterd, Ricky",24,20,11,4,0,0,0,7
Richmond,"Rance, Alex",20,8,5,12,0,0,0,2
Richmond,"Riewoldt, Jack",13,9,5,4,1,3,0,1
Richmond,"Vickery, Ty",10,7,6,3,0,0,13,1
Richmond,"Vlastuin, Nick",15,9,2,6,0,1,0,3
Richmond,"White, Matt",15,13,7,2,0,1,0,5
Richmond,"Arnot, Matt",9,6,2,3,0,1,0,2
Richmond,"Chaplin, Troy",15,9,6,6,0,0,0,2
Richmond,"Conca, Reece",16,7,6,9,0,0,0,2
Richmond,"Cotchin, Trent",34,26,6,8,1,0,0,6
Richmond,"Deledio, Brett",15,8,2,7,1,0,0,3
Richmond,"Edwards, Shane",20,12,5,8,1,1,0,3
Richmond,"Ellis, Brandon",24,15,8,9,0,0,0,2
Richmond,"Foley, Nathan",7,2,0,5,0,0,0,1
Richmond,"Grigg, Shaun",24,15,9,9,0,1,0,7
Richmond,"Houli, Bachar",20,11,6,9,0,0,0,1
Richmond,"Jackson, Daniel",22,18,4,4,1,0,0,8
Richmond,"King, Jake",12,6,2,6,1,2,0,3
Richmond,"Maric, Ivan",10,5,2,5,0,1,26,5
Richmond,"Martin, Dustin",30,24,7,6,1,4,0,1
Richmond,"Morris, Steven",8,2,1,6,0,0,0,3
Richmond,"Newman, Chris",20,11,9,9,0,0,0,3
Richmond,"Petterd, Ricky",22,13,5,9,0,0,0,1
Richmond,"Rance, Alex",30,15,16,15,0,0,0,5
Richmond,"Riewoldt, Jack",15,13,2,2,4,1,0,4
Richmond,"Vickery, Ty",15,7,7,8,1,0,9,2
Richmond,"Vlastuin, Nick",17,8,7,9,0,0,0,4
Richmond,"White, Matt",17,10,2,7,1,0,1,0
Richmond,"Arnot, Matt",9,2,2,7,0,0,0,0
Richmond,"Chaplin, Troy",19,10,7,9,0,0,0,2
Richmond,"Conca, Reece",21,14,1,7,1,0,0,8
Richmond,"Cotchin, Trent",30,15,1,15,0,0,0,3
Richmond,"Deledio, Brett",21,9,6,12,0,1,0,4
Richmond,"Edwards, Shane",14,5,1,9,0,0,0,3
Richmond,"Ellis, Brandon",18,10,9,8,0,2,0,4
Richmond,"Foley, Nathan",21,12,4,9,0,1,0,3
Richmond,"Grigg, Shaun",26,13,6,13,0,0,2,2
Richmond,"Houli, Bachar",22,18,6,4,0,0,0,2
Richmond,"Jackson, Daniel",22,14,7,8,1,1,0,2
Richmond,"Maric, Ivan",5,2,3,3,0,0,21,3
Richmond,"Martin, Dustin",30,18,4,12,2,0,1,3
Richmond,"Morris, Steven",10,5,1,5,0,0,0,0
Richmond,"Newman, Chris",13,7,1,6,0,0,0,1
Richmond,"Petterd, Ricky",15,8,4,7,0,0,0,0
Richmond,"Rance, Alex",17,8,4,9,0,0,1,2
Richmond,"Riewoldt, Jack",18,11,8,7,3,2,0,3
Richmond,"Tuck, Shane",21,9,5,12,0,0,0,3
Richmond,"Vickery, Ty",12,8,5,4,1,1,4,0
Richmond,"Vlastuin, Nick",21,8,2,13,0,0,0,2
Richmond,"White, Matt",15,12,2,3,1,0,0,1
Richmond,"Astbury, David",10,7,4,3,0,0,0,0
Richmond,"Chaplin, Troy",13,5,4,8,0,0,0,3
Richmond,"Conca, Reece",18,9,3,9,0,1,0,6
Richmond,"Cotchin, Trent",34,19,6,15,0,0,0,9
Richmond,"Deledio, Brett",27,14,3,13,0,0,1,5
Richmond,"Edwards, Shane",16,11,2,5,2,0,0,4
Richmond,"Ellis, Brandon",25,20,9,5,0,0,0,2
Richmond,"Foley, Nathan",22,7,5,15,1,1,0,0
Richmond,"Grigg, Shaun",20,8,2,12,0,0,1,0
Richmond,"Houli, Bachar",28,14,5,14,0,0,0,1
Richmond,"Jackson, Daniel",19,13,2,6,2,1,0,3
Richmond,"Maric, Ivan",14,4,0,10,1,0,30,4
Richmond,"Martin, Dustin",25,16,3,9,1,1,1,1
Richmond,"McGuane, Luke",11,7,3,4,2,0,4,6
Richmond,"Morris, Steven",3,0,1,3,0,0,0,2
Richmond,"Newman, Chris",19,10,9,9,1,1,0,1
Richmond,"Rance, Alex",16,7,6,9,0,0,1,1
Richmond,"Riewoldt, Jack",15,11,7,4,3,1,0,2
Richmond,"Stephenson, Orren",2,1,1,1,0,0,13,0
Richmond,"Tuck, Shane",12,9,1,3,1,0,0,2
Richmond,"Vlastuin, Nick",14,8,2,6,0,0,0,4
Richmond,"White, Matt",12,9,4,3,2,0,0,5
Richmond,"Astbury, David",15,8,7,7,0,0,0,1
Richmond,"Chaplin, Troy",21,9,10,12,0,0,0,2
Richmond,"Conca, Reece",21,14,5,7,3,0,0,6
Richmond,"Cotchin, Trent",30,19,5,11,0,2,0,1
Richmond,"Deledio, Brett",29,15,6,14,0,0,0,6
Richmond,"Ellis, Brandon",27,15,9,12,1,1,0,4
Richmond,"Foley, Nathan",24,17,7,7,1,0,0,4
Richmond,"Grigg, Shaun",20,11,6,9,1,1,0,3
Richmond,"Houli, Bachar",25,17,7,8,0,0,0,4
Richmond,"Jackson, Daniel",30,13,3,17,1,0,0,3
Richmond,"Maric, Ivan",15,7,2,8,0,0,23,0
Richmond,"Martin, Dustin",27,15,5,12,0,0,0,4
Richmond,"McGuane, Luke",14,13,8,1,3,2,0,2
Richmond,"Morris, Steven",16,11,5,5,1,0,0,1
Richmond,"Nahas, Robin",9,4,2,5,0,0,0,1
Richmond,"Newman, Chris",11,9,4,2,0,0,0,4
Richmond,"Rance, Alex",20,12,9,8,0,0,0,2
Richmond,"Riewoldt, Jack",16,11,9,5,1,4,1,1
Richmond,"Tuck, Shane",8,3,0,5,0,0,0,1
Richmond,"Vickery, Ty",17,8,5,9,0,1,8,4
Richmond,"Vlastuin, Nick",10,7,5,3,1,0,0,3
Richmond,"White, Matt",19,13,5,6,1,0,0,5
Richmond,"Astbury, David",17,8,2,9,0,0,0,1
Richmond,"Chaplin, Troy",10,5,3,5,0,0,0,2
Richmond,"Conca, Reece",18,11,2,7,0,0,0,5
Richmond,"Cotchin, Trent",14,6,1,8,0,0,0,4
Richmond,"Deledio, Brett",29,14,4,15,0,0,0,7
Richmond,"Ellis, Brandon",15,8,1,7,2,0,0,1
Richmond,"Foley, Nathan",18,12,3,6,0,1,0,5
Richmond,"Grigg, Shaun",23,11,5,12,1,0,2,5
Richmond,"Grimes, Dylan",5,2,0,3,0,0,0,1
Richmond,"Houli, Bachar",18,11,2,7,0,0,0,2
Richmond,"Jackson, Daniel",23,14,1,9,1,0,0,8
Richmond,"Maric, Ivan",11,6,4,5,1,2,33,4
Richmond,"Martin, Dustin",10,6,2,4,0,2,0,0
Richmond,"McDonough, Matt",11,8,1,3,0,0,0,3
Richmond,"McGuane, Luke",9,5,3,4,1,0,2,0
Richmond,"Morris, Steven",15,5,3,10,0,0,0,1
Richmond,"Petterd, Ricky",12,4,3,8,1,1,0,5
Richmond,"Rance, Alex",17,9,3,8,1,0,0,2
Richmond,"Riewoldt, Jack",13,10,6,3,2,0,0,1
Richmond,"Tuck, Shane",16,9,2,7,0,1,0,2
Richmond,"Vickery, Ty",12,11,7,1,3,1,9,2
Richmond,"Vlastuin, Nick",16,4,1,12,1,0,1,4
Richmond,"Chaplin, Troy",23,13,8,10,0,0,0,1
Richmond,"Conca, Reece",28,17,7,11,3,0,0,0
Richmond,"Cotchin, Trent",15,10,2,5,0,0,0,2
Richmond,"Deledio, Brett",23,15,8,8,0,1,0,4
Richmond,"Edwards, Aaron",20,15,8,5,5,2,0,1
Richmond,"Edwards, Shane",14,4,3,10,1,0,0,3
Richmond,"Ellis, Brandon",20,13,7,7,3,0,0,0
Richmond,"Foley, Nathan",10,6,2,4,0,0,0,2
Richmond,"Grigg, Shaun",26,14,6,12,2,1,0,4
Richmond,"Grimes, Dylan",9,7,5,2,0,0,0,2
Richmond,"Houli, Bachar",28,17,8,11,2,0,0,0
Richmond,"Jackson, Daniel",25,15,3,10,0,1,0,4
Richmond,"King, Jake",17,8,5,9,1,1,0,2
Richmond,"Maric, Ivan",17,13,6,4,2,1,22,1
Richmond,"Martin, Dustin",33,23,8,10,0,0,1,5
Richmond,"Morris, Steven",13,8,4,5,1,0,0,0
Richmond,"Petterd, Ricky",15,10,4,5,2,1,0,2
Richmond,"Rance, Alex",21,10,7,11,0,0,0,0
Richmond,"Riewoldt, Jack",11,6,5,5,1,0,0,0
Richmond,"Vickery, Ty",18,10,5,8,2,3,8,3
Richmond,"Vlastuin, Nick",16,8,9,8,0,1,0,1
Richmond,"White, Matt",22,10,5,12,0,0,0,5
Richmond,"Chaplin, Troy",14,7,9,7,0,0,0,3
Richmond,"Conca, Reece",22,12,3,10,0,2,0,2
Richmond,"Cotchin, Trent",29,22,7,7,0,0,0,1
Richmond,"Deledio, Brett",25,16,7,9,0,0,0,2
Richmond,"Edwards, Aaron",19,14,12,5,4,1,0,0
Richmond,"Ellis, Brandon",35,25,16,10,0,0,0,0
Richmond,"Foley, Nathan",20,12,6,8,0,1,0,6
Richmond,"Grigg, Shaun",22,13,3,9,1,1,0,2
Richmond,"Grimes, Dylan",15,10,5,5,0,0,0,1
Richmond,"Houli, Bachar",19,15,9,4,0,0,0,2
Richmond,"Jackson, Daniel",30,18,8,12,2,0,0,3
Richmond,"King, Jake",12,10,4,2,2,0,0,2
Richmond,"Maric, Ivan",8,4,4,4,0,0,14,2
Richmond,"Martin, Dustin",26,21,7,5,1,3,0,3
Richmond,"Morris, Steven",15,8,4,7,0,0,0,1
Richmond,"Petterd, Ricky",24,9,7,15,0,2,0,1
Richmond,"Rance, Alex",12,7,5,5,0,0,0,4
Richmond,"Stephenson, Orren",14,6,4,8,0,0,15,2
Richmond,"Tuck, Shane",15,8,1,7,1,0,0,3
Richmond,"Vickery, Ty",13,9,9,4,4,0,0,1
Richmond,"Vlastuin, Nick",17,6,6,11,0,0,0,4
Richmond,"White, Matt",7,5,2,2,0,1,0,0
Richmond,"Chaplin, Troy",10,5,3,5,0,0,0,2
Richmond,"Conca, Reece",0,0,0,0,0,0,0,0
Richmond,"Cotchin, Trent",26,22,4,4,2,0,0,4
Richmond,"Deledio, Brett",24,16,3,8,0,1,0,4
Richmond,"Edwards, Aaron",12,10,7,2,2,2,0,0
Richmond,"Edwards, Shane",11,4,1,7,0,2,0,3
Richmond,"Ellis, Brandon",12,7,5,5,1,0,0,5
Richmond,"Grigg, Shaun",14,10,6,4,0,0,1,4
Richmond,"Grimes, Dylan",8,3,3,5,0,0,0,3
Richmond,"Houli, Bachar",20,15,9,5,0,1,0,4
Richmond,"Jackson, Daniel",21,12,3,9,0,0,0,4
Richmond,"King, Jake",10,8,1,2,0,0,0,4
Richmond,"Maric, Ivan",16,5,2,11,2,0,26,3
Richmond,"Martin, Dustin",19,12,2,7,1,1,0,2
Richmond,"Morris, Steven",5,3,2,2,0,0,0,1
Richmond,"Newman, Chris",15,11,6,4,1,0,0,3
Richmond,"Petterd, Ricky",16,8,5,8,1,0,0,2
Richmond,"Rance, Alex",20,12,6,8,0,0,0,0
Richmond,"Riewoldt, Jack",11,8,6,3,1,0,0,3
Richmond,"Tuck, Shane",18,8,2,10,1,1,1,3
Richmond,"Vickery, Ty",14,9,6,5,2,0,9,4
Richmond,"Vlastuin, Nick",18,13,6,5,0,0,0,1
St Kilda,"Armitage, David",25,19,4,6,1,1,0,5
St Kilda,"Blake, Jason",12,6,5,6,0,0,0,3
St Kilda,"Dal Santo, Nick",23,13,5,10,0,0,0,9
St Kilda,"Dennis-Lane, Trent",0,0,0,0,0,0,0,0
St Kilda,"Geary, Jarryn",28,15,7,13,0,0,0,6
St Kilda,"Gilbert, Sam",18,9,3,9,0,1,4,3
St Kilda,"Gwilt, James",21,15,7,6,0,0,0,1
St Kilda,"Hayes, Lenny",23,16,6,7,0,0,1,7
St Kilda,"Hickey, Tom",4,1,1,3,0,0,12,1
St Kilda,"Jones, Clinton",22,10,4,12,0,0,0,1
St Kilda,"Maister, Beau",10,7,3,3,1,0,0,2
St Kilda,"McEvoy, Ben",11,5,2,6,0,0,23,0
St Kilda,"Milera, Terry",11,9,4,2,3,2,0,3
St Kilda,"Milne, Stephen",13,9,1,4,1,3,0,1
St Kilda,"Newnes, Jack",12,8,3,4,0,0,0,0
St Kilda,"Ray, Farren",19,15,5,4,0,0,0,3
St Kilda,"Riewoldt, Nick",14,11,9,3,2,2,0,0
St Kilda,"Roberton, Dylan",18,11,3,7,0,0,0,1
St Kilda,"Saad, Ahmed",9,5,0,4,0,2,0,0
St Kilda,"Siposs, Arryn",19,12,7,7,1,1,0,1
St Kilda,"Stanley, Rhys",18,13,14,5,0,0,0,0
St Kilda,"Steven, Jack",25,17,5,8,1,0,0,2
St Kilda,"Armitage, David",18,9,5,9,0,1,0,4
St Kilda,"Blake, Jason",9,4,4,5,0,0,0,3
St Kilda,"Dal Santo, Nick",25,11,3,14,0,1,0,3
St Kilda,"Dempster, Sean",16,13,6,3,0,0,0,2
St Kilda,"Fisher, Sam",14,10,4,4,0,0,0,1
St Kilda,"Geary, Jarryn",12,4,2,8,0,1,0,2
St Kilda,"Gilbert, Sam",19,7,2,12,1,0,0,3
St Kilda,"Hayes, Lenny",24,12,3,12,0,1,1,3
St Kilda,"Jones, Clinton",24,17,2,7,0,0,0,6
St Kilda,"Maister, Beau",11,7,7,4,2,0,0,1
St Kilda,"McEvoy, Ben",19,7,6,12,1,0,26,3
St Kilda,"Milera, Terry",9,5,4,4,0,0,0,5
St Kilda,"Milne, Stephen",8,7,3,1,1,1,0,0
St Kilda,"Montagna, Leigh",27,18,2,9,0,0,0,8
St Kilda,"Newnes, Jack",14,10,4,4,0,0,0,2
St Kilda,"Riewoldt, Nick",20,12,11,8,4,0,0,0
St Kilda,"Roberton, Dylan",17,11,3,6,0,0,0,2
St Kilda,"Saad, Ahmed",7,6,2,1,2,2,0,2
St Kilda,"Schneider, Adam",13,7,5,6,0,0,0,0
St Kilda,"Siposs, Arryn",9,7,4,2,0,0,0,0
St Kilda,"Stanley, Rhys",12,7,8,5,1,0,2,1
St Kilda,"Steven, Jack",23,14,4,9,0,0,0,4
St Kilda,"Armitage, David",31,19,8,12,4,1,0,2
St Kilda,"Blake, Jason",16,10,5,6,0,0,2,2
St Kilda,"Dal Santo, Nick",24,9,3,15,0,1,0,2
St Kilda,"Fisher, Sam",17,12,7,5,0,0,0,0
St Kilda,"Geary, Jarryn",23,12,6,11,0,0,0,2
St Kilda,"Gilbert, Sam",23,8,5,15,1,1,0,2
St Kilda,"Hayes, Lenny",24,8,6,16,0,0,0,4
St Kilda,"Jones, Clinton",20,8,4,12,0,0,0,4
St Kilda,"Lee, Tom",9,4,3,5,1,0,0,2
St Kilda,"Maister, Beau",11,10,5,1,2,3,0,1
St Kilda,"McEvoy, Ben",18,6,5,12,0,0,30,2
St Kilda,"Milera, Terry",18,11,4,7,2,1,0,0
St Kilda,"Milne, Stephen",14,10,6,4,3,1,0,1
St Kilda,"Montagna, Leigh",30,14,5,16,1,0,0,3
St Kilda,"Newnes, Jack",2,2,0,0,0,0,0,0
St Kilda,"Ray, Farren",21,15,6,6,0,0,0,2
St Kilda,"Riewoldt, Nick",18,13,9,5,3,2,1,1
St Kilda,"Roberton, Dylan",27,14,7,13,0,0,0,3
St Kilda,"Saad, Ahmed",11,8,4,3,3,0,0,1
St Kilda,"Stanley, Rhys",17,13,5,4,0,0,0,3
St Kilda,"Steven, Jack",32,17,6,15,1,1,0,2
St Kilda,"Wright, Nathan",22,8,2,14,0,1,0,3
St Kilda,"Armitage, David",19,14,3,5,1,1,0,7
St Kilda,"Dal Santo, Nick",24,11,3,13,0,1,0,5
St Kilda,"Dennis-Lane, Trent",9,3,2,6,2,0,0,6
St Kilda,"Fisher, Sam",20,12,8,8,0,0,0,1
St Kilda,"Geary, Jarryn",16,9,5,7,0,0,0,0
St Kilda,"Gilbert, Sam",12,5,1,7,1,0,1,4
St Kilda,"Hayes, Lenny",25,14,5,11,0,0,0,4
St Kilda,"Jones, Clinton",31,13,8,18,0,0,0,3
St Kilda,"Maister, Beau",7,7,3,0,2,1,2,0
St Kilda,"McEvoy, Ben",16,5,7,11,0,0,27,3
St Kilda,"Milera, Terry",8,5,0,3,0,1,0,1
St Kilda,"Milne, Stephen",10,8,1,2,1,2,0,2
St Kilda,"Montagna, Leigh",29,19,4,10,0,0,0,2
St Kilda,"Ray, Farren",14,12,7,2,0,1,0,2
St Kilda,"Riewoldt, Nick",12,12,8,0,3,1,0,4
St Kilda,"Roberton, Dylan",18,8,5,10,0,0,0,2
St Kilda,"Ross, Sebastian",6,3,2,3,0,0,0,0
St Kilda,"Saad, Ahmed",8,5,2,3,2,2,0,5
St Kilda,"Simpkin, Tom",7,3,0,4,0,0,0,2
St Kilda,"Stanley, Rhys",5,4,1,1,0,0,3,1
St Kilda,"Steven, Jack",21,10,2,11,1,1,0,3
St Kilda,"Wright, Nathan",7,3,0,4,0,0,0,0
St Kilda,"Armitage, David",11,8,1,3,0,0,0,6
St Kilda,"Dal Santo, Nick",21,13,0,8,0,1,1,6
St Kilda,"Dempster, Sean",12,7,5,5,0,0,0,3
St Kilda,"Dennis-Lane, Trent",10,7,5,3,1,1,0,4
St Kilda,"Fisher, Sam",16,9,5,7,0,0,0,2
St Kilda,"Geary, Jarryn",20,9,5,11,1,0,0,4
St Kilda,"Gilbert, Sam",13,4,5,9,0,0,0,7
St Kilda,"Hayes, Lenny",28,17,3,11,0,0,0,8
St Kilda,"Jones, Clinton",22,13,3,9,0,0,0,6
St Kilda,"Koschitzke, Justin",7,5,4,2,1,0,2,5
St Kilda,"Lee, Tom",5,4,2,1,0,2,0,2
St Kilda,"McEvoy, Ben",10,6,1,4,0,0,27,5
St Kilda,"Montagna, Leigh",22,18,3,4,2,0,0,5
St Kilda,"Murdoch, Brodie",8,5,3,3,0,0,0,1
St Kilda,"Riewoldt, Nick",27,22,13,5,2,1,2,7
St Kilda,"Roberton, Dylan",15,12,4,3,0,0,1,5
St Kilda,"Ross, Sebastian",17,7,2,10,1,0,0,0
St Kilda,"Saad, Ahmed",6,5,1,1,0,2,0,6
St Kilda,"Saunders, Josh",6,3,1,3,0,0,0,5
St Kilda,"Stanley, Rhys",15,8,0,7,0,0,3,3
St Kilda,"Steven, Jack",22,10,0,12,1,0,0,3
St Kilda,"Wright, Nathan",11,5,1,6,0,0,0,5
St Kilda,"Armitage, David",22,14,4,8,1,0,0,3
St Kilda,"Dal Santo, Nick",16,11,3,5,0,0,0,0
St Kilda,"Dempster, Sean",10,7,6,3,0,0,0,1
St Kilda,"Fisher, Sam",15,8,6,7,0,0,5,1
St Kilda,"Geary, Jarryn",9,5,2,4,0,0,0,2
St Kilda,"Gilbert, Sam",6,4,2,2,1,0,0,2
St Kilda,"Jones, Clinton",16,10,4,6,0,0,0,5
St Kilda,"Koschitzke, Justin",7,4,5,3,1,0,10,0
St Kilda,"McEvoy, Ben",10,7,6,3,0,1,23,5
St Kilda,"Milne, Stephen",10,9,2,1,1,2,0,0
St Kilda,"Montagna, Leigh",30,19,6,11,0,0,0,2
St Kilda,"Murdoch, Brodie",1,1,0,0,0,0,0,1
St Kilda,"Newnes, Jack",12,4,3,8,0,0,0,1
St Kilda,"Riewoldt, Nick",19,13,11,6,4,1,1,3
St Kilda,"Roberton, Dylan",21,15,5,6,1,0,0,1
St Kilda,"Ross, Sebastian",14,7,2,7,0,0,0,4
St Kilda,"Saad, Ahmed",9,4,4,5,0,0,0,2
St Kilda,"Saunders, Josh",9,5,2,4,0,2,0,2
St Kilda,"Siposs, Arryn",12,10,6,2,2,3,0,2
St Kilda,"Stanley, Rhys",11,9,4,2,0,0,0,1
St Kilda,"Steven, Jack",21,11,5,10,0,0,0,1
St Kilda,"Wright, Nathan",10,5,3,5,0,0,0,1
St Kilda,"Armitage, David",20,12,7,8,1,0,0,3
St Kilda,"Dal Santo, Nick",26,12,3,14,0,0,1,4
St Kilda,"Dempster, Sean",21,11,8,10,0,0,0,3
St Kilda,"Fisher, Sam",27,17,9,10,0,0,0,3
St Kilda,"Geary, Jarryn",12,9,1,3,0,3,0,7
St Kilda,"Gwilt, James",24,14,7,10,0,0,0,2
St Kilda,"Hickey, Tom",14,5,5,9,0,0,9,4
St Kilda,"McEvoy, Ben",20,8,10,12,0,0,18,8
St Kilda,"Milera, Terry",14,11,5,3,1,3,0,1
St Kilda,"Milne, Stephen",11,8,5,3,2,0,0,1
St Kilda,"Montagna, Leigh",16,10,1,6,0,0,0,9
St Kilda,"Newnes, Jack",15,7,7,8,0,0,0,5
St Kilda,"Ray, Farren",15,9,3,6,0,1,0,2
St Kilda,"Riewoldt, Nick",25,15,13,10,3,0,0,0
St Kilda,"Roberton, Dylan",16,12,6,4,1,0,0,1
St Kilda,"Ross, Sebastian",21,9,6,12,0,0,1,6
St Kilda,"Saad, Ahmed",9,6,3,3,2,1,0,5
St Kilda,"Siposs, Arryn",11,8,4,3,1,2,0,2
St Kilda,"Stanley, Rhys",12,7,4,5,0,0,0,1
St Kilda,"Steven, Jack",39,22,6,17,0,1,0,7
St Kilda,"Webster, Jimmy",9,4,2,5,0,0,0,3
St Kilda,"Wright, Nathan",11,1,1,10,0,0,0,4
St Kilda,"Armitage, David",16,6,1,10,1,0,0,6
St Kilda,"Dal Santo, Nick",23,10,3,13,0,0,0,2
St Kilda,"Dempster, Sean",10,8,3,2,0,0,0,3
St Kilda,"Fisher, Sam",19,11,7,8,0,0,0,3
St Kilda,"Geary, Jarryn",15,7,5,8,0,0,0,6
St Kilda,"Gwilt, James",18,12,3,6,0,0,0,1
St Kilda,"Hickey, Tom",9,7,5,2,0,1,4,0
St Kilda,"Maister, Beau",4,2,1,2,0,1,0,0
St Kilda,"McEvoy, Ben",8,3,5,5,0,0,15,0
St Kilda,"Milera, Terry",11,9,4,2,0,2,0,1
St Kilda,"Milne, Stephen",11,7,2,4,2,0,0,0
St Kilda,"Montagna, Leigh",34,21,9,13,0,1,0,3
St Kilda,"Newnes, Jack",25,13,7,12,0,0,0,3
St Kilda,"Ray, Farren",23,14,6,9,0,1,0,4
St Kilda,"Riewoldt, Nick",18,16,12,2,1,3,0,0
St Kilda,"Roberton, Dylan",23,15,7,8,0,0,0,1
St Kilda,"Ross, Sebastian",18,7,5,11,0,0,0,0
St Kilda,"Saad, Ahmed",12,7,3,5,2,1,0,1
St Kilda,"Siposs, Arryn",8,4,2,4,0,0,0,0
St Kilda,"Stanley, Rhys",9,7,3,2,0,0,0,0
St Kilda,"Steven, Jack",22,12,6,10,0,1,0,5
St Kilda,"Webster, Jimmy",14,7,4,7,0,0,0,2
St Kilda,"Dal Santo, Nick",19,13,3,6,1,0,3,0
St Kilda,"Dempster, Sean",13,11,4,2,0,0,0,3
St Kilda,"Fisher, Sam",19,11,6,8,0,0,2,2
St Kilda,"Geary, Jarryn",12,5,5,7,0,0,0,0
St Kilda,"Gwilt, James",16,7,3,9,0,0,0,3
St Kilda,"Hayes, Lenny",13,7,3,6,0,1,1,7
St Kilda,"Hickey, Tom",15,5,4,10,0,0,17,2
St Kilda,"Jones, Clinton",12,9,2,3,1,0,0,7
St Kilda,"Maister, Beau",12,8,5,4,1,1,0,3
St Kilda,"McEvoy, Ben",10,2,4,8,0,0,13,5
St Kilda,"Milne, Stephen",9,8,4,1,1,2,0,3
St Kilda,"Montagna, Leigh",27,16,6,11,2,1,0,6
St Kilda,"Newnes, Jack",10,7,3,3,0,0,0,1
St Kilda,"Ray, Farren",15,9,5,6,1,0,0,1
St Kilda,"Riewoldt, Nick",12,11,7,1,4,2,0,0
St Kilda,"Roberton, Dylan",17,10,7,7,0,0,0,4
St Kilda,"Ross, Sebastian",22,8,3,14,0,1,0,6
St Kilda,"Saad, Ahmed",11,5,3,6,1,1,0,9
St Kilda,"Siposs, Arryn",12,5,1,7,2,0,0,5
St Kilda,"Stanley, Rhys",10,8,3,2,0,0,0,0
St Kilda,"Steven, Jack",27,15,8,12,1,0,0,3
St Kilda,"Webster, Jimmy",4,4,1,0,0,0,0,2
St Kilda,"Armitage, David",17,10,2,7,0,0,0,6
St Kilda,"Dal Santo, Nick",25,12,7,13,0,0,0,3
St Kilda,"Dempster, Sean",8,8,3,0,0,0,0,2
St Kilda,"Ferguson, Jackson",3,0,0,3,0,0,0,0
St Kilda,"Fisher, Sam",14,8,4,6,0,0,0,1
St Kilda,"Geary, Jarryn",16,7,0,9,1,0,0,0
St Kilda,"Gwilt, James",12,8,4,4,0,0,1,1
St Kilda,"Hickey, Tom",7,1,2,6,0,0,10,2
St Kilda,"McEvoy, Ben",8,5,3,3,0,1,18,2
St Kilda,"Milne, Stephen",13,10,4,3,1,0,0,1
St Kilda,"Montagna, Leigh",23,17,2,6,1,0,0,5
St Kilda,"Newnes, Jack",11,5,3,6,0,0,0,5
St Kilda,"Ray, Farren",25,17,6,8,0,0,1,4
St Kilda,"Riewoldt, Nick",12,10,7,2,3,0,0,3
St Kilda,"Roberton, Dylan",16,10,2,6,0,0,0,1
St Kilda,"Ross, Sebastian",12,5,3,7,0,0,0,5
St Kilda,"Saad, Ahmed",3,0,0,3,0,0,0,2
St Kilda,"Siposs, Arryn",8,2,1,6,0,0,0,1
St Kilda,"Stanley, Rhys",12,9,7,3,2,2,9,2
St Kilda,"Steven, Jack",24,10,1,14,1,1,0,6
St Kilda,"Webster, Jimmy",9,6,5,3,1,0,0,2
St Kilda,"Wright, Nathan",13,8,3,5,0,0,0,0
St Kilda,"Armitage, David",22,13,2,9,0,0,0,12
St Kilda,"Dal Santo, Nick",25,15,1,10,0,0,0,5
St Kilda,"Dempster, Sean",16,10,6,6,0,0,1,3
St Kilda,"Dennis-Lane, Trent",13,9,8,4,1,2,0,3
St Kilda,"Dunell, Sam",12,6,4,6,0,0,0,3
St Kilda,"Geary, Jarryn",10,7,2,3,0,0,0,3
St Kilda,"Gwilt, James",8,7,3,1,0,0,0,0
St Kilda,"Jones, Clinton",17,9,1,8,0,0,0,4
St Kilda,"Maister, Beau",12,11,10,1,2,2,3,1
St Kilda,"McEvoy, Ben",15,7,6,8,0,0,11,3
St Kilda,"Milne, Stephen",13,10,6,3,5,1,0,3
St Kilda,"Montagna, Leigh",29,20,4,9,0,2,0,5
St Kilda,"Newnes, Jack",18,13,5,5,0,2,0,3
St Kilda,"Ray, Farren",23,13,3,10,0,1,0,1
St Kilda,"Riewoldt, Nick",16,12,9,4,1,1,2,2
St Kilda,"Roberton, Dylan",12,5,3,7,0,0,0,1
St Kilda,"Ross, Sebastian",10,4,2,6,0,0,0,5
St Kilda,"Saad, Ahmed",7,3,3,4,1,0,0,1
St Kilda,"Saunders, Josh",3,3,1,0,0,0,0,2
St Kilda,"Stanley, Rhys",11,8,3,3,1,2,6,5
St Kilda,"Steven, Jack",19,8,2,11,0,0,0,9
St Kilda,"Webster, Jimmy",10,7,3,3,0,0,0,0
St Kilda,"Armitage, David",24,14,1,10,1,0,0,5
St Kilda,"Dal Santo, Nick",28,11,2,17,0,0,1,3
St Kilda,"Dempster, Sean",19,11,7,8,1,0,0,2
St Kilda,"Dennis-Lane, Trent",13,3,4,10,1,0,0,4
St Kilda,"Dunell, Sam",17,11,8,6,0,2,0,4
St Kilda,"Geary, Jarryn",27,15,5,12,1,0,0,3
St Kilda,"Gwilt, James",22,15,9,7,0,0,0,0
St Kilda,"Jones, Clinton",11,5,2,6,1,0,0,3
St Kilda,"Koschitzke, Justin",7,4,2,3,2,1,5,1
St Kilda,"McEvoy, Ben",6,3,1,3,0,0,11,0
St Kilda,"Milera, Terry",23,11,7,12,1,0,0,1
St Kilda,"Montagna, Leigh",35,20,9,15,1,0,0,5
St Kilda,"Murdoch, Brodie",11,6,3,5,0,0,0,3
St Kilda,"Newnes, Jack",20,13,5,7,0,0,0,2
St Kilda,"Ray, Farren",29,16,7,13,2,0,0,1
St Kilda,"Riewoldt, Nick",21,16,10,5,3,1,0,2
St Kilda,"Roberton, Dylan",13,11,7,2,0,1,0,1
St Kilda,"Ross, Sebastian",18,7,3,11,1,0,0,2
St Kilda,"Simpkin, Tom",9,4,3,5,0,0,0,1
St Kilda,"Stanley, Rhys",8,3,0,5,1,0,10,1
St Kilda,"Steven, Jack",30,18,1,12,0,0,1,2
St Kilda,"Webster, Jimmy",9,4,3,5,0,0,0,1
St Kilda,"Armitage, David",25,14,4,11,0,0,0,6
St Kilda,"Dal Santo, Nick",25,16,5,9,1,1,2,6
St Kilda,"Dempster, Sean",14,9,6,5,0,0,0,0
St Kilda,"Dennis-Lane, Trent",10,8,5,2,2,3,0,7
St Kilda,"Dunell, Sam",2,1,0,1,0,0,0,0
St Kilda,"Geary, Jarryn",16,9,1,7,0,0,0,8
St Kilda,"Gwilt, James",16,10,4,6,0,0,0,2
St Kilda,"Jones, Clinton",24,21,5,3,1,1,0,4
St Kilda,"Koschitzke, Justin",5,3,2,2,0,0,4,2
St Kilda,"McEvoy, Ben",12,6,7,6,0,0,24,2
St Kilda,"Milera, Terry",7,2,1,5,0,0,0,2
St Kilda,"Montagna, Leigh",22,15,3,7,1,0,0,1
St Kilda,"Murdoch, Brodie",12,9,6,3,1,0,0,3
St Kilda,"Newnes, Jack",15,9,7,6,0,0,0,2
St Kilda,"Ray, Farren",18,8,6,10,0,0,0,2
St Kilda,"Riewoldt, Nick",22,12,8,10,1,1,0,2
St Kilda,"Roberton, Dylan",9,7,2,2,0,0,0,2
St Kilda,"Ross, Sebastian",9,5,2,4,0,0,0,2
St Kilda,"Stanley, Rhys",15,6,5,9,0,0,6,1
St Kilda,"Steven, Jack",23,12,5,11,1,0,0,4
St Kilda,"Webster, Jimmy",12,7,5,5,0,0,0,0
St Kilda,"Wright, Nathan",13,6,3,7,0,1,0,2
St Kilda,"Armitage, David",23,11,4,12,0,1,0,9
St Kilda,"Dal Santo, Nick",21,9,5,12,1,0,0,3
St Kilda,"Dempster, Sean",11,8,3,3,0,0,0,0
St Kilda,"Dennis-Lane, Trent",7,5,4,2,2,0,0,2
St Kilda,"Geary, Jarryn",19,13,5,6,0,0,0,2
St Kilda,"Gwilt, James",10,6,1,4,0,0,0,3
St Kilda,"Hayes, Lenny",25,9,2,16,0,0,0,4
St Kilda,"Hickey, Tom",7,2,1,5,0,0,12,2
St Kilda,"Jones, Clinton",17,6,5,11,1,0,0,4
St Kilda,"Lee, Tom",8,6,6,2,3,1,0,0
St Kilda,"McEvoy, Ben",16,8,7,8,1,0,15,3
St Kilda,"Milera, Terry",5,4,2,1,0,0,0,0
St Kilda,"Montagna, Leigh",31,24,2,7,0,0,0,7
St Kilda,"Murdoch, Brodie",13,7,3,6,0,0,0,5
St Kilda,"Newnes, Jack",18,8,3,10,0,0,0,6
St Kilda,"Ray, Farren",18,12,4,6,0,1,0,8
St Kilda,"Roberton, Dylan",14,8,2,6,0,0,0,5
St Kilda,"Saad, Ahmed",9,6,1,3,2,0,0,3
St Kilda,"Saunders, Josh",17,8,1,9,1,0,0,2
St Kilda,"Stanley, Rhys",6,4,1,2,0,0,0,4
St Kilda,"Steven, Jack",26,14,3,12,0,0,0,4
St Kilda,"Wright, Nathan",9,3,3,6,0,0,0,1
St Kilda,"Armitage, David",25,17,4,8,0,1,0,8
St Kilda,"Dal Santo, Nick",20,10,2,10,0,0,1,3
St Kilda,"Dempster, Sean",17,9,5,8,0,0,0,3
St Kilda,"Dennis-Lane, Trent",6,2,1,4,0,0,0,2
St Kilda,"Geary, Jarryn",14,11,7,3,0,0,0,4
St Kilda,"Gwilt, James",20,12,9,8,0,0,0,0
St Kilda,"Hayes, Lenny",28,14,2,14,0,0,1,5
St Kilda,"Hickey, Tom",15,5,6,10,0,2,9,0
St Kilda,"Jones, Clinton",21,11,0,10,2,0,0,2
St Kilda,"Lee, Tom",12,7,5,5,3,3,0,2
St Kilda,"McEvoy, Ben",7,4,5,3,0,0,23,5
St Kilda,"Milera, Terry",5,3,1,2,0,0,0,4
St Kilda,"Milne, Stephen",10,10,3,0,2,1,0,1
St Kilda,"Montagna, Leigh",22,16,1,6,0,0,0,1
St Kilda,"Murdoch, Brodie",8,3,2,5,0,0,0,2
St Kilda,"Newnes, Jack",16,7,4,9,0,0,0,1
St Kilda,"Ray, Farren",25,17,5,8,0,1,1,1
St Kilda,"Riewoldt, Nick",17,13,10,4,1,4,0,2
St Kilda,"Roberton, Dylan",24,10,7,14,0,0,0,1
St Kilda,"Saunders, Josh",6,3,3,3,0,1,0,2
St Kilda,"Stanley, Rhys",10,8,4,2,1,0,7,0
St Kilda,"Steven, Jack",22,14,0,8,1,0,0,6
St Kilda,"Armitage, David",20,11,1,9,0,2,0,10
St Kilda,"Curren, Tom",7,4,1,3,1,0,0,2
St Kilda,"Dal Santo, Nick",33,17,7,16,0,0,0,5
St Kilda,"Dempster, Sean",15,11,6,4,0,0,0,0
St Kilda,"Dennis-Lane, Trent",8,6,4,2,0,3,0,5
St Kilda,"Gwilt, James",17,9,4,8,0,0,0,1
St Kilda,"Hayes, Lenny",19,7,4,12,1,1,1,7
St Kilda,"Hickey, Tom",9,3,1,6,0,1,11,2
St Kilda,"Jones, Clinton",21,10,5,11,0,0,0,3
St Kilda,"Lee, Tom",7,2,2,5,2,0,0,2
St Kilda,"McEvoy, Ben",13,7,4,6,3,0,34,1
St Kilda,"Milne, Stephen",8,7,2,1,1,0,0,2
St Kilda,"Montagna, Leigh",35,24,7,11,0,1,0,6
St Kilda,"Newnes, Jack",14,7,3,7,0,0,0,4
St Kilda,"Ray, Farren",22,13,3,9,0,0,1,0
St Kilda,"Riewoldt, Nick",20,17,12,3,2,3,0,3
St Kilda,"Roberton, Dylan",10,6,0,4,0,0,0,0
St Kilda,"Saunders, Josh",18,9,3,9,0,1,0,4
St Kilda,"Simpkin, Tom",13,10,6,3,0,0,0,0
St Kilda,"Stanley, Rhys",4,2,1,2,0,0,1,0
St Kilda,"Steven, Jack",25,15,5,10,3,0,0,4
St Kilda,"Webster, Jimmy",12,6,3,6,0,0,0,3
St Kilda,"Armitage, David",21,5,2,16,0,0,0,4
St Kilda,"Curren, Tom",2,1,0,1,0,0,0,1
St Kilda,"Dal Santo, Nick",25,9,1,16,0,0,0,2
St Kilda,"Dempster, Sean",17,10,7,7,0,0,0,2
St Kilda,"Geary, Jarryn",15,5,5,10,0,0,0,3
St Kilda,"Gwilt, James",5,3,0,2,0,0,1,0
St Kilda,"Hayes, Lenny",22,9,2,13,0,2,0,6
St Kilda,"Hickey, Tom",9,1,2,8,0,0,16,3
St Kilda,"Jones, Clinton",27,9,3,18,0,0,0,4
St Kilda,"Lee, Tom",7,6,4,1,2,0,0,0
St Kilda,"McEvoy, Ben",8,5,3,3,0,0,21,1
St Kilda,"Milne, Stephen",12,7,2,5,0,0,0,1
St Kilda,"Montagna, Leigh",34,16,3,18,1,1,0,3
St Kilda,"Newnes, Jack",24,12,7,12,0,0,0,0
St Kilda,"Ray, Farren",21,14,6,7,0,0,1,4
St Kilda,"Riewoldt, Nick",9,6,1,3,2,1,0,2
St Kilda,"Saunders, Josh",8,4,1,4,0,0,0,4
St Kilda,"Simpkin, Tom",10,5,0,5,0,0,0,5
St Kilda,"Siposs, Arryn",6,4,3,2,0,2,0,1
St Kilda,"Stanley, Rhys",6,4,1,2,0,0,4,1
St Kilda,"Steven, Jack",36,23,5,13,0,0,0,4
St Kilda,"Webster, Jimmy",14,4,0,10,0,0,0,3
St Kilda,"Armitage, David",30,16,6,14,0,2,0,4
St Kilda,"Curren, Tom",17,9,4,8,0,0,0,1
St Kilda,"Dal Santo, Nick",31,21,4,10,1,2,3,2
St Kilda,"Dempster, Sean",18,10,7,8,0,0,0,4
St Kilda,"Dunell, Sam",17,13,6,4,0,0,0,0
St Kilda,"Geary, Jarryn",11,6,4,5,0,0,0,0
St Kilda,"Hayes, Lenny",22,10,4,12,0,0,1,2
St Kilda,"Jones, Clinton",18,10,0,8,0,0,0,2
St Kilda,"Lee, Tom",16,10,3,6,2,1,3,3
St Kilda,"McEvoy, Ben",11,4,2,7,0,0,24,2
St Kilda,"Milne, Stephen",12,9,5,3,1,0,0,0
St Kilda,"Montagna, Leigh",28,21,6,7,2,0,0,1
St Kilda,"Ray, Farren",20,11,7,9,0,0,1,3
St Kilda,"Riewoldt, Nick",16,11,8,5,2,2,0,2
St Kilda,"Roberton, Dylan",19,12,7,7,0,0,0,3
St Kilda,"Saad, Ahmed",3,3,1,0,2,0,0,1
St Kilda,"Saunders, Josh",13,7,3,6,0,0,0,3
St Kilda,"Simpkin, Tom",9,6,2,3,0,0,1,0
St Kilda,"Siposs, Arryn",11,1,2,10,0,0,0,0
St Kilda,"Stanley, Rhys",7,3,3,4,0,1,4,2
St Kilda,"Steven, Jack",17,11,2,6,1,0,0,5
St Kilda,"Webster, Jimmy",15,9,5,6,0,0,0,1
St Kilda,"Armitage, David",21,8,5,13,0,0,0,2
St Kilda,"Blake, Jason",11,6,3,5,0,0,0,2
St Kilda,"Curren, Tom",20,11,3,9,0,2,0,3
St Kilda,"Dal Santo, Nick",28,16,3,12,0,0,0,4
St Kilda,"Dempster, Sean",10,8,3,2,0,0,0,3
St Kilda,"Geary, Jarryn",15,11,3,4,0,0,0,4
St Kilda,"Gwilt, James",5,1,0,4,0,0,0,0
St Kilda,"Hayes, Lenny",25,11,4,14,0,0,1,3
St Kilda,"Jones, Clinton",22,10,2,12,0,0,0,1
St Kilda,"Lee, Tom",10,5,4,5,0,1,0,1
St Kilda,"McEvoy, Ben",9,3,4,6,0,0,20,3
St Kilda,"Minchington, Darren",8,6,4,2,1,1,0,0
St Kilda,"Montagna, Leigh",35,19,6,16,0,0,0,2
St Kilda,"Murdoch, Brodie",7,5,7,2,1,0,0,1
St Kilda,"Newnes, Jack",15,10,7,5,0,0,0,2
St Kilda,"Ray, Farren",30,20,11,10,0,1,1,4
St Kilda,"Riewoldt, Nick",21,14,9,7,1,3,2,2
St Kilda,"Roberton, Dylan",19,13,5,6,0,0,0,2
St Kilda,"Saunders, Josh",11,5,1,6,1,1,0,1
St Kilda,"Schneider, Adam",14,10,3,4,3,1,0,3
St Kilda,"Steven, Jack",33,12,4,21,0,1,0,3
St Kilda,"Webster, Jimmy",12,7,4,5,0,0,0,0
St Kilda,"Armitage, David",30,11,2,19,0,0,0,8
St Kilda,"Blake, Jason",9,7,1,2,0,0,0,3
St Kilda,"Curren, Tom",20,14,5,6,1,2,0,2
St Kilda,"Dal Santo, Nick",19,12,1,7,0,0,3,3
St Kilda,"Dempster, Sean",20,12,9,8,0,0,0,1
St Kilda,"Geary, Jarryn",23,14,10,9,0,0,0,3
St Kilda,"Gilbert, Sam",15,5,5,10,0,0,0,2
St Kilda,"Hickey, Tom",11,5,6,6,1,0,20,0
St Kilda,"Jones, Clinton",18,10,1,8,0,0,0,2
St Kilda,"Lee, Tom",6,3,2,3,1,0,2,0
St Kilda,"McEvoy, Ben",2,0,1,2,0,0,8,2
St Kilda,"Milne, Stephen",6,5,2,1,0,2,0,0
St Kilda,"Minchington, Darren",9,4,4,5,1,0,0,2
St Kilda,"Montagna, Leigh",32,16,4,16,0,1,0,4
St Kilda,"Newnes, Jack",18,14,6,4,0,0,0,4
St Kilda,"Ray, Farren",20,13,6,7,0,0,0,0
St Kilda,"Riewoldt, Nick",22,10,8,12,2,3,2,2
St Kilda,"Roberton, Dylan",20,13,7,7,0,0,1,0
St Kilda,"Ross, Sebastian",14,3,1,11,0,0,0,2
St Kilda,"Saunders, Josh",7,2,1,5,0,0,0,1
St Kilda,"Schneider, Adam",21,9,4,12,0,0,0,3
St Kilda,"Steven, Jack",35,17,5,18,2,2,0,2
St Kilda,"Armitage, David",17,10,2,7,0,0,0,3
St Kilda,"Blake, Jason",14,6,8,8,0,0,0,0
St Kilda,"Curren, Tom",22,11,9,11,0,0,0,3
St Kilda,"Dal Santo, Nick",31,19,7,12,1,0,0,1
St Kilda,"Dempster, Sean",26,19,8,7,0,0,0,0
St Kilda,"Geary, Jarryn",23,15,9,8,1,0,0,3
St Kilda,"Gilbert, Sam",25,15,10,10,0,0,0,2
St Kilda,"Hayes, Lenny",22,13,2,9,0,0,0,1
St Kilda,"Hickey, Tom",17,7,6,10,1,0,16,2
St Kilda,"Jones, Clinton",22,10,2,12,0,0,0,5
St Kilda,"Ledger, Tom",11,8,4,3,1,0,0,0
St Kilda,"McEvoy, Ben",10,7,7,3,0,0,26,7
St Kilda,"Milne, Stephen",17,13,4,4,4,2,0,0
St Kilda,"Montagna, Leigh",33,18,6,15,3,1,1,1
St Kilda,"Murdoch, Brodie",3,3,3,0,0,1,0,1
St Kilda,"Newnes, Jack",14,8,4,6,0,0,0,1
St Kilda,"Ray, Farren",21,15,8,6,0,0,1,1
St Kilda,"Riewoldt, Nick",26,20,15,6,4,5,1,1
St Kilda,"Ross, Sebastian",14,2,2,12,0,0,0,4
St Kilda,"Schneider, Adam",22,14,6,8,1,1,0,2
St Kilda,"Shenton, Cameron",7,3,3,4,0,0,0,1
St Kilda,"Steven, Jack",22,13,2,9,1,0,0,4
St Kilda,"Armitage, David",20,7,3,13,0,0,0,2
St Kilda,"Blake, Jason",21,9,7,12,1,1,0,0
St Kilda,"Curren, Tom",26,15,5,11,1,2,0,3
St Kilda,"Dal Santo, Nick",34,17,5,17,0,0,0,0
St Kilda,"Dempster, Sean",29,18,11,11,0,0,0,0
St Kilda,"Geary, Jarryn",34,19,8,15,0,0,0,3
St Kilda,"Gilbert, Sam",21,15,11,6,0,0,0,1
St Kilda,"Hayes, Lenny",24,10,4,14,1,0,0,3
St Kilda,"Hickey, Tom",8,1,3,7,0,1,9,0
St Kilda,"Jones, Clinton",35,14,7,21,0,0,0,4
St Kilda,"Koschitzke, Justin",7,5,6,2,0,4,0,0
St Kilda,"Ledger, Tom",23,7,4,16,1,0,0,6
St Kilda,"Lee, Tom",10,6,7,4,3,1,0,3
St Kilda,"McEvoy, Ben",14,8,7,6,1,0,12,1
St Kilda,"Milne, Stephen",21,15,8,6,2,3,0,1
St Kilda,"Montagna, Leigh",47,34,12,13,2,0,0,3
St Kilda,"Ray, Farren",25,16,6,9,0,0,0,2
St Kilda,"Riewoldt, Nick",23,15,12,8,2,0,1,3
St Kilda,"Roberton, Dylan",12,3,5,9,0,0,0,2
St Kilda,"Ross, Sebastian",22,5,2,17,1,0,0,6
St Kilda,"Schneider, Adam",17,12,4,5,0,2,0,1
St Kilda,"Steven, Jack",47,17,6,30,1,0,0,4
Sydney,"Armstrong, Tony",6,4,3,2,0,0,0,0
Sydney,"Bolton, Jude",14,5,1,9,2,1,0,2
Sydney,"Goodes, Adam",22,10,4,12,2,1,0,1
Sydney,"Grundy, Heath",21,13,6,8,0,0,0,1
Sydney,"Hannebery, Dan",23,12,3,11,0,1,0,3
Sydney,"Jack, Kieren",25,15,2,10,3,0,0,5
Sydney,"Jetta, Lewis",8,5,1,3,0,0,0,5
Sydney,"Kennedy, Josh",28,12,0,16,1,0,0,3
Sydney,"Malceski, Nick",20,17,3,3,0,0,0,2
Sydney,"Mattner, Martin",10,7,3,3,0,0,0,4
Sydney,"McGlynn, Ben",13,8,3,5,2,1,0,6
Sydney,"McVeigh, Jarrad",18,9,4,9,1,0,0,5
Sydney,"Mumford, Shane",16,11,7,5,1,3,25,3
Sydney,"OKeefe, Ryan",27,19,6,8,0,1,0,6
Sydney,"Parker, Luke",20,14,3,6,0,0,0,6
Sydney,"Pyke, Mike",11,6,3,5,2,0,24,2
Sydney,"Rampe, Dane",7,5,0,2,0,0,0,3
Sydney,"Reid, Sam",11,7,3,4,2,0,0,2
Sydney,"Richards, Ted",17,4,6,13,0,0,0,0
Sydney,"Roberts-Thomson, Lewis",10,7,1,3,0,0,0,3
Sydney,"Shaw, Rhyce",21,13,4,8,0,0,0,2
Sydney,"Smith, Nick",13,4,4,9,0,0,0,5
Sydney,"Bird, Craig",7,4,1,3,0,0,0,0
Sydney,"Bolton, Jude",22,12,3,10,1,0,0,1
Sydney,"Everitt, Andrejs",18,11,2,7,2,1,0,2
Sydney,"Goodes, Adam",12,6,2,6,0,1,0,2
Sydney,"Grundy, Heath",16,6,2,10,0,0,0,2
Sydney,"Hannebery, Dan",24,18,4,6,0,1,0,6
Sydney,"Jack, Kieren",28,18,2,10,1,0,0,9
Sydney,"Jetta, Lewis",15,14,2,1,1,0,0,3
Sydney,"Kennedy, Josh",28,13,2,15,1,0,0,4
Sydney,"Malceski, Nick",19,13,0,6,0,0,0,1
Sydney,"Mattner, Martin",6,4,1,2,0,0,0,4
Sydney,"McGlynn, Ben",14,10,2,4,1,3,0,4
Sydney,"McVeigh, Jarrad",27,18,4,9,4,1,0,4
Sydney,"Mumford, Shane",9,0,1,9,0,0,21,2
Sydney,"OKeefe, Ryan",27,19,1,8,2,1,1,3
Sydney,"Parker, Luke",25,12,4,13,2,0,0,9
Sydney,"Pyke, Mike",13,6,5,7,2,0,35,4
Sydney,"Reid, Sam",13,7,4,6,0,0,0,3
Sydney,"Richards, Ted",12,9,0,3,0,0,0,3
Sydney,"Roberts-Thomson, Lewis",11,5,1,6,0,0,0,2
Sydney,"Shaw, Rhyce",8,7,1,1,0,0,0,2
Sydney,"Smith, Nick",15,6,1,9,0,0,0,3
Sydney,"Armstrong, Tony",15,10,2,5,0,1,0,0
Sydney,"Bird, Craig",6,1,0,5,0,0,0,1
Sydney,"Bolton, Jude",16,10,4,6,4,0,0,2
Sydney,"Everitt, Andrejs",12,4,2,8,1,0,0,0
Sydney,"Goodes, Adam",15,8,4,7,2,0,1,1
Sydney,"Grundy, Heath",13,8,7,5,0,0,0,3
Sydney,"Hannebery, Dan",25,15,7,10,3,2,0,1
Sydney,"Jack, Kieren",17,9,1,8,0,0,0,3
Sydney,"Jetta, Lewis",8,7,1,1,1,0,0,2
Sydney,"Kennedy, Josh",29,13,2,16,1,1,0,9
Sydney,"Malceski, Nick",28,26,5,2,0,1,0,2
Sydney,"Mattner, Martin",10,6,2,4,0,0,0,1
Sydney,"McGlynn, Ben",16,11,1,5,3,1,0,4
Sydney,"McVeigh, Jarrad",28,15,9,13,2,1,0,3
Sydney,"Mumford, Shane",11,0,1,11,0,0,21,5
Sydney,"OKeefe, Ryan",26,14,4,12,1,0,0,9
Sydney,"Parker, Luke",27,17,4,10,2,0,0,4
Sydney,"Pyke, Mike",10,3,4,7,0,0,35,1
Sydney,"Reid, Sam",10,7,3,3,0,2,0,4
Sydney,"Richards, Ted",10,6,1,4,0,0,0,1
Sydney,"Roberts-Thomson, Lewis",9,6,2,3,0,0,0,1
Sydney,"Smith, Nick",16,9,5,7,0,0,0,0
Sydney,"Armstrong, Tony",17,10,3,7,0,0,0,3
Sydney,"Bolton, Jude",17,10,1,7,2,0,0,4
Sydney,"Goodes, Adam",11,9,4,2,2,2,0,2
Sydney,"Grundy, Heath",16,7,4,9,0,0,0,2
Sydney,"Hannebery, Dan",29,13,5,16,2,0,0,2
Sydney,"Jack, Kieren",29,20,4,9,0,1,0,3
Sydney,"Jetta, Lewis",7,6,3,1,0,0,0,2
Sydney,"Kennedy, Josh",23,6,2,17,1,0,0,1
Sydney,"Malceski, Nick",28,24,6,4,2,0,0,3
Sydney,"Mattner, Martin",16,11,5,5,0,0,0,0
Sydney,"McGlynn, Ben",13,7,4,6,1,0,0,5
Sydney,"McVeigh, Jarrad",27,15,1,12,3,0,0,3
Sydney,"Morton, Mitch",9,4,1,5,0,0,0,1
Sydney,"Mumford, Shane",5,2,0,3,0,0,30,5
Sydney,"OKeefe, Ryan",24,9,1,15,0,0,0,3
Sydney,"Parker, Luke",15,8,0,7,0,0,0,1
Sydney,"Pyke, Mike",8,4,5,4,1,0,15,1
Sydney,"Rampe, Dane",9,8,3,1,0,0,0,1
Sydney,"Reid, Sam",10,3,2,7,1,0,0,3
Sydney,"Richards, Ted",20,11,6,9,0,0,0,0
Sydney,"Roberts-Thomson, Lewis",6,4,3,2,1,1,0,0
Sydney,"Smith, Nick",10,5,1,5,0,0,0,5
Sydney,"Armstrong, Tony",21,10,4,11,0,0,0,2
Sydney,"Bird, Craig",16,12,1,4,0,0,0,8
Sydney,"Bolton, Jude",16,10,4,6,1,3,0,7
Sydney,"Everitt, Andrejs",9,3,1,6,0,0,0,2
Sydney,"Goodes, Adam",14,8,5,6,1,0,0,5
Sydney,"Grundy, Heath",17,8,5,9,0,0,0,0
Sydney,"Hannebery, Dan",30,13,3,17,0,0,0,4
Sydney,"Jack, Kieren",22,9,1,13,1,1,0,13
Sydney,"Jetta, Lewis",7,6,2,1,0,0,0,2
Sydney,"Kennedy, Josh",25,12,1,13,1,0,0,7
Sydney,"Malceski, Nick",19,14,6,5,0,0,0,3
Sydney,"Mattner, Martin",9,4,3,5,0,0,0,3
Sydney,"McGlynn, Ben",16,12,4,4,2,1,0,3
Sydney,"McVeigh, Jarrad",25,10,2,15,1,1,0,6
Sydney,"Mumford, Shane",9,3,0,6,1,2,24,4
Sydney,"OKeefe, Ryan",21,15,5,6,0,2,0,5
Sydney,"Parker, Luke",25,11,4,14,2,0,0,3
Sydney,"Pyke, Mike",7,4,1,3,0,1,32,3
Sydney,"Rampe, Dane",17,11,3,6,0,0,0,0
Sydney,"Reid, Sam",8,2,1,6,0,0,0,5
Sydney,"Richards, Ted",16,10,7,6,1,0,0,3
Sydney,"Smith, Nick",15,10,1,5,0,0,0,2
Sydney,"Armstrong, Tony",9,7,3,2,0,0,0,4
Sydney,"Bird, Craig",13,7,4,6,0,0,0,2
Sydney,"Bolton, Jude",14,9,3,5,2,3,0,5
Sydney,"Goodes, Adam",18,14,8,4,2,1,0,1
Sydney,"Grundy, Heath",13,5,5,8,0,0,0,3
Sydney,"Hannebery, Dan",32,14,2,18,1,1,0,2
Sydney,"Jack, Kieren",29,17,4,12,0,0,0,5
Sydney,"Jetta, Lewis",21,16,4,5,2,0,0,4
Sydney,"Kennedy, Josh",24,8,4,16,1,0,0,4
Sydney,"Lamb, Jed",7,5,2,2,0,0,0,0
Sydney,"Malceski, Nick",27,22,5,5,0,1,0,0
Sydney,"Mattner, Martin",9,4,3,5,0,0,0,2
Sydney,"McGlynn, Ben",7,5,2,2,1,2,0,5
Sydney,"McVeigh, Jarrad",28,14,4,14,1,0,0,4
Sydney,"Mumford, Shane",15,2,3,13,0,0,29,2
Sydney,"OKeefe, Ryan",29,12,3,17,1,0,0,2
Sydney,"Parker, Luke",21,8,4,13,1,1,0,8
Sydney,"Pyke, Mike",10,6,4,4,2,1,21,5
Sydney,"Rampe, Dane",11,6,2,5,0,0,0,2
Sydney,"Reid, Sam",14,10,6,4,3,1,0,2
Sydney,"Richards, Ted",10,5,4,5,0,0,0,1
Sydney,"Smith, Nick",16,7,4,9,0,0,0,7
Sydney,"Armstrong, Tony",11,7,2,4,0,0,0,0
Sydney,"Bird, Craig",14,10,3,4,0,0,0,4
Sydney,"Bolton, Jude",15,7,3,8,1,1,0,1
Sydney,"Goodes, Adam",26,21,7,5,1,0,0,4
Sydney,"Grundy, Heath",20,13,7,7,0,0,0,4
Sydney,"Hannebery, Dan",19,9,4,10,0,0,0,2
Sydney,"Jack, Kieren",23,11,2,12,0,0,0,10
Sydney,"Jetta, Lewis",20,13,6,7,0,0,0,4
Sydney,"Kennedy, Josh",30,10,3,20,2,1,0,7
Sydney,"Lamb, Jed",5,4,1,1,1,1,0,0
Sydney,"Malceski, Nick",11,10,3,1,0,0,0,2
Sydney,"Mattner, Martin",16,13,6,3,0,0,0,5
Sydney,"McGlynn, Ben",14,11,5,3,2,3,0,6
Sydney,"McVeigh, Jarrad",19,11,2,8,0,0,0,3
Sydney,"OKeefe, Ryan",18,8,4,10,2,0,0,2
Sydney,"Parker, Luke",19,7,1,12,1,0,0,10
Sydney,"Pyke, Mike",10,5,4,5,1,1,26,3
Sydney,"Rampe, Dane",9,6,4,3,0,0,0,1
Sydney,"Reid, Sam",9,4,4,5,0,1,0,1
Sydney,"Richards, Ted",10,6,6,4,0,0,0,0
Sydney,"Smith, Nick",15,6,5,9,0,0,0,3
Sydney,"White, Jesse",10,6,2,4,1,1,11,4
Sydney,"Bird, Craig",8,5,2,3,0,0,0,1
Sydney,"Bolton, Jude",11,5,2,6,1,1,0,3
Sydney,"Everitt, Andrejs",12,6,3,6,1,0,0,1
Sydney,"Goodes, Adam",28,14,6,14,0,1,0,2
Sydney,"Grundy, Heath",18,9,4,9,0,0,0,3
Sydney,"Hannebery, Dan",27,12,5,15,4,0,0,3
Sydney,"Jack, Kieren",33,15,2,18,1,1,0,11
Sydney,"Jetta, Lewis",14,8,4,6,1,0,0,2
Sydney,"Kennedy, Josh",29,13,6,16,0,0,0,11
Sydney,"Malceski, Nick",26,18,3,8,0,0,0,1
Sydney,"McGlynn, Ben",14,10,5,4,2,0,0,5
Sydney,"McVeigh, Jarrad",28,16,6,12,0,0,0,2
Sydney,"Morton, Mitch",9,5,3,4,0,0,0,4
Sydney,"Mumford, Shane",6,3,2,3,0,0,22,7
Sydney,"OKeefe, Ryan",22,13,5,9,0,0,0,8
Sydney,"Parker, Luke",22,13,6,9,0,0,0,10
Sydney,"Pyke, Mike",15,4,5,11,1,0,29,2
Sydney,"Rampe, Dane",10,6,4,4,0,0,0,3
Sydney,"Reid, Sam",17,12,11,5,0,0,0,3
Sydney,"Richards, Ted",18,9,6,9,0,0,0,2
Sydney,"Smith, Nick",15,5,5,10,0,0,0,4
Sydney,"Walsh, Tommy",5,3,4,2,0,0,0,2
Sydney,"Bird, Craig",15,9,2,6,1,0,0,4
Sydney,"Bolton, Jude",12,6,4,6,1,1,0,5
Sydney,"Everitt, Andrejs",17,9,5,8,0,0,0,1
Sydney,"Goodes, Adam",30,19,11,11,3,2,0,3
Sydney,"Grundy, Heath",16,13,5,3,0,0,0,1
Sydney,"Hannebery, Dan",31,17,5,14,2,1,0,3
Sydney,"Jack, Kieren",27,14,5,13,1,1,0,6
Sydney,"Jetta, Lewis",18,12,4,6,1,2,0,3
Sydney,"Kennedy, Josh",18,6,0,12,0,0,0,2
Sydney,"Lamb, Jed",3,2,2,1,0,1,0,1
Sydney,"Malceski, Nick",30,17,6,13,0,0,0,2
Sydney,"McGlynn, Ben",17,12,7,5,2,0,0,6
Sydney,"McVeigh, Jarrad",30,15,7,15,0,0,0,3
Sydney,"Morton, Mitch",12,8,4,4,1,2,0,3
Sydney,"Mumford, Shane",9,3,5,6,0,0,20,4
Sydney,"OKeefe, Ryan",25,13,5,12,0,0,0,14
Sydney,"Parker, Luke",18,4,2,14,0,0,0,4
Sydney,"Pyke, Mike",11,3,4,8,2,0,22,3
Sydney,"Rampe, Dane",11,6,3,5,0,0,0,4
Sydney,"Reid, Sam",13,9,3,4,1,0,0,1
Sydney,"Richards, Ted",11,3,2,8,0,0,0,2
Sydney,"Smith, Nick",15,8,2,7,0,0,0,3
Sydney,"Bird, Craig",27,17,2,10,1,0,0,3
Sydney,"Bolton, Jude",12,5,2,7,0,0,0,5
Sydney,"Everitt, Andrejs",12,9,3,3,1,0,0,1
Sydney,"Goodes, Adam",15,11,4,4,4,1,0,2
Sydney,"Grundy, Heath",11,8,0,3,0,0,0,2
Sydney,"Hannebery, Dan",24,8,1,16,0,0,0,2
Sydney,"Jack, Kieren",27,16,1,11,1,2,0,6
Sydney,"Jetta, Lewis",12,9,3,3,1,1,0,6
Sydney,"Kennedy, Josh",37,20,2,17,1,1,0,1
Sydney,"Malceski, Nick",28,23,3,5,2,1,0,1
Sydney,"McGlynn, Ben",19,14,1,5,1,1,0,3
Sydney,"McVeigh, Jarrad",34,23,1,11,0,0,0,2
Sydney,"Mitchell, Tom",18,12,6,6,1,2,0,6
Sydney,"Morton, Mitch",12,5,0,7,0,1,0,4
Sydney,"Mumford, Shane",15,5,5,10,1,0,35,2
Sydney,"OKeefe, Ryan",17,10,1,7,1,0,0,5
Sydney,"Parker, Luke",22,10,2,12,1,1,0,5
Sydney,"Pyke, Mike",16,8,2,8,1,0,24,2
Sydney,"Rampe, Dane",11,10,5,1,0,0,0,5
Sydney,"Richards, Ted",6,5,2,1,0,0,0,2
Sydney,"Smith, Nick",10,5,3,5,0,1,0,4
Sydney,"Walsh, Tommy",3,2,0,1,0,0,0,1
Sydney,"Bird, Craig",18,13,4,5,2,0,0,4
Sydney,"Bolton, Jude",16,6,2,10,2,0,0,4
Sydney,"Everitt, Andrejs",19,10,6,9,1,1,0,2
Sydney,"Goodes, Adam",11,5,4,6,1,0,0,1
Sydney,"Grundy, Heath",16,9,4,7,0,0,0,2
Sydney,"Hannebery, Dan",42,19,6,23,1,1,0,2
Sydney,"Jack, Brandon",6,4,3,2,0,0,0,1
Sydney,"Jack, Kieren",32,15,2,17,1,2,0,9
Sydney,"Kennedy, Josh",23,9,0,14,0,1,0,2
Sydney,"Malceski, Nick",26,17,9,9,0,0,0,1
Sydney,"McGlynn, Ben",8,7,3,1,3,0,0,9
Sydney,"McVeigh, Jarrad",24,14,6,10,0,0,0,5
Sydney,"Mitchell, Tom",31,18,5,13,1,2,0,10
Sydney,"Morton, Mitch",14,8,4,6,3,2,0,1
Sydney,"Mumford, Shane",7,1,2,6,0,1,21,3
Sydney,"OKeefe, Ryan",28,18,5,10,0,0,0,15
Sydney,"Parker, Luke",24,11,5,13,1,0,0,3
Sydney,"Pyke, Mike",18,3,1,15,0,0,16,1
Sydney,"Rampe, Dane",18,11,4,7,0,0,0,4
Sydney,"Richards, Ted",6,2,0,4,0,0,0,0
Sydney,"Smith, Nick",10,4,4,6,0,0,0,4
Sydney,"White, Jesse",13,10,7,3,3,1,0,2
Sydney,"Armstrong, Tony",13,8,4,5,0,0,0,3
Sydney,"Bird, Craig",21,14,3,7,0,0,0,8
Sydney,"Bolton, Jude",11,6,0,5,0,0,0,5
Sydney,"Goodes, Adam",12,8,1,4,2,0,0,1
Sydney,"Grundy, Heath",15,3,6,12,0,0,0,2
Sydney,"Hannebery, Dan",13,6,2,7,0,0,0,5
Sydney,"Jack, Kieren",23,14,1,9,2,0,0,9
Sydney,"Kennedy, Josh",31,14,0,17,0,0,0,4
Sydney,"Lamb, Jed",5,3,0,2,0,0,0,1
Sydney,"Malceski, Nick",26,21,6,5,0,0,1,2
Sydney,"McGlynn, Ben",10,5,3,5,0,0,0,3
Sydney,"McVeigh, Jarrad",27,15,1,12,0,0,0,7
Sydney,"Mitchell, Tom",16,9,2,7,1,1,0,7
Sydney,"Morton, Mitch",9,4,2,5,1,0,0,5
Sydney,"OKeefe, Ryan",21,15,2,6,0,0,0,13
Sydney,"Parker, Luke",17,9,0,8,0,0,0,7
Sydney,"Pyke, Mike",8,6,0,2,0,0,42,5
Sydney,"Rampe, Dane",16,10,2,6,0,1,0,4
Sydney,"Richards, Ted",13,7,4,6,0,0,0,2
Sydney,"Smith, Nick",12,6,2,6,0,0,0,1
Sydney,"Tippett, Kurt",6,5,3,1,2,2,1,5
Sydney,"White, Jesse",5,5,0,0,0,0,7,1
Sydney,"Bird, Craig",33,25,2,8,0,0,0,5
Sydney,"Bolton, Jude",14,10,3,4,1,2,0,4
Sydney,"Everitt, Andrejs",14,9,4,5,0,0,0,5
Sydney,"Grundy, Heath",6,4,1,2,0,0,0,1
Sydney,"Hannebery, Dan",20,7,0,13,0,2,0,8
Sydney,"Jack, Brandon",10,6,0,4,0,1,0,4
Sydney,"Jack, Kieren",16,14,1,2,0,2,0,9
Sydney,"Kennedy, Josh",23,16,0,7,0,1,0,7
Sydney,"Lamb, Jed",14,11,0,3,0,0,0,6
Sydney,"Malceski, Nick",19,15,3,4,0,0,0,3
Sydney,"McGlynn, Ben",12,11,0,1,2,1,0,5
Sydney,"McVeigh, Jarrad",19,15,2,4,0,0,0,3
Sydney,"Mitchell, Tom",20,9,2,11,1,1,0,6
Sydney,"OKeefe, Ryan",29,20,4,9,0,0,0,7
Sydney,"Parker, Luke",23,12,1,11,1,1,0,7
Sydney,"Pyke, Mike",11,6,3,5,1,0,36,2
Sydney,"Rampe, Dane",13,11,2,2,0,0,0,0
Sydney,"Richards, Ted",12,8,3,4,0,0,0,4
Sydney,"Richards, Xavier",1,1,0,0,0,0,0,0
Sydney,"Smith, Nick",13,8,2,5,0,0,0,2
Sydney,"Tippett, Kurt",17,11,4,6,2,2,9,5
Sydney,"White, Jesse",7,3,2,4,0,1,8,2
Sydney,"Bird, Craig",20,13,4,7,2,0,0,5
Sydney,"Bolton, Jude",16,9,4,7,0,0,0,2
Sydney,"Everitt, Andrejs",15,8,5,7,1,1,0,2
Sydney,"Grundy, Heath",16,7,2,9,0,0,0,0
Sydney,"Hannebery, Dan",26,12,1,14,0,1,0,1
Sydney,"Jack, Brandon",10,7,0,3,4,1,0,4
Sydney,"Jack, Kieren",31,17,0,14,1,1,0,2
Sydney,"Kennedy, Josh",33,4,1,29,0,0,0,2
Sydney,"Lamb, Jed",10,3,1,7,1,1,0,4
Sydney,"Malceski, Nick",29,25,5,4,0,1,0,1
Sydney,"McGlynn, Ben",9,3,0,6,0,0,0,2
Sydney,"McVeigh, Jarrad",33,22,7,11,1,2,0,2
Sydney,"Mitchell, Tom",27,12,2,15,1,2,0,6
Sydney,"Mumford, Shane",12,1,1,11,0,1,31,5
Sydney,"OKeefe, Ryan",28,15,6,13,1,0,0,8
Sydney,"Parker, Luke",17,10,2,7,1,1,0,3
Sydney,"Pyke, Mike",8,5,1,3,1,1,21,1
Sydney,"Rampe, Dane",15,7,0,8,0,0,0,4
Sydney,"Reid, Sam",3,0,1,3,0,0,0,0
Sydney,"Richards, Ted",13,6,7,7,0,0,0,2
Sydney,"Smith, Nick",10,2,3,8,0,0,0,2
Sydney,"Tippett, Kurt",15,10,7,5,2,4,1,1
Sydney,"Bird, Craig",28,23,7,5,2,3,0,1
Sydney,"Bolton, Jude",23,8,5,15,1,0,0,2
Sydney,"Everitt, Andrejs",22,11,8,11,0,0,0,1
Sydney,"Grundy, Heath",14,7,3,7,0,0,0,1
Sydney,"Hannebery, Dan",34,15,6,19,0,0,0,1
Sydney,"Jack, Brandon",10,7,4,3,0,3,0,2
Sydney,"Jack, Kieren",19,8,7,11,0,1,0,3
Sydney,"Kennedy, Josh",29,11,5,18,2,2,0,3
Sydney,"Lamb, Jed",13,10,1,3,0,0,0,3
Sydney,"Malceski, Nick",30,26,6,4,1,0,0,4
Sydney,"McGlynn, Ben",10,9,4,1,2,0,0,2
Sydney,"McVeigh, Jarrad",35,21,11,14,0,0,0,2
Sydney,"Mitchell, Tom",23,14,3,9,3,1,0,6
Sydney,"Mumford, Shane",10,4,4,6,1,1,20,0
Sydney,"OKeefe, Ryan",26,11,7,15,1,2,0,3
Sydney,"Parker, Luke",18,9,5,9,1,1,0,3
Sydney,"Pyke, Mike",10,9,5,1,3,2,16,2
Sydney,"Rampe, Dane",18,10,1,8,1,0,0,4
Sydney,"Richards, Ted",13,8,4,5,0,0,0,0
Sydney,"Smith, Nick",14,8,3,6,0,0,0,2
Sydney,"Tippett, Kurt",10,8,6,2,3,5,0,3
Sydney,"White, Jesse",9,5,5,4,3,0,2,0
Sydney,"Bird, Craig",22,13,1,9,0,1,0,1
Sydney,"Bolton, Jude",9,5,3,4,1,0,0,5
Sydney,"Cunningham, Harry",4,2,0,2,0,0,0,0
Sydney,"Everitt, Andrejs",13,9,2,4,0,0,0,0
Sydney,"Grundy, Heath",15,7,6,8,0,0,0,0
Sydney,"Hannebery, Dan",40,17,4,23,2,0,0,3
Sydney,"Jack, Brandon",11,3,1,8,1,0,0,3
Sydney,"Jack, Kieren",30,14,2,16,2,2,0,3
Sydney,"Kennedy, Josh",29,9,2,20,1,3,0,6
Sydney,"Lamb, Jed",19,10,5,9,2,1,0,0
Sydney,"Malceski, Nick",19,13,4,6,0,0,0,1
Sydney,"McVeigh, Jarrad",26,18,1,8,0,1,0,2
Sydney,"Mitchell, Tom",18,9,3,9,0,1,0,5
Sydney,"Mumford, Shane",8,2,1,6,1,0,24,5
Sydney,"OKeefe, Ryan",21,9,1,12,0,0,0,7
Sydney,"Parker, Luke",19,11,1,8,1,1,0,6
Sydney,"Pyke, Mike",10,3,6,7,2,0,12,0
Sydney,"Rampe, Dane",10,6,2,4,0,0,0,4
Sydney,"Richards, Ted",12,7,3,5,0,0,0,0
Sydney,"Smith, Nick",21,12,6,9,0,0,0,3
Sydney,"Tippett, Kurt",12,8,3,4,3,0,0,4
Sydney,"White, Jesse",14,7,5,7,1,0,0,2
Sydney,"Bird, Craig",20,15,3,5,0,1,0,1
Sydney,"Bolton, Jude",17,8,6,9,1,0,0,1
Sydney,"Cunningham, Harry",3,3,1,0,0,0,0,0
Sydney,"Everitt, Andrejs",12,8,3,4,0,0,0,3
Sydney,"Grundy, Heath",14,7,2,7,0,0,0,1
Sydney,"Hannebery, Dan",26,10,2,16,0,1,0,3
Sydney,"Jack, Brandon",7,4,3,3,1,0,0,3
Sydney,"Jack, Kieren",26,18,2,8,2,0,0,10
Sydney,"Kennedy, Josh",22,6,0,16,0,0,0,2
Sydney,"Lamb, Jed",12,7,5,5,1,1,0,1
Sydney,"Malceski, Nick",18,16,2,2,0,0,0,4
Sydney,"McVeigh, Jarrad",23,16,2,7,0,1,0,1
Sydney,"Mitchell, Tom",26,13,6,13,2,2,0,4
Sydney,"Mumford, Shane",18,1,5,17,0,0,29,6
Sydney,"OKeefe, Ryan",30,15,3,15,0,1,0,5
Sydney,"Parker, Luke",22,16,5,6,0,1,0,2
Sydney,"Pyke, Mike",6,1,2,5,1,0,10,1
Sydney,"Rampe, Dane",15,9,2,6,0,0,0,2
Sydney,"Richards, Ted",19,6,4,13,0,0,0,2
Sydney,"Smith, Nick",20,13,4,7,1,0,0,4
Sydney,"Tippett, Kurt",13,6,5,7,3,2,0,3
Sydney,"White, Jesse",14,10,5,4,4,1,0,0
Sydney,"Bird, Craig",11,8,2,3,2,0,0,4
Sydney,"Bolton, Jude",11,8,3,3,2,1,0,2
Sydney,"Everitt, Andrejs",18,14,7,4,0,0,0,3
Sydney,"Grundy, Heath",20,7,4,13,1,1,0,1
Sydney,"Hannebery, Dan",22,9,1,13,0,0,0,3
Sydney,"Jack, Brandon",3,1,0,2,1,0,0,0
Sydney,"Jack, Kieren",30,16,1,14,2,0,0,13
Sydney,"Kennedy, Josh",18,6,1,12,0,1,0,6
Sydney,"Lamb, Jed",9,6,1,3,2,0,0,3
Sydney,"Malceski, Nick",19,13,5,6,0,0,0,0
Sydney,"McVeigh, Jarrad",30,17,3,13,0,0,0,2
Sydney,"Mitchell, Tom",19,6,3,13,0,1,0,2
Sydney,"Mumford, Shane",14,7,2,7,2,0,36,5
Sydney,"OKeefe, Ryan",21,13,4,8,1,0,1,7
Sydney,"Parker, Luke",21,13,4,8,1,0,0,9
Sydney,"Pyke, Mike",13,3,6,10,0,0,14,3
Sydney,"Rampe, Dane",20,16,7,4,0,0,0,4
Sydney,"Richards, Ted",10,6,2,4,0,0,0,1
Sydney,"Shaw, Rhyce",10,7,2,3,0,0,0,2
Sydney,"Smith, Nick",18,10,5,8,0,0,0,6
Sydney,"Tippett, Kurt",15,10,8,5,6,0,0,1
Sydney,"White, Jesse",10,6,6,4,1,2,0,2
Sydney,"Bird, Craig",20,11,2,9,0,0,0,4
Sydney,"Bolton, Jude",12,7,3,5,1,2,0,3
Sydney,"Everitt, Andrejs",14,6,3,8,0,0,0,1
Sydney,"Grundy, Heath",14,6,5,8,0,0,0,1
Sydney,"Hannebery, Dan",21,8,2,13,0,1,0,1
Sydney,"Jack, Brandon",3,3,0,0,0,0,0,0
Sydney,"Jack, Kieren",16,3,0,13,1,0,0,4
Sydney,"Kennedy, Josh",19,7,1,12,1,0,0,8
Sydney,"Malceski, Nick",20,15,2,5,0,0,0,7
Sydney,"McGlynn, Ben",4,3,2,1,0,0,0,0
Sydney,"McVeigh, Jarrad",35,22,4,13,0,0,0,5
Sydney,"Mitchell, Tom",16,7,2,9,0,1,0,7
Sydney,"Mumford, Shane",10,6,4,4,0,0,28,6
Sydney,"OKeefe, Ryan",19,11,2,8,0,0,0,6
Sydney,"Parker, Luke",12,7,3,5,0,0,0,4
Sydney,"Pyke, Mike",12,4,5,8,0,0,18,3
Sydney,"Rampe, Dane",7,7,4,0,0,0,0,0
Sydney,"Richards, Ted",16,12,3,4,0,0,0,2
Sydney,"Shaw, Rhyce",17,12,9,5,1,1,0,0
Sydney,"Smith, Nick",5,2,1,3,0,0,0,3
Sydney,"Tippett, Kurt",13,10,6,3,6,2,0,1
Sydney,"White, Jesse",13,6,2,7,0,2,3,0
Sydney,"Bird, Craig",26,15,2,11,0,0,0,2
Sydney,"Bolton, Jude",10,5,5,5,2,1,0,5
Sydney,"Everitt, Andrejs",22,8,5,14,0,0,0,2
Sydney,"Grundy, Heath",16,9,3,7,0,0,0,2
Sydney,"Hannebery, Dan",16,5,1,11,0,0,0,1
Sydney,"Jack, Kieren",20,11,3,9,2,0,0,3
Sydney,"Kennedy, Josh",38,15,4,23,0,1,0,5
Sydney,"Lamb, Jed",15,8,7,7,2,1,0,3
Sydney,"Malceski, Nick",17,11,1,6,0,0,0,1
Sydney,"McGlynn, Ben",19,17,5,2,2,3,0,1
Sydney,"McVeigh, Jarrad",28,18,4,10,0,0,0,1
Sydney,"Mumford, Shane",12,2,3,10,0,0,35,5
Sydney,"OKeefe, Ryan",12,3,2,9,0,1,0,6
Sydney,"Parker, Luke",27,10,2,17,0,0,0,6
Sydney,"Pyke, Mike",13,7,7,6,2,0,17,0
Sydney,"Rampe, Dane",15,11,3,4,0,1,0,2
Sydney,"Richards, Ted",12,9,5,3,0,0,0,4
Sydney,"Rohan, Gary",5,4,2,1,0,0,0,0
Sydney,"Shaw, Rhyce",24,19,5,5,0,0,0,0
Sydney,"Smith, Nick",14,7,2,7,0,0,0,0
Sydney,"Tippett, Kurt",13,8,5,5,5,1,0,4
Sydney,"White, Jesse",15,10,9,5,3,0,0,4
Sydney,"Bird, Craig",16,8,1,8,0,0,0,6
Sydney,"Everitt, Andrejs",17,8,2,9,0,0,0,3
Sydney,"Grundy, Heath",16,7,3,9,0,0,0,2
Sydney,"Hannebery, Dan",23,11,6,12,1,1,0,3
Sydney,"Jack, Kieren",28,14,1,14,0,0,0,4
Sydney,"Kennedy, Josh",32,9,1,23,0,1,0,4
Sydney,"Lamb, Jed",6,3,2,3,0,0,0,3
Sydney,"Malceski, Nick",24,22,5,2,0,0,0,0
Sydney,"McGlynn, Ben",13,7,3,6,2,0,0,2
Sydney,"McVeigh, Jarrad",31,14,1,17,0,0,0,5
Sydney,"Mitchell, Tom",23,9,5,14,0,2,0,3
Sydney,"Mumford, Shane",9,0,1,9,0,0,33,7
Sydney,"OKeefe, Ryan",9,5,5,4,0,1,0,5
Sydney,"Parker, Luke",18,9,3,9,0,0,0,2
Sydney,"Pyke, Mike",14,6,6,8,3,0,18,1
Sydney,"Rampe, Dane",11,7,2,4,0,0,0,1
Sydney,"Richards, Ted",21,13,6,8,0,0,0,2
Sydney,"Rohan, Gary",7,5,3,2,0,0,0,3
Sydney,"Shaw, Rhyce",2,2,0,0,0,0,0,0
Sydney,"Smith, Nick",11,8,3,3,0,0,0,5
Sydney,"Tippett, Kurt",6,4,3,2,1,1,0,0
Sydney,"White, Jesse",12,6,4,6,0,0,0,4
Sydney,"Biggs, Shane",18,11,6,7,0,0,0,1
Sydney,"Bird, Craig",24,12,4,12,0,0,0,3
Sydney,"Bolton, Jude",12,6,1,6,1,0,0,4
Sydney,"Cunningham, Harry",6,2,1,4,0,0,0,4
Sydney,"Everitt, Andrejs",16,7,6,9,0,0,0,3
Sydney,"Grundy, Heath",7,3,2,4,0,0,0,1
Sydney,"Jack, Brandon",8,5,0,3,0,0,0,3
Sydney,"Jack, Kieren",27,17,1,10,1,0,0,5
Sydney,"Kennedy, Josh",33,11,1,22,0,1,0,3
Sydney,"Malceski, Nick",18,14,4,4,0,0,0,2
Sydney,"McGlynn, Ben",22,12,7,10,1,0,0,8
Sydney,"McVeigh, Jarrad",23,15,4,8,0,0,0,5
Sydney,"Mitchell, Tom",15,7,2,8,1,0,0,2
Sydney,"Morton, Mitch",4,2,0,2,1,0,0,2
Sydney,"Mumford, Shane",17,8,4,9,2,0,41,6
Sydney,"OKeefe, Ryan",27,10,6,17,0,0,0,11
Sydney,"Parker, Luke",19,9,3,10,3,0,0,4
Sydney,"Pyke, Mike",10,5,4,5,1,1,15,2
Sydney,"Rampe, Dane",10,8,3,2,0,0,0,2
Sydney,"Richards, Ted",19,13,7,6,0,0,0,3
Sydney,"Rohan, Gary",4,2,1,2,2,0,0,4
Sydney,"White, Jesse",12,6,5,6,3,1,0,3
Sydney,"Bird, Craig",27,13,1,14,0,0,0,6
Sydney,"Bolton, Jude",9,1,0,8,0,0,0,6
Sydney,"Everitt, Andrejs",11,9,0,2,0,0,0,0
Sydney,"Grundy, Heath",15,5,4,10,0,0,0,2
Sydney,"Hannebery, Dan",13,5,3,8,0,2,0,1
Sydney,"Jack, Kieren",32,18,0,14,0,0,0,11
Sydney,"Jetta, Lewis",4,4,3,0,1,0,0,4
Sydney,"Kennedy, Josh",29,10,1,19,0,2,0,9
Sydney,"Malceski, Nick",18,12,1,6,0,0,0,3
Sydney,"McGlynn, Ben",9,6,0,3,0,0,0,1
Sydney,"McVeigh, Jarrad",18,11,2,7,0,0,0,2
Sydney,"Mitchell, Tom",15,8,4,7,0,1,0,2
Sydney,"Mumford, Shane",3,0,1,3,0,0,21,1
Sydney,"OKeefe, Ryan",21,10,4,11,1,0,0,3
Sydney,"Parker, Luke",26,9,2,17,0,1,0,1
Sydney,"Pyke, Mike",8,3,3,5,1,1,20,0
Sydney,"Rampe, Dane",11,10,0,1,0,0,0,2
Sydney,"Richards, Ted",9,5,3,4,0,0,0,1
Sydney,"Rohan, Gary",3,2,2,1,1,0,0,4
Sydney,"Smith, Nick",10,2,2,8,0,0,0,4
Sydney,"Tippett, Kurt",8,4,2,4,2,0,5,2
Sydney,"White, Jesse",16,9,5,7,1,1,3,0
Sydney,"Biggs, Shane",21,11,3,10,0,0,0,2
Sydney,"Bird, Craig",23,16,2,7,0,0,0,7
Sydney,"Bolton, Jude",12,6,5,6,1,1,0,6
Sydney,"Cunningham, Harry",15,8,6,7,2,1,0,3
Sydney,"Everitt, Andrejs",16,11,6,5,0,0,0,4
Sydney,"Grundy, Heath",32,15,4,17,0,0,0,1
Sydney,"Hannebery, Dan",33,11,5,22,0,0,0,2
Sydney,"Jack, Kieren",30,22,5,8,2,0,0,1
Sydney,"Jetta, Lewis",10,8,5,2,1,0,0,0
Sydney,"Kennedy, Josh",24,9,1,15,1,0,0,5
Sydney,"Malceski, Nick",14,11,3,3,0,0,0,3
Sydney,"McVeigh, Jarrad",42,24,9,18,2,0,0,5
Sydney,"Mitchell, Tom",3,1,0,2,0,0,0,0
Sydney,"Mumford, Shane",19,4,4,15,0,0,16,5
Sydney,"OKeefe, Ryan",30,11,7,19,1,1,0,7
Sydney,"Parker, Luke",22,12,6,10,3,2,0,2
Sydney,"Pyke, Mike",12,9,1,3,0,0,17,3
Sydney,"Rampe, Dane",20,16,6,4,0,0,0,2
Sydney,"Richards, Ted",23,12,6,11,0,0,0,1
Sydney,"Smith, Nick",20,12,2,8,0,0,0,1
Sydney,"Tippett, Kurt",1,1,1,0,0,1,0,0
Sydney,"White, Jesse",20,8,6,12,0,0,0,0
Sydney,"Biggs, Shane",15,6,4,9,0,0,0,1
Sydney,"Bird, Craig",6,5,0,1,0,0,0,4
Sydney,"Bolton, Jude",9,2,2,7,1,0,0,7
Sydney,"Cunningham, Harry",13,5,3,8,2,0,0,0
Sydney,"Everitt, Andrejs",19,9,5,10,0,0,0,1
Sydney,"Grundy, Heath",21,12,3,9,0,0,0,0
Sydney,"Hannebery, Dan",14,9,2,5,1,1,0,5
Sydney,"Jack, Kieren",11,5,3,6,0,0,0,2
Sydney,"Jetta, Lewis",10,8,5,2,1,0,0,0
Sydney,"Kennedy, Josh",24,8,2,16,0,0,0,8
Sydney,"Malceski, Nick",19,14,5,5,0,0,0,3
Sydney,"McGlynn, Ben",20,11,1,9,1,0,0,7
Sydney,"McVeigh, Jarrad",30,16,5,14,1,0,0,6
Sydney,"Mumford, Shane",11,2,2,9,0,0,19,7
Sydney,"OKeefe, Ryan",17,10,3,7,0,1,0,4
Sydney,"Parker, Luke",25,14,4,11,1,2,0,6
Sydney,"Pyke, Mike",12,4,2,8,1,0,11,3
Sydney,"Rampe, Dane",16,8,5,8,0,0,0,6
Sydney,"Richards, Ted",18,8,1,10,0,0,0,2
Sydney,"Rohan, Gary",6,5,4,1,2,1,0,0
Sydney,"Smith, Nick",16,8,2,8,0,0,0,2
Sydney,"White, Jesse",20,12,9,8,0,2,0,2
West Coast,"Cox, Dean",14,8,3,6,0,1,36,0
West Coast,"Cripps, Jamie",11,8,3,3,2,0,0,6
West Coast,"Darling, Jack",11,8,4,3,0,2,0,3
West Coast,"Embley, Andrew",10,8,1,2,0,1,0,2
West Coast,"Gaff, Andrew",17,12,2,5,0,1,0,2
West Coast,"Glass, Darren",7,3,3,4,0,0,0,2
West Coast,"Hams, Ashton",13,12,3,1,2,1,0,5
West Coast,"Hill, Josh",8,5,5,3,2,0,0,2
West Coast,"Hurn, Shannon",18,18,1,0,0,0,0,6
West Coast,"Kennedy, Josh",19,11,8,8,2,0,0,4
West Coast,"LeCras, Mark",14,10,0,4,2,2,0,8
West Coast,"Lycett, Scott",3,2,0,1,0,0,9,2
West Coast,"Mackenzie, Eric",4,3,1,1,0,0,0,3
West Coast,"Masten, Chris",19,11,3,8,1,0,0,4
West Coast,"Priddis, Matt",28,10,5,18,0,0,0,7
West Coast,"Schofield, Will",9,5,2,4,0,0,2,7
West Coast,"Selwood, Adam",9,5,1,4,0,0,0,2
West Coast,"Selwood, Scott",16,7,1,9,0,2,0,6
West Coast,"Sheppard, Brad",10,5,2,5,0,0,0,1
West Coast,"Shuey, Luke",12,6,0,6,0,0,0,6
West Coast,"Smith, Ashley",11,4,1,7,0,0,0,1
West Coast,"Waters, Beau",26,18,9,8,0,0,0,4
West Coast,"Brown, Mitch",6,2,2,4,0,0,0,1
West Coast,"Butler, Sam",19,7,3,12,0,0,0,2
West Coast,"Cox, Dean",17,8,2,9,0,1,35,2
West Coast,"Cripps, Jamie",8,6,2,2,1,0,0,3
West Coast,"Dalziell, Bradd",7,2,2,5,0,0,0,0
West Coast,"Darling, Jack",8,3,1,5,3,0,0,4
West Coast,"Embley, Andrew",20,13,5,7,1,0,0,1
West Coast,"Gaff, Andrew",14,8,3,6,1,0,0,0
West Coast,"Glass, Darren",8,5,2,3,0,0,0,1
West Coast,"Hams, Ashton",2,2,1,0,0,0,0,2
West Coast,"Hill, Josh",12,10,4,2,3,2,0,2
West Coast,"Hurn, Shannon",11,10,1,1,0,0,0,1
West Coast,"Kennedy, Josh",11,7,6,4,5,0,0,5
West Coast,"Masten, Chris",33,12,2,21,0,0,0,3
West Coast,"Priddis, Matt",26,10,1,16,0,1,0,6
West Coast,"Schofield, Will",4,2,2,2,0,0,0,1
West Coast,"Selwood, Adam",12,8,4,4,0,0,0,0
West Coast,"Selwood, Scott",21,11,4,10,0,0,0,7
West Coast,"Sheppard, Brad",18,16,5,2,0,0,0,3
West Coast,"Shuey, Luke",26,13,2,13,0,0,0,4
West Coast,"Sinclair, Callum",6,5,4,1,1,1,13,1
West Coast,"Waters, Beau",16,13,5,3,0,0,0,3
West Coast,"Brennan, Jacob",8,5,3,3,0,0,0,4
West Coast,"Brown, Mitch",9,4,3,5,0,0,0,2
West Coast,"Butler, Sam",15,8,4,7,0,0,0,4
West Coast,"Cox, Dean",24,13,5,11,3,2,23,4
West Coast,"Cripps, Jamie",6,3,0,3,1,1,0,3
West Coast,"Darling, Jack",19,14,6,5,5,3,0,6
West Coast,"Embley, Andrew",14,7,4,7,1,1,0,0
West Coast,"Gaff, Andrew",23,11,3,12,1,0,0,4
West Coast,"Glass, Darren",6,3,1,3,0,0,0,1
West Coast,"Hams, Ashton",13,10,4,3,3,0,0,2
West Coast,"Hill, Josh",17,10,6,7,1,0,0,4
West Coast,"Hurn, Shannon",16,13,3,3,1,0,0,1
West Coast,"Kennedy, Josh",15,12,7,3,5,3,0,4
West Coast,"Kerr, Daniel",19,9,3,10,0,0,0,5
West Coast,"LeCras, Mark",17,14,3,3,3,0,0,2
West Coast,"Masten, Chris",39,19,4,20,1,0,0,2
West Coast,"Priddis, Matt",33,7,1,26,0,0,0,7
West Coast,"Schofield, Will",13,6,2,7,0,1,0,1
West Coast,"Selwood, Adam",22,14,2,8,0,0,0,1
West Coast,"Selwood, Scott",26,12,9,14,0,0,0,12
West Coast,"Shuey, Luke",26,17,4,9,0,2,0,8
West Coast,"Sinclair, Callum",11,5,6,6,2,0,10,1
West Coast,"Brennan, Jacob",15,10,6,5,0,0,0,3
West Coast,"Butler, Sam",13,8,3,5,0,0,0,4
West Coast,"Cox, Dean",11,8,3,3,0,0,29,2
West Coast,"Cripps, Jamie",8,4,4,4,0,1,0,4
West Coast,"Dalziell, Bradd",5,3,2,2,0,1,0,3
West Coast,"Darling, Jack",16,10,9,6,1,2,0,1
West Coast,"Gaff, Andrew",14,8,1,6,1,1,0,0
West Coast,"Glass, Darren",12,9,4,3,0,0,0,1
West Coast,"Hams, Ashton",6,4,2,2,1,1,0,2
West Coast,"Hill, Josh",8,7,1,1,0,0,0,2
West Coast,"Hurn, Shannon",14,10,3,4,0,1,0,2
West Coast,"Kennedy, Josh",12,7,6,5,0,2,1,6
West Coast,"Kerr, Daniel",21,8,1,13,1,0,0,3
West Coast,"LeCras, Mark",23,16,5,7,2,1,0,4
West Coast,"Mackenzie, Eric",7,4,1,3,0,0,0,7
West Coast,"Masten, Chris",30,16,6,14,0,0,0,3
West Coast,"Priddis, Matt",25,10,1,15,0,0,0,7
West Coast,"Schofield, Will",14,12,5,2,0,0,1,1
West Coast,"Selwood, Adam",8,5,1,3,0,0,0,0
West Coast,"Selwood, Scott",32,17,4,15,0,1,0,8
West Coast,"Shuey, Luke",24,15,3,9,1,2,0,5
West Coast,"Sinclair, Callum",14,7,2,7,0,2,6,0
West Coast,"Brennan, Jacob",5,3,3,2,0,1,0,2
West Coast,"Brown, Mitch",9,6,3,3,0,0,0,2
West Coast,"Butler, Sam",23,16,8,7,0,0,0,4
West Coast,"Cox, Dean",19,9,7,10,0,1,27,2
West Coast,"Cripps, Jamie",14,6,3,8,1,1,0,6
West Coast,"Dalziell, Bradd",20,10,4,10,1,0,0,5
West Coast,"Darling, Jack",11,8,4,3,1,1,0,2
West Coast,"Gaff, Andrew",27,20,8,7,0,3,0,2
West Coast,"Glass, Darren",12,10,10,2,0,0,0,2
West Coast,"Hams, Ashton",11,8,5,3,1,0,0,2
West Coast,"Hill, Josh",15,11,5,4,1,1,0,5
West Coast,"Hurn, Shannon",15,14,4,1,0,0,0,3
West Coast,"Kennedy, Josh",14,9,9,5,4,0,0,3
West Coast,"Kerr, Daniel",16,7,0,9,0,0,0,2
West Coast,"LeCras, Mark",18,16,6,2,0,3,0,1
West Coast,"Mackenzie, Eric",7,6,4,1,0,0,0,2
West Coast,"Masten, Chris",21,14,3,7,1,0,0,6
West Coast,"Priddis, Matt",2,0,0,2,0,0,0,0
West Coast,"Selwood, Scott",28,15,8,13,0,0,0,10
West Coast,"Shuey, Luke",32,18,6,14,0,1,0,5
West Coast,"Sinclair, Callum",12,9,6,3,0,2,8,1
West Coast,"Waters, Beau",17,13,8,4,0,0,0,3
West Coast,"Brennan, Jacob",16,13,4,3,0,0,0,6
West Coast,"Brown, Mitch",10,5,3,5,0,0,0,7
West Coast,"Cox, Dean",14,12,9,2,4,0,29,0
West Coast,"Dalziell, Bradd",19,12,5,7,0,1,0,5
West Coast,"Darling, Jack",14,11,5,3,5,1,0,0
West Coast,"Gaff, Andrew",18,10,2,8,0,0,0,2
West Coast,"Glass, Darren",16,8,7,8,0,0,0,2
West Coast,"Hill, Josh",11,7,4,4,1,1,0,2
West Coast,"Hurn, Shannon",23,21,7,2,0,0,0,2
West Coast,"Kennedy, Josh",12,10,6,2,4,1,0,1
West Coast,"Kerr, Daniel",19,5,0,14,0,0,0,5
West Coast,"LeCras, Mark",19,18,9,1,3,4,0,0
West Coast,"Mackenzie, Eric",9,3,4,6,0,0,1,6
West Coast,"Masten, Chris",26,19,5,7,1,0,0,8
West Coast,"Naitanui, Nic",5,1,1,4,0,0,17,1
West Coast,"Priddis, Matt",29,14,5,15,1,0,0,7
West Coast,"Schofield, Will",14,9,9,5,0,0,0,3
West Coast,"Selwood, Scott",24,11,6,13,0,0,0,11
West Coast,"Shuey, Luke",25,15,5,10,2,1,0,5
West Coast,"Sinclair, Callum",6,4,3,2,0,0,10,3
West Coast,"Smith, Ashley",15,10,9,5,0,0,0,0
West Coast,"Wellingham, Sharrod",26,18,6,8,0,1,0,4
West Coast,"Brennan, Jacob",7,6,0,1,0,0,0,3
West Coast,"Brown, Mitch",10,4,2,6,0,0,0,1
West Coast,"Cox, Dean",10,8,4,2,0,1,29,3
West Coast,"Dalziell, Bradd",11,6,3,5,1,0,0,1
West Coast,"Darling, Jack",11,6,4,5,1,1,0,1
West Coast,"Gaff, Andrew",15,6,2,9,0,0,0,0
West Coast,"Glass, Darren",17,8,3,9,0,0,0,6
West Coast,"Hill, Josh",13,10,4,3,2,1,0,4
West Coast,"Hurn, Shannon",20,17,4,3,0,0,0,5
West Coast,"Hutchings, Mark",15,13,4,2,0,1,1,7
West Coast,"Kennedy, Josh",9,8,4,1,4,1,0,3
West Coast,"LeCras, Mark",9,7,3,2,3,0,0,2
West Coast,"Mackenzie, Eric",7,2,1,5,0,0,0,3
West Coast,"Naitanui, Nic",15,6,1,9,2,0,29,1
West Coast,"Priddis, Matt",29,17,0,12,0,0,0,3
West Coast,"Rosa, Matt",22,7,2,15,1,0,0,3
West Coast,"Schofield, Will",10,9,1,1,0,0,0,2
West Coast,"Selwood, Scott",23,12,2,11,0,0,0,10
West Coast,"Sheppard, Brad",13,9,3,4,2,0,0,1
West Coast,"Shuey, Luke",12,8,0,4,1,0,0,5
West Coast,"Smith, Ashley",14,8,2,6,0,0,0,1
West Coast,"Wellingham, Sharrod",16,6,3,10,0,0,0,3
West Coast,"Brennan, Jacob",11,10,8,1,0,0,0,0
West Coast,"Cox, Dean",8,7,3,1,1,2,25,3
West Coast,"Darling, Jack",7,7,3,0,1,3,0,7
West Coast,"Gaff, Andrew",22,15,5,7,0,1,0,0
West Coast,"Glass, Darren",9,6,3,3,0,0,1,6
West Coast,"Hill, Josh",9,9,5,0,3,2,0,1
West Coast,"Hurn, Shannon",15,15,7,0,0,0,0,1
West Coast,"Kennedy, Josh",13,12,8,1,2,1,0,3
West Coast,"Kerr, Daniel",21,11,4,10,0,0,0,1
West Coast,"LeCras, Mark",15,12,4,3,1,4,0,0
West Coast,"Mackenzie, Eric",8,4,3,4,0,0,0,4
West Coast,"Masten, Chris",17,11,2,6,1,0,0,9
West Coast,"Naitanui, Nic",18,6,6,12,1,1,20,4
West Coast,"Priddis, Matt",21,9,2,12,0,1,0,11
West Coast,"Rosa, Matt",15,6,5,9,0,0,0,1
West Coast,"Schofield, Will",4,3,2,1,0,0,0,3
West Coast,"Selwood, Adam",9,8,3,1,0,0,0,2
West Coast,"Selwood, Scott",18,10,5,8,0,0,0,3
West Coast,"Sheppard, Brad",10,6,0,4,0,1,0,0
West Coast,"Shuey, Luke",18,14,5,4,2,1,0,4
West Coast,"Waters, Beau",16,11,9,5,0,0,0,2
West Coast,"Wellingham, Sharrod",3,2,1,1,0,0,0,0
West Coast,"Brennan, Jacob",13,8,4,5,0,0,0,2
West Coast,"Brown, Mitch",8,7,6,1,0,2,0,4
West Coast,"Butler, Sam",18,12,5,6,1,1,0,3
West Coast,"Cox, Dean",21,11,8,10,0,1,25,0
West Coast,"Dalziell, Bradd",3,0,0,3,0,0,0,0
West Coast,"Darling, Jack",14,11,7,3,5,2,0,7
West Coast,"Gaff, Andrew",23,16,3,7,1,1,0,3
West Coast,"Glass, Darren",15,7,4,8,0,0,0,2
West Coast,"Hill, Josh",11,9,6,2,3,1,0,4
West Coast,"Hurn, Shannon",22,14,7,8,0,1,0,3
West Coast,"Hutchings, Mark",22,13,8,9,0,0,0,4
West Coast,"Kennedy, Josh",14,11,7,3,5,2,0,3
West Coast,"Kerr, Daniel",28,13,2,15,1,0,0,2
West Coast,"LeCras, Mark",16,13,9,3,3,3,0,0
West Coast,"Mackenzie, Eric",12,5,2,7,0,0,0,5
West Coast,"Masten, Chris",32,23,8,9,0,1,0,4
West Coast,"Naitanui, Nic",13,6,1,7,2,0,30,8
West Coast,"Priddis, Matt",27,11,2,16,0,0,0,9
West Coast,"Rosa, Matt",17,7,5,10,0,1,0,2
West Coast,"Selwood, Scott",22,12,4,10,0,0,0,3
West Coast,"Sheppard, Brad",14,9,7,5,1,0,0,4
West Coast,"Shuey, Luke",27,16,4,11,1,0,0,5
West Coast,"Brown, Mitch",7,4,2,3,0,0,0,3
West Coast,"Butler, Sam",16,9,4,7,0,0,0,3
West Coast,"Cox, Dean",9,6,3,3,0,1,42,1
West Coast,"Darling, Jack",10,5,4,5,1,1,0,2
West Coast,"Embley, Andrew",9,7,2,2,0,0,0,0
West Coast,"Gaff, Andrew",13,10,2,3,0,0,0,0
West Coast,"Glass, Darren",8,6,3,2,0,0,0,1
West Coast,"Hill, Josh",17,12,7,5,2,1,0,2
West Coast,"Hurn, Shannon",17,15,5,2,0,0,0,2
West Coast,"Hutchings, Mark",19,10,5,9,0,0,0,5
West Coast,"Kennedy, Josh",10,9,4,1,3,3,0,3
West Coast,"Kerr, Daniel",21,10,1,11,1,0,0,4
West Coast,"LeCras, Mark",8,8,4,0,0,1,0,5
West Coast,"Mackenzie, Eric",9,5,3,4,0,0,0,4
West Coast,"Masten, Chris",27,15,8,12,0,0,0,4
West Coast,"Naitanui, Nic",11,6,2,5,0,0,39,2
West Coast,"Priddis, Matt",17,6,0,11,0,0,0,13
West Coast,"Rosa, Matt",15,6,6,9,0,0,0,6
West Coast,"Selwood, Adam",12,6,3,6,0,0,0,4
West Coast,"Selwood, Scott",31,19,1,12,1,2,0,11
West Coast,"Sheppard, Brad",11,7,3,4,0,0,0,3
West Coast,"Shuey, Luke",27,15,7,12,0,0,0,6
West Coast,"Brennan, Jacob",11,5,4,6,0,0,0,3
West Coast,"Brown, Mitch",13,5,3,8,0,0,0,1
West Coast,"Butler, Sam",12,8,6,4,0,0,0,5
West Coast,"Cox, Dean",17,14,6,3,1,1,26,1
West Coast,"Cripps, Jamie",2,0,0,2,0,0,0,1
West Coast,"Darling, Jack",11,8,7,3,3,1,0,2
West Coast,"Embley, Andrew",15,13,5,2,2,0,0,1
West Coast,"Gaff, Andrew",10,5,2,5,0,0,0,0
West Coast,"Hams, Ashton",5,4,2,1,0,2,0,3
West Coast,"Hill, Josh",9,6,4,3,0,1,0,1
West Coast,"Hurn, Shannon",14,12,4,2,0,0,0,0
West Coast,"Kerr, Daniel",18,10,4,8,0,0,0,2
West Coast,"Mackenzie, Eric",17,8,7,9,2,0,0,3
West Coast,"Masten, Chris",24,12,4,12,0,0,0,1
West Coast,"Naitanui, Nic",14,9,5,5,1,1,31,2
West Coast,"Priddis, Matt",27,15,5,12,2,0,0,2
West Coast,"Rosa, Matt",14,10,3,4,0,0,0,1
West Coast,"Selwood, Adam",10,7,3,3,0,0,0,0
West Coast,"Selwood, Scott",33,14,6,19,1,0,0,5
West Coast,"Sheppard, Brad",13,10,2,3,0,1,0,3
West Coast,"Shuey, Luke",26,14,4,12,0,0,0,3
West Coast,"Wilson, Blayne",21,12,10,9,0,0,0,0
West Coast,"Brown, Mitch",16,0,2,16,0,0,0,2
West Coast,"Butler, Sam",13,8,3,5,0,0,0,2
West Coast,"Cox, Dean",17,11,10,6,1,1,17,5
West Coast,"Dalziell, Bradd",16,9,5,7,1,0,0,3
West Coast,"Darling, Jack",10,10,4,0,1,0,0,2
West Coast,"Embley, Andrew",10,8,4,2,0,0,0,3
West Coast,"Gaff, Andrew",29,17,6,12,0,0,0,5
West Coast,"Glass, Darren",9,4,3,5,0,0,1,2
West Coast,"Hurn, Shannon",2,1,1,1,0,0,0,0
West Coast,"Kennedy, Josh",13,11,10,2,5,1,0,8
West Coast,"Kerr, Daniel",25,11,2,14,0,0,0,1
West Coast,"LeCras, Mark",19,14,5,5,2,1,0,3
West Coast,"Mackenzie, Eric",12,8,4,4,0,0,0,1
West Coast,"Masten, Chris",26,15,7,11,1,0,0,3
West Coast,"McGinnity, Patrick",10,3,2,7,0,0,0,8
West Coast,"Naitanui, Nic",12,7,2,5,1,0,29,4
West Coast,"Priddis, Matt",27,9,2,18,1,0,0,9
West Coast,"Rosa, Matt",22,10,3,12,0,0,0,1
West Coast,"Selwood, Scott",24,11,5,13,1,0,0,6
West Coast,"Shuey, Luke",33,18,4,15,2,0,1,2
West Coast,"Waters, Beau",23,19,7,4,0,0,0,1
West Coast,"Wilson, Blayne",15,8,3,7,0,0,0,1
West Coast,"Brown, Mitch",11,5,3,6,0,0,0,3
West Coast,"Butler, Sam",22,15,7,7,0,0,0,6
West Coast,"Cox, Dean",16,10,7,6,1,0,21,3
West Coast,"Dalziell, Bradd",24,12,8,12,2,0,0,4
West Coast,"Darling, Jack",15,8,4,7,3,2,0,2
West Coast,"Gaff, Andrew",25,19,6,6,0,0,0,2
West Coast,"Glass, Darren",14,7,4,7,0,0,0,2
West Coast,"Hutchings, Mark",24,16,4,8,0,1,0,4
West Coast,"Kennedy, Josh",17,15,7,2,2,2,0,5
West Coast,"Kerr, Daniel",19,11,0,8,1,0,0,2
West Coast,"LeCras, Mark",14,14,8,0,3,1,0,4
West Coast,"Mackenzie, Eric",10,7,4,3,0,0,0,1
West Coast,"Masten, Chris",30,12,5,18,0,0,0,3
West Coast,"McGinnity, Patrick",12,9,1,3,0,0,0,3
West Coast,"Naitanui, Nic",10,4,5,6,0,1,17,2
West Coast,"Priddis, Matt",33,14,4,19,1,0,0,4
West Coast,"Rosa, Matt",22,10,1,12,0,0,0,3
West Coast,"Schofield, Will",11,6,5,5,0,0,0,0
West Coast,"Sheppard, Brad",9,4,1,5,0,0,0,4
West Coast,"Smith, Ashley",22,13,7,9,0,1,0,3
West Coast,"Tunbridge, Simon",2,2,0,0,0,0,0,0
West Coast,"Waters, Beau",21,16,7,5,0,0,0,2
West Coast,"Brennan, Jacob",4,2,1,2,0,0,0,0
West Coast,"Brown, Mitch",10,7,3,3,0,0,0,3
West Coast,"Cox, Dean",12,5,1,7,0,0,19,4
West Coast,"Cripps, Jamie",13,8,7,5,1,0,0,4
West Coast,"Dalziell, Bradd",26,16,9,10,1,1,0,6
West Coast,"Darling, Jack",3,2,2,1,0,0,0,1
West Coast,"Embley, Andrew",16,13,3,3,1,0,0,1
West Coast,"Gaff, Andrew",16,9,0,7,0,0,0,1
West Coast,"Glass, Darren",10,5,4,5,0,0,0,3
West Coast,"Hill, Josh",9,7,1,2,1,1,0,4
West Coast,"Hutchings, Mark",17,11,1,6,0,0,0,5
West Coast,"Kennedy, Josh",13,12,8,1,4,0,0,0
West Coast,"LeCras, Mark",14,11,4,3,1,3,0,5
West Coast,"Mackenzie, Eric",21,14,11,7,0,0,0,1
West Coast,"Masten, Chris",39,18,4,21,0,0,0,1
West Coast,"McGinnity, Patrick",17,11,5,6,1,0,0,7
West Coast,"Naitanui, Nic",11,7,1,4,0,0,22,4
West Coast,"Priddis, Matt",33,18,3,15,0,1,0,6
West Coast,"Rosa, Matt",22,15,2,7,0,0,1,5
West Coast,"Schofield, Will",15,10,5,5,1,0,0,0
West Coast,"Sheppard, Brad",10,5,2,5,0,0,0,4
West Coast,"Waters, Beau",24,14,5,10,0,0,0,4
West Coast,"Brennan, Jacob",14,11,4,3,0,1,0,3
West Coast,"Brown, Mitch",6,2,3,4,0,0,0,5
West Coast,"Carter, Adam",11,10,7,1,0,0,0,2
West Coast,"Cox, Dean",12,6,2,6,0,1,15,2
West Coast,"Cripps, Jamie",11,6,4,5,2,0,0,5
West Coast,"Dalziell, Bradd",14,4,1,10,0,0,0,2
West Coast,"Darling, Jack",12,11,6,1,5,1,0,4
West Coast,"Embley, Andrew",23,16,5,7,1,0,0,8
West Coast,"Gaff, Andrew",14,10,3,4,0,0,0,2
West Coast,"Glass, Darren",15,8,8,7,0,0,0,3
West Coast,"Hill, Josh",8,6,3,2,0,2,0,3
West Coast,"Hutchings, Mark",19,9,1,10,0,0,0,16
West Coast,"Kennedy, Josh",12,11,9,1,2,1,0,3
West Coast,"LeCras, Mark",14,10,4,4,2,1,0,3
West Coast,"Mackenzie, Eric",20,16,9,4,0,0,1,2
West Coast,"Masten, Chris",26,16,3,10,0,0,0,4
West Coast,"Morton, Cale",2,2,0,0,0,0,0,0
West Coast,"Naitanui, Nic",6,2,0,4,0,0,19,9
West Coast,"Priddis, Matt",26,10,0,16,0,1,0,5
West Coast,"Rosa, Matt",11,4,1,7,0,0,0,2
West Coast,"Schofield, Will",17,14,6,3,2,0,7,1
West Coast,"Smith, Ashley",12,6,4,6,0,0,0,2
West Coast,"Brown, Mitch",14,5,4,9,0,0,0,0
West Coast,"Carter, Adam",14,8,4,6,0,1,0,3
West Coast,"Cox, Dean",9,7,6,2,1,0,22,2
West Coast,"Cripps, Jamie",7,7,3,0,0,0,0,2
West Coast,"Dalziell, Bradd",15,3,0,12,1,0,0,4
West Coast,"Darling, Jack",11,9,6,2,1,2,0,2
West Coast,"Gaff, Andrew",28,14,4,14,0,0,0,4
West Coast,"Glass, Darren",23,13,14,10,0,0,0,0
West Coast,"Hill, Josh",6,3,1,3,0,1,0,8
West Coast,"Hutchings, Mark",19,7,5,12,0,0,0,7
West Coast,"Kennedy, Josh",20,12,9,8,4,1,0,5
West Coast,"LeCras, Mark",24,18,8,6,0,1,0,6
West Coast,"Mackenzie, Eric",13,11,6,2,0,0,0,2
West Coast,"Masten, Chris",31,21,5,10,1,0,1,7
West Coast,"Morton, Cale",16,9,4,7,1,2,0,0
West Coast,"Naitanui, Nic",12,2,1,10,1,0,26,2
West Coast,"Priddis, Matt",31,9,3,22,0,1,0,10
West Coast,"Schofield, Will",14,8,3,6,0,0,3,3
West Coast,"Selwood, Adam",10,6,4,4,0,0,0,1
West Coast,"Shuey, Luke",6,5,2,1,0,1,0,9
West Coast,"Smith, Ashley",22,18,7,4,0,0,0,3
West Coast,"Wellingham, Sharrod",19,9,3,10,1,0,0,2
West Coast,"Brown, Mitch",12,7,3,5,0,0,0,1
West Coast,"Butler, Sam",22,16,10,6,0,0,0,2
West Coast,"Carter, Adam",13,9,4,4,0,0,0,2
West Coast,"Cox, Dean",21,11,7,10,0,0,26,1
West Coast,"Cripps, Jamie",9,7,4,2,2,1,0,5
West Coast,"Dalziell, Bradd",26,11,5,15,1,0,0,2
West Coast,"Darling, Jack",10,8,6,2,2,2,1,2
West Coast,"Gaff, Andrew",31,18,6,13,0,2,0,2
West Coast,"Hams, Ashton",11,8,5,3,0,1,0,1
West Coast,"Hill, Josh",8,6,1,2,3,0,0,3
West Coast,"Hutchings, Mark",26,8,4,18,0,0,0,6
West Coast,"Kennedy, Josh",11,10,7,1,3,0,0,3
West Coast,"Lycett, Scott",15,7,5,8,0,0,7,3
West Coast,"Mackenzie, Eric",17,7,3,10,0,0,0,1
West Coast,"Masten, Chris",5,3,0,2,0,1,0,2
West Coast,"Morton, Cale",13,9,5,4,0,0,1,0
West Coast,"Priddis, Matt",27,7,2,20,0,0,0,3
West Coast,"Schofield, Will",14,11,8,3,0,1,2,1
West Coast,"Selwood, Scott",23,10,6,13,0,1,0,11
West Coast,"Smith, Ashley",17,9,2,8,0,0,0,2
West Coast,"Wellingham, Sharrod",21,10,2,11,2,0,0,7
West Coast,"Wilson, Blayne",18,15,10,3,0,0,0,1
West Coast,"Brown, Mitch",11,4,4,7,0,0,0,2
West Coast,"Butler, Sam",17,14,6,3,0,0,0,4
West Coast,"Carter, Adam",8,5,2,3,0,0,0,1
West Coast,"Cox, Dean",19,11,9,8,1,1,44,4
West Coast,"Cripps, Jamie",15,9,4,6,1,0,0,5
West Coast,"Dalziell, Bradd",23,16,7,7,2,0,0,3
West Coast,"Darling, Jack",13,6,4,7,0,1,0,0
West Coast,"Embley, Andrew",3,2,1,1,1,0,0,0
West Coast,"Gaff, Andrew",21,15,4,6,0,0,0,4
West Coast,"Glass, Darren",14,9,6,5,0,0,0,5
West Coast,"Hams, Ashton",15,8,3,7,1,0,0,3
West Coast,"Hill, Josh",13,7,5,6,3,1,0,3
West Coast,"Hutchings, Mark",25,15,2,10,1,1,0,6
West Coast,"Kennedy, Josh",14,12,8,2,5,2,0,3
West Coast,"Lycett, Scott",13,11,9,2,1,1,15,1
West Coast,"Mackenzie, Eric",17,15,8,2,1,1,0,3
West Coast,"Schofield, Will",14,8,5,6,2,0,1,4
West Coast,"Selwood, Scott",27,15,4,12,0,0,0,4
West Coast,"Sheppard, Brad",8,4,3,4,0,1,0,1
West Coast,"Smith, Ashley",8,5,3,3,0,0,0,1
West Coast,"Wellingham, Sharrod",23,18,6,5,1,0,0,5
West Coast,"Wilson, Blayne",24,14,5,10,0,0,0,0
West Coast,"Brown, Mitch",14,7,4,7,0,0,0,2
West Coast,"Butler, Sam",18,10,6,8,0,0,0,6
West Coast,"Cox, Dean",20,13,7,7,0,1,23,3
West Coast,"Cripps, Jamie",17,8,3,9,1,0,0,3
West Coast,"Dalziell, Bradd",25,15,5,10,2,0,0,2
West Coast,"Darling, Jack",21,11,4,10,2,2,0,7
West Coast,"Gaff, Andrew",22,13,4,9,1,0,0,2
West Coast,"Glass, Darren",12,5,4,7,0,0,0,2
West Coast,"Hill, Josh",12,5,2,7,2,0,0,2
West Coast,"Kennedy, Josh",12,11,4,1,1,0,0,1
West Coast,"LeCras, Mark",13,10,8,3,5,2,0,3
West Coast,"Lycett, Scott",8,2,2,6,0,0,9,2
West Coast,"Mackenzie, Eric",11,7,4,4,0,0,0,1
West Coast,"Masten, Chris",26,20,6,6,0,0,0,7
West Coast,"McGinnity, Patrick",12,8,4,4,0,1,0,5
West Coast,"Priddis, Matt",28,15,6,13,1,0,0,3
West Coast,"Schofield, Will",11,8,9,3,1,1,5,3
West Coast,"Selwood, Scott",21,13,4,8,0,0,0,9
West Coast,"Sheppard, Brad",8,6,2,2,0,0,0,1
West Coast,"Smith, Ashley",21,14,5,7,0,0,0,1
West Coast,"Wellingham, Sharrod",24,15,4,9,2,0,0,3
West Coast,"Wilson, Blayne",8,5,1,3,0,0,0,1
West Coast,"Brown, Mitch",8,3,3,5,0,0,0,1
West Coast,"Butler, Sam",18,11,3,7,0,1,0,7
West Coast,"Carter, Adam",17,14,7,3,0,0,0,4
West Coast,"Cox, Dean",15,8,1,7,0,1,29,6
West Coast,"Cripps, Jamie",12,6,2,6,0,0,0,3
West Coast,"Dalziell, Bradd",19,9,4,10,1,0,0,4
West Coast,"Darling, Jack",12,7,3,5,1,0,0,2
West Coast,"Embley, Andrew",11,6,1,5,0,0,0,3
West Coast,"Gaff, Andrew",22,11,5,11,0,0,0,2
West Coast,"Glass, Darren",18,8,7,10,0,0,0,1
West Coast,"Hill, Josh",3,1,0,2,1,0,0,1
West Coast,"Kennedy, Josh",14,8,6,6,0,0,0,3
West Coast,"Lycett, Scott",11,4,4,7,0,0,16,4
West Coast,"Mackenzie, Eric",12,9,6,3,0,0,1,2
West Coast,"McGinnity, Patrick",10,7,2,3,0,0,0,4
West Coast,"Priddis, Matt",29,10,4,19,0,0,0,3
West Coast,"Schofield, Will",15,6,2,9,1,1,1,4
West Coast,"Selwood, Scott",26,12,1,14,1,0,0,11
West Coast,"Sheppard, Brad",17,13,5,4,0,1,0,4
West Coast,"Shuey, Luke",7,4,2,3,0,0,0,0
West Coast,"Smith, Ashley",13,9,3,4,0,0,0,5
West Coast,"Wellingham, Sharrod",29,21,2,8,1,1,0,2
West Coast,"Brown, Mitch",9,3,1,6,0,0,0,2
West Coast,"Butler, Sam",23,12,3,11,0,0,0,6
West Coast,"Cox, Dean",17,7,7,10,0,1,28,2
West Coast,"Cripps, Jamie",17,8,3,9,0,0,0,4
West Coast,"Dalziell, Bradd",8,7,3,1,1,0,0,0
West Coast,"Darling, Jack",9,5,3,4,1,0,0,1
West Coast,"Gaff, Andrew",17,10,2,7,0,0,0,1
West Coast,"Glass, Darren",16,8,3,8,0,0,0,2
West Coast,"Hill, Josh",12,7,4,5,0,3,0,3
West Coast,"Kennedy, Josh",12,8,5,4,0,2,0,1
West Coast,"Lycett, Scott",17,5,4,12,1,0,9,3
West Coast,"Mackenzie, Eric",6,4,1,2,0,0,0,1
West Coast,"Masten, Chris",31,15,7,16,2,0,0,1
West Coast,"McGinnity, Patrick",15,6,3,9,0,0,0,2
West Coast,"Priddis, Matt",32,13,3,19,0,0,0,9
West Coast,"Rosa, Matt",37,19,8,18,0,0,0,3
West Coast,"Schofield, Will",14,7,3,7,0,0,1,1
West Coast,"Selwood, Scott",33,13,4,20,0,0,0,3
West Coast,"Sheppard, Brad",13,3,2,10,0,0,0,2
West Coast,"Smith, Ashley",13,8,0,5,0,0,0,2
West Coast,"Wellingham, Sharrod",14,8,4,6,0,1,0,0
West Coast,"Wilson, Blayne",15,9,2,6,0,0,0,2
West Coast,"Brown, Mitch",5,3,1,2,0,0,0,2
West Coast,"Butler, Sam",19,13,7,6,0,0,0,0
West Coast,"Cox, Dean",27,16,8,11,0,1,27,2
West Coast,"Cripps, Jamie",7,5,0,2,0,1,0,7
West Coast,"Dalziell, Bradd",18,10,5,8,1,0,0,2
West Coast,"Embley, Andrew",11,8,3,3,0,1,0,2
West Coast,"Gaff, Andrew",16,9,3,7,0,0,0,2
West Coast,"Glass, Darren",17,10,4,7,0,0,0,3
West Coast,"Hill, Josh",6,5,2,1,0,1,0,2
West Coast,"Kennedy, Josh",6,4,5,2,0,1,0,2
West Coast,"Lycett, Scott",9,1,1,8,0,1,16,0
West Coast,"Mackenzie, Eric",16,8,3,8,0,0,1,1
West Coast,"Masten, Chris",18,10,2,8,0,1,0,2
West Coast,"McGinnity, Patrick",10,6,3,4,0,1,0,1
West Coast,"Priddis, Matt",35,7,0,28,0,0,0,5
West Coast,"Rosa, Matt",23,11,3,12,0,0,0,6
West Coast,"Selwood, Adam",7,2,0,5,0,0,0,3
West Coast,"Selwood, Scott",32,14,8,18,0,0,0,6
West Coast,"Smith, Ashley",13,9,5,4,1,0,0,2
West Coast,"Tunbridge, Simon",9,9,2,0,2,1,0,3
West Coast,"Wellingham, Sharrod",16,4,1,12,1,0,0,1
West Coast,"Wilson, Blayne",17,12,6,5,0,0,0,3
Western Bulldogs,"Cooney, Adam",21,16,8,5,1,0,0,3
Western Bulldogs,"Cordy, Ayce",8,6,2,2,2,0,4,3
Western Bulldogs,"Cross, Daniel",23,14,7,9,0,0,0,4
Western Bulldogs,"Dahlhaus, Luke",16,11,4,5,2,0,0,3
Western Bulldogs,"Dickson, Tory",18,12,6,6,2,0,0,8
Western Bulldogs,"Giansiracusa, Daniel",18,13,9,5,3,0,0,1
Western Bulldogs,"Goodes, Brett",24,14,7,10,0,0,0,2
Western Bulldogs,"Griffen, Ryan",27,18,7,9,2,1,0,6
Western Bulldogs,"Higgins, Shaun",22,18,8,4,3,3,0,3
Western Bulldogs,"Johannisen, Jason",14,11,3,3,1,1,0,4
Western Bulldogs,"Jones, Liam",7,3,2,4,1,2,0,3
Western Bulldogs,"Liberatore, Tom",28,15,5,13,0,0,0,9
Western Bulldogs,"Lower, Nick",13,11,2,2,0,1,0,3
Western Bulldogs,"Minson, Will",18,9,5,9,0,0,34,2
Western Bulldogs,"Morris, Dale",12,9,7,3,0,0,0,4
Western Bulldogs,"Murphy, Robert",16,13,6,3,2,1,0,2
Western Bulldogs,"Picken, Liam",18,15,10,3,0,0,0,1
Western Bulldogs,"Roughead, Jordan",11,8,7,3,0,0,0,1
Western Bulldogs,"Smith, Clay",8,2,0,6,0,0,1,3
Western Bulldogs,"Stevens, Koby",17,7,3,10,0,0,0,1
Western Bulldogs,"Wallis, Mitch",24,9,1,15,0,0,0,4
Western Bulldogs,"Young, Tom",17,11,7,6,0,0,0,1
Western Bulldogs,"Cooney, Adam",31,18,5,13,1,0,0,3
Western Bulldogs,"Cordy, Ayce",7,4,1,3,1,1,3,0
Western Bulldogs,"Cross, Daniel",24,11,7,13,2,0,0,3
Western Bulldogs,"Dahlhaus, Luke",12,8,1,4,3,2,0,4
Western Bulldogs,"Dickson, Tory",11,8,1,3,0,0,0,3
Western Bulldogs,"Giansiracusa, Daniel",11,10,3,1,0,2,0,1
Western Bulldogs,"Goodes, Brett",21,13,6,8,0,0,0,3
Western Bulldogs,"Griffen, Ryan",17,10,3,7,0,0,0,5
Western Bulldogs,"Higgins, Shaun",11,8,6,3,0,1,0,6
Western Bulldogs,"Johannisen, Jason",15,6,1,9,0,0,0,1
Western Bulldogs,"Jones, Liam",10,6,4,4,0,1,0,0
Western Bulldogs,"Liberatore, Tom",28,12,3,16,0,0,0,11
Western Bulldogs,"Lower, Nick",11,10,6,1,1,0,0,3
Western Bulldogs,"Minson, Will",16,6,1,10,0,0,48,3
Western Bulldogs,"Morris, Dale",13,6,4,7,0,0,0,1
Western Bulldogs,"Murphy, Robert",13,8,4,5,2,1,0,1
Western Bulldogs,"Picken, Liam",23,14,4,9,0,1,2,2
Western Bulldogs,"Roughead, Jordan",8,6,4,2,0,0,0,1
Western Bulldogs,"Smith, Clay",21,13,7,8,1,1,0,5
Western Bulldogs,"Stevens, Koby",13,7,2,6,0,1,0,1
Western Bulldogs,"Wallis, Mitch",17,9,1,8,0,0,0,3
Western Bulldogs,"Young, Tom",17,11,6,6,0,0,0,1
Western Bulldogs,"Campbell, Tom",5,2,1,3,0,0,5,0
Western Bulldogs,"Cooney, Adam",16,11,2,5,2,0,0,3
Western Bulldogs,"Cross, Daniel",23,8,5,15,0,0,1,3
Western Bulldogs,"Dahlhaus, Luke",15,4,0,11,1,0,0,0
Western Bulldogs,"Dickson, Tory",8,4,3,4,0,1,0,1
Western Bulldogs,"Giansiracusa, Daniel",11,5,4,6,1,0,0,2
Western Bulldogs,"Goodes, Brett",14,7,4,7,0,0,0,0
Western Bulldogs,"Griffen, Ryan",30,19,2,11,1,1,0,3
Western Bulldogs,"Higgins, Shaun",8,4,3,4,0,0,0,1
Western Bulldogs,"Jones, Liam",9,7,6,2,4,1,0,1
Western Bulldogs,"Liberatore, Tom",10,4,1,6,0,0,0,5
Western Bulldogs,"Lower, Nick",10,7,3,3,0,0,0,3
Western Bulldogs,"Minson, Will",11,6,1,5,0,0,32,4
Western Bulldogs,"Morris, Dale",12,7,1,5,0,0,0,1
Western Bulldogs,"Murphy, Robert",22,16,6,6,0,1,0,0
Western Bulldogs,"Picken, Liam",14,10,1,4,0,0,0,1
Western Bulldogs,"Roughead, Jordan",4,1,0,3,0,0,0,3
Western Bulldogs,"Smith, Clay",11,8,2,3,0,0,0,3
Western Bulldogs,"Stevens, Koby",19,9,4,10,1,0,0,2
Western Bulldogs,"Wallis, Mitch",22,9,2,13,0,0,0,6
Western Bulldogs,"Wood, Easton",0,0,0,0,0,0,0,0
Western Bulldogs,"Young, Tom",18,14,4,4,0,0,0,3
Western Bulldogs,"Boyd, Matthew",28,19,0,9,1,0,0,2
Western Bulldogs,"Cooney, Adam",30,20,3,10,2,0,0,4
Western Bulldogs,"Cordy, Ayce",13,4,1,9,0,0,8,4
Western Bulldogs,"Cross, Daniel",21,9,6,12,0,0,0,7
Western Bulldogs,"Dahlhaus, Luke",13,8,0,5,0,1,0,5
Western Bulldogs,"Giansiracusa, Daniel",5,2,1,3,0,0,0,2
Western Bulldogs,"Goodes, Brett",27,19,6,8,0,1,0,6
Western Bulldogs,"Griffen, Ryan",15,12,1,3,0,0,1,7
Western Bulldogs,"Johannisen, Jason",14,7,2,7,0,0,0,1
Western Bulldogs,"Jones, Liam",7,3,2,4,0,0,0,4
Western Bulldogs,"Liberatore, Tom",33,16,2,17,0,1,0,7
Western Bulldogs,"Lower, Nick",15,9,3,6,0,0,0,2
Western Bulldogs,"Macrae, Jack",16,10,0,6,1,0,0,4
Western Bulldogs,"Minson, Will",10,10,1,0,0,0,47,5
Western Bulldogs,"Morris, Dale",14,9,3,5,0,0,0,5
Western Bulldogs,"Picken, Liam",12,6,2,6,0,0,0,6
Western Bulldogs,"Roughead, Jordan",13,8,5,5,0,0,0,5
Western Bulldogs,"Stevens, Koby",14,4,1,10,0,0,0,5
Western Bulldogs,"Stringer, Jake",5,2,2,3,0,0,0,2
Western Bulldogs,"Tutt, Jason",8,4,2,4,0,0,0,6
Western Bulldogs,"Wallis, Mitch",24,14,4,10,0,0,0,2
Western Bulldogs,"Young, Tom",16,9,2,7,0,0,0,2
Western Bulldogs,"Austin, Mark",11,7,4,4,0,0,0,0
Western Bulldogs,"Boyd, Matthew",29,11,5,18,0,0,0,6
Western Bulldogs,"Cooney, Adam",19,13,3,6,2,1,0,0
Western Bulldogs,"Cross, Daniel",27,9,8,18,0,0,1,4
Western Bulldogs,"Dahlhaus, Luke",17,7,1,10,1,1,0,3
Western Bulldogs,"Goodes, Brett",17,12,6,5,0,0,0,0
Western Bulldogs,"Johannisen, Jason",24,18,4,6,0,0,0,1
Western Bulldogs,"Jones, Liam",12,8,6,4,4,2,0,1
Western Bulldogs,"Liberatore, Tom",25,14,3,11,0,0,0,2
Western Bulldogs,"Lower, Nick",18,11,3,7,0,0,0,3
Western Bulldogs,"Macrae, Jack",8,3,2,5,0,0,0,0
Western Bulldogs,"Minson, Will",10,7,0,3,0,0,37,3
Western Bulldogs,"Morris, Dale",11,7,8,4,0,0,0,0
Western Bulldogs,"Picken, Liam",16,9,9,7,0,0,0,2
Western Bulldogs,"Roughead, Jordan",14,8,6,6,1,0,4,3
Western Bulldogs,"Smith, Clay",17,13,5,4,2,1,0,1
Western Bulldogs,"Stevens, Koby",20,11,5,9,0,0,0,1
Western Bulldogs,"Stringer, Jake",10,7,5,3,3,0,0,1
Western Bulldogs,"Tutt, Jason",16,12,7,4,0,2,0,2
Western Bulldogs,"Veszpremi, Patrick",4,2,0,2,0,1,0,1
Western Bulldogs,"Wallis, Mitch",16,8,4,8,0,0,0,4
Western Bulldogs,"Young, Tom",21,14,5,7,0,0,0,2
Western Bulldogs,"Addison, Dylan",14,6,3,8,1,0,0,4
Western Bulldogs,"Austin, Mark",4,2,1,2,0,0,1,3
Western Bulldogs,"Boyd, Matthew",25,7,3,18,0,0,0,4
Western Bulldogs,"Cooney, Adam",24,13,4,11,1,0,0,1
Western Bulldogs,"Cross, Daniel",20,11,4,9,0,0,1,4
Western Bulldogs,"Dahlhaus, Luke",21,9,2,12,0,1,0,1
Western Bulldogs,"Howard, Christian",9,7,0,2,0,0,0,1
Western Bulldogs,"Johannisen, Jason",9,9,2,0,0,0,0,0
Western Bulldogs,"Jones, Liam",15,11,9,4,1,2,0,2
Western Bulldogs,"Liberatore, Tom",18,9,1,9,0,0,0,6
Western Bulldogs,"Lower, Nick",16,10,2,6,1,0,0,8
Western Bulldogs,"Macrae, Jack",16,11,0,5,1,0,0,2
Western Bulldogs,"Minson, Will",14,7,1,7,0,0,38,1
Western Bulldogs,"Morris, Dale",5,2,1,3,0,0,0,0
Western Bulldogs,"Picken, Liam",19,7,3,12,0,0,0,8
Western Bulldogs,"Roughead, Jordan",8,5,4,3,0,0,0,5
Western Bulldogs,"Smith, Clay",26,16,3,10,2,1,0,4
Western Bulldogs,"Stevens, Koby",18,8,5,10,0,0,0,4
Western Bulldogs,"Stringer, Jake",3,2,0,1,1,0,0,2
Western Bulldogs,"Tutt, Jason",9,8,3,1,1,1,0,3
Western Bulldogs,"Wallis, Mitch",10,6,0,4,1,0,0,2
Western Bulldogs,"Young, Tom",15,10,3,5,0,0,0,0
Western Bulldogs,"Addison, Dylan",10,6,5,4,0,1,0,2
Western Bulldogs,"Austin, Mark",10,3,1,7,1,0,0,3
Western Bulldogs,"Boyd, Matthew",20,9,1,11,0,0,0,4
Western Bulldogs,"Cooney, Adam",15,10,1,5,0,1,0,1
Western Bulldogs,"Cross, Daniel",11,3,1,8,0,0,1,6
Western Bulldogs,"Dahlhaus, Luke",17,10,0,7,1,0,0,6
Western Bulldogs,"Giansiracusa, Daniel",11,9,4,2,4,0,0,1
Western Bulldogs,"Griffen, Ryan",33,20,6,13,1,0,0,4
Western Bulldogs,"Johannisen, Jason",16,11,4,5,0,0,0,0
Western Bulldogs,"Jones, Liam",7,3,4,4,0,1,1,0
Western Bulldogs,"Liberatore, Tom",14,3,1,11,0,0,0,6
Western Bulldogs,"Lower, Nick",16,8,2,8,0,0,0,15
Western Bulldogs,"Markovic, Lukas",12,5,7,7,3,0,1,4
Western Bulldogs,"Minson, Will",13,7,1,6,1,0,38,2
Western Bulldogs,"Morris, Dale",10,6,3,4,0,0,0,5
Western Bulldogs,"Murphy, Robert",18,13,7,5,2,0,0,5
Western Bulldogs,"Picken, Liam",12,4,2,8,0,0,0,2
Western Bulldogs,"Roughead, Jordan",5,3,1,2,0,0,0,3
Western Bulldogs,"Smith, Clay",6,5,1,1,1,1,0,3
Western Bulldogs,"Tutt, Jason",1,0,0,1,0,0,0,0
Western Bulldogs,"Wallis, Mitch",15,11,1,4,1,1,0,7
Western Bulldogs,"Young, Tom",15,10,6,5,0,0,0,1
Western Bulldogs,"Boyd, Matthew",29,12,4,17,0,0,1,3
Western Bulldogs,"Cooney, Adam",31,14,6,17,0,1,0,1
Western Bulldogs,"Cross, Daniel",22,8,4,14,0,0,0,2
Western Bulldogs,"Dahlhaus, Luke",17,11,1,6,0,2,0,3
Western Bulldogs,"Giansiracusa, Daniel",19,12,10,7,1,1,0,1
Western Bulldogs,"Goodes, Brett",22,14,4,8,0,0,0,1
Western Bulldogs,"Griffen, Ryan",29,14,4,15,0,0,0,1
Western Bulldogs,"Johannisen, Jason",16,8,2,8,0,1,0,2
Western Bulldogs,"Jones, Liam",3,1,2,2,1,0,0,2
Western Bulldogs,"Liberatore, Tom",20,13,5,7,0,0,1,3
Western Bulldogs,"Lower, Nick",24,10,4,14,0,0,0,4
Western Bulldogs,"Macrae, Jack",26,13,5,13,0,0,0,4
Western Bulldogs,"Markovic, Lukas",10,5,2,5,2,1,0,0
Western Bulldogs,"Minson, Will",16,9,5,7,0,1,40,4
Western Bulldogs,"Morris, Dale",14,5,3,9,0,0,0,1
Western Bulldogs,"Murphy, Robert",19,13,7,6,1,1,0,4
Western Bulldogs,"Picken, Liam",16,9,2,7,0,0,0,1
Western Bulldogs,"Roughead, Jordan",12,6,7,6,0,0,0,0
Western Bulldogs,"Smith, Clay",4,1,0,3,0,0,0,1
Western Bulldogs,"Stevens, Koby",19,11,5,8,0,1,0,1
Western Bulldogs,"Stringer, Jake",10,9,3,1,3,1,0,2
Western Bulldogs,"Young, Tom",19,8,5,11,0,0,0,1
Western Bulldogs,"Addison, Dylan",12,9,4,3,4,1,0,4
Western Bulldogs,"Boyd, Matthew",38,24,6,14,0,0,1,7
Western Bulldogs,"Dahlhaus, Luke",10,3,3,7,1,0,0,2
Western Bulldogs,"Giansiracusa, Daniel",9,5,0,4,1,0,0,1
Western Bulldogs,"Goodes, Brett",19,9,1,10,1,0,0,6
Western Bulldogs,"Griffen, Ryan",30,15,1,15,2,0,1,1
Western Bulldogs,"Hrovat, Nathan",19,11,4,8,1,0,0,4
Western Bulldogs,"Johannisen, Jason",23,16,8,7,0,0,0,2
Western Bulldogs,"Jones, Liam",5,3,2,2,1,0,0,1
Western Bulldogs,"Liberatore, Tom",16,7,2,9,0,0,0,7
Western Bulldogs,"Lower, Nick",11,6,2,5,0,0,0,8
Western Bulldogs,"Macrae, Jack",18,6,2,12,0,0,0,4
Western Bulldogs,"Minson, Will",13,6,1,7,0,1,46,2
Western Bulldogs,"Morris, Dale",14,6,4,8,0,0,0,2
Western Bulldogs,"Murphy, Robert",19,10,3,9,1,0,0,3
Western Bulldogs,"Picken, Liam",16,9,6,7,0,0,0,2
Western Bulldogs,"Roughead, Jordan",14,6,2,8,1,0,0,2
Western Bulldogs,"Smith, Clay",17,12,7,5,1,0,0,3
Western Bulldogs,"Stevens, Koby",31,18,8,13,3,1,0,4
Western Bulldogs,"Stringer, Jake",8,4,3,4,0,1,0,0
Western Bulldogs,"Williams, Tom",10,4,3,6,0,2,1,1
Western Bulldogs,"Young, Tom",16,8,5,8,0,0,0,3
Western Bulldogs,"Addison, Dylan",10,5,4,5,1,0,0,2
Western Bulldogs,"Dahlhaus, Luke",10,6,0,4,1,0,0,6
Western Bulldogs,"Giansiracusa, Daniel",21,9,2,12,2,2,0,4
Western Bulldogs,"Goodes, Brett",26,14,5,12,0,0,0,2
Western Bulldogs,"Griffen, Ryan",40,29,4,11,1,1,1,9
Western Bulldogs,"Hrovat, Nathan",13,6,2,7,0,0,0,3
Western Bulldogs,"Johannisen, Jason",21,13,5,8,1,0,0,2
Western Bulldogs,"Jones, Liam",12,6,1,6,1,0,2,2
Western Bulldogs,"Liberatore, Tom",35,20,4,15,0,1,0,4
Western Bulldogs,"Lower, Nick",17,7,1,10,0,0,0,8
Western Bulldogs,"Macrae, Jack",23,12,3,11,0,0,0,1
Western Bulldogs,"Minson, Will",13,5,0,8,1,0,57,7
Western Bulldogs,"Morris, Dale",14,6,5,8,0,0,0,5
Western Bulldogs,"Murphy, Robert",23,16,4,7,1,0,0,6
Western Bulldogs,"Picken, Liam",8,4,0,4,0,0,0,4
Western Bulldogs,"Roughead, Jordan",13,4,3,9,0,0,0,6
Western Bulldogs,"Smith, Clay",21,15,3,6,0,1,0,7
Western Bulldogs,"Stevens, Koby",10,0,1,10,0,0,0,0
Western Bulldogs,"Stringer, Jake",3,1,0,2,0,0,0,5
Western Bulldogs,"Talia, Michael",21,13,2,8,0,0,0,1
Western Bulldogs,"Wallis, Mitch",22,11,2,11,0,0,0,5
Western Bulldogs,"Williams, Tom",6,4,2,2,1,0,2,1
Western Bulldogs,"Addison, Dylan",5,2,2,3,0,2,0,3
Western Bulldogs,"Boyd, Matthew",32,23,6,9,1,0,0,1
Western Bulldogs,"Cooney, Adam",25,14,4,11,0,0,0,0
Western Bulldogs,"Dahlhaus, Luke",15,8,2,7,0,0,0,5
Western Bulldogs,"Giansiracusa, Daniel",15,11,6,4,2,0,0,1
Western Bulldogs,"Goodes, Brett",17,13,7,4,0,0,0,4
Western Bulldogs,"Griffen, Ryan",32,12,2,20,1,0,0,7
Western Bulldogs,"Johannisen, Jason",16,8,4,8,0,0,0,3
Western Bulldogs,"Jones, Liam",10,7,4,3,0,1,3,4
Western Bulldogs,"Liberatore, Tom",26,13,1,13,1,0,0,4
Western Bulldogs,"Lower, Nick",20,11,7,9,0,1,0,3
Western Bulldogs,"Macrae, Jack",22,9,8,13,0,0,0,2
Western Bulldogs,"Markovic, Lukas",5,1,2,4,0,0,0,1
Western Bulldogs,"Minson, Will",13,5,2,8,0,0,35,3
Western Bulldogs,"Morris, Dale",16,7,8,9,0,0,0,2
Western Bulldogs,"Murphy, Robert",28,22,8,6,1,1,0,1
Western Bulldogs,"Picken, Liam",8,3,3,5,0,0,0,1
Western Bulldogs,"Roughead, Jordan",14,10,11,4,0,0,0,2
Western Bulldogs,"Smith, Clay",16,9,1,7,0,0,0,6
Western Bulldogs,"Stevens, Koby",16,10,7,6,1,1,0,2
Western Bulldogs,"Stringer, Jake",16,10,12,6,2,2,0,1
Western Bulldogs,"Talia, Michael",30,15,9,15,0,0,0,1
Western Bulldogs,"Boyd, Matthew",34,17,10,17,1,0,0,9
Western Bulldogs,"Cooney, Adam",23,14,3,9,1,0,0,4
Western Bulldogs,"Dahlhaus, Luke",10,6,2,4,0,2,0,4
Western Bulldogs,"Giansiracusa, Daniel",4,3,2,1,1,0,0,1
Western Bulldogs,"Goodes, Brett",14,9,4,5,0,0,0,2
Western Bulldogs,"Griffen, Ryan",38,21,7,17,0,1,0,4
Western Bulldogs,"Hrovat, Nathan",6,2,1,4,0,0,0,0
Western Bulldogs,"Hunter, Lachie",19,11,5,8,1,2,0,3
Western Bulldogs,"Johannisen, Jason",19,15,5,4,0,2,0,1
Western Bulldogs,"Jones, Liam",8,6,7,2,1,1,0,0
Western Bulldogs,"Liberatore, Tom",19,8,2,11,0,0,0,5
Western Bulldogs,"Lower, Nick",5,2,1,3,0,0,0,2
Western Bulldogs,"Macrae, Jack",27,8,3,19,0,1,0,1
Western Bulldogs,"Markovic, Lukas",9,2,3,7,0,0,2,3
Western Bulldogs,"Minson, Will",10,4,2,6,0,0,39,5
Western Bulldogs,"Morris, Dale",11,4,3,7,0,0,0,1
Western Bulldogs,"Murphy, Robert",23,16,5,7,1,0,0,1
Western Bulldogs,"Picken, Liam",6,2,0,4,0,1,0,6
Western Bulldogs,"Roughead, Jordan",13,10,11,3,0,0,0,2
Western Bulldogs,"Smith, Clay",19,15,5,4,0,1,0,5
Western Bulldogs,"Stringer, Jake",9,6,4,3,2,1,0,1
Western Bulldogs,"Talia, Michael",18,11,6,7,0,0,0,1
Western Bulldogs,"Boyd, Matthew",27,16,4,11,0,0,1,3
Western Bulldogs,"Cooney, Adam",18,8,2,10,3,1,0,4
Western Bulldogs,"Cordy, Ayce",7,3,3,4,2,0,2,0
Western Bulldogs,"Dahlhaus, Luke",14,4,0,10,1,1,0,5
Western Bulldogs,"Dickson, Tory",11,7,3,4,1,1,0,3
Western Bulldogs,"Giansiracusa, Daniel",19,13,6,6,3,1,0,3
Western Bulldogs,"Griffen, Ryan",31,18,4,13,3,1,0,7
Western Bulldogs,"Hrovat, Nathan",19,11,4,8,0,1,0,2
Western Bulldogs,"Hunter, Lachie",4,3,0,1,0,0,0,2
Western Bulldogs,"Johannisen, Jason",12,10,0,2,0,0,0,2
Western Bulldogs,"Jones, Liam",7,4,4,3,0,0,0,1
Western Bulldogs,"Liberatore, Tom",36,23,6,13,0,1,0,9
Western Bulldogs,"Lower, Nick",13,6,2,7,0,0,0,6
Western Bulldogs,"Macrae, Jack",22,8,4,14,1,0,0,2
Western Bulldogs,"Minson, Will",14,10,3,4,1,0,51,2
Western Bulldogs,"Morris, Dale",6,1,0,5,0,0,0,5
Western Bulldogs,"Murphy, Robert",20,15,5,5,0,0,0,7
Western Bulldogs,"Roughead, Jordan",5,2,3,3,0,0,0,1
Western Bulldogs,"Smith, Clay",12,7,0,5,0,0,0,4
Western Bulldogs,"Stringer, Jake",11,2,1,9,0,1,0,1
Western Bulldogs,"Talia, Michael",14,6,3,8,0,0,0,4
Western Bulldogs,"Wallis, Mitch",18,8,1,10,0,0,0,3
Western Bulldogs,"Cooney, Adam",26,12,1,14,0,1,0,1
Western Bulldogs,"Cordy, Ayce",5,0,0,5,0,0,1,2
Western Bulldogs,"Dahlhaus, Luke",22,8,3,14,1,1,0,5
Western Bulldogs,"Dickson, Tory",13,6,4,7,1,1,0,4
Western Bulldogs,"Giansiracusa, Daniel",13,8,5,5,3,0,0,2
Western Bulldogs,"Goodes, Brett",25,15,10,10,0,0,0,2
Western Bulldogs,"Griffen, Ryan",22,15,0,7,0,1,0,7
Western Bulldogs,"Hrovat, Nathan",17,10,3,7,0,0,0,1
Western Bulldogs,"Johannisen, Jason",9,6,0,3,0,0,0,0
Western Bulldogs,"Jones, Liam",6,5,3,1,2,1,0,0
Western Bulldogs,"Liberatore, Tom",19,11,2,8,0,0,0,1
Western Bulldogs,"Macrae, Jack",22,9,3,13,0,0,0,4
Western Bulldogs,"Minson, Will",14,6,0,8,0,0,45,3
Western Bulldogs,"Morris, Dale",12,4,5,8,0,0,0,1
Western Bulldogs,"Murphy, Robert",23,15,1,8,0,0,0,1
Western Bulldogs,"Roughead, Jordan",13,5,7,8,0,0,0,6
Western Bulldogs,"Smith, Clay",16,7,2,9,2,0,0,11
Western Bulldogs,"Stevens, Koby",18,9,1,9,0,0,0,3
Western Bulldogs,"Stringer, Jake",9,4,1,5,1,1,0,5
Western Bulldogs,"Talia, Michael",32,14,5,18,0,0,0,2
Western Bulldogs,"Tutt, Jason",18,11,1,7,2,0,0,1
Western Bulldogs,"Wallis, Mitch",15,6,3,9,1,0,0,4
Western Bulldogs,"Addison, Dylan",12,4,4,8,0,1,0,1
Western Bulldogs,"Cooney, Adam",29,17,5,12,0,0,0,5
Western Bulldogs,"Dahlhaus, Luke",16,8,4,8,3,1,0,4
Western Bulldogs,"Dickson, Tory",15,6,2,9,0,1,0,3
Western Bulldogs,"Giansiracusa, Daniel",24,13,7,11,2,0,0,0
Western Bulldogs,"Goodes, Brett",27,20,4,7,1,0,0,2
Western Bulldogs,"Grant, Jarrad",19,11,5,8,1,0,0,1
Western Bulldogs,"Griffen, Ryan",28,12,2,16,0,0,0,6
Western Bulldogs,"Hrovat, Nathan",25,14,8,11,0,1,0,4
Western Bulldogs,"Hunter, Lachie",11,8,3,3,0,0,0,2
Western Bulldogs,"Jones, Liam",7,6,6,1,2,0,2,2
Western Bulldogs,"Liberatore, Tom",33,15,4,18,1,0,0,6
Western Bulldogs,"Minson, Will",19,8,3,11,1,0,29,4
Western Bulldogs,"Morris, Dale",15,6,6,9,0,0,0,2
Western Bulldogs,"Murphy, Robert",26,19,5,7,0,0,0,1
Western Bulldogs,"Picken, Liam",15,6,0,9,0,0,0,1
Western Bulldogs,"Roughead, Jordan",5,1,2,4,0,0,1,1
Western Bulldogs,"Smith, Clay",18,5,2,13,1,0,0,5
Western Bulldogs,"Stevens, Koby",29,12,3,17,1,1,0,4
Western Bulldogs,"Talia, Michael",17,7,3,10,0,0,0,1
Western Bulldogs,"Tutt, Jason",15,14,3,1,1,1,0,0
Western Bulldogs,"Wallis, Mitch",10,2,1,8,0,0,0,5
Western Bulldogs,"Addison, Dylan",8,4,3,4,1,1,0,3
Western Bulldogs,"Cooney, Adam",33,17,6,16,0,1,0,6
Western Bulldogs,"Dahlhaus, Luke",13,4,1,9,2,0,0,2
Western Bulldogs,"Dickson, Tory",14,8,5,6,2,0,0,3
Western Bulldogs,"Giansiracusa, Daniel",28,14,8,14,2,0,0,3
Western Bulldogs,"Goodes, Brett",17,10,2,7,0,0,0,4
Western Bulldogs,"Grant, Jarrad",16,10,8,6,1,4,0,5
Western Bulldogs,"Griffen, Ryan",37,17,3,20,2,0,1,2
Western Bulldogs,"Hrovat, Nathan",12,7,3,5,0,1,0,0
Western Bulldogs,"Hunter, Lachie",3,2,0,1,0,0,0,0
Western Bulldogs,"Jones, Liam",9,8,5,1,1,2,1,1
Western Bulldogs,"Liberatore, Tom",28,13,4,15,0,0,0,5
Western Bulldogs,"Macrae, Jack",23,6,4,17,0,0,0,5
Western Bulldogs,"Minson, Will",11,2,3,9,0,0,32,4
Western Bulldogs,"Morris, Dale",10,6,5,4,0,0,0,1
Western Bulldogs,"Murphy, Robert",20,15,1,5,0,0,0,2
Western Bulldogs,"Picken, Liam",12,7,1,5,0,0,0,4
Western Bulldogs,"Roughead, Jordan",8,4,1,4,0,0,0,5
Western Bulldogs,"Stevens, Koby",19,8,4,11,0,1,0,8
Western Bulldogs,"Talia, Michael",12,7,2,5,0,0,1,1
Western Bulldogs,"Tutt, Jason",14,8,2,6,0,0,0,0
Western Bulldogs,"Wallis, Mitch",15,3,1,12,0,0,0,2
Western Bulldogs,"Addison, Dylan",11,8,6,3,2,1,0,0
Western Bulldogs,"Boyd, Matthew",26,14,8,12,1,2,1,3
Western Bulldogs,"Cooney, Adam",30,14,4,16,1,2,0,2
Western Bulldogs,"Dahlhaus, Luke",29,15,3,14,4,0,0,6
Western Bulldogs,"Dickson, Tory",18,10,5,8,3,2,0,3
Western Bulldogs,"Giansiracusa, Daniel",13,8,5,5,1,1,0,1
Western Bulldogs,"Grant, Jarrad",16,8,6,8,3,0,0,0
Western Bulldogs,"Griffen, Ryan",30,12,5,18,0,0,0,6
Western Bulldogs,"Hunter, Lachie",18,10,5,8,0,1,0,2
Western Bulldogs,"Jones, Liam",10,10,3,0,0,0,0,0
Western Bulldogs,"Liberatore, Tom",29,17,7,12,0,0,0,12
Western Bulldogs,"Macrae, Jack",3,2,1,1,0,0,0,0
Western Bulldogs,"Minson, Will",24,8,4,16,0,1,27,4
Western Bulldogs,"Morris, Dale",13,7,1,6,0,0,0,1
Western Bulldogs,"Murphy, Robert",29,16,2,13,1,1,0,2
Western Bulldogs,"Picken, Liam",20,9,1,11,0,0,0,3
Western Bulldogs,"Roughead, Jordan",12,6,5,6,0,0,1,3
Western Bulldogs,"Stevens, Koby",28,13,6,15,0,1,0,3
Western Bulldogs,"Talia, Michael",9,7,4,2,0,0,0,0
Western Bulldogs,"Tutt, Jason",18,11,2,7,0,0,0,1
Western Bulldogs,"Wallis, Mitch",25,8,1,17,0,0,0,7
Western Bulldogs,"Young, Tom",19,12,4,7,0,1,0,4
Western Bulldogs,"Addison, Dylan",12,5,5,7,1,0,0,4
Western Bulldogs,"Campbell, Tom",7,2,2,5,2,0,11,2
Western Bulldogs,"Cooney, Adam",30,13,3,17,0,0,0,2
Western Bulldogs,"Cross, Daniel",32,6,4,26,0,0,1,5
Western Bulldogs,"Dahlhaus, Luke",20,8,2,12,1,0,0,4
Western Bulldogs,"Dickson, Tory",14,8,3,6,2,0,0,1
Western Bulldogs,"Giansiracusa, Daniel",8,7,5,1,2,1,0,1
Western Bulldogs,"Grant, Jarrad",20,12,4,8,3,0,1,3
Western Bulldogs,"Griffen, Ryan",41,15,3,26,0,1,0,6
Western Bulldogs,"Hunter, Lachie",14,6,1,8,1,1,0,4
Western Bulldogs,"Liberatore, Tom",33,18,3,15,0,0,0,9
Western Bulldogs,"Macrae, Jack",7,3,0,4,0,0,0,6
Western Bulldogs,"Minson, Will",14,6,2,8,0,0,35,6
Western Bulldogs,"Morris, Dale",11,5,0,6,0,0,0,2
Western Bulldogs,"Murphy, Robert",23,21,3,2,0,0,0,5
Western Bulldogs,"Picken, Liam",24,17,5,7,0,0,0,6
Western Bulldogs,"Roughead, Jordan",7,1,4,6,0,0,0,4
Western Bulldogs,"Stevens, Koby",18,8,3,10,2,2,0,5
Western Bulldogs,"Talia, Michael",21,12,6,9,0,0,0,0
Western Bulldogs,"Tutt, Jason",13,8,4,5,0,1,0,2
Western Bulldogs,"Wallis, Mitch",29,8,1,21,0,0,0,13
Western Bulldogs,"Young, Tom",8,7,1,1,1,0,0,6
Western Bulldogs,"Addison, Dylan",7,5,3,2,0,3,0,2
Western Bulldogs,"Austin, Mark",18,15,6,3,0,0,0,0
Western Bulldogs,"Campbell, Tom",9,2,1,7,1,0,5,3
Western Bulldogs,"Cooney, Adam",31,14,3,17,1,2,0,0
Western Bulldogs,"Cross, Daniel",22,12,6,10,0,2,0,3
Western Bulldogs,"Dahlhaus, Luke",24,9,1,15,2,1,0,11
Western Bulldogs,"Dickson, Tory",16,9,4,7,1,2,0,2
Western Bulldogs,"Giansiracusa, Daniel",16,14,5,2,2,2,0,3
Western Bulldogs,"Grant, Jarrad",24,14,7,10,4,3,1,3
Western Bulldogs,"Griffen, Ryan",34,16,3,18,0,1,0,7
Western Bulldogs,"Jones, Liam",10,4,4,6,2,0,0,4
Western Bulldogs,"Liberatore, Tom",28,14,4,14,0,0,0,4
Western Bulldogs,"Minson, Will",18,9,1,9,0,1,29,8
Western Bulldogs,"Morris, Dale",14,7,4,7,0,0,0,6
Western Bulldogs,"Murphy, Robert",27,14,4,13,0,0,0,0
Western Bulldogs,"Picken, Liam",27,12,3,15,1,0,0,2
Western Bulldogs,"Roughead, Jordan",15,5,5,10,0,0,0,5
Western Bulldogs,"Stevens, Koby",18,9,2,9,0,0,0,4
Western Bulldogs,"Tutt, Jason",8,6,1,2,1,2,0,1
Western Bulldogs,"Wallis, Mitch",18,6,1,12,0,0,0,7
Western Bulldogs,"Wood, Easton",17,8,5,9,0,1,0,3
Western Bulldogs,"Young, Tom",21,15,3,6,1,0,0,1
Western Bulldogs,"Addison, Dylan",10,5,3,5,0,1,0,2
Western Bulldogs,"Austin, Mark",17,5,4,12,0,0,0,0
Western Bulldogs,"Boyd, Matthew",27,7,2,20,0,0,0,4
Western Bulldogs,"Campbell, Tom",12,6,5,6,4,1,4,3
Western Bulldogs,"Cooney, Adam",23,12,9,11,2,1,0,1
Western Bulldogs,"Cross, Daniel",25,10,8,15,1,0,0,4
Western Bulldogs,"Dahlhaus, Luke",18,13,0,5,1,1,0,5
Western Bulldogs,"Dickson, Tory",17,12,5,5,6,0,0,4
Western Bulldogs,"Giansiracusa, Daniel",13,11,5,2,2,2,0,2
Western Bulldogs,"Grant, Jarrad",12,5,4,7,0,0,0,4
Western Bulldogs,"Griffen, Ryan",26,12,5,14,0,1,0,3
Western Bulldogs,"Hunter, Lachie",11,3,1,8,0,0,0,1
Western Bulldogs,"Liberatore, Tom",30,12,3,18,0,0,0,5
Western Bulldogs,"Minson, Will",12,8,2,4,1,1,37,2
Western Bulldogs,"Morris, Dale",11,4,5,7,0,0,0,4
Western Bulldogs,"Murphy, Robert",27,19,6,8,0,0,0,1
Western Bulldogs,"Picken, Liam",21,13,5,8,0,1,0,4
Western Bulldogs,"Roughead, Jordan",11,2,3,9,0,0,0,2
Western Bulldogs,"Stevens, Koby",20,9,2,11,1,0,0,5
Western Bulldogs,"Wallis, Mitch",19,7,2,12,1,0,0,7
Western Bulldogs,"Wood, Easton",14,10,6,4,1,1,0,0
Western Bulldogs,"Young, Tom",12,5,3,7,0,0,0,1
Western Bulldogs,"Addison, Dylan",11,3,2,8,2,0,0,1
Western Bulldogs,"Austin, Mark",5,2,2,3,0,0,0,1
Western Bulldogs,"Boyd, Matthew",27,14,4,13,0,0,0,4
Western Bulldogs,"Campbell, Tom",7,5,2,2,1,3,5,0
Western Bulldogs,"Cross, Daniel",17,5,3,12,0,0,0,5
Western Bulldogs,"Dahlhaus, Luke",20,9,2,11,3,2,0,3
Western Bulldogs,"Dickson, Tory",14,8,2,6,1,1,0,1
Western Bulldogs,"Giansiracusa, Daniel",19,9,2,10,2,3,0,3
Western Bulldogs,"Grant, Jarrad",14,11,7,3,0,1,0,0
Western Bulldogs,"Griffen, Ryan",23,9,0,14,1,0,0,4
Western Bulldogs,"Hunter, Lachie",17,8,3,9,0,0,0,1
Western Bulldogs,"Liberatore, Tom",27,13,0,14,0,0,0,6
Western Bulldogs,"Minson, Will",15,10,1,5,1,0,36,4
Western Bulldogs,"Morris, Dale",8,4,4,4,0,0,0,2
Western Bulldogs,"Murphy, Robert",13,12,2,1,1,1,0,1
Western Bulldogs,"Picken, Liam",15,10,3,5,0,0,0,8
Western Bulldogs,"Roughead, Jordan",13,5,5,8,0,1,6,3
Western Bulldogs,"Stevens, Koby",13,6,3,7,0,0,0,1
Western Bulldogs,"Tutt, Jason",4,4,0,0,0,1,0,0
Western Bulldogs,"Wallis, Mitch",14,7,0,7,1,0,0,3
Western Bulldogs,"Wood, Easton",11,5,0,6,0,0,0,0
Western Bulldogs,"Young, Tom",17,14,3,3,0,0,0,3
Western Bulldogs,"Austin, Mark",4,3,1,1,0,0,0,3
Western Bulldogs,"Boyd, Matthew",40,23,8,17,0,0,1,1
Western Bulldogs,"Campbell, Tom",7,6,3,1,1,3,2,1
Western Bulldogs,"Cooney, Adam",30,14,10,16,2,0,0,3
Western Bulldogs,"Cross, Daniel",27,11,8,16,1,0,1,7
Western Bulldogs,"Dahlhaus, Luke",20,8,5,12,0,2,0,3
Western Bulldogs,"Dickson, Tory",14,10,5,4,3,1,0,3
Western Bulldogs,"Giansiracusa, Daniel",14,9,3,5,2,1,0,3
Western Bulldogs,"Grant, Jarrad",12,6,5,6,1,0,0,2
Western Bulldogs,"Griffen, Ryan",16,8,1,8,0,1,0,3
Western Bulldogs,"Hunter, Lachie",22,15,7,7,2,0,0,1
Western Bulldogs,"Jones, Liam",7,6,3,1,1,1,0,0
Western Bulldogs,"Liberatore, Tom",36,15,3,21,1,0,0,11
Western Bulldogs,"Minson, Will",22,4,1,18,1,0,48,3
Western Bulldogs,"Morris, Dale",9,4,3,5,0,0,0,0
Western Bulldogs,"Murphy, Robert",29,23,9,6,0,0,0,0
Western Bulldogs,"Picken, Liam",25,15,7,10,0,0,0,2
Western Bulldogs,"Roughead, Jordan",16,11,9,5,0,0,0,2
Western Bulldogs,"Stevens, Koby",8,1,0,7,0,0,0,0
Western Bulldogs,"Wallis, Mitch",19,8,2,11,1,0,0,5
Western Bulldogs,"Wood, Easton",12,4,2,8,0,0,0,2
Western Bulldogs,"Young, Tom",15,6,4,9,0,1,0,2
Adelaide,"Callinan, Ian",18,14,5,4,2,5,0,5
Adelaide,"Dangerfield, Patrick",25,13,3,12,2,0,0,2
Adelaide,"Doughty, Michael",17,5,4,12,0,0,0,3
Adelaide,"Douglas, Richard",19,14,6,5,1,3,0,7
Adelaide,"Henderson, Ricky",8,5,1,3,0,0,0,1
Adelaide,"Jacobs, Sam",18,9,5,9,0,0,28,3
Adelaide,"Johncock, Graham",18,16,7,2,0,0,0,2
Adelaide,"Lynch, Tom",7,7,2,0,1,2,0,1
Adelaide,"Mackay, David",21,9,3,12,0,0,1,5
Adelaide,"Otten, Andy",17,10,7,7,0,0,0,4
Adelaide,"Petrenko, Jared",13,6,4,7,0,1,0,4
Adelaide,"Porplyzia, Jason",17,8,2,9,1,0,0,1
Adelaide,"Reilly, Brent",23,14,6,9,0,0,0,4
Adelaide,"Rutten, Ben",10,6,7,4,0,0,0,1
Adelaide,"Sloane, Rory",24,18,6,6,1,1,0,9
Adelaide,"Smith, Brodie",19,11,5,8,0,0,0,5
Adelaide,"Talia, Daniel",15,6,5,9,0,0,0,2
Adelaide,"Thompson, Scott",39,25,6,14,0,1,0,3
Adelaide,"Tippett, Kurt",19,13,7,6,4,3,13,1
Adelaide,"Vince, Bernie",22,18,3,4,0,1,0,3
Adelaide,"Walker, Taylor",15,10,8,5,5,2,0,2
Adelaide,"van Berlo, Nathan",22,15,7,7,2,0,0,5
Adelaide,"Callinan, Ian",7,3,1,4,1,1,0,0
Adelaide,"Dangerfield, Patrick",18,9,7,9,1,0,0,1
Adelaide,"Doughty, Michael",24,14,7,10,0,0,0,1
Adelaide,"Douglas, Richard",3,1,0,2,0,0,0,0
Adelaide,"Henderson, Ricky",13,4,2,9,0,0,0,2
Adelaide,"Jacobs, Sam",11,7,3,4,0,0,30,2
Adelaide,"Johncock, Graham",14,8,1,6,0,2,0,2
Adelaide,"Lynch, Tom",17,15,11,2,2,1,0,2
Adelaide,"Mackay, David",17,12,4,5,0,0,0,8
Adelaide,"Otten, Andy",4,1,1,3,0,0,0,1
Adelaide,"Petrenko, Jared",10,8,2,2,2,0,0,3
Adelaide,"Porplyzia, Jason",20,13,6,7,1,1,0,1
Adelaide,"Reilly, Brent",25,15,8,10,0,0,0,2
Adelaide,"Rutten, Ben",11,5,6,6,0,0,1,0
Adelaide,"Sloane, Rory",21,10,5,11,1,0,0,8
Adelaide,"Smith, Brodie",21,13,3,8,0,0,1,2
Adelaide,"Talia, Daniel",10,8,4,2,0,0,0,2
Adelaide,"Thompson, Scott",34,18,5,16,0,0,0,4
Adelaide,"Tippett, Kurt",15,9,8,6,0,2,9,0
Adelaide,"Vince, Bernie",26,20,6,6,0,2,0,1
Adelaide,"Walker, Taylor",16,13,6,3,3,4,0,2
Adelaide,"van Berlo, Nathan",23,9,6,14,0,1,0,9
Adelaide,"Callinan, Ian",21,12,0,9,3,0,0,1
Adelaide,"Dangerfield, Patrick",27,13,3,14,0,0,0,5
Adelaide,"Doughty, Michael",12,4,1,8,1,0,0,3
Adelaide,"Jacobs, Sam",19,10,5,9,0,0,25,1
Adelaide,"Johncock, Graham",15,12,3,3,0,0,0,2
Adelaide,"Kerridge, Sam",3,0,0,3,0,0,0,0
Adelaide,"Lynch, Tom",6,6,2,0,2,0,0,2
Adelaide,"Mackay, David",20,7,3,13,0,0,0,6
Adelaide,"Martin, Brodie",12,6,2,6,0,0,0,1
Adelaide,"Otten, Andy",7,5,2,2,0,0,0,1
Adelaide,"Petrenko, Jared",9,8,4,1,0,0,0,6
Adelaide,"Porplyzia, Jason",11,7,1,4,1,0,0,4
Adelaide,"Reilly, Brent",13,9,3,4,1,0,0,3
Adelaide,"Rutten, Ben",7,5,1,2,0,1,0,1
Adelaide,"Sloane, Rory",15,8,2,7,0,0,0,3
Adelaide,"Smith, Brodie",15,9,2,6,0,0,0,1
Adelaide,"Talia, Daniel",11,5,1,6,0,0,0,3
Adelaide,"Thompson, Scott",25,7,1,18,0,0,0,2
Adelaide,"Tippett, Kurt",17,10,8,7,3,3,9,2
Adelaide,"Vince, Bernie",11,8,2,3,1,2,0,1
Adelaide,"Walker, Taylor",4,3,3,1,0,2,0,0
Adelaide,"van Berlo, Nathan",24,16,3,8,0,1,0,3
Adelaide,"Dangerfield, Patrick",24,10,1,14,0,0,1,1
Adelaide,"Doughty, Michael",19,11,3,8,0,0,0,5
Adelaide,"Henderson, Ricky",13,8,3,5,1,0,0,0
Adelaide,"Jacobs, Sam",12,7,3,5,0,1,29,2
Adelaide,"Jaensch, Matthew",13,8,2,5,0,0,0,3
Adelaide,"Mackay, David",10,7,4,3,1,1,0,5
Adelaide,"Martin, Brodie",20,12,2,8,0,1,0,3
Adelaide,"McKernan, Shaun",12,3,0,9,0,0,12,2
Adelaide,"Petrenko, Jared",0,0,0,0,0,0,0,0
Adelaide,"Porplyzia, Jason",14,9,2,5,2,0,0,5
Adelaide,"Reilly, Brent",27,18,4,9,0,0,0,4
Adelaide,"Rutten, Ben",7,5,0,2,0,0,0,2
Adelaide,"Shaw, Sam",13,12,3,1,0,0,0,3
Adelaide,"Sloane, Rory",24,13,0,11,1,0,1,8
Adelaide,"Smith, Brodie",21,15,1,6,1,1,1,6
Adelaide,"Talia, Daniel",7,3,1,4,0,1,0,5
Adelaide,"Thompson, Scott",27,16,2,11,1,0,0,6
Adelaide,"Tippett, Kurt",17,11,5,6,4,1,3,1
Adelaide,"Vince, Bernie",22,16,1,6,0,3,0,1
Adelaide,"Walker, Taylor",18,11,3,7,1,5,0,2
Adelaide,"Wright, Matthew",23,10,0,13,1,1,0,3
Adelaide,"van Berlo, Nathan",27,20,1,7,0,1,0,9
Adelaide,"Callinan, Ian",11,7,3,4,1,0,0,2
Adelaide,"Dangerfield, Patrick",39,28,8,11,0,0,0,3
Adelaide,"Doughty, Michael",14,6,2,8,0,0,0,2
Adelaide,"Henderson, Ricky",8,6,4,2,0,0,0,1
Adelaide,"Jacobs, Sam",17,11,8,6,1,1,24,2
Adelaide,"Jaensch, Matthew",16,9,3,7,0,0,0,1
Adelaide,"Johncock, Graham",17,13,7,4,2,1,0,5
Adelaide,"Lyons, Jarryd",14,5,2,9,0,1,0,3
Adelaide,"Mackay, David",11,6,3,5,0,1,0,7
Adelaide,"McKernan, Shaun",14,8,2,6,1,0,19,1
Adelaide,"Otten, Andy",15,9,6,6,0,0,0,2
Adelaide,"Petrenko, Jared",16,11,4,5,2,0,0,8
Adelaide,"Reilly, Brent",14,10,4,4,0,0,0,3
Adelaide,"Rutten, Ben",17,8,5,9,0,0,0,0
Adelaide,"Sloane, Rory",27,11,6,16,0,0,0,5
Adelaide,"Smith, Brodie",9,4,1,5,0,0,1,1
Adelaide,"Talia, Daniel",7,5,2,2,0,0,0,1
Adelaide,"Thompson, Scott",34,26,8,8,1,1,0,6
Adelaide,"Tippett, Kurt",12,11,4,1,1,4,1,1
Adelaide,"Walker, Taylor",17,13,9,4,6,1,0,2
Adelaide,"Wright, Matthew",20,8,4,12,1,0,0,6
Adelaide,"van Berlo, Nathan",10,6,0,4,0,1,0,3
Adelaide,"Callinan, Ian",20,11,2,9,3,0,0,4
Adelaide,"Dangerfield, Patrick",30,23,8,7,0,0,0,2
Adelaide,"Doughty, Michael",13,6,2,7,0,0,0,2
Adelaide,"Henderson, Ricky",23,15,8,8,0,0,0,1
Adelaide,"Jacobs, Sam",9,4,2,5,0,0,44,3
Adelaide,"Jaensch, Matthew",17,12,3,5,2,1,0,2
Adelaide,"Johncock, Graham",12,9,2,3,0,1,0,1
Adelaide,"Lyons, Jarryd",3,1,0,2,0,0,0,1
Adelaide,"Mackay, David",20,7,4,13,0,0,0,5
Adelaide,"McKernan, Shaun",7,5,1,2,1,1,19,0
Adelaide,"Petrenko, Jared",15,12,5,3,3,0,0,1
Adelaide,"Porplyzia, Jason",18,15,7,3,0,2,0,5
Adelaide,"Reilly, Brent",25,17,7,8,0,0,0,1
Adelaide,"Rutten, Ben",7,4,4,3,0,0,0,3
Adelaide,"Sloane, Rory",29,14,6,15,0,1,1,1
Adelaide,"Smith, Brodie",20,12,2,8,0,0,1,2
Adelaide,"Talia, Daniel",8,5,1,3,0,0,0,0
Adelaide,"Thompson, Scott",31,15,4,16,0,0,0,10
Adelaide,"Tippett, Kurt",5,1,1,4,1,0,5,3
Adelaide,"Walker, Taylor",12,8,7,4,5,0,0,1
Adelaide,"Wright, Matthew",18,7,2,11,0,0,0,6
Adelaide,"van Berlo, Nathan",20,15,0,5,0,0,0,9
Adelaide,"Callinan, Ian",16,9,1,7,0,0,0,3
Adelaide,"Dangerfield, Patrick",20,14,3,6,0,0,1,5
Adelaide,"Doughty, Michael",22,11,8,11,1,0,0,3
Adelaide,"Henderson, Ricky",9,5,1,4,0,0,0,1
Adelaide,"Jacobs, Sam",15,7,4,8,0,1,27,1
Adelaide,"Jaensch, Matthew",21,14,7,7,1,0,0,3
Adelaide,"Jenkins, Josh",7,5,4,2,1,0,8,2
Adelaide,"Johncock, Graham",15,12,4,3,2,2,0,3
Adelaide,"Lyons, Jarryd",9,4,3,5,1,0,0,2
Adelaide,"Mackay, David",17,8,2,9,1,0,1,3
Adelaide,"Petrenko, Jared",15,9,5,6,2,1,0,3
Adelaide,"Porplyzia, Jason",18,12,2,6,1,0,0,4
Adelaide,"Reilly, Brent",25,15,9,10,0,0,0,1
Adelaide,"Rutten, Ben",11,6,4,5,0,0,0,1
Adelaide,"Sloane, Rory",26,16,6,10,0,1,0,2
Adelaide,"Smith, Brodie",16,8,3,8,0,0,0,2
Adelaide,"Talia, Daniel",4,2,1,2,0,0,0,3
Adelaide,"Thompson, Scott",34,21,6,13,1,0,0,7
Adelaide,"Tippett, Kurt",16,11,6,5,2,1,11,2
Adelaide,"Walker, Taylor",16,11,7,5,3,1,0,4
Adelaide,"Wright, Matthew",14,7,3,7,1,0,0,4
Adelaide,"van Berlo, Nathan",19,17,4,2,2,0,0,6
Adelaide,"Callinan, Ian",11,8,4,3,3,0,0,3
Adelaide,"Dangerfield, Patrick",35,23,4,12,2,1,0,6
Adelaide,"Doughty, Michael",16,12,6,4,0,1,0,1
Adelaide,"Henderson, Ricky",13,8,7,5,0,0,0,2
Adelaide,"Jacobs, Sam",6,6,2,0,0,0,38,3
Adelaide,"Jaensch, Matthew",15,12,8,3,0,0,0,2
Adelaide,"Jenkins, Josh",13,10,8,3,2,0,4,4
Adelaide,"Johncock, Graham",12,9,4,3,0,2,0,4
Adelaide,"Lynch, Tom",6,4,3,2,0,0,1,1
Adelaide,"Mackay, David",12,6,1,6,2,0,0,4
Adelaide,"Petrenko, Jared",7,5,3,2,1,0,0,3
Adelaide,"Porplyzia, Jason",20,10,3,10,1,0,1,2
Adelaide,"Reilly, Brent",19,15,7,4,0,0,0,1
Adelaide,"Rutten, Ben",14,9,6,5,0,0,0,1
Adelaide,"Sloane, Rory",24,13,7,11,0,1,0,6
Adelaide,"Smith, Brodie",11,6,3,5,0,0,0,3
Adelaide,"Talia, Daniel",6,2,1,4,0,0,0,3
Adelaide,"Thompson, Scott",31,22,8,9,1,0,1,3
Adelaide,"Tippett, Kurt",14,11,6,3,3,4,9,1
Adelaide,"Vince, Bernie",20,17,8,3,3,0,0,0
Adelaide,"Wright, Matthew",17,7,2,10,0,0,0,5
Adelaide,"van Berlo, Nathan",23,15,9,8,1,0,0,9
Adelaide,"Callinan, Ian",17,11,2,6,0,2,0,1
Adelaide,"Dangerfield, Patrick",18,9,1,9,0,0,2,4
Adelaide,"Doughty, Michael",14,10,3,4,0,0,0,6
Adelaide,"Douglas, Richard",5,3,0,2,0,0,0,1
Adelaide,"Henderson, Ricky",9,8,3,1,1,0,0,1
Adelaide,"Jacobs, Sam",11,4,0,7,0,0,24,0
Adelaide,"Jaensch, Matthew",28,19,6,9,0,1,0,2
Adelaide,"Jenkins, Josh",13,6,3,7,0,0,6,2
Adelaide,"Johncock, Graham",8,6,2,2,0,0,0,3
Adelaide,"Mackay, David",19,14,7,5,0,1,2,5
Adelaide,"Petrenko, Jared",9,5,2,4,1,0,0,4
Adelaide,"Porplyzia, Jason",15,12,4,3,0,1,1,3
Adelaide,"Reilly, Brent",22,18,6,4,0,1,0,5
Adelaide,"Rutten, Ben",7,4,4,3,0,0,0,0
Adelaide,"Sloane, Rory",16,7,3,9,0,0,1,7
Adelaide,"Smith, Brodie",18,12,6,6,1,0,0,4
Adelaide,"Talia, Daniel",9,6,3,3,0,0,0,2
Adelaide,"Thompson, Scott",22,14,4,8,0,0,1,3
Adelaide,"Tippett, Kurt",16,11,7,5,2,4,8,3
Adelaide,"Vince, Bernie",17,10,2,7,0,0,0,3
Adelaide,"Wright, Matthew",15,5,0,10,1,2,0,5
Adelaide,"van Berlo, Nathan",16,11,1,5,0,0,1,13
Adelaide,"Callinan, Ian",14,7,2,7,2,0,0,1
Adelaide,"Dangerfield, Patrick",32,20,6,12,1,0,0,1
Adelaide,"Doughty, Michael",12,7,4,5,0,0,0,5
Adelaide,"Douglas, Richard",21,16,4,5,0,1,0,0
Adelaide,"Jacobs, Sam",15,11,7,4,0,0,16,0
Adelaide,"Jaensch, Matthew",7,6,3,1,0,0,0,4
Adelaide,"Jenkins, Josh",9,4,5,5,1,1,0,1
Adelaide,"Johncock, Graham",3,3,3,0,1,0,0,0
Adelaide,"Petrenko, Jared",19,10,2,9,1,1,1,5
Adelaide,"Porplyzia, Jason",18,10,3,8,1,1,0,4
Adelaide,"Reilly, Brent",14,9,5,5,0,0,0,2
Adelaide,"Rutten, Ben",13,5,4,8,0,0,0,1
Adelaide,"Shaw, Sam",16,14,8,2,0,0,0,2
Adelaide,"Sloane, Rory",33,19,5,14,3,0,0,7
Adelaide,"Smith, Brodie",9,6,2,3,0,0,0,1
Adelaide,"Talia, Daniel",7,3,0,4,0,0,0,1
Adelaide,"Thompson, Scott",18,7,2,11,0,1,0,4
Adelaide,"Tippett, Kurt",11,7,2,4,0,0,17,2
Adelaide,"Vince, Bernie",22,14,3,8,0,0,0,2
Adelaide,"Walker, Taylor",14,9,6,5,4,1,0,2
Adelaide,"Wright, Matthew",20,10,4,10,3,0,0,6
Adelaide,"van Berlo, Nathan",24,18,5,6,0,0,0,7
Adelaide,"Callinan, Ian",20,11,6,9,2,0,0,2
Adelaide,"Dangerfield, Patrick",28,15,2,13,0,0,0,1
Adelaide,"Doughty, Michael",14,6,2,8,0,0,0,1
Adelaide,"Douglas, Richard",19,13,3,6,0,0,0,5
Adelaide,"Jacobs, Sam",14,9,2,5,1,0,45,2
Adelaide,"Jaensch, Matthew",11,9,3,2,0,0,0,3
Adelaide,"Jenkins, Josh",8,4,1,4,0,0,4,2
Adelaide,"Knights, Chris",5,2,0,3,0,0,0,1
Adelaide,"Mackay, David",20,14,3,6,1,1,1,5
Adelaide,"Martin, Brodie",21,14,4,7,0,0,0,4
Adelaide,"Petrenko, Jared",20,7,4,13,0,0,0,7
Adelaide,"Porplyzia, Jason",19,16,7,3,3,0,0,0
Adelaide,"Reilly, Brent",19,10,5,9,0,0,0,4
Adelaide,"Rutten, Ben",8,5,2,3,0,0,0,0
Adelaide,"Shaw, Sam",14,10,7,4,0,0,0,2
Adelaide,"Sloane, Rory",24,15,5,9,0,0,1,6
Adelaide,"Talia, Daniel",7,4,2,3,0,0,0,0
Adelaide,"Thompson, Scott",39,23,8,16,1,0,0,3
Adelaide,"Tippett, Kurt",15,11,6,4,5,3,12,1
Adelaide,"Walker, Taylor",17,9,6,8,2,3,0,0
Adelaide,"Wright, Matthew",16,8,3,8,2,1,0,2
Adelaide,"van Berlo, Nathan",15,9,6,6,0,1,0,8
Adelaide,"Callinan, Ian",11,6,7,5,1,2,0,1
Adelaide,"Dangerfield, Patrick",25,15,6,10,1,0,1,3
Adelaide,"Doughty, Michael",10,6,5,4,0,0,0,0
Adelaide,"Douglas, Richard",17,13,7,4,1,1,0,4
Adelaide,"Jacobs, Sam",8,6,5,2,0,0,27,1
Adelaide,"Jaensch, Matthew",11,9,5,2,0,0,0,1
Adelaide,"Mackay, David",13,8,5,5,0,0,0,3
Adelaide,"Martin, Brodie",15,9,1,6,0,0,0,1
Adelaide,"McKernan, Shaun",8,7,3,1,1,2,8,0
Adelaide,"Petrenko, Jared",5,4,1,1,0,0,0,2
Adelaide,"Porplyzia, Jason",12,8,4,4,1,0,0,2
Adelaide,"Reilly, Brent",18,14,6,4,0,0,0,4
Adelaide,"Rutten, Ben",8,2,2,6,0,0,0,2
Adelaide,"Shaw, Sam",6,5,1,1,0,0,0,1
Adelaide,"Sloane, Rory",21,9,4,12,1,0,0,4
Adelaide,"Talia, Daniel",4,1,2,3,0,0,0,0
Adelaide,"Thompson, Scott",28,20,5,8,0,1,0,5
Adelaide,"Tippett, Kurt",6,6,3,0,1,1,0,0
Adelaide,"Vince, Bernie",14,11,6,3,2,0,0,1
Adelaide,"Walker, Taylor",19,15,10,4,3,1,0,2
Adelaide,"Wright, Matthew",16,12,5,4,1,1,0,0
Adelaide,"van Berlo, Nathan",11,6,3,5,0,0,0,5
Adelaide,"Callinan, Ian",5,4,1,1,1,0,0,0
Adelaide,"Dangerfield, Patrick",23,11,3,12,0,0,1,5
Adelaide,"Doughty, Michael",14,9,3,5,0,0,0,3
Adelaide,"Douglas, Richard",21,17,6,4,2,1,0,2
Adelaide,"Jacobs, Sam",14,8,5,6,0,0,32,2
Adelaide,"Knights, Chris",19,10,3,9,2,0,0,4
Adelaide,"Mackay, David",15,4,3,11,1,0,0,2
Adelaide,"Martin, Brodie",11,8,3,3,0,1,0,1
Adelaide,"Petrenko, Jared",4,2,2,2,0,1,0,5
Adelaide,"Porplyzia, Jason",23,13,6,10,2,0,0,2
Adelaide,"Reilly, Brent",15,9,2,6,0,0,0,1
Adelaide,"Rutten, Ben",14,8,8,6,0,0,0,1
Adelaide,"Shaw, Sam",9,8,0,1,0,0,1,2
Adelaide,"Sloane, Rory",20,12,3,8,1,0,0,2
Adelaide,"Smith, Brodie",14,6,3,8,0,0,0,2
Adelaide,"Talia, Daniel",8,3,4,5,0,0,0,1
Adelaide,"Thompson, Scott",32,16,6,16,0,0,1,10
Adelaide,"Tippett, Kurt",10,8,6,2,3,0,8,4
Adelaide,"Vince, Bernie",23,14,2,9,0,0,0,3
Adelaide,"Walker, Taylor",15,11,4,4,5,1,0,1
Adelaide,"Wright, Matthew",19,13,4,6,0,0,0,5
Adelaide,"van Berlo, Nathan",4,3,0,1,0,0,0,0
Adelaide,"Dangerfield, Patrick",22,14,4,8,1,1,0,3
Adelaide,"Doughty, Michael",9,6,4,3,0,0,0,6
Adelaide,"Douglas, Richard",19,12,4,7,1,0,0,4
Adelaide,"Henderson, Ricky",20,18,11,2,6,2,0,0
Adelaide,"Jacobs, Sam",19,9,3,10,0,1,61,2
Adelaide,"Knights, Chris",12,8,4,4,1,1,0,1
Adelaide,"Mackay, David",20,9,8,11,0,0,0,4
Adelaide,"Martin, Brodie",13,10,5,3,3,2,0,2
Adelaide,"McIntyre, Tim",6,6,2,0,2,1,0,5
Adelaide,"McKernan, Shaun",2,2,2,0,0,1,1,1
Adelaide,"Porplyzia, Jason",14,9,3,5,1,1,0,6
Adelaide,"Reilly, Brent",17,14,8,3,0,0,0,4
Adelaide,"Rutten, Ben",19,8,7,11,0,0,0,0
Adelaide,"Shaw, Sam",17,14,7,3,0,0,0,1
Adelaide,"Sloane, Rory",21,14,4,7,1,1,0,4
Adelaide,"Smith, Brodie",16,12,5,4,0,0,0,0
Adelaide,"Talia, Daniel",12,9,3,3,0,0,0,2
Adelaide,"Thompson, Scott",32,17,2,15,0,1,0,2
Adelaide,"Tippett, Kurt",2,2,1,0,1,0,1,0
Adelaide,"Vince, Bernie",24,21,7,3,0,0,1,3
Adelaide,"Wright, Matthew",20,14,4,6,0,0,0,8
Adelaide,"van Berlo, Nathan",26,16,7,10,0,1,0,2
Adelaide,"Brown, Luke",11,7,5,4,0,0,0,0
Adelaide,"Callinan, Ian",14,12,8,2,4,2,0,0
Adelaide,"Dangerfield, Patrick",22,10,3,12,0,2,0,3
Adelaide,"Douglas, Richard",14,11,5,3,2,1,0,2
Adelaide,"Henderson, Ricky",2,1,1,1,0,0,0,0
Adelaide,"Jacobs, Sam",20,14,9,6,2,0,21,1
Adelaide,"Jenkins, Josh",16,8,6,8,1,0,8,2
Adelaide,"Knights, Chris",17,12,6,5,0,1,0,1
Adelaide,"Lynch, Tom",10,9,7,1,2,1,0,1
Adelaide,"Mackay, David",23,13,5,10,1,0,0,1
Adelaide,"Martin, Brodie",8,7,4,1,0,1,0,0
Adelaide,"Porplyzia, Jason",21,12,5,9,4,1,0,2
Adelaide,"Reilly, Brent",25,14,6,11,0,0,0,2
Adelaide,"Rutten, Ben",10,7,7,3,1,0,0,2
Adelaide,"Shaw, Sam",16,13,8,3,0,1,0,3
Adelaide,"Sloane, Rory",16,8,5,8,3,0,0,1
Adelaide,"Smith, Brodie",14,10,3,4,1,1,0,0
Adelaide,"Talia, Daniel",13,8,5,5,0,1,0,3
Adelaide,"Thompson, Scott",28,16,5,12,2,1,1,4
Adelaide,"Vince, Bernie",29,19,6,10,3,0,0,3
Adelaide,"Wright, Matthew",32,16,9,16,0,1,0,4
Adelaide,"van Berlo, Nathan",17,10,5,7,1,0,0,5
Adelaide,"Callinan, Ian",7,3,3,4,0,0,0,0
Adelaide,"Dangerfield, Patrick",28,18,7,10,2,0,0,4
Adelaide,"Doughty, Michael",12,7,2,5,0,0,0,2
Adelaide,"Douglas, Richard",25,14,3,11,1,0,0,3
Adelaide,"Jacobs, Sam",17,9,5,8,1,0,16,1
Adelaide,"Jenkins, Josh",20,12,7,8,2,0,6,2
Adelaide,"Johncock, Graham",10,6,3,4,2,2,0,3
Adelaide,"Mackay, David",11,7,3,4,0,0,0,6
Adelaide,"Otten, Andy",19,10,6,9,0,0,0,1
Adelaide,"Petrenko, Jared",8,5,2,3,0,0,0,1
Adelaide,"Porplyzia, Jason",25,16,4,9,3,1,0,1
Adelaide,"Reilly, Brent",23,18,7,5,0,1,0,5
Adelaide,"Rutten, Ben",15,8,7,7,0,0,0,3
Adelaide,"Sloane, Rory",24,16,6,8,2,0,0,4
Adelaide,"Smith, Brodie",21,13,5,8,0,0,0,0
Adelaide,"Symes, Brad",6,1,2,5,0,0,0,0
Adelaide,"Talia, Daniel",9,4,4,5,0,0,0,2
Adelaide,"Thompson, Scott",28,15,6,13,0,0,0,6
Adelaide,"Tippett, Kurt",4,3,1,1,0,0,2,1
Adelaide,"Vince, Bernie",25,16,3,9,4,0,0,1
Adelaide,"Wright, Matthew",25,17,7,8,1,2,0,4
Adelaide,"van Berlo, Nathan",25,17,5,8,1,2,0,2
Adelaide,"Callinan, Ian",9,7,2,2,1,3,0,0
Adelaide,"Dangerfield, Patrick",33,15,2,18,2,0,0,3
Adelaide,"Doughty, Michael",19,7,3,12,0,0,0,4
Adelaide,"Douglas, Richard",26,18,4,8,0,1,0,1
Adelaide,"Jenkins, Josh",7,5,3,2,1,0,11,2
Adelaide,"Johncock, Graham",11,4,1,7,0,0,0,4
Adelaide,"Mackay, David",15,11,1,4,1,0,0,6
Adelaide,"McKernan, Shaun",7,3,1,4,0,0,26,0
Adelaide,"Petrenko, Jared",9,3,0,6,0,0,0,6
Adelaide,"Porplyzia, Jason",20,15,9,5,2,1,0,4
Adelaide,"Reilly, Brent",15,11,1,4,0,0,0,2
Adelaide,"Rutten, Ben",3,3,2,0,1,0,0,1
Adelaide,"Sloane, Rory",19,11,3,8,1,0,0,4
Adelaide,"Smith, Brodie",20,14,5,6,0,0,0,2
Adelaide,"Symes, Brad",7,2,0,5,0,0,0,3
Adelaide,"Talia, Daniel",6,3,0,3,0,0,0,1
Adelaide,"Thompson, Luke",9,4,1,5,0,0,0,3
Adelaide,"Thompson, Scott",40,16,1,24,0,0,2,3
Adelaide,"Vince, Bernie",21,14,3,7,2,0,0,3
Adelaide,"Walker, Taylor",10,9,4,1,0,3,0,0
Adelaide,"Wright, Matthew",26,3,3,23,0,0,0,6
Adelaide,"van Berlo, Nathan",21,14,2,7,0,0,0,3
Adelaide,"Callinan, Ian",9,4,2,5,0,0,0,1
Adelaide,"Dangerfield, Patrick",29,21,5,8,3,1,0,4
Adelaide,"Doughty, Michael",13,9,6,4,0,0,0,6
Adelaide,"Douglas, Richard",19,17,3,2,0,0,0,2
Adelaide,"Jacobs, Sam",13,10,6,3,1,1,40,1
Adelaide,"Jenkins, Josh",12,8,5,4,2,0,4,3
Adelaide,"Johncock, Graham",11,9,3,2,2,1,0,3
Adelaide,"Petrenko, Jared",10,6,2,4,0,2,0,6
Adelaide,"Porplyzia, Jason",6,3,0,3,1,0,0,1
Adelaide,"Reilly, Brent",20,17,9,3,0,0,0,2
Adelaide,"Riley, Aidan",17,11,5,6,1,0,0,4
Adelaide,"Rutten, Ben",11,5,5,6,0,0,0,2
Adelaide,"Shaw, Sam",12,9,6,3,0,0,0,1
Adelaide,"Sloane, Rory",18,12,6,6,1,0,1,2
Adelaide,"Smith, Brodie",18,12,8,6,0,0,0,4
Adelaide,"Talia, Daniel",9,9,4,0,0,0,0,2
Adelaide,"Tambling, Richard",6,4,2,2,0,0,0,2
Adelaide,"Thompson, Scott",22,11,1,11,0,0,0,6
Adelaide,"Vince, Bernie",19,15,5,4,0,0,0,4
Adelaide,"Walker, Taylor",12,10,7,2,4,0,0,2
Adelaide,"Wright, Matthew",11,7,3,4,0,0,0,5
Adelaide,"van Berlo, Nathan",19,12,7,7,1,0,0,4
Adelaide,"Callinan, Ian",12,9,5,3,2,2,0,1
Adelaide,"Dangerfield, Patrick",34,17,4,17,2,0,1,8
Adelaide,"Doughty, Michael",17,10,5,7,0,0,0,4
Adelaide,"Douglas, Richard",19,13,6,6,1,1,0,2
Adelaide,"Jacobs, Sam",10,7,5,3,0,1,33,1
Adelaide,"Jenkins, Josh",6,6,5,0,0,1,5,2
Adelaide,"Johncock, Graham",14,10,5,4,1,2,0,2
Adelaide,"Johnston, Lewis",7,6,5,1,0,0,0,1
Adelaide,"Mackay, David",17,8,3,9,1,0,0,4
Adelaide,"Petrenko, Jared",16,9,2,7,0,3,1,2
Adelaide,"Reilly, Brent",13,10,4,3,0,0,0,2
Adelaide,"Riley, Aidan",2,1,1,1,1,0,0,0
Adelaide,"Rutten, Ben",12,4,5,8,0,0,1,4
Adelaide,"Shaw, Sam",9,9,4,0,0,0,0,2
Adelaide,"Sloane, Rory",17,13,3,4,1,0,1,2
Adelaide,"Smith, Brodie",20,14,7,6,0,1,0,2
Adelaide,"Talia, Daniel",8,6,2,2,0,0,0,4
Adelaide,"Thompson, Scott",16,7,1,9,1,1,0,4
Adelaide,"Vince, Bernie",21,10,3,11,1,0,0,2
Adelaide,"Walker, Taylor",12,10,8,2,4,2,0,1
Adelaide,"Wright, Matthew",37,22,6,15,2,0,0,3
Adelaide,"van Berlo, Nathan",13,8,2,5,0,1,0,3
Adelaide,"Brown, Luke",7,4,3,3,0,0,0,1
Adelaide,"Callinan, Ian",14,11,6,3,4,1,0,1
Adelaide,"Dangerfield, Patrick",30,20,5,10,0,1,1,2
Adelaide,"Doughty, Michael",15,8,1,7,0,0,0,2
Adelaide,"Douglas, Richard",12,7,0,5,0,2,0,7
Adelaide,"Jacobs, Sam",13,7,6,6,0,0,37,0
Adelaide,"Jenkins, Josh",6,6,3,0,1,1,5,2
Adelaide,"Johncock, Graham",15,6,6,9,1,2,0,2
Adelaide,"Knights, Chris",7,5,2,2,0,1,0,1
Adelaide,"Mackay, David",12,6,1,6,0,0,0,3
Adelaide,"Petrenko, Jared",14,9,3,5,1,0,0,5
Adelaide,"Reilly, Brent",20,17,9,3,0,0,0,2
Adelaide,"Rutten, Ben",16,7,6,9,0,0,0,2
Adelaide,"Shaw, Sam",22,21,7,1,0,0,0,0
Adelaide,"Sloane, Rory",16,13,9,3,0,0,0,1
Adelaide,"Talia, Daniel",5,3,1,2,0,0,0,1
Adelaide,"Thompson, Scott",32,16,7,16,0,1,0,5
Adelaide,"Tippett, Kurt",7,5,3,2,0,1,5,3
Adelaide,"Vince, Bernie",21,17,5,4,1,0,0,1
Adelaide,"Walker, Taylor",15,9,7,6,4,2,0,5
Adelaide,"Wright, Matthew",16,12,6,4,0,0,0,2
Adelaide,"van Berlo, Nathan",14,8,6,6,0,0,0,3
Adelaide,"Brown, Luke",1,1,1,0,0,0,0,1
Adelaide,"Callinan, Ian",11,7,2,4,4,0,0,2
Adelaide,"Dangerfield, Patrick",22,19,3,3,3,1,0,3
Adelaide,"Doughty, Michael",16,12,2,4,0,0,0,4
Adelaide,"Douglas, Richard",15,11,2,4,2,1,1,1
Adelaide,"Jacobs, Sam",15,11,2,4,0,2,32,0
Adelaide,"Johncock, Graham",11,8,4,3,2,1,0,3
Adelaide,"Mackay, David",13,7,6,6,0,0,0,3
Adelaide,"Petrenko, Jared",11,4,2,7,1,1,0,6
Adelaide,"Porplyzia, Jason",20,12,5,8,0,0,0,2
Adelaide,"Reilly, Brent",14,13,5,1,1,0,0,4
Adelaide,"Riley, Aidan",16,9,3,7,0,0,0,5
Adelaide,"Rutten, Ben",5,4,4,1,0,0,0,1
Adelaide,"Shaw, Sam",14,9,3,5,0,0,0,2
Adelaide,"Smith, Brodie",12,7,2,5,0,0,0,1
Adelaide,"Talia, Daniel",8,6,7,2,0,0,0,1
Adelaide,"Thompson, Scott",29,18,3,11,0,1,0,3
Adelaide,"Tippett, Kurt",18,14,11,4,3,1,9,3
Adelaide,"Vince, Bernie",9,3,2,6,0,1,0,0
Adelaide,"Walker, Taylor",25,17,16,8,4,2,0,2
Adelaide,"Wright, Matthew",24,16,6,8,1,1,0,4
Adelaide,"van Berlo, Nathan",17,10,4,7,1,1,0,4
Adelaide,"Callinan, Ian",17,10,4,7,4,1,0,1
Adelaide,"Dangerfield, Patrick",36,22,5,14,2,1,0,3
Adelaide,"Doughty, Michael",13,6,6,7,0,0,0,3
Adelaide,"Douglas, Richard",20,17,6,3,0,1,0,4
Adelaide,"Jacobs, Sam",17,9,5,8,1,0,27,1
Adelaide,"Jaensch, Matthew",5,4,2,1,0,0,0,1
Adelaide,"Johncock, Graham",11,8,4,3,4,2,0,1
Adelaide,"Lynch, Tom",13,9,6,4,0,1,0,1
Adelaide,"Mackay, David",24,12,6,12,0,0,0,0
Adelaide,"Petrenko, Jared",18,10,5,8,2,1,0,7
Adelaide,"Porplyzia, Jason",25,17,8,8,1,3,0,3
Adelaide,"Reilly, Brent",18,16,7,2,0,0,0,3
Adelaide,"Riley, Aidan",17,6,2,11,1,0,0,3
Adelaide,"Rutten, Ben",17,7,10,10,0,0,2,2
Adelaide,"Shaw, Sam",8,6,1,2,0,0,0,4
Adelaide,"Sloane, Rory",22,13,3,9,0,0,0,3
Adelaide,"Smith, Brodie",21,14,5,7,1,2,0,3
Adelaide,"Talia, Daniel",7,3,4,4,1,0,0,2
Adelaide,"Thompson, Scott",30,17,4,13,2,4,0,3
Adelaide,"Tippett, Kurt",13,10,5,3,1,2,15,2
Adelaide,"Wright, Matthew",21,9,5,12,0,1,0,3
Adelaide,"van Berlo, Nathan",16,7,7,9,2,1,0,2
Adelaide,"Callinan, Ian",10,8,2,2,1,0,0,2
Adelaide,"Dangerfield, Patrick",21,11,3,10,0,0,0,2
Adelaide,"Doughty, Michael",26,13,10,13,0,0,0,2
Adelaide,"Douglas, Richard",16,13,4,3,0,0,0,2
Adelaide,"Jacobs, Sam",7,3,1,4,0,0,27,3
Adelaide,"Johncock, Graham",13,10,5,3,1,1,0,6
Adelaide,"Mackay, David",24,15,5,9,0,2,0,0
Adelaide,"Petrenko, Jared",5,4,0,1,0,1,0,2
Adelaide,"Porplyzia, Jason",10,6,1,4,0,0,0,3
Adelaide,"Reilly, Brent",23,14,9,9,0,0,0,1
Adelaide,"Riley, Aidan",3,2,1,1,0,0,0,1
Adelaide,"Rutten, Ben",17,10,8,7,0,0,0,5
Adelaide,"Shaw, Sam",7,3,1,4,0,0,0,0
Adelaide,"Sloane, Rory",24,15,5,9,1,0,3,4
Adelaide,"Smith, Brodie",20,13,3,7,0,0,0,0
Adelaide,"Talia, Daniel",6,3,3,3,0,0,0,0
Adelaide,"Thompson, Scott",28,18,2,10,0,2,0,8
Adelaide,"Tippett, Kurt",8,5,3,3,0,0,10,1
Adelaide,"Vince, Bernie",23,14,3,9,0,1,0,1
Adelaide,"Walker, Taylor",11,5,4,6,1,3,2,0
Adelaide,"Wright, Matthew",19,9,3,10,0,0,0,3
Adelaide,"van Berlo, Nathan",13,7,3,6,1,0,0,4
Adelaide,"Callinan, Ian",8,6,2,2,0,0,0,2
Adelaide,"Dangerfield, Patrick",18,5,3,13,1,0,0,2
Adelaide,"Doughty, Michael",15,11,6,4,0,0,0,4
Adelaide,"Douglas, Richard",23,17,9,6,0,2,0,0
Adelaide,"Henderson, Ricky",18,12,6,6,0,0,0,0
Adelaide,"Jacobs, Sam",12,7,3,5,0,0,22,2
Adelaide,"Johncock, Graham",10,6,4,4,0,4,0,2
Adelaide,"Mackay, David",16,9,3,7,0,0,0,6
Adelaide,"Petrenko, Jared",8,7,3,1,0,1,0,6
Adelaide,"Porplyzia, Jason",23,15,11,8,3,0,0,5
Adelaide,"Reilly, Brent",24,16,10,8,0,0,0,4
Adelaide,"Rutten, Ben",11,8,5,3,0,0,0,3
Adelaide,"Shaw, Sam",2,1,0,1,0,0,0,0
Adelaide,"Sloane, Rory",22,11,7,11,0,0,0,6
Adelaide,"Smith, Brodie",20,10,4,10,0,0,0,3
Adelaide,"Thompson, Luke",15,9,4,6,0,0,0,2
Adelaide,"Thompson, Scott",27,15,4,12,0,0,0,6
Adelaide,"Tippett, Kurt",14,5,2,9,1,0,5,1
Adelaide,"Vince, Bernie",24,18,6,6,1,0,0,1
Adelaide,"Walker, Taylor",13,10,6,3,5,2,0,0
Adelaide,"Wright, Matthew",18,9,5,9,1,0,0,4
Adelaide,"van Berlo, Nathan",17,15,9,2,0,0,0,6
Adelaide,"Callinan, Ian",9,5,2,4,0,1,0,1
Adelaide,"Dangerfield, Patrick",28,15,7,13,0,1,0,1
Adelaide,"Doughty, Michael",17,10,5,7,0,0,0,2
Adelaide,"Douglas, Richard",19,9,2,10,0,1,0,5
Adelaide,"Henderson, Ricky",16,9,7,7,1,0,0,2
Adelaide,"Jacobs, Sam",9,5,2,4,0,0,38,0
Adelaide,"Johncock, Graham",2,2,2,0,1,0,0,0
Adelaide,"Mackay, David",19,12,6,7,0,0,0,5
Adelaide,"Otten, Andy",16,9,8,7,0,0,0,6
Adelaide,"Petrenko, Jared",4,3,1,1,0,1,0,2
Adelaide,"Porplyzia, Jason",26,19,10,7,1,1,0,0
Adelaide,"Reilly, Brent",20,17,3,3,0,0,0,1
Adelaide,"Rutten, Ben",14,5,6,9,0,0,0,2
Adelaide,"Sloane, Rory",20,10,4,10,1,1,0,2
Adelaide,"Smith, Brodie",16,9,4,7,1,0,0,1
Adelaide,"Thompson, Luke",11,4,4,7,0,0,0,2
Adelaide,"Thompson, Scott",31,14,7,17,0,0,1,3
Adelaide,"Tippett, Kurt",16,12,11,4,4,1,6,0
Adelaide,"Vince, Bernie",21,18,7,3,0,0,0,0
Adelaide,"Walker, Taylor",12,8,7,4,4,0,0,0
Adelaide,"Wright, Matthew",18,9,7,9,0,0,0,2
Adelaide,"van Berlo, Nathan",19,9,3,10,1,0,0,2
Brisbane Lions,"Adcock, Jed",29,18,9,11,1,0,0,4
Brisbane Lions,"Banfield, Todd",10,8,2,2,3,1,0,2
Brisbane Lions,"Beams, Claye",25,12,1,13,0,0,0,5
Brisbane Lions,"Bewick, Rohan",11,5,5,6,0,0,0,2
Brisbane Lions,"Black, Simon",30,17,3,13,0,0,0,10
Brisbane Lions,"Golby, Mitch",20,12,8,8,0,0,0,1
Brisbane Lions,"Hanley, Pearce",23,17,9,6,2,0,0,6
Brisbane Lions,"Hudson, Ben",17,5,1,12,0,0,19,3
Brisbane Lions,"Lester, Ryan",12,9,3,3,0,2,0,2
Brisbane Lions,"Leuenberger, Matthew",9,3,2,6,1,0,22,3
Brisbane Lions,"Maguire, Matt",14,11,9,3,0,0,0,2
Brisbane Lions,"McGrath, Ashley",12,9,3,3,1,1,0,3
Brisbane Lions,"McKeever, Niall",18,13,7,5,0,0,0,0
Brisbane Lions,"Merrett, Daniel",16,11,5,5,2,1,0,4
Brisbane Lions,"Patfull, Joel",16,6,4,10,0,0,0,2
Brisbane Lions,"Polec, Jared",18,8,6,10,0,0,1,0
Brisbane Lions,"Polkinghorne, James",16,11,4,5,3,1,0,7
Brisbane Lions,"Redden, Jack",18,7,4,11,0,1,0,7
Brisbane Lions,"Rich, Daniel",24,13,1,11,0,1,0,2
Brisbane Lions,"Rockliff, Tom",23,16,10,7,3,5,0,5
Brisbane Lions,"Sheldon, Sam",5,4,1,1,1,1,0,2
Brisbane Lions,"Stiller, Cheynee",19,11,10,8,0,0,0,4
Brisbane Lions,"Adcock, Jed",14,6,1,8,0,0,0,4
Brisbane Lions,"Banfield, Todd",8,4,2,4,0,0,0,2
Brisbane Lions,"Beams, Claye",9,5,2,4,1,0,0,6
Brisbane Lions,"Bewick, Rohan",12,7,4,5,0,0,0,2
Brisbane Lions,"Black, Simon",23,8,0,15,0,0,0,4
Brisbane Lions,"Golby, Mitch",10,3,3,7,0,0,0,3
Brisbane Lions,"Hanley, Pearce",18,16,2,2,0,0,0,0
Brisbane Lions,"Hudson, Ben",6,4,1,2,1,0,13,3
Brisbane Lions,"Lester, Ryan",14,10,5,4,2,1,0,0
Brisbane Lions,"Leuenberger, Matthew",17,12,4,5,0,0,21,5
Brisbane Lions,"Maguire, Matt",20,13,4,7,0,0,0,0
Brisbane Lions,"McGrath, Ashley",14,6,2,8,0,0,0,4
Brisbane Lions,"McKeever, Niall",10,5,2,5,0,1,0,0
Brisbane Lions,"Merrett, Daniel",15,11,5,4,2,3,0,2
Brisbane Lions,"OBrien, Jesse",2,2,0,0,1,0,0,1
Brisbane Lions,"Patfull, Joel",12,8,4,4,0,0,0,4
Brisbane Lions,"Polec, Jared",9,5,2,4,0,1,0,5
Brisbane Lions,"Polkinghorne, James",13,7,0,6,0,0,1,4
Brisbane Lions,"Redden, Jack",26,13,7,13,1,0,0,5
Brisbane Lions,"Rich, Daniel",27,17,4,10,1,0,0,1
Brisbane Lions,"Rockliff, Tom",17,8,2,9,0,0,0,4
Brisbane Lions,"Stiller, Cheynee",12,6,2,6,0,0,0,4
Brisbane Lions,"Adcock, Jed",20,18,6,2,0,0,0,3
Brisbane Lions,"Banfield, Todd",6,4,1,2,1,1,0,5
Brisbane Lions,"Beams, Claye",11,8,3,3,0,0,0,3
Brisbane Lions,"Brown, Jonathan",3,3,3,0,0,0,0,0
Brisbane Lions,"Drummond, Josh",20,16,11,4,0,0,0,1
Brisbane Lions,"Golby, Mitch",15,8,5,7,0,0,0,5
Brisbane Lions,"Hanley, Pearce",18,14,7,4,0,0,0,0
Brisbane Lions,"Harwood, Ryan",16,9,6,7,0,0,0,7
Brisbane Lions,"Lester, Ryan",14,12,5,2,0,0,0,0
Brisbane Lions,"Leuenberger, Matthew",2,2,1,0,0,0,1,0
Brisbane Lions,"Longer, Billy",8,8,2,0,0,0,19,3
Brisbane Lions,"Maguire, Matt",14,11,8,3,0,0,0,1
Brisbane Lions,"McGrath, Ashley",14,9,3,5,0,0,0,5
Brisbane Lions,"Merrett, Daniel",13,10,7,3,1,1,4,5
Brisbane Lions,"OBrien, Jesse",8,4,3,4,0,0,0,4
Brisbane Lions,"Patfull, Joel",19,13,5,6,0,0,0,2
Brisbane Lions,"Polec, Jared",15,12,5,3,2,2,0,3
Brisbane Lions,"Polkinghorne, James",18,11,7,7,0,0,0,6
Brisbane Lions,"Raines, Andrew",9,5,2,4,0,0,0,1
Brisbane Lions,"Redden, Jack",21,10,6,11,0,0,0,2
Brisbane Lions,"Rich, Daniel",13,6,3,7,1,1,0,0
Brisbane Lions,"Rockliff, Tom",22,10,4,12,0,0,0,7
Brisbane Lions,"Adcock, Jed",19,9,4,10,1,0,0,4
Brisbane Lions,"Banfield, Todd",21,13,3,8,1,0,0,3
Brisbane Lions,"Black, Simon",30,15,7,15,0,0,0,6
Brisbane Lions,"Brown, Jonathan",16,8,7,8,3,0,0,1
Brisbane Lions,"Cornelius, Aaron",13,12,10,1,4,3,0,3
Brisbane Lions,"Crisp, Jack",17,10,1,7,0,3,0,4
Brisbane Lions,"Drummond, Josh",22,17,7,5,0,0,0,5
Brisbane Lions,"Golby, Mitch",26,12,5,14,0,0,0,5
Brisbane Lions,"Hanley, Pearce",25,18,3,7,0,0,0,6
Brisbane Lions,"Harwood, Ryan",8,3,1,5,0,0,0,3
Brisbane Lions,"Hudson, Ben",14,4,1,10,0,0,33,1
Brisbane Lions,"Lester, Ryan",17,6,3,11,0,0,0,0
Brisbane Lions,"Maguire, Matt",15,10,4,5,0,0,0,2
Brisbane Lions,"McGrath, Ashley",28,18,9,10,0,0,0,2
Brisbane Lions,"Merrett, Daniel",13,9,4,4,1,0,8,2
Brisbane Lions,"Patfull, Joel",13,5,5,8,0,0,0,3
Brisbane Lions,"Polec, Jared",20,12,4,8,1,0,0,3
Brisbane Lions,"Raines, Andrew",14,8,1,6,1,0,0,6
Brisbane Lions,"Redden, Jack",26,3,5,23,0,0,1,2
Brisbane Lions,"Rich, Daniel",22,15,2,7,3,0,0,8
Brisbane Lions,"Rockliff, Tom",37,18,4,19,2,0,0,7
Brisbane Lions,"Sheldon, Sam",14,4,0,10,0,0,0,2
Brisbane Lions,"Adcock, Jed",17,10,1,7,0,1,0,10
Brisbane Lions,"Banfield, Todd",11,5,0,6,0,2,0,7
Brisbane Lions,"Black, Simon",22,12,2,10,1,0,0,8
Brisbane Lions,"Brown, Jonathan",14,8,4,6,1,1,1,1
Brisbane Lions,"Cornelius, Aaron",8,3,2,5,0,0,1,3
Brisbane Lions,"Crisp, Jack",12,8,1,4,0,0,0,5
Brisbane Lions,"Drummond, Josh",6,5,0,1,0,0,0,2
Brisbane Lions,"Golby, Mitch",16,10,1,6,0,0,0,3
Brisbane Lions,"Hanley, Pearce",18,10,3,8,0,0,0,2
Brisbane Lions,"Hudson, Ben",15,9,0,6,0,0,39,5
Brisbane Lions,"Karnezis, Patrick",6,4,0,2,0,3,0,3
Brisbane Lions,"Lester, Ryan",12,7,1,5,0,0,0,3
Brisbane Lions,"Maguire, Matt",9,5,0,4,0,0,3,5
Brisbane Lions,"McGrath, Ashley",15,10,0,5,1,1,0,3
Brisbane Lions,"Merrett, Daniel",16,11,1,5,0,0,3,9
Brisbane Lions,"Patfull, Joel",12,8,3,4,0,0,0,5
Brisbane Lions,"Polec, Jared",20,15,1,5,0,1,0,3
Brisbane Lions,"Raines, Andrew",12,10,1,2,0,1,0,7
Brisbane Lions,"Redden, Jack",21,16,0,5,0,0,0,7
Brisbane Lions,"Rich, Daniel",21,11,2,10,0,2,0,4
Brisbane Lions,"Rockliff, Tom",32,18,5,14,1,0,0,8
Brisbane Lions,"Sheldon, Sam",10,6,2,4,0,0,0,8
Brisbane Lions,"Adcock, Jed",21,10,4,11,0,0,0,3
Brisbane Lions,"Banfield, Todd",7,2,0,5,0,0,0,2
Brisbane Lions,"Black, Simon",27,9,3,18,0,1,0,0
Brisbane Lions,"Brown, Jonathan",21,11,7,10,2,1,0,0
Brisbane Lions,"Cornelius, Aaron",13,8,4,5,1,0,0,1
Brisbane Lions,"Crisp, Jack",16,10,4,6,2,0,0,2
Brisbane Lions,"Golby, Mitch",14,8,3,6,0,0,0,5
Brisbane Lions,"Hanley, Pearce",24,11,1,13,0,0,0,5
Brisbane Lions,"Harwood, Ryan",16,8,3,8,0,0,0,1
Brisbane Lions,"Hudson, Ben",16,4,4,12,1,0,23,3
Brisbane Lions,"Karnezis, Patrick",8,6,6,2,0,2,0,1
Brisbane Lions,"Lester, Ryan",18,10,4,8,0,0,0,3
Brisbane Lions,"Longer, Billy",1,0,0,1,0,0,7,3
Brisbane Lions,"Maguire, Matt",13,7,3,6,0,0,1,4
Brisbane Lions,"McGrath, Ashley",15,10,3,5,1,1,0,3
Brisbane Lions,"Merrett, Daniel",6,3,1,3,0,0,0,6
Brisbane Lions,"Patfull, Joel",8,3,3,5,0,0,0,1
Brisbane Lions,"Polec, Jared",13,9,2,4,2,0,2,1
Brisbane Lions,"Polkinghorne, James",20,14,3,6,0,0,0,2
Brisbane Lions,"Redden, Jack",30,15,8,15,0,1,0,5
Brisbane Lions,"Rich, Daniel",30,15,5,15,0,1,0,5
Brisbane Lions,"Rockliff, Tom",21,7,5,14,0,0,0,3
Brisbane Lions,"Banfield, Todd",8,5,4,3,0,2,0,1
Brisbane Lions,"Black, Simon",20,9,3,11,1,0,0,4
Brisbane Lions,"Brown, Jonathan",16,9,9,7,2,2,0,0
Brisbane Lions,"Drummond, Josh",13,7,4,6,0,0,0,2
Brisbane Lions,"Golby, Mitch",18,10,3,8,0,0,0,2
Brisbane Lions,"Hanley, Pearce",17,8,2,9,0,0,0,1
Brisbane Lions,"Harwood, Ryan",13,5,3,8,0,0,0,2
Brisbane Lions,"Hawksley, James",21,12,10,9,0,1,1,1
Brisbane Lions,"Karnezis, Patrick",7,6,3,1,2,1,0,1
Brisbane Lions,"Longer, Billy",7,3,3,4,0,0,31,1
Brisbane Lions,"Maguire, Matt",15,12,7,3,0,0,0,3
Brisbane Lions,"McGrath, Ashley",16,10,5,6,0,2,0,2
Brisbane Lions,"McKeever, Niall",14,3,3,11,0,0,0,0
Brisbane Lions,"Merrett, Daniel",6,5,4,1,1,0,4,3
Brisbane Lions,"Patfull, Joel",6,4,2,2,0,0,0,2
Brisbane Lions,"Polec, Jared",10,6,5,4,1,0,1,3
Brisbane Lions,"Polkinghorne, James",10,8,5,2,0,0,1,4
Brisbane Lions,"Raines, Andrew",15,8,5,7,0,0,0,1
Brisbane Lions,"Redden, Jack",28,14,6,14,0,0,1,8
Brisbane Lions,"Rich, Daniel",20,16,4,4,1,0,0,3
Brisbane Lions,"Rockliff, Tom",22,11,3,11,0,0,0,3
Brisbane Lions,"Zorko, Dayne",8,2,1,6,0,0,0,2
Brisbane Lions,"Adcock, Jed",17,9,5,8,0,0,0,2
Brisbane Lions,"Bewick, Rohan",24,13,6,11,0,2,0,3
Brisbane Lions,"Black, Simon",25,13,5,12,0,1,0,2
Brisbane Lions,"Brown, Jonathan",23,15,16,8,5,2,2,1
Brisbane Lions,"Drummond, Josh",19,12,6,7,0,0,0,1
Brisbane Lions,"Golby, Mitch",24,16,8,8,0,0,0,4
Brisbane Lions,"Green, Josh",18,8,3,10,0,1,0,2
Brisbane Lions,"Hanley, Pearce",29,18,10,11,0,0,0,4
Brisbane Lions,"Karnezis, Patrick",10,8,7,2,2,1,0,2
Brisbane Lions,"Lester, Ryan",19,10,9,9,0,1,0,2
Brisbane Lions,"Longer, Billy",15,8,3,7,0,0,25,3
Brisbane Lions,"Maguire, Matt",13,9,4,4,0,0,0,2
Brisbane Lions,"McGrath, Ashley",22,10,3,12,0,1,0,3
Brisbane Lions,"Merrett, Daniel",23,17,12,6,7,2,2,1
Brisbane Lions,"Patfull, Joel",13,5,4,8,0,0,0,2
Brisbane Lions,"Polec, Jared",2,1,2,1,0,0,0,0
Brisbane Lions,"Polkinghorne, James",13,8,5,5,0,0,2,2
Brisbane Lions,"Raines, Andrew",17,8,2,9,0,0,0,1
Brisbane Lions,"Redden, Jack",26,9,1,17,0,0,0,9
Brisbane Lions,"Rich, Daniel",26,18,5,8,1,0,0,3
Brisbane Lions,"Rockliff, Tom",36,20,5,16,3,4,0,0
Brisbane Lions,"Zorko, Dayne",18,11,7,7,1,1,0,6
Brisbane Lions,"Adcock, Jed",20,9,6,11,0,0,0,7
Brisbane Lions,"Bewick, Rohan",13,8,3,5,1,0,0,3
Brisbane Lions,"Black, Simon",12,6,0,6,0,0,0,3
Brisbane Lions,"Brown, Jonathan",14,9,10,5,2,0,0,2
Brisbane Lions,"Cornelius, Aaron",10,8,5,2,4,0,0,0
Brisbane Lions,"Drummond, Josh",19,14,6,5,0,0,0,1
Brisbane Lions,"Golby, Mitch",25,16,6,9,0,0,0,4
Brisbane Lions,"Green, Josh",10,9,2,1,2,0,0,4
Brisbane Lions,"Hanley, Pearce",21,17,8,4,0,0,1,4
Brisbane Lions,"Lester, Ryan",6,2,3,4,0,0,0,0
Brisbane Lions,"Longer, Billy",6,2,3,4,0,0,31,5
Brisbane Lions,"Maguire, Matt",13,8,5,5,0,0,0,4
Brisbane Lions,"McGrath, Ashley",21,13,5,8,0,2,0,2
Brisbane Lions,"Merrett, Daniel",11,8,5,3,1,1,5,1
Brisbane Lions,"Patfull, Joel",11,6,5,5,0,0,0,6
Brisbane Lions,"Polkinghorne, James",14,9,2,5,0,0,0,1
Brisbane Lions,"Raines, Andrew",14,8,2,6,0,0,0,3
Brisbane Lions,"Redden, Jack",25,16,9,9,2,0,3,5
Brisbane Lions,"Rich, Daniel",21,16,3,5,1,0,0,5
Brisbane Lions,"Rockliff, Tom",22,9,4,13,1,0,0,2
Brisbane Lions,"Yeo, Elliot",16,7,3,9,0,1,0,1
Brisbane Lions,"Zorko, Dayne",14,8,4,6,1,0,0,9
Brisbane Lions,"Adcock, Jed",28,15,9,13,0,0,0,6
Brisbane Lions,"Bewick, Rohan",9,5,2,4,1,1,0,0
Brisbane Lions,"Brown, Jonathan",13,8,6,5,1,1,2,2
Brisbane Lions,"Cornelius, Aaron",7,4,3,3,1,0,0,0
Brisbane Lions,"Drummond, Josh",26,20,5,6,3,0,0,0
Brisbane Lions,"Golby, Mitch",20,15,7,5,0,0,0,3
Brisbane Lions,"Green, Josh",4,4,0,0,3,0,0,0
Brisbane Lions,"Hanley, Pearce",13,11,5,2,0,1,0,4
Brisbane Lions,"Hudson, Ben",19,5,4,14,0,0,22,0
Brisbane Lions,"Lester, Ryan",21,12,5,9,0,0,0,4
Brisbane Lions,"Maguire, Matt",15,13,11,2,0,0,1,4
Brisbane Lions,"McGrath, Ashley",7,3,5,4,0,0,0,3
Brisbane Lions,"McKeever, Niall",11,4,3,7,0,0,1,1
Brisbane Lions,"Merrett, Daniel",10,6,4,4,1,0,3,4
Brisbane Lions,"Patfull, Joel",12,9,5,3,0,0,0,4
Brisbane Lions,"Polec, Jared",12,7,6,5,1,0,0,3
Brisbane Lions,"Polkinghorne, James",14,10,3,4,3,0,0,1
Brisbane Lions,"Raines, Andrew",15,4,1,11,0,0,0,8
Brisbane Lions,"Redden, Jack",21,11,5,10,0,0,0,15
Brisbane Lions,"Rich, Daniel",21,14,4,7,1,1,0,3
Brisbane Lions,"Rockliff, Tom",27,9,0,18,0,0,0,7
Brisbane Lions,"Zorko, Dayne",18,10,5,8,1,1,0,9
Brisbane Lions,"Adcock, Jed",27,16,3,11,0,0,0,5
Brisbane Lions,"Bewick, Rohan",5,5,1,0,1,0,0,1
Brisbane Lions,"Brown, Jonathan",14,10,7,4,3,0,0,2
Brisbane Lions,"Cornelius, Aaron",4,2,1,2,1,0,1,3
Brisbane Lions,"Drummond, Josh",17,8,3,9,0,0,0,2
Brisbane Lions,"Golby, Mitch",14,5,2,9,0,0,0,6
Brisbane Lions,"Green, Josh",10,10,0,0,0,1,0,3
Brisbane Lions,"Hanley, Pearce",9,6,2,3,0,0,0,3
Brisbane Lions,"Harwood, Ryan",13,8,2,5,0,0,0,2
Brisbane Lions,"Hudson, Ben",14,7,3,7,0,0,34,2
Brisbane Lions,"Lester, Ryan",16,9,3,7,0,0,0,0
Brisbane Lions,"Maguire, Matt",12,10,3,2,0,0,0,2
Brisbane Lions,"McKeever, Niall",6,3,3,3,0,0,1,1
Brisbane Lions,"Merrett, Daniel",11,8,3,3,0,2,7,3
Brisbane Lions,"Patfull, Joel",9,7,3,2,0,0,0,4
Brisbane Lions,"Polec, Jared",6,3,1,3,0,0,0,2
Brisbane Lions,"Polkinghorne, James",11,6,1,5,1,1,0,2
Brisbane Lions,"Raines, Andrew",19,10,0,9,1,0,0,5
Brisbane Lions,"Redden, Jack",24,13,5,11,0,0,2,4
Brisbane Lions,"Rich, Daniel",14,9,1,5,1,0,0,4
Brisbane Lions,"Rockliff, Tom",27,11,2,16,0,0,0,7
Brisbane Lions,"Zorko, Dayne",24,18,9,6,3,0,0,7
Brisbane Lions,"Adcock, Jed",17,9,2,8,0,0,0,5
Brisbane Lions,"Bewick, Rohan",19,14,8,5,2,1,1,1
Brisbane Lions,"Black, Simon",23,8,2,15,0,0,0,6
Brisbane Lions,"Brown, Jonathan",15,12,11,3,0,1,0,2
Brisbane Lions,"Drummond, Josh",16,12,6,4,0,0,0,1
Brisbane Lions,"Golby, Mitch",22,11,5,11,0,0,0,2
Brisbane Lions,"Green, Josh",6,3,2,3,0,0,0,3
Brisbane Lions,"Hanley, Pearce",29,21,13,8,1,0,1,2
Brisbane Lions,"Harwood, Ryan",18,11,5,7,0,0,0,3
Brisbane Lions,"Hudson, Ben",7,3,5,4,0,0,23,5
Brisbane Lions,"Lester, Ryan",10,4,2,6,0,0,0,6
Brisbane Lions,"Maguire, Matt",0,0,0,0,0,0,0,1
Brisbane Lions,"McGrath, Ashley",11,9,7,2,5,0,0,1
Brisbane Lions,"McKeever, Niall",11,2,3,9,0,0,0,3
Brisbane Lions,"Merrett, Daniel",13,10,7,3,4,0,3,3
Brisbane Lions,"Patfull, Joel",11,5,3,6,0,0,0,3
Brisbane Lions,"Polkinghorne, James",15,8,4,7,0,0,2,1
Brisbane Lions,"Raines, Andrew",21,8,0,13,1,1,0,3
Brisbane Lions,"Redden, Jack",31,13,6,18,1,0,0,6
Brisbane Lions,"Rich, Daniel",22,15,7,7,2,1,0,4
Brisbane Lions,"Rockliff, Tom",40,19,8,21,2,0,0,3
Brisbane Lions,"Zorko, Dayne",29,17,8,12,0,1,0,5
Brisbane Lions,"Adcock, Jed",15,9,5,6,0,1,0,3
Brisbane Lions,"Bewick, Rohan",8,5,1,3,1,0,0,1
Brisbane Lions,"Black, Simon",26,14,4,12,1,1,0,2
Brisbane Lions,"Brown, Jonathan",24,19,12,5,4,3,0,0
Brisbane Lions,"Drummond, Josh",15,9,4,6,0,0,0,1
Brisbane Lions,"Golby, Mitch",17,9,5,8,0,0,0,4
Brisbane Lions,"Green, Josh",12,4,0,8,2,1,0,2
Brisbane Lions,"Hanley, Pearce",24,20,8,4,3,1,0,3
Brisbane Lions,"Harwood, Ryan",29,17,12,12,0,0,0,4
Brisbane Lions,"Hudson, Ben",18,6,4,12,0,0,26,2
Brisbane Lions,"Lester, Ryan",15,11,8,4,0,0,0,2
Brisbane Lions,"McGrath, Ashley",7,6,4,1,3,0,0,1
Brisbane Lions,"McKeever, Niall",16,7,8,9,0,0,0,1
Brisbane Lions,"Merrett, Daniel",17,9,5,8,1,0,3,1
Brisbane Lions,"Patfull, Joel",10,4,2,6,0,0,0,3
Brisbane Lions,"Polec, Jared",7,5,4,2,1,0,0,0
Brisbane Lions,"Polkinghorne, James",17,11,4,6,0,2,0,2
Brisbane Lions,"Raines, Andrew",21,9,3,12,0,0,0,3
Brisbane Lions,"Redden, Jack",32,14,7,18,1,0,0,1
Brisbane Lions,"Rich, Daniel",24,15,5,9,0,1,0,4
Brisbane Lions,"Rockliff, Tom",29,16,5,13,0,0,0,8
Brisbane Lions,"Zorko, Dayne",15,7,3,8,1,1,0,5
Brisbane Lions,"Adcock, Jed",21,17,10,4,0,0,0,6
Brisbane Lions,"Beams, Claye",4,1,1,3,0,0,0,3
Brisbane Lions,"Bewick, Rohan",14,8,5,6,1,1,0,1
Brisbane Lions,"Brown, Jonathan",13,8,3,5,2,1,0,1
Brisbane Lions,"Crisp, Jack",15,9,5,6,1,1,0,3
Brisbane Lions,"Drummond, Josh",22,17,7,5,0,0,0,2
Brisbane Lions,"Green, Josh",5,2,0,3,0,0,0,0
Brisbane Lions,"Hanley, Pearce",34,22,5,12,0,0,2,3
Brisbane Lions,"Harwood, Ryan",22,13,8,9,0,0,0,1
Brisbane Lions,"Hudson, Ben",16,4,1,12,0,0,24,2
Brisbane Lions,"Karnezis, Patrick",13,9,11,4,2,1,0,3
Brisbane Lions,"Lester, Ryan",13,8,5,5,0,0,0,2
Brisbane Lions,"McKeever, Niall",12,4,2,8,0,0,0,2
Brisbane Lions,"Merrett, Daniel",12,7,6,5,0,0,1,2
Brisbane Lions,"Patfull, Joel",16,7,4,9,0,0,0,3
Brisbane Lions,"Polkinghorne, James",12,7,4,5,0,1,1,1
Brisbane Lions,"Raines, Andrew",20,7,1,13,1,0,0,3
Brisbane Lions,"Redden, Jack",20,7,5,13,0,0,0,3
Brisbane Lions,"Rich, Daniel",18,13,4,5,2,0,2,0
Brisbane Lions,"Rockliff, Tom",27,14,5,13,0,1,0,4
Brisbane Lions,"Stiller, Cheynee",14,11,6,3,0,0,0,0
Brisbane Lions,"Zorko, Dayne",31,15,10,16,0,2,1,8
Brisbane Lions,"Adcock, Jed",11,9,6,2,0,0,0,3
Brisbane Lions,"Banfield, Todd",9,4,1,5,1,0,0,0
Brisbane Lions,"Bewick, Rohan",20,13,2,7,2,0,0,0
Brisbane Lions,"Black, Simon",31,10,3,21,1,0,0,2
Brisbane Lions,"Brown, Jonathan",11,5,3,6,1,1,3,1
Brisbane Lions,"Cornelius, Aaron",7,2,3,5,1,0,0,2
Brisbane Lions,"Crisp, Jack",12,5,3,7,0,1,0,1
Brisbane Lions,"Drummond, Josh",12,9,3,3,0,1,0,1
Brisbane Lions,"Hanley, Pearce",17,13,3,4,0,0,0,2
Brisbane Lions,"Harwood, Ryan",10,5,2,5,0,0,0,1
Brisbane Lions,"Hudson, Ben",23,9,6,14,0,0,31,3
Brisbane Lions,"Karnezis, Patrick",6,3,1,3,1,0,0,1
Brisbane Lions,"Maguire, Matt",24,16,10,8,0,0,0,1
Brisbane Lions,"Merrett, Daniel",14,8,5,6,2,1,4,4
Brisbane Lions,"Patfull, Joel",11,8,3,3,0,0,0,3
Brisbane Lions,"Polkinghorne, James",15,10,4,5,1,0,0,1
Brisbane Lions,"Raines, Andrew",17,10,2,7,1,0,0,9
Brisbane Lions,"Redden, Jack",18,10,4,8,0,0,0,9
Brisbane Lions,"Rich, Daniel",23,10,2,13,0,0,0,1
Brisbane Lions,"Rockliff, Tom",16,14,3,2,2,0,0,3
Brisbane Lions,"Yeo, Elliot",17,11,3,6,0,0,0,1
Brisbane Lions,"Zorko, Dayne",23,12,5,11,1,2,0,8
Brisbane Lions,"Adcock, Jed",17,10,8,7,0,0,0,0
Brisbane Lions,"Banfield, Todd",9,4,1,5,0,1,0,2
Brisbane Lions,"Bewick, Rohan",3,2,0,1,1,0,0,1
Brisbane Lions,"Black, Simon",29,9,2,20,0,0,0,3
Brisbane Lions,"Brown, Jonathan",15,9,4,6,1,0,2,0
Brisbane Lions,"Cornelius, Aaron",14,9,5,5,1,2,0,0
Brisbane Lions,"Crisp, Jack",13,5,2,8,0,0,0,3
Brisbane Lions,"Drummond, Josh",11,9,2,2,0,0,0,0
Brisbane Lions,"Hanley, Pearce",27,20,6,7,0,0,0,0
Brisbane Lions,"Harwood, Ryan",16,11,6,5,0,0,0,1
Brisbane Lions,"Hudson, Ben",21,3,2,18,0,0,21,1
Brisbane Lions,"Lester, Ryan",21,13,5,8,0,0,0,0
Brisbane Lions,"Maguire, Matt",18,13,8,5,0,0,0,1
Brisbane Lions,"Merrett, Daniel",24,12,10,12,1,2,2,1
Brisbane Lions,"Patfull, Joel",11,5,1,6,0,0,0,2
Brisbane Lions,"Polec, Jared",11,9,2,2,0,1,0,3
Brisbane Lions,"Polkinghorne, James",21,12,5,9,1,1,0,1
Brisbane Lions,"Raines, Andrew",17,10,2,7,0,0,0,1
Brisbane Lions,"Redden, Jack",24,17,5,7,2,0,0,6
Brisbane Lions,"Rockliff, Tom",29,19,5,10,1,0,0,3
Brisbane Lions,"Yeo, Elliot",22,12,4,10,0,0,0,1
Brisbane Lions,"Zorko, Dayne",19,9,0,10,0,0,0,6
Brisbane Lions,"Adcock, Jed",21,13,4,8,1,0,0,4
Brisbane Lions,"Banfield, Todd",1,0,0,1,0,0,0,0
Brisbane Lions,"Bewick, Rohan",13,6,3,7,0,1,0,3
Brisbane Lions,"Black, Simon",23,9,1,14,0,1,0,4
Brisbane Lions,"Brown, Jonathan",19,10,7,9,3,1,0,3
Brisbane Lions,"Crisp, Jack",11,4,1,7,0,0,0,6
Brisbane Lions,"Hanley, Pearce",15,5,4,10,0,0,1,1
Brisbane Lions,"Harwood, Ryan",11,8,3,3,0,0,0,2
Brisbane Lions,"Hawksley, James",11,4,0,7,2,0,1,2
Brisbane Lions,"Hudson, Ben",15,7,0,8,0,0,17,1
Brisbane Lions,"Lester, Ryan",14,8,0,6,0,0,1,3
Brisbane Lions,"Maguire, Matt",8,6,4,2,0,0,0,2
Brisbane Lions,"McKeever, Niall",10,6,3,4,0,0,0,1
Brisbane Lions,"Merrett, Daniel",6,4,3,2,2,0,8,6
Brisbane Lions,"Patfull, Joel",8,6,4,2,0,0,0,2
Brisbane Lions,"Polkinghorne, James",13,8,1,5,1,0,0,4
Brisbane Lions,"Raines, Andrew",10,7,1,3,0,1,0,1
Brisbane Lions,"Redden, Jack",28,15,3,13,1,0,1,8
Brisbane Lions,"Rockliff, Tom",21,12,2,9,0,1,0,3
Brisbane Lions,"Wrigley, Stephen",8,5,0,3,0,0,0,3
Brisbane Lions,"Yeo, Elliot",14,7,4,7,0,0,0,0
Brisbane Lions,"Zorko, Dayne",16,12,2,4,2,0,1,9
Brisbane Lions,"Adcock, Jed",19,9,4,10,0,0,0,5
Brisbane Lions,"Banfield, Todd",7,5,3,2,0,2,0,2
Brisbane Lions,"Black, Simon",15,4,1,11,0,0,0,1
Brisbane Lions,"Brown, Jonathan",14,9,9,5,4,3,1,0
Brisbane Lions,"Crisp, Jack",6,2,3,4,0,0,0,4
Brisbane Lions,"Drummond, Josh",12,11,3,1,0,0,0,3
Brisbane Lions,"Green, Josh",12,7,1,5,2,0,0,1
Brisbane Lions,"Hanley, Pearce",11,6,2,5,0,0,1,0
Brisbane Lions,"Harwood, Ryan",19,8,3,11,0,1,0,4
Brisbane Lions,"Hudson, Ben",16,7,2,9,0,0,31,1
Brisbane Lions,"Karnezis, Patrick",7,3,1,4,0,0,0,3
Brisbane Lions,"Lisle, Jordan",11,6,3,5,0,2,7,2
Brisbane Lions,"Merrett, Daniel",11,7,3,4,0,0,0,2
Brisbane Lions,"Patfull, Joel",12,6,4,6,0,0,0,4
Brisbane Lions,"Polkinghorne, James",12,7,4,5,1,0,0,3
Brisbane Lions,"Raines, Andrew",15,9,2,6,0,2,0,2
Brisbane Lions,"Redden, Jack",23,10,4,13,1,0,0,6
Brisbane Lions,"Rich, Daniel",23,14,5,9,0,0,0,5
Brisbane Lions,"Rockliff, Tom",21,9,3,12,2,0,0,4
Brisbane Lions,"Wrigley, Stephen",8,6,2,2,0,0,0,3
Brisbane Lions,"Yeo, Elliot",14,10,4,4,0,0,0,0
Brisbane Lions,"Zorko, Dayne",19,8,4,11,2,1,0,9
Brisbane Lions,"Adcock, Jed",17,10,5,7,0,0,0,2
Brisbane Lions,"Banfield, Todd",5,3,0,2,0,1,0,2
Brisbane Lions,"Beams, Claye",9,5,1,4,2,0,0,1
Brisbane Lions,"Bewick, Rohan",17,12,7,5,2,3,0,3
Brisbane Lions,"Black, Simon",15,5,2,10,0,0,0,3
Brisbane Lions,"Brown, Jonathan",13,8,4,5,2,2,2,2
Brisbane Lions,"Green, Josh",17,8,1,9,2,3,0,2
Brisbane Lions,"Hanley, Pearce",20,13,6,7,0,0,0,2
Brisbane Lions,"Harwood, Ryan",14,9,1,5,0,1,0,1
Brisbane Lions,"Hudson, Ben",10,1,2,9,0,0,21,0
Brisbane Lions,"Lester, Ryan",20,13,4,7,1,0,0,1
Brisbane Lions,"Lisle, Jordan",19,12,10,7,0,2,2,1
Brisbane Lions,"Merrett, Daniel",17,11,10,6,0,0,0,0
Brisbane Lions,"Patfull, Joel",12,9,8,3,0,0,0,2
Brisbane Lions,"Polkinghorne, James",12,4,3,8,0,0,0,1
Brisbane Lions,"Raines, Andrew",11,7,2,4,0,1,0,3
Brisbane Lions,"Redden, Jack",27,13,6,14,0,0,0,6
Brisbane Lions,"Rich, Daniel",15,7,2,8,0,1,0,2
Brisbane Lions,"Rockliff, Tom",19,9,2,10,0,0,0,4
Brisbane Lions,"Wrigley, Stephen",17,12,5,5,0,0,0,2
Brisbane Lions,"Yeo, Elliot",11,6,3,5,0,0,0,2
Brisbane Lions,"Zorko, Dayne",14,7,3,7,1,0,0,4
Brisbane Lions,"Adcock, Jed",22,14,6,8,0,0,0,3
Brisbane Lions,"Beams, Claye",19,13,6,6,0,0,0,2
Brisbane Lions,"Bewick, Rohan",10,8,4,2,3,1,0,1
Brisbane Lions,"Black, Simon",25,11,3,14,1,1,0,4
Brisbane Lions,"Brown, Jonathan",15,9,6,6,2,0,0,1
Brisbane Lions,"Crisp, Jack",5,1,0,4,0,0,0,3
Brisbane Lions,"Green, Josh",14,11,6,3,0,2,0,3
Brisbane Lions,"Hanley, Pearce",27,16,6,11,0,1,0,1
Brisbane Lions,"Harwood, Ryan",16,7,4,9,0,0,0,1
Brisbane Lions,"Hudson, Ben",16,7,3,9,1,0,17,3
Brisbane Lions,"Lester, Ryan",20,11,3,9,0,0,0,0
Brisbane Lions,"Lisle, Jordan",13,7,5,6,1,0,2,0
Brisbane Lions,"Maguire, Matt",3,3,1,0,0,0,0,0
Brisbane Lions,"Merrett, Daniel",13,7,4,6,0,0,0,3
Brisbane Lions,"Patfull, Joel",14,8,5,6,0,0,0,3
Brisbane Lions,"Polkinghorne, James",11,7,3,4,1,0,0,1
Brisbane Lions,"Raines, Andrew",22,13,1,9,1,0,0,6
Brisbane Lions,"Redden, Jack",30,14,3,16,0,1,2,9
Brisbane Lions,"Rich, Daniel",22,14,5,8,2,2,0,1
Brisbane Lions,"Rockliff, Tom",16,11,6,5,1,3,0,4
Brisbane Lions,"Yeo, Elliot",12,4,2,8,0,0,0,1
Brisbane Lions,"Zorko, Dayne",22,8,5,14,0,1,0,6
Brisbane Lions,"Adcock, Jed",12,9,3,3,0,0,0,3
Brisbane Lions,"Beams, Claye",15,9,6,6,2,1,0,1
Brisbane Lions,"Bewick, Rohan",8,4,2,4,1,0,0,3
Brisbane Lions,"Black, Simon",27,12,1,15,0,0,0,4
Brisbane Lions,"Brown, Jonathan",12,9,6,3,4,0,1,0
Brisbane Lions,"Crisp, Jack",7,3,1,4,0,0,0,3
Brisbane Lions,"Drummond, Josh",3,2,0,1,0,0,0,0
Brisbane Lions,"Green, Josh",12,9,3,3,3,0,0,3
Brisbane Lions,"Hanley, Pearce",20,14,3,6,0,0,0,2
Brisbane Lions,"Harwood, Ryan",14,7,1,7,0,0,0,0
Brisbane Lions,"Hawksley, James",17,8,6,9,0,0,0,1
Brisbane Lions,"Hudson, Ben",9,4,0,5,0,0,38,3
Brisbane Lions,"Lester, Ryan",9,7,2,2,0,0,0,1
Brisbane Lions,"Lisle, Jordan",11,4,2,7,1,0,3,0
Brisbane Lions,"Merrett, Daniel",10,9,3,1,0,0,0,1
Brisbane Lions,"Patfull, Joel",9,5,5,4,0,0,0,2
Brisbane Lions,"Polkinghorne, James",9,7,0,2,0,1,1,2
Brisbane Lions,"Raines, Andrew",20,17,3,3,1,0,0,7
Brisbane Lions,"Redden, Jack",24,9,3,15,1,0,0,13
Brisbane Lions,"Rich, Daniel",23,13,2,10,0,1,0,7
Brisbane Lions,"Rockliff, Tom",16,12,3,4,0,2,0,4
Brisbane Lions,"Zorko, Dayne",23,15,3,8,3,2,0,6
Brisbane Lions,"Adcock, Jed",20,15,3,5,0,0,0,3
Brisbane Lions,"Beams, Claye",26,18,5,8,1,1,0,5
Brisbane Lions,"Bewick, Rohan",13,9,5,4,2,2,0,2
Brisbane Lions,"Black, Simon",24,9,6,15,0,1,0,1
Brisbane Lions,"Brown, Jonathan",12,10,9,2,5,1,1,1
Brisbane Lions,"Buchanan, Amon",19,7,2,12,0,1,0,2
Brisbane Lions,"Green, Josh",16,8,2,8,1,0,0,2
Brisbane Lions,"Hanley, Pearce",22,18,11,4,1,0,0,2
Brisbane Lions,"Harwood, Ryan",8,2,0,6,0,0,0,3
Brisbane Lions,"Hawksley, James",16,11,4,5,0,0,2,0
Brisbane Lions,"Hudson, Ben",14,4,0,10,0,1,21,0
Brisbane Lions,"Lester, Ryan",17,6,7,11,0,0,0,1
Brisbane Lions,"Lisle, Jordan",12,8,6,4,2,0,5,2
Brisbane Lions,"Merrett, Daniel",14,8,6,6,0,0,0,0
Brisbane Lions,"Patfull, Joel",11,6,6,5,0,0,0,1
Brisbane Lions,"Polkinghorne, James",13,8,4,5,1,1,0,1
Brisbane Lions,"Raines, Andrew",16,9,0,7,1,0,0,4
Brisbane Lions,"Redden, Jack",26,14,6,12,1,0,1,6
Brisbane Lions,"Rich, Daniel",25,18,7,7,4,1,0,3
Brisbane Lions,"Rockliff, Tom",16,8,1,8,0,1,0,2
Brisbane Lions,"Yeo, Elliot",13,4,5,9,0,0,0,3
Brisbane Lions,"Zorko, Dayne",21,9,5,12,0,2,0,4
Carlton,"Armfield, Dennis",19,15,6,4,2,0,0,2
Carlton,"Betts, Eddie",13,8,2,5,2,3,0,0
Carlton,"Bower, Paul",12,11,6,1,0,0,0,1
Carlton,"Carrazzo, Andrew",31,16,4,15,0,0,0,5
Carlton,"Curnow, Ed",18,7,4,11,0,1,0,6
Carlton,"Garlett, Jeff",11,8,3,3,1,2,0,2
Carlton,"Gibbs, Bryce",22,13,10,9,0,0,0,4
Carlton,"Hampson, Shaun",11,7,4,4,3,1,10,3
Carlton,"Henderson, Lachie",16,12,6,4,0,0,0,0
Carlton,"Judd, Chris",26,8,3,18,0,0,0,6
Carlton,"Kreuzer, Matthew",16,8,5,8,1,0,15,5
Carlton,"Laidler, Jeremy",16,9,5,7,0,0,0,2
Carlton,"Lucas, Kane",5,2,1,3,2,0,0,3
Carlton,"Murphy, Marc",32,12,5,20,1,1,0,4
Carlton,"Robinson, Mitch",17,14,5,3,1,2,1,3
Carlton,"Russell, Jordan",5,3,3,2,0,0,0,1
Carlton,"Scotland, Heath",19,10,4,9,0,0,0,5
Carlton,"Simpson, Kade",25,18,6,7,1,0,0,3
Carlton,"Thornton, Bret",15,10,7,5,1,3,0,1
Carlton,"Tuohy, Zach",13,6,3,7,0,0,0,4
Carlton,"Waite, Jarrad",11,9,8,2,1,1,0,1
Carlton,"Yarran, Chris",22,13,3,9,2,0,0,3
Carlton,"Armfield, Dennis",8,4,2,4,0,0,0,2
Carlton,"Betts, Eddie",13,9,4,4,2,3,0,5
Carlton,"Bower, Paul",24,15,9,9,0,0,0,1
Carlton,"Carrazzo, Andrew",31,12,4,19,0,0,0,2
Carlton,"Curnow, Ed",18,10,4,8,0,1,0,3
Carlton,"Garlett, Jeff",11,9,5,2,3,0,0,2
Carlton,"Gibbs, Bryce",19,11,2,8,0,1,0,1
Carlton,"Hampson, Shaun",7,2,2,5,1,0,25,3
Carlton,"Henderson, Lachie",13,8,2,5,0,0,0,3
Carlton,"Judd, Chris",33,15,4,18,3,0,0,6
Carlton,"Kreuzer, Matthew",13,11,4,2,1,1,24,3
Carlton,"Laidler, Jeremy",13,5,2,8,0,0,0,1
Carlton,"Lucas, Kane",13,9,4,4,1,0,0,3
Carlton,"Murphy, Marc",30,17,5,13,2,1,0,3
Carlton,"Robinson, Mitch",23,15,7,8,0,1,1,5
Carlton,"Russell, Jordan",4,4,1,0,0,0,0,3
Carlton,"Scotland, Heath",26,17,6,9,1,0,0,3
Carlton,"Simpson, Kade",23,18,7,5,2,2,1,5
Carlton,"Thornton, Bret",15,8,9,7,0,0,0,3
Carlton,"Tuohy, Zach",13,9,3,4,1,0,0,4
Carlton,"Waite, Jarrad",20,14,12,6,5,1,0,3
Carlton,"Yarran, Chris",22,17,6,5,1,1,0,1
Carlton,"Armfield, Dennis",16,9,3,7,0,0,0,7
Carlton,"Betts, Eddie",12,11,3,1,5,2,0,0
Carlton,"Bower, Paul",13,11,5,2,0,0,0,1
Carlton,"Carrazzo, Andrew",29,10,2,19,1,0,0,3
Carlton,"Curnow, Ed",21,11,6,10,0,0,0,1
Carlton,"Duigan, Nick",9,6,2,3,0,0,0,0
Carlton,"Garlett, Jeff",8,7,3,1,2,1,0,6
Carlton,"Gibbs, Bryce",32,21,9,11,0,0,0,4
Carlton,"Hampson, Shaun",14,6,6,8,2,0,26,3
Carlton,"Henderson, Lachie",13,10,7,3,0,0,0,1
Carlton,"Jamison, Michael",16,8,7,8,0,0,0,1
Carlton,"Judd, Chris",35,18,7,17,1,0,0,3
Carlton,"Kreuzer, Matthew",11,4,2,7,0,0,28,3
Carlton,"Laidler, Jeremy",8,5,4,3,0,0,0,1
Carlton,"Lucas, Kane",11,8,4,3,0,1,0,1
Carlton,"Murphy, Marc",39,22,6,17,2,1,0,2
Carlton,"Robinson, Mitch",28,14,8,14,0,1,2,7
Carlton,"Scotland, Heath",35,17,8,18,0,1,0,4
Carlton,"Simpson, Kade",20,8,6,12,0,0,0,3
Carlton,"Tuohy, Zach",11,7,1,4,1,1,0,1
Carlton,"Waite, Jarrad",17,15,10,2,3,1,0,2
Carlton,"Yarran, Chris",13,13,6,0,1,0,0,0
Carlton,"Betts, Eddie",9,7,1,2,4,1,0,2
Carlton,"Bower, Paul",9,6,1,3,0,0,0,4
Carlton,"Carrazzo, Andrew",0,0,0,0,0,0,0,0
Carlton,"Curnow, Ed",17,5,5,12,0,0,0,1
Carlton,"Duigan, Nick",12,7,1,5,0,0,0,5
Carlton,"Garlett, Jeff",11,9,4,2,1,0,0,4
Carlton,"Gibbs, Bryce",18,11,1,7,1,0,1,5
Carlton,"Hampson, Shaun",7,2,2,5,1,0,22,2
Carlton,"Henderson, Lachie",16,10,5,6,0,0,0,6
Carlton,"Jamison, Michael",9,5,3,4,0,1,0,2
Carlton,"Judd, Chris",24,10,2,14,1,1,0,3
Carlton,"Kreuzer, Matthew",10,2,5,8,0,0,12,2
Carlton,"Laidler, Jeremy",10,8,5,2,0,0,0,1
Carlton,"Lucas, Kane",16,9,5,7,0,2,0,5
Carlton,"McLean, Brock",17,4,0,13,1,0,0,3
Carlton,"Murphy, Marc",29,20,6,9,1,0,0,3
Carlton,"Robinson, Mitch",18,11,5,7,1,0,1,8
Carlton,"Scotland, Heath",28,10,3,18,0,0,0,6
Carlton,"Simpson, Kade",33,23,6,10,0,3,0,3
Carlton,"Tuohy, Zach",11,7,2,4,0,0,0,5
Carlton,"Waite, Jarrad",20,12,13,8,0,3,0,1
Carlton,"Yarran, Chris",12,8,1,4,0,0,0,1
Carlton,"Armfield, Dennis",8,5,1,3,0,0,0,8
Carlton,"Betts, Eddie",14,8,2,6,1,0,0,2
Carlton,"Curnow, Ed",20,11,6,9,0,0,0,6
Carlton,"Duigan, Nick",11,5,2,6,0,0,0,5
Carlton,"Garlett, Jeff",9,8,3,1,2,1,0,1
Carlton,"Gibbs, Bryce",25,18,7,7,0,0,0,2
Carlton,"Hampson, Shaun",9,3,3,6,1,0,28,3
Carlton,"Henderson, Lachie",19,13,10,6,0,0,0,1
Carlton,"Jamison, Michael",21,14,5,7,0,0,0,0
Carlton,"Joseph, Aaron",13,7,5,6,0,0,0,4
Carlton,"Judd, Chris",18,9,1,9,0,1,0,3
Carlton,"Kreuzer, Matthew",10,5,2,5,0,0,25,1
Carlton,"Lucas, Kane",3,1,0,2,0,0,0,1
Carlton,"Murphy, Marc",28,15,4,13,0,0,0,8
Carlton,"Robinson, Mitch",21,12,7,9,2,1,0,6
Carlton,"Russell, Jordan",20,11,8,9,0,0,0,4
Carlton,"Scotland, Heath",30,15,10,15,0,0,0,5
Carlton,"Simpson, Kade",35,20,13,15,1,0,1,1
Carlton,"Thornton, Bret",15,10,6,5,0,0,0,0
Carlton,"Tuohy, Zach",12,9,5,3,0,0,0,2
Carlton,"Waite, Jarrad",12,9,5,3,1,1,0,2
Carlton,"Walker, Andrew",19,15,4,4,2,0,0,3
Carlton,"Armfield, Dennis",8,6,1,2,0,1,0,3
Carlton,"Betts, Eddie",14,10,4,4,0,2,0,1
Carlton,"Bootsma, Josh",7,6,2,1,0,0,0,1
Carlton,"Bower, Paul",22,16,10,6,1,0,0,5
Carlton,"Duigan, Nick",18,12,5,6,0,1,0,3
Carlton,"Ellard, David",14,10,3,4,0,0,0,10
Carlton,"Garlett, Jeff",14,11,6,3,1,3,0,2
Carlton,"Gibbs, Bryce",21,16,5,5,0,1,0,5
Carlton,"Hampson, Shaun",15,8,7,7,3,0,31,0
Carlton,"Henderson, Lachie",9,8,4,1,0,0,1,0
Carlton,"Jamison, Michael",20,18,9,2,0,1,0,3
Carlton,"Joseph, Aaron",19,10,5,9,0,0,0,4
Carlton,"Kreuzer, Matthew",14,10,8,4,0,1,14,3
Carlton,"Lucas, Kane",10,10,6,0,2,1,0,5
Carlton,"Murphy, Marc",27,11,3,16,0,1,0,4
Carlton,"Robinson, Mitch",28,17,7,11,1,1,1,5
Carlton,"Russell, Jordan",21,7,8,14,0,0,0,7
Carlton,"Scotland, Heath",24,11,5,13,0,0,0,3
Carlton,"Simpson, Kade",25,13,7,12,2,2,0,7
Carlton,"Thornton, Bret",13,9,8,4,3,1,0,0
Carlton,"Tuohy, Zach",13,4,2,9,0,0,0,3
Carlton,"Walker, Andrew",20,13,7,7,2,2,0,3
Carlton,"Armfield, Dennis",14,8,1,6,0,0,0,2
Carlton,"Betts, Eddie",11,9,3,2,2,1,0,6
Carlton,"Bower, Paul",20,14,7,6,0,0,0,3
Carlton,"Curnow, Ed",21,7,2,14,0,0,0,6
Carlton,"Duigan, Nick",18,12,4,6,0,0,0,2
Carlton,"Ellard, David",13,10,3,3,3,1,0,3
Carlton,"Garlett, Jeff",9,8,3,1,0,0,0,3
Carlton,"Gibbs, Bryce",19,10,3,9,1,1,0,4
Carlton,"Hampson, Shaun",10,4,5,6,0,1,31,1
Carlton,"Henderson, Lachie",8,7,2,1,0,0,0,1
Carlton,"Jamison, Michael",10,5,2,5,0,0,0,0
Carlton,"Joseph, Aaron",2,1,1,1,0,0,0,1
Carlton,"Judd, Chris",29,14,3,15,1,0,0,6
Carlton,"Kreuzer, Matthew",16,10,3,6,1,1,29,2
Carlton,"Murphy, Marc",17,12,4,5,0,2,0,4
Carlton,"Robinson, Mitch",21,12,4,9,1,0,0,6
Carlton,"Russell, Jordan",10,2,3,8,0,1,0,7
Carlton,"Scotland, Heath",23,13,4,10,1,1,0,5
Carlton,"Simpson, Kade",16,13,3,3,1,1,0,8
Carlton,"Tuohy, Zach",10,3,0,7,0,0,0,4
Carlton,"Waite, Jarrad",11,6,2,5,1,0,0,2
Carlton,"Walker, Andrew",14,11,6,3,2,2,0,3
Carlton,"Armfield, Dennis",13,10,1,3,0,0,0,3
Carlton,"Betts, Eddie",11,6,3,5,0,0,0,2
Carlton,"Bower, Paul",11,8,4,3,0,0,0,2
Carlton,"Curnow, Ed",17,4,0,13,0,0,0,6
Carlton,"Duigan, Nick",5,1,3,4,0,0,0,6
Carlton,"Ellard, David",18,12,2,6,0,0,0,7
Carlton,"Garlett, Jeff",13,10,5,3,3,0,0,3
Carlton,"Gibbs, Bryce",12,5,1,7,0,1,0,5
Carlton,"Hampson, Shaun",5,2,1,3,0,0,29,2
Carlton,"Henderson, Lachie",10,6,6,4,1,0,0,4
Carlton,"Jamison, Michael",14,9,4,5,0,0,0,5
Carlton,"Judd, Chris",24,11,5,13,0,1,0,8
Carlton,"Kreuzer, Matthew",7,5,1,2,1,1,17,7
Carlton,"Murphy, Marc",5,3,0,2,0,0,0,3
Carlton,"Robinson, Mitch",16,7,3,9,0,0,0,2
Carlton,"Russell, Jordan",9,4,2,5,0,0,0,4
Carlton,"Scotland, Heath",33,15,1,18,0,0,0,1
Carlton,"Simpson, Kade",16,9,3,7,2,0,0,0
Carlton,"Thornton, Bret",4,3,2,1,1,1,0,2
Carlton,"Tuohy, Zach",8,6,1,2,0,0,0,3
Carlton,"Walker, Andrew",23,11,2,12,0,0,0,2
Carlton,"Yarran, Chris",11,8,4,3,0,1,0,2
Carlton,"Armfield, Dennis",6,2,2,4,1,1,0,4
Carlton,"Betts, Eddie",17,8,3,9,5,0,0,4
Carlton,"Bootsma, Josh",14,8,2,6,0,0,0,5
Carlton,"Bower, Paul",15,10,8,5,0,0,0,1
Carlton,"Collins, Andrew",17,10,1,7,0,0,0,5
Carlton,"Curnow, Ed",22,7,2,15,0,0,0,3
Carlton,"Ellard, David",29,17,3,12,0,2,0,7
Carlton,"Garlett, Jeff",10,5,2,5,0,1,0,3
Carlton,"Gibbs, Bryce",25,17,6,8,0,1,0,7
Carlton,"Hampson, Shaun",11,9,9,2,2,0,5,4
Carlton,"Jamison, Michael",20,15,7,5,0,0,0,2
Carlton,"Joseph, Aaron",18,9,3,9,0,0,0,2
Carlton,"Judd, Chris",21,7,0,14,0,1,0,3
Carlton,"Kreuzer, Matthew",20,9,3,11,1,0,11,1
Carlton,"Lucas, Kane",3,0,0,3,0,0,0,1
Carlton,"McLean, Brock",33,12,3,21,0,1,0,5
Carlton,"Robinson, Mitch",33,18,8,15,3,2,1,6
Carlton,"Scotland, Heath",23,10,5,13,0,1,0,5
Carlton,"Simpson, Kade",26,14,5,12,0,1,1,7
Carlton,"Tuohy, Zach",10,5,2,5,1,0,0,6
Carlton,"Walker, Andrew",25,17,6,8,2,1,0,5
Carlton,"Warnock, Robert",12,6,2,6,0,1,34,3
Carlton,"Armfield, Dennis",14,9,4,5,0,0,0,4
Carlton,"Betts, Eddie",11,4,4,7,1,1,0,1
Carlton,"Bootsma, Josh",17,8,4,9,0,0,0,6
Carlton,"Bower, Paul",11,7,5,4,0,0,0,4
Carlton,"Collins, Andrew",7,4,3,3,0,1,0,3
Carlton,"Curnow, Ed",8,5,1,3,0,0,0,3
Carlton,"Ellard, David",27,18,5,9,0,1,0,6
Carlton,"Garlett, Jeff",7,6,2,1,1,0,0,5
Carlton,"Gibbs, Bryce",19,13,2,6,1,0,0,3
Carlton,"Hampson, Shaun",9,7,4,2,1,0,14,1
Carlton,"Jamison, Michael",8,2,2,6,0,0,0,3
Carlton,"Joseph, Aaron",12,6,1,6,0,0,0,4
Carlton,"Judd, Chris",23,12,1,11,0,0,0,1
Carlton,"McLean, Brock",21,11,4,10,1,0,0,6
Carlton,"Robinson, Mitch",19,9,3,10,0,0,0,7
Carlton,"Scotland, Heath",24,14,3,10,0,0,0,4
Carlton,"Simpson, Kade",14,11,1,3,0,1,0,2
Carlton,"Tuohy, Zach",14,10,5,4,0,0,0,2
Carlton,"Walker, Andrew",16,8,0,8,1,1,0,10
Carlton,"Warnock, Robert",5,3,0,2,0,0,42,2
Carlton,"Watson, Matthew",14,12,7,2,0,0,0,1
Carlton,"Yarran, Chris",10,8,3,2,0,0,0,2
Carlton,"Armfield, Dennis",22,11,4,11,1,0,0,1
Carlton,"Betts, Eddie",14,10,4,4,4,2,0,4
Carlton,"Bootsma, Josh",7,5,4,2,0,1,0,1
Carlton,"Collins, Andrew",18,9,3,9,1,1,0,3
Carlton,"Duigan, Nick",20,13,4,7,0,0,0,1
Carlton,"Ellard, David",17,9,2,8,0,2,0,6
Carlton,"Garlett, Jeff",12,9,1,3,0,2,0,3
Carlton,"Gibbs, Bryce",11,6,2,5,1,0,0,2
Carlton,"Hampson, Shaun",8,1,1,7,0,0,18,1
Carlton,"Henderson, Lachie",10,8,6,2,0,2,0,2
Carlton,"Jamison, Michael",11,6,3,5,0,0,0,2
Carlton,"Joseph, Aaron",17,7,3,10,0,0,0,3
Carlton,"Judd, Chris",25,15,1,10,1,2,0,5
Carlton,"Kreuzer, Matthew",10,8,3,2,1,1,5,2
Carlton,"McLean, Brock",27,10,6,17,0,0,0,2
Carlton,"Robinson, Mitch",23,7,2,16,0,0,0,4
Carlton,"Simpson, Kade",31,23,6,8,1,1,0,1
Carlton,"Tuohy, Zach",14,8,2,6,1,0,0,3
Carlton,"Walker, Andrew",25,10,1,15,0,1,0,1
Carlton,"Warnock, Robert",9,6,3,3,0,0,30,1
Carlton,"Watson, Matthew",10,8,4,2,0,0,1,2
Carlton,"Yarran, Chris",6,4,3,2,0,2,0,0
Carlton,"Armfield, Dennis",18,13,2,5,1,0,0,1
Carlton,"Betts, Eddie",13,8,1,5,0,0,0,7
Carlton,"Carrazzo, Andrew",28,11,3,17,0,0,0,10
Carlton,"Collins, Andrew",8,5,2,3,1,0,0,0
Carlton,"Duigan, Nick",18,6,3,12,0,0,0,3
Carlton,"Ellard, David",19,8,3,11,0,1,1,10
Carlton,"Garlett, Jeff",6,5,2,1,1,1,0,3
Carlton,"Gibbs, Bryce",21,14,2,7,0,1,0,4
Carlton,"Henderson, Lachie",7,6,3,1,2,0,0,1
Carlton,"Jamison, Michael",11,8,2,3,0,0,0,0
Carlton,"Joseph, Aaron",12,11,4,1,0,0,0,2
Carlton,"Judd, Chris",12,6,2,6,0,1,0,8
Carlton,"Kreuzer, Matthew",15,10,2,5,2,0,12,4
Carlton,"McLean, Brock",17,6,0,11,0,1,0,4
Carlton,"Robinson, Mitch",15,12,6,3,0,0,1,6
Carlton,"Scotland, Heath",26,12,4,14,0,0,0,7
Carlton,"Simpson, Kade",18,13,4,5,1,0,0,3
Carlton,"Tuohy, Zach",10,8,1,2,1,0,0,4
Carlton,"Walker, Andrew",21,17,6,4,1,1,0,0
Carlton,"Warnock, Robert",2,1,0,1,0,0,25,4
Carlton,"Watson, Matthew",15,11,4,4,0,0,0,0
Carlton,"Yarran, Chris",5,5,0,0,0,1,0,3
Carlton,"Armfield, Dennis",11,7,4,4,2,0,0,6
Carlton,"Betts, Eddie",11,5,2,6,2,2,0,3
Carlton,"Bootsma, Josh",4,3,0,1,0,0,0,0
Carlton,"Carrazzo, Andrew",31,15,8,16,0,0,0,4
Carlton,"Duigan, Nick",15,5,7,10,0,0,0,0
Carlton,"Ellard, David",21,11,4,10,1,0,0,4
Carlton,"Garlett, Jeff",9,5,2,4,0,3,0,1
Carlton,"Gibbs, Bryce",25,17,8,8,0,0,0,4
Carlton,"Hampson, Shaun",13,10,7,3,1,2,0,1
Carlton,"Jamison, Michael",9,6,5,3,0,0,0,0
Carlton,"Joseph, Aaron",10,8,3,2,0,0,0,2
Carlton,"Judd, Chris",29,17,4,12,1,0,0,2
Carlton,"Kreuzer, Matthew",9,6,3,3,0,0,12,2
Carlton,"McLean, Brock",23,10,4,13,0,0,0,8
Carlton,"Robinson, Mitch",27,12,7,15,1,0,1,5
Carlton,"Scotland, Heath",27,13,6,14,0,0,0,4
Carlton,"Simpson, Kade",15,9,5,6,1,0,0,3
Carlton,"Tuohy, Zach",10,6,3,4,0,0,0,2
Carlton,"Walker, Andrew",24,15,5,9,0,0,0,1
Carlton,"Warnock, Robert",7,3,3,4,0,0,27,2
Carlton,"Watson, Matthew",13,12,4,1,0,0,0,1
Carlton,"Yarran, Chris",17,16,7,1,1,0,0,4
Carlton,"Armfield, Dennis",15,13,6,2,1,2,0,3
Carlton,"Betts, Eddie",15,10,7,5,4,1,0,2
Carlton,"Carrazzo, Andrew",26,13,9,13,0,0,0,7
Carlton,"Collins, Andrew",22,11,5,11,1,2,0,3
Carlton,"Curnow, Ed",24,12,6,12,0,0,0,6
Carlton,"Duigan, Nick",10,5,3,5,3,0,0,4
Carlton,"Garlett, Jeff",16,10,3,6,0,2,0,3
Carlton,"Gibbs, Bryce",27,17,5,10,0,0,0,3
Carlton,"Hampson, Shaun",1,0,0,1,0,0,1,0
Carlton,"Jamison, Michael",11,8,7,3,0,0,0,3
Carlton,"Joseph, Aaron",16,10,6,6,0,0,0,2
Carlton,"Judd, Chris",32,17,4,15,0,0,0,1
Carlton,"Kreuzer, Matthew",17,13,2,4,0,1,21,4
Carlton,"McInnes, Andrew",12,6,4,6,0,0,0,5
Carlton,"McLean, Brock",28,9,6,19,0,0,0,6
Carlton,"Robinson, Mitch",26,15,5,11,0,1,2,7
Carlton,"Scotland, Heath",27,10,6,17,0,0,0,1
Carlton,"Simpson, Kade",14,8,3,6,0,0,0,0
Carlton,"Tuohy, Zach",10,5,1,5,0,0,0,5
Carlton,"Walker, Andrew",19,6,2,13,2,0,0,1
Carlton,"Watson, Matthew",11,10,5,1,0,0,0,3
Carlton,"Yarran, Chris",23,16,7,7,1,1,0,1
Carlton,"Armfield, Dennis",25,14,9,11,2,0,0,3
Carlton,"Betts, Eddie",11,8,4,3,2,1,0,3
Carlton,"Carrazzo, Andrew",29,9,6,20,1,0,0,8
Carlton,"Collins, Andrew",25,16,7,9,0,0,0,5
Carlton,"Curnow, Ed",17,9,3,8,0,0,0,5
Carlton,"Duigan, Nick",8,4,1,4,1,0,0,1
Carlton,"Garlett, Jeff",13,7,4,6,1,3,0,3
Carlton,"Gibbs, Bryce",17,12,5,5,0,0,0,3
Carlton,"Henderson, Lachie",12,9,8,3,0,2,0,0
Carlton,"Jamison, Michael",15,8,6,7,0,0,0,1
Carlton,"Joseph, Aaron",9,7,3,2,0,0,0,2
Carlton,"Judd, Chris",36,21,10,15,3,0,0,2
Carlton,"Kreuzer, Matthew",6,2,0,4,0,0,29,0
Carlton,"Lucas, Kane",16,7,3,9,0,1,0,3
Carlton,"McInnes, Andrew",14,9,6,5,0,0,0,4
Carlton,"McLean, Brock",25,13,7,12,1,0,0,3
Carlton,"Murphy, Marc",24,15,6,9,1,2,0,4
Carlton,"Robinson, Mitch",23,15,8,8,1,1,2,5
Carlton,"Scotland, Heath",26,12,6,14,0,0,0,3
Carlton,"Walker, Andrew",0,0,0,0,0,0,0,1
Carlton,"Watson, Matthew",9,7,2,2,0,0,1,1
Carlton,"Yarran, Chris",18,17,3,1,1,0,0,1
Carlton,"Armfield, Dennis",13,7,1,6,0,0,0,0
Carlton,"Bell, Tom",13,11,1,2,1,1,0,4
Carlton,"Betts, Eddie",13,8,3,5,2,1,0,2
Carlton,"Bower, Paul",9,6,5,3,1,0,0,0
Carlton,"Carrazzo, Andrew",18,13,4,5,1,0,0,4
Carlton,"Casboult, Levi",7,5,5,2,0,0,9,3
Carlton,"Collins, Andrew",21,17,5,4,3,0,0,1
Carlton,"Curnow, Ed",17,7,2,10,0,0,0,6
Carlton,"Dale, Frazer",4,3,2,1,1,0,1,0
Carlton,"Duigan, Nick",7,5,0,2,0,0,0,7
Carlton,"Garlett, Jeff",20,13,7,7,2,1,0,3
Carlton,"Gibbs, Bryce",17,11,6,6,2,1,1,4
Carlton,"Jamison, Michael",9,6,5,3,0,0,0,1
Carlton,"Joseph, Aaron",11,5,2,6,1,0,0,0
Carlton,"McInnes, Andrew",13,9,5,4,0,0,0,2
Carlton,"McLean, Brock",29,14,6,15,0,0,1,6
Carlton,"Murphy, Marc",21,13,2,8,0,0,0,5
Carlton,"Russell, Jordan",16,8,7,8,0,0,0,0
Carlton,"Scotland, Heath",31,20,8,11,0,0,0,2
Carlton,"Thornton, Bret",16,9,6,7,2,0,6,1
Carlton,"Watson, Matthew",10,7,2,3,0,0,1,1
Carlton,"Yarran, Chris",20,15,7,5,0,0,0,0
Carlton,"Armfield, Dennis",13,8,4,5,2,1,0,2
Carlton,"Bell, Tom",16,10,3,6,1,0,0,7
Carlton,"Betts, Eddie",17,13,3,4,4,1,0,3
Carlton,"Carrazzo, Andrew",27,10,0,17,1,0,0,8
Carlton,"Casboult, Levi",8,6,3,2,1,1,5,0
Carlton,"Collins, Andrew",14,8,1,6,0,1,0,5
Carlton,"Curnow, Ed",25,4,2,21,0,0,0,10
Carlton,"Dale, Frazer",3,2,0,1,0,0,0,3
Carlton,"Davies, Marcus",7,6,0,1,0,0,0,2
Carlton,"Duigan, Nick",7,4,3,3,0,0,0,2
Carlton,"Garlett, Jeff",18,15,1,3,1,0,0,8
Carlton,"Gibbs, Bryce",20,15,3,5,0,0,0,5
Carlton,"Jamison, Michael",7,5,4,2,0,0,0,2
Carlton,"Joseph, Aaron",6,6,2,0,0,0,0,2
Carlton,"Kreuzer, Matthew",11,7,2,4,0,0,45,6
Carlton,"McInnes, Andrew",6,6,1,0,0,0,0,3
Carlton,"McLean, Brock",27,15,4,12,1,1,0,11
Carlton,"Murphy, Marc",36,16,2,20,1,0,0,3
Carlton,"Scotland, Heath",27,17,6,10,0,2,0,5
Carlton,"Thornton, Bret",7,7,4,0,2,1,4,1
Carlton,"Tuohy, Zach",11,7,1,4,0,0,0,1
Carlton,"Yarran, Chris",10,5,0,5,0,0,0,6
Carlton,"Armfield, Dennis",15,10,5,5,2,0,0,1
Carlton,"Bell, Tom",16,10,2,6,0,0,0,7
Carlton,"Betts, Eddie",12,4,3,8,0,0,0,5
Carlton,"Carrazzo, Andrew",19,7,3,12,0,0,0,6
Carlton,"Casboult, Levi",8,7,6,1,1,2,6,1
Carlton,"Collins, Andrew",13,8,3,5,0,1,0,5
Carlton,"Curnow, Ed",16,12,3,4,0,0,0,4
Carlton,"Davies, Marcus",4,4,3,0,0,0,0,0
Carlton,"Garlett, Jeff",15,10,5,5,2,0,0,4
Carlton,"Gibbs, Bryce",29,20,7,9,1,0,2,6
Carlton,"Jamison, Michael",11,8,4,3,0,0,0,3
Carlton,"Joseph, Aaron",12,8,5,4,0,0,0,1
Carlton,"Kreuzer, Matthew",8,5,3,3,0,1,24,3
Carlton,"McInnes, Andrew",16,14,7,2,0,0,0,2
Carlton,"McLean, Brock",29,16,5,13,0,1,0,8
Carlton,"Murphy, Marc",24,12,4,12,1,0,0,4
Carlton,"Scotland, Heath",24,13,9,11,0,0,0,1
Carlton,"Simpson, Kade",20,12,6,8,0,0,0,4
Carlton,"Tuohy, Zach",5,4,2,1,0,0,0,3
Carlton,"Waite, Jarrad",16,11,8,5,3,2,0,5
Carlton,"White, Simon",15,11,9,4,0,0,0,1
Carlton,"Yarran, Chris",20,12,5,8,0,0,0,1
Carlton,"Armfield, Dennis",16,9,6,7,2,0,0,0
Carlton,"Bell, Tom",18,10,3,8,1,0,0,0
Carlton,"Betts, Eddie",11,8,4,3,3,1,0,1
Carlton,"Carrazzo, Andrew",31,13,7,18,1,1,0,4
Carlton,"Casboult, Levi",11,7,6,4,2,3,7,4
Carlton,"Curnow, Ed",12,4,1,8,0,0,0,9
Carlton,"Garlett, Jeff",17,13,2,4,3,1,0,5
Carlton,"Gibbs, Bryce",33,21,12,12,1,1,0,4
Carlton,"Kreuzer, Matthew",13,8,4,5,2,0,26,5
Carlton,"McInnes, Andrew",13,10,6,3,0,0,0,2
Carlton,"McLean, Brock",20,8,6,12,0,0,0,2
Carlton,"Murphy, Marc",26,21,5,5,0,1,0,2
Carlton,"OKeeffe, Rhys",6,2,1,4,0,0,0,1
Carlton,"Robinson, Mitch",11,8,3,3,0,0,0,3
Carlton,"Scotland, Heath",32,16,11,16,0,0,0,3
Carlton,"Simpson, Kade",31,19,9,12,0,1,0,1
Carlton,"Tuohy, Zach",11,8,2,3,0,0,0,3
Carlton,"Waite, Jarrad",10,7,6,3,1,0,0,1
Carlton,"Walker, Andrew",20,11,5,9,1,2,0,1
Carlton,"Watson, Matthew",13,6,6,7,0,0,0,0
Carlton,"White, Simon",9,3,4,6,0,0,0,2
Carlton,"Yarran, Chris",16,8,4,8,0,0,0,0
Carlton,"Armfield, Dennis",15,10,3,5,0,1,0,4
Carlton,"Bell, Tom",7,4,3,3,0,0,0,3
Carlton,"Betts, Eddie",13,9,7,4,2,1,0,3
Carlton,"Carrazzo, Andrew",18,12,0,6,0,0,0,1
Carlton,"Casboult, Levi",12,6,6,6,3,1,5,3
Carlton,"Curnow, Ed",13,4,4,9,0,0,0,7
Carlton,"Duigan, Nick",15,7,6,8,0,0,0,3
Carlton,"Garlett, Jeff",16,12,9,4,3,2,0,1
Carlton,"Gibbs, Bryce",28,21,10,7,0,0,1,4
Carlton,"Judd, Chris",23,12,3,11,0,1,0,3
Carlton,"Kreuzer, Matthew",12,8,4,4,0,0,19,6
Carlton,"McInnes, Andrew",12,8,7,4,0,0,0,1
Carlton,"McLean, Brock",27,19,8,8,3,1,1,3
Carlton,"Murphy, Marc",37,23,9,14,2,0,0,6
Carlton,"Robinson, Mitch",11,5,1,6,0,0,2,3
Carlton,"Scotland, Heath",15,10,4,5,0,0,0,2
Carlton,"Simpson, Kade",27,16,10,11,3,1,0,3
Carlton,"Tuohy, Zach",7,5,0,2,0,0,0,3
Carlton,"Waite, Jarrad",17,13,5,4,5,1,0,4
Carlton,"Walker, Andrew",11,11,8,0,3,1,0,1
Carlton,"White, Simon",11,9,6,2,0,0,0,3
Carlton,"Yarran, Chris",17,14,4,3,0,0,0,4
Carlton,"Armfield, Dennis",12,6,4,6,0,0,0,1
Carlton,"Bell, Tom",21,13,4,8,0,0,1,5
Carlton,"Betts, Eddie",15,10,2,5,2,3,0,4
Carlton,"Carrazzo, Andrew",27,14,3,13,0,0,0,4
Carlton,"Casboult, Levi",8,6,5,2,0,5,11,1
Carlton,"Curnow, Ed",19,6,3,13,0,0,0,4
Carlton,"Duigan, Nick",13,7,2,6,0,0,0,2
Carlton,"Ellard, David",11,8,3,3,0,1,0,2
Carlton,"Garlett, Jeff",6,5,3,1,1,1,0,4
Carlton,"Gibbs, Bryce",15,11,5,4,0,0,0,2
Carlton,"Judd, Chris",26,10,3,16,2,1,0,1
Carlton,"Kreuzer, Matthew",11,7,3,4,0,0,38,4
Carlton,"McInnes, Andrew",0,0,0,0,0,0,0,0
Carlton,"McLean, Brock",26,11,6,15,2,0,0,5
Carlton,"Murphy, Marc",26,16,5,10,0,0,0,2
Carlton,"Scotland, Heath",33,17,5,16,0,1,0,2
Carlton,"Simpson, Kade",18,11,2,7,0,0,0,2
Carlton,"Tuohy, Zach",15,12,3,3,0,0,0,2
Carlton,"Waite, Jarrad",17,13,9,4,2,4,0,6
Carlton,"Walker, Andrew",21,9,1,12,0,0,0,2
Carlton,"White, Simon",9,4,2,5,0,0,0,1
Carlton,"Yarran, Chris",16,15,8,1,2,2,0,1
Carlton,"Armfield, Dennis",18,10,4,8,0,0,0,1
Carlton,"Bell, Tom",13,9,3,4,1,0,0,4
Carlton,"Betts, Eddie",15,9,3,6,1,4,0,2
Carlton,"Curnow, Ed",13,3,4,10,0,0,0,3
Carlton,"Duigan, Nick",12,6,3,6,1,0,0,3
Carlton,"Ellard, David",17,11,6,6,0,0,0,1
Carlton,"Garlett, Jeff",13,10,3,3,1,3,0,3
Carlton,"Gibbs, Bryce",26,17,3,9,0,1,0,10
Carlton,"Judd, Chris",10,7,2,3,0,0,0,1
Carlton,"Kreuzer, Matthew",14,8,1,6,0,1,44,3
Carlton,"McCarthy, Pat",10,6,5,4,0,0,0,0
Carlton,"McLean, Brock",39,21,13,18,1,3,0,6
Carlton,"Mitchell, Luke",8,7,3,1,1,2,2,0
Carlton,"Murphy, Marc",19,8,3,11,0,1,0,6
Carlton,"OKeeffe, Rhys",15,6,5,9,0,0,0,3
Carlton,"Robinson, Mitch",19,10,5,9,1,0,2,5
Carlton,"Scotland, Heath",20,11,2,9,0,0,0,1
Carlton,"Simpson, Kade",19,9,4,10,0,0,0,6
Carlton,"Waite, Jarrad",14,7,6,7,5,0,0,3
Carlton,"Walker, Andrew",17,15,3,2,0,0,0,2
Carlton,"White, Simon",9,4,3,5,0,0,0,2
Carlton,"Yarran, Chris",6,3,2,3,0,0,0,1
Collingwood,"Ball, Luke",21,13,4,8,0,0,0,10
Collingwood,"Blair, Jarryd",20,10,2,10,3,2,0,5
Collingwood,"Clarke, Martin",13,10,4,3,0,0,0,4
Collingwood,"Cloke, Travis",18,15,7,3,2,3,0,2
Collingwood,"Dawes, Chris",12,9,5,3,0,2,3,3
Collingwood,"Fasolo, Alex",12,9,3,3,2,2,0,3
Collingwood,"Goldsack, Tyson",13,8,4,5,0,0,0,0
Collingwood,"Jolly, Darren",15,6,3,9,2,1,28,3
Collingwood,"Keeffe, Lachlan",4,1,1,3,0,0,0,3
Collingwood,"Lumumba, Heritier",14,6,4,8,0,0,0,2
Collingwood,"Paine, Jackson",6,3,3,3,1,1,0,2
Collingwood,"Pendlebury, Scott",33,14,5,19,2,1,0,6
Collingwood,"Reid, Ben",11,7,5,4,0,0,0,1
Collingwood,"Rounds, Luke",10,7,4,3,0,2,0,3
Collingwood,"Seedsman, Paul",5,1,2,4,0,0,0,0
Collingwood,"Shaw, Heath",16,13,3,3,1,0,0,1
Collingwood,"Sidebottom, Steele",23,14,5,9,0,3,0,2
Collingwood,"Sinclair, Ben",11,9,1,2,0,0,0,4
Collingwood,"Swan, Dane",31,21,3,10,1,0,0,1
Collingwood,"Thomas, Dale",19,12,6,7,2,0,0,4
Collingwood,"Toovey, Alan",13,9,2,4,0,0,0,7
Collingwood,"Yagmoor, Peter",0,0,0,0,0,0,0,2
Collingwood,"Ball, Luke",20,11,5,9,0,1,0,6
Collingwood,"Beams, Dayne",22,11,5,11,0,0,0,1
Collingwood,"Blair, Jarryd",18,8,6,10,2,0,0,4
Collingwood,"Clarke, Martin",19,11,4,8,0,0,0,2
Collingwood,"Cloke, Travis",18,16,8,2,3,2,0,1
Collingwood,"Dawes, Chris",12,4,5,8,0,1,2,1
Collingwood,"Fasolo, Alex",13,9,5,4,2,1,0,2
Collingwood,"Goldsack, Tyson",14,8,7,6,0,1,0,1
Collingwood,"Jolly, Darren",5,2,1,3,1,0,25,3
Collingwood,"Keeffe, Lachlan",14,9,3,5,0,0,0,0
Collingwood,"Lumumba, Heritier",23,15,6,8,0,0,0,1
Collingwood,"Paine, Jackson",9,5,2,4,1,0,0,1
Collingwood,"Pendlebury, Scott",29,17,5,12,0,0,0,8
Collingwood,"Reid, Ben",15,9,6,6,0,0,0,2
Collingwood,"Seedsman, Paul",10,4,5,6,0,0,0,2
Collingwood,"Shaw, Heath",14,13,6,1,0,0,0,3
Collingwood,"Sidebottom, Steele",24,14,5,10,0,0,0,2
Collingwood,"Sinclair, Ben",9,5,3,4,0,1,0,1
Collingwood,"Swan, Dane",32,19,6,13,0,3,0,3
Collingwood,"Tarrant, Chris",1,1,1,0,0,0,0,0
Collingwood,"Thomas, Dale",16,10,4,6,3,0,0,4
Collingwood,"Toovey, Alan",12,6,2,6,0,0,0,3
Collingwood,"Ball, Luke",9,4,1,5,0,0,0,1
Collingwood,"Beams, Dayne",22,15,6,7,1,1,0,2
Collingwood,"Blair, Jarryd",17,9,1,8,0,2,0,4
Collingwood,"Clarke, Martin",20,12,6,8,0,0,0,1
Collingwood,"Cloke, Travis",12,9,5,3,1,0,0,1
Collingwood,"Dawes, Chris",13,7,4,6,1,1,0,4
Collingwood,"Fasolo, Alex",15,9,5,6,1,0,0,5
Collingwood,"Goldsack, Tyson",12,5,3,7,1,0,0,2
Collingwood,"Jolly, Darren",7,2,3,5,0,0,17,2
Collingwood,"Keeffe, Lachlan",16,14,10,2,0,0,0,1
Collingwood,"Lumumba, Heritier",19,12,7,7,0,0,0,3
Collingwood,"Maxwell, Nick",13,8,5,5,0,0,1,1
Collingwood,"Pendlebury, Scott",15,10,3,5,0,0,0,3
Collingwood,"Reid, Ben",3,2,0,1,0,0,0,1
Collingwood,"Shaw, Heath",22,19,4,3,1,0,0,2
Collingwood,"Sidebottom, Steele",21,15,9,6,2,0,0,4
Collingwood,"Sinclair, Ben",4,2,1,2,0,1,0,0
Collingwood,"Swan, Dane",31,19,8,12,0,0,0,1
Collingwood,"Thomas, Dale",22,14,6,8,1,0,0,3
Collingwood,"Toovey, Alan",12,7,3,5,0,0,0,2
Collingwood,"Wellingham, Sharrod",16,10,0,6,0,1,0,5
Collingwood,"Wood, Cameron",11,4,5,7,0,0,8,0
Collingwood,"Beams, Dayne",27,13,1,14,1,0,0,2
Collingwood,"Blair, Jarryd",16,7,4,9,0,0,0,5
Collingwood,"Buckley, Simon",17,9,4,8,0,0,0,2
Collingwood,"Clarke, Martin",20,15,6,5,0,1,0,6
Collingwood,"Cloke, Travis",17,14,9,3,4,2,0,1
Collingwood,"Dawes, Chris",15,7,5,8,1,1,6,2
Collingwood,"Fasolo, Alex",14,6,5,8,1,0,0,2
Collingwood,"Goldsack, Tyson",15,9,5,6,0,0,0,3
Collingwood,"Johnson, Ben",13,8,1,5,0,0,0,2
Collingwood,"Jolly, Darren",14,7,5,7,0,1,36,4
Collingwood,"Keeffe, Lachlan",9,7,5,2,0,0,0,0
Collingwood,"Lumumba, Heritier",29,16,6,13,0,0,0,1
Collingwood,"Maxwell, Nick",15,7,5,8,0,0,1,3
Collingwood,"Paine, Jackson",5,4,1,1,1,0,0,3
Collingwood,"Pendlebury, Scott",29,13,7,16,0,0,0,8
Collingwood,"Seedsman, Paul",12,6,3,6,1,0,0,0
Collingwood,"Sidebottom, Steele",26,21,6,5,2,0,0,3
Collingwood,"Sinclair, Ben",12,7,2,5,1,1,0,2
Collingwood,"Swan, Dane",36,18,4,18,0,2,0,7
Collingwood,"Toovey, Alan",12,7,3,5,0,0,0,5
Collingwood,"Wellingham, Sharrod",19,10,2,9,2,1,0,4
Collingwood,"Young, Tom",8,5,2,3,0,1,1,7
Collingwood,"Beams, Dayne",32,18,7,14,1,0,0,3
Collingwood,"Blair, Jarryd",15,6,1,9,2,0,0,1
Collingwood,"Brown, Nathan",10,5,3,5,0,0,0,3
Collingwood,"Buckley, Simon",16,12,2,4,0,1,0,3
Collingwood,"Clarke, Martin",13,9,3,4,0,0,0,1
Collingwood,"Cloke, Travis",12,11,7,1,3,1,0,0
Collingwood,"Dawes, Chris",14,6,5,8,0,0,6,2
Collingwood,"Fasolo, Alex",13,7,2,6,0,2,0,6
Collingwood,"Goldsack, Tyson",10,7,3,3,0,2,0,7
Collingwood,"Johnson, Ben",27,21,4,6,0,0,0,1
Collingwood,"Jolly, Darren",9,4,2,5,1,0,34,8
Collingwood,"Keeffe, Lachlan",12,7,3,5,0,0,0,1
Collingwood,"Lumumba, Heritier",16,8,2,8,0,0,0,3
Collingwood,"Maxwell, Nick",16,10,1,6,0,0,0,3
Collingwood,"Pendlebury, Scott",34,18,5,16,0,0,0,3
Collingwood,"Seedsman, Paul",4,3,1,1,0,1,0,7
Collingwood,"Sidebottom, Steele",28,19,5,9,1,0,0,3
Collingwood,"Sinclair, Ben",11,8,2,3,0,2,0,9
Collingwood,"Swan, Dane",42,28,6,14,3,1,0,6
Collingwood,"Toovey, Alan",15,13,2,2,0,0,0,7
Collingwood,"Ugle, Kirk",5,2,1,3,0,0,0,0
Collingwood,"Wellingham, Sharrod",18,11,2,7,0,1,0,8
Collingwood,"Beams, Dayne",33,14,4,19,0,1,0,11
Collingwood,"Brown, Nathan",12,6,2,6,0,0,0,3
Collingwood,"Buckley, Simon",30,20,3,10,0,0,0,2
Collingwood,"Clarke, Martin",26,14,1,12,0,0,0,4
Collingwood,"Cloke, Travis",13,11,8,2,2,0,0,2
Collingwood,"Dawes, Chris",11,6,3,5,1,2,2,2
Collingwood,"Fasolo, Alex",11,7,4,4,1,1,0,1
Collingwood,"Goldsack, Tyson",8,5,3,3,2,1,0,3
Collingwood,"Johnson, Ben",7,4,1,3,0,0,0,0
Collingwood,"Keeffe, Lachlan",15,12,7,3,0,0,0,2
Collingwood,"Lumumba, Heritier",11,9,3,2,1,1,0,1
Collingwood,"Maxwell, Nick",12,2,3,10,0,0,0,3
Collingwood,"Pendlebury, Scott",34,14,5,20,0,0,0,9
Collingwood,"Reid, Ben",15,8,2,7,1,1,0,1
Collingwood,"Shaw, Heath",22,16,2,6,2,0,0,8
Collingwood,"Sidebottom, Steele",29,11,5,18,1,0,0,6
Collingwood,"Sinclair, Ben",13,8,3,5,2,0,0,3
Collingwood,"Swan, Dane",29,15,4,14,1,0,0,6
Collingwood,"Toovey, Alan",15,11,2,4,0,0,0,5
Collingwood,"Ugle, Kirk",5,3,3,2,0,0,0,1
Collingwood,"Wellingham, Sharrod",14,7,1,7,1,1,1,4
Collingwood,"Wood, Cameron",10,6,2,4,0,0,33,2
Collingwood,"Beams, Dayne",30,15,8,15,0,1,0,5
Collingwood,"Blair, Jarryd",21,6,2,15,0,0,0,6
Collingwood,"Brown, Nathan",4,3,1,1,0,0,0,1
Collingwood,"Buckley, Simon",17,10,4,7,0,1,0,1
Collingwood,"Clarke, Martin",24,12,6,12,0,0,0,3
Collingwood,"Cloke, Travis",13,11,8,2,2,0,0,1
Collingwood,"Didak, Alan",25,18,6,7,1,2,0,4
Collingwood,"Goldsack, Tyson",8,4,2,4,3,0,1,5
Collingwood,"Keeffe, Lachlan",9,6,4,3,1,0,6,1
Collingwood,"Lumumba, Heritier",28,9,6,19,0,0,0,2
Collingwood,"Maxwell, Nick",21,14,7,7,0,0,2,2
Collingwood,"Pendlebury, Scott",33,20,3,13,0,1,1,5
Collingwood,"Reid, Ben",15,9,6,6,0,0,0,0
Collingwood,"Seedsman, Paul",17,5,4,12,0,0,0,1
Collingwood,"Shaw, Heath",28,23,7,5,1,0,0,1
Collingwood,"Sidebottom, Steele",35,16,5,19,2,0,0,1
Collingwood,"Sinclair, Ben",16,10,4,6,2,0,0,2
Collingwood,"Swan, Dane",34,22,13,12,2,2,0,0
Collingwood,"Toovey, Alan",17,11,6,6,0,1,0,2
Collingwood,"Wellingham, Sharrod",23,13,5,10,1,1,0,1
Collingwood,"Wood, Cameron",14,8,3,6,2,0,32,3
Collingwood,"Yagmoor, Peter",11,9,4,2,0,1,0,0
Collingwood,"Beams, Dayne",28,18,3,10,0,1,0,4
Collingwood,"Blair, Jarryd",15,3,0,12,1,0,0,5
Collingwood,"Buckley, Simon",7,3,2,4,0,0,0,0
Collingwood,"Clarke, Martin",17,9,3,8,0,0,0,3
Collingwood,"Cloke, Travis",15,13,6,2,2,1,0,2
Collingwood,"Dawes, Chris",14,7,7,7,1,1,5,2
Collingwood,"Didak, Alan",14,10,3,4,0,0,0,0
Collingwood,"Fasolo, Alex",16,11,2,5,3,2,0,0
Collingwood,"Goldsack, Tyson",13,6,5,7,2,0,0,3
Collingwood,"Jolly, Darren",13,5,1,8,0,0,28,1
Collingwood,"Keeffe, Lachlan",13,9,7,4,0,0,0,0
Collingwood,"Lumumba, Heritier",15,8,4,7,0,0,0,2
Collingwood,"Maxwell, Nick",12,6,6,6,0,0,0,2
Collingwood,"Pendlebury, Scott",30,16,3,14,4,0,0,6
Collingwood,"Reid, Ben",15,12,6,3,0,0,1,3
Collingwood,"Shaw, Heath",30,22,9,8,0,0,0,2
Collingwood,"Sidebottom, Steele",38,22,9,16,0,1,0,3
Collingwood,"Sinclair, Ben",16,9,2,7,0,1,0,4
Collingwood,"Swan, Dane",27,15,2,12,1,1,0,4
Collingwood,"Thomas, Dale",18,10,5,8,0,1,0,3
Collingwood,"Toovey, Alan",12,7,5,5,0,0,0,3
Collingwood,"Wellingham, Sharrod",20,9,7,11,0,1,0,3
Collingwood,"Beams, Dayne",36,16,5,20,2,0,0,5
Collingwood,"Blair, Jarryd",23,9,2,14,0,2,0,2
Collingwood,"Buckley, Simon",21,12,4,9,0,0,0,1
Collingwood,"Clarke, Martin",17,13,4,4,0,1,0,2
Collingwood,"Cloke, Travis",4,2,1,2,0,1,0,3
Collingwood,"Dawes, Chris",11,5,3,6,0,1,4,3
Collingwood,"Didak, Alan",21,16,3,5,1,2,0,2
Collingwood,"Elliott, Jamie",1,1,1,0,0,0,0,2
Collingwood,"Fasolo, Alex",6,3,2,3,0,0,0,5
Collingwood,"Goldsack, Tyson",14,9,4,5,2,2,0,5
Collingwood,"Jolly, Darren",5,2,2,3,0,1,29,3
Collingwood,"Keeffe, Lachlan",8,4,2,4,0,0,0,3
Collingwood,"Lumumba, Heritier",18,9,3,9,0,0,0,4
Collingwood,"Maxwell, Nick",12,5,1,7,0,0,6,6
Collingwood,"Pendlebury, Scott",29,16,1,13,1,1,0,1
Collingwood,"Shaw, Heath",22,15,5,7,1,1,0,0
Collingwood,"Sidebottom, Steele",31,19,6,12,2,2,0,5
Collingwood,"Sinclair, Ben",14,5,1,9,0,0,0,4
Collingwood,"Thomas, Dale",29,18,7,11,0,0,0,7
Collingwood,"Toovey, Alan",15,8,3,7,0,0,0,9
Collingwood,"Wellingham, Sharrod",19,11,2,8,1,0,0,3
Collingwood,"Williams, Marley",11,8,3,3,0,0,0,0
Collingwood,"Beams, Dayne",32,12,3,20,1,0,0,3
Collingwood,"Blair, Jarryd",24,9,0,15,0,0,0,5
Collingwood,"Brown, Nathan",12,7,4,5,0,0,0,3
Collingwood,"Buckley, Simon",25,17,7,8,1,0,0,0
Collingwood,"Clarke, Martin",20,13,6,7,0,0,0,2
Collingwood,"Cloke, Travis",19,15,9,4,3,4,0,3
Collingwood,"Dawes, Chris",15,7,3,8,0,0,5,2
Collingwood,"Didak, Alan",29,21,9,8,2,0,0,2
Collingwood,"Elliott, Jamie",18,15,7,3,3,1,0,2
Collingwood,"Fasolo, Alex",21,13,8,8,2,0,0,3
Collingwood,"Goldsack, Tyson",11,8,4,3,1,0,0,5
Collingwood,"Lumumba, Heritier",16,11,5,5,0,0,0,1
Collingwood,"Maxwell, Nick",17,11,7,6,0,0,2,1
Collingwood,"Pendlebury, Scott",17,8,1,9,1,0,0,2
Collingwood,"Sidebottom, Steele",24,11,2,13,0,0,0,2
Collingwood,"Sinclair, Ben",10,4,2,6,3,0,0,1
Collingwood,"Thomas, Dale",32,18,5,14,3,0,0,4
Collingwood,"Ugle, Kirk",8,2,0,6,0,0,0,2
Collingwood,"Wellingham, Sharrod",27,19,9,8,1,3,0,4
Collingwood,"Williams, Marley",17,12,4,5,1,0,0,6
Collingwood,"Wood, Cameron",23,11,5,12,1,0,25,4
Collingwood,"Young, Tom",11,3,4,8,0,0,0,2
Collingwood,"Beams, Dayne",37,20,9,17,1,3,0,6
Collingwood,"Blair, Jarryd",27,11,4,16,2,1,0,6
Collingwood,"Brown, Nathan",18,10,6,8,0,0,0,1
Collingwood,"Buckley, Simon",19,7,0,12,0,1,0,2
Collingwood,"Clarke, Martin",14,7,1,7,0,1,0,2
Collingwood,"Cloke, Travis",16,11,6,5,2,0,0,3
Collingwood,"Dawes, Chris",19,14,8,5,0,1,7,5
Collingwood,"Didak, Alan",1,1,1,0,0,0,0,0
Collingwood,"Elliott, Jamie",9,6,2,3,0,1,0,7
Collingwood,"Fasolo, Alex",17,14,6,3,2,0,0,1
Collingwood,"Goldsack, Tyson",15,10,7,5,2,1,0,2
Collingwood,"Jolly, Darren",12,5,3,7,2,0,34,7
Collingwood,"Lumumba, Heritier",10,6,2,4,0,0,0,3
Collingwood,"Maxwell, Nick",7,4,3,3,0,0,0,3
Collingwood,"Sidebottom, Steele",36,21,7,15,1,1,0,7
Collingwood,"Sinclair, Ben",12,8,5,4,3,0,0,0
Collingwood,"Swan, Dane",42,23,8,19,2,1,0,1
Collingwood,"Tarrant, Chris",11,9,5,2,0,0,0,3
Collingwood,"Thomas, Dale",20,11,6,9,0,2,0,1
Collingwood,"Wellingham, Sharrod",21,19,10,2,2,1,0,5
Collingwood,"Williams, Marley",11,6,2,5,0,0,0,4
Collingwood,"Young, Tom",10,5,4,5,0,0,0,2
Collingwood,"Beams, Dayne",34,18,1,16,3,0,0,3
Collingwood,"Blair, Jarryd",20,8,3,12,2,0,0,5
Collingwood,"Brown, Nathan",15,8,5,7,0,0,0,1
Collingwood,"Buckley, Simon",22,12,4,10,0,0,0,1
Collingwood,"Clarke, Martin",12,6,3,6,0,0,0,0
Collingwood,"Cloke, Travis",11,9,6,2,5,1,0,2
Collingwood,"Dawes, Chris",11,5,3,6,0,2,2,1
Collingwood,"Elliott, Jamie",15,12,9,3,0,1,0,4
Collingwood,"Fasolo, Alex",16,11,6,5,2,0,0,2
Collingwood,"Goldsack, Tyson",10,4,1,6,0,3,0,2
Collingwood,"Jolly, Darren",16,5,4,11,0,0,23,1
Collingwood,"Lumumba, Heritier",15,9,2,6,0,1,0,1
Collingwood,"Maxwell, Nick",21,11,6,10,0,0,1,5
Collingwood,"Reid, Ben",13,5,5,8,0,0,0,1
Collingwood,"Shaw, Heath",21,15,4,6,0,0,0,3
Collingwood,"Sidebottom, Steele",25,15,2,10,0,2,0,2
Collingwood,"Swan, Dane",38,21,11,17,0,1,0,1
Collingwood,"Thomas, Dale",21,9,3,12,0,0,0,6
Collingwood,"Toovey, Alan",8,3,0,5,0,0,0,8
Collingwood,"Wellingham, Sharrod",16,10,5,6,0,1,0,5
Collingwood,"Williams, Marley",13,13,2,0,0,0,0,4
Collingwood,"Young, Tom",1,0,0,1,0,0,0,2
Collingwood,"Beams, Dayne",32,19,3,13,1,1,0,4
Collingwood,"Blair, Jarryd",32,19,5,13,0,2,0,8
Collingwood,"Brown, Nathan",8,5,4,3,0,0,0,3
Collingwood,"Buckley, Simon",19,11,6,8,1,1,1,3
Collingwood,"Cloke, Travis",7,5,2,2,2,1,0,1
Collingwood,"Dawes, Chris",12,8,3,4,3,1,8,1
Collingwood,"Elliott, Jamie",9,4,4,5,0,1,0,15
Collingwood,"Fasolo, Alex",19,11,2,8,0,0,0,8
Collingwood,"Goldsack, Tyson",14,10,5,4,2,1,0,3
Collingwood,"Jolly, Darren",18,6,4,12,0,0,43,6
Collingwood,"Lumumba, Heritier",12,7,2,5,0,0,0,3
Collingwood,"Maxwell, Nick",9,5,4,4,0,0,1,3
Collingwood,"Mooney, Caolan",3,1,0,2,0,0,0,2
Collingwood,"Paine, Jackson",15,6,3,9,2,0,0,6
Collingwood,"Reid, Ben",11,7,2,4,0,0,0,1
Collingwood,"Shaw, Heath",15,13,2,2,0,0,0,3
Collingwood,"Sidebottom, Steele",26,12,3,14,0,1,0,7
Collingwood,"Swan, Dane",43,21,8,22,2,2,0,7
Collingwood,"Thomas, Dale",26,21,6,5,2,1,0,5
Collingwood,"Toovey, Alan",7,4,2,3,0,0,0,4
Collingwood,"Wellingham, Sharrod",29,18,3,11,0,1,0,4
Collingwood,"Williams, Marley",13,8,2,5,0,0,0,3
Collingwood,"Beams, Dayne",24,13,1,11,0,0,0,3
Collingwood,"Blair, Jarryd",23,9,1,14,0,2,0,4
Collingwood,"Buckley, Simon",15,12,6,3,0,0,0,2
Collingwood,"Clarke, Martin",14,9,6,5,0,0,0,3
Collingwood,"Cloke, Travis",15,12,9,3,2,2,0,2
Collingwood,"Dawes, Chris",8,2,4,6,0,1,3,4
Collingwood,"Elliott, Jamie",5,2,1,3,0,0,0,7
Collingwood,"Fasolo, Alex",22,9,6,13,0,2,0,0
Collingwood,"Goldsack, Tyson",9,4,1,5,1,1,0,2
Collingwood,"Jolly, Darren",7,1,2,6,0,0,39,1
Collingwood,"Lumumba, Heritier",12,9,6,3,0,0,0,2
Collingwood,"Maxwell, Nick",15,8,10,7,0,0,0,2
Collingwood,"Paine, Jackson",4,2,2,2,2,0,0,2
Collingwood,"Reid, Ben",11,8,6,3,0,0,0,0
Collingwood,"Shaw, Heath",19,12,6,7,0,1,0,2
Collingwood,"Sidebottom, Steele",26,15,5,11,1,0,0,2
Collingwood,"Sinclair, Ben",9,7,4,2,0,0,0,0
Collingwood,"Swan, Dane",31,18,5,13,0,0,0,4
Collingwood,"Thomas, Dale",27,19,7,8,1,0,0,2
Collingwood,"Toovey, Alan",10,7,4,3,0,0,0,2
Collingwood,"Wellingham, Sharrod",20,15,6,5,1,0,0,3
Collingwood,"Williams, Marley",8,5,3,3,0,0,0,1
Collingwood,"Beams, Dayne",36,20,8,16,2,0,0,3
Collingwood,"Blair, Jarryd",21,13,5,8,0,0,0,5
Collingwood,"Brown, Nathan",11,4,3,7,0,0,0,3
Collingwood,"Buckley, Simon",4,2,1,2,0,0,0,3
Collingwood,"Clarke, Martin",9,6,3,3,0,0,0,0
Collingwood,"Cloke, Travis",9,6,1,3,1,1,0,3
Collingwood,"Dawes, Chris",12,7,6,5,2,0,4,4
Collingwood,"Elliott, Jamie",10,7,3,3,1,0,0,5
Collingwood,"Fasolo, Alex",19,11,8,8,2,0,0,3
Collingwood,"Goldsack, Tyson",10,5,0,5,2,0,0,4
Collingwood,"Jolly, Darren",10,5,3,5,1,0,29,2
Collingwood,"Lumumba, Heritier",19,14,7,5,0,0,0,2
Collingwood,"Maxwell, Nick",16,12,4,4,1,0,0,4
Collingwood,"Pendlebury, Scott",36,18,3,18,0,1,0,5
Collingwood,"Reid, Ben",16,8,7,8,0,0,0,0
Collingwood,"Shaw, Heath",29,22,5,7,0,0,0,1
Collingwood,"Sidebottom, Steele",22,18,6,4,0,0,0,3
Collingwood,"Sinclair, Ben",15,8,5,7,0,0,0,2
Collingwood,"Swan, Dane",40,23,3,17,0,0,0,1
Collingwood,"Tarrant, Chris",11,9,5,2,2,2,0,2
Collingwood,"Thomas, Dale",15,10,5,5,3,1,0,1
Collingwood,"Toovey, Alan",12,7,4,5,0,0,0,5
Collingwood,"Beams, Dayne",34,18,3,16,4,1,0,6
Collingwood,"Blair, Jarryd",21,6,1,15,0,0,0,7
Collingwood,"Brown, Nathan",8,4,2,4,0,0,0,2
Collingwood,"Cloke, Travis",10,7,2,3,1,1,0,1
Collingwood,"Dawes, Chris",12,9,3,3,1,3,6,2
Collingwood,"Elliott, Jamie",14,8,10,6,0,1,0,2
Collingwood,"Fasolo, Alex",20,14,8,6,0,2,0,1
Collingwood,"Goldsack, Tyson",11,8,6,3,0,0,0,4
Collingwood,"Jolly, Darren",8,4,3,4,2,0,38,5
Collingwood,"Lumumba, Heritier",16,7,2,9,0,0,0,1
Collingwood,"Maxwell, Nick",17,10,7,7,0,0,0,2
Collingwood,"Mooney, Caolan",6,2,2,4,0,0,0,0
Collingwood,"Pendlebury, Scott",34,15,7,19,0,0,0,11
Collingwood,"Reid, Ben",14,8,2,6,0,0,0,3
Collingwood,"Seedsman, Paul",12,7,4,5,0,0,0,2
Collingwood,"Shaw, Heath",22,15,2,7,0,0,0,5
Collingwood,"Sidebottom, Steele",29,14,5,15,1,0,0,2
Collingwood,"Swan, Dane",49,31,6,18,2,0,0,2
Collingwood,"Tarrant, Chris",9,6,3,3,1,0,0,2
Collingwood,"Thomas, Dale",17,11,8,6,1,0,0,1
Collingwood,"Toovey, Alan",13,5,4,8,0,0,0,3
Collingwood,"Young, Tom",11,3,1,8,0,0,0,1
Collingwood,"Beams, Dayne",30,16,6,14,2,2,0,2
Collingwood,"Blair, Jarryd",23,11,6,12,1,0,0,2
Collingwood,"Brown, Nathan",16,8,8,8,0,0,0,1
Collingwood,"Buckley, Simon",13,9,0,4,0,0,0,5
Collingwood,"Clarke, Martin",16,10,4,6,0,0,0,2
Collingwood,"Cloke, Travis",21,13,11,8,6,0,0,1
Collingwood,"Dawes, Chris",17,8,11,9,2,0,6,4
Collingwood,"Elliott, Jamie",22,16,8,6,2,2,0,0
Collingwood,"Fasolo, Alex",14,11,3,3,1,1,0,2
Collingwood,"Goldsack, Tyson",14,7,5,7,2,0,0,1
Collingwood,"Maxwell, Nick",19,11,4,8,1,0,0,2
Collingwood,"Mooney, Caolan",4,2,1,2,1,1,0,1
Collingwood,"Pendlebury, Scott",33,16,5,17,0,1,0,3
Collingwood,"Reid, Ben",25,14,13,11,0,0,0,1
Collingwood,"Seedsman, Paul",24,11,3,13,0,1,0,3
Collingwood,"Shaw, Heath",23,15,9,8,1,0,0,2
Collingwood,"Sinclair, Ben",11,4,3,7,1,0,0,1
Collingwood,"Swan, Dane",37,23,8,14,5,2,0,1
Collingwood,"Tarrant, Chris",15,8,10,7,1,2,0,1
Collingwood,"Toovey, Alan",18,10,1,8,0,1,0,4
Collingwood,"Wood, Cameron",11,4,5,7,0,0,22,3
Collingwood,"Young, Tom",25,13,7,12,0,0,0,0
Collingwood,"Beams, Dayne",32,16,4,16,1,0,0,4
Collingwood,"Blair, Jarryd",17,9,4,8,0,1,0,1
Collingwood,"Brown, Nathan",7,5,3,2,0,0,0,2
Collingwood,"Cloke, Travis",12,8,3,4,1,1,0,0
Collingwood,"Dawes, Chris",13,8,5,5,2,2,3,6
Collingwood,"Elliott, Jamie",15,7,3,8,0,1,0,9
Collingwood,"Fasolo, Alex",15,10,0,5,1,1,0,3
Collingwood,"Goldsack, Tyson",6,3,2,3,0,1,0,1
Collingwood,"Jolly, Darren",21,9,10,12,2,0,37,6
Collingwood,"Lumumba, Heritier",15,11,4,4,0,0,0,2
Collingwood,"Maxwell, Nick",10,2,2,8,0,0,0,0
Collingwood,"Pendlebury, Scott",30,14,2,16,0,1,0,3
Collingwood,"Reid, Ben",12,9,4,3,0,0,1,2
Collingwood,"Seedsman, Paul",10,7,4,3,0,1,0,5
Collingwood,"Shaw, Heath",15,13,3,2,0,0,0,3
Collingwood,"Sidebottom, Steele",32,17,6,15,0,1,0,5
Collingwood,"Sinclair, Ben",14,12,4,2,0,1,0,4
Collingwood,"Swan, Dane",31,17,7,14,2,2,0,2
Collingwood,"Thomas, Dale",26,17,6,9,2,3,0,1
Collingwood,"Toovey, Alan",15,9,2,6,0,0,0,1
Collingwood,"Wellingham, Sharrod",18,10,4,8,1,0,1,2
Collingwood,"Young, Tom",7,2,1,5,0,0,0,1
Collingwood,"Beams, Dayne",34,21,1,13,3,0,0,5
Collingwood,"Blair, Jarryd",19,7,2,12,1,0,0,9
Collingwood,"Brown, Nathan",3,2,2,1,0,0,0,0
Collingwood,"Clarke, Martin",16,8,1,8,0,0,0,6
Collingwood,"Cloke, Travis",10,6,5,4,3,2,0,1
Collingwood,"Dawes, Chris",15,12,8,3,0,1,4,3
Collingwood,"Didak, Alan",15,9,2,6,1,1,0,2
Collingwood,"Elliott, Jamie",11,2,0,9,0,1,0,4
Collingwood,"Fasolo, Alex",19,11,4,8,1,0,0,0
Collingwood,"Jolly, Darren",11,4,0,7,0,0,42,4
Collingwood,"Lumumba, Heritier",13,12,1,1,0,0,0,8
Collingwood,"Maxwell, Nick",20,16,7,4,0,0,0,8
Collingwood,"Pendlebury, Scott",29,14,3,15,0,0,0,6
Collingwood,"Reid, Ben",20,14,6,6,0,0,0,2
Collingwood,"Seedsman, Paul",20,13,4,7,1,0,0,2
Collingwood,"Shaw, Heath",18,16,5,2,0,0,0,3
Collingwood,"Sidebottom, Steele",19,16,5,3,0,0,0,8
Collingwood,"Sinclair, Ben",8,3,1,5,0,0,0,4
Collingwood,"Tarrant, Chris",9,5,4,4,0,1,0,0
Collingwood,"Thomas, Dale",8,6,0,2,1,0,0,1
Collingwood,"Toovey, Alan",7,4,0,3,0,0,0,3
Collingwood,"Wellingham, Sharrod",24,10,4,14,1,0,0,11
Collingwood,"Beams, Dayne",38,16,4,22,2,0,0,3
Collingwood,"Blair, Jarryd",20,10,1,10,1,0,0,4
Collingwood,"Brown, Nathan",5,1,3,4,0,0,0,3
Collingwood,"Clarke, Martin",9,5,1,4,0,0,0,3
Collingwood,"Cloke, Travis",11,7,2,4,0,3,0,4
Collingwood,"Dawes, Chris",8,6,4,2,0,0,3,3
Collingwood,"Didak, Alan",18,14,3,4,1,1,0,1
Collingwood,"Elliott, Jamie",6,3,1,3,0,0,0,0
Collingwood,"Fasolo, Alex",13,7,3,6,1,3,0,3
Collingwood,"Jolly, Darren",4,2,1,2,0,0,24,3
Collingwood,"Lumumba, Heritier",11,10,2,1,0,0,0,2
Collingwood,"Maxwell, Nick",13,8,3,5,0,0,0,2
Collingwood,"Mooney, Caolan",3,2,0,1,0,0,0,1
Collingwood,"Pendlebury, Scott",24,18,2,6,1,0,0,4
Collingwood,"Reid, Ben",16,9,6,7,0,0,0,1
Collingwood,"Seedsman, Paul",12,11,5,1,0,0,0,3
Collingwood,"Shaw, Heath",19,15,7,4,0,0,0,3
Collingwood,"Sidebottom, Steele",26,16,10,10,0,1,0,5
Collingwood,"Sinclair, Ben",10,9,2,1,1,3,0,2
Collingwood,"Tarrant, Chris",10,5,4,5,1,0,0,3
Collingwood,"Thomas, Dale",27,17,9,10,0,1,0,5
Collingwood,"Wellingham, Sharrod",14,8,4,6,0,0,0,2
Collingwood,"Beams, Dayne",30,17,9,13,1,0,0,6
Collingwood,"Blair, Jarryd",10,5,2,5,1,0,0,3
Collingwood,"Brown, Nathan",7,2,1,5,0,0,0,1
Collingwood,"Cloke, Travis",11,8,6,3,0,0,0,1
Collingwood,"Dawes, Chris",10,6,3,4,0,0,0,1
Collingwood,"Didak, Alan",15,11,4,4,0,1,0,0
Collingwood,"Fasolo, Alex",14,10,7,4,3,0,0,1
Collingwood,"Goldsack, Tyson",8,5,3,3,1,1,0,3
Collingwood,"Johnson, Ben",24,18,5,6,0,1,0,3
Collingwood,"Lumumba, Heritier",11,5,4,6,0,0,0,3
Collingwood,"Pendlebury, Scott",30,13,6,17,1,1,0,7
Collingwood,"Reid, Ben",10,7,5,3,0,0,0,1
Collingwood,"Seedsman, Paul",5,4,3,1,0,0,0,0
Collingwood,"Shaw, Heath",18,18,5,0,0,0,0,3
Collingwood,"Sidebottom, Steele",25,15,8,10,1,0,0,1
Collingwood,"Sinclair, Ben",4,2,1,2,0,0,0,0
Collingwood,"Swan, Dane",27,16,9,11,0,2,0,5
Collingwood,"Tarrant, Chris",14,10,7,4,0,0,0,3
Collingwood,"Thomas, Dale",21,13,7,8,0,1,0,4
Collingwood,"Toovey, Alan",8,4,1,4,0,0,0,1
Collingwood,"Wellingham, Sharrod",18,7,3,11,0,0,0,7
Collingwood,"Wood, Cameron",8,6,2,2,0,0,12,3
Collingwood,"Beams, Dayne",33,11,6,22,1,3,0,2
Collingwood,"Brown, Nathan",8,4,5,4,0,0,0,2
Collingwood,"Cloke, Travis",20,20,16,0,5,4,0,1
Collingwood,"Didak, Alan",14,11,4,3,0,0,0,0
Collingwood,"Elliott, Jamie",12,11,5,1,0,2,0,3
Collingwood,"Fasolo, Alex",22,17,12,5,2,0,0,2
Collingwood,"Goldsack, Tyson",5,2,2,3,1,1,0,2
Collingwood,"Johnson, Ben",22,13,4,9,0,0,0,1
Collingwood,"Jolly, Darren",18,7,4,11,0,1,36,5
Collingwood,"Krakouer, Andrew",11,9,4,2,1,0,0,2
Collingwood,"Lumumba, Heritier",20,13,4,7,1,0,0,1
Collingwood,"Maxwell, Nick",15,10,5,5,0,0,1,3
Collingwood,"Paine, Jackson",9,8,5,1,1,2,0,2
Collingwood,"Pendlebury, Scott",31,15,4,16,0,0,2,3
Collingwood,"Reid, Ben",11,8,5,3,0,0,0,1
Collingwood,"Shaw, Heath",17,8,6,9,1,0,0,2
Collingwood,"Sidebottom, Steele",19,9,4,10,0,0,0,2
Collingwood,"Swan, Dane",42,32,12,10,1,2,1,6
Collingwood,"Tarrant, Chris",10,6,4,4,0,0,0,0
Collingwood,"Thomas, Dale",29,18,10,11,0,1,0,2
Collingwood,"Toovey, Alan",12,6,3,6,0,0,0,3
Collingwood,"Wellingham, Sharrod",17,8,2,9,0,0,0,2
Collingwood,"Beams, Dayne",28,15,4,13,0,0,0,7
Collingwood,"Blair, Jarryd",16,8,1,8,0,0,0,7
Collingwood,"Brown, Nathan",5,2,1,3,0,0,0,0
Collingwood,"Cloke, Travis",16,13,8,3,6,1,0,0
Collingwood,"Dawes, Chris",20,6,3,14,1,0,5,2
Collingwood,"Didak, Alan",12,7,2,5,0,0,0,0
Collingwood,"Fasolo, Alex",15,11,6,4,0,1,0,5
Collingwood,"Johnson, Ben",12,9,2,3,0,0,0,4
Collingwood,"Jolly, Darren",6,4,1,2,0,0,49,1
Collingwood,"Krakouer, Andrew",10,8,6,2,4,1,0,5
Collingwood,"Lumumba, Heritier",11,9,0,2,0,0,0,5
Collingwood,"Maxwell, Nick",11,8,3,3,0,0,0,3
Collingwood,"Pendlebury, Scott",30,14,2,16,0,0,0,7
Collingwood,"Reid, Ben",20,14,7,6,0,0,1,2
Collingwood,"Shaw, Heath",15,9,4,6,1,0,0,5
Collingwood,"Sidebottom, Steele",30,16,4,14,0,0,0,2
Collingwood,"Sinclair, Ben",7,6,2,1,1,1,0,1
Collingwood,"Swan, Dane",29,19,2,10,0,1,0,7
Collingwood,"Tarrant, Chris",3,2,1,1,0,0,0,3
Collingwood,"Thomas, Dale",17,5,4,12,0,0,0,2
Collingwood,"Toovey, Alan",11,6,3,5,0,0,0,7
Collingwood,"Wellingham, Sharrod",16,12,5,4,2,0,0,2
Collingwood,"Beams, Dayne",30,16,4,14,0,0,0,7
Collingwood,"Blair, Jarryd",14,10,3,4,1,0,0,7
Collingwood,"Brown, Nathan",11,4,1,7,0,0,0,2
Collingwood,"Cloke, Travis",9,7,5,2,0,1,0,2
Collingwood,"Dawes, Chris",7,4,3,3,0,0,2,2
Collingwood,"Didak, Alan",17,12,2,5,0,0,0,0
Collingwood,"Elliott, Jamie",3,3,2,0,0,0,0,2
Collingwood,"Fasolo, Alex",9,5,2,4,0,2,0,4
Collingwood,"Goldsack, Tyson",15,10,5,5,1,2,0,8
Collingwood,"Johnson, Ben",22,13,5,9,0,0,0,1
Collingwood,"Jolly, Darren",12,9,4,3,1,0,24,3
Collingwood,"Krakouer, Andrew",11,8,3,3,0,2,0,2
Collingwood,"Lumumba, Heritier",10,8,3,2,1,0,0,2
Collingwood,"Pendlebury, Scott",29,16,6,13,1,0,0,5
Collingwood,"Reid, Ben",16,12,10,4,0,0,0,3
Collingwood,"Shaw, Heath",20,13,7,7,0,0,0,4
Collingwood,"Sidebottom, Steele",25,19,5,6,0,0,0,5
Collingwood,"Swan, Dane",29,20,6,9,2,0,1,4
Collingwood,"Tarrant, Chris",11,7,1,4,0,0,0,3
Collingwood,"Thomas, Dale",23,17,9,6,3,1,0,3
Collingwood,"Toovey, Alan",12,9,5,3,0,0,0,2
Collingwood,"Wellingham, Sharrod",19,14,7,5,0,1,0,8
Collingwood,"Beams, Dayne",27,12,3,15,1,2,0,4
Collingwood,"Blair, Jarryd",23,7,3,16,0,0,0,2
Collingwood,"Brown, Nathan",11,4,3,7,0,0,0,2
Collingwood,"Cloke, Travis",11,10,7,1,3,2,0,5
Collingwood,"Dawes, Chris",11,5,6,6,1,0,3,0
Collingwood,"Elliott, Jamie",4,2,1,2,0,0,0,0
Collingwood,"Fasolo, Alex",16,10,4,6,1,0,0,2
Collingwood,"Goldsack, Tyson",9,5,4,4,1,2,0,3
Collingwood,"Johnson, Ben",21,17,5,4,1,0,0,2
Collingwood,"Jolly, Darren",7,5,2,2,0,0,34,4
Collingwood,"Krakouer, Andrew",10,6,2,4,0,0,0,2
Collingwood,"Lumumba, Heritier",21,16,9,5,0,0,0,3
Collingwood,"Pendlebury, Scott",30,17,4,13,0,1,0,10
Collingwood,"Reid, Ben",15,11,7,4,0,0,0,2
Collingwood,"Shaw, Heath",18,13,6,5,0,0,0,2
Collingwood,"Sidebottom, Steele",16,12,6,4,0,1,1,7
Collingwood,"Sinclair, Ben",5,3,2,2,0,0,0,0
Collingwood,"Swan, Dane",25,21,7,4,1,0,0,2
Collingwood,"Tarrant, Chris",16,12,9,4,1,0,0,4
Collingwood,"Thomas, Dale",20,15,8,5,0,0,0,1
Collingwood,"Toovey, Alan",7,4,3,3,0,0,0,3
Collingwood,"Wellingham, Sharrod",16,12,7,4,0,0,0,4
Essendon,"Crameri, Stewart",20,11,6,9,0,5,0,0
Essendon,"Dempsey, Courtenay",14,8,4,6,0,0,0,4
Essendon,"Fletcher, Dustin",14,12,3,2,0,0,0,1
Essendon,"Hardingham, Kyle",6,3,0,3,0,0,0,1
Essendon,"Heppell, Dyson",20,13,5,7,1,0,0,1
Essendon,"Hibberd, Michael",15,10,10,5,0,0,0,0
Essendon,"Hille, David",18,12,10,6,1,1,10,0
Essendon,"Hocking, Heath",2,2,1,0,0,1,0,0
Essendon,"Hooker, Cale",13,8,4,5,0,0,0,0
Essendon,"Howlett, Ben",19,9,1,10,0,0,0,8
Essendon,"Hurley, Michael",11,6,6,5,2,1,0,1
Essendon,"Jetta, Leroy",13,9,2,4,1,3,0,2
Essendon,"Lovett-Murray, Nathan",12,8,3,4,2,0,0,2
Essendon,"McVeigh, Mark",5,4,3,1,1,0,0,1
Essendon,"Melksham, Jake",16,12,6,4,2,1,1,3
Essendon,"Monfries, Angus",14,6,4,8,0,1,0,5
Essendon,"Myers, David",18,13,5,5,0,0,0,0
Essendon,"Pears, Tayte",12,4,3,8,0,0,0,2
Essendon,"Ryder, Paddy",20,13,9,7,1,1,33,3
Essendon,"Stanton, Brent",35,26,7,9,2,0,0,5
Essendon,"Watson, Jobe",28,15,10,13,1,1,0,1
Essendon,"Zaharakis, David",25,18,3,7,0,2,0,6
Essendon,"Carlisle, Jake",11,7,5,4,1,0,0,4
Essendon,"Crameri, Stewart",15,8,4,7,3,1,0,4
Essendon,"Dempsey, Courtenay",23,16,6,7,1,0,0,2
Essendon,"Fletcher, Dustin",14,12,5,2,0,0,0,3
Essendon,"Hardingham, Kyle",14,8,5,6,0,0,0,0
Essendon,"Heppell, Dyson",17,10,7,7,0,0,1,5
Essendon,"Hibberd, Michael",20,13,3,7,0,0,0,2
Essendon,"Hille, David",2,1,1,1,1,0,4,0
Essendon,"Howlett, Ben",14,10,2,4,1,1,0,13
Essendon,"Hurley, Michael",17,11,9,6,1,3,1,0
Essendon,"Jetta, Leroy",15,13,6,2,4,1,0,1
Essendon,"Lonergan, Sam",8,4,2,4,0,0,0,4
Essendon,"Lovett-Murray, Nathan",17,11,5,6,0,3,1,1
Essendon,"McVeigh, Mark",13,8,7,5,0,0,0,1
Essendon,"Melksham, Jake",17,12,5,5,0,1,0,3
Essendon,"Monfries, Angus",21,13,7,8,1,2,0,5
Essendon,"Myers, David",7,6,2,1,0,0,0,2
Essendon,"Pears, Tayte",6,0,0,6,0,0,0,1
Essendon,"Ryder, Paddy",13,6,5,7,0,0,46,6
Essendon,"Stanton, Brent",25,21,5,4,2,1,0,5
Essendon,"Watson, Jobe",25,16,6,9,0,0,0,13
Essendon,"Zaharakis, David",18,14,5,4,1,0,0,5
Essendon,"Bellchambers, Tom",11,5,3,6,1,1,33,3
Essendon,"Carlisle, Jake",7,5,0,2,0,0,0,2
Essendon,"Crameri, Stewart",17,10,5,7,4,2,0,5
Essendon,"Davey, Alwyn",12,7,1,5,1,3,0,4
Essendon,"Dempsey, Courtenay",3,1,1,2,0,0,0,0
Essendon,"Dyson, Ricky",14,11,5,3,0,1,0,3
Essendon,"Fletcher, Dustin",20,17,7,3,0,0,0,0
Essendon,"Hardingham, Kyle",14,13,5,1,0,0,0,2
Essendon,"Heppell, Dyson",21,12,2,9,0,0,0,3
Essendon,"Hibberd, Michael",25,15,6,10,0,0,0,2
Essendon,"Hocking, Heath",19,8,1,11,0,2,0,6
Essendon,"Howlett, Ben",24,11,1,13,0,0,0,5
Essendon,"Hurley, Michael",13,9,3,4,2,1,0,0
Essendon,"Jetta, Leroy",24,12,5,12,2,1,0,2
Essendon,"Melksham, Jake",12,8,4,4,0,1,0,4
Essendon,"Monfries, Angus",28,16,5,12,0,0,0,1
Essendon,"Pears, Tayte",24,13,6,11,0,0,0,4
Essendon,"Reimers, Kyle",6,5,3,1,1,0,0,4
Essendon,"Ryder, Paddy",17,8,7,9,2,0,11,2
Essendon,"Stanton, Brent",20,12,4,8,0,0,0,8
Essendon,"Watson, Jobe",25,13,1,12,2,0,0,5
Essendon,"Zaharakis, David",12,4,2,8,0,1,0,3
Essendon,"Bellchambers, Tom",11,8,5,3,0,0,28,1
Essendon,"Crameri, Stewart",18,13,8,5,5,6,0,5
Essendon,"Davey, Alwyn",15,10,3,5,3,1,0,2
Essendon,"DellOlio, Cory",9,6,1,3,0,1,0,5
Essendon,"Dyson, Ricky",17,12,6,5,0,1,0,2
Essendon,"Fletcher, Dustin",14,11,7,3,1,0,0,2
Essendon,"Hardingham, Kyle",6,4,2,2,0,0,0,2
Essendon,"Heppell, Dyson",22,12,6,10,0,0,0,5
Essendon,"Hibberd, Michael",21,16,10,5,0,0,0,1
Essendon,"Hocking, Heath",8,5,2,3,0,0,0,4
Essendon,"Hooker, Cale",21,12,7,9,0,0,0,2
Essendon,"Howlett, Ben",17,7,3,10,0,0,0,7
Essendon,"Hurley, Michael",9,6,3,3,1,0,0,0
Essendon,"Jetta, Leroy",11,5,1,6,0,1,0,8
Essendon,"Lonergan, Sam",14,8,2,6,0,0,0,6
Essendon,"Melksham, Jake",15,9,4,6,1,2,0,2
Essendon,"Monfries, Angus",15,9,3,6,1,0,0,4
Essendon,"Pears, Tayte",13,9,4,4,0,0,0,7
Essendon,"Ryder, Paddy",14,7,4,7,1,2,19,1
Essendon,"Stanton, Brent",36,28,17,8,1,0,0,4
Essendon,"Watson, Jobe",31,17,2,14,0,2,1,3
Essendon,"Zaharakis, David",16,9,3,7,1,0,0,3
Essendon,"Bellchambers, Tom",14,8,5,6,0,0,27,1
Essendon,"Carlisle, Jake",16,9,6,7,0,2,0,2
Essendon,"Crameri, Stewart",7,2,1,5,0,0,0,5
Essendon,"Davey, Alwyn",10,6,2,4,3,0,0,4
Essendon,"DellOlio, Cory",7,5,1,2,1,1,0,3
Essendon,"Dyson, Ricky",25,19,2,6,0,1,0,4
Essendon,"Fletcher, Dustin",16,14,5,2,0,0,0,2
Essendon,"Hardingham, Kyle",11,8,5,3,0,0,0,3
Essendon,"Heppell, Dyson",22,15,10,7,0,0,1,5
Essendon,"Hibberd, Michael",7,6,1,1,0,0,0,1
Essendon,"Hocking, Heath",15,9,3,6,1,0,0,7
Essendon,"Hooker, Cale",13,9,4,4,0,0,0,2
Essendon,"Howlett, Ben",20,12,7,8,1,2,0,7
Essendon,"Jetta, Leroy",11,5,1,6,0,0,0,7
Essendon,"Lonergan, Sam",19,9,1,10,1,1,0,7
Essendon,"Melksham, Jake",14,10,4,4,0,0,0,4
Essendon,"Monfries, Angus",15,10,4,5,1,2,0,2
Essendon,"Pears, Tayte",7,1,0,6,0,0,0,4
Essendon,"Ryder, Paddy",16,10,3,6,0,1,15,3
Essendon,"Stanton, Brent",13,13,3,0,1,0,0,6
Essendon,"Watson, Jobe",23,11,6,12,0,0,1,7
Essendon,"Zaharakis, David",24,15,3,9,2,0,0,5
Essendon,"Bellchambers, Tom",21,13,9,8,0,1,26,1
Essendon,"Carlisle, Jake",17,9,6,8,0,0,0,2
Essendon,"Colyer, Travis",9,6,2,3,0,1,0,2
Essendon,"Crameri, Stewart",18,7,1,11,4,0,0,0
Essendon,"Davey, Alwyn",17,12,2,5,3,1,0,2
Essendon,"Dempsey, Courtenay",13,9,4,4,1,0,0,2
Essendon,"Dyson, Ricky",25,17,8,8,1,0,0,3
Essendon,"Fletcher, Dustin",21,19,10,2,0,0,0,0
Essendon,"Hardingham, Kyle",16,9,5,7,0,0,0,4
Essendon,"Heppell, Dyson",34,19,14,15,0,0,0,2
Essendon,"Hocking, Heath",18,4,2,14,0,0,0,5
Essendon,"Hooker, Cale",17,12,7,5,0,1,0,4
Essendon,"Howlett, Ben",19,10,3,9,0,0,0,8
Essendon,"Jetta, Leroy",16,7,3,9,3,1,0,4
Essendon,"Lonergan, Sam",22,13,3,9,2,0,0,12
Essendon,"Lovett-Murray, Nathan",23,11,5,12,1,0,0,4
Essendon,"Melksham, Jake",24,21,7,3,1,1,1,0
Essendon,"Monfries, Angus",18,10,8,8,2,1,0,4
Essendon,"Ryder, Paddy",8,6,2,2,0,0,21,1
Essendon,"Stanton, Brent",39,32,17,7,0,3,0,8
Essendon,"Watson, Jobe",36,18,8,18,1,0,0,5
Essendon,"Zaharakis, David",30,15,5,15,0,2,0,3
Essendon,"Bellchambers, Tom",13,7,6,6,1,0,22,0
Essendon,"Carlisle, Jake",12,9,4,3,0,2,0,2
Essendon,"Colyer, Travis",2,1,0,1,0,0,0,2
Essendon,"Crameri, Stewart",17,9,7,8,3,2,0,1
Essendon,"Davey, Alwyn",12,9,3,3,3,2,0,3
Essendon,"Dempsey, Courtenay",19,15,5,4,0,0,0,2
Essendon,"Dyson, Ricky",20,16,8,4,1,0,0,1
Essendon,"Fletcher, Dustin",18,17,6,1,0,0,0,2
Essendon,"Hardingham, Kyle",12,8,6,4,0,0,0,1
Essendon,"Heppell, Dyson",18,9,6,9,0,1,0,0
Essendon,"Hocking, Heath",12,5,2,7,0,0,0,5
Essendon,"Hooker, Cale",19,11,11,8,0,0,0,0
Essendon,"Howlett, Ben",21,11,4,10,0,0,0,7
Essendon,"Jetta, Leroy",10,6,3,4,2,1,0,3
Essendon,"Lonergan, Sam",13,7,2,6,0,0,0,2
Essendon,"Lovett-Murray, Nathan",12,6,1,6,1,0,2,3
Essendon,"Melksham, Jake",22,20,5,2,1,1,1,4
Essendon,"Monfries, Angus",17,9,6,8,0,0,0,3
Essendon,"Ryder, Paddy",17,13,9,4,2,2,7,1
Essendon,"Stanton, Brent",36,20,9,16,2,1,0,3
Essendon,"Watson, Jobe",36,19,5,17,0,1,0,2
Essendon,"Zaharakis, David",32,20,3,12,0,1,0,3
Essendon,"Bellchambers, Tom",13,5,9,8,0,2,20,3
Essendon,"Carlisle, Jake",14,8,6,6,0,0,0,2
Essendon,"Crameri, Stewart",21,12,11,9,1,1,0,0
Essendon,"Davey, Alwyn",16,10,2,6,2,2,0,1
Essendon,"Dempsey, Courtenay",15,14,7,1,0,0,0,5
Essendon,"Dyson, Ricky",23,17,6,6,0,1,0,1
Essendon,"Fletcher, Dustin",16,14,4,2,0,0,0,1
Essendon,"Hardingham, Kyle",9,7,3,2,0,0,0,5
Essendon,"Heppell, Dyson",18,9,3,9,0,0,0,2
Essendon,"Hocking, Heath",13,3,0,10,0,0,0,3
Essendon,"Hooker, Cale",9,5,1,4,0,0,0,0
Essendon,"Howlett, Ben",22,9,4,13,1,0,0,6
Essendon,"Hurley, Michael",18,13,6,5,0,1,0,0
Essendon,"Jetta, Leroy",15,8,3,7,2,1,0,1
Essendon,"Lonergan, Sam",13,6,2,7,0,0,0,10
Essendon,"Lovett-Murray, Nathan",6,5,1,1,1,1,1,3
Essendon,"Melksham, Jake",14,8,6,6,0,0,1,0
Essendon,"Monfries, Angus",12,5,4,7,3,1,0,2
Essendon,"Ryder, Paddy",14,7,7,7,4,0,13,0
Essendon,"Stanton, Brent",29,22,5,7,3,1,0,2
Essendon,"Watson, Jobe",30,17,8,13,2,1,0,4
Essendon,"Zaharakis, David",23,15,4,8,0,0,0,3
Essendon,"Bellchambers, Tom",15,12,4,3,3,1,23,0
Essendon,"Carlisle, Jake",13,8,7,5,0,0,1,2
Essendon,"Colyer, Travis",11,6,2,5,1,1,0,2
Essendon,"Crameri, Stewart",9,6,3,3,3,0,0,3
Essendon,"Davey, Alwyn",17,11,5,6,3,2,0,2
Essendon,"Dempsey, Courtenay",25,15,9,10,0,0,0,4
Essendon,"Dyson, Ricky",21,14,7,7,0,0,0,4
Essendon,"Hocking, Heath",18,6,2,12,0,0,0,6
Essendon,"Hooker, Cale",24,11,9,13,0,0,0,1
Essendon,"Howlett, Ben",27,15,6,12,0,0,0,7
Essendon,"Hurley, Michael",9,4,2,5,1,0,0,2
Essendon,"Lonergan, Sam",22,7,3,15,0,1,0,3
Essendon,"Lovett-Murray, Nathan",26,15,7,11,0,0,0,2
Essendon,"McVeigh, Mark",21,16,5,5,0,0,0,1
Essendon,"Melksham, Jake",12,7,5,5,1,0,1,2
Essendon,"Monfries, Angus",21,9,4,12,2,0,0,3
Essendon,"Pears, Tayte",22,11,6,11,0,0,0,2
Essendon,"Ryder, Paddy",17,11,6,6,2,0,19,3
Essendon,"Slattery, Henry",5,2,0,3,0,0,0,1
Essendon,"Stanton, Brent",27,16,4,11,0,1,1,3
Essendon,"Watson, Jobe",26,13,4,13,1,0,0,3
Essendon,"Zaharakis, David",32,19,5,13,1,1,0,1
Essendon,"Bellchambers, Tom",9,6,3,3,0,0,18,1
Essendon,"Carlisle, Jake",13,8,7,5,0,0,0,2
Essendon,"Colyer, Travis",15,13,3,2,1,1,0,3
Essendon,"Crameri, Stewart",18,5,3,13,0,3,0,1
Essendon,"Davey, Alwyn",8,6,0,2,1,0,0,7
Essendon,"Dempsey, Courtenay",25,19,5,6,0,0,0,3
Essendon,"Dyson, Ricky",24,15,4,9,0,1,0,0
Essendon,"Fletcher, Dustin",13,11,6,2,0,0,0,1
Essendon,"Hardingham, Kyle",9,6,4,3,0,0,0,0
Essendon,"Hocking, Heath",18,8,2,10,1,0,0,5
Essendon,"Howlett, Ben",20,11,4,9,0,0,0,8
Essendon,"Hurley, Michael",18,8,3,10,0,3,0,1
Essendon,"Jetta, Leroy",14,7,2,7,0,2,0,4
Essendon,"Lonergan, Sam",3,2,0,1,0,0,0,2
Essendon,"Lovett-Murray, Nathan",15,7,1,8,0,0,0,3
Essendon,"Melksham, Jake",12,8,2,4,1,0,0,3
Essendon,"Monfries, Angus",17,9,5,8,0,2,0,3
Essendon,"Pears, Tayte",9,4,1,5,0,0,0,3
Essendon,"Ryder, Paddy",9,8,2,1,0,2,27,5
Essendon,"Stanton, Brent",23,19,7,4,0,0,1,5
Essendon,"Watson, Jobe",32,14,6,18,2,0,0,5
Essendon,"Zaharakis, David",30,18,2,12,0,0,0,4
Essendon,"Bellchambers, Tom",5,4,3,1,0,1,7,1
Essendon,"Carlisle, Jake",11,6,4,5,0,0,1,0
Essendon,"Crameri, Stewart",8,2,1,6,0,0,0,3
Essendon,"Davey, Alwyn",17,9,3,8,3,2,0,6
Essendon,"Dempsey, Courtenay",17,12,6,5,0,0,0,0
Essendon,"Dyson, Ricky",21,10,4,11,0,0,1,1
Essendon,"Fletcher, Dustin",19,13,6,6,0,0,0,1
Essendon,"Hardingham, Kyle",18,10,2,8,0,0,0,1
Essendon,"Heppell, Dyson",22,13,5,9,0,1,1,1
Essendon,"Hocking, Heath",15,7,2,8,1,1,0,6
Essendon,"Hooker, Cale",23,13,5,10,0,0,0,4
Essendon,"Howlett, Ben",23,15,1,8,1,1,0,3
Essendon,"Hurley, Michael",13,8,4,5,0,1,0,3
Essendon,"Jetta, Leroy",18,11,2,7,1,1,0,3
Essendon,"Lonergan, Sam",12,4,0,8,0,0,0,8
Essendon,"Lovett-Murray, Nathan",15,9,4,6,1,0,2,6
Essendon,"Melksham, Jake",20,15,6,5,0,1,0,3
Essendon,"Monfries, Angus",14,6,2,8,0,2,0,3
Essendon,"Myers, David",19,12,1,7,1,1,0,4
Essendon,"Ryder, Paddy",7,4,5,3,0,0,41,5
Essendon,"Stanton, Brent",19,14,6,5,1,0,0,3
Essendon,"Watson, Jobe",32,22,3,10,2,1,0,5
Essendon,"Carlisle, Jake",15,6,6,9,0,0,0,2
Essendon,"Crameri, Stewart",14,8,4,6,2,1,0,3
Essendon,"DellOlio, Cory",8,7,3,1,2,1,0,3
Essendon,"Dempsey, Courtenay",20,9,6,11,0,0,0,4
Essendon,"Fletcher, Dustin",11,10,4,1,0,1,0,2
Essendon,"Hardingham, Kyle",14,7,3,7,0,0,0,1
Essendon,"Heppell, Dyson",24,14,6,10,1,1,0,1
Essendon,"Hibberd, Michael",20,14,5,6,0,0,0,1
Essendon,"Hille, David",18,11,7,7,1,0,17,1
Essendon,"Hocking, Heath",14,6,2,8,0,1,0,3
Essendon,"Hooker, Cale",15,5,5,10,0,0,0,5
Essendon,"Howlett, Ben",19,9,2,10,0,0,0,3
Essendon,"Hurley, Michael",15,11,6,4,6,1,0,0
Essendon,"Jetta, Leroy",20,9,4,11,0,0,0,2
Essendon,"Lovett-Murray, Nathan",12,5,3,7,0,1,1,1
Essendon,"Melksham, Jake",18,5,3,13,1,0,0,0
Essendon,"Monfries, Angus",12,9,4,3,2,0,0,2
Essendon,"Myers, David",28,16,5,12,0,0,0,1
Essendon,"Reimers, Kyle",14,13,6,1,0,0,0,1
Essendon,"Ryder, Paddy",16,9,10,7,1,1,22,1
Essendon,"Stanton, Brent",28,20,5,8,0,1,0,7
Essendon,"Watson, Jobe",27,13,5,14,1,0,0,3
Essendon,"Carlisle, Jake",12,8,5,4,0,0,0,2
Essendon,"Crameri, Stewart",5,5,2,0,2,0,0,3
Essendon,"DellOlio, Cory",10,5,4,5,2,0,0,1
Essendon,"Dempsey, Courtenay",23,17,13,6,1,0,0,5
Essendon,"Fletcher, Dustin",27,24,9,3,0,0,0,1
Essendon,"Hardingham, Kyle",20,14,4,6,0,0,0,1
Essendon,"Heppell, Dyson",18,12,8,6,0,0,2,2
Essendon,"Hibberd, Michael",24,16,10,8,0,0,0,2
Essendon,"Hille, David",15,9,5,6,0,1,18,1
Essendon,"Hocking, Heath",27,16,8,11,1,3,0,6
Essendon,"Hooker, Cale",21,17,14,4,0,0,0,0
Essendon,"Howlett, Ben",26,14,7,12,0,0,0,9
Essendon,"Hurley, Michael",22,14,12,8,5,1,0,2
Essendon,"Jetta, Leroy",9,7,3,2,0,2,0,4
Essendon,"Lonergan, Sam",19,9,5,10,0,0,0,4
Essendon,"Lovett-Murray, Nathan",10,2,0,8,0,1,1,2
Essendon,"Melksham, Jake",14,9,6,5,2,0,0,1
Essendon,"Myers, David",16,8,5,8,0,0,1,5
Essendon,"Reimers, Kyle",12,12,7,0,3,4,0,2
Essendon,"Ryder, Paddy",16,10,10,6,2,0,15,2
Essendon,"Stanton, Brent",29,20,7,9,0,1,0,4
Essendon,"Watson, Jobe",30,18,6,12,3,0,0,3
Essendon,"Carlisle, Jake",10,6,7,4,1,0,0,2
Essendon,"Davey, Alwyn",8,2,2,6,1,0,0,6
Essendon,"Dempsey, Courtenay",24,10,5,14,0,0,1,5
Essendon,"Dyson, Ricky",4,3,3,1,0,0,0,0
Essendon,"Fletcher, Dustin",13,12,3,1,0,0,0,0
Essendon,"Hardingham, Kyle",8,6,6,2,0,0,0,1
Essendon,"Heppell, Dyson",22,12,7,10,0,0,0,1
Essendon,"Hibberd, Michael",12,9,3,3,0,0,0,1
Essendon,"Hille, David",14,12,6,2,2,1,22,2
Essendon,"Hocking, Heath",20,4,3,16,0,0,0,8
Essendon,"Hooker, Cale",12,7,3,5,0,1,0,1
Essendon,"Howlett, Ben",18,11,4,7,0,2,0,4
Essendon,"Hurley, Michael",9,4,2,5,1,0,1,0
Essendon,"Jetta, Leroy",12,6,1,6,0,2,0,8
Essendon,"Lonergan, Sam",20,11,4,9,0,0,0,6
Essendon,"Lovett-Murray, Nathan",16,5,3,11,0,1,1,6
Essendon,"Melksham, Jake",20,16,2,4,2,1,0,1
Essendon,"Myers, David",12,8,3,4,0,0,0,1
Essendon,"Reimers, Kyle",12,7,4,5,1,0,0,2
Essendon,"Ryder, Paddy",11,5,6,6,0,0,34,1
Essendon,"Stanton, Brent",22,15,3,7,0,0,0,3
Essendon,"Watson, Jobe",23,13,4,10,0,0,0,2
Essendon,"Baguley, Mark",20,12,7,8,0,0,0,2
Essendon,"Bellchambers, Tom",13,8,3,5,2,1,34,3
Essendon,"Carlisle, Jake",18,7,6,11,0,0,0,1
Essendon,"Davey, Alwyn",19,12,6,7,1,5,0,3
Essendon,"DellOlio, Cory",11,7,3,4,2,1,0,1
Essendon,"Dempsey, Courtenay",12,9,5,3,0,0,0,4
Essendon,"Dyson, Ricky",19,12,8,7,1,0,1,4
Essendon,"Fletcher, Dustin",16,12,7,4,0,0,0,1
Essendon,"Gumbleton, Scott",14,8,5,6,3,0,0,2
Essendon,"Hardingham, Kyle",11,8,4,3,0,0,0,1
Essendon,"Heppell, Dyson",24,11,4,13,0,0,0,6
Essendon,"Hibberd, Michael",13,8,1,5,0,0,0,1
Essendon,"Hille, David",16,7,6,9,2,2,2,2
Essendon,"Hooker, Cale",14,8,6,6,0,0,0,1
Essendon,"Howlett, Ben",26,15,4,11,1,1,0,8
Essendon,"Jetta, Leroy",18,14,7,4,3,1,0,4
Essendon,"Lovett-Murray, Nathan",5,2,1,3,0,0,1,2
Essendon,"Melksham, Jake",15,9,4,6,1,1,0,1
Essendon,"Myers, David",25,14,4,11,1,0,0,1
Essendon,"Reimers, Kyle",6,4,1,2,1,1,0,3
Essendon,"Stanton, Brent",21,16,6,5,0,0,0,3
Essendon,"Watson, Jobe",28,18,6,10,1,0,0,7
Essendon,"Baguley, Mark",13,8,4,5,0,0,0,2
Essendon,"Bellchambers, Tom",10,8,6,2,3,1,35,3
Essendon,"Carlisle, Jake",12,6,2,6,0,0,0,2
Essendon,"Crameri, Stewart",13,5,5,8,1,2,0,0
Essendon,"Davey, Alwyn",11,5,1,6,1,0,0,7
Essendon,"DellOlio, Cory",10,5,3,5,1,1,0,2
Essendon,"Dempsey, Courtenay",14,9,3,5,0,0,0,2
Essendon,"Dyson, Ricky",16,11,4,5,0,0,0,1
Essendon,"Fletcher, Dustin",24,20,2,4,0,0,0,0
Essendon,"Gumbleton, Scott",7,3,6,4,1,0,0,2
Essendon,"Hardingham, Kyle",15,8,6,7,0,0,0,2
Essendon,"Heppell, Dyson",20,11,3,9,0,0,0,4
Essendon,"Hille, David",9,3,3,6,0,0,7,2
Essendon,"Hooker, Cale",10,3,4,7,0,0,0,1
Essendon,"Howlett, Ben",12,7,5,5,0,0,0,5
Essendon,"Jetta, Leroy",16,14,1,2,1,0,0,3
Essendon,"Lovett-Murray, Nathan",8,2,0,6,0,0,0,2
Essendon,"Melksham, Jake",7,3,0,4,0,0,0,7
Essendon,"Monfries, Angus",8,3,2,5,1,1,0,6
Essendon,"Myers, David",14,12,3,2,1,1,0,4
Essendon,"Stanton, Brent",18,15,8,3,0,0,0,3
Essendon,"Watson, Jobe",29,16,7,13,0,0,0,7
Essendon,"Baguley, Mark",23,15,5,8,0,0,0,3
Essendon,"Bellchambers, Tom",10,1,3,9,0,0,26,1
Essendon,"Browne, Alex",17,6,1,11,0,0,0,2
Essendon,"Carlisle, Jake",18,13,4,5,0,0,0,2
Essendon,"Davey, Alwyn",5,1,0,4,0,1,0,3
Essendon,"DellOlio, Cory",9,5,5,4,1,1,0,1
Essendon,"Dempsey, Courtenay",15,10,4,5,0,0,0,4
Essendon,"Fletcher, Dustin",18,14,2,4,0,0,0,2
Essendon,"Gumbleton, Scott",9,7,6,2,4,2,0,0
Essendon,"Hardingham, Kyle",7,4,4,3,0,0,0,1
Essendon,"Heppell, Dyson",25,15,7,10,0,0,0,0
Essendon,"Hille, David",12,6,5,6,2,1,17,1
Essendon,"Hocking, Heath",15,8,0,7,0,0,0,4
Essendon,"Howlett, Ben",23,14,2,9,1,0,0,5
Essendon,"Jetta, Leroy",15,12,5,3,1,1,0,1
Essendon,"Kavanagh, Elliott",13,8,4,5,0,0,0,0
Essendon,"Lovett-Murray, Nathan",9,1,0,8,1,0,0,3
Essendon,"Melksham, Jake",14,8,5,6,0,0,0,1
Essendon,"Monfries, Angus",16,8,4,8,1,3,0,0
Essendon,"Stanton, Brent",14,8,2,6,0,0,0,5
Essendon,"Watson, Jobe",37,15,2,22,0,1,0,4
Essendon,"Winderlich, Jason",12,6,4,6,1,0,0,2
Essendon,"Baguley, Mark",12,8,2,4,0,0,0,3
Essendon,"Bellchambers, Tom",8,7,2,1,0,0,46,1
Essendon,"Browne, Alex",17,11,4,6,2,0,0,2
Essendon,"Carlisle, Jake",13,9,5,4,0,0,0,4
Essendon,"Colyer, Travis",14,10,4,4,1,0,0,4
Essendon,"Davey, Alwyn",14,9,0,5,1,1,0,4
Essendon,"Dempsey, Courtenay",27,21,8,6,1,0,0,2
Essendon,"Gumbleton, Scott",9,5,4,4,2,1,0,3
Essendon,"Hardingham, Kyle",10,8,6,2,0,0,0,0
Essendon,"Heppell, Dyson",20,12,3,8,0,0,0,5
Essendon,"Hocking, Heath",16,10,1,6,0,1,0,3
Essendon,"Hooker, Cale",15,7,3,8,0,0,0,2
Essendon,"Howlett, Ben",6,6,0,0,0,1,0,3
Essendon,"Hurley, Michael",14,9,7,5,1,1,0,3
Essendon,"Jetta, Leroy",15,8,0,7,1,2,0,2
Essendon,"Lonergan, Sam",18,13,1,5,1,0,1,4
Essendon,"Lovett-Murray, Nathan",20,12,5,8,0,0,1,6
Essendon,"Melksham, Jake",15,10,4,5,0,0,0,2
Essendon,"Pears, Tayte",16,5,2,11,0,0,0,2
Essendon,"Slattery, Henry",4,3,0,1,0,0,0,1
Essendon,"Watson, Jobe",31,13,1,18,1,1,0,7
Essendon,"Winderlich, Jason",10,8,6,2,4,0,0,2
Essendon,"Baguley, Mark",14,9,4,5,0,0,0,4
Essendon,"Bellchambers, Tom",14,9,9,5,0,0,48,1
Essendon,"Browne, Alex",15,9,4,6,0,0,0,1
Essendon,"Carlisle, Jake",9,6,1,3,0,0,0,2
Essendon,"Colyer, Travis",21,14,4,7,0,1,0,2
Essendon,"Crameri, Stewart",8,3,2,5,1,1,0,3
Essendon,"Davey, Alwyn",8,6,1,2,3,0,0,6
Essendon,"Dempsey, Courtenay",18,10,3,8,0,0,0,3
Essendon,"Fletcher, Dustin",13,10,2,3,0,1,0,1
Essendon,"Gumbleton, Scott",7,4,2,3,0,1,1,0
Essendon,"Hardingham, Kyle",12,6,1,6,0,0,0,5
Essendon,"Heppell, Dyson",17,12,2,5,0,0,2,5
Essendon,"Hibberd, Michael",21,11,5,10,0,0,0,0
Essendon,"Hocking, Heath",14,6,2,8,0,1,0,3
Essendon,"Hurley, Michael",11,9,6,2,3,2,0,0
Essendon,"Jetta, Leroy",13,6,2,7,0,1,0,3
Essendon,"Lee, Brendan",18,10,3,8,0,0,0,6
Essendon,"Lonergan, Sam",12,6,2,6,1,0,0,4
Essendon,"Lovett-Murray, Nathan",18,6,3,12,1,0,1,4
Essendon,"Melksham, Jake",11,8,4,3,1,1,0,4
Essendon,"Monfries, Angus",6,2,0,4,0,0,0,1
Essendon,"Watson, Jobe",32,19,4,13,1,0,0,7
Essendon,"Bellchambers, Tom",8,6,4,2,0,2,29,0
Essendon,"Browne, Alex",17,10,5,7,0,1,0,0
Essendon,"Carlisle, Jake",7,4,2,3,0,0,0,3
Essendon,"Crameri, Stewart",10,6,2,4,2,0,0,3
Essendon,"Davey, Alwyn",11,6,2,5,0,1,0,4
Essendon,"Dempsey, Courtenay",25,13,3,12,0,0,0,2
Essendon,"Fletcher, Dustin",2,2,0,0,0,0,0,0
Essendon,"Hardingham, Kyle",12,6,1,6,0,0,0,1
Essendon,"Heppell, Dyson",21,9,7,12,0,0,1,2
Essendon,"Hibberd, Michael",17,12,3,5,0,0,0,0
Essendon,"Hocking, Heath",14,6,3,8,0,0,0,6
Essendon,"Hooker, Cale",17,6,5,11,0,0,0,1
Essendon,"Hurley, Michael",12,7,5,5,1,4,0,1
Essendon,"Jetta, Leroy",15,10,5,5,0,1,0,2
Essendon,"Lee, Brendan",18,9,6,9,0,0,0,2
Essendon,"Lonergan, Sam",15,8,2,7,1,0,1,2
Essendon,"Melksham, Jake",12,6,2,6,0,0,0,1
Essendon,"Monfries, Angus",9,5,3,4,0,0,0,2
Essendon,"Ryder, Paddy",9,6,4,3,2,1,6,4
Essendon,"Stanton, Brent",16,14,3,2,1,0,0,2
Essendon,"Watson, Jobe",29,16,3,13,1,0,0,3
Essendon,"Zaharakis, David",11,5,2,6,0,0,0,2
Essendon,"Baguley, Mark",17,8,4,9,0,0,0,1
Essendon,"Bellchambers, Tom",11,6,3,5,0,0,26,1
Essendon,"Browne, Alex",14,7,4,7,1,1,0,2
Essendon,"Crameri, Stewart",19,13,8,6,0,4,0,0
Essendon,"Davey, Alwyn",0,0,0,0,0,0,0,2
Essendon,"Dempsey, Courtenay",10,7,1,3,0,0,0,9
Essendon,"Gumbleton, Scott",12,8,1,4,1,0,3,1
Essendon,"Hardingham, Kyle",15,10,4,5,0,0,0,1
Essendon,"Heppell, Dyson",28,19,4,9,0,0,0,2
Essendon,"Hibberd, Michael",20,12,5,8,0,1,0,2
Essendon,"Hocking, Heath",16,7,1,9,0,0,0,4
Essendon,"Hooker, Cale",17,9,1,8,0,0,0,3
Essendon,"Hurley, Michael",17,7,4,10,1,1,0,0
Essendon,"Jetta, Leroy",14,6,2,8,1,0,0,2
Essendon,"Lovett-Murray, Nathan",12,6,4,6,0,0,1,3
Essendon,"Melksham, Jake",7,3,3,4,0,0,0,3
Essendon,"Monfries, Angus",19,12,4,7,3,0,0,3
Essendon,"OBrien, Nick",12,8,2,4,1,1,0,0
Essendon,"Pears, Tayte",9,4,1,5,0,0,0,1
Essendon,"Stanton, Brent",19,10,2,9,0,0,0,3
Essendon,"Watson, Jobe",20,14,1,6,0,0,0,6
Essendon,"Zaharakis, David",12,4,2,8,0,0,0,1
Essendon,"Baguley, Mark",14,11,2,3,0,0,0,0
Essendon,"Browne, Alex",2,2,1,0,0,0,0,0
Essendon,"Crameri, Stewart",11,7,2,4,1,1,0,1
Essendon,"DellOlio, Cory",6,3,0,3,0,0,0,1
Essendon,"Dempsey, Courtenay",20,14,8,6,0,0,1,0
Essendon,"Hardingham, Kyle",13,9,6,4,0,0,0,3
Essendon,"Heppell, Dyson",17,11,4,6,1,0,0,7
Essendon,"Hibberd, Michael",17,11,3,6,0,0,0,3
Essendon,"Hille, David",23,12,4,11,0,1,20,1
Essendon,"Hooker, Cale",14,6,6,8,0,0,0,1
Essendon,"Howlett, Ben",18,9,2,9,0,0,0,5
Essendon,"Hurley, Michael",11,6,6,5,1,1,0,0
Essendon,"Jetta, Leroy",4,3,3,1,0,0,0,1
Essendon,"Melksham, Jake",16,8,3,8,0,2,2,1
Essendon,"Merrett, Jackson",3,3,2,0,0,0,0,4
Essendon,"Monfries, Angus",9,4,2,5,1,0,0,3
Essendon,"Myers, David",17,13,4,4,1,2,0,0
Essendon,"OBrien, Nick",12,4,2,8,2,0,1,0
Essendon,"Pears, Tayte",6,2,1,4,0,0,0,1
Essendon,"Stanton, Brent",27,18,9,9,0,0,0,4
Essendon,"Watson, Jobe",28,13,8,15,1,0,0,3
Essendon,"Zaharakis, David",25,15,4,10,2,1,0,3
Fremantle,"Ballantyne, Hayden",20,15,1,5,2,2,0,4
Fremantle,"Barlow, Michael",13,4,1,9,1,0,0,3
Fremantle,"Bradley, Kepler",13,7,2,6,1,0,4,1
Fremantle,"Broughton, Greg",14,7,1,7,0,0,0,5
Fremantle,"Clarke, Zac",11,7,6,4,2,1,6,2
Fremantle,"Crowley, Ryan",22,7,5,15,0,0,0,4
Fremantle,"Dawson, Zac",12,3,2,9,0,0,1,2
Fremantle,"Duffield, Paul",21,15,4,6,0,0,0,5
Fremantle,"Fyfe, Nat",30,20,6,10,2,0,0,7
Fremantle,"Hill, Stephen",19,10,2,9,0,0,0,2
Fremantle,"Ibbotson, Garrick",22,11,4,11,0,2,0,4
Fremantle,"Johnson, Michael",24,15,6,9,0,0,0,1
Fremantle,"Mayne, Chris",16,5,3,11,0,0,0,5
Fremantle,"McPharlin, Luke",12,7,8,5,0,0,0,3
Fremantle,"McPhee, Adam",9,8,4,1,0,0,0,2
Fremantle,"Mellington, Josh",5,4,1,1,3,0,0,5
Fremantle,"Mzungu, Tendai",22,15,2,7,1,1,0,6
Fremantle,"Pavlich, Matthew",17,10,5,7,3,0,0,3
Fremantle,"Pearce, Clancee",4,1,1,3,0,0,0,1
Fremantle,"Sandilands, Aaron",19,6,4,13,0,0,32,1
Fremantle,"Suban, Nick",19,10,1,9,0,0,0,5
Fremantle,"de Boer, Matt",20,11,7,9,1,1,0,4
Fremantle,"Anthony, John",12,5,2,7,1,0,0,1
Fremantle,"Barlow, Michael",20,11,1,9,0,0,0,4
Fremantle,"Bradley, Kepler",19,8,2,11,1,1,1,1
Fremantle,"Broughton, Greg",17,7,4,10,0,0,0,3
Fremantle,"Clarke, Zac",16,10,8,6,0,2,6,2
Fremantle,"Crowley, Ryan",21,13,5,8,2,1,0,6
Fremantle,"Dawson, Zac",11,3,3,8,0,0,0,2
Fremantle,"Duffield, Paul",10,7,3,3,0,0,0,1
Fremantle,"Fyfe, Nat",28,15,1,13,0,0,0,4
Fremantle,"Hill, Stephen",18,8,2,10,0,0,0,4
Fremantle,"Ibbotson, Garrick",18,10,3,8,0,1,0,2
Fremantle,"Johnson, Michael",20,11,8,9,1,0,0,3
Fremantle,"Mayne, Chris",11,7,3,4,4,0,0,4
Fremantle,"McPharlin, Luke",15,9,7,6,0,0,0,2
Fremantle,"McPhee, Adam",7,6,0,1,0,0,0,5
Fremantle,"Mellington, Josh",4,2,0,2,0,0,0,1
Fremantle,"Mzungu, Tendai",23,15,3,8,1,0,0,5
Fremantle,"Pavlich, Matthew",16,10,2,6,0,2,2,6
Fremantle,"Pearce, Clancee",25,9,3,16,1,0,0,5
Fremantle,"Sandilands, Aaron",19,5,5,14,1,0,54,3
Fremantle,"Suban, Nick",11,10,2,1,0,0,0,1
Fremantle,"de Boer, Matt",20,9,5,11,0,0,0,8
Fremantle,"Barlow, Michael",25,13,1,12,0,1,0,8
Fremantle,"Bradley, Kepler",18,10,8,8,0,2,2,4
Fremantle,"Broughton, Greg",23,16,7,7,0,0,1,7
Fremantle,"Clarke, Zac",15,6,3,9,1,0,2,3
Fremantle,"Crowley, Ryan",13,8,2,5,0,0,0,3
Fremantle,"Dawson, Zac",13,8,7,5,0,0,0,0
Fremantle,"Duffield, Paul",28,16,7,12,1,0,0,6
Fremantle,"Fyfe, Nat",8,1,1,7,0,0,0,1
Fremantle,"Hill, Stephen",14,9,4,5,0,2,0,0
Fremantle,"Ibbotson, Garrick",20,12,5,8,0,1,0,3
Fremantle,"Johnson, Michael",25,18,8,7,0,0,0,3
Fremantle,"Mayne, Chris",11,6,4,5,0,0,0,3
Fremantle,"McPharlin, Luke",19,13,8,6,0,0,0,0
Fremantle,"McPhee, Adam",22,14,6,8,0,0,0,4
Fremantle,"Mellington, Josh",8,6,4,2,1,3,0,1
Fremantle,"Mundy, David",13,7,3,6,1,0,0,1
Fremantle,"Mzungu, Tendai",25,16,4,9,0,1,1,5
Fremantle,"Pavlich, Matthew",14,8,2,6,1,1,0,5
Fremantle,"Pearce, Clancee",23,10,8,13,3,0,0,4
Fremantle,"Sandilands, Aaron",16,7,4,9,0,0,54,0
Fremantle,"Suban, Nick",18,14,5,4,0,0,0,2
Fremantle,"de Boer, Matt",13,8,5,5,0,2,0,4
Fremantle,"Anthony, John",10,5,4,5,2,1,0,0
Fremantle,"Ballantyne, Hayden",16,14,3,2,0,0,0,6
Fremantle,"Barlow, Michael",30,17,5,13,0,1,0,4
Fremantle,"Broughton, Greg",25,8,4,17,1,0,0,6
Fremantle,"Clarke, Zac",18,10,6,8,2,0,10,0
Fremantle,"Crowley, Ryan",15,9,3,6,1,0,0,3
Fremantle,"Dawson, Zac",9,4,1,5,0,0,0,1
Fremantle,"Duffield, Paul",22,18,4,4,0,0,0,2
Fremantle,"Hill, Stephen",28,14,3,14,0,0,0,2
Fremantle,"Ibbotson, Garrick",10,6,4,4,0,0,0,3
Fremantle,"Johnson, Michael",22,9,6,13,0,0,0,1
Fremantle,"Mayne, Chris",13,7,5,6,2,0,0,2
Fremantle,"McPharlin, Luke",12,6,2,6,0,0,0,1
Fremantle,"McPhee, Adam",20,14,4,6,0,0,0,1
Fremantle,"Mundy, David",24,13,5,11,0,0,0,4
Fremantle,"Mzungu, Tendai",21,17,4,4,2,1,0,6
Fremantle,"Neale, Lachie",7,0,1,7,0,0,0,0
Fremantle,"Pavlich, Matthew",16,10,3,6,1,2,0,4
Fremantle,"Pearce, Clancee",25,16,8,9,1,0,0,4
Fremantle,"Sandilands, Aaron",20,6,6,14,1,0,44,2
Fremantle,"Suban, Nick",3,3,2,0,0,0,0,2
Fremantle,"de Boer, Matt",21,9,8,12,1,1,0,3
Fremantle,"Anthony, John",4,4,3,0,0,0,0,0
Fremantle,"Ballantyne, Hayden",10,9,1,1,1,1,0,4
Fremantle,"Barlow, Michael",28,13,5,15,0,3,0,5
Fremantle,"Broughton, Greg",16,9,5,7,0,0,0,8
Fremantle,"Clarke, Zac",3,2,2,1,1,0,7,4
Fremantle,"Crowley, Ryan",12,4,3,8,1,0,0,8
Fremantle,"Dawson, Zac",13,5,6,8,0,1,0,1
Fremantle,"Duffield, Paul",23,18,5,5,0,0,0,2
Fremantle,"Fyfe, Nat",22,11,4,11,0,0,0,6
Fremantle,"Griffin, Jonathon",14,3,2,11,0,0,25,6
Fremantle,"Hill, Stephen",19,8,1,11,1,0,0,1
Fremantle,"Ibbotson, Garrick",21,15,9,6,0,0,0,0
Fremantle,"Johnson, Michael",13,9,5,4,0,0,0,2
Fremantle,"Mayne, Chris",14,9,7,5,1,0,0,4
Fremantle,"McPharlin, Luke",14,12,7,2,1,1,0,1
Fremantle,"McPhee, Adam",18,9,1,9,0,0,0,1
Fremantle,"Mundy, David",27,16,4,11,0,1,0,5
Fremantle,"Mzungu, Tendai",26,17,4,9,0,1,0,4
Fremantle,"Neale, Lachie",8,4,2,4,0,0,0,0
Fremantle,"Pavlich, Matthew",20,11,9,9,1,1,0,3
Fremantle,"Pearce, Clancee",20,8,4,12,0,0,0,10
Fremantle,"de Boer, Matt",12,5,6,7,0,2,0,6
Fremantle,"Ballantyne, Hayden",18,10,2,8,0,1,0,5
Fremantle,"Barlow, Michael",18,9,2,9,0,0,0,4
Fremantle,"Broughton, Greg",18,10,2,8,0,0,0,7
Fremantle,"Clarke, Zac",17,11,4,6,1,0,13,4
Fremantle,"Crowley, Ryan",25,15,6,10,1,0,0,2
Fremantle,"Dawson, Zac",14,5,4,9,0,0,1,1
Fremantle,"Duffield, Paul",11,5,2,6,0,0,0,1
Fremantle,"Griffin, Jonathon",12,6,3,6,0,0,31,3
Fremantle,"Hill, Stephen",5,2,1,3,1,0,0,0
Fremantle,"Ibbotson, Garrick",26,20,10,6,0,0,0,4
Fremantle,"Johnson, Michael",25,17,10,8,0,0,0,4
Fremantle,"Mayne, Chris",18,10,7,8,3,0,0,4
Fremantle,"McPharlin, Luke",22,12,7,10,0,0,0,0
Fremantle,"McPhee, Adam",9,4,2,5,0,0,0,2
Fremantle,"Mundy, David",25,13,4,12,0,2,0,3
Fremantle,"Mzungu, Tendai",17,11,3,6,1,1,0,4
Fremantle,"Neale, Lachie",14,7,2,7,2,0,0,1
Fremantle,"Pavlich, Matthew",24,16,7,8,1,0,0,5
Fremantle,"Pearce, Clancee",29,9,6,20,0,0,0,5
Fremantle,"Roberton, Dylan",10,7,2,3,1,0,0,2
Fremantle,"Spurr, Lee",6,1,0,5,0,0,0,3
Fremantle,"de Boer, Matt",17,10,7,7,3,0,0,6
Fremantle,"Ballantyne, Hayden",12,9,3,3,1,0,0,4
Fremantle,"Barlow, Michael",20,8,1,12,0,0,0,7
Fremantle,"Broughton, Greg",22,8,3,14,0,0,0,11
Fremantle,"Clarke, Zac",18,11,8,7,0,4,13,4
Fremantle,"Crowley, Ryan",20,14,4,6,1,3,0,3
Fremantle,"Dawson, Zac",12,3,0,9,0,0,0,3
Fremantle,"Duffield, Paul",28,17,5,11,0,0,0,7
Fremantle,"Hill, Stephen",26,10,3,16,0,2,0,3
Fremantle,"Ibbotson, Garrick",14,7,1,7,0,0,0,1
Fremantle,"Johnson, Michael",27,18,5,9,0,0,0,3
Fremantle,"Mayne, Chris",18,6,4,12,3,0,0,4
Fremantle,"McPharlin, Luke",22,12,10,10,0,0,0,3
Fremantle,"McPhee, Adam",16,6,3,10,0,0,0,1
Fremantle,"Mundy, David",19,14,2,5,0,2,0,3
Fremantle,"Mzungu, Tendai",22,12,2,10,0,1,0,2
Fremantle,"Neale, Lachie",10,7,2,3,0,1,0,4
Fremantle,"Pavlich, Matthew",19,13,10,6,4,0,0,3
Fremantle,"Pearce, Clancee",26,7,5,19,1,0,0,5
Fremantle,"Roberton, Dylan",7,4,0,3,0,0,0,1
Fremantle,"Sandilands, Aaron",16,4,5,12,1,0,43,1
Fremantle,"Spurr, Lee",20,8,6,12,0,0,0,1
Fremantle,"de Boer, Matt",13,6,2,7,1,0,0,1
Fremantle,"Ballantyne, Hayden",12,12,1,0,2,0,0,1
Fremantle,"Barlow, Michael",27,13,4,14,1,0,0,6
Fremantle,"Broughton, Greg",28,13,8,15,0,0,0,3
Fremantle,"Clarke, Zac",10,7,4,3,1,1,10,4
Fremantle,"Crowley, Ryan",23,15,5,8,1,1,0,2
Fremantle,"Dawson, Zac",7,1,3,6,1,0,0,1
Fremantle,"Duffield, Paul",17,11,2,6,0,0,0,7
Fremantle,"Hill, Stephen",12,5,0,7,0,0,0,1
Fremantle,"Ibbotson, Garrick",14,6,2,8,0,0,0,2
Fremantle,"Johnson, Michael",23,16,9,7,1,0,0,1
Fremantle,"Mayne, Chris",14,8,3,6,1,2,0,3
Fremantle,"McPharlin, Luke",11,6,5,5,0,0,0,4
Fremantle,"Mundy, David",23,13,2,10,0,1,0,4
Fremantle,"Mzungu, Tendai",11,5,4,6,0,1,0,5
Fremantle,"Neale, Lachie",21,5,3,16,1,0,0,0
Fremantle,"Pavlich, Matthew",11,8,7,3,0,2,0,1
Fremantle,"Pearce, Clancee",13,3,0,10,0,0,0,3
Fremantle,"Roberton, Dylan",14,8,5,6,0,0,0,2
Fremantle,"Sandilands, Aaron",12,1,2,11,0,0,41,1
Fremantle,"Spurr, Lee",15,10,5,5,0,0,0,1
Fremantle,"de Boer, Matt",14,7,5,7,0,0,0,4
Fremantle,"van Berlo, Jay",6,3,0,3,0,0,1,2
Fremantle,"Ballantyne, Hayden",15,11,3,4,1,1,0,2
Fremantle,"Barlow, Michael",25,14,3,11,0,1,0,7
Fremantle,"Broughton, Greg",21,11,2,10,0,0,0,5
Fremantle,"Clarke, Zac",11,6,3,5,1,1,5,3
Fremantle,"Crichton, Jesse",10,5,4,5,0,0,0,2
Fremantle,"Crowley, Ryan",5,4,0,1,0,0,0,2
Fremantle,"Dawson, Zac",4,2,1,2,1,0,0,2
Fremantle,"Duffield, Paul",14,10,4,4,0,1,0,6
Fremantle,"Griffin, Jonathon",5,2,2,3,0,0,6,1
Fremantle,"Hill, Stephen",11,7,1,4,0,0,0,6
Fremantle,"Johnson, Michael",24,15,8,9,0,0,1,2
Fremantle,"Mayne, Chris",16,6,4,10,1,0,0,2
Fremantle,"McPharlin, Luke",17,12,9,5,0,1,0,1
Fremantle,"Mundy, David",16,7,3,9,0,0,0,1
Fremantle,"Mzungu, Tendai",9,7,1,2,0,0,0,2
Fremantle,"Neale, Lachie",13,6,0,7,0,0,0,6
Fremantle,"Pavlich, Matthew",23,13,4,10,0,0,0,7
Fremantle,"Pearce, Clancee",8,4,3,4,0,0,0,3
Fremantle,"Sandilands, Aaron",17,9,4,8,0,0,27,1
Fremantle,"Silvagni, Alex",13,9,5,4,0,0,0,3
Fremantle,"de Boer, Matt",10,4,1,6,1,1,0,9
Fremantle,"van Berlo, Jay",7,5,3,2,0,0,0,2
Fremantle,"Anthony, John",4,3,3,1,0,0,0,3
Fremantle,"Ballantyne, Hayden",17,13,3,4,1,2,0,3
Fremantle,"Barlow, Michael",26,14,4,12,2,0,0,5
Fremantle,"Broughton, Greg",24,12,7,12,0,1,0,2
Fremantle,"Clarke, Zac",5,3,2,2,0,1,3,4
Fremantle,"Crichton, Jesse",18,7,5,11,0,0,0,5
Fremantle,"Crowley, Ryan",14,8,3,6,2,0,0,1
Fremantle,"Crozier, Hayden",3,2,1,1,0,0,0,1
Fremantle,"Dawson, Zac",11,1,3,10,0,0,0,2
Fremantle,"Duffield, Paul",16,12,4,4,0,0,0,0
Fremantle,"Hill, Stephen",20,14,1,6,1,1,0,6
Fremantle,"Ibbotson, Garrick",24,17,8,7,0,0,0,3
Fremantle,"Johnson, Michael",24,17,11,7,0,0,0,0
Fremantle,"Mayne, Chris",7,4,4,3,2,0,0,3
Fremantle,"McPharlin, Luke",24,11,12,13,0,0,0,3
Fremantle,"Mundy, David",18,11,6,7,1,0,0,2
Fremantle,"Mzungu, Tendai",20,9,6,11,0,0,0,1
Fremantle,"Neale, Lachie",15,8,4,7,0,0,0,1
Fremantle,"Pavlich, Matthew",14,11,5,3,3,3,0,3
Fremantle,"Pearce, Clancee",20,12,6,8,0,0,0,3
Fremantle,"Sandilands, Aaron",18,11,4,7,0,0,49,2
Fremantle,"de Boer, Matt",25,9,8,16,0,0,0,7
Fremantle,"Ballantyne, Hayden",18,13,3,5,2,1,0,9
Fremantle,"Barlow, Michael",24,15,4,9,0,0,0,8
Fremantle,"Broughton, Greg",17,8,6,9,0,1,0,9
Fremantle,"Crichton, Jesse",10,3,2,7,1,0,0,6
Fremantle,"Crowley, Ryan",10,6,1,4,0,0,0,7
Fremantle,"Crozier, Hayden",16,5,0,11,0,0,0,1
Fremantle,"Dawson, Zac",11,3,2,8,0,0,0,1
Fremantle,"Griffin, Jonathon",8,8,1,0,1,0,43,6
Fremantle,"Hill, Stephen",24,15,1,9,0,0,0,9
Fremantle,"Ibbotson, Garrick",16,13,5,3,0,1,0,0
Fremantle,"Johnson, Michael",23,16,7,7,0,0,0,6
Fremantle,"Mayne, Chris",20,10,2,10,1,0,0,4
Fremantle,"McPharlin, Luke",12,9,4,3,0,0,0,2
Fremantle,"McPhee, Adam",17,9,3,8,0,0,0,6
Fremantle,"Mundy, David",21,14,7,7,0,0,0,6
Fremantle,"Mzungu, Tendai",20,13,2,7,0,0,1,3
Fremantle,"Neale, Lachie",13,5,0,8,0,0,0,7
Fremantle,"Pavlich, Matthew",17,13,6,4,6,1,0,2
Fremantle,"Pearce, Clancee",12,9,1,3,0,0,0,9
Fremantle,"Sandilands, Aaron",3,1,0,2,0,0,3,0
Fremantle,"Suban, Nick",13,10,3,3,0,0,0,4
Fremantle,"de Boer, Matt",29,14,5,15,1,0,0,13
Fremantle,"Barlow, Michael",28,13,4,15,1,0,1,3
Fremantle,"Broughton, Greg",11,5,3,6,2,0,0,2
Fremantle,"Clarke, Zac",15,11,5,4,2,0,11,5
Fremantle,"Crichton, Jesse",11,5,1,6,0,1,0,1
Fremantle,"Crowley, Ryan",14,9,4,5,0,1,0,2
Fremantle,"Crozier, Hayden",11,6,4,5,0,0,0,1
Fremantle,"Griffin, Jonathon",14,12,5,2,1,1,13,2
Fremantle,"Ibbotson, Garrick",21,15,10,6,0,0,0,3
Fremantle,"Johnson, Michael",12,7,2,5,0,0,0,1
Fremantle,"Lower, Nick",30,15,3,15,0,0,0,8
Fremantle,"Mayne, Chris",17,10,7,7,4,0,0,3
Fremantle,"McPharlin, Luke",14,9,6,5,0,0,0,1
Fremantle,"McPhee, Adam",18,14,6,4,0,0,0,2
Fremantle,"Mundy, David",17,14,3,3,0,0,0,5
Fremantle,"Mzungu, Tendai",13,9,2,4,0,0,0,6
Fremantle,"Neale, Lachie",14,4,2,10,0,0,0,1
Fremantle,"Pavlich, Matthew",22,14,11,8,3,0,0,1
Fremantle,"Pearce, Clancee",20,13,4,7,0,0,0,3
Fremantle,"Pitt, Jayden",3,1,2,2,0,0,0,0
Fremantle,"Silvagni, Alex",15,11,9,4,0,0,0,1
Fremantle,"Suban, Nick",14,13,3,1,0,0,0,4
Fremantle,"de Boer, Matt",26,11,0,15,1,0,0,5
Fremantle,"Ballantyne, Hayden",14,12,3,2,0,0,0,6
Fremantle,"Barlow, Michael",37,14,4,23,0,0,3,4
Fremantle,"Broughton, Greg",14,6,4,8,2,0,0,4
Fremantle,"Clarke, Zac",6,4,2,2,1,1,9,0
Fremantle,"Crowley, Ryan",21,12,3,9,0,0,0,6
Fremantle,"Griffin, Jonathon",19,12,4,7,0,0,21,3
Fremantle,"Ibbotson, Garrick",14,8,1,6,0,0,1,7
Fremantle,"Johnson, Michael",22,14,10,8,0,0,1,6
Fremantle,"Lower, Nick",19,11,2,8,0,0,0,9
Fremantle,"Mayne, Chris",12,5,4,7,2,0,0,3
Fremantle,"McPharlin, Luke",22,10,8,12,0,0,0,1
Fremantle,"McPhee, Adam",19,11,8,8,0,0,0,2
Fremantle,"Mundy, David",18,7,5,11,1,0,0,1
Fremantle,"Mzungu, Tendai",18,9,3,9,0,0,0,4
Fremantle,"Neale, Lachie",4,2,1,2,0,1,0,3
Fremantle,"Pavlich, Matthew",21,14,6,7,5,2,0,1
Fremantle,"Pearce, Clancee",15,4,1,11,1,0,0,8
Fremantle,"Pitt, Jayden",5,4,2,1,0,0,0,0
Fremantle,"Roberton, Dylan",19,8,4,11,0,0,0,3
Fremantle,"Silvagni, Alex",11,6,3,5,0,0,2,2
Fremantle,"Suban, Nick",16,11,1,5,0,0,0,5
Fremantle,"de Boer, Matt",20,7,2,13,0,0,0,8
Fremantle,"Ballantyne, Hayden",17,13,3,4,0,0,0,2
Fremantle,"Barlow, Michael",20,14,4,6,0,1,0,7
Fremantle,"Bradley, Kepler",21,12,7,9,0,0,11,1
Fremantle,"Broughton, Greg",11,7,4,4,1,1,0,4
Fremantle,"Crowley, Ryan",11,9,2,2,1,3,0,3
Fremantle,"Duffield, Paul",7,3,1,4,0,0,0,3
Fremantle,"Griffin, Jonathon",11,7,2,4,0,1,37,4
Fremantle,"Grover, Antoni",9,5,3,4,0,0,0,1
Fremantle,"Hill, Stephen",8,4,0,4,1,0,0,3
Fremantle,"Ibbotson, Garrick",15,8,6,7,0,0,0,3
Fremantle,"Johnson, Michael",22,12,8,10,0,0,0,0
Fremantle,"Lower, Nick",21,13,3,8,1,0,0,5
Fremantle,"Mayne, Chris",20,14,9,6,4,1,0,2
Fremantle,"McPharlin, Luke",13,11,6,2,0,0,0,0
Fremantle,"McPhee, Adam",16,12,10,4,0,0,0,2
Fremantle,"Mundy, David",18,14,7,4,0,0,0,6
Fremantle,"Mzungu, Tendai",20,15,5,5,0,0,0,5
Fremantle,"Pavlich, Matthew",21,13,10,8,6,2,0,5
Fremantle,"Pearce, Clancee",23,14,3,9,0,1,0,7
Fremantle,"Roberton, Dylan",7,5,2,2,0,0,0,3
Fremantle,"Sutcliffe, Cam",15,7,5,8,0,0,0,4
Fremantle,"de Boer, Matt",22,11,5,11,0,0,0,6
Fremantle,"Ballantyne, Hayden",18,13,4,5,2,2,0,4
Fremantle,"Barlow, Michael",17,14,2,3,2,0,1,3
Fremantle,"Bradley, Kepler",16,12,10,4,1,3,3,1
Fremantle,"Broughton, Greg",9,2,2,7,0,0,0,3
Fremantle,"Crowley, Ryan",12,8,3,4,0,0,0,4
Fremantle,"Duffield, Paul",15,11,8,4,0,0,0,1
Fremantle,"Griffin, Jonathon",10,4,0,6,0,0,36,4
Fremantle,"Hill, Stephen",20,16,2,4,2,1,0,2
Fremantle,"Ibbotson, Garrick",20,17,6,3,0,0,0,1
Fremantle,"Johnson, Michael",11,9,5,2,0,0,0,1
Fremantle,"Mayne, Chris",16,7,8,9,1,0,0,5
Fremantle,"McPharlin, Luke",20,13,15,7,0,0,0,1
Fremantle,"McPhee, Adam",17,12,9,5,0,0,0,0
Fremantle,"Mundy, David",27,16,6,11,0,0,0,6
Fremantle,"Mzungu, Tendai",11,10,4,1,1,0,1,5
Fremantle,"Pavlich, Matthew",16,10,6,6,4,1,0,1
Fremantle,"Pearce, Clancee",20,15,7,5,2,0,0,4
Fremantle,"Roberton, Dylan",10,7,2,3,0,0,0,3
Fremantle,"Spurr, Lee",19,17,11,2,0,0,0,4
Fremantle,"Sutcliffe, Cam",7,6,4,1,0,0,1,2
Fremantle,"Walters, Michael",14,9,4,5,3,1,0,4
Fremantle,"de Boer, Matt",13,8,3,5,0,0,0,8
Fremantle,"Ballantyne, Hayden",13,8,0,5,1,3,0,1
Fremantle,"Barlow, Michael",23,13,4,10,0,2,3,6
Fremantle,"Bradley, Kepler",20,9,5,11,1,4,0,2
Fremantle,"Clarke, Zac",9,7,5,2,1,1,10,2
Fremantle,"Crowley, Ryan",20,10,3,10,1,2,0,0
Fremantle,"Duffield, Paul",17,16,11,1,0,0,0,1
Fremantle,"Griffin, Jonathon",20,9,5,11,0,0,19,0
Fremantle,"Hill, Stephen",22,14,1,8,2,0,0,2
Fremantle,"Ibbotson, Garrick",18,14,8,4,0,0,0,2
Fremantle,"Johnson, Michael",20,17,11,3,1,0,0,1
Fremantle,"McPharlin, Luke",23,20,16,3,0,0,0,1
Fremantle,"McPhee, Adam",18,13,4,5,0,0,0,0
Fremantle,"Mundy, David",14,11,4,3,0,1,0,1
Fremantle,"Mzungu, Tendai",16,8,5,8,0,3,1,6
Fremantle,"Pavlich, Matthew",16,15,7,1,7,3,0,3
Fremantle,"Pearce, Clancee",24,17,11,7,2,1,1,1
Fremantle,"Roberton, Dylan",13,9,4,4,0,0,0,2
Fremantle,"Spurr, Lee",17,7,7,10,0,0,0,1
Fremantle,"Suban, Nick",10,5,1,5,0,0,0,4
Fremantle,"Sutcliffe, Cam",10,6,1,4,0,1,0,1
Fremantle,"Walters, Michael",12,10,4,2,2,1,0,1
Fremantle,"de Boer, Matt",13,4,2,9,0,0,0,7
Fremantle,"Ballantyne, Hayden",11,8,2,3,0,1,0,3
Fremantle,"Barlow, Michael",24,11,9,13,0,2,1,7
Fremantle,"Bradley, Kepler",15,7,3,8,0,0,7,0
Fremantle,"Crowley, Ryan",8,2,1,6,0,0,0,3
Fremantle,"Duffield, Paul",22,16,8,6,0,0,0,1
Fremantle,"Fyfe, Nat",26,22,4,4,1,1,0,1
Fremantle,"Griffin, Jonathon",6,5,3,1,0,0,24,6
Fremantle,"Hill, Stephen",20,12,5,8,0,0,0,5
Fremantle,"Ibbotson, Garrick",20,12,8,8,0,0,1,3
Fremantle,"Johnson, Michael",16,13,4,3,0,0,1,4
Fremantle,"Mayne, Chris",8,4,5,4,2,0,0,6
Fremantle,"McPharlin, Luke",20,16,13,4,0,0,0,1
Fremantle,"McPhee, Adam",21,16,11,5,0,0,0,2
Fremantle,"Mundy, David",19,9,3,10,1,0,0,5
Fremantle,"Mzungu, Tendai",11,7,3,4,1,0,1,6
Fremantle,"Pavlich, Matthew",18,10,7,8,2,3,0,1
Fremantle,"Pearce, Clancee",22,12,9,10,2,0,0,3
Fremantle,"Roberton, Dylan",15,12,5,3,0,0,0,0
Fremantle,"Spurr, Lee",16,11,4,5,0,1,0,4
Fremantle,"Sutcliffe, Cam",6,4,2,2,1,0,0,2
Fremantle,"Walters, Michael",6,4,2,2,1,0,0,4
Fremantle,"de Boer, Matt",15,7,3,8,0,1,0,4
Fremantle,"Ballantyne, Hayden",13,12,4,1,3,0,0,4
Fremantle,"Barlow, Michael",27,19,4,8,0,2,1,5
Fremantle,"Bradley, Kepler",12,6,3,6,0,0,8,1
Fremantle,"Crowley, Ryan",9,7,5,2,0,0,0,3
Fremantle,"Dawson, Zac",3,1,0,2,0,0,0,1
Fremantle,"Duffield, Paul",16,11,7,5,0,0,0,7
Fremantle,"Fyfe, Nat",28,21,3,7,0,0,0,5
Fremantle,"Griffin, Jonathon",12,8,2,4,0,0,26,5
Fremantle,"Hill, Stephen",14,12,4,2,0,1,0,6
Fremantle,"Ibbotson, Garrick",9,5,2,4,0,0,0,1
Fremantle,"Johnson, Michael",16,11,4,5,0,0,0,3
Fremantle,"Mayne, Chris",13,5,4,8,0,0,2,4
Fremantle,"McPharlin, Luke",13,10,8,3,0,0,0,1
Fremantle,"McPhee, Adam",15,9,5,6,0,0,0,2
Fremantle,"Mundy, David",27,21,5,6,1,1,0,6
Fremantle,"Mzungu, Tendai",18,12,1,6,2,0,0,5
Fremantle,"Pavlich, Matthew",24,15,9,9,8,2,1,2
Fremantle,"Pearce, Clancee",20,11,6,9,1,1,0,0
Fremantle,"Roberton, Dylan",4,4,2,0,0,0,0,0
Fremantle,"Spurr, Lee",18,13,6,5,0,0,0,3
Fremantle,"Walters, Michael",10,8,2,2,2,2,0,4
Fremantle,"de Boer, Matt",8,6,3,2,0,0,0,4
Fremantle,"Ballantyne, Hayden",11,5,3,6,1,0,0,5
Fremantle,"Barlow, Michael",21,11,7,10,1,0,0,6
Fremantle,"Bradley, Kepler",6,3,1,3,1,0,9,0
Fremantle,"Crowley, Ryan",7,7,3,0,0,0,0,4
Fremantle,"Dawson, Zac",4,2,1,2,0,0,0,0
Fremantle,"Duffield, Paul",20,17,8,3,1,0,0,4
Fremantle,"Griffin, Jonathon",6,4,4,2,0,0,27,4
Fremantle,"Hill, Stephen",11,4,2,7,1,1,0,3
Fremantle,"Ibbotson, Garrick",10,7,2,3,0,0,0,2
Fremantle,"Johnson, Michael",12,11,4,1,0,0,0,0
Fremantle,"Mayne, Chris",6,2,2,4,1,0,0,1
Fremantle,"McPhee, Adam",8,5,3,3,0,0,0,1
Fremantle,"Mundy, David",20,13,3,7,0,0,1,3
Fremantle,"Mzungu, Tendai",11,9,2,2,0,0,0,3
Fremantle,"Neale, Lachie",5,3,1,2,1,0,0,0
Fremantle,"Pavlich, Matthew",14,6,3,8,2,1,0,2
Fremantle,"Pearce, Clancee",16,13,4,3,1,1,0,2
Fremantle,"Roberton, Dylan",7,6,3,1,0,0,0,2
Fremantle,"Spurr, Lee",15,11,10,4,0,0,1,2
Fremantle,"Suban, Nick",10,8,1,2,0,0,0,3
Fremantle,"Walters, Michael",11,8,4,3,3,1,0,2
Fremantle,"de Boer, Matt",22,11,7,11,1,1,0,11
Fremantle,"Ballantyne, Hayden",24,16,6,8,3,0,0,2
Fremantle,"Barlow, Michael",25,17,8,8,0,0,1,5
Fremantle,"Bradley, Kepler",18,10,5,8,1,3,9,3
Fremantle,"Crowley, Ryan",17,8,3,9,0,2,0,4
Fremantle,"Dawson, Zac",7,4,2,3,0,0,0,2
Fremantle,"Duffield, Paul",25,22,9,3,0,0,0,4
Fremantle,"Fyfe, Nat",21,14,5,7,0,0,0,4
Fremantle,"Hill, Stephen",16,8,3,8,1,1,0,4
Fremantle,"Ibbotson, Garrick",17,12,5,5,0,0,0,0
Fremantle,"Johnson, Michael",15,10,5,5,0,0,0,1
Fremantle,"Mayne, Chris",15,3,5,12,1,1,2,0
Fremantle,"McPharlin, Luke",19,13,8,6,0,0,0,1
Fremantle,"McPhee, Adam",23,16,11,7,0,0,0,1
Fremantle,"Mundy, David",32,16,7,16,0,0,0,7
Fremantle,"Mzungu, Tendai",17,10,6,7,1,0,0,5
Fremantle,"Pavlich, Matthew",18,10,3,8,3,3,0,1
Fremantle,"Pearce, Clancee",22,6,6,16,0,2,0,8
Fremantle,"Sandilands, Aaron",18,5,3,13,0,0,33,0
Fremantle,"Spurr, Lee",13,10,9,3,0,0,0,2
Fremantle,"Suban, Nick",6,5,1,1,0,1,0,1
Fremantle,"Walters, Michael",9,5,2,4,1,1,0,4
Fremantle,"de Boer, Matt",22,11,4,11,2,0,0,6
Fremantle,"Ballantyne, Hayden",23,15,3,8,4,2,0,4
Fremantle,"Barlow, Michael",28,12,7,16,0,0,0,0
Fremantle,"Bradley, Kepler",4,1,1,3,0,0,2,1
Fremantle,"Clarke, Zac",10,5,5,5,0,1,9,7
Fremantle,"Crowley, Ryan",17,10,6,7,0,0,0,0
Fremantle,"Dawson, Zac",10,2,5,8,0,0,0,0
Fremantle,"Duffield, Paul",27,24,9,3,0,0,0,5
Fremantle,"Fyfe, Nat",25,15,4,10,0,2,0,4
Fremantle,"Hill, Stephen",28,22,5,6,0,1,0,1
Fremantle,"Ibbotson, Garrick",16,13,5,3,0,0,0,2
Fremantle,"Johnson, Michael",15,11,10,4,0,0,0,2
Fremantle,"Mayne, Chris",13,6,3,7,2,2,1,7
Fremantle,"McPharlin, Luke",13,9,4,4,0,0,0,1
Fremantle,"McPhee, Adam",13,12,6,1,2,0,0,0
Fremantle,"Mundy, David",27,19,2,8,2,2,1,8
Fremantle,"Mzungu, Tendai",13,10,3,3,1,0,0,5
Fremantle,"Pearce, Clancee",28,19,9,9,0,0,0,4
Fremantle,"Sandilands, Aaron",15,5,3,10,1,0,49,3
Fremantle,"Spurr, Lee",18,12,6,6,0,0,0,3
Fremantle,"Suban, Nick",8,5,1,3,2,1,0,1
Fremantle,"Walters, Michael",11,9,6,2,4,0,0,0
Fremantle,"de Boer, Matt",23,10,5,13,2,0,0,3
Fremantle,"Ballantyne, Hayden",11,9,5,2,3,0,0,4
Fremantle,"Barlow, Michael",32,16,6,16,0,0,1,2
Fremantle,"Crowley, Ryan",13,9,4,4,0,1,1,6
Fremantle,"Dawson, Zac",12,7,7,5,0,1,0,1
Fremantle,"Duffield, Paul",23,18,9,5,0,0,0,5
Fremantle,"Fyfe, Nat",30,13,9,17,0,0,0,3
Fremantle,"Griffin, Jonathon",8,6,4,2,2,0,13,1
Fremantle,"Hill, Stephen",22,12,4,10,0,1,0,3
Fremantle,"Ibbotson, Garrick",15,11,6,4,0,0,0,0
Fremantle,"Johnson, Michael",24,17,10,7,0,0,0,1
Fremantle,"Mayne, Chris",15,10,5,5,1,1,0,3
Fremantle,"McPharlin, Luke",12,10,8,2,0,0,0,0
Fremantle,"McPhee, Adam",19,15,10,4,0,0,0,2
Fremantle,"Mundy, David",31,20,5,11,1,2,0,2
Fremantle,"Mzungu, Tendai",21,16,7,5,2,2,0,4
Fremantle,"Pavlich, Matthew",15,9,8,6,2,3,0,3
Fremantle,"Pearce, Clancee",23,13,5,10,0,0,0,1
Fremantle,"Sandilands, Aaron",15,6,4,9,2,0,34,2
Fremantle,"Sheridan, Tom",5,3,1,2,0,0,0,1
Fremantle,"Spurr, Lee",11,6,4,5,0,0,0,1
Fremantle,"Suban, Nick",15,11,4,4,0,0,0,5
Fremantle,"Walters, Michael",16,7,5,9,1,2,0,2
Fremantle,"Ballantyne, Hayden",14,10,5,4,3,1,0,4
Fremantle,"Barlow, Michael",27,12,6,15,0,1,0,11
Fremantle,"Bradley, Kepler",11,9,5,2,0,0,8,1
Fremantle,"Crowley, Ryan",18,8,3,10,1,0,0,6
Fremantle,"Dawson, Zac",8,5,2,3,0,0,0,1
Fremantle,"Duffield, Paul",20,16,4,4,0,0,0,5
Fremantle,"Fyfe, Nat",20,12,4,8,0,0,0,0
Fremantle,"Hill, Stephen",21,16,5,5,0,1,0,4
Fremantle,"Ibbotson, Garrick",15,9,1,6,0,0,0,3
Fremantle,"Johnson, Michael",9,7,3,2,0,1,1,4
Fremantle,"Mayne, Chris",15,10,5,5,0,0,0,8
Fremantle,"McPhee, Adam",18,14,11,4,0,0,0,0
Fremantle,"Mundy, David",21,16,3,5,0,0,0,6
Fremantle,"Mzungu, Tendai",10,5,3,5,0,1,0,2
Fremantle,"Pavlich, Matthew",14,12,9,2,6,0,0,2
Fremantle,"Pearce, Clancee",17,11,5,6,1,0,0,5
Fremantle,"Sandilands, Aaron",11,3,2,8,0,0,35,0
Fremantle,"Silvagni, Alex",5,4,3,1,0,0,0,4
Fremantle,"Spurr, Lee",14,10,3,4,0,0,0,2
Fremantle,"Suban, Nick",4,4,1,0,0,0,0,0
Fremantle,"Walters, Michael",15,11,5,4,2,2,0,4
Fremantle,"de Boer, Matt",18,7,6,11,1,1,0,5
Fremantle,"Ballantyne, Hayden",10,9,0,1,1,0,0,2
Fremantle,"Barlow, Michael",20,13,7,7,0,0,0,4
Fremantle,"Clarke, Zac",8,5,4,3,0,0,7,4
Fremantle,"Crowley, Ryan",8,6,1,2,0,2,0,6
Fremantle,"Dawson, Zac",6,1,1,5,0,0,1,0
Fremantle,"Duffield, Paul",20,17,3,3,0,0,0,2
Fremantle,"Fyfe, Nat",19,13,3,6,1,0,0,6
Fremantle,"Hill, Stephen",12,8,3,4,0,1,0,3
Fremantle,"Ibbotson, Garrick",13,12,5,1,1,0,0,1
Fremantle,"Johnson, Michael",22,16,7,6,0,0,0,2
Fremantle,"Mayne, Chris",13,9,6,4,3,0,0,3
Fremantle,"McPhee, Adam",21,16,7,5,0,0,0,0
Fremantle,"Mundy, David",30,22,5,8,0,0,0,3
Fremantle,"Mzungu, Tendai",14,9,6,5,0,0,0,4
Fremantle,"Pavlich, Matthew",10,6,6,4,1,0,0,2
Fremantle,"Pearce, Clancee",14,11,5,3,0,0,0,5
Fremantle,"Sandilands, Aaron",7,2,2,5,0,0,30,0
Fremantle,"Silvagni, Alex",9,7,4,2,0,0,0,5
Fremantle,"Spurr, Lee",9,4,0,5,0,0,0,2
Fremantle,"Suban, Nick",2,2,0,0,1,0,0,1
Fremantle,"Walters, Michael",15,12,6,3,3,1,0,4
Fremantle,"de Boer, Matt",14,3,3,11,0,0,0,6
Gold Coast,"Ablett, Gary",42,23,3,19,2,0,0,3
Gold Coast,"Bennell, Harley",22,12,6,10,2,1,0,0
Gold Coast,"Brennan, Jared",27,20,6,7,0,0,1,3
Gold Coast,"Brown, Campbell",15,10,6,5,2,0,0,1
Gold Coast,"Caddy, Josh",16,12,7,4,1,0,0,2
Gold Coast,"Gorringe, Daniel",8,1,2,7,0,0,1,3
Gold Coast,"Hall, Aaron",17,7,3,10,0,0,0,1
Gold Coast,"Harbrow, Jarrod",17,10,6,7,0,0,0,0
Gold Coast,"Hickey, Tom",9,3,3,6,0,1,4,2
Gold Coast,"Hunt, Karmichael",15,8,4,7,0,0,0,3
Gold Coast,"Iles, Sam",22,11,7,11,0,0,0,3
Gold Coast,"Lynch, Tom",9,4,3,5,0,0,0,2
Gold Coast,"Matera, Brandon",10,6,0,4,0,0,0,4
Gold Coast,"May, Steven",11,7,4,4,0,0,0,1
Gold Coast,"Prestia, Dion",19,9,4,10,1,1,0,3
Gold Coast,"Rischitelli, Michael",26,9,3,17,0,0,0,3
Gold Coast,"Russell, Luke",16,11,8,5,0,1,0,1
Gold Coast,"Smith, Zac",13,5,1,8,1,0,15,3
Gold Coast,"Swallow, David",22,12,2,10,1,0,0,5
Gold Coast,"Tape, Seb",8,3,1,5,0,0,0,4
Gold Coast,"Taylor, Jeremy",9,5,3,4,0,0,0,1
Gold Coast,"Warnock, Matthew",9,2,1,7,0,0,0,0
Gold Coast,"Ablett, Gary",40,20,4,20,2,1,0,4
Gold Coast,"Bennell, Harley",19,6,2,13,0,0,1,1
Gold Coast,"Brennan, Jared",25,11,4,14,0,0,1,4
Gold Coast,"Brown, Campbell",8,5,3,3,2,0,0,1
Gold Coast,"Caddy, Josh",12,7,2,5,0,0,1,8
Gold Coast,"Hall, Aaron",9,4,0,5,0,0,0,1
Gold Coast,"Harbrow, Jarrod",16,10,4,6,0,1,0,2
Gold Coast,"Hickey, Tom",9,4,3,5,1,0,7,0
Gold Coast,"Hunt, Karmichael",6,1,1,5,0,0,0,3
Gold Coast,"Lynch, Tom",12,4,2,8,0,0,0,2
Gold Coast,"Matera, Brandon",20,12,5,8,1,1,0,1
Gold Coast,"May, Steven",10,4,2,6,0,1,0,3
Gold Coast,"McKenzie, Trent",6,4,1,2,0,0,0,1
Gold Coast,"Prestia, Dion",19,6,5,13,0,0,0,5
Gold Coast,"Rischitelli, Michael",11,4,2,7,0,0,0,6
Gold Coast,"Russell, Luke",16,7,1,9,1,0,0,4
Gold Coast,"Shaw, Matt",17,5,1,12,0,1,0,2
Gold Coast,"Smith, Zac",12,1,0,11,0,0,26,3
Gold Coast,"Swallow, David",28,12,1,16,0,0,0,7
Gold Coast,"Taylor, Jeremy",9,6,3,3,0,0,0,4
Gold Coast,"Warnock, Matthew",11,3,2,8,0,0,0,0
Gold Coast,"Weller, Maverick",15,3,3,12,0,0,0,2
Gold Coast,"Ablett, Gary",45,25,2,20,2,1,0,7
Gold Coast,"Bennell, Harley",13,3,1,10,0,0,0,4
Gold Coast,"Bock, Nathan",18,16,5,2,2,0,0,2
Gold Coast,"Brennan, Jared",18,12,2,6,1,0,0,2
Gold Coast,"Caddy, Josh",16,11,3,5,1,0,0,2
Gold Coast,"Day, Sam",3,0,1,3,0,0,0,1
Gold Coast,"Fraser, Josh",18,12,2,6,0,2,16,1
Gold Coast,"Hall, Aaron",12,11,3,1,2,1,0,3
Gold Coast,"Harbrow, Jarrod",16,11,3,5,1,1,0,5
Gold Coast,"Hunt, Karmichael",16,2,2,14,0,0,0,1
Gold Coast,"Lynch, Tom",12,6,4,6,0,0,0,1
Gold Coast,"Matera, Brandon",16,12,4,4,1,1,0,5
Gold Coast,"McKenzie, Trent",9,6,3,3,0,1,0,2
Gold Coast,"Prestia, Dion",18,7,1,11,0,0,0,7
Gold Coast,"Rischitelli, Michael",14,8,1,6,1,0,0,11
Gold Coast,"Russell, Luke",10,6,1,4,1,0,0,3
Gold Coast,"Shaw, Matt",17,10,4,7,1,0,0,0
Gold Coast,"Smith, Zac",17,6,2,11,0,0,18,1
Gold Coast,"Swallow, David",23,13,0,10,0,0,0,6
Gold Coast,"Tape, Seb",21,6,3,15,0,0,0,1
Gold Coast,"Warnock, Matthew",11,5,3,6,0,0,0,3
Gold Coast,"Weller, Maverick",9,4,2,5,0,0,0,4
Gold Coast,"Ablett, Gary",33,17,0,16,0,0,0,4
Gold Coast,"Bennell, Harley",17,10,1,7,3,0,1,2
Gold Coast,"Bock, Nathan",18,14,7,4,0,0,0,1
Gold Coast,"Brennan, Jared",17,10,5,7,0,0,0,3
Gold Coast,"Brown, Campbell",9,3,1,6,0,1,0,3
Gold Coast,"Caddy, Josh",20,10,5,10,0,0,0,2
Gold Coast,"Day, Sam",7,4,3,3,0,0,0,2
Gold Coast,"Fraser, Josh",14,6,1,8,0,0,14,1
Gold Coast,"Hall, Aaron",13,10,6,3,0,1,0,5
Gold Coast,"Harbrow, Jarrod",8,3,2,5,0,0,0,1
Gold Coast,"Hunt, Karmichael",21,5,1,16,0,1,0,6
Gold Coast,"Lynch, Tom",14,7,3,7,0,0,0,0
Gold Coast,"Matera, Brandon",12,8,1,4,0,1,0,2
Gold Coast,"McKenzie, Trent",14,13,3,1,1,2,0,2
Gold Coast,"Prestia, Dion",18,9,3,9,0,0,0,0
Gold Coast,"Rischitelli, Michael",20,8,2,12,0,0,0,4
Gold Coast,"Russell, Luke",14,9,2,5,0,0,0,1
Gold Coast,"Shaw, Matt",19,9,2,10,0,0,0,3
Gold Coast,"Smith, Zac",16,5,2,11,1,1,24,0
Gold Coast,"Swallow, David",25,12,2,13,1,0,0,1
Gold Coast,"Tape, Seb",8,1,2,7,0,0,0,0
Gold Coast,"Warnock, Matthew",12,4,2,8,0,0,0,0
Gold Coast,"Bennell, Harley",21,18,3,3,3,2,0,0
Gold Coast,"Bock, Nathan",17,11,9,6,0,1,1,1
Gold Coast,"Brennan, Jared",24,19,11,5,0,1,3,8
Gold Coast,"Brown, Campbell",12,4,3,8,2,0,0,1
Gold Coast,"Caddy, Josh",13,5,2,8,0,0,0,3
Gold Coast,"Day, Sam",10,5,3,5,2,1,0,1
Gold Coast,"Dixon, Charlie",11,7,3,4,2,2,6,2
Gold Coast,"Horsley, Kyal",19,15,5,4,0,1,0,8
Gold Coast,"Hunt, Karmichael",16,7,3,9,0,0,0,4
Gold Coast,"Iles, Sam",12,9,3,3,1,1,0,3
Gold Coast,"Lynch, Tom",14,11,7,3,1,0,0,2
Gold Coast,"Matera, Brandon",16,12,8,4,0,1,0,3
Gold Coast,"McKenzie, Trent",16,11,3,5,0,0,0,2
Gold Coast,"Prestia, Dion",14,6,2,8,0,1,0,5
Gold Coast,"Russell, Luke",10,5,4,5,1,0,0,0
Gold Coast,"Shaw, Matt",5,2,1,3,0,0,0,1
Gold Coast,"Smith, Zac",6,3,0,3,0,0,27,3
Gold Coast,"Swallow, David",23,18,4,5,1,0,0,4
Gold Coast,"Tape, Seb",8,7,5,1,0,0,0,0
Gold Coast,"Warnock, Matthew",12,3,2,9,0,0,0,2
Gold Coast,"Weller, Maverick",12,9,4,3,0,1,0,2
Gold Coast,"Wilkinson, Joel",9,4,4,5,0,0,0,3
Gold Coast,"Bennell, Harley",37,21,3,16,3,0,0,1
Gold Coast,"Bock, Nathan",7,5,3,2,0,0,0,0
Gold Coast,"Brennan, Jared",19,10,6,9,1,0,2,2
Gold Coast,"Brown, Campbell",12,6,4,6,1,0,0,0
Gold Coast,"Caddy, Josh",16,11,3,5,1,0,0,4
Gold Coast,"Day, Sam",10,6,4,4,1,0,0,3
Gold Coast,"Dixon, Charlie",14,4,2,10,0,0,12,4
Gold Coast,"Horsley, Kyal",25,12,7,13,0,0,0,10
Gold Coast,"Hunt, Karmichael",22,6,3,16,1,1,0,4
Gold Coast,"Iles, Sam",29,20,10,9,1,0,0,1
Gold Coast,"Lynch, Tom",20,12,9,8,0,0,0,2
Gold Coast,"McKenzie, Trent",17,9,4,8,0,0,1,2
Gold Coast,"Prestia, Dion",32,16,5,16,0,0,0,6
Gold Coast,"Russell, Luke",21,14,8,7,1,1,1,6
Gold Coast,"Shaw, Matt",17,12,6,5,1,0,0,0
Gold Coast,"Smith, Zac",16,6,4,10,0,0,20,1
Gold Coast,"Swallow, David",16,11,5,5,3,0,0,3
Gold Coast,"Tape, Seb",19,7,5,12,0,0,0,1
Gold Coast,"Toy, Josh",4,2,2,2,0,0,0,2
Gold Coast,"Warnock, Matthew",16,10,9,6,0,0,0,1
Gold Coast,"Weller, Maverick",19,8,4,11,0,0,0,5
Gold Coast,"Wilkinson, Joel",16,8,5,8,0,0,0,2
Gold Coast,"Ablett, Gary",33,23,2,10,0,1,0,2
Gold Coast,"Bennell, Harley",24,13,4,11,1,3,0,3
Gold Coast,"Brennan, Jared",15,7,1,8,0,0,6,3
Gold Coast,"Brown, Campbell",11,8,3,3,0,2,0,3
Gold Coast,"Caddy, Josh",19,11,6,8,2,0,0,2
Gold Coast,"Coad, Michael",18,12,5,6,0,0,0,1
Gold Coast,"Day, Sam",11,7,6,4,2,1,0,0
Gold Coast,"Dixon, Charlie",7,3,3,4,0,0,6,0
Gold Coast,"Horsley, Kyal",13,9,6,4,1,0,0,9
Gold Coast,"Hunt, Karmichael",16,5,1,11,0,0,1,2
Gold Coast,"Iles, Sam",28,16,8,12,1,0,0,5
Gold Coast,"Lynch, Tom",16,10,4,6,0,2,0,3
Gold Coast,"McKenzie, Trent",21,13,6,8,0,0,0,2
Gold Coast,"Prestia, Dion",26,15,5,11,0,1,0,11
Gold Coast,"Rischitelli, Michael",15,6,5,9,1,0,0,1
Gold Coast,"Russell, Luke",18,13,10,5,0,1,0,4
Gold Coast,"Smith, Zac",14,3,3,11,0,0,17,0
Gold Coast,"Swallow, David",10,9,3,1,1,0,0,1
Gold Coast,"Tape, Seb",11,6,3,5,0,0,0,8
Gold Coast,"Toy, Josh",1,0,0,1,0,0,0,1
Gold Coast,"Warnock, Matthew",22,17,10,5,0,0,0,3
Gold Coast,"Wilkinson, Joel",9,6,6,3,0,0,0,1
Gold Coast,"Ablett, Gary",29,17,2,12,0,1,0,9
Gold Coast,"Bennell, Harley",23,14,3,9,1,0,0,1
Gold Coast,"Brown, Campbell",10,7,5,3,0,0,0,7
Gold Coast,"Caddy, Josh",27,13,3,14,0,1,0,2
Gold Coast,"Day, Sam",12,4,4,8,0,0,1,1
Gold Coast,"Horsley, Kyal",27,14,3,13,0,3,0,7
Gold Coast,"Hunt, Karmichael",18,5,3,13,0,1,0,3
Gold Coast,"Iles, Sam",29,18,6,11,0,1,0,1
Gold Coast,"Lynch, Tom",12,5,5,7,1,0,1,1
Gold Coast,"McQualter, Andrew",20,8,2,12,0,0,0,0
Gold Coast,"Prestia, Dion",23,13,3,10,1,0,0,5
Gold Coast,"Rischitelli, Michael",9,3,1,6,0,0,0,3
Gold Coast,"Russell, Luke",14,7,3,7,0,0,0,6
Gold Coast,"Sexton, Alex",6,6,2,0,0,0,0,0
Gold Coast,"Shaw, Matt",27,11,3,16,0,1,0,1
Gold Coast,"Smith, Zac",16,4,3,12,1,0,20,1
Gold Coast,"Stanley, Danny",28,17,7,11,0,1,0,3
Gold Coast,"Tape, Seb",7,4,2,3,0,0,0,0
Gold Coast,"Taylor, Jeremy",11,4,3,7,0,0,0,4
Gold Coast,"Thompson, Rory",11,8,3,3,0,0,5,3
Gold Coast,"Warnock, Matthew",21,12,5,9,0,0,0,3
Gold Coast,"Wilkinson, Joel",9,3,3,6,0,0,0,2
Gold Coast,"Ablett, Gary",25,16,1,9,1,1,0,9
Gold Coast,"Bennell, Harley",25,11,3,14,0,0,2,3
Gold Coast,"Brown, Campbell",12,6,4,6,1,0,0,1
Gold Coast,"Caddy, Josh",20,8,1,12,0,2,1,1
Gold Coast,"Day, Sam",11,7,6,4,3,1,5,2
Gold Coast,"Horsley, Kyal",14,8,0,6,1,1,0,2
Gold Coast,"Hunt, Karmichael",13,3,1,10,0,0,0,2
Gold Coast,"Iles, Sam",25,13,7,12,0,0,0,4
Gold Coast,"Lynch, Tom",18,13,7,5,0,3,6,4
Gold Coast,"Magin, Alik",5,3,1,2,0,0,0,1
Gold Coast,"McQualter, Andrew",23,15,5,8,2,0,0,0
Gold Coast,"Prestia, Dion",19,9,2,10,0,0,0,5
Gold Coast,"Rischitelli, Michael",16,7,5,9,1,0,1,11
Gold Coast,"Sexton, Alex",11,8,4,3,1,0,0,3
Gold Coast,"Shaw, Matt",10,9,4,1,0,0,1,5
Gold Coast,"Smith, Zac",9,2,1,7,0,0,20,1
Gold Coast,"Stanley, Danny",25,13,6,12,0,1,0,2
Gold Coast,"Tape, Seb",10,4,2,6,0,0,0,2
Gold Coast,"Taylor, Jeremy",6,2,0,4,0,0,0,7
Gold Coast,"Thompson, Rory",8,5,2,3,0,0,2,3
Gold Coast,"Warnock, Matthew",13,5,2,8,0,0,0,0
Gold Coast,"Wilkinson, Joel",8,4,3,4,0,0,0,4
Gold Coast,"Ablett, Gary",53,31,9,22,0,0,0,6
Gold Coast,"Bennell, Harley",28,13,6,15,0,4,0,3
Gold Coast,"Brown, Campbell",14,8,5,6,3,0,0,1
Gold Coast,"Caddy, Josh",16,6,3,10,0,0,0,0
Gold Coast,"Day, Sam",7,1,3,6,0,0,5,1
Gold Coast,"Hall, Aaron",15,8,2,7,1,1,0,8
Gold Coast,"Hickey, Tom",19,9,8,10,0,0,24,4
Gold Coast,"Horsley, Kyal",10,5,3,5,0,0,0,1
Gold Coast,"Hunt, Karmichael",15,5,2,10,0,0,1,0
Gold Coast,"Iles, Sam",24,17,6,7,0,0,0,0
Gold Coast,"Lynch, Tom",13,9,7,4,1,1,0,1
Gold Coast,"Magin, Alik",8,2,2,6,0,0,0,1
Gold Coast,"McKenzie, Trent",21,16,6,5,0,0,1,4
Gold Coast,"McQualter, Andrew",12,6,4,6,0,1,0,5
Gold Coast,"Rischitelli, Michael",7,4,0,3,0,1,0,5
Gold Coast,"Russell, Luke",16,11,8,5,1,0,1,2
Gold Coast,"Sexton, Alex",14,10,5,4,0,0,0,2
Gold Coast,"Shaw, Matt",19,12,7,7,1,0,0,0
Gold Coast,"Stanley, Danny",20,13,9,7,0,0,0,3
Gold Coast,"Thompson, Rory",11,7,6,4,0,0,0,1
Gold Coast,"Warnock, Matthew",12,6,4,6,0,0,0,2
Gold Coast,"Wilkinson, Joel",9,6,3,3,0,0,0,3
Gold Coast,"Ablett, Gary",20,12,1,8,0,0,0,2
Gold Coast,"Bennell, Harley",18,11,2,7,0,2,0,5
Gold Coast,"Brennan, Jared",18,13,7,5,2,0,5,2
Gold Coast,"Brown, Campbell",2,2,2,0,0,0,0,0
Gold Coast,"Caddy, Josh",20,9,6,11,0,0,2,3
Gold Coast,"Day, Sam",5,3,2,2,0,0,1,0
Gold Coast,"Hall, Aaron",14,7,5,7,1,0,0,3
Gold Coast,"Hickey, Tom",12,6,7,6,2,1,18,0
Gold Coast,"Hunt, Karmichael",18,5,3,13,0,0,0,3
Gold Coast,"Iles, Sam",27,15,3,12,0,0,0,0
Gold Coast,"Matera, Brandon",17,13,5,4,0,1,0,1
Gold Coast,"McKenzie, Trent",18,14,6,4,0,1,0,3
Gold Coast,"McQualter, Andrew",12,8,7,4,0,0,0,2
Gold Coast,"Rischitelli, Michael",8,2,0,6,1,0,0,4
Gold Coast,"Russell, Luke",14,9,6,5,0,1,2,1
Gold Coast,"Sexton, Alex",9,6,4,3,0,0,0,4
Gold Coast,"Shaw, Matt",8,3,1,5,0,0,0,1
Gold Coast,"Stanley, Danny",26,13,8,13,1,0,0,3
Gold Coast,"Tape, Seb",9,5,5,4,0,0,0,4
Gold Coast,"Thompson, Rory",8,7,4,1,0,0,2,2
Gold Coast,"Toy, Josh",7,3,3,4,0,0,0,4
Gold Coast,"Warnock, Matthew",15,7,3,8,0,0,0,0
Gold Coast,"Ablett, Gary",42,19,1,23,4,0,0,5
Gold Coast,"Bennell, Harley",27,14,1,13,2,0,2,2
Gold Coast,"Brennan, Jared",13,7,5,6,1,2,0,3
Gold Coast,"Caddy, Josh",13,10,3,3,1,1,1,3
Gold Coast,"Day, Sam",6,4,3,2,1,1,0,0
Gold Coast,"Hickey, Tom",11,1,3,10,0,0,12,2
Gold Coast,"Hine, Taylor",16,7,2,9,1,0,0,2
Gold Coast,"Horsley, Kyal",25,8,2,17,0,0,0,3
Gold Coast,"Hunt, Karmichael",21,6,1,15,0,0,0,3
Gold Coast,"Iles, Sam",20,16,5,4,0,0,0,3
Gold Coast,"Matera, Brandon",21,14,10,7,1,1,0,1
Gold Coast,"McKenzie, Trent",15,6,1,9,0,0,0,2
Gold Coast,"Patrick, Liam",18,9,4,9,1,2,0,3
Gold Coast,"Rischitelli, Michael",20,10,5,10,0,1,0,5
Gold Coast,"Russell, Luke",16,10,4,6,0,0,0,2
Gold Coast,"Sexton, Alex",7,5,1,2,0,0,0,1
Gold Coast,"Smith, Zac",17,4,6,13,0,0,22,1
Gold Coast,"Stanley, Danny",27,14,6,13,0,0,0,4
Gold Coast,"Tape, Seb",4,3,1,1,0,0,0,2
Gold Coast,"Thompson, Rory",8,5,3,3,0,0,0,3
Gold Coast,"Warnock, Matthew",11,4,1,7,0,0,1,2
Gold Coast,"Wilkinson, Joel",7,1,0,6,0,0,0,4
Gold Coast,"Ablett, Gary",26,16,3,10,1,2,0,5
Gold Coast,"Bennell, Harley",22,12,4,10,1,1,1,2
Gold Coast,"Brennan, Jared",11,6,2,5,0,1,0,2
Gold Coast,"Caddy, Josh",10,6,3,4,0,0,0,2
Gold Coast,"Day, Sam",5,2,1,3,0,1,0,1
Gold Coast,"Dixon, Charlie",10,5,2,5,1,0,0,2
Gold Coast,"Hickey, Tom",7,4,5,3,0,0,4,4
Gold Coast,"Hine, Taylor",9,6,3,3,0,0,0,2
Gold Coast,"Horsley, Kyal",14,10,1,4,0,1,0,4
Gold Coast,"Hunt, Karmichael",8,1,0,7,0,0,0,4
Gold Coast,"Iles, Sam",22,11,5,11,0,0,0,2
Gold Coast,"Matera, Brandon",14,9,4,5,0,2,0,1
Gold Coast,"May, Steven",13,10,5,3,0,0,0,4
Gold Coast,"McKenzie, Trent",13,8,5,5,0,0,0,1
Gold Coast,"Patrick, Liam",10,7,4,3,1,0,0,3
Gold Coast,"Sexton, Alex",3,3,2,0,0,1,0,0
Gold Coast,"Shaw, Matt",19,9,3,10,1,0,0,3
Gold Coast,"Smith, Zac",9,2,1,7,0,0,12,0
Gold Coast,"Stanley, Danny",30,17,6,13,0,0,1,1
Gold Coast,"Taylor, Jeremy",6,2,1,4,0,0,0,0
Gold Coast,"Warnock, Matthew",7,4,2,3,0,0,0,1
Gold Coast,"Wilkinson, Joel",8,5,2,3,0,0,0,2
Gold Coast,"Ablett, Gary",27,19,2,8,2,4,0,3
Gold Coast,"Bennell, Harley",22,13,3,9,2,0,0,3
Gold Coast,"Brennan, Jared",14,12,8,2,0,3,2,3
Gold Coast,"Brown, Campbell",13,5,4,8,1,1,0,2
Gold Coast,"Caddy, Josh",18,11,6,7,3,0,0,0
Gold Coast,"Day, Sam",10,5,4,5,1,3,0,0
Gold Coast,"Dixon, Charlie",12,9,8,3,0,1,0,3
Gold Coast,"Harbrow, Jarrod",23,17,7,6,1,0,0,3
Gold Coast,"Hickey, Tom",10,6,5,4,0,1,6,1
Gold Coast,"Horsley, Kyal",13,7,5,6,0,0,0,0
Gold Coast,"Hunt, Karmichael",10,7,3,3,0,0,0,3
Gold Coast,"Matera, Brandon",15,9,5,6,0,0,0,2
Gold Coast,"McKenzie, Trent",16,14,4,2,2,0,0,0
Gold Coast,"Patrick, Liam",8,5,2,3,0,1,0,2
Gold Coast,"Prestia, Dion",15,9,2,6,0,0,0,2
Gold Coast,"Rischitelli, Michael",20,9,6,11,1,1,0,1
Gold Coast,"Shaw, Matt",17,9,5,8,0,0,0,0
Gold Coast,"Smith, Zac",13,3,3,10,0,0,11,2
Gold Coast,"Stanley, Danny",19,10,7,9,0,0,0,3
Gold Coast,"Warnock, Matthew",6,2,2,4,0,0,0,1
Gold Coast,"Weller, Maverick",11,6,2,5,0,1,0,1
Gold Coast,"Wilkinson, Joel",1,1,1,0,0,0,0,2
Gold Coast,"Ablett, Gary",33,21,7,12,1,1,0,5
Gold Coast,"Bennell, Harley",30,12,6,18,1,1,1,1
Gold Coast,"Brennan, Jared",9,5,2,4,0,0,0,1
Gold Coast,"Brown, Campbell",15,12,8,3,1,3,0,0
Gold Coast,"Caddy, Josh",15,10,1,5,1,0,0,5
Gold Coast,"Day, Sam",7,2,2,5,0,1,2,0
Gold Coast,"Dixon, Charlie",15,9,6,6,0,0,2,0
Gold Coast,"Hall, Aaron",6,4,1,2,1,0,0,1
Gold Coast,"Hall, Josh",6,4,2,2,2,1,0,0
Gold Coast,"Harbrow, Jarrod",20,12,4,8,1,0,0,3
Gold Coast,"Hunt, Karmichael",10,7,5,3,2,0,1,6
Gold Coast,"Matera, Brandon",20,11,4,9,2,1,0,0
Gold Coast,"McKenzie, Trent",26,18,8,8,0,0,0,4
Gold Coast,"Patrick, Liam",14,6,5,8,0,1,0,2
Gold Coast,"Prestia, Dion",17,10,2,7,0,1,0,5
Gold Coast,"Rischitelli, Michael",13,4,2,9,0,0,0,2
Gold Coast,"Shaw, Matt",19,16,11,3,0,0,0,3
Gold Coast,"Smith, Zac",8,2,1,6,0,0,19,1
Gold Coast,"Stanley, Danny",22,12,8,10,0,0,0,2
Gold Coast,"Swallow, David",11,6,4,5,1,0,0,3
Gold Coast,"Warnock, Matthew",9,7,4,2,0,0,0,1
Gold Coast,"Weller, Maverick",15,8,2,7,0,0,0,3
Gold Coast,"Ablett, Gary",37,20,4,17,1,2,0,8
Gold Coast,"Bennell, Harley",17,10,3,7,1,0,2,2
Gold Coast,"Brennan, Jared",15,13,4,2,1,2,0,3
Gold Coast,"Brown, Campbell",11,8,6,3,0,0,0,2
Gold Coast,"Caddy, Josh",13,6,3,7,1,0,1,2
Gold Coast,"Day, Sam",6,2,1,4,0,1,1,2
Gold Coast,"Dixon, Charlie",18,13,7,5,0,0,2,1
Gold Coast,"Hall, Josh",2,1,2,1,0,0,0,0
Gold Coast,"Harbrow, Jarrod",18,12,2,6,0,1,0,5
Gold Coast,"Hunt, Karmichael",13,6,1,7,0,0,2,2
Gold Coast,"Lynch, Tom",14,9,7,5,1,1,2,1
Gold Coast,"Matera, Brandon",9,7,5,2,0,1,0,4
Gold Coast,"McKenzie, Trent",19,14,7,5,0,1,0,4
Gold Coast,"Patrick, Liam",4,4,1,0,0,1,0,0
Gold Coast,"Prestia, Dion",26,17,4,9,0,0,0,2
Gold Coast,"Rischitelli, Michael",14,9,3,5,0,0,0,1
Gold Coast,"Russell, Luke",17,13,5,4,0,1,0,1
Gold Coast,"Shaw, Matt",21,13,5,8,0,1,0,2
Gold Coast,"Smith, Zac",13,5,4,8,0,0,21,1
Gold Coast,"Swallow, David",16,8,2,8,0,1,0,4
Gold Coast,"Warnock, Matthew",18,10,8,8,0,0,1,1
Gold Coast,"Weller, Maverick",14,8,3,6,0,0,1,0
Gold Coast,"Ablett, Gary",42,23,2,19,1,1,0,9
Gold Coast,"Bennell, Harley",28,13,4,15,0,1,0,2
Gold Coast,"Brennan, Jared",21,9,3,12,0,0,3,7
Gold Coast,"Brown, Campbell",9,8,3,1,1,1,0,1
Gold Coast,"Caddy, Josh",16,9,7,7,0,0,2,6
Gold Coast,"Dixon, Charlie",12,7,5,5,0,1,11,2
Gold Coast,"Harbrow, Jarrod",25,12,3,13,0,0,0,6
Gold Coast,"Hine, Taylor",26,10,1,16,0,0,0,1
Gold Coast,"Hunt, Karmichael",14,3,2,11,0,0,3,6
Gold Coast,"Lynch, Tom",17,9,6,8,1,0,1,1
Gold Coast,"Matera, Brandon",18,14,3,4,3,1,0,1
Gold Coast,"May, Steven",12,9,5,3,0,0,0,1
Gold Coast,"McKenzie, Trent",25,13,6,12,0,0,0,1
Gold Coast,"Patrick, Liam",7,4,3,3,0,0,0,1
Gold Coast,"Prestia, Dion",24,8,0,16,0,0,0,2
Gold Coast,"Russell, Luke",19,9,4,10,0,0,0,3
Gold Coast,"Shaw, Matt",11,6,2,5,0,0,0,1
Gold Coast,"Smith, Zac",12,2,2,10,2,0,15,1
Gold Coast,"Stanley, Danny",21,6,3,15,0,0,0,3
Gold Coast,"Swallow, David",5,1,0,4,0,0,0,2
Gold Coast,"Warnock, Matthew",17,12,8,5,0,0,0,0
Gold Coast,"Weller, Maverick",17,5,2,12,0,0,0,4
Gold Coast,"Ablett, Gary",33,21,3,12,1,1,0,7
Gold Coast,"Bennell, Harley",38,21,7,17,4,0,1,4
Gold Coast,"Brennan, Jared",22,11,3,11,1,1,3,1
Gold Coast,"Brown, Campbell",10,7,5,3,0,0,0,1
Gold Coast,"Caddy, Josh",11,8,4,3,0,1,2,2
Gold Coast,"Day, Sam",11,4,3,7,0,0,1,2
Gold Coast,"Dixon, Charlie",10,5,2,5,0,1,18,2
Gold Coast,"Harbrow, Jarrod",22,14,2,8,0,0,0,0
Gold Coast,"Hine, Taylor",6,2,0,4,0,0,0,1
Gold Coast,"Hunt, Karmichael",12,2,1,10,0,0,0,8
Gold Coast,"Lynch, Tom",18,12,8,6,1,0,3,2
Gold Coast,"Matera, Brandon",15,10,4,5,0,4,0,5
Gold Coast,"McKenzie, Trent",14,6,8,8,0,0,0,3
Gold Coast,"Patrick, Liam",13,8,5,5,0,1,0,2
Gold Coast,"Prestia, Dion",6,1,1,5,0,0,0,1
Gold Coast,"Rischitelli, Michael",10,6,3,4,1,1,0,2
Gold Coast,"Russell, Luke",16,8,2,8,1,0,0,2
Gold Coast,"Shaw, Matt",20,14,9,6,0,1,0,1
Gold Coast,"Smith, Zac",7,1,1,6,0,0,7,0
Gold Coast,"Swallow, David",23,12,1,11,0,0,0,4
Gold Coast,"Warnock, Matthew",5,3,3,2,0,0,0,0
Gold Coast,"Weller, Maverick",15,7,4,8,0,0,0,1
Gold Coast,"Ablett, Gary",23,13,2,10,3,0,0,4
Gold Coast,"Allen, Jackson",15,11,5,4,0,0,0,4
Gold Coast,"Bennell, Harley",18,12,3,6,1,0,1,0
Gold Coast,"Brennan, Jared",15,9,5,6,0,0,3,4
Gold Coast,"Brown, Campbell",13,9,7,4,3,0,0,1
Gold Coast,"Caddy, Josh",16,8,4,8,1,1,0,1
Gold Coast,"Dixon, Charlie",14,8,3,6,0,0,12,1
Gold Coast,"Hall, Aaron",15,14,4,1,3,2,0,7
Gold Coast,"Harbrow, Jarrod",14,8,3,6,0,0,0,2
Gold Coast,"Hine, Taylor",14,7,1,7,0,0,0,6
Gold Coast,"Horsley, Kyal",23,11,4,12,0,1,0,3
Gold Coast,"Lynch, Tom",18,6,6,12,1,2,5,2
Gold Coast,"Matera, Brandon",22,17,5,5,2,1,0,0
Gold Coast,"May, Steven",5,4,3,1,0,0,0,0
Gold Coast,"McKenzie, Trent",15,8,6,7,0,1,1,8
Gold Coast,"Patrick, Liam",10,3,1,7,2,0,0,1
Gold Coast,"Shaw, Matt",17,11,5,6,0,1,0,0
Gold Coast,"Stanley, Danny",26,14,12,12,0,0,0,2
Gold Coast,"Swallow, David",24,16,7,8,0,1,3,3
Gold Coast,"Taylor, Jeremy",8,3,3,5,0,0,0,1
Gold Coast,"Warnock, Matthew",20,10,5,10,0,0,0,0
Gold Coast,"Weller, Maverick",16,9,5,7,0,0,0,2
Gold Coast,"Ablett, Gary",43,22,9,21,2,0,0,8
Gold Coast,"Bennell, Harley",31,12,3,19,0,0,0,3
Gold Coast,"Brennan, Jared",10,6,1,4,0,0,6,4
Gold Coast,"Brown, Campbell",15,11,8,4,2,1,0,1
Gold Coast,"Caddy, Josh",13,4,2,9,0,0,1,2
Gold Coast,"Coad, Michael",8,7,1,1,0,0,0,2
Gold Coast,"Flanagan, Piers",9,4,0,5,0,0,0,2
Gold Coast,"Harbrow, Jarrod",15,10,3,5,0,1,0,1
Gold Coast,"Hickey, Tom",12,2,3,10,0,0,10,2
Gold Coast,"Hine, Taylor",15,10,3,5,0,0,0,2
Gold Coast,"Horsley, Kyal",11,5,3,6,0,0,0,2
Gold Coast,"Lynch, Tom",11,7,4,4,0,0,3,2
Gold Coast,"Magin, Alik",13,6,1,7,2,0,0,3
Gold Coast,"Matera, Brandon",14,7,1,7,0,0,0,4
Gold Coast,"May, Steven",22,16,12,6,3,0,0,2
Gold Coast,"McQualter, Andrew",17,8,5,9,0,0,0,4
Gold Coast,"Shaw, Matt",9,3,2,6,0,1,0,2
Gold Coast,"Stanley, Danny",25,8,6,17,0,1,0,2
Gold Coast,"Taylor, Jeremy",12,4,3,8,1,0,0,2
Gold Coast,"Toy, Josh",3,0,0,3,0,0,0,0
Gold Coast,"Warnock, Matthew",13,4,2,9,0,0,0,2
Gold Coast,"Weller, Maverick",17,4,5,13,0,0,0,2
Gold Coast,"Ablett, Gary",23,16,1,7,1,2,0,3
Gold Coast,"Bennell, Harley",22,11,3,11,0,1,2,5
Gold Coast,"Brown, Campbell",11,9,5,2,2,0,0,2
Gold Coast,"Caddy, Josh",11,8,6,3,3,0,0,1
Gold Coast,"Coad, Michael",16,14,8,2,0,0,0,0
Gold Coast,"Dixon, Charlie",12,10,5,2,1,1,8,2
Gold Coast,"Flanagan, Piers",6,5,3,1,0,0,0,3
Gold Coast,"Gillbee, Jacob",6,5,2,1,0,0,0,1
Gold Coast,"Harbrow, Jarrod",13,10,1,3,0,0,0,0
Gold Coast,"Hickey, Tom",6,5,4,1,1,0,13,2
Gold Coast,"Hine, Taylor",15,8,4,7,0,0,0,3
Gold Coast,"Horsley, Kyal",14,9,3,5,1,0,0,5
Gold Coast,"Lynch, Tom",16,8,6,8,4,0,6,0
Gold Coast,"Magin, Alik",10,4,1,6,0,1,0,2
Gold Coast,"Matera, Brandon",21,13,5,8,0,0,0,2
Gold Coast,"May, Steven",10,8,7,2,0,1,0,1
Gold Coast,"McKenzie, Trent",16,12,6,4,1,0,0,3
Gold Coast,"Shaw, Matt",14,8,6,6,0,0,0,1
Gold Coast,"Stanley, Danny",21,12,5,9,0,0,0,3
Gold Coast,"Toy, Josh",3,2,0,1,0,0,0,2
Gold Coast,"Warnock, Matthew",13,6,4,7,0,0,0,1
Gold Coast,"Weller, Maverick",12,8,5,4,1,0,0,2
Gold Coast,"Ablett, Gary",26,15,3,11,2,1,0,7
Gold Coast,"Bennell, Harley",19,11,1,8,0,2,1,1
Gold Coast,"Brown, Campbell",13,7,4,6,1,1,0,1
Gold Coast,"Caddy, Josh",3,1,0,2,0,0,0,3
Gold Coast,"Coad, Michael",19,12,3,7,0,0,0,2
Gold Coast,"Dixon, Charlie",16,9,2,7,0,0,16,2
Gold Coast,"Flanagan, Piers",5,3,2,2,0,0,0,0
Gold Coast,"Gillbee, Jacob",14,6,4,8,1,1,0,2
Gold Coast,"Harbrow, Jarrod",13,8,2,5,0,0,0,1
Gold Coast,"Hickey, Tom",2,1,1,1,0,0,3,0
Gold Coast,"Hine, Taylor",16,9,4,7,0,0,0,3
Gold Coast,"Horsley, Kyal",15,9,3,6,0,0,0,6
Gold Coast,"Lynch, Tom",20,14,10,6,1,1,3,0
Gold Coast,"Magin, Alik",8,5,2,3,0,0,0,3
Gold Coast,"Matera, Brandon",21,12,3,9,1,0,0,2
Gold Coast,"May, Steven",9,6,3,3,2,0,0,1
Gold Coast,"McKenzie, Trent",16,8,4,8,0,0,0,2
Gold Coast,"Shaw, Matt",13,8,3,5,1,0,1,1
Gold Coast,"Stanley, Danny",23,14,9,9,0,0,0,5
Gold Coast,"Taylor, Jeremy",14,3,3,11,0,0,0,0
Gold Coast,"Warnock, Matthew",16,9,7,7,0,0,0,3
Gold Coast,"Weller, Maverick",12,5,6,7,0,0,0,1
Geelong,"Bartel, Jimmy",21,15,5,6,3,1,3,4
Geelong,"Chapman, Paul",24,19,6,5,0,0,0,5
Geelong,"Christensen, Allen",9,4,2,5,0,0,0,1
Geelong,"Corey, Joel",18,9,3,9,0,0,1,5
Geelong,"Duncan, Mitch",16,12,7,4,1,0,0,1
Geelong,"Enright, Corey",11,8,1,3,0,0,0,2
Geelong,"Guthrie, Cameron",13,4,1,9,0,0,0,7
Geelong,"Hawkins, Tom",9,7,6,2,4,2,2,2
Geelong,"Hunt, Taylor",11,5,1,6,1,1,0,2
Geelong,"Johnson, Steve",16,12,2,4,1,0,0,6
Geelong,"Kelly, James",26,13,5,13,0,0,0,8
Geelong,"Lonergan, Tom",11,6,3,5,0,0,0,2
Geelong,"Mackie, Andrew",20,15,5,5,1,1,0,4
Geelong,"Motlop, Steven",14,8,5,6,2,0,0,4
Geelong,"Podsiadly, James",16,11,5,5,2,0,0,3
Geelong,"Scarlett, Matthew",10,8,4,2,0,0,0,5
Geelong,"Selwood, Joel",33,17,3,16,0,1,2,4
Geelong,"Smedts, Billie",9,4,0,5,0,0,0,7
Geelong,"Stephenson, Orren",3,1,1,2,0,0,10,2
Geelong,"Stokes, Mathew",15,10,6,5,0,1,0,3
Geelong,"Taylor, Harry",14,9,2,5,0,0,0,2
Geelong,"West, Trent",8,4,1,4,0,1,14,3
Geelong,"Bartel, Jimmy",20,11,7,9,2,0,2,8
Geelong,"Brown, Mitch",1,1,1,0,0,0,0,0
Geelong,"Byrnes, Shannon",9,6,1,3,0,0,0,3
Geelong,"Chapman, Paul",22,15,5,7,0,0,0,7
Geelong,"Christensen, Allen",24,9,0,15,0,0,0,2
Geelong,"Corey, Joel",24,14,2,10,0,0,1,2
Geelong,"Duncan, Mitch",11,8,2,3,0,0,0,1
Geelong,"Enright, Corey",20,12,2,8,0,0,0,1
Geelong,"Guthrie, Cameron",9,6,0,3,0,0,0,4
Geelong,"Hawkins, Tom",22,16,12,6,3,2,2,2
Geelong,"Hunt, Taylor",11,9,1,2,0,0,0,2
Geelong,"Johnson, Steve",17,11,5,6,3,1,0,6
Geelong,"Kelly, James",21,11,3,10,0,0,0,6
Geelong,"Lonergan, Tom",10,5,2,5,0,0,0,0
Geelong,"Mackie, Andrew",13,8,4,5,0,0,0,3
Geelong,"Motlop, Steven",8,6,0,2,0,0,0,5
Geelong,"Podsiadly, James",15,12,6,3,5,0,0,1
Geelong,"Selwood, Joel",24,11,3,13,0,0,2,8
Geelong,"Smedts, Billie",12,6,1,6,1,0,0,0
Geelong,"Stokes, Mathew",6,4,1,2,0,0,0,6
Geelong,"Taylor, Harry",16,12,3,4,0,0,0,2
Geelong,"West, Trent",8,4,3,4,0,0,32,1
Geelong,"Bartel, Jimmy",22,9,6,13,0,1,0,6
Geelong,"Byrnes, Shannon",9,4,1,5,1,0,0,2
Geelong,"Chapman, Paul",12,10,1,2,0,0,0,6
Geelong,"Christensen, Allen",16,10,6,6,0,2,0,4
Geelong,"Corey, Joel",21,10,6,11,0,0,1,9
Geelong,"Duncan, Mitch",18,11,6,7,1,1,0,2
Geelong,"Enright, Corey",18,10,5,8,0,0,0,3
Geelong,"Gillies, Tom",12,6,3,6,1,0,0,3
Geelong,"Guthrie, Cameron",12,7,1,5,0,0,0,4
Geelong,"Hawkins, Tom",12,6,5,6,4,1,0,1
Geelong,"Horlin-Smith, George",12,9,6,3,1,1,0,0
Geelong,"Hunt, Taylor",23,15,8,8,0,0,0,1
Geelong,"Johnson, Steve",13,10,3,3,0,1,0,4
Geelong,"Kelly, James",22,13,2,9,0,1,0,3
Geelong,"Lonergan, Tom",10,4,3,6,0,0,0,1
Geelong,"Mackie, Andrew",5,3,0,2,0,0,0,1
Geelong,"Motlop, Steven",12,11,1,1,2,2,0,3
Geelong,"Podsiadly, James",12,11,8,1,5,3,1,2
Geelong,"Selwood, Joel",29,15,4,14,0,2,0,4
Geelong,"Stephenson, Orren",11,4,5,7,0,0,16,5
Geelong,"Taylor, Harry",14,6,4,8,1,0,0,3
Geelong,"West, Trent",12,6,2,6,0,0,24,1
Geelong,"Bartel, Jimmy",22,10,6,12,0,0,1,8
Geelong,"Chapman, Paul",18,16,5,2,2,0,0,6
Geelong,"Christensen, Allen",23,12,4,11,1,1,0,8
Geelong,"Corey, Joel",17,9,0,8,0,0,2,4
Geelong,"Duncan, Mitch",8,3,2,5,1,1,0,3
Geelong,"Enright, Corey",25,14,6,11,0,0,0,4
Geelong,"Gillies, Tom",14,8,5,6,0,0,0,1
Geelong,"Guthrie, Cameron",18,6,3,12,0,0,0,5
Geelong,"Hawkins, Tom",14,9,7,5,1,2,2,3
Geelong,"Horlin-Smith, George",11,5,4,6,0,0,0,1
Geelong,"Hunt, Josh",14,12,9,2,1,1,0,4
Geelong,"Hunt, Taylor",17,8,4,9,0,0,0,7
Geelong,"Johnson, Steve",21,15,7,6,0,1,0,5
Geelong,"Lonergan, Tom",13,7,7,6,0,0,0,4
Geelong,"Mackie, Andrew",19,15,3,4,0,0,0,2
Geelong,"Motlop, Steven",20,13,3,7,1,0,0,2
Geelong,"Podsiadly, James",9,6,1,3,1,0,1,4
Geelong,"Selwood, Joel",27,13,5,14,1,0,2,10
Geelong,"Stokes, Mathew",16,8,2,8,2,0,0,4
Geelong,"Stringer, Jesse",6,3,2,3,0,2,0,3
Geelong,"Taylor, Harry",29,15,8,14,0,0,1,4
Geelong,"West, Trent",12,7,4,5,0,1,31,2
Geelong,"Bartel, Jimmy",15,8,2,7,0,0,0,9
Geelong,"Chapman, Paul",29,21,2,8,2,1,0,2
Geelong,"Christensen, Allen",29,15,1,14,0,0,0,7
Geelong,"Corey, Joel",23,13,1,10,1,0,1,5
Geelong,"Duncan, Mitch",16,10,4,6,1,0,0,3
Geelong,"Enright, Corey",18,13,2,5,0,0,0,1
Geelong,"Guthrie, Cameron",11,6,2,5,0,0,0,3
Geelong,"Hawkins, Tom",11,11,6,0,6,0,3,1
Geelong,"Hunt, Josh",7,6,2,1,0,0,0,3
Geelong,"Hunt, Taylor",20,12,3,8,0,0,0,6
Geelong,"Johnson, Steve",21,17,2,4,0,0,0,6
Geelong,"Lonergan, Tom",8,5,2,3,0,0,0,3
Geelong,"Mackie, Andrew",18,18,3,0,0,1,0,2
Geelong,"Motlop, Steven",15,10,3,5,1,1,0,4
Geelong,"Podsiadly, James",11,7,1,4,0,0,5,5
Geelong,"Scarlett, Matthew",16,11,6,5,0,0,0,7
Geelong,"Selwood, Joel",18,9,0,9,1,0,1,5
Geelong,"Smedts, Billie",2,2,0,0,0,0,0,1
Geelong,"Stokes, Mathew",9,8,0,1,0,1,0,3
Geelong,"Stringer, Jesse",15,7,2,8,0,0,0,10
Geelong,"Taylor, Harry",20,13,8,7,0,0,1,3
Geelong,"West, Trent",10,4,0,6,0,1,38,5
Geelong,"Bartel, Jimmy",16,8,1,8,2,0,1,5
Geelong,"Brown, Mitch",9,6,3,3,0,2,0,3
Geelong,"Byrnes, Shannon",16,5,4,11,0,1,0,6
Geelong,"Chapman, Paul",22,15,9,7,3,0,0,5
Geelong,"Christensen, Allen",22,10,4,12,0,1,0,1
Geelong,"Corey, Joel",34,10,2,24,0,2,2,3
Geelong,"Duncan, Mitch",31,15,8,16,0,1,0,4
Geelong,"Enright, Corey",31,13,6,18,0,0,0,3
Geelong,"Gillies, Tom",19,11,8,8,0,0,0,3
Geelong,"Guthrie, Cameron",3,1,1,2,0,0,0,0
Geelong,"Hawkins, Tom",16,13,10,3,1,2,7,0
Geelong,"Hunt, Josh",19,13,4,6,0,0,0,3
Geelong,"Johnson, Steve",35,18,10,17,3,2,0,7
Geelong,"Kelly, James",24,14,3,10,1,1,0,3
Geelong,"Mackie, Andrew",18,10,6,8,2,0,0,2
Geelong,"Motlop, Steven",28,17,3,11,1,0,0,2
Geelong,"Podsiadly, James",19,16,9,3,3,0,0,3
Geelong,"Scarlett, Matthew",21,15,8,6,0,0,0,3
Geelong,"Smedts, Billie",11,8,5,3,0,1,0,1
Geelong,"Stringer, Jesse",18,8,3,10,1,1,0,4
Geelong,"Taylor, Harry",25,9,7,16,0,0,0,2
Geelong,"West, Trent",6,2,1,4,0,0,20,1
Geelong,"Byrnes, Shannon",6,3,4,3,0,1,0,1
Geelong,"Chapman, Paul",24,14,5,10,1,1,0,5
Geelong,"Christensen, Allen",17,5,0,12,2,0,0,4
Geelong,"Corey, Joel",22,10,6,12,0,0,2,2
Geelong,"Duncan, Mitch",21,17,10,4,3,0,0,1
Geelong,"Enright, Corey",17,7,5,10,0,0,0,2
Geelong,"Gillies, Tom",10,6,3,4,0,0,0,1
Geelong,"Guthrie, Cameron",8,4,2,4,0,0,0,1
Geelong,"Hawkins, Tom",8,4,5,4,0,1,4,3
Geelong,"Hunt, Josh",18,10,4,8,0,0,0,2
Geelong,"Hunt, Taylor",16,6,4,10,0,1,0,4
Geelong,"Johnson, Steve",25,16,5,9,0,1,0,4
Geelong,"Kelly, James",27,17,4,10,0,0,0,9
Geelong,"Lonergan, Tom",11,5,4,6,0,0,0,0
Geelong,"Mackie, Andrew",20,14,8,6,0,1,0,1
Geelong,"Motlop, Steven",13,8,2,5,0,1,0,2
Geelong,"Podsiadly, James",11,5,4,6,1,1,0,4
Geelong,"Selwood, Joel",29,9,4,20,2,0,1,5
Geelong,"Smedts, Billie",17,13,6,4,0,0,0,3
Geelong,"Stringer, Jesse",13,6,2,7,1,0,0,0
Geelong,"Taylor, Harry",14,5,5,9,0,0,1,3
Geelong,"West, Trent",12,5,3,7,0,1,28,1
Geelong,"Bartel, Jimmy",21,14,3,7,0,1,1,6
Geelong,"Chapman, Paul",24,15,3,9,1,2,0,3
Geelong,"Corey, Joel",24,7,1,17,0,1,0,5
Geelong,"Duncan, Mitch",14,9,4,5,2,0,0,5
Geelong,"Enright, Corey",25,15,6,10,0,0,0,3
Geelong,"Guthrie, Cameron",12,8,0,4,0,0,0,1
Geelong,"Hawkins, Tom",12,8,5,4,2,4,2,0
Geelong,"Hunt, Josh",15,11,6,4,0,0,0,4
Geelong,"Hunt, Taylor",15,4,4,11,0,0,0,4
Geelong,"Johnson, Steve",23,16,7,7,0,2,0,3
Geelong,"Kelly, James",26,11,5,15,0,1,0,9
Geelong,"Lonergan, Tom",9,6,2,3,0,0,0,4
Geelong,"Mackie, Andrew",22,18,5,4,0,0,0,2
Geelong,"Motlop, Steven",9,6,2,3,1,0,0,0
Geelong,"Podsiadly, James",10,8,5,2,2,3,2,2
Geelong,"Selwood, Joel",36,19,7,17,0,1,1,5
Geelong,"Smedts, Billie",5,3,0,2,0,0,0,3
Geelong,"Stephenson, Orren",12,6,5,6,0,1,17,3
Geelong,"Stokes, Mathew",19,12,4,7,3,0,0,0
Geelong,"Stringer, Jesse",7,3,3,4,0,0,0,1
Geelong,"Taylor, Harry",17,11,6,6,0,0,0,2
Geelong,"West, Trent",12,3,4,9,0,1,15,3
Geelong,"Bartel, Jimmy",20,10,4,10,1,0,0,8
Geelong,"Chapman, Paul",27,18,8,9,2,2,0,5
Geelong,"Corey, Joel",26,13,3,13,0,0,3,3
Geelong,"Duncan, Mitch",14,13,7,1,0,0,0,1
Geelong,"Enright, Corey",21,17,9,4,0,0,0,3
Geelong,"Guthrie, Cameron",5,3,1,2,0,0,0,4
Geelong,"Hawkins, Tom",18,10,6,8,3,2,1,0
Geelong,"Hunt, Josh",19,12,5,7,0,0,0,3
Geelong,"Hunt, Taylor",16,5,4,11,1,0,0,8
Geelong,"Johnson, Steve",36,25,14,11,0,1,0,2
Geelong,"Lonergan, Tom",5,3,2,2,0,0,0,0
Geelong,"Mackie, Andrew",22,13,5,9,1,0,0,3
Geelong,"Motlop, Steven",17,9,2,8,3,1,0,2
Geelong,"Podsiadly, James",6,6,4,0,1,1,1,1
Geelong,"Scarlett, Matthew",17,12,8,5,0,0,0,4
Geelong,"Selwood, Joel",22,16,4,6,1,0,1,5
Geelong,"Simpkin, Jonathan",5,1,0,4,0,0,0,1
Geelong,"Stephenson, Orren",10,6,4,4,0,0,30,2
Geelong,"Stokes, Mathew",14,10,9,4,0,1,0,2
Geelong,"Stringer, Jesse",17,6,2,11,0,0,0,7
Geelong,"Taylor, Harry",12,8,6,4,0,0,0,2
Geelong,"West, Trent",10,7,3,3,1,1,8,0
Geelong,"Bartel, Jimmy",32,19,7,13,0,2,4,1
Geelong,"Chapman, Paul",26,14,8,12,2,1,0,8
Geelong,"Duncan, Mitch",17,15,7,2,0,0,0,6
Geelong,"Gillies, Tom",18,9,7,9,0,0,0,1
Geelong,"Guthrie, Cameron",12,7,4,5,1,0,0,2
Geelong,"Hunt, Josh",19,11,6,8,0,0,0,1
Geelong,"Hunt, Taylor",18,9,8,9,0,0,0,4
Geelong,"Johnson, Steve",25,19,12,6,5,1,0,3
Geelong,"Kelly, James",32,21,7,11,0,0,0,7
Geelong,"Lonergan, Tom",13,9,5,4,0,0,1,1
Geelong,"Mackie, Andrew",23,20,8,3,0,0,0,2
Geelong,"McCarthy, Lincoln",6,3,3,3,0,0,0,0
Geelong,"Podsiadly, James",9,6,6,3,3,1,2,0
Geelong,"Scarlett, Matthew",19,11,7,8,0,0,0,2
Geelong,"Schroder, Jordan",11,4,1,7,0,0,0,2
Geelong,"Selwood, Joel",19,9,1,10,0,0,0,4
Geelong,"Smedts, Billie",15,10,6,5,0,1,0,4
Geelong,"Stephenson, Orren",2,1,0,1,1,0,19,5
Geelong,"Stokes, Mathew",14,6,4,8,0,0,0,4
Geelong,"Stringer, Jesse",14,9,5,5,1,0,0,4
Geelong,"Taylor, Harry",17,13,10,4,6,3,0,3
Geelong,"West, Trent",15,5,7,10,0,0,15,1
Geelong,"Bartel, Jimmy",20,10,1,10,1,0,1,4
Geelong,"Chapman, Paul",24,18,6,6,1,0,0,2
Geelong,"Corey, Joel",17,7,3,10,0,0,0,7
Geelong,"Duncan, Mitch",24,13,6,11,2,1,1,5
Geelong,"Enright, Corey",12,9,6,3,0,0,0,0
Geelong,"Guthrie, Cameron",9,6,2,3,0,0,0,0
Geelong,"Hawkins, Tom",7,7,5,0,1,2,0,2
Geelong,"Hunt, Josh",16,12,8,4,0,0,0,2
Geelong,"Hunt, Taylor",15,7,4,8,1,1,0,1
Geelong,"Johnson, Steve",17,9,3,8,0,1,0,1
Geelong,"Kelly, James",22,11,3,11,0,0,0,2
Geelong,"Lonergan, Tom",14,7,4,7,0,0,0,2
Geelong,"Mackie, Andrew",16,10,5,6,0,0,0,2
Geelong,"Motlop, Steven",14,11,3,3,4,2,0,2
Geelong,"Scarlett, Matthew",20,11,8,9,0,0,0,5
Geelong,"Selwood, Joel",27,16,3,11,2,1,3,6
Geelong,"Stephenson, Orren",3,3,1,0,0,0,10,1
Geelong,"Stokes, Mathew",23,5,2,18,1,0,0,0
Geelong,"Stringer, Jesse",10,6,1,4,0,1,0,1
Geelong,"Taylor, Harry",16,11,8,5,0,0,0,1
Geelong,"West, Trent",9,3,2,6,1,0,11,5
Geelong,"Wojcinski, David",11,8,7,3,0,0,0,1
Geelong,"Bartel, Jimmy",27,19,9,8,0,0,1,3
Geelong,"Chapman, Paul",20,13,5,7,2,0,0,9
Geelong,"Christensen, Allen",12,8,1,4,0,0,0,4
Geelong,"Corey, Joel",23,11,4,12,0,0,1,6
Geelong,"Duncan, Mitch",16,11,2,5,0,1,1,2
Geelong,"Enright, Corey",29,16,11,13,1,0,0,1
Geelong,"Hawkins, Tom",12,8,7,4,1,3,0,1
Geelong,"Hunt, Josh",18,14,11,4,1,0,0,1
Geelong,"Hunt, Taylor",15,8,1,7,1,0,0,3
Geelong,"Johnson, Steve",18,12,4,6,0,0,0,7
Geelong,"Kelly, James",19,12,2,7,0,0,0,8
Geelong,"Lonergan, Tom",16,9,9,7,0,0,0,1
Geelong,"Mackie, Andrew",24,16,6,8,0,0,0,2
Geelong,"Motlop, Steven",14,10,3,4,1,1,0,1
Geelong,"Podsiadly, James",8,5,4,3,2,0,2,1
Geelong,"Scarlett, Matthew",17,13,9,4,0,0,0,1
Geelong,"Selwood, Joel",25,18,3,7,1,0,1,5
Geelong,"Simpson, Dawson",2,0,0,2,0,0,16,2
Geelong,"Stokes, Mathew",8,4,3,4,0,1,0,1
Geelong,"Taylor, Harry",18,10,8,8,0,0,1,3
Geelong,"West, Trent",8,5,3,3,1,0,30,1
Geelong,"Wojcinski, David",17,9,3,8,0,0,0,4
Geelong,"Bartel, Jimmy",21,11,4,10,0,1,0,6
Geelong,"Christensen, Allen",21,11,3,10,0,0,0,3
Geelong,"Corey, Joel",22,10,2,12,0,0,0,3
Geelong,"Duncan, Mitch",17,12,4,5,1,1,2,4
Geelong,"Enright, Corey",21,17,6,4,1,0,0,3
Geelong,"Guthrie, Cameron",14,7,4,7,0,0,0,1
Geelong,"Hawkins, Tom",16,9,7,7,2,0,0,2
Geelong,"Horlin-Smith, George",14,6,2,8,1,0,0,2
Geelong,"Hunt, Taylor",13,5,2,8,0,1,0,4
Geelong,"Johnson, Steve",15,10,6,5,1,1,0,4
Geelong,"Kelly, James",25,11,2,14,0,1,0,3
Geelong,"Lonergan, Tom",10,3,6,7,1,0,0,0
Geelong,"Mackie, Andrew",13,11,3,2,0,0,0,4
Geelong,"Motlop, Steven",14,9,4,5,1,2,0,3
Geelong,"Murdoch, Jordan",16,10,4,6,0,1,0,8
Geelong,"Podsiadly, James",9,7,2,2,0,2,1,7
Geelong,"Scarlett, Matthew",16,10,6,6,0,0,0,0
Geelong,"Selwood, Joel",27,19,4,8,2,0,0,6
Geelong,"Smedts, Billie",20,10,3,10,1,1,0,4
Geelong,"Stokes, Mathew",9,6,2,3,0,0,0,0
Geelong,"Taylor, Harry",10,5,4,5,3,0,2,2
Geelong,"West, Trent",9,4,2,5,0,0,39,1
Geelong,"Bartel, Jimmy",25,18,8,7,0,0,0,4
Geelong,"Brown, Mitch",13,9,7,4,2,0,0,1
Geelong,"Chapman, Paul",28,22,7,6,4,1,0,2
Geelong,"Christensen, Allen",24,10,7,14,0,0,0,3
Geelong,"Corey, Joel",21,10,3,11,0,1,0,4
Geelong,"Enright, Corey",27,16,7,11,0,0,0,3
Geelong,"Guthrie, Cameron",4,1,0,3,0,0,0,2
Geelong,"Hawkins, Tom",12,10,8,2,4,1,0,1
Geelong,"Hunt, Josh",17,12,9,5,0,0,0,4
Geelong,"Hunt, Taylor",18,9,7,9,1,1,0,0
Geelong,"Kelly, James",27,15,6,12,1,0,0,8
Geelong,"Lonergan, Tom",21,15,12,6,1,1,0,0
Geelong,"Mackie, Andrew",26,15,9,11,0,2,0,1
Geelong,"Motlop, Steven",14,9,2,5,1,2,0,2
Geelong,"Murdoch, Jordan",15,9,7,6,0,0,0,0
Geelong,"Scarlett, Matthew",13,12,9,1,0,0,0,0
Geelong,"Selwood, Joel",32,17,7,15,0,3,1,0
Geelong,"Simpson, Dawson",6,4,3,2,0,1,17,2
Geelong,"Smedts, Billie",17,9,6,8,0,1,0,4
Geelong,"Stokes, Mathew",20,6,4,14,1,0,0,2
Geelong,"West, Trent",9,5,4,4,0,0,21,3
Geelong,"Wojcinski, David",16,8,2,8,0,1,0,5
Geelong,"Chapman, Paul",16,9,2,7,1,0,0,2
Geelong,"Christensen, Allen",15,9,2,6,0,0,0,2
Geelong,"Corey, Joel",21,10,3,11,0,0,1,3
Geelong,"Duncan, Mitch",15,11,4,4,0,1,0,6
Geelong,"Enright, Corey",25,14,7,11,0,1,0,2
Geelong,"Guthrie, Cameron",16,8,4,8,0,0,0,3
Geelong,"Hawkins, Tom",10,9,8,1,1,4,0,2
Geelong,"Hunt, Josh",12,6,3,6,0,0,0,1
Geelong,"Hunt, Taylor",13,5,2,8,0,0,0,4
Geelong,"Johnson, Steve",36,20,6,16,0,1,1,6
Geelong,"Kelly, James",38,18,4,20,0,0,0,6
Geelong,"Lonergan, Tom",8,5,2,3,0,0,0,4
Geelong,"Mackie, Andrew",15,10,4,5,0,0,0,2
Geelong,"Motlop, Steven",15,12,3,3,2,0,0,1
Geelong,"Scarlett, Matthew",16,10,2,6,0,0,0,4
Geelong,"Selwood, Joel",23,11,3,12,2,1,0,6
Geelong,"Sheringham, Jackson",6,3,0,3,1,0,0,0
Geelong,"Smedts, Billie",7,4,3,3,0,1,0,0
Geelong,"Stokes, Mathew",13,8,5,5,1,0,0,4
Geelong,"Taylor, Harry",7,6,1,1,0,1,0,0
Geelong,"Walker, Josh",9,5,4,4,0,3,2,4
Geelong,"West, Trent",11,6,3,5,2,1,26,2
Geelong,"Chapman, Paul",12,5,3,7,2,0,0,4
Geelong,"Corey, Joel",27,12,2,15,0,1,0,4
Geelong,"Duncan, Mitch",31,20,7,11,1,0,0,1
Geelong,"Enright, Corey",21,16,9,5,0,1,0,0
Geelong,"Guthrie, Cameron",7,3,2,4,0,0,0,0
Geelong,"Hawkins, Tom",15,12,8,3,5,1,0,0
Geelong,"Hunt, Josh",11,3,3,8,0,1,0,2
Geelong,"Hunt, Taylor",14,5,4,9,0,0,0,1
Geelong,"Johnson, Steve",22,13,5,9,2,0,1,5
Geelong,"Kelly, James",24,11,2,13,0,0,0,4
Geelong,"Lonergan, Tom",17,15,9,2,0,0,0,1
Geelong,"Mackie, Andrew",24,23,10,1,1,1,0,3
Geelong,"Motlop, Steven",20,14,4,6,1,1,0,1
Geelong,"Murdoch, Jordan",9,6,1,3,2,0,0,5
Geelong,"Scarlett, Matthew",14,12,6,2,0,0,0,1
Geelong,"Selwood, Joel",19,11,4,8,0,2,2,7
Geelong,"Sheringham, Jackson",12,6,3,6,0,0,0,5
Geelong,"Smedts, Billie",16,11,4,5,3,0,0,3
Geelong,"Stokes, Mathew",20,8,5,12,0,1,0,7
Geelong,"Taylor, Harry",19,11,10,8,2,0,0,3
Geelong,"Walker, Josh",12,10,4,2,1,1,1,2
Geelong,"West, Trent",13,8,3,5,0,0,22,5
Geelong,"Bartel, Jimmy",18,7,1,11,1,1,1,4
Geelong,"Chapman, Paul",19,12,7,7,3,1,0,5
Geelong,"Christensen, Allen",23,12,5,11,1,1,0,4
Geelong,"Corey, Joel",18,10,3,8,0,0,0,3
Geelong,"Duncan, Mitch",14,11,3,3,2,2,0,3
Geelong,"Enright, Corey",23,12,4,11,0,0,0,4
Geelong,"Guthrie, Cameron",13,7,5,6,0,0,0,4
Geelong,"Hawkins, Tom",19,14,11,5,3,3,1,2
Geelong,"Hunt, Josh",16,11,5,5,0,0,0,2
Geelong,"Hunt, Taylor",14,4,4,10,0,0,0,2
Geelong,"Johnson, Steve",0,0,0,0,0,0,0,0
Geelong,"Kelly, James",25,15,1,10,0,0,0,9
Geelong,"Lonergan, Tom",16,9,3,7,0,0,0,1
Geelong,"Mackie, Andrew",15,12,5,3,2,0,0,6
Geelong,"Motlop, Steven",9,4,1,5,0,0,0,6
Geelong,"Selwood, Joel",26,18,6,8,0,1,0,6
Geelong,"Sheringham, Jackson",20,8,3,12,0,1,0,5
Geelong,"Smedts, Billie",15,7,5,8,1,2,0,2
Geelong,"Stokes, Mathew",22,12,5,10,2,0,0,6
Geelong,"Taylor, Harry",19,8,6,11,0,0,1,1
Geelong,"Walker, Josh",11,4,3,7,0,0,4,6
Geelong,"West, Trent",6,3,1,3,0,0,46,3
Geelong,"Bartel, Jimmy",15,11,7,4,0,0,0,9
Geelong,"Chapman, Paul",14,10,5,4,4,1,0,4
Geelong,"Christensen, Allen",15,6,0,9,1,0,0,0
Geelong,"Duncan, Mitch",19,14,8,5,2,1,0,3
Geelong,"Enright, Corey",10,4,3,6,0,0,0,2
Geelong,"Hawkins, Tom",13,10,6,3,6,2,2,0
Geelong,"Hunt, Josh",6,5,4,1,0,0,0,3
Geelong,"Hunt, Taylor",7,4,3,3,0,0,0,4
Geelong,"Johnson, Steve",26,17,7,9,2,2,0,2
Geelong,"Kelly, James",23,11,2,12,0,0,0,7
Geelong,"Lonergan, Tom",11,7,5,4,0,0,0,2
Geelong,"Mackie, Andrew",15,10,7,5,1,0,0,1
Geelong,"Motlop, Steven",3,2,1,1,0,0,0,1
Geelong,"Podsiadly, James",13,8,5,5,1,1,1,5
Geelong,"Scarlett, Matthew",14,11,1,3,0,0,1,3
Geelong,"Selwood, Joel",29,13,5,16,0,0,1,11
Geelong,"Sheringham, Jackson",10,6,3,4,0,0,0,2
Geelong,"Smedts, Billie",17,5,2,12,0,2,0,3
Geelong,"Stephenson, Orren",13,7,0,6,0,0,23,2
Geelong,"Stokes, Mathew",18,7,3,11,0,0,0,3
Geelong,"Taylor, Harry",12,8,6,4,0,0,0,0
Geelong,"Walker, Josh",4,4,1,0,1,0,3,4
Geelong,"Bartel, Jimmy",18,9,6,9,1,1,6,9
Geelong,"Christensen, Allen",22,14,2,8,1,0,0,4
Geelong,"Duncan, Mitch",14,8,4,6,0,0,1,5
Geelong,"Enright, Corey",18,13,6,5,0,0,1,3
Geelong,"Guthrie, Cameron",11,7,3,4,0,0,0,2
Geelong,"Hawkins, Tom",2,2,1,0,1,1,0,0
Geelong,"Hunt, Taylor",21,7,3,14,1,1,0,3
Geelong,"Johnson, Steve",32,17,4,15,1,1,0,10
Geelong,"Lonergan, Tom",12,8,4,4,0,0,0,3
Geelong,"Mackie, Andrew",26,15,7,11,0,0,0,3
Geelong,"Motlop, Steven",9,7,2,2,2,0,0,0
Geelong,"Murdoch, Jordan",10,4,3,6,1,1,0,0
Geelong,"Podsiadly, James",14,10,7,4,3,0,0,3
Geelong,"Scarlett, Matthew",10,8,4,2,0,0,0,2
Geelong,"Selwood, Joel",21,16,2,5,0,0,1,6
Geelong,"Sheringham, Jackson",8,5,4,3,0,0,0,2
Geelong,"Simpkin, Jonathan",12,9,4,3,1,0,0,4
Geelong,"Stephenson, Orren",14,6,3,8,0,0,14,0
Geelong,"Stokes, Mathew",13,6,1,7,2,0,0,2
Geelong,"Taylor, Harry",11,7,4,4,0,0,0,4
Geelong,"Walker, Josh",4,4,0,0,1,0,2,1
Geelong,"Wojcinski, David",11,8,1,3,0,0,0,4
Geelong,"Bartel, Jimmy",19,4,1,15,0,0,1,6
Geelong,"Chapman, Paul",16,8,5,8,1,3,0,3
Geelong,"Corey, Joel",11,2,2,9,0,0,0,2
Geelong,"Duncan, Mitch",23,11,6,12,0,0,0,1
Geelong,"Enright, Corey",20,12,6,8,0,1,0,3
Geelong,"Hawkins, Tom",12,8,5,4,6,0,0,0
Geelong,"Hunt, Josh",22,12,11,10,0,1,0,4
Geelong,"Hunt, Taylor",14,7,4,7,2,0,0,7
Geelong,"Johnson, Steve",23,14,7,9,0,0,0,5
Geelong,"Kelly, James",27,12,3,15,0,0,0,11
Geelong,"Lonergan, Tom",2,0,1,2,0,0,0,2
Geelong,"Mackie, Andrew",18,15,4,3,1,0,0,3
Geelong,"Motlop, Steven",15,9,2,6,2,0,0,3
Geelong,"Murdoch, Jordan",19,12,5,7,1,0,0,2
Geelong,"Podsiadly, James",13,7,6,6,2,0,0,3
Geelong,"Scarlett, Matthew",10,6,3,4,0,0,0,1
Geelong,"Selwood, Joel",18,7,1,11,0,0,0,5
Geelong,"Simpkin, Jonathan",9,4,2,5,0,0,0,1
Geelong,"Stokes, Mathew",23,10,6,13,1,1,0,4
Geelong,"Taylor, Harry",16,8,6,8,0,0,0,1
Geelong,"Walker, Josh",6,2,0,4,0,0,7,3
Geelong,"West, Trent",11,5,3,6,2,0,26,2
Geelong,"Bartel, Jimmy",21,10,9,11,0,1,0,9
Geelong,"Chapman, Paul",14,10,8,4,2,0,0,2
Geelong,"Christensen, Allen",25,16,5,9,1,1,0,7
Geelong,"Corey, Joel",16,4,4,12,2,0,0,8
Geelong,"Duncan, Mitch",21,12,9,9,1,0,2,3
Geelong,"Enright, Corey",29,18,11,11,0,0,0,5
Geelong,"Guthrie, Cameron",20,9,7,11,0,0,0,1
Geelong,"Hawkins, Tom",13,11,6,2,4,2,0,0
Geelong,"Hunt, Josh",27,19,12,8,1,0,0,0
Geelong,"Johnson, Steve",20,14,5,6,0,0,1,2
Geelong,"Kelly, James",24,12,2,12,0,1,0,2
Geelong,"Lonergan, Tom",18,7,7,11,0,0,0,4
Geelong,"Mackie, Andrew",21,13,8,8,0,0,0,2
Geelong,"Motlop, Steven",23,12,4,11,0,1,0,1
Geelong,"Murdoch, Jordan",20,15,7,5,0,1,0,5
Geelong,"Podsiadly, James",13,9,9,4,1,0,1,2
Geelong,"Smedts, Billie",3,2,2,1,0,0,0,5
Geelong,"Stokes, Mathew",19,10,5,9,1,0,0,3
Geelong,"Taylor, Harry",17,8,6,9,2,0,0,2
Geelong,"Varcoe, Travis",2,1,0,1,0,0,0,1
Geelong,"Walker, Josh",12,8,4,4,0,0,4,2
Geelong,"West, Trent",5,2,2,3,1,0,25,3
Geelong,"Bartel, Jimmy",21,14,9,7,1,1,1,4
Geelong,"Chapman, Paul",18,15,6,3,3,2,0,1
Geelong,"Christensen, Allen",14,5,3,9,1,0,0,5
Geelong,"Corey, Joel",22,9,1,13,0,0,0,13
Geelong,"Duncan, Mitch",21,15,7,6,1,1,0,6
Geelong,"Enright, Corey",15,12,6,3,0,0,0,2
Geelong,"Hawkins, Tom",16,10,7,6,4,1,0,3
Geelong,"Hunt, Josh",15,8,2,7,0,0,0,1
Geelong,"Hunt, Taylor",7,2,0,5,0,0,0,1
Geelong,"Johnson, Steve",24,14,3,10,1,1,0,6
Geelong,"Kelly, James",23,17,2,6,0,0,0,16
Geelong,"Lonergan, Tom",10,6,4,4,1,0,0,4
Geelong,"Mackie, Andrew",17,14,3,3,1,0,0,5
Geelong,"Motlop, Steven",3,2,2,1,0,0,0,0
Geelong,"Murdoch, Jordan",11,9,6,2,0,0,0,3
Geelong,"Podsiadly, James",14,12,5,2,3,1,2,1
Geelong,"Scarlett, Matthew",21,13,7,8,0,0,0,0
Geelong,"Selwood, Joel",27,16,3,11,0,0,1,5
Geelong,"Stokes, Mathew",15,5,2,10,0,0,0,5
Geelong,"Taylor, Harry",21,15,14,6,0,0,0,2
Geelong,"Vardy, Nathan",9,8,3,1,1,1,10,1
Geelong,"West, Trent",17,7,5,10,0,0,26,5
Geelong,"Bartel, Jimmy",26,13,5,13,0,0,0,8
Geelong,"Chapman, Paul",19,13,1,6,0,0,0,8
Geelong,"Christensen, Allen",18,10,2,8,1,3,0,4
Geelong,"Corey, Joel",21,9,3,12,0,0,0,12
Geelong,"Duncan, Mitch",19,11,5,8,1,1,0,2
Geelong,"Enright, Corey",26,15,2,11,0,0,0,3
Geelong,"Hawkins, Tom",9,4,3,5,0,2,1,0
Geelong,"Hunt, Josh",11,8,2,3,2,2,0,3
Geelong,"Hunt, Taylor",18,10,4,8,0,0,0,2
Geelong,"Kelly, James",15,12,1,3,0,0,0,7
Geelong,"Lonergan, Tom",6,3,2,3,0,1,0,1
Geelong,"Mackie, Andrew",21,13,5,8,2,1,0,4
Geelong,"Motlop, Steven",7,3,0,4,1,0,0,7
Geelong,"Murdoch, Jordan",2,2,0,0,0,0,0,1
Geelong,"Podsiadly, James",13,7,3,6,0,0,1,3
Geelong,"Scarlett, Matthew",10,6,1,4,0,0,0,2
Geelong,"Selwood, Joel",28,13,2,15,1,0,1,5
Geelong,"Simpkin, Jonathan",9,8,2,1,0,0,0,1
Geelong,"Stokes, Mathew",14,4,1,10,1,0,0,4
Geelong,"Taylor, Harry",13,7,3,6,1,1,0,3
Geelong,"Vardy, Nathan",4,3,2,1,1,0,7,2
Geelong,"West, Trent",12,8,3,4,0,0,21,4
Greater Western Sydney,"Bugg, Tomas",27,14,5,13,0,0,0,4
Greater Western Sydney,"Cameron, Jeremy",8,6,5,2,0,0,0,1
Greater Western Sydney,"Coniglio, Stephen",17,6,3,11,0,0,0,1
Greater Western Sydney,"Cornes, Chad",24,17,8,7,0,0,0,6
Greater Western Sydney,"Davis, Phil",17,12,5,5,0,0,0,0
Greater Western Sydney,"Folau, Israel",3,1,1,2,0,0,7,1
Greater Western Sydney,"Giles, Jonathan",12,6,3,6,1,0,26,2
Greater Western Sydney,"Greene, Toby",27,12,3,15,0,0,0,5
Greater Western Sydney,"Hampton, Curtly",17,14,7,3,0,3,0,1
Greater Western Sydney,"Hombsch, Jack",18,9,8,9,0,0,0,1
Greater Western Sydney,"Hoskin-Elliott, Will",16,12,4,4,1,0,0,2
Greater Western Sydney,"Kennedy, Adam",28,17,11,11,0,1,0,2
Greater Western Sydney,"McDonald, James",23,9,6,14,1,0,0,6
Greater Western Sydney,"Mohr, Tim",16,9,7,7,0,0,0,3
Greater Western Sydney,"Palmer, Rhys",25,13,4,12,0,0,1,7
Greater Western Sydney,"Shiel, Dylan",11,4,1,7,0,0,0,3
Greater Western Sydney,"Smith, Devon",15,8,3,7,0,2,0,5
Greater Western Sydney,"Tomlinson, Adam",13,9,5,4,0,0,0,1
Greater Western Sydney,"Townsend, Jacob",9,6,2,3,0,0,0,4
Greater Western Sydney,"Tyson, Dom",10,2,1,8,0,0,0,0
Greater Western Sydney,"Ward, Callan",22,17,3,5,1,0,3,7
Greater Western Sydney,"Wilson, Nathan",9,7,1,2,1,0,0,1
Greater Western Sydney,"Bugg, Tomas",18,8,4,10,0,0,0,1
Greater Western Sydney,"Cameron, Jeremy",12,8,7,4,4,0,0,2
Greater Western Sydney,"Coniglio, Stephen",18,9,3,9,0,0,0,2
Greater Western Sydney,"Cornes, Chad",32,15,10,17,0,0,2,3
Greater Western Sydney,"Davis, Phil",11,10,3,1,1,0,0,5
Greater Western Sydney,"Folau, Israel",5,2,2,3,0,0,4,2
Greater Western Sydney,"Giles, Jonathan",19,15,3,4,1,0,26,2
Greater Western Sydney,"Greene, Toby",31,16,6,15,0,2,0,3
Greater Western Sydney,"Hampton, Curtly",9,4,1,5,0,2,0,2
Greater Western Sydney,"Hombsch, Jack",13,9,1,4,0,0,1,0
Greater Western Sydney,"Hoskin-Elliott, Will",12,6,3,6,0,0,0,0
Greater Western Sydney,"Kennedy, Adam",23,12,3,11,0,0,0,1
Greater Western Sydney,"Mohr, Tim",10,9,2,1,0,0,1,3
Greater Western Sydney,"Palmer, Rhys",15,5,2,10,0,1,0,2
Greater Western Sydney,"Power, Luke",18,9,3,9,0,0,0,4
Greater Western Sydney,"Scully, Tom",25,11,4,14,0,0,0,4
Greater Western Sydney,"Shiel, Dylan",19,6,4,13,0,0,0,2
Greater Western Sydney,"Smith, Devon",21,10,2,11,1,0,0,3
Greater Western Sydney,"Townsend, Jacob",8,6,2,2,0,0,2,6
Greater Western Sydney,"Tyson, Dom",6,2,1,4,0,0,0,0
Greater Western Sydney,"Ward, Callan",21,13,4,8,1,1,2,7
Greater Western Sydney,"Wilson, Nathan",4,4,1,0,0,0,0,3
Greater Western Sydney,"Brogan, Dean",13,6,7,7,0,0,15,2
Greater Western Sydney,"Bugg, Tomas",27,10,3,17,1,0,0,3
Greater Western Sydney,"Cameron, Jeremy",2,1,2,1,0,0,0,2
Greater Western Sydney,"Coniglio, Stephen",22,9,5,13,0,1,0,2
Greater Western Sydney,"Cornes, Chad",21,10,4,11,0,0,1,3
Greater Western Sydney,"Davis, Phil",17,9,4,8,0,0,0,0
Greater Western Sydney,"Folau, Israel",2,1,0,1,0,0,1,1
Greater Western Sydney,"Giles, Jonathan",12,7,2,5,3,1,11,0
Greater Western Sydney,"Greene, Toby",20,7,2,13,0,0,0,1
Greater Western Sydney,"Hampton, Curtly",5,3,2,2,0,2,0,1
Greater Western Sydney,"Hombsch, Jack",19,12,5,7,0,0,0,3
Greater Western Sydney,"Kennedy, Adam",20,7,1,13,0,0,0,2
Greater Western Sydney,"Mohr, Tim",8,5,3,3,0,0,0,3
Greater Western Sydney,"Palmer, Rhys",21,13,5,8,2,2,0,1
Greater Western Sydney,"Power, Luke",19,8,2,11,0,0,0,1
Greater Western Sydney,"Scully, Tom",30,11,3,19,0,0,0,0
Greater Western Sydney,"Shiel, Dylan",28,11,1,17,0,0,0,1
Greater Western Sydney,"Smith, Devon",18,12,7,6,0,0,0,5
Greater Western Sydney,"Tomlinson, Adam",13,9,4,4,1,0,0,4
Greater Western Sydney,"Townsend, Jacob",7,3,2,4,1,0,0,4
Greater Western Sydney,"Treloar, Adam",17,8,3,9,1,1,0,2
Greater Western Sydney,"Ward, Callan",36,21,8,15,1,1,0,5
Greater Western Sydney,"Brogan, Dean",15,11,3,4,0,0,17,3
Greater Western Sydney,"Bugg, Tomas",15,4,1,11,0,0,0,7
Greater Western Sydney,"Cornes, Chad",9,5,1,4,0,0,0,3
Greater Western Sydney,"Davis, Phil",12,10,4,2,0,1,0,4
Greater Western Sydney,"Edwards, Shaun",5,4,0,1,1,0,0,1
Greater Western Sydney,"Folau, Israel",8,5,4,3,1,1,0,1
Greater Western Sydney,"Giles, Jonathan",11,8,5,3,1,0,24,6
Greater Western Sydney,"Hampton, Curtly",8,6,3,2,3,0,0,2
Greater Western Sydney,"Hombsch, Jack",16,8,3,8,0,0,0,2
Greater Western Sydney,"Kennedy, Adam",10,7,3,3,0,0,0,1
Greater Western Sydney,"McDonald, James",14,9,2,5,0,0,0,11
Greater Western Sydney,"Miles, Anthony",15,11,8,4,0,0,0,6
Greater Western Sydney,"Mohr, Tim",12,7,2,5,1,0,0,1
Greater Western Sydney,"Palmer, Rhys",12,7,2,5,0,1,0,2
Greater Western Sydney,"Power, Luke",31,23,6,8,0,0,0,4
Greater Western Sydney,"Scully, Tom",23,16,7,7,0,0,0,6
Greater Western Sydney,"Shiel, Dylan",18,8,2,10,0,0,0,5
Greater Western Sydney,"Smith, Devon",13,9,2,4,0,3,0,5
Greater Western Sydney,"Tomlinson, Adam",8,3,1,5,0,0,0,1
Greater Western Sydney,"Townsend, Jacob",7,5,1,2,0,0,0,2
Greater Western Sydney,"Treloar, Adam",18,15,6,3,0,0,0,4
Greater Western Sydney,"Ward, Callan",33,14,3,19,0,2,0,6
Greater Western Sydney,"Adams, Taylor",17,7,5,10,1,0,0,3
Greater Western Sydney,"Bruce, Josh",8,4,2,4,1,0,0,1
Greater Western Sydney,"Bugg, Tomas",28,12,7,16,0,0,0,1
Greater Western Sydney,"Cameron, Jeremy",12,6,7,6,5,0,0,3
Greater Western Sydney,"Coniglio, Stephen",16,5,1,11,0,1,1,1
Greater Western Sydney,"Davis, Phil",18,11,6,7,0,0,0,0
Greater Western Sydney,"Edwards, Shaun",12,9,5,3,0,1,0,1
Greater Western Sydney,"Folau, Israel",9,4,2,5,0,1,7,1
Greater Western Sydney,"Giles, Jonathan",13,7,3,6,0,0,31,5
Greater Western Sydney,"Greene, Toby",27,11,4,16,0,0,0,4
Greater Western Sydney,"Hampton, Curtly",9,6,0,3,2,1,0,1
Greater Western Sydney,"Hombsch, Jack",16,8,4,8,0,0,0,2
Greater Western Sydney,"McDonald, James",25,12,5,13,0,0,0,3
Greater Western Sydney,"Power, Luke",30,17,10,13,0,0,0,3
Greater Western Sydney,"Reid, Sam",17,7,6,10,0,0,0,1
Greater Western Sydney,"Scully, Tom",19,7,0,12,0,0,0,1
Greater Western Sydney,"Shiel, Dylan",23,13,4,10,0,0,0,2
Greater Western Sydney,"Smith, Devon",11,7,1,4,0,1,0,2
Greater Western Sydney,"Tomlinson, Adam",14,8,3,6,0,0,0,2
Greater Western Sydney,"Townsend, Jacob",8,5,3,3,0,0,0,2
Greater Western Sydney,"Treloar, Adam",18,11,5,7,0,1,0,0
Greater Western Sydney,"Ward, Callan",18,12,5,6,0,0,0,8
Greater Western Sydney,"Adams, Taylor",23,16,8,7,0,0,0,2
Greater Western Sydney,"Brogan, Dean",3,1,0,2,0,0,5,0
Greater Western Sydney,"Bugg, Tomas",18,11,5,7,0,0,0,3
Greater Western Sydney,"Coniglio, Stephen",23,12,6,11,0,1,0,5
Greater Western Sydney,"Davis, Phil",11,6,5,5,2,0,0,3
Greater Western Sydney,"Giles, Jonathan",11,4,0,7,0,0,18,5
Greater Western Sydney,"Greene, Toby",28,16,9,12,0,2,0,5
Greater Western Sydney,"Hampton, Curtly",12,5,2,7,0,0,0,3
Greater Western Sydney,"Hombsch, Jack",9,5,5,4,0,0,0,2
Greater Western Sydney,"Kennedy, Adam",12,6,2,6,0,0,0,1
Greater Western Sydney,"McDonald, James",26,11,3,15,0,2,0,6
Greater Western Sydney,"Mohr, Tim",16,8,6,8,0,0,0,4
Greater Western Sydney,"OhAilpin, Setanta",5,3,1,2,2,1,0,1
Greater Western Sydney,"Palmer, Rhys",19,11,5,8,0,0,0,0
Greater Western Sydney,"Power, Luke",20,12,5,8,0,0,0,2
Greater Western Sydney,"Reid, Sam",5,3,2,2,0,0,0,2
Greater Western Sydney,"Scully, Tom",13,6,3,7,1,0,0,7
Greater Western Sydney,"Shiel, Dylan",23,9,7,14,0,0,0,1
Greater Western Sydney,"Smith, Devon",22,14,5,8,0,1,0,6
Greater Western Sydney,"Sumner, Liam",15,6,3,9,1,0,0,3
Greater Western Sydney,"Tyson, Dom",15,6,4,9,0,0,0,1
Greater Western Sydney,"Ward, Callan",18,9,0,9,0,0,1,2
Greater Western Sydney,"Adams, Taylor",21,11,2,10,0,0,0,3
Greater Western Sydney,"Bugg, Tomas",12,6,4,6,0,0,0,4
Greater Western Sydney,"Cameron, Jeremy",7,4,2,3,1,0,0,4
Greater Western Sydney,"Coniglio, Stephen",31,18,6,13,1,0,0,1
Greater Western Sydney,"Cornes, Chad",28,16,12,12,0,0,0,2
Greater Western Sydney,"Davis, Phil",16,11,7,5,0,0,0,1
Greater Western Sydney,"Folau, Israel",11,4,3,7,0,2,4,4
Greater Western Sydney,"Giles, Jonathan",21,13,6,8,3,1,13,1
Greater Western Sydney,"Greene, Toby",22,15,8,7,0,2,0,3
Greater Western Sydney,"Kennedy, Adam",16,9,6,7,0,0,0,1
Greater Western Sydney,"Mohr, Tim",13,6,4,7,0,0,0,1
Greater Western Sydney,"Palmer, Rhys",23,14,7,9,0,2,0,2
Greater Western Sydney,"Phillips, Andrew",6,3,1,3,0,0,9,2
Greater Western Sydney,"Power, Luke",16,12,5,4,0,0,0,1
Greater Western Sydney,"Scully, Tom",22,12,2,10,0,2,0,4
Greater Western Sydney,"Shiel, Dylan",16,7,5,9,1,1,0,2
Greater Western Sydney,"Smith, Devon",17,11,4,6,2,2,0,2
Greater Western Sydney,"Sumner, Liam",5,2,0,3,1,0,0,1
Greater Western Sydney,"Townsend, Jacob",11,6,4,5,1,1,0,3
Greater Western Sydney,"Treloar, Adam",18,14,6,4,1,0,0,5
Greater Western Sydney,"Tyson, Dom",21,11,8,10,1,0,0,2
Greater Western Sydney,"Ward, Callan",22,16,6,6,1,0,2,4
Greater Western Sydney,"Adams, Taylor",17,10,1,7,0,0,0,4
Greater Western Sydney,"Buntine, Matt",7,2,1,5,0,0,0,0
Greater Western Sydney,"Cameron, Jeremy",9,7,6,2,0,4,0,1
Greater Western Sydney,"Coniglio, Stephen",19,8,4,11,0,0,0,4
Greater Western Sydney,"Cornes, Chad",9,6,2,3,0,0,1,2
Greater Western Sydney,"Darley, Sam",19,12,4,7,0,0,0,2
Greater Western Sydney,"Davis, Phil",12,6,5,6,0,0,0,1
Greater Western Sydney,"Folau, Israel",7,3,2,4,0,1,0,2
Greater Western Sydney,"Giles, Jonathan",14,10,5,4,1,1,16,1
Greater Western Sydney,"Greene, Toby",19,10,3,9,0,0,0,2
Greater Western Sydney,"Hoskin-Elliott, Will",5,3,1,2,0,0,0,2
Greater Western Sydney,"Mohr, Tim",11,6,4,5,0,0,0,0
Greater Western Sydney,"Palmer, Rhys",23,16,8,7,0,0,0,4
Greater Western Sydney,"Phillips, Andrew",8,5,5,3,1,0,12,1
Greater Western Sydney,"Power, Luke",16,9,3,7,0,0,0,3
Greater Western Sydney,"Reid, Sam",11,6,1,5,0,0,0,5
Greater Western Sydney,"Scully, Tom",14,8,1,6,1,0,0,6
Greater Western Sydney,"Tomlinson, Adam",3,2,2,1,0,0,0,3
Greater Western Sydney,"Treloar, Adam",19,8,1,11,0,0,0,2
Greater Western Sydney,"Tyson, Dom",18,4,2,14,1,0,1,6
Greater Western Sydney,"Ward, Callan",24,15,4,9,0,2,1,4
Greater Western Sydney,"Wilson, Nathan",7,5,3,2,1,1,0,2
Greater Western Sydney,"Adams, Taylor",13,11,6,2,0,1,0,3
Greater Western Sydney,"Bugg, Tomas",14,5,0,9,0,0,0,4
Greater Western Sydney,"Cameron, Jeremy",14,13,10,1,3,1,0,2
Greater Western Sydney,"Coniglio, Stephen",13,8,4,5,0,0,0,4
Greater Western Sydney,"Cornes, Chad",18,6,6,12,0,0,0,2
Greater Western Sydney,"Darley, Sam",7,6,3,1,0,0,0,3
Greater Western Sydney,"Davis, Phil",11,6,3,5,0,0,0,3
Greater Western Sydney,"Giles, Jonathan",17,12,2,5,1,0,17,4
Greater Western Sydney,"Hampton, Curtly",12,9,2,3,0,0,0,2
Greater Western Sydney,"Kennedy, Adam",7,3,1,4,0,0,0,1
Greater Western Sydney,"McDonald, James",18,10,1,8,1,1,0,5
Greater Western Sydney,"Mohr, Tim",8,6,3,2,0,0,0,1
Greater Western Sydney,"Phillips, Andrew",5,2,1,3,0,0,7,2
Greater Western Sydney,"Power, Luke",24,17,4,7,0,0,0,4
Greater Western Sydney,"Reid, Sam",21,8,3,13,0,0,0,1
Greater Western Sydney,"Scully, Tom",26,11,3,15,0,0,0,5
Greater Western Sydney,"Shiel, Dylan",21,11,2,10,1,2,0,6
Greater Western Sydney,"Smith, Devon",17,9,3,8,0,2,0,6
Greater Western Sydney,"Townsend, Jacob",7,4,1,3,0,1,0,4
Greater Western Sydney,"Treloar, Adam",25,20,6,5,1,0,0,6
Greater Western Sydney,"Tyson, Dom",17,8,10,9,0,0,0,5
Greater Western Sydney,"Ward, Callan",25,14,4,11,0,0,0,4
Greater Western Sydney,"Adams, Taylor",14,6,1,8,0,0,0,5
Greater Western Sydney,"Bugg, Tomas",13,7,5,6,0,0,0,4
Greater Western Sydney,"Cameron, Jeremy",9,6,6,3,2,0,0,3
Greater Western Sydney,"Coniglio, Stephen",27,22,9,5,1,2,0,1
Greater Western Sydney,"Cornes, Chad",16,9,5,7,0,1,0,2
Greater Western Sydney,"Darley, Sam",11,9,5,2,0,0,0,5
Greater Western Sydney,"Davis, Phil",14,10,6,4,0,0,0,0
Greater Western Sydney,"Giles, Jonathan",14,8,0,6,0,0,23,2
Greater Western Sydney,"Greene, Toby",20,9,3,11,0,0,0,4
Greater Western Sydney,"Haynes, Nick",8,6,3,2,0,0,0,5
Greater Western Sydney,"McDonald, James",12,7,1,5,0,0,0,7
Greater Western Sydney,"Mohr, Tim",10,8,4,2,0,0,0,1
Greater Western Sydney,"Phillips, Andrew",8,5,2,3,0,0,7,2
Greater Western Sydney,"Power, Luke",18,13,4,5,0,0,0,2
Greater Western Sydney,"Reid, Sam",10,4,2,6,0,0,0,4
Greater Western Sydney,"Scully, Tom",20,9,1,11,0,0,0,7
Greater Western Sydney,"Shiel, Dylan",21,11,3,10,2,1,0,5
Greater Western Sydney,"Smith, Devon",10,3,1,7,0,1,0,5
Greater Western Sydney,"Townsend, Jacob",6,5,1,1,0,0,0,5
Greater Western Sydney,"Treloar, Adam",14,10,3,4,2,0,0,4
Greater Western Sydney,"Tyson, Dom",4,3,1,1,1,0,0,1
Greater Western Sydney,"Ward, Callan",23,14,6,9,1,1,1,5
Greater Western Sydney,"Adams, Taylor",15,11,1,4,0,0,0,5
Greater Western Sydney,"Brogan, Dean",9,7,0,2,0,0,29,2
Greater Western Sydney,"Bugg, Tomas",17,10,3,7,0,0,0,8
Greater Western Sydney,"Cameron, Jeremy",13,12,5,1,3,0,0,4
Greater Western Sydney,"Cornes, Chad",23,15,8,8,0,0,0,2
Greater Western Sydney,"Darley, Sam",16,12,3,4,0,0,0,3
Greater Western Sydney,"Davis, Phil",23,16,7,7,0,0,3,3
Greater Western Sydney,"Edwards, Shaun",14,9,2,5,0,1,0,3
Greater Western Sydney,"Greene, Toby",24,13,1,11,2,0,0,4
Greater Western Sydney,"McDonald, James",8,6,3,2,1,0,0,9
Greater Western Sydney,"Mohr, Tim",15,12,1,3,0,0,0,2
Greater Western Sydney,"Palmer, Rhys",13,10,2,3,2,0,0,4
Greater Western Sydney,"Patton, Jonathon",7,5,4,2,1,0,0,2
Greater Western Sydney,"Phillips, Andrew",4,3,1,1,1,0,13,2
Greater Western Sydney,"Power, Luke",16,10,1,6,0,0,0,6
Greater Western Sydney,"Schulz, Sam",3,3,1,0,1,0,0,2
Greater Western Sydney,"Scully, Tom",20,8,2,12,0,0,0,4
Greater Western Sydney,"Shiel, Dylan",11,6,1,5,1,0,0,9
Greater Western Sydney,"Smith, Devon",8,5,1,3,0,0,0,3
Greater Western Sydney,"Treloar, Adam",6,3,1,3,0,0,0,3
Greater Western Sydney,"Ward, Callan",20,12,0,8,0,1,1,5
Greater Western Sydney,"Whiley, Mark",9,5,3,4,0,0,0,2
Greater Western Sydney,"Adams, Taylor",24,12,2,12,1,0,0,6
Greater Western Sydney,"Brogan, Dean",12,5,6,7,0,0,10,1
Greater Western Sydney,"Bugg, Tomas",8,6,2,2,1,0,0,3
Greater Western Sydney,"Cameron, Jeremy",13,6,3,7,3,0,0,3
Greater Western Sydney,"Darley, Sam",19,13,5,6,0,0,0,1
Greater Western Sydney,"Davis, Phil",16,13,8,3,0,0,0,4
Greater Western Sydney,"Edwards, Shaun",21,13,3,8,0,0,0,2
Greater Western Sydney,"Giles, Jonathan",7,5,2,2,0,1,16,1
Greater Western Sydney,"Greene, Toby",21,12,2,9,1,0,0,3
Greater Western Sydney,"Hombsch, Jack",15,10,5,5,0,0,0,3
Greater Western Sydney,"McDonald, James",16,10,1,6,0,0,0,7
Greater Western Sydney,"Mohr, Tim",12,5,5,7,0,0,0,1
Greater Western Sydney,"Palmer, Rhys",23,10,3,13,0,1,1,4
Greater Western Sydney,"Patton, Jonathon",8,4,3,4,1,0,0,2
Greater Western Sydney,"Power, Luke",10,5,3,5,0,0,0,2
Greater Western Sydney,"Scully, Tom",19,6,4,13,0,0,0,5
Greater Western Sydney,"Shiel, Dylan",21,12,7,9,0,0,0,4
Greater Western Sydney,"Smith, Devon",20,10,4,10,0,0,0,2
Greater Western Sydney,"Treloar, Adam",26,13,5,13,0,0,0,3
Greater Western Sydney,"Ward, Callan",27,18,8,9,0,0,1,7
Greater Western Sydney,"Whiley, Mark",10,5,5,5,0,0,0,1
Greater Western Sydney,"Wilson, Nathan",9,6,2,3,2,0,0,1
Greater Western Sydney,"Brogan, Dean",9,8,4,1,0,0,28,3
Greater Western Sydney,"Bugg, Tomas",10,5,1,5,0,1,0,3
Greater Western Sydney,"Cameron, Jeremy",6,2,1,4,1,1,0,2
Greater Western Sydney,"Cornes, Chad",26,19,8,7,0,0,1,0
Greater Western Sydney,"Davis, Phil",17,8,6,9,0,0,0,4
Greater Western Sydney,"Edwards, Shaun",14,12,4,2,0,0,0,2
Greater Western Sydney,"Giles, Jonathan",17,10,4,7,1,1,21,2
Greater Western Sydney,"Greene, Toby",31,16,2,15,1,0,0,3
Greater Western Sydney,"Hampton, Curtly",15,13,6,2,0,0,0,3
Greater Western Sydney,"Kennedy, Adam",3,2,1,1,0,0,0,1
Greater Western Sydney,"McDonald, James",16,8,3,8,0,0,0,5
Greater Western Sydney,"Mohr, Tim",12,8,7,4,0,0,0,2
Greater Western Sydney,"Palmer, Rhys",25,16,6,9,1,0,0,2
Greater Western Sydney,"Patton, Jonathon",7,3,3,4,0,1,1,1
Greater Western Sydney,"Power, Luke",19,7,2,12,0,0,0,0
Greater Western Sydney,"Scully, Tom",17,5,2,12,0,0,0,8
Greater Western Sydney,"Shiel, Dylan",16,10,2,6,0,0,0,6
Greater Western Sydney,"Smith, Devon",13,4,2,9,0,0,0,8
Greater Western Sydney,"Tomlinson, Adam",9,5,5,4,0,1,0,2
Greater Western Sydney,"Treloar, Adam",26,17,1,9,0,1,0,2
Greater Western Sydney,"Ward, Callan",25,14,5,11,1,0,1,6
Greater Western Sydney,"Wilson, Nathan",7,1,0,6,0,0,0,5
Greater Western Sydney,"Adams, Taylor",24,13,3,11,1,0,0,2
Greater Western Sydney,"Bugg, Tomas",16,4,3,12,0,0,0,4
Greater Western Sydney,"Cameron, Jeremy",6,4,2,2,0,2,0,1
Greater Western Sydney,"Coniglio, Stephen",25,14,3,11,0,0,0,4
Greater Western Sydney,"Cornes, Chad",17,7,4,10,2,0,0,0
Greater Western Sydney,"Davis, Phil",10,7,3,3,0,0,0,1
Greater Western Sydney,"Edwards, Shaun",13,7,3,6,0,0,0,0
Greater Western Sydney,"Giles, Jonathan",8,6,1,2,0,0,22,1
Greater Western Sydney,"Greene, Toby",34,20,4,14,0,0,0,5
Greater Western Sydney,"Hampton, Curtly",16,8,1,8,0,0,1,4
Greater Western Sydney,"Haynes, Nick",6,2,1,4,0,0,0,0
Greater Western Sydney,"Kennedy, Adam",12,4,1,8,0,0,0,4
Greater Western Sydney,"McDonald, James",8,0,2,8,0,0,0,2
Greater Western Sydney,"Mohr, Tim",15,9,5,6,0,0,0,2
Greater Western Sydney,"Palmer, Rhys",22,11,3,11,0,0,0,1
Greater Western Sydney,"Patton, Jonathon",6,3,1,3,0,0,0,1
Greater Western Sydney,"Phillips, Andrew",5,5,2,0,0,1,13,1
Greater Western Sydney,"Smith, Devon",21,14,7,7,0,1,0,4
Greater Western Sydney,"Tomlinson, Adam",17,5,2,12,0,0,0,0
Greater Western Sydney,"Treloar, Adam",13,7,4,6,0,0,0,0
Greater Western Sydney,"Ward, Callan",22,9,3,13,0,0,0,3
Greater Western Sydney,"Wilson, Nathan",9,6,3,3,1,1,0,2
Greater Western Sydney,"Adams, Taylor",19,11,3,8,0,0,0,3
Greater Western Sydney,"Brogan, Dean",14,9,5,5,0,0,22,1
Greater Western Sydney,"Cameron, Jeremy",8,6,3,2,0,1,0,0
Greater Western Sydney,"Clifton, Steve",11,5,1,6,0,0,0,4
Greater Western Sydney,"Coniglio, Stephen",20,9,6,11,0,0,0,3
Greater Western Sydney,"Cornes, Chad",24,13,10,11,1,2,0,1
Greater Western Sydney,"Darley, Sam",20,12,5,8,0,0,0,1
Greater Western Sydney,"Davis, Phil",14,6,5,8,1,0,0,3
Greater Western Sydney,"Edwards, Shaun",18,13,3,5,0,1,0,0
Greater Western Sydney,"Folau, Israel",5,5,2,0,0,0,13,1
Greater Western Sydney,"Greene, Toby",30,16,4,14,1,0,0,7
Greater Western Sydney,"Hampton, Curtly",16,10,5,6,0,0,0,2
Greater Western Sydney,"Haynes, Nick",10,4,2,6,1,0,0,3
Greater Western Sydney,"Kennedy, Adam",16,6,4,10,0,0,0,2
Greater Western Sydney,"Palmer, Rhys",6,2,0,4,0,0,1,0
Greater Western Sydney,"Patton, Jonathon",8,4,3,4,1,0,0,0
Greater Western Sydney,"Power, Luke",14,4,1,10,0,1,0,3
Greater Western Sydney,"Scully, Tom",16,6,3,10,0,1,1,4
Greater Western Sydney,"Smith, Devon",9,2,1,7,0,2,0,4
Greater Western Sydney,"Treloar, Adam",16,11,1,5,1,1,0,4
Greater Western Sydney,"Ward, Callan",30,19,7,11,1,0,2,6
Greater Western Sydney,"Wilson, Nathan",4,4,3,0,1,1,0,1
Greater Western Sydney,"Aylett, Kurt",6,5,2,1,0,0,0,2
Greater Western Sydney,"Bruce, Josh",15,10,9,5,1,1,0,1
Greater Western Sydney,"Bugg, Tomas",27,13,11,14,0,0,0,3
Greater Western Sydney,"Clifton, Steve",14,5,4,9,0,0,0,4
Greater Western Sydney,"Davis, Phil",14,9,5,5,0,0,0,2
Greater Western Sydney,"Folau, Israel",10,4,2,6,0,0,11,2
Greater Western Sydney,"Frost, Sam",10,6,3,4,1,0,1,4
Greater Western Sydney,"Giles, Jonathan",10,7,0,3,0,1,10,1
Greater Western Sydney,"Greene, Toby",29,12,3,17,0,0,0,2
Greater Western Sydney,"Hampton, Curtly",18,10,4,8,0,0,0,2
Greater Western Sydney,"Haynes, Nick",8,6,4,2,0,0,0,1
Greater Western Sydney,"Hoskin-Elliott, Will",14,8,5,6,1,0,0,0
Greater Western Sydney,"Miles, Anthony",27,15,6,12,0,0,0,2
Greater Western Sydney,"Palmer, Rhys",22,13,8,9,0,1,0,2
Greater Western Sydney,"Power, Luke",25,17,12,8,0,0,0,0
Greater Western Sydney,"Scully, Tom",12,5,1,7,0,0,0,7
Greater Western Sydney,"Townsend, Jacob",5,2,3,3,0,0,0,1
Greater Western Sydney,"Treloar, Adam",26,13,10,13,1,0,0,2
Greater Western Sydney,"Ugle, Gerald",5,4,3,1,1,0,0,3
Greater Western Sydney,"Ward, Callan",20,11,4,9,0,1,3,5
Greater Western Sydney,"Whiley, Mark",16,10,7,6,0,0,0,2
Greater Western Sydney,"Wilson, Nathan",5,3,2,2,0,0,0,1
Greater Western Sydney,"Adams, Taylor",26,10,4,16,0,0,0,5
Greater Western Sydney,"Bruce, Josh",10,2,1,8,0,0,0,0
Greater Western Sydney,"Bugg, Tomas",26,13,8,13,0,0,0,1
Greater Western Sydney,"Cameron, Jeremy",14,12,7,2,2,3,0,0
Greater Western Sydney,"Davis, Phil",14,7,5,7,0,0,0,1
Greater Western Sydney,"Edwards, Shaun",13,10,4,3,0,0,0,0
Greater Western Sydney,"Folau, Israel",7,3,1,4,0,1,10,0
Greater Western Sydney,"Frost, Sam",11,5,3,6,0,0,0,1
Greater Western Sydney,"Giles, Jonathan",19,8,10,11,1,2,29,1
Greater Western Sydney,"Greene, Toby",35,12,6,23,0,0,1,0
Greater Western Sydney,"Hampton, Curtly",25,17,8,8,0,0,0,2
Greater Western Sydney,"Haynes, Nick",7,4,2,3,0,1,0,2
Greater Western Sydney,"Hoskin-Elliott, Will",16,10,5,6,0,1,1,0
Greater Western Sydney,"Miles, Anthony",21,11,6,10,0,0,0,1
Greater Western Sydney,"Palmer, Rhys",18,9,8,9,1,0,1,1
Greater Western Sydney,"Patton, Jonathon",7,5,3,2,0,1,0,2
Greater Western Sydney,"Power, Luke",24,12,4,12,0,0,0,2
Greater Western Sydney,"Scully, Tom",27,13,5,14,0,0,0,7
Greater Western Sydney,"Smith, Devon",22,11,2,11,3,0,0,5
Greater Western Sydney,"Townsend, Jacob",10,5,3,5,0,1,0,3
Greater Western Sydney,"Treloar, Adam",37,18,9,19,0,0,0,1
Greater Western Sydney,"Ward, Callan",25,10,3,15,0,0,1,3
Greater Western Sydney,"Adams, Taylor",10,6,3,4,1,0,0,3
Greater Western Sydney,"Brogan, Dean",12,8,6,4,0,0,8,0
Greater Western Sydney,"Bugg, Tomas",14,7,3,7,3,0,0,1
Greater Western Sydney,"Buntine, Matt",14,4,2,10,0,0,0,2
Greater Western Sydney,"Cameron, Jeremy",14,13,7,1,3,3,0,0
Greater Western Sydney,"Coniglio, Stephen",27,20,8,7,0,0,0,3
Greater Western Sydney,"Cornes, Chad",21,16,10,5,1,0,0,3
Greater Western Sydney,"Davis, Phil",16,10,6,6,0,0,0,2
Greater Western Sydney,"Frost, Sam",16,12,8,4,0,0,0,0
Greater Western Sydney,"Giles, Jonathan",23,12,6,11,2,0,26,3
Greater Western Sydney,"Greene, Toby",31,14,2,17,0,1,0,2
Greater Western Sydney,"Hampton, Curtly",16,11,4,5,0,0,0,1
Greater Western Sydney,"Hoskin-Elliott, Will",5,4,1,1,1,0,0,1
Greater Western Sydney,"Kennedy, Adam",11,6,4,5,0,0,0,2
Greater Western Sydney,"Miles, Anthony",11,7,3,4,0,0,0,4
Greater Western Sydney,"Patton, Jonathon",5,4,3,1,1,2,0,1
Greater Western Sydney,"Power, Luke",23,11,5,12,0,0,0,1
Greater Western Sydney,"Scully, Tom",20,7,5,13,0,0,0,1
Greater Western Sydney,"Smith, Devon",21,12,8,9,2,2,0,6
Greater Western Sydney,"Townsend, Jacob",10,3,3,7,0,0,0,3
Greater Western Sydney,"Treloar, Adam",26,13,5,13,2,1,0,2
Greater Western Sydney,"Ward, Callan",29,15,5,14,0,0,2,8
Greater Western Sydney,"Bugg, Tomas",16,8,4,8,1,2,0,1
Greater Western Sydney,"Buntine, Matt",12,5,5,7,0,0,0,2
Greater Western Sydney,"Cameron, Jeremy",13,9,7,4,2,0,1,0
Greater Western Sydney,"Clifton, Steve",11,8,4,3,1,0,0,5
Greater Western Sydney,"Cornes, Chad",22,13,7,9,0,0,0,2
Greater Western Sydney,"Darley, Sam",13,8,3,5,0,0,0,2
Greater Western Sydney,"Davis, Phil",19,16,11,3,0,0,0,2
Greater Western Sydney,"Edwards, Shaun",11,8,3,3,0,1,0,0
Greater Western Sydney,"Folau, Israel",1,1,1,0,0,1,1,1
Greater Western Sydney,"Giles, Jonathan",12,8,1,4,0,0,38,1
Greater Western Sydney,"Golds, Tim",9,7,3,2,0,0,0,0
Greater Western Sydney,"Hampton, Curtly",16,12,3,4,0,0,0,1
Greater Western Sydney,"Hombsch, Jack",15,12,4,3,0,0,0,2
Greater Western Sydney,"Hoskin-Elliott, Will",16,12,4,4,5,1,0,2
Greater Western Sydney,"Kennedy, Adam",13,7,5,6,0,0,0,1
Greater Western Sydney,"Miles, Anthony",18,10,3,8,0,0,0,6
Greater Western Sydney,"Phillips, Andrew",5,2,0,3,0,0,8,1
Greater Western Sydney,"Power, Luke",17,5,3,12,0,0,0,3
Greater Western Sydney,"Scully, Tom",22,12,1,10,1,0,0,2
Greater Western Sydney,"Smith, Devon",25,15,5,10,1,0,0,5
Greater Western Sydney,"Tomlinson, Adam",13,10,8,3,1,0,0,1
Greater Western Sydney,"Treloar, Adam",32,17,7,15,0,0,0,2
Greater Western Sydney,"Adams, Taylor",25,18,4,7,0,0,0,3
Greater Western Sydney,"Buntine, Matt",6,3,1,3,0,0,0,3
Greater Western Sydney,"Clifton, Steve",6,2,0,4,0,0,0,4
Greater Western Sydney,"Cornes, Chad",18,10,5,8,0,0,0,2
Greater Western Sydney,"Darley, Sam",7,4,2,3,0,0,0,0
Greater Western Sydney,"Davis, Phil",17,11,4,6,1,0,0,0
Greater Western Sydney,"Edwards, Shaun",11,6,4,5,1,0,0,2
Greater Western Sydney,"Folau, Israel",3,1,0,2,0,0,3,0
Greater Western Sydney,"Giles, Jonathan",21,14,10,7,0,0,25,2
Greater Western Sydney,"Golds, Tim",9,3,1,6,0,0,0,1
Greater Western Sydney,"Greene, Toby",38,20,7,18,2,1,0,4
Greater Western Sydney,"Hampton, Curtly",9,4,0,5,0,0,0,1
Greater Western Sydney,"Haynes, Nick",5,2,1,3,0,0,0,3
Greater Western Sydney,"Hoskin-Elliott, Will",8,7,4,1,1,0,0,1
Greater Western Sydney,"Kennedy, Adam",13,4,3,9,0,0,0,4
Greater Western Sydney,"McDonald, James",10,5,2,5,1,0,1,2
Greater Western Sydney,"Miles, Anthony",13,9,3,4,0,0,0,5
Greater Western Sydney,"Phillips, Andrew",14,11,2,3,1,1,14,3
Greater Western Sydney,"Power, Luke",25,15,4,10,0,0,0,3
Greater Western Sydney,"Scully, Tom",16,12,2,4,1,0,0,6
Greater Western Sydney,"Smith, Devon",18,8,2,10,1,1,0,6
Greater Western Sydney,"Tyson, Dom",17,10,6,7,0,0,0,2
Greater Western Sydney,"Adams, Taylor",27,15,7,12,1,0,0,2
Greater Western Sydney,"Bugg, Tomas",11,7,3,4,0,0,0,2
Greater Western Sydney,"Buntine, Matt",13,5,4,8,0,0,0,0
Greater Western Sydney,"Cooyou, Rhys",10,3,2,7,1,0,0,3
Greater Western Sydney,"Darley, Sam",16,6,2,10,0,0,0,1
Greater Western Sydney,"Davis, Phil",17,9,7,8,0,0,0,1
Greater Western Sydney,"Giles, Jonathan",10,8,3,2,0,0,27,3
Greater Western Sydney,"Greene, Toby",34,20,2,14,0,0,0,4
Greater Western Sydney,"Hampton, Curtly",10,5,1,5,1,0,0,2
Greater Western Sydney,"Haynes, Nick",19,10,5,9,0,0,0,0
Greater Western Sydney,"Hoskin-Elliott, Will",11,6,3,5,0,0,0,2
Greater Western Sydney,"Kennedy, Adam",6,4,1,2,0,0,0,3
Greater Western Sydney,"McDonald, James",12,7,0,5,0,0,0,3
Greater Western Sydney,"Miles, Anthony",23,11,5,12,0,0,1,4
Greater Western Sydney,"Phillips, Andrew",6,2,2,4,0,0,8,1
Greater Western Sydney,"Power, Luke",25,13,5,12,0,0,0,8
Greater Western Sydney,"Smith, Devon",11,6,1,5,0,1,0,1
Greater Western Sydney,"Tomlinson, Adam",9,5,1,4,0,0,0,2
Greater Western Sydney,"Treloar, Adam",20,13,7,7,2,0,0,3
Greater Western Sydney,"Tyson, Dom",24,9,8,15,0,0,0,4
Greater Western Sydney,"Ward, Callan",18,11,6,7,0,1,3,2
Greater Western Sydney,"Wilson, Nathan",2,1,0,1,0,0,0,4
Greater Western Sydney,"Adams, Taylor",23,10,1,13,0,0,0,4
Greater Western Sydney,"Brogan, Dean",13,3,4,10,0,0,8,0
Greater Western Sydney,"Buntine, Matt",15,9,3,6,0,2,0,3
Greater Western Sydney,"Clifton, Steve",14,7,2,7,0,0,0,3
Greater Western Sydney,"Cornes, Chad",9,4,3,5,0,0,0,3
Greater Western Sydney,"Davis, Phil",12,6,7,6,0,0,0,2
Greater Western Sydney,"Folau, Israel",9,5,2,4,1,1,4,2
Greater Western Sydney,"Giles, Jonathan",14,9,4,5,3,0,23,0
Greater Western Sydney,"Greene, Toby",38,22,2,16,1,2,0,2
Greater Western Sydney,"Hampton, Curtly",17,13,3,4,0,0,0,1
Greater Western Sydney,"Haynes, Nick",15,10,4,5,0,0,0,3
Greater Western Sydney,"Hombsch, Jack",9,6,2,3,0,0,0,3
Greater Western Sydney,"Hoskin-Elliott, Will",13,12,6,1,0,0,0,2
Greater Western Sydney,"Kennedy, Adam",17,7,5,10,0,0,0,1
Greater Western Sydney,"McDonald, James",9,6,2,3,0,0,0,1
Greater Western Sydney,"Palmer, Rhys",19,8,3,11,3,1,2,2
Greater Western Sydney,"Power, Luke",19,8,2,11,0,0,0,0
Greater Western Sydney,"Scully, Tom",25,12,2,13,0,1,0,1
Greater Western Sydney,"Smith, Devon",6,4,0,2,0,0,0,2
Greater Western Sydney,"Treloar, Adam",23,12,6,11,1,0,0,3
Greater Western Sydney,"Tyson, Dom",26,13,5,13,1,0,0,2
Greater Western Sydney,"Ward, Callan",30,14,2,16,1,1,2,3
Hawthorn,"Bateman, Chance",11,7,2,4,0,0,0,1
Hawthorn,"Birchall, Grant",28,21,9,7,1,0,0,2
Hawthorn,"Boumann, Jarrad",7,3,1,4,0,0,0,0
Hawthorn,"Breust, Luke",14,5,2,9,0,1,0,5
Hawthorn,"Burgoyne, Shaun",13,9,3,4,1,1,0,4
Hawthorn,"Franklin, Lance",21,13,6,8,5,3,1,6
Hawthorn,"Gibson, Josh",13,6,4,7,0,0,0,4
Hawthorn,"Guerra, Brent",20,13,5,7,0,2,0,4
Hawthorn,"Gunston, Jack",7,4,4,3,1,1,0,1
Hawthorn,"Hale, David",16,7,6,9,0,1,18,0
Hawthorn,"Lewis, Jordan",17,12,7,5,2,1,2,4
Hawthorn,"McCauley, Broc",14,4,4,10,1,0,21,1
Hawthorn,"Mitchell, Sam",32,16,6,16,0,2,0,8
Hawthorn,"Osborne, Michael",17,10,5,7,1,1,0,1
Hawthorn,"Rioli, Cyril",16,9,4,7,2,0,0,4
Hawthorn,"Savage, Shane",15,7,3,8,2,1,0,1
Hawthorn,"Schoenmakers, Ryan",7,5,3,2,0,0,0,1
Hawthorn,"Sewell, Brad",26,12,2,14,0,1,0,7
Hawthorn,"Smith, Isaac",17,13,1,4,2,0,0,5
Hawthorn,"Stratton, Ben",11,5,1,6,0,0,0,5
Hawthorn,"Suckling, Matt",26,14,7,12,0,0,0,5
Hawthorn,"Whitecross, Brendan",21,11,3,10,2,0,0,6
Hawthorn,"Bateman, Chance",9,7,2,2,0,0,0,3
Hawthorn,"Birchall, Grant",18,14,5,4,0,0,0,3
Hawthorn,"Breust, Luke",10,5,3,5,0,2,0,4
Hawthorn,"Burgoyne, Shaun",23,17,2,6,0,0,0,8
Hawthorn,"Franklin, Lance",15,13,3,2,2,4,0,3
Hawthorn,"Gibson, Josh",16,6,2,10,0,0,0,8
Hawthorn,"Guerra, Brent",14,10,1,4,0,0,0,6
Hawthorn,"Gunston, Jack",4,4,2,0,0,1,0,0
Hawthorn,"Hale, David",12,4,2,8,1,0,17,1
Hawthorn,"Lewis, Jordan",20,11,2,9,3,0,3,4
Hawthorn,"McCauley, Broc",11,4,4,7,0,0,12,2
Hawthorn,"Mitchell, Sam",30,15,3,15,1,0,0,7
Hawthorn,"Osborne, Michael",17,8,1,9,0,1,1,2
Hawthorn,"Rioli, Cyril",15,9,2,6,2,1,0,3
Hawthorn,"Roughead, Jarryd",16,7,2,9,1,1,1,3
Hawthorn,"Savage, Shane",15,10,3,5,0,0,0,5
Hawthorn,"Schoenmakers, Ryan",8,6,2,2,0,0,0,3
Hawthorn,"Sewell, Brad",19,11,3,8,0,0,0,3
Hawthorn,"Smith, Isaac",17,15,4,2,0,1,0,6
Hawthorn,"Stratton, Ben",9,8,3,1,0,0,0,5
Hawthorn,"Suckling, Matt",15,13,6,2,1,0,0,1
Hawthorn,"Whitecross, Brendan",28,19,7,9,2,0,2,3
Hawthorn,"Birchall, Grant",19,12,9,7,0,0,0,1
Hawthorn,"Breust, Luke",16,11,5,5,3,2,0,4
Hawthorn,"Burgoyne, Shaun",13,10,6,3,1,0,0,2
Hawthorn,"Cheney, Kyle",17,7,2,10,1,0,0,3
Hawthorn,"Franklin, Lance",24,15,8,9,3,2,0,5
Hawthorn,"Gibson, Josh",30,21,15,9,0,0,0,6
Hawthorn,"Guerra, Brent",27,18,8,9,0,1,0,2
Hawthorn,"Gunston, Jack",10,4,4,6,1,0,0,1
Hawthorn,"Hale, David",15,8,5,7,2,2,23,3
Hawthorn,"Lewis, Jordan",24,12,3,12,2,1,2,1
Hawthorn,"Mitchell, Sam",20,11,3,9,1,1,0,7
Hawthorn,"Osborne, Michael",15,7,6,8,1,1,5,2
Hawthorn,"Rioli, Cyril",10,5,4,5,2,0,0,3
Hawthorn,"Roughead, Jarryd",22,10,6,12,0,1,9,8
Hawthorn,"Savage, Shane",6,4,3,2,0,1,0,3
Hawthorn,"Schoenmakers, Ryan",22,12,10,10,0,0,0,2
Hawthorn,"Sewell, Brad",16,6,3,10,0,0,0,7
Hawthorn,"Shiels, Liam",19,10,2,9,1,0,1,9
Hawthorn,"Stratton, Ben",21,14,10,7,0,0,0,2
Hawthorn,"Suckling, Matt",20,14,10,6,2,0,1,1
Hawthorn,"Whitecross, Brendan",25,16,12,9,1,0,0,4
Hawthorn,"Young, Clinton",16,12,6,4,0,0,0,3
Hawthorn,"Bruce, Cameron",8,4,2,4,0,0,0,0
Hawthorn,"Burgoyne, Shaun",16,10,5,6,0,0,0,1
Hawthorn,"Cheney, Kyle",5,2,4,3,0,0,0,5
Hawthorn,"Franklin, Lance",19,13,4,6,1,6,0,5
Hawthorn,"Gibson, Josh",12,9,4,3,0,0,0,2
Hawthorn,"Guerra, Brent",18,14,5,4,0,0,0,3
Hawthorn,"Gunston, Jack",8,4,2,4,0,1,0,2
Hawthorn,"Hale, David",11,4,2,7,0,0,10,4
Hawthorn,"Hill, Bradley",2,1,0,1,0,0,0,1
Hawthorn,"Lewis, Jordan",26,15,7,11,1,0,0,2
Hawthorn,"Mitchell, Sam",29,16,6,13,0,1,0,9
Hawthorn,"Osborne, Michael",14,9,2,5,1,3,0,3
Hawthorn,"Rioli, Cyril",12,9,3,3,2,1,0,4
Hawthorn,"Roughead, Jarryd",11,9,4,2,0,0,14,5
Hawthorn,"Savage, Shane",12,9,4,3,0,0,0,8
Hawthorn,"Schoenmakers, Ryan",8,4,3,4,0,0,0,2
Hawthorn,"Sewell, Brad",25,13,2,12,0,1,0,6
Hawthorn,"Shiels, Liam",15,8,3,7,0,1,0,4
Hawthorn,"Stratton, Ben",12,9,4,3,0,0,0,4
Hawthorn,"Suckling, Matt",21,17,5,4,0,1,0,4
Hawthorn,"Whitecross, Brendan",12,8,1,4,0,0,2,1
Hawthorn,"Young, Clinton",8,6,0,2,0,0,0,6
Hawthorn,"Breust, Luke",11,6,0,5,0,0,0,7
Hawthorn,"Burgoyne, Shaun",26,11,2,15,0,0,0,3
Hawthorn,"Cheney, Kyle",11,3,2,8,0,0,0,3
Hawthorn,"Franklin, Lance",14,7,4,7,0,3,0,6
Hawthorn,"Gibson, Josh",12,5,4,7,0,0,0,2
Hawthorn,"Guerra, Brent",20,13,6,7,0,0,0,6
Hawthorn,"Hale, David",5,3,2,2,2,0,12,2
Hawthorn,"Hodge, Luke",14,8,3,6,0,0,0,2
Hawthorn,"Lewis, Jordan",18,5,4,13,2,0,3,6
Hawthorn,"McCauley, Broc",9,3,3,6,0,0,23,4
Hawthorn,"Mitchell, Sam",20,12,3,8,0,0,0,2
Hawthorn,"Osborne, Michael",15,3,2,12,0,0,3,3
Hawthorn,"Puopolo, Paul",8,2,2,6,0,0,0,1
Hawthorn,"Rioli, Cyril",15,9,4,6,1,0,1,4
Hawthorn,"Roughead, Jarryd",14,11,4,3,5,1,10,0
Hawthorn,"Savage, Shane",21,14,6,7,0,0,0,3
Hawthorn,"Schoenmakers, Ryan",18,8,5,10,0,0,0,2
Hawthorn,"Sewell, Brad",22,14,2,8,0,2,0,6
Hawthorn,"Shiels, Liam",18,9,4,9,0,0,0,5
Hawthorn,"Stratton, Ben",9,5,1,4,0,0,0,3
Hawthorn,"Suckling, Matt",27,13,2,14,0,2,0,0
Hawthorn,"Whitecross, Brendan",21,14,5,7,0,0,4,3
Hawthorn,"Birchall, Grant",21,11,3,10,0,0,0,0
Hawthorn,"Boumann, Jarrad",3,0,0,3,0,0,0,5
Hawthorn,"Breust, Luke",11,6,6,5,1,0,0,1
Hawthorn,"Burgoyne, Shaun",15,13,5,2,0,0,0,2
Hawthorn,"Franklin, Lance",18,15,7,3,5,6,0,1
Hawthorn,"Guerra, Brent",25,21,14,4,0,0,0,1
Hawthorn,"Hale, David",11,3,2,8,1,0,31,5
Hawthorn,"Hodge, Luke",24,14,6,10,0,0,0,1
Hawthorn,"Lewis, Jordan",22,12,8,10,0,0,1,3
Hawthorn,"Mitchell, Sam",29,17,6,12,0,0,0,4
Hawthorn,"Osborne, Michael",9,7,4,2,0,0,1,3
Hawthorn,"Puopolo, Paul",4,2,0,2,1,0,0,5
Hawthorn,"Rioli, Cyril",18,12,2,6,6,1,0,5
Hawthorn,"Roughead, Jarryd",23,15,5,8,2,0,8,1
Hawthorn,"Savage, Shane",16,8,7,8,0,2,0,4
Hawthorn,"Schoenmakers, Ryan",16,10,6,6,0,0,0,1
Hawthorn,"Sewell, Brad",23,11,0,12,0,0,0,6
Hawthorn,"Shiels, Liam",26,16,11,10,0,0,0,7
Hawthorn,"Smith, Isaac",22,13,5,9,1,0,0,2
Hawthorn,"Stratton, Ben",15,5,6,10,0,0,0,1
Hawthorn,"Suckling, Matt",20,12,7,8,0,0,0,2
Hawthorn,"Whitecross, Brendan",20,13,7,7,1,1,0,0
Hawthorn,"Birchall, Grant",29,12,8,17,0,0,0,2
Hawthorn,"Breust, Luke",16,6,5,10,1,3,0,4
Hawthorn,"Burgoyne, Shaun",19,12,6,7,0,0,0,1
Hawthorn,"Franklin, Lance",23,15,6,8,3,7,0,4
Hawthorn,"Gilham, Stephen",13,8,5,5,0,0,0,1
Hawthorn,"Guerra, Brent",14,6,3,8,0,0,0,2
Hawthorn,"Hale, David",23,11,4,12,1,2,23,1
Hawthorn,"Lewis, Jordan",26,6,5,20,1,0,0,1
Hawthorn,"Mitchell, Sam",22,15,4,7,0,0,0,8
Hawthorn,"Osborne, Michael",1,1,0,0,0,0,0,0
Hawthorn,"Puopolo, Paul",9,5,3,4,2,1,0,0
Hawthorn,"Rioli, Cyril",10,6,1,4,1,2,0,1
Hawthorn,"Roughead, Jarryd",22,14,8,8,1,1,3,1
Hawthorn,"Savage, Shane",20,10,5,10,1,2,0,3
Hawthorn,"Schoenmakers, Ryan",22,14,8,8,0,0,0,0
Hawthorn,"Sewell, Brad",32,13,2,19,0,1,0,7
Hawthorn,"Shiels, Liam",24,12,4,12,0,0,0,5
Hawthorn,"Smith, Isaac",16,8,4,8,1,1,0,4
Hawthorn,"Stratton, Ben",15,8,6,7,0,0,0,2
Hawthorn,"Suckling, Matt",29,23,13,6,1,1,0,0
Hawthorn,"Whitecross, Brendan",23,14,6,9,0,2,0,2
Hawthorn,"Young, Clinton",16,11,4,5,2,0,0,1
Hawthorn,"Birchall, Grant",23,15,7,8,0,0,0,1
Hawthorn,"Breust, Luke",24,11,4,13,2,1,0,3
Hawthorn,"Burgoyne, Shaun",13,8,2,5,0,0,0,3
Hawthorn,"Franklin, Lance",21,15,6,6,1,2,0,1
Hawthorn,"Gibson, Josh",19,7,2,12,0,0,0,3
Hawthorn,"Gilham, Stephen",14,8,4,6,0,0,0,0
Hawthorn,"Guerra, Brent",22,17,5,5,1,1,0,2
Hawthorn,"Hale, David",14,7,5,7,1,0,19,1
Hawthorn,"Lewis, Jordan",26,9,3,17,1,1,2,5
Hawthorn,"Mitchell, Sam",21,10,0,11,1,0,0,5
Hawthorn,"Puopolo, Paul",4,0,0,4,0,0,0,2
Hawthorn,"Rioli, Cyril",14,6,4,8,2,0,0,8
Hawthorn,"Roughead, Jarryd",11,10,6,1,4,2,1,1
Hawthorn,"Savage, Shane",8,4,5,4,0,0,0,0
Hawthorn,"Schoenmakers, Ryan",9,6,6,3,0,0,0,1
Hawthorn,"Sewell, Brad",28,13,4,15,0,0,0,3
Hawthorn,"Shiels, Liam",27,20,5,7,0,0,0,4
Hawthorn,"Smith, Isaac",20,11,6,9,1,3,1,4
Hawthorn,"Stratton, Ben",18,7,6,11,0,0,0,2
Hawthorn,"Suckling, Matt",18,17,8,1,2,2,1,0
Hawthorn,"Whitecross, Brendan",20,14,6,6,0,0,1,1
Hawthorn,"Young, Clinton",25,20,12,5,1,3,0,4
Hawthorn,"Birchall, Grant",24,14,6,10,0,0,0,2
Hawthorn,"Breust, Luke",11,4,4,7,3,0,0,8
Hawthorn,"Burgoyne, Shaun",26,14,3,12,0,1,0,4
Hawthorn,"Franklin, Lance",18,12,6,6,1,3,0,6
Hawthorn,"Gibson, Josh",15,7,4,8,0,0,0,3
Hawthorn,"Gilham, Stephen",11,5,4,6,0,0,0,0
Hawthorn,"Guerra, Brent",13,10,3,3,0,0,0,3
Hawthorn,"Hale, David",12,3,3,9,0,0,23,1
Hawthorn,"Lewis, Jordan",20,9,4,11,0,0,4,3
Hawthorn,"Mitchell, Sam",22,13,2,9,0,1,0,9
Hawthorn,"Puopolo, Paul",4,3,0,1,0,0,0,1
Hawthorn,"Rioli, Cyril",15,9,2,6,2,3,0,4
Hawthorn,"Roughead, Jarryd",17,9,6,8,2,1,13,3
Hawthorn,"Savage, Shane",8,6,2,2,0,1,0,5
Hawthorn,"Schoenmakers, Ryan",17,12,3,5,0,0,0,2
Hawthorn,"Sewell, Brad",21,12,1,9,0,0,0,7
Hawthorn,"Shiels, Liam",11,8,3,3,0,0,0,2
Hawthorn,"Smith, Isaac",15,5,1,10,1,0,0,5
Hawthorn,"Stratton, Ben",13,8,5,5,0,0,0,5
Hawthorn,"Suckling, Matt",20,13,7,7,0,0,0,0
Hawthorn,"Whitecross, Brendan",24,19,8,5,0,2,0,2
Hawthorn,"Young, Clinton",12,7,3,5,1,0,0,5
Hawthorn,"Birchall, Grant",28,13,5,15,0,0,0,0
Hawthorn,"Breust, Luke",12,6,5,6,3,0,0,6
Hawthorn,"Burgoyne, Shaun",18,10,2,8,0,0,0,7
Hawthorn,"Franklin, Lance",23,22,11,1,13,4,0,6
Hawthorn,"Gibson, Josh",7,6,2,1,0,0,0,1
Hawthorn,"Guerra, Brent",24,17,8,7,0,0,0,6
Hawthorn,"Hale, David",13,6,7,7,1,0,40,4
Hawthorn,"Hill, Bradley",9,8,4,1,0,1,0,0
Hawthorn,"Lewis, Jordan",18,10,2,8,2,1,4,1
Hawthorn,"Mitchell, Sam",35,19,7,16,0,0,0,4
Hawthorn,"Puopolo, Paul",17,8,2,9,2,1,0,0
Hawthorn,"Rioli, Cyril",18,12,3,6,2,0,0,3
Hawthorn,"Roughead, Jarryd",8,7,4,1,1,0,15,7
Hawthorn,"Savage, Shane",9,5,3,4,0,0,0,1
Hawthorn,"Schoenmakers, Ryan",21,12,7,9,0,0,0,4
Hawthorn,"Sewell, Brad",21,12,3,9,0,0,0,9
Hawthorn,"Shiels, Liam",12,10,2,2,0,1,0,3
Hawthorn,"Smith, Isaac",15,9,5,6,1,1,1,1
Hawthorn,"Stratton, Ben",9,5,4,4,0,0,0,1
Hawthorn,"Suckling, Matt",20,14,6,6,0,1,0,3
Hawthorn,"Whitecross, Brendan",23,22,3,1,0,0,1,5
Hawthorn,"Young, Clinton",17,13,3,4,2,1,0,2
Hawthorn,"Birchall, Grant",26,13,5,13,0,0,0,2
Hawthorn,"Breust, Luke",19,6,1,13,3,1,0,2
Hawthorn,"Burgoyne, Shaun",19,10,5,9,0,0,0,3
Hawthorn,"Franklin, Lance",15,14,6,1,4,4,0,3
Hawthorn,"Gibson, Josh",24,13,11,11,0,0,0,2
Hawthorn,"Guerra, Brent",16,12,1,4,0,0,0,3
Hawthorn,"Gunston, Jack",11,7,7,4,2,1,0,3
Hawthorn,"Hale, David",19,9,4,10,1,0,25,3
Hawthorn,"Hill, Bradley",11,9,4,2,2,1,0,1
Hawthorn,"Mitchell, Sam",25,13,2,12,0,0,0,6
Hawthorn,"Puopolo, Paul",15,10,3,5,1,0,0,4
Hawthorn,"Rioli, Cyril",13,6,1,7,0,0,0,14
Hawthorn,"Roughead, Jarryd",17,12,5,5,2,2,11,2
Hawthorn,"Savage, Shane",9,7,2,2,0,0,0,4
Hawthorn,"Schoenmakers, Ryan",16,13,6,3,0,0,0,2
Hawthorn,"Sewell, Brad",33,18,4,15,0,1,0,2
Hawthorn,"Shiels, Liam",16,7,2,9,1,0,0,5
Hawthorn,"Smith, Isaac",16,11,4,5,0,1,3,4
Hawthorn,"Stratton, Ben",6,4,0,2,0,0,0,1
Hawthorn,"Suckling, Matt",20,9,5,11,0,1,0,2
Hawthorn,"Whitecross, Brendan",18,13,11,5,0,0,1,2
Hawthorn,"Young, Clinton",13,11,2,2,0,0,1,0
Hawthorn,"Birchall, Grant",25,21,6,4,0,0,0,2
Hawthorn,"Breust, Luke",13,4,5,9,2,0,0,5
Hawthorn,"Burgoyne, Shaun",25,16,3,9,2,0,0,7
Hawthorn,"Franklin, Lance",17,15,4,2,5,1,0,7
Hawthorn,"Gibson, Josh",14,6,6,8,0,0,0,1
Hawthorn,"Guerra, Brent",11,9,4,2,0,1,0,2
Hawthorn,"Gunston, Jack",13,6,1,7,2,4,0,2
Hawthorn,"Hale, David",9,3,4,6,0,2,20,0
Hawthorn,"Hill, Bradley",11,7,0,4,1,1,0,1
Hawthorn,"Mitchell, Sam",25,13,4,12,1,0,0,8
Hawthorn,"Murphy, Tom",10,5,1,5,0,0,0,5
Hawthorn,"Puopolo, Paul",16,10,1,6,2,1,0,9
Hawthorn,"Rioli, Cyril",19,11,2,8,1,0,0,9
Hawthorn,"Roughead, Jarryd",17,10,3,7,2,3,17,6
Hawthorn,"Savage, Shane",22,13,2,9,1,1,0,4
Hawthorn,"Schoenmakers, Ryan",8,1,0,7,0,0,0,1
Hawthorn,"Sewell, Brad",21,10,3,11,0,0,0,4
Hawthorn,"Shiels, Liam",20,12,4,8,0,2,0,10
Hawthorn,"Smith, Isaac",14,8,2,6,0,0,0,6
Hawthorn,"Stratton, Ben",12,11,5,1,0,0,0,1
Hawthorn,"Suckling, Matt",26,16,3,10,0,0,0,5
Hawthorn,"Young, Clinton",15,12,3,3,0,1,0,2
Hawthorn,"Birchall, Grant",29,14,9,15,0,1,0,2
Hawthorn,"Breust, Luke",16,6,3,10,2,0,0,1
Hawthorn,"Burgoyne, Shaun",17,8,5,9,0,0,0,1
Hawthorn,"Franklin, Lance",23,19,7,4,4,2,0,1
Hawthorn,"Gibson, Josh",13,7,4,6,0,0,0,0
Hawthorn,"Guerra, Brent",22,17,5,5,0,0,0,2
Hawthorn,"Gunston, Jack",10,6,3,4,3,0,0,1
Hawthorn,"Hale, David",16,9,6,7,1,1,29,3
Hawthorn,"Lewis, Jordan",24,15,8,9,1,0,1,2
Hawthorn,"Mitchell, Sam",32,19,5,13,1,0,1,5
Hawthorn,"Puopolo, Paul",10,6,2,4,1,0,0,2
Hawthorn,"Rioli, Cyril",15,8,1,7,0,0,0,7
Hawthorn,"Roughead, Jarryd",12,8,4,4,3,0,6,5
Hawthorn,"Savage, Shane",15,10,6,5,1,0,0,2
Hawthorn,"Schoenmakers, Ryan",15,8,6,7,0,0,0,1
Hawthorn,"Sewell, Brad",24,12,0,12,0,1,0,4
Hawthorn,"Shiels, Liam",21,11,4,10,0,0,0,5
Hawthorn,"Smith, Isaac",7,5,2,2,0,0,0,0
Hawthorn,"Stratton, Ben",9,7,5,2,0,0,0,5
Hawthorn,"Suckling, Matt",18,12,5,6,1,0,0,2
Hawthorn,"Whitecross, Brendan",17,9,5,8,0,0,1,3
Hawthorn,"Young, Clinton",14,11,4,3,0,3,0,8
Hawthorn,"Birchall, Grant",30,16,8,14,0,1,0,2
Hawthorn,"Breust, Luke",20,8,4,12,3,3,0,8
Hawthorn,"Cheney, Kyle",11,5,3,6,0,1,0,0
Hawthorn,"Franklin, Lance",9,7,5,2,4,1,0,3
Hawthorn,"Gibson, Josh",26,18,5,8,0,0,0,0
Hawthorn,"Gunston, Jack",9,7,5,2,1,1,0,3
Hawthorn,"Hale, David",16,4,7,12,2,1,19,4
Hawthorn,"Hill, Bradley",17,11,1,6,0,1,0,0
Hawthorn,"Lewis, Jordan",31,14,8,17,1,0,3,1
Hawthorn,"Mitchell, Sam",33,17,6,16,1,0,0,1
Hawthorn,"Murphy, Tom",17,6,6,11,1,0,0,2
Hawthorn,"Puopolo, Paul",13,9,4,4,1,1,0,3
Hawthorn,"Rioli, Cyril",26,19,10,7,3,3,0,9
Hawthorn,"Roughead, Jarryd",21,15,12,6,6,3,6,2
Hawthorn,"Savage, Shane",11,7,2,4,1,1,0,2
Hawthorn,"Schoenmakers, Ryan",13,6,5,7,0,0,0,2
Hawthorn,"Shiels, Liam",29,15,5,14,1,0,0,6
Hawthorn,"Smith, Isaac",24,12,8,12,0,2,0,7
Hawthorn,"Stratton, Ben",9,2,3,7,0,0,0,1
Hawthorn,"Suckling, Matt",35,23,6,12,1,1,0,1
Hawthorn,"Whitecross, Brendan",26,16,11,10,0,1,0,2
Hawthorn,"Young, Clinton",28,19,8,9,2,0,0,1
Hawthorn,"Birchall, Grant",28,11,7,17,0,0,0,1
Hawthorn,"Breust, Luke",16,8,1,8,2,0,0,3
Hawthorn,"Burgoyne, Shaun",14,8,1,6,0,1,0,1
Hawthorn,"Cheney, Kyle",7,2,2,5,0,0,0,1
Hawthorn,"Gibson, Josh",30,18,7,12,0,0,0,2
Hawthorn,"Gilham, Stephen",10,5,2,5,0,0,0,1
Hawthorn,"Gunston, Jack",13,10,9,3,4,1,0,0
Hawthorn,"Hale, David",18,4,2,14,0,1,23,2
Hawthorn,"Lewis, Jordan",23,10,6,13,2,0,2,1
Hawthorn,"Mitchell, Sam",34,19,4,15,1,0,0,5
Hawthorn,"Murphy, Tom",13,9,6,4,0,0,0,2
Hawthorn,"Puopolo, Paul",4,1,0,3,0,0,0,3
Hawthorn,"Rioli, Cyril",15,10,5,5,2,1,0,4
Hawthorn,"Roughead, Jarryd",18,8,3,10,2,3,9,4
Hawthorn,"Schoenmakers, Ryan",14,7,5,7,2,1,0,1
Hawthorn,"Sewell, Brad",24,10,3,14,1,1,0,6
Hawthorn,"Shiels, Liam",18,10,1,8,0,1,0,5
Hawthorn,"Smith, Isaac",22,7,7,15,0,0,1,2
Hawthorn,"Stratton, Ben",20,9,4,11,0,0,0,4
Hawthorn,"Suckling, Matt",9,5,2,4,0,0,0,2
Hawthorn,"Whitecross, Brendan",25,18,9,7,1,0,1,4
Hawthorn,"Young, Clinton",22,15,2,7,0,2,1,2
Hawthorn,"Birchall, Grant",18,12,5,6,0,0,0,5
Hawthorn,"Breust, Luke",15,12,3,3,5,2,0,3
Hawthorn,"Burgoyne, Shaun",16,6,4,10,0,0,0,7
Hawthorn,"Cheney, Kyle",10,5,4,5,0,0,0,0
Hawthorn,"Gibson, Josh",18,9,5,9,0,0,0,1
Hawthorn,"Gunston, Jack",21,13,4,8,3,1,0,2
Hawthorn,"Hale, David",12,6,6,6,0,0,29,0
Hawthorn,"Lewis, Jordan",20,11,5,9,5,1,3,0
Hawthorn,"Mitchell, Sam",33,20,2,13,0,1,1,3
Hawthorn,"Murphy, Tom",16,10,2,6,1,1,0,2
Hawthorn,"Puopolo, Paul",13,7,4,6,1,1,0,3
Hawthorn,"Rioli, Cyril",19,9,1,10,1,0,0,8
Hawthorn,"Roughead, Jarryd",20,12,6,8,3,1,6,0
Hawthorn,"Savage, Shane",7,4,2,3,0,1,0,0
Hawthorn,"Schoenmakers, Ryan",13,8,4,5,0,0,0,1
Hawthorn,"Sewell, Brad",26,12,2,14,1,0,0,7
Hawthorn,"Shiels, Liam",21,10,3,11,0,0,0,3
Hawthorn,"Smith, Isaac",20,10,3,10,0,0,0,1
Hawthorn,"Stratton, Ben",10,8,4,2,0,0,0,4
Hawthorn,"Suckling, Matt",22,15,5,7,0,0,0,0
Hawthorn,"Whitecross, Brendan",20,11,5,9,0,0,2,4
Hawthorn,"Young, Clinton",14,13,9,1,1,2,0,2
Hawthorn,"Bailey, Max",6,1,2,5,0,0,25,2
Hawthorn,"Birchall, Grant",18,9,5,9,0,1,0,2
Hawthorn,"Breust, Luke",21,8,6,13,2,2,0,3
Hawthorn,"Burgoyne, Shaun",13,9,3,4,0,0,0,3
Hawthorn,"Gibson, Josh",18,13,6,5,0,0,0,0
Hawthorn,"Guerra, Brent",20,18,10,2,0,0,0,1
Hawthorn,"Gunston, Jack",18,11,5,7,3,3,0,1
Hawthorn,"Hodge, Luke",16,9,6,7,5,0,0,1
Hawthorn,"Lewis, Jordan",18,13,6,5,1,1,2,0
Hawthorn,"Mitchell, Sam",29,13,2,16,0,0,0,8
Hawthorn,"Puopolo, Paul",16,8,5,8,1,1,0,2
Hawthorn,"Rioli, Cyril",21,16,6,5,2,2,0,9
Hawthorn,"Roughead, Jarryd",18,13,4,5,3,0,8,0
Hawthorn,"Savage, Shane",1,1,1,0,0,0,0,1
Hawthorn,"Schoenmakers, Ryan",13,7,4,6,0,0,0,0
Hawthorn,"Sewell, Brad",21,13,3,8,0,1,0,3
Hawthorn,"Shiels, Liam",24,12,5,12,1,0,1,1
Hawthorn,"Smith, Isaac",22,17,5,5,2,1,0,3
Hawthorn,"Stratton, Ben",13,9,6,4,0,0,0,2
Hawthorn,"Suckling, Matt",22,18,8,4,4,0,0,1
Hawthorn,"Whitecross, Brendan",29,16,15,13,1,0,0,2
Hawthorn,"Young, Clinton",17,15,6,2,2,1,0,2
Hawthorn,"Birchall, Grant",18,10,5,8,0,0,0,2
Hawthorn,"Breust, Luke",11,5,1,6,2,1,0,11
Hawthorn,"Burgoyne, Shaun",20,10,3,10,2,0,0,4
Hawthorn,"Gibson, Josh",9,4,1,5,0,0,0,2
Hawthorn,"Guerra, Brent",15,10,5,5,0,0,0,2
Hawthorn,"Gunston, Jack",14,9,4,5,4,0,0,2
Hawthorn,"Hale, David",17,8,2,9,1,1,32,4
Hawthorn,"Hodge, Luke",9,6,3,3,0,1,3,1
Hawthorn,"Lewis, Jordan",16,10,1,6,1,1,1,4
Hawthorn,"Mitchell, Sam",24,8,4,16,0,0,0,5
Hawthorn,"Puopolo, Paul",11,8,1,3,2,1,0,3
Hawthorn,"Rioli, Cyril",18,13,2,5,2,2,0,6
Hawthorn,"Roughead, Jarryd",21,10,3,11,1,0,17,2
Hawthorn,"Savage, Shane",4,3,1,1,0,0,0,2
Hawthorn,"Schoenmakers, Ryan",6,3,2,3,0,0,0,4
Hawthorn,"Sewell, Brad",26,13,1,13,1,0,0,2
Hawthorn,"Shiels, Liam",15,11,2,4,0,0,0,9
Hawthorn,"Smith, Isaac",12,9,5,3,0,1,3,6
Hawthorn,"Stratton, Ben",9,8,3,1,0,0,0,2
Hawthorn,"Suckling, Matt",13,7,4,6,0,1,0,2
Hawthorn,"Whitecross, Brendan",19,14,4,5,1,0,0,3
Hawthorn,"Young, Clinton",21,16,7,5,0,1,0,1
Hawthorn,"Bailey, Max",6,2,1,4,0,0,26,6
Hawthorn,"Birchall, Grant",32,18,12,14,0,0,0,2
Hawthorn,"Breust, Luke",15,7,3,8,3,0,0,1
Hawthorn,"Burgoyne, Shaun",16,7,2,9,0,0,0,2
Hawthorn,"Ellis, Xavier",17,9,5,8,2,0,0,3
Hawthorn,"Gibson, Josh",11,8,5,3,0,0,0,1
Hawthorn,"Gilham, Stephen",15,8,4,7,1,0,0,3
Hawthorn,"Guerra, Brent",19,9,6,10,1,0,0,2
Hawthorn,"Gunston, Jack",14,7,4,7,1,1,0,0
Hawthorn,"Hale, David",13,9,8,4,4,3,10,2
Hawthorn,"Hodge, Luke",17,13,5,4,1,0,0,1
Hawthorn,"Lewis, Jordan",26,15,7,11,1,3,1,6
Hawthorn,"Mitchell, Sam",29,13,4,16,0,1,0,5
Hawthorn,"Puopolo, Paul",21,12,4,9,5,2,0,2
Hawthorn,"Rioli, Cyril",7,5,2,2,1,0,0,1
Hawthorn,"Schoenmakers, Ryan",21,15,9,6,0,1,0,0
Hawthorn,"Sewell, Brad",21,8,2,13,0,1,0,8
Hawthorn,"Smith, Isaac",21,11,8,10,2,0,0,1
Hawthorn,"Stratton, Ben",10,8,7,2,0,0,0,3
Hawthorn,"Suckling, Matt",14,8,4,6,1,0,0,0
Hawthorn,"Whitecross, Brendan",17,9,5,8,0,1,0,4
Hawthorn,"Young, Clinton",23,18,5,5,1,1,0,4
Hawthorn,"Bateman, Chance",8,5,0,3,0,0,0,0
Hawthorn,"Birchall, Grant",25,13,3,12,0,0,0,3
Hawthorn,"Breust, Luke",19,11,5,8,1,3,0,5
Hawthorn,"Burgoyne, Shaun",14,8,4,6,0,0,0,2
Hawthorn,"Ellis, Xavier",24,10,6,14,2,0,1,2
Hawthorn,"Gilham, Stephen",10,4,4,6,0,0,0,2
Hawthorn,"Guerra, Brent",19,8,5,11,0,0,0,0
Hawthorn,"Gunston, Jack",17,10,9,7,4,1,0,2
Hawthorn,"Hale, David",23,11,7,12,1,0,30,6
Hawthorn,"Hodge, Luke",35,15,4,20,0,2,0,4
Hawthorn,"Lewis, Jordan",27,14,5,13,1,1,2,2
Hawthorn,"Puopolo, Paul",16,8,2,8,1,2,0,4
Hawthorn,"Roughead, Jarryd",29,16,5,13,2,1,16,2
Hawthorn,"Savage, Shane",17,7,3,10,2,1,0,5
Hawthorn,"Schoenmakers, Ryan",13,7,3,6,2,0,1,2
Hawthorn,"Sewell, Brad",35,15,4,20,0,0,0,4
Hawthorn,"Shiels, Liam",26,9,6,17,1,0,0,1
Hawthorn,"Smith, Isaac",24,11,3,13,2,1,1,3
Hawthorn,"Stratton, Ben",16,6,4,10,0,0,0,1
Hawthorn,"Suckling, Matt",19,11,4,8,0,0,0,3
Hawthorn,"Whitecross, Brendan",16,11,4,5,0,0,0,4
Hawthorn,"Young, Clinton",22,16,8,6,0,0,0,5
Hawthorn,"Birchall, Grant",17,13,5,4,0,0,0,2
Hawthorn,"Breust, Luke",12,4,1,8,0,1,0,6
Hawthorn,"Burgoyne, Shaun",26,8,7,18,3,0,0,2
Hawthorn,"Ellis, Xavier",3,2,1,1,0,0,0,1
Hawthorn,"Franklin, Lance",14,10,4,4,4,3,1,0
Hawthorn,"Gibson, Josh",4,1,1,3,0,0,0,2
Hawthorn,"Guerra, Brent",19,15,5,4,0,0,0,3
Hawthorn,"Gunston, Jack",9,5,3,4,1,2,0,3
Hawthorn,"Hale, David",11,2,1,9,0,0,33,1
Hawthorn,"Hodge, Luke",22,17,5,5,0,0,2,2
Hawthorn,"Lewis, Jordan",28,14,4,14,0,2,3,6
Hawthorn,"Mitchell, Sam",17,10,1,7,0,0,0,3
Hawthorn,"Puopolo, Paul",12,5,0,7,2,0,0,0
Hawthorn,"Roughead, Jarryd",13,4,1,9,0,2,9,3
Hawthorn,"Schoenmakers, Ryan",22,16,6,6,0,0,0,1
Hawthorn,"Sewell, Brad",26,19,2,7,1,0,0,5
Hawthorn,"Shiels, Liam",13,10,1,3,1,0,0,3
Hawthorn,"Smith, Isaac",12,7,4,5,1,0,1,6
Hawthorn,"Stratton, Ben",8,5,2,3,0,0,0,1
Hawthorn,"Suckling, Matt",14,9,5,5,2,0,0,3
Hawthorn,"Whitecross, Brendan",15,11,4,4,0,2,1,0
Hawthorn,"Young, Clinton",18,11,4,7,0,0,0,3
Hawthorn,"Birchall, Grant",29,19,3,10,0,0,0,0
Hawthorn,"Breust, Luke",16,9,2,7,1,0,0,6
Hawthorn,"Burgoyne, Shaun",16,10,3,6,1,1,0,2
Hawthorn,"Franklin, Lance",14,9,5,5,4,1,0,1
Hawthorn,"Gibson, Josh",16,10,5,6,0,0,0,4
Hawthorn,"Guerra, Brent",12,7,5,5,0,0,0,1
Hawthorn,"Gunston, Jack",7,3,2,4,3,0,0,2
Hawthorn,"Hale, David",12,6,3,6,1,2,12,1
Hawthorn,"Hodge, Luke",22,15,4,7,1,1,1,1
Hawthorn,"Lewis, Jordan",17,8,4,9,0,2,1,2
Hawthorn,"Mitchell, Sam",28,14,7,14,0,0,0,4
Hawthorn,"Puopolo, Paul",9,4,2,5,1,1,0,5
Hawthorn,"Rioli, Cyril",11,5,1,6,1,1,0,2
Hawthorn,"Roughead, Jarryd",18,9,7,9,0,1,3,2
Hawthorn,"Schoenmakers, Ryan",16,12,8,4,0,0,0,4
Hawthorn,"Sewell, Brad",26,13,3,13,0,0,0,3
Hawthorn,"Shiels, Liam",7,6,1,1,0,1,0,3
Hawthorn,"Smith, Isaac",18,11,5,7,1,0,0,4
Hawthorn,"Stratton, Ben",11,7,3,4,0,0,0,4
Hawthorn,"Suckling, Matt",24,15,5,9,0,0,0,1
Hawthorn,"Whitecross, Brendan",17,14,4,3,0,0,2,2
Hawthorn,"Young, Clinton",20,13,4,7,0,0,0,6
Hawthorn,"Birchall, Grant",11,9,0,2,0,0,0,1
Hawthorn,"Breust, Luke",19,8,2,11,2,0,0,7
Hawthorn,"Burgoyne, Shaun",14,9,3,5,0,0,0,2
Hawthorn,"Ellis, Xavier",17,11,2,6,1,0,0,1
Hawthorn,"Franklin, Lance",18,11,7,7,4,3,0,3
Hawthorn,"Gibson, Josh",20,9,5,11,0,0,0,0
Hawthorn,"Gunston, Jack",16,15,3,1,2,3,0,1
Hawthorn,"Hale, David",10,3,1,7,2,0,22,3
Hawthorn,"Hodge, Luke",15,11,5,4,2,2,0,4
Hawthorn,"Mitchell, Sam",31,18,1,13,0,0,0,6
Hawthorn,"Murphy, Tom",16,7,3,9,0,0,0,2
Hawthorn,"Puopolo, Paul",9,5,1,4,1,2,0,7
Hawthorn,"Rioli, Cyril",13,9,5,4,2,2,1,4
Hawthorn,"Roughead, Jarryd",15,2,0,13,1,0,11,2
Hawthorn,"Savage, Shane",14,9,3,5,2,0,0,3
Hawthorn,"Schoenmakers, Ryan",14,7,3,7,0,0,0,1
Hawthorn,"Sewell, Brad",32,17,3,15,0,1,0,6
Hawthorn,"Shiels, Liam",22,14,0,8,0,1,0,7
Hawthorn,"Smith, Isaac",18,12,4,6,1,1,1,7
Hawthorn,"Stratton, Ben",9,4,1,5,0,0,0,5
Hawthorn,"Suckling, Matt",18,11,4,7,0,0,0,0
Hawthorn,"Whitecross, Brendan",1,1,0,0,0,0,0,0
Hawthorn,"Birchall, Grant",21,15,6,6,0,1,0,1
Hawthorn,"Breust, Luke",23,12,5,11,2,3,0,2
Hawthorn,"Burgoyne, Shaun",15,12,2,3,1,1,0,1
Hawthorn,"Ellis, Xavier",7,3,0,4,0,0,1,0
Hawthorn,"Franklin, Lance",20,11,4,9,3,5,0,4
Hawthorn,"Gibson, Josh",15,9,7,6,0,0,0,0
Hawthorn,"Gunston, Jack",17,8,3,9,2,0,0,0
Hawthorn,"Hale, David",11,3,2,8,0,0,17,1
Hawthorn,"Lewis, Jordan",23,11,8,12,0,0,3,6
Hawthorn,"Mitchell, Sam",29,15,1,14,0,0,0,6
Hawthorn,"Murphy, Tom",13,9,4,4,0,0,0,2
Hawthorn,"Puopolo, Paul",6,1,2,5,0,0,0,1
Hawthorn,"Rioli, Cyril",26,17,8,9,2,3,0,5
Hawthorn,"Roughead, Jarryd",15,7,4,8,0,2,11,5
Hawthorn,"Savage, Shane",3,3,1,0,0,0,0,1
Hawthorn,"Schoenmakers, Ryan",6,5,4,1,0,0,0,4
Hawthorn,"Sewell, Brad",28,16,3,12,0,0,0,1
Hawthorn,"Shiels, Liam",18,10,4,8,1,0,1,6
Hawthorn,"Smith, Isaac",19,7,8,12,0,0,0,6
Hawthorn,"Stratton, Ben",10,8,3,2,0,0,0,3
Hawthorn,"Suckling, Matt",13,10,4,3,1,0,0,1
Hawthorn,"Young, Clinton",19,15,5,4,1,1,0,4
Hawthorn,"Birchall, Grant",14,10,4,4,0,0,0,0
Hawthorn,"Breust, Luke",14,7,1,7,2,0,0,8
Hawthorn,"Burgoyne, Shaun",21,11,2,10,0,0,0,10
Hawthorn,"Ellis, Xavier",11,9,0,2,1,0,0,1
Hawthorn,"Franklin, Lance",24,14,8,10,3,4,1,6
Hawthorn,"Gibson, Josh",11,3,3,8,0,0,0,3
Hawthorn,"Gunston, Jack",8,6,4,2,2,1,0,3
Hawthorn,"Hale, David",12,6,3,6,2,2,30,2
Hawthorn,"Hodge, Luke",17,13,3,4,0,0,2,1
Hawthorn,"Lewis, Jordan",20,7,1,13,0,0,8,7
Hawthorn,"Mitchell, Sam",24,9,1,15,0,0,0,5
Hawthorn,"Puopolo, Paul",6,4,0,2,0,0,0,7
Hawthorn,"Rioli, Cyril",14,4,4,10,0,0,0,4
Hawthorn,"Roughead, Jarryd",14,9,3,5,0,3,18,0
Hawthorn,"Savage, Shane",4,4,1,0,0,0,0,2
Hawthorn,"Schoenmakers, Ryan",12,7,2,5,0,0,0,1
Hawthorn,"Sewell, Brad",33,16,4,17,0,2,1,11
Hawthorn,"Shiels, Liam",18,13,2,5,0,0,0,3
Hawthorn,"Smith, Isaac",15,10,1,5,1,0,0,3
Hawthorn,"Stratton, Ben",9,5,1,4,0,0,0,3
Hawthorn,"Suckling, Matt",16,14,5,2,0,1,0,1
Hawthorn,"Young, Clinton",19,13,3,6,0,0,0,3
Melbourne,"Bail, Rohan",12,5,0,7,0,0,0,6
Melbourne,"Bartram, Clint",15,8,3,7,0,0,0,1
Melbourne,"Bate, Matthew",10,6,2,4,0,1,0,0
Melbourne,"Blease, Sam",5,3,1,2,0,3,0,0
Melbourne,"Clark, Mitch",10,9,4,1,2,1,0,2
Melbourne,"Davey, Aaron",11,6,0,5,1,1,0,5
Melbourne,"Frawley, James",17,13,4,4,0,0,0,2
Melbourne,"Garland, Colin",12,12,3,0,0,0,0,2
Melbourne,"Green, Brad",14,11,5,3,1,0,0,1
Melbourne,"Grimes, Jack",15,11,3,4,0,0,0,4
Melbourne,"Howe, Jeremy",10,8,5,2,2,1,0,2
Melbourne,"Jamar, Mark",12,6,3,6,0,1,27,4
Melbourne,"Jones, Nathan",20,13,4,7,0,1,0,4
Melbourne,"Macdonald, Joel",19,13,3,6,0,0,0,2
Melbourne,"Magner, James",23,13,4,10,2,0,0,4
Melbourne,"Martin, Stefan",8,5,5,3,1,0,11,4
Melbourne,"McKenzie, Jordie",16,12,1,4,0,0,0,6
Melbourne,"Moloney, Brent",13,7,0,6,0,0,0,2
Melbourne,"Rivers, Jared",7,3,2,4,0,0,0,3
Melbourne,"Trengove, Jack",17,11,6,6,1,1,0,8
Melbourne,"Tynan, Josh",14,11,2,3,0,0,0,1
Melbourne,"Watts, Jack",18,12,5,6,1,0,0,3
Melbourne,"Bail, Rohan",12,7,4,5,0,0,0,1
Melbourne,"Bartram, Clint",11,8,6,3,0,0,0,2
Melbourne,"Bate, Matthew",14,10,4,4,0,1,0,1
Melbourne,"Bennell, Jamie",3,1,1,2,0,0,0,1
Melbourne,"Clark, Mitch",12,7,0,5,5,0,0,0
Melbourne,"Dunn, Lynden",10,10,6,0,2,1,0,1
Melbourne,"Frawley, James",16,11,4,5,0,0,0,0
Melbourne,"Garland, Colin",11,8,5,3,0,0,0,2
Melbourne,"Green, Brad",11,5,1,6,0,1,0,3
Melbourne,"Grimes, Jack",18,13,5,5,0,0,0,1
Melbourne,"Howe, Jeremy",19,14,5,5,0,0,0,4
Melbourne,"Jamar, Mark",4,1,2,3,0,0,27,1
Melbourne,"Jones, Nathan",27,13,2,14,2,0,0,3
Melbourne,"Macdonald, Joel",13,7,3,6,0,0,0,3
Melbourne,"Magner, James",32,18,4,14,0,0,0,3
Melbourne,"McDonald, Tom",17,7,4,10,0,0,0,1
Melbourne,"McKenzie, Jordie",16,11,1,5,0,0,0,4
Melbourne,"Petterd, Ricky",9,6,4,3,0,0,0,4
Melbourne,"Rivers, Jared",13,9,5,4,0,0,0,2
Melbourne,"Sellar, James",10,3,3,7,0,0,4,1
Melbourne,"Trengove, Jack",21,11,2,10,0,0,0,2
Melbourne,"Watts, Jack",14,4,4,10,0,0,0,1
Melbourne,"Bail, Rohan",8,4,2,4,0,0,0,3
Melbourne,"Bartram, Clint",10,8,3,2,0,0,0,3
Melbourne,"Bate, Matthew",12,9,4,3,0,1,0,3
Melbourne,"Clark, Mitch",8,8,5,0,2,3,0,1
Melbourne,"Davey, Aaron",10,5,3,5,0,0,0,4
Melbourne,"Dunn, Lynden",7,5,2,2,2,0,0,0
Melbourne,"Frawley, James",13,11,2,2,0,0,0,5
Melbourne,"Garland, Colin",10,9,4,1,0,0,0,6
Melbourne,"Grimes, Jack",14,8,5,6,0,0,0,4
Melbourne,"Howe, Jeremy",24,20,12,4,2,1,0,3
Melbourne,"Jamar, Mark",12,6,4,6,0,1,34,1
Melbourne,"Jones, Nathan",17,12,3,5,1,0,0,3
Melbourne,"Magner, James",9,7,4,2,0,0,0,4
Melbourne,"Martin, Stefan",7,1,2,6,0,1,1,0
Melbourne,"McDonald, Tom",13,6,6,7,0,0,0,1
Melbourne,"McKenzie, Jordie",17,9,0,8,0,0,0,5
Melbourne,"Morton, Cale",17,8,5,9,0,0,0,1
Melbourne,"Rivers, Jared",12,6,7,6,0,0,0,1
Melbourne,"Sellar, James",9,6,4,3,1,1,4,2
Melbourne,"Tapscott, Luke",8,4,2,4,0,0,0,4
Melbourne,"Trengove, Jack",16,10,4,6,2,0,0,2
Melbourne,"Watts, Jack",15,10,9,5,1,0,0,1
Melbourne,"Bail, Rohan",19,8,4,11,1,0,0,3
Melbourne,"Bartram, Clint",11,6,3,5,0,0,0,6
Melbourne,"Bate, Matthew",20,14,6,6,2,1,0,4
Melbourne,"Clark, Mitch",7,7,5,0,1,2,1,1
Melbourne,"Davey, Aaron",9,6,1,3,2,0,0,5
Melbourne,"Dunn, Lynden",4,3,1,1,0,1,0,2
Melbourne,"Frawley, James",16,11,5,5,0,0,0,5
Melbourne,"Garland, Colin",10,8,0,2,0,1,0,3
Melbourne,"Howe, Jeremy",12,8,3,4,0,2,1,1
Melbourne,"Jamar, Mark",8,3,2,5,0,0,46,1
Melbourne,"Jones, Nathan",22,10,1,12,0,0,0,5
Melbourne,"Macdonald, Joel",16,7,3,9,0,0,0,3
Melbourne,"Magner, James",12,9,3,3,0,0,1,6
Melbourne,"McDonald, Tom",11,5,3,6,0,0,1,1
Melbourne,"McKenzie, Jordie",14,9,1,5,0,0,0,7
Melbourne,"Moloney, Brent",17,10,0,7,1,2,0,4
Melbourne,"Morton, Cale",21,14,4,7,1,0,1,6
Melbourne,"Rivers, Jared",15,13,7,2,0,0,0,0
Melbourne,"Sellar, James",4,3,1,1,0,1,5,2
Melbourne,"Tapscott, Luke",3,1,0,2,0,0,0,2
Melbourne,"Trengove, Jack",13,7,1,6,0,1,2,3
Melbourne,"Watts, Jack",12,8,6,4,1,1,0,3
Melbourne,"Bail, Rohan",13,6,2,7,2,0,0,4
Melbourne,"Bartram, Clint",14,6,2,8,1,0,0,5
Melbourne,"Bate, Matthew",18,13,7,5,1,0,0,4
Melbourne,"Davey, Aaron",13,6,0,7,1,1,0,5
Melbourne,"Dunn, Lynden",12,8,2,4,1,0,0,1
Melbourne,"Garland, Colin",11,7,3,4,0,1,0,6
Melbourne,"Grimes, Jack",27,16,4,11,0,0,0,7
Melbourne,"Howe, Jeremy",17,9,3,8,0,1,0,2
Melbourne,"Jamar, Mark",9,7,0,2,0,0,55,2
Melbourne,"Jones, Nathan",27,16,0,11,2,1,0,6
Melbourne,"Macdonald, Joel",16,9,4,7,0,0,0,6
Melbourne,"Magner, James",20,10,1,10,0,0,0,8
Melbourne,"McDonald, Tom",19,9,3,10,0,0,0,5
Melbourne,"McKenzie, Jordie",14,7,1,7,0,0,0,8
Melbourne,"Moloney, Brent",22,16,4,6,1,1,0,4
Melbourne,"Morton, Cale",22,16,2,6,0,0,3,5
Melbourne,"Rivers, Jared",15,12,4,3,0,0,0,2
Melbourne,"Sellar, James",8,2,0,6,0,0,9,2
Melbourne,"Sylvia, Colin",6,4,1,2,0,0,0,6
Melbourne,"Tapscott, Luke",8,7,2,1,0,0,0,5
Melbourne,"Trengove, Jack",15,9,0,6,0,0,1,9
Melbourne,"Watts, Jack",12,7,2,5,1,0,1,0
Melbourne,"Bail, Rohan",7,3,1,4,0,0,0,1
Melbourne,"Bartram, Clint",17,9,5,8,0,0,0,6
Melbourne,"Bate, Matthew",11,6,4,5,2,0,1,2
Melbourne,"Clark, Mitch",21,16,8,5,4,2,2,1
Melbourne,"Davey, Aaron",11,7,1,4,1,0,0,3
Melbourne,"Dunn, Lynden",5,5,0,0,1,1,0,1
Melbourne,"Frawley, James",19,17,7,2,0,0,3,4
Melbourne,"Garland, Colin",15,11,7,4,0,0,0,6
Melbourne,"Grimes, Jack",24,11,4,13,0,0,0,1
Melbourne,"Howe, Jeremy",17,10,6,7,1,2,0,1
Melbourne,"Jamar, Mark",10,3,4,7,0,0,40,1
Melbourne,"Jones, Nathan",19,15,5,4,2,1,0,4
Melbourne,"Magner, James",13,7,5,6,0,1,0,4
Melbourne,"McDonald, Tom",15,11,5,4,0,0,0,0
Melbourne,"McKenzie, Jordie",13,6,0,7,0,0,0,7
Melbourne,"Moloney, Brent",18,10,2,8,0,0,0,3
Melbourne,"Morton, Cale",20,10,2,10,0,2,1,3
Melbourne,"Rivers, Jared",13,6,3,7,0,0,0,1
Melbourne,"Sellar, James",4,3,0,1,0,0,5,1
Melbourne,"Sylvia, Colin",13,8,2,5,0,0,0,1
Melbourne,"Tapscott, Luke",14,9,4,5,0,0,0,3
Melbourne,"Trengove, Jack",21,7,6,14,0,0,0,2
Melbourne,"Bail, Rohan",11,8,3,3,0,0,0,0
Melbourne,"Bartram, Clint",16,13,10,3,0,0,0,4
Melbourne,"Bate, Matthew",4,1,1,3,0,1,0,1
Melbourne,"Bennell, Jamie",4,2,0,2,0,1,0,5
Melbourne,"Clark, Mitch",13,11,9,2,3,2,8,4
Melbourne,"Davey, Aaron",12,11,4,1,0,0,0,6
Melbourne,"Fitzpatrick, Jack",3,1,0,2,0,0,2,3
Melbourne,"Frawley, James",16,13,7,3,0,0,0,2
Melbourne,"Garland, Colin",12,9,3,3,0,0,0,2
Melbourne,"Grimes, Jack",18,15,9,3,0,0,0,2
Melbourne,"Howe, Jeremy",12,11,7,1,1,1,0,3
Melbourne,"Jamar, Mark",11,10,4,1,0,1,18,1
Melbourne,"Jones, Nathan",21,11,2,10,0,0,0,4
Melbourne,"Magner, James",17,11,8,6,1,0,0,2
Melbourne,"McDonald, Tom",15,6,4,9,0,0,0,1
Melbourne,"McKenzie, Jordie",14,10,4,4,1,1,0,5
Melbourne,"Moloney, Brent",16,9,4,7,0,1,0,8
Melbourne,"Morton, Cale",16,11,8,5,0,0,1,1
Melbourne,"Petterd, Ricky",5,3,2,2,0,1,0,1
Melbourne,"Rivers, Jared",7,7,4,0,0,0,1,1
Melbourne,"Sylvia, Colin",6,4,1,2,0,0,0,1
Melbourne,"Trengove, Jack",10,5,2,5,0,0,1,10
Melbourne,"Bartram, Clint",16,10,8,6,0,0,0,2
Melbourne,"Bennell, Jamie",4,3,4,1,1,0,0,0
Melbourne,"Blease, Sam",29,18,3,11,0,0,0,1
Melbourne,"Clark, Mitch",16,13,6,3,0,1,14,3
Melbourne,"Davey, Aaron",5,3,1,2,0,1,0,4
Melbourne,"Frawley, James",22,15,7,7,0,0,0,1
Melbourne,"Garland, Colin",20,15,10,5,0,0,0,5
Melbourne,"Green, Brad",9,6,3,3,1,0,0,4
Melbourne,"Grimes, Jack",23,17,9,6,0,0,0,1
Melbourne,"Howe, Jeremy",11,6,5,5,0,2,1,1
Melbourne,"Jamar, Mark",7,4,3,3,0,0,46,0
Melbourne,"Jones, Nathan",22,12,3,10,2,1,0,4
Melbourne,"Jurrah, Liam",12,5,3,7,0,0,0,1
Melbourne,"Magner, James",14,7,4,7,0,1,0,7
Melbourne,"McDonald, Tom",14,5,5,9,0,0,0,2
Melbourne,"McKenzie, Jordie",13,6,2,7,0,0,0,4
Melbourne,"Moloney, Brent",19,7,2,12,0,0,0,3
Melbourne,"Morton, Cale",13,5,2,8,0,0,0,0
Melbourne,"Rivers, Jared",19,11,10,8,0,0,0,1
Melbourne,"Sylvia, Colin",17,11,5,6,1,0,0,1
Melbourne,"Trengove, Jack",14,6,1,8,0,0,1,5
Melbourne,"Watts, Jack",34,18,11,16,0,0,0,1
Melbourne,"Bail, Rohan",24,14,5,10,0,0,0,3
Melbourne,"Bennell, Jamie",6,5,2,1,0,1,0,2
Melbourne,"Blease, Sam",17,15,5,2,1,1,0,2
Melbourne,"Clark, Mitch",12,8,3,4,3,4,0,1
Melbourne,"Dunn, Lynden",14,13,4,1,0,1,0,3
Melbourne,"Frawley, James",23,20,10,3,0,1,0,4
Melbourne,"Garland, Colin",16,9,5,7,0,0,0,5
Melbourne,"Green, Brad",1,1,0,0,0,1,0,0
Melbourne,"Grimes, Jack",24,15,4,9,0,1,0,4
Melbourne,"Howe, Jeremy",9,5,4,4,1,1,0,4
Melbourne,"Jamar, Mark",5,2,0,3,0,1,39,6
Melbourne,"Jones, Nathan",27,12,5,15,1,0,0,5
Melbourne,"Magner, James",15,9,1,6,0,0,0,4
Melbourne,"McDonald, Tom",19,7,7,12,0,0,0,3
Melbourne,"McKenzie, Jordie",17,7,3,10,0,0,0,10
Melbourne,"Moloney, Brent",13,4,1,9,0,0,1,2
Melbourne,"Nicholson, Daniel",22,13,9,9,0,0,0,1
Melbourne,"Rivers, Jared",22,13,6,9,0,0,0,3
Melbourne,"Sellar, James",7,2,3,5,0,0,3,1
Melbourne,"Tapscott, Luke",10,7,5,3,0,1,0,5
Melbourne,"Trengove, Jack",14,7,4,7,0,0,2,4
Melbourne,"Watts, Jack",23,12,5,11,0,0,1,2
Melbourne,"Blease, Sam",12,6,1,6,0,0,0,0
Melbourne,"Clark, Mitch",13,7,1,6,1,1,7,6
Melbourne,"Dunn, Lynden",7,4,0,3,0,0,1,7
Melbourne,"Garland, Colin",20,15,11,5,2,2,0,2
Melbourne,"Green, Brad",10,5,2,5,0,0,0,2
Melbourne,"Grimes, Jack",26,21,5,5,0,0,0,2
Melbourne,"Howe, Jeremy",24,14,6,10,1,0,0,4
Melbourne,"Jamar, Mark",14,4,3,10,0,0,23,1
Melbourne,"Jones, Nathan",26,15,2,11,1,0,0,9
Melbourne,"Macdonald, Joel",15,10,2,5,0,0,0,5
Melbourne,"Magner, James",15,8,3,7,0,1,0,6
Melbourne,"McDonald, Tom",14,6,4,8,0,0,0,3
Melbourne,"McKenzie, Jordie",12,6,1,6,0,0,0,5
Melbourne,"Moloney, Brent",23,14,2,9,1,0,0,6
Melbourne,"Morton, Cale",17,13,8,4,1,1,0,3
Melbourne,"Nicholson, Daniel",22,10,6,12,0,1,0,3
Melbourne,"Rivers, Jared",20,14,6,6,0,0,0,6
Melbourne,"Sellar, James",18,8,6,10,0,0,0,2
Melbourne,"Sylvia, Colin",12,7,3,5,1,2,0,2
Melbourne,"Tapscott, Luke",16,13,7,3,0,0,0,3
Melbourne,"Trengove, Jack",22,10,4,12,0,1,2,3
Melbourne,"Watts, Jack",24,15,7,9,0,0,0,4
Melbourne,"Blease, Sam",11,8,3,3,1,0,0,2
Melbourne,"Clark, Mitch",16,12,9,4,4,1,8,2
Melbourne,"Dunn, Lynden",7,4,2,3,2,1,0,0
Melbourne,"Frawley, James",11,7,6,4,0,0,0,6
Melbourne,"Garland, Colin",11,9,3,2,0,1,0,3
Melbourne,"Green, Brad",7,6,6,1,0,3,0,1
Melbourne,"Grimes, Jack",25,21,7,4,0,0,0,5
Melbourne,"Howe, Jeremy",18,10,7,8,2,0,0,3
Melbourne,"Jamar, Mark",9,2,0,7,0,0,28,2
Melbourne,"Jones, Nathan",31,16,1,15,0,0,0,2
Melbourne,"Magner, James",9,7,3,2,1,0,0,2
Melbourne,"McDonald, Tom",12,7,4,5,0,0,0,4
Melbourne,"McKenzie, Jordie",18,6,1,12,0,0,0,6
Melbourne,"Moloney, Brent",14,9,2,5,0,0,1,2
Melbourne,"Morton, Cale",19,11,4,8,0,0,0,1
Melbourne,"Nicholson, Daniel",12,5,6,7,0,0,0,2
Melbourne,"Rivers, Jared",8,4,2,4,1,0,0,4
Melbourne,"Sellar, James",12,9,5,3,0,0,0,0
Melbourne,"Sylvia, Colin",10,4,4,6,1,1,0,3
Melbourne,"Tapscott, Luke",13,6,2,7,0,0,0,3
Melbourne,"Trengove, Jack",17,7,5,10,1,1,1,6
Melbourne,"Watts, Jack",18,11,5,7,0,0,0,1
Melbourne,"Bate, Matthew",28,19,8,9,1,1,0,1
Melbourne,"Blease, Sam",7,4,0,3,1,0,0,1
Melbourne,"Clark, Mitch",11,10,3,1,4,1,1,0
Melbourne,"Davey, Aaron",13,7,3,6,2,0,0,5
Melbourne,"Dunn, Lynden",21,11,7,10,0,1,0,5
Melbourne,"Frawley, James",16,13,5,3,0,0,0,2
Melbourne,"Garland, Colin",10,8,6,2,3,0,0,5
Melbourne,"Grimes, Jack",26,16,4,10,0,1,0,3
Melbourne,"Howe, Jeremy",19,11,7,8,1,2,1,4
Melbourne,"Jamar, Mark",10,4,3,6,1,0,35,0
Melbourne,"Jones, Nathan",33,17,1,16,0,2,0,3
Melbourne,"Macdonald, Joel",16,9,6,7,0,0,0,5
Melbourne,"Magner, James",16,9,2,7,0,0,0,7
Melbourne,"McDonald, Tom",26,6,4,20,0,0,0,3
Melbourne,"McKenzie, Jordie",21,11,1,10,0,0,0,4
Melbourne,"Moloney, Brent",16,5,2,11,0,0,0,5
Melbourne,"Nicholson, Daniel",22,13,4,9,0,0,0,4
Melbourne,"Rivers, Jared",15,6,7,9,4,1,0,2
Melbourne,"Sellar, James",15,6,4,9,0,0,3,1
Melbourne,"Sylvia, Colin",23,13,2,10,2,0,6,1
Melbourne,"Trengove, Jack",18,10,6,8,1,1,1,3
Melbourne,"Watts, Jack",27,15,7,12,0,0,0,1
Melbourne,"Bail, Rohan",9,5,3,4,1,1,0,2
Melbourne,"Bate, Matthew",12,9,10,3,1,0,0,2
Melbourne,"Blease, Sam",10,7,3,3,2,1,0,2
Melbourne,"Dunn, Lynden",15,11,3,4,0,0,0,1
Melbourne,"Frawley, James",11,10,3,1,0,0,0,0
Melbourne,"Garland, Colin",8,7,5,1,1,0,0,2
Melbourne,"Grimes, Jack",13,10,5,3,0,0,0,4
Melbourne,"Howe, Jeremy",21,12,7,9,1,0,1,4
Melbourne,"Macdonald, Joel",17,7,4,10,0,0,0,1
Melbourne,"Magner, James",15,7,2,8,0,1,0,4
Melbourne,"Martin, Stefan",21,14,7,7,0,0,20,2
Melbourne,"McDonald, Tom",1,1,0,0,0,0,0,0
Melbourne,"McKenzie, Jordie",21,10,3,11,1,0,0,5
Melbourne,"Moloney, Brent",16,10,1,6,0,0,0,3
Melbourne,"Nicholson, Daniel",20,13,4,7,0,0,0,2
Melbourne,"Rivers, Jared",10,8,3,2,0,3,4,1
Melbourne,"Sellar, James",11,9,2,2,0,0,0,3
Melbourne,"Spencer, Jake",6,3,2,3,0,0,17,3
Melbourne,"Sylvia, Colin",21,14,7,7,1,0,0,5
Melbourne,"Tapscott, Luke",17,9,2,8,0,1,0,0
Melbourne,"Trengove, Jack",19,11,4,8,0,2,0,4
Melbourne,"Watts, Jack",19,8,5,11,0,0,0,3
Melbourne,"Bail, Rohan",20,12,5,8,1,1,0,7
Melbourne,"Bate, Matthew",10,8,6,2,0,2,0,2
Melbourne,"Bennell, Jamie",8,4,4,4,1,0,0,3
Melbourne,"Blease, Sam",7,5,2,2,1,1,0,7
Melbourne,"Dunn, Lynden",22,15,7,7,0,0,0,5
Melbourne,"Frawley, James",20,15,10,5,0,0,0,2
Melbourne,"Garland, Colin",11,8,6,3,1,0,0,2
Melbourne,"Grimes, Jack",15,10,5,5,0,0,0,5
Melbourne,"Howe, Jeremy",16,12,6,4,0,2,0,3
Melbourne,"Jones, Nathan",25,11,2,14,1,0,0,6
Melbourne,"Macdonald, Joel",18,10,3,8,0,1,0,1
Melbourne,"Magner, James",3,2,1,1,0,1,0,1
Melbourne,"Martin, Stefan",18,13,6,5,2,0,20,0
Melbourne,"McKenzie, Jordie",20,8,3,12,1,0,0,6
Melbourne,"Moloney, Brent",6,4,0,2,0,0,0,3
Melbourne,"Nicholson, Daniel",18,16,8,2,0,0,0,6
Melbourne,"Rivers, Jared",8,3,4,5,1,1,0,1
Melbourne,"Spencer, Jake",8,3,1,5,0,0,11,2
Melbourne,"Sylvia, Colin",25,13,3,12,1,0,2,7
Melbourne,"Tapscott, Luke",9,5,3,4,1,0,0,0
Melbourne,"Trengove, Jack",14,10,6,4,0,0,0,6
Melbourne,"Watts, Jack",17,9,5,8,0,0,0,1
Melbourne,"Bail, Rohan",16,8,2,8,2,2,0,4
Melbourne,"Bate, Matthew",6,6,4,0,1,0,1,5
Melbourne,"Bennell, Jamie",6,4,2,2,1,0,0,1
Melbourne,"Blease, Sam",8,6,2,2,2,0,0,2
Melbourne,"Couch, Tom",13,5,1,8,0,0,0,9
Melbourne,"Frawley, James",11,8,4,3,0,0,0,1
Melbourne,"Garland, Colin",13,8,5,5,0,0,0,2
Melbourne,"Green, Brad",13,7,5,6,3,1,0,2
Melbourne,"Grimes, Jack",22,16,7,6,0,1,0,6
Melbourne,"Howe, Jeremy",13,10,4,3,0,1,3,4
Melbourne,"Jamar, Mark",1,1,0,0,0,0,7,0
Melbourne,"Jones, Nathan",20,10,1,10,0,0,0,6
Melbourne,"Macdonald, Joel",22,5,3,17,0,0,0,5
Melbourne,"Martin, Stefan",19,11,7,8,2,0,26,2
Melbourne,"McDonald, Tom",17,7,5,10,0,0,0,1
Melbourne,"McKenzie, Jordie",20,9,0,11,0,0,0,10
Melbourne,"Nicholson, Daniel",18,5,2,13,0,0,0,1
Melbourne,"Petterd, Ricky",14,8,3,6,0,2,1,2
Melbourne,"Rivers, Jared",10,9,3,1,0,2,0,4
Melbourne,"Strauss, James",10,7,3,3,0,0,0,4
Melbourne,"Sylvia, Colin",23,12,2,11,1,0,2,7
Melbourne,"Trengove, Jack",21,10,4,11,0,0,1,5
Melbourne,"Bail, Rohan",18,7,4,11,0,1,0,0
Melbourne,"Blease, Sam",17,12,4,5,1,1,0,4
Melbourne,"Couch, Tom",12,6,0,6,0,0,0,5
Melbourne,"Dunn, Lynden",19,13,6,6,0,0,0,3
Melbourne,"Frawley, James",12,10,3,2,0,0,1,3
Melbourne,"Garland, Colin",18,12,6,6,0,0,0,3
Melbourne,"Green, Brad",16,13,7,3,2,3,0,7
Melbourne,"Grimes, Jack",32,20,11,12,0,0,0,4
Melbourne,"Howe, Jeremy",9,6,3,3,0,1,1,2
Melbourne,"Jetta, Neville",18,11,4,7,0,0,0,3
Melbourne,"Jones, Nathan",26,13,2,13,1,0,0,5
Melbourne,"Macdonald, Joel",17,9,3,8,0,0,0,2
Melbourne,"Magner, James",12,5,4,7,0,0,0,5
Melbourne,"Martin, Stefan",12,7,3,5,1,0,11,1
Melbourne,"McDonald, Tom",22,14,5,8,0,0,0,2
Melbourne,"Nicholson, Daniel",22,17,6,5,0,0,0,3
Melbourne,"Petterd, Ricky",15,11,3,4,0,0,0,4
Melbourne,"Rivers, Jared",9,7,5,2,2,1,2,1
Melbourne,"Spencer, Jake",8,3,3,5,0,0,18,6
Melbourne,"Strauss, James",2,1,0,1,0,0,0,1
Melbourne,"Sylvia, Colin",20,14,2,6,1,0,1,6
Melbourne,"Trengove, Jack",19,7,4,12,0,0,0,3
Melbourne,"Bail, Rohan",16,11,4,5,0,3,0,4
Melbourne,"Blease, Sam",11,8,4,3,1,1,0,2
Melbourne,"Dunn, Lynden",11,6,2,5,0,0,0,3
Melbourne,"Frawley, James",14,9,6,5,0,0,0,2
Melbourne,"Garland, Colin",4,3,1,1,1,1,0,4
Melbourne,"Green, Brad",10,9,6,1,3,1,0,1
Melbourne,"Grimes, Jack",23,11,5,12,0,0,0,2
Melbourne,"Howe, Jeremy",20,13,6,7,1,0,1,4
Melbourne,"Jetta, Neville",7,4,4,3,0,0,0,1
Melbourne,"Jones, Nathan",32,14,4,18,1,0,0,4
Melbourne,"Macdonald, Joel",20,7,4,13,0,0,0,0
Melbourne,"Martin, Stefan",12,4,1,8,1,0,11,4
Melbourne,"McDonald, Tom",23,12,5,11,0,0,0,3
Melbourne,"McKenzie, Jordie",21,8,2,13,0,0,0,6
Melbourne,"Moloney, Brent",29,13,3,16,0,0,0,4
Melbourne,"Nicholson, Daniel",13,6,4,7,0,0,0,0
Melbourne,"Rivers, Jared",18,9,4,9,0,0,0,0
Melbourne,"Sellar, James",14,6,4,8,0,0,0,1
Melbourne,"Spencer, Jake",5,1,0,4,0,0,27,5
Melbourne,"Strauss, James",5,2,2,3,0,0,0,0
Melbourne,"Sylvia, Colin",12,10,7,2,3,1,0,6
Melbourne,"Trengove, Jack",17,8,5,9,0,0,1,6
Melbourne,"Bail, Rohan",15,7,5,8,1,3,1,6
Melbourne,"Blease, Sam",15,11,6,4,2,2,0,1
Melbourne,"Dunn, Lynden",22,13,6,9,0,0,0,4
Melbourne,"Frawley, James",17,10,5,7,0,0,0,1
Melbourne,"Garland, Colin",14,8,3,6,0,0,0,5
Melbourne,"Green, Brad",14,11,7,3,5,2,0,2
Melbourne,"Grimes, Jack",23,10,8,13,0,0,0,6
Melbourne,"Gysberts, Jordan",9,5,4,4,0,0,0,4
Melbourne,"Howe, Jeremy",23,14,8,9,1,0,0,2
Melbourne,"Jones, Nathan",29,12,2,17,0,0,0,5
Melbourne,"Macdonald, Joel",18,9,4,9,0,0,0,2
Melbourne,"Magner, James",10,4,2,6,0,0,0,4
Melbourne,"McDonald, Tom",23,15,5,8,0,0,0,5
Melbourne,"Moloney, Brent",24,13,3,11,0,1,0,1
Melbourne,"Morton, Cale",3,3,0,0,0,0,0,0
Melbourne,"Rivers, Jared",8,4,5,4,1,1,1,1
Melbourne,"Sellar, James",11,8,5,3,1,1,6,1
Melbourne,"Spencer, Jake",9,3,5,6,1,0,21,3
Melbourne,"Strauss, James",13,6,2,7,0,1,0,2
Melbourne,"Sylvia, Colin",24,12,6,12,2,0,2,3
Melbourne,"Tapscott, Luke",18,14,9,4,1,0,0,3
Melbourne,"Trengove, Jack",17,9,7,8,1,0,1,5
Melbourne,"Bail, Rohan",18,9,5,9,0,0,0,5
Melbourne,"Bate, Matthew",20,8,7,12,0,0,0,4
Melbourne,"Blease, Sam",20,12,8,8,5,0,0,3
Melbourne,"Dunn, Lynden",15,12,5,3,1,0,0,3
Melbourne,"Garland, Colin",20,14,5,6,0,0,0,1
Melbourne,"Green, Brad",10,8,4,2,1,1,0,0
Melbourne,"Grimes, Jack",29,19,5,10,0,1,0,3
Melbourne,"Howe, Jeremy",12,4,2,8,1,1,3,1
Melbourne,"Jetta, Neville",11,7,4,4,1,0,0,5
Melbourne,"Jones, Nathan",26,11,2,15,0,1,0,5
Melbourne,"Macdonald, Joel",27,10,7,17,0,0,0,4
Melbourne,"Magner, James",5,2,0,3,0,0,0,3
Melbourne,"McDonald, Tom",18,9,6,9,0,1,0,2
Melbourne,"McKenzie, Jordie",19,6,1,13,0,0,0,3
Melbourne,"Moloney, Brent",10,5,0,5,0,0,0,2
Melbourne,"Rivers, Jared",21,10,8,11,0,0,0,1
Melbourne,"Sellar, James",12,6,3,6,2,0,12,3
Melbourne,"Spencer, Jake",10,4,2,6,0,0,28,3
Melbourne,"Strauss, James",18,6,1,12,0,0,0,2
Melbourne,"Sylvia, Colin",12,2,1,10,1,0,0,8
Melbourne,"Tapscott, Luke",10,9,5,1,0,0,0,6
Melbourne,"Trengove, Jack",22,12,4,10,0,0,2,2
Melbourne,"Bail, Rohan",16,8,4,8,0,2,0,4
Melbourne,"Blease, Sam",8,6,1,2,0,1,0,2
Melbourne,"Couch, Tom",8,5,1,3,0,0,0,1
Melbourne,"Dunn, Lynden",28,16,10,12,0,0,0,3
Melbourne,"Frawley, James",17,7,2,10,0,0,0,2
Melbourne,"Garland, Colin",15,8,2,7,0,0,0,2
Melbourne,"Green, Brad",6,6,5,0,1,3,0,4
Melbourne,"Grimes, Jack",24,15,7,9,1,0,0,9
Melbourne,"Howe, Jeremy",17,11,6,6,3,3,1,7
Melbourne,"Jetta, Neville",8,6,3,2,0,0,0,2
Melbourne,"Jones, Nathan",24,9,0,15,0,2,0,3
Melbourne,"Macdonald, Joel",22,14,4,8,0,0,0,3
Melbourne,"McDonald, Tom",21,12,7,9,0,0,0,0
Melbourne,"McKenzie, Jordie",19,11,2,8,0,0,0,7
Melbourne,"Rivers, Jared",14,8,8,6,2,1,1,1
Melbourne,"Sellar, James",13,4,2,9,2,0,7,3
Melbourne,"Spencer, Jake",15,6,3,9,0,0,24,1
Melbourne,"Strauss, James",15,3,3,12,0,0,0,9
Melbourne,"Sylvia, Colin",22,11,5,11,0,1,0,3
Melbourne,"Tapscott, Luke",11,6,3,5,0,1,0,6
Melbourne,"Trengove, Jack",23,12,4,11,2,1,0,1
Melbourne,"Watts, Jack",15,7,5,8,0,0,0,0
Melbourne,"Bail, Rohan",22,12,6,10,0,2,0,2
Melbourne,"Blease, Sam",19,12,1,7,1,2,0,3
Melbourne,"Dunn, Lynden",17,11,3,6,0,0,0,2
Melbourne,"Frawley, James",14,9,4,5,0,0,0,2
Melbourne,"Garland, Colin",12,9,3,3,0,0,0,3
Melbourne,"Green, Brad",14,8,4,6,2,2,0,2
Melbourne,"Grimes, Jack",23,14,7,9,0,1,0,2
Melbourne,"Howe, Jeremy",14,13,8,1,1,3,1,3
Melbourne,"Jetta, Neville",7,4,3,3,0,0,0,0
Melbourne,"Jones, Nathan",25,13,1,12,1,0,0,4
Melbourne,"Macdonald, Joel",16,8,5,8,0,0,1,0
Melbourne,"McDonald, Tom",14,6,5,8,0,0,0,2
Melbourne,"McKenzie, Jordie",18,6,2,12,0,1,0,3
Melbourne,"Nicholson, Daniel",17,8,4,9,0,2,0,2
Melbourne,"Rivers, Jared",8,4,3,4,2,0,0,3
Melbourne,"Sellar, James",9,5,5,4,2,1,2,1
Melbourne,"Spencer, Jake",13,5,4,8,1,0,21,7
Melbourne,"Strauss, James",14,5,3,9,0,0,0,1
Melbourne,"Sylvia, Colin",34,16,4,18,0,0,0,2
Melbourne,"Tapscott, Luke",10,5,5,5,0,0,0,2
Melbourne,"Trengove, Jack",18,8,3,10,0,0,0,5
Melbourne,"Watts, Jack",18,7,2,11,1,0,0,2
Melbourne,"Bail, Rohan",16,6,2,10,0,0,0,3
Melbourne,"Blease, Sam",5,3,0,2,1,0,0,1
Melbourne,"Dunn, Lynden",10,4,3,6,0,0,0,2
Melbourne,"Fitzpatrick, Jack",8,5,1,3,2,0,0,0
Melbourne,"Frawley, James",10,6,2,4,0,0,0,1
Melbourne,"Garland, Colin",8,6,2,2,0,0,0,2
Melbourne,"Grimes, Jack",23,12,3,11,0,1,0,6
Melbourne,"Howe, Jeremy",12,6,2,6,0,1,2,6
Melbourne,"Jamar, Mark",4,1,2,3,0,0,28,3
Melbourne,"Jetta, Neville",9,7,3,2,0,0,0,4
Melbourne,"Jones, Nathan",17,10,2,7,1,1,0,5
Melbourne,"Macdonald, Joel",14,6,3,8,0,0,0,1
Melbourne,"McDonald, Tom",18,10,7,8,0,0,0,1
Melbourne,"McKenzie, Jordie",18,9,1,9,0,0,0,5
Melbourne,"Nicholson, Daniel",17,10,4,7,0,0,0,3
Melbourne,"Rivers, Jared",10,5,3,5,0,0,0,2
Melbourne,"Sellar, James",11,7,3,4,1,0,4,3
Melbourne,"Sylvia, Colin",25,15,4,10,0,1,0,2
Melbourne,"Tapscott, Luke",9,5,5,4,0,1,0,6
Melbourne,"Trengove, Jack",21,12,6,9,0,0,1,5
Melbourne,"Tynan, Josh",3,1,1,2,0,1,0,2
Melbourne,"Watts, Jack",12,6,5,6,0,0,0,0
North Melbourne,"Adams, Leigh",19,9,1,10,2,1,0,2
North Melbourne,"Anthony, Liam",23,14,6,9,0,0,0,3
North Melbourne,"Atley, Shaun",16,8,2,8,0,0,0,1
North Melbourne,"Bastinac, Ryan",18,6,1,12,0,0,0,3
North Melbourne,"Campbell, Matt",8,4,2,4,0,0,0,4
North Melbourne,"Cunnington, Ben",12,4,1,8,0,0,0,6
North Melbourne,"Edwards, Aaron",11,8,5,3,2,0,0,1
North Melbourne,"Firrito, Michael",18,9,5,9,0,0,0,1
North Melbourne,"Goldstein, Todd",10,5,1,5,0,0,18,4
North Melbourne,"Harper, Kieran",15,9,3,6,1,1,0,2
North Melbourne,"Harvey, Brent",21,10,3,11,3,0,0,0
North Melbourne,"Macmillan, Jamie",10,7,2,3,1,0,0,1
North Melbourne,"McIntosh, Hamish",11,7,5,4,1,1,10,0
North Melbourne,"McMahon, Scott",15,7,5,8,0,0,0,2
North Melbourne,"Mullett, Aaron",12,4,3,8,0,0,0,2
North Melbourne,"Petrie, Drew",13,7,6,6,2,1,1,3
North Melbourne,"Swallow, Andrew",26,10,2,16,0,0,0,5
North Melbourne,"Tarrant, Robbie",5,3,2,2,0,0,0,1
North Melbourne,"Thomas, Lindsay",18,17,7,1,2,2,0,6
North Melbourne,"Thompson, Scott",15,8,9,7,0,0,0,5
North Melbourne,"Wells, Daniel",25,20,5,5,1,2,1,0
North Melbourne,"Wright, Sam",17,8,4,9,0,0,0,1
North Melbourne,"Adams, Leigh",37,12,6,25,1,2,0,4
North Melbourne,"Anthony, Liam",38,16,5,22,2,1,1,0
North Melbourne,"Atley, Shaun",25,7,2,18,0,0,0,0
North Melbourne,"Bastinac, Ryan",44,16,2,28,2,3,0,4
North Melbourne,"Campbell, Matt",13,4,3,9,0,0,0,3
North Melbourne,"Cunnington, Ben",25,10,2,15,2,0,0,5
North Melbourne,"Delaney, Cameron",19,6,5,13,0,0,0,1
North Melbourne,"Edwards, Aaron",15,11,9,4,5,1,0,2
North Melbourne,"Firrito, Michael",33,8,6,25,0,0,0,2
North Melbourne,"Goldstein, Todd",13,3,2,10,2,0,18,3
North Melbourne,"Harper, Kieran",16,10,4,6,1,1,0,5
North Melbourne,"Harvey, Brent",32,21,2,11,2,1,0,2
North Melbourne,"Macmillan, Jamie",21,11,3,10,1,0,0,1
North Melbourne,"McIntosh, Hamish",20,8,5,12,3,0,21,1
North Melbourne,"McMahon, Scott",20,8,3,12,0,0,0,3
North Melbourne,"Mullett, Aaron",16,5,2,11,2,0,0,0
North Melbourne,"Petrie, Drew",15,9,7,6,2,0,0,5
North Melbourne,"Swallow, Andrew",29,14,1,15,1,1,0,3
North Melbourne,"Thomas, Lindsay",4,2,0,2,0,1,0,5
North Melbourne,"Thompson, Scott",23,7,6,16,0,0,0,2
North Melbourne,"Wells, Daniel",28,15,8,13,1,2,1,3
North Melbourne,"Wright, Sam",19,8,5,11,1,0,0,2
North Melbourne,"Adams, Leigh",15,8,0,7,2,1,0,4
North Melbourne,"Anthony, Liam",25,14,3,11,1,0,0,6
North Melbourne,"Atley, Shaun",20,7,2,13,0,0,0,1
North Melbourne,"Bastinac, Ryan",26,14,5,12,4,0,0,1
North Melbourne,"Campbell, Matt",17,6,4,11,0,1,0,6
North Melbourne,"Cunnington, Ben",12,6,3,6,0,0,0,5
North Melbourne,"Delaney, Luke",8,2,3,6,0,0,0,5
North Melbourne,"Edwards, Aaron",17,9,6,8,4,0,0,0
North Melbourne,"Firrito, Michael",23,10,2,13,0,0,0,1
North Melbourne,"Goldstein, Todd",5,2,2,3,0,0,33,1
North Melbourne,"Harper, Kieran",6,4,3,2,1,1,0,2
North Melbourne,"Harvey, Brent",38,19,3,19,1,0,0,0
North Melbourne,"Macmillan, Jamie",12,5,3,7,0,0,0,4
North Melbourne,"McIntosh, Hamish",16,10,8,6,2,2,9,4
North Melbourne,"McMahon, Scott",10,6,3,4,0,0,1,2
North Melbourne,"Petrie, Drew",7,4,4,3,0,1,0,2
North Melbourne,"Swallow, Andrew",30,14,4,16,0,1,0,4
North Melbourne,"Thomas, Lindsay",11,6,3,5,1,0,0,1
North Melbourne,"Thompson, Scott",11,6,5,5,0,0,0,2
North Melbourne,"Wells, Daniel",31,14,4,17,0,2,1,4
North Melbourne,"Wright, Sam",18,3,1,15,0,0,0,3
North Melbourne,"Ziebell, Jack",27,17,9,10,4,0,0,4
North Melbourne,"Adams, Leigh",16,11,5,5,0,0,0,6
North Melbourne,"Anthony, Liam",30,15,2,15,0,0,0,4
North Melbourne,"Atley, Shaun",21,6,3,15,0,0,0,2
North Melbourne,"Bastinac, Ryan",18,11,2,7,0,1,0,3
North Melbourne,"Campbell, Matt",6,5,1,1,2,1,0,1
North Melbourne,"Cunnington, Ben",21,9,1,12,1,1,0,7
North Melbourne,"Delaney, Luke",12,5,3,7,0,0,0,0
North Melbourne,"Edwards, Aaron",7,3,2,4,0,1,0,1
North Melbourne,"Firrito, Michael",19,12,3,7,0,0,0,1
North Melbourne,"Goldstein, Todd",7,2,0,5,0,1,18,0
North Melbourne,"Harper, Kieran",6,4,1,2,0,0,0,2
North Melbourne,"Harvey, Brent",14,10,1,4,1,0,0,1
North Melbourne,"Macmillan, Jamie",20,11,3,9,2,1,0,1
North Melbourne,"McIntosh, Hamish",14,9,2,5,0,0,29,3
North Melbourne,"McMahon, Scott",16,11,4,5,0,0,0,1
North Melbourne,"Petrie, Drew",15,8,8,7,1,2,3,2
North Melbourne,"Swallow, Andrew",25,9,3,16,0,1,0,6
North Melbourne,"Thomas, Lindsay",18,14,7,4,2,3,0,4
North Melbourne,"Thompson, Scott",21,9,8,12,0,0,0,5
North Melbourne,"Wells, Daniel",19,14,3,5,1,0,0,2
North Melbourne,"Wright, Sam",15,5,2,10,0,1,0,2
North Melbourne,"Ziebell, Jack",22,15,5,7,0,1,0,4
North Melbourne,"Adams, Leigh",14,8,1,6,2,3,0,4
North Melbourne,"Anthony, Liam",23,10,4,13,0,1,0,3
North Melbourne,"Atley, Shaun",26,12,3,14,0,0,0,0
North Melbourne,"Bastinac, Ryan",24,13,2,11,0,1,0,2
North Melbourne,"Cunnington, Ben",23,10,7,13,1,1,0,4
North Melbourne,"Delaney, Luke",9,4,2,5,0,0,0,1
North Melbourne,"Edwards, Aaron",10,7,6,3,3,2,0,2
North Melbourne,"Firrito, Michael",22,11,6,11,0,0,0,2
North Melbourne,"Greenwood, Levi",1,0,0,1,0,0,1,5
North Melbourne,"Harper, Kieran",15,11,1,4,2,3,0,6
North Melbourne,"Harvey, Brent",23,7,2,16,1,1,0,3
North Melbourne,"Macmillan, Jamie",25,12,4,13,1,1,0,3
North Melbourne,"McIntosh, Hamish",17,9,4,8,1,0,40,5
North Melbourne,"Mullett, Aaron",20,11,6,9,0,1,0,2
North Melbourne,"Petrie, Drew",16,10,7,6,3,0,9,4
North Melbourne,"Swallow, Andrew",31,10,3,21,0,0,0,4
North Melbourne,"Tarrant, Robbie",18,10,4,8,0,2,0,0
North Melbourne,"Thomas, Lindsay",19,15,4,4,3,0,0,4
North Melbourne,"Thompson, Scott",19,9,6,10,0,1,0,2
North Melbourne,"Wells, Daniel",13,6,3,7,0,0,0,2
North Melbourne,"Wright, Sam",13,7,1,6,0,2,0,1
North Melbourne,"Ziebell, Jack",14,7,1,7,0,0,0,6
North Melbourne,"Adams, Leigh",23,10,3,13,0,1,0,1
North Melbourne,"Anthony, Liam",24,12,6,12,0,1,0,2
North Melbourne,"Atley, Shaun",20,12,5,8,0,0,0,0
North Melbourne,"Bastinac, Ryan",18,9,1,9,0,0,0,1
North Melbourne,"Cunnington, Ben",15,12,6,3,3,0,0,5
North Melbourne,"Delaney, Luke",8,6,4,2,0,0,0,3
North Melbourne,"Edwards, Aaron",9,7,3,2,1,0,0,3
North Melbourne,"Firrito, Michael",21,12,4,9,0,0,0,3
North Melbourne,"Harper, Kieran",9,5,3,4,1,0,0,4
North Melbourne,"Harvey, Brent",21,9,2,12,2,0,0,0
North Melbourne,"Macmillan, Jamie",12,7,3,5,2,0,0,4
North Melbourne,"McIntosh, Hamish",20,12,4,8,0,0,31,3
North Melbourne,"Mullett, Aaron",6,4,0,2,0,0,0,0
North Melbourne,"Pedersen, Cameron",11,8,4,3,1,1,2,2
North Melbourne,"Petrie, Drew",11,7,5,4,1,0,3,3
North Melbourne,"Swallow, Andrew",29,14,6,15,0,1,0,9
North Melbourne,"Tarrant, Robbie",8,5,3,3,0,0,0,0
North Melbourne,"Thomas, Lindsay",20,8,2,12,1,0,0,2
North Melbourne,"Thompson, Scott",20,9,10,11,0,1,0,3
North Melbourne,"Wells, Daniel",19,13,4,6,1,0,0,5
North Melbourne,"Wright, Sam",16,14,7,2,1,0,0,5
North Melbourne,"Ziebell, Jack",22,15,2,7,1,0,0,4
North Melbourne,"Adams, Leigh",11,7,2,4,1,1,0,6
North Melbourne,"Anthony, Liam",27,14,5,13,2,0,0,2
North Melbourne,"Atley, Shaun",19,9,2,10,0,0,0,5
North Melbourne,"Bastinac, Ryan",20,9,2,11,0,1,0,3
North Melbourne,"Cunnington, Ben",11,4,4,7,1,0,1,2
North Melbourne,"Delaney, Cameron",8,5,3,3,0,0,0,6
North Melbourne,"Delaney, Luke",11,3,2,8,0,0,0,0
North Melbourne,"Edwards, Aaron",11,5,6,6,1,1,0,0
North Melbourne,"Firrito, Michael",16,9,2,7,0,0,0,3
North Melbourne,"Goldstein, Todd",12,4,4,8,0,0,27,6
North Melbourne,"Harper, Kieran",8,5,3,3,1,2,0,4
North Melbourne,"Harvey, Brent",23,14,3,9,0,0,0,2
North Melbourne,"Macmillan, Jamie",12,7,3,5,0,0,0,3
North Melbourne,"McIntosh, Hamish",12,7,3,5,0,0,17,3
North Melbourne,"McKenzie, Brad",4,3,4,1,0,0,0,0
North Melbourne,"Petrie, Drew",9,5,5,4,3,1,0,3
North Melbourne,"Swallow, Andrew",22,13,2,9,0,0,0,9
North Melbourne,"Thomas, Lindsay",15,11,3,4,3,2,0,2
North Melbourne,"Thompson, Scott",28,14,7,14,0,0,0,2
North Melbourne,"Wells, Daniel",24,15,2,9,0,1,1,4
North Melbourne,"Wright, Sam",14,8,2,6,0,0,0,6
North Melbourne,"Ziebell, Jack",16,8,4,8,0,0,0,6
North Melbourne,"Adams, Leigh",19,7,0,12,0,0,1,3
North Melbourne,"Atley, Shaun",14,7,3,7,0,0,0,4
North Melbourne,"Bastinac, Ryan",19,12,3,7,0,0,0,2
North Melbourne,"Cunnington, Ben",9,1,1,8,0,0,0,3
North Melbourne,"Delaney, Cameron",17,11,3,6,0,0,0,2
North Melbourne,"Delaney, Luke",8,6,3,2,0,0,0,0
North Melbourne,"Firrito, Michael",14,4,5,10,0,0,0,2
North Melbourne,"Goldstein, Todd",12,6,2,6,0,0,38,1
North Melbourne,"Greenwood, Levi",11,4,0,7,0,0,0,7
North Melbourne,"Grima, Nathan",13,9,5,4,0,0,0,3
North Melbourne,"Harper, Kieran",16,9,4,7,0,0,0,4
North Melbourne,"Harvey, Brent",12,6,1,6,1,0,0,6
North Melbourne,"Macmillan, Jamie",15,10,6,5,0,1,0,0
North Melbourne,"McKenzie, Brad",2,0,0,2,0,0,0,0
North Melbourne,"Pedersen, Cameron",11,7,6,4,1,0,2,2
North Melbourne,"Petrie, Drew",9,7,2,2,5,0,2,6
North Melbourne,"Swallow, Andrew",28,19,2,9,1,1,1,12
North Melbourne,"Thomas, Lindsay",11,9,2,2,2,1,0,5
North Melbourne,"Thompson, Scott",16,6,1,10,0,1,0,2
North Melbourne,"Warren, Ben",11,8,6,3,1,2,0,1
North Melbourne,"Wells, Daniel",26,20,4,6,2,1,0,5
North Melbourne,"Ziebell, Jack",22,14,4,8,1,0,0,5
North Melbourne,"Adams, Leigh",25,9,2,16,0,1,0,4
North Melbourne,"Atley, Shaun",20,8,2,12,0,0,0,2
North Melbourne,"Bastinac, Ryan",21,10,3,11,0,1,0,2
North Melbourne,"Black, Aaron",11,5,3,6,3,0,0,1
North Melbourne,"Cunnington, Ben",12,3,4,9,0,0,0,4
North Melbourne,"Delaney, Cameron",16,11,4,5,0,1,0,1
North Melbourne,"Delaney, Luke",15,11,5,4,0,0,0,1
North Melbourne,"Edwards, Aaron",13,8,5,5,0,1,0,2
North Melbourne,"Firrito, Michael",20,12,5,8,0,0,0,2
North Melbourne,"Garlett, Cruize",8,6,2,2,0,0,0,1
North Melbourne,"Goldstein, Todd",28,13,5,15,0,0,47,2
North Melbourne,"Greenwood, Levi",24,16,2,8,1,0,0,1
North Melbourne,"Grima, Nathan",21,14,5,7,0,0,0,1
North Melbourne,"Harper, Kieran",9,6,3,3,3,0,0,4
North Melbourne,"Harvey, Brent",27,16,6,11,1,0,0,2
North Melbourne,"Macmillan, Jamie",16,10,0,6,0,0,0,2
North Melbourne,"Petrie, Drew",17,13,7,4,3,2,3,1
North Melbourne,"Swallow, Andrew",25,10,3,15,1,0,0,5
North Melbourne,"Thompson, Scott",15,7,4,8,0,0,0,2
North Melbourne,"Wells, Daniel",18,11,3,7,0,0,0,3
North Melbourne,"Wright, Sam",14,7,3,7,4,1,0,1
North Melbourne,"Ziebell, Jack",7,6,3,1,1,0,0,1
North Melbourne,"Adams, Leigh",17,13,3,4,1,0,0,2
North Melbourne,"Atley, Shaun",17,7,2,10,1,0,0,0
North Melbourne,"Bastinac, Ryan",16,10,5,6,0,0,0,1
North Melbourne,"Black, Aaron",8,4,4,4,0,1,0,2
North Melbourne,"Cunnington, Ben",10,5,3,5,0,0,0,10
North Melbourne,"Delaney, Cameron",11,7,1,4,0,0,0,2
North Melbourne,"Delaney, Luke",9,6,2,3,0,0,3,1
North Melbourne,"Edwards, Aaron",4,4,3,0,1,0,0,7
North Melbourne,"Firrito, Michael",9,3,3,6,0,1,0,2
North Melbourne,"Garlett, Cruize",15,8,2,7,0,0,0,2
North Melbourne,"Goldstein, Todd",19,12,6,7,0,0,31,0
North Melbourne,"Greenwood, Levi",18,12,1,6,0,2,0,5
North Melbourne,"Grima, Nathan",17,14,7,3,0,0,0,5
North Melbourne,"Harper, Kieran",3,3,2,0,0,0,0,3
North Melbourne,"Harvey, Brent",14,9,4,5,0,1,0,3
North Melbourne,"Macmillan, Jamie",11,8,2,3,0,0,0,1
North Melbourne,"Petrie, Drew",12,7,4,5,1,0,2,3
North Melbourne,"Swallow, Andrew",16,6,0,10,1,0,0,4
North Melbourne,"Thompson, Scott",10,5,2,5,0,0,0,1
North Melbourne,"Wells, Daniel",22,16,5,6,1,0,0,4
North Melbourne,"Wright, Sam",9,7,4,2,3,0,0,1
North Melbourne,"Ziebell, Jack",19,14,5,5,0,0,0,5
North Melbourne,"Adams, Leigh",21,13,4,8,0,2,0,3
North Melbourne,"Atley, Shaun",19,8,1,11,0,0,0,2
North Melbourne,"Bastinac, Ryan",19,8,3,11,0,0,0,3
North Melbourne,"Black, Aaron",4,1,1,3,0,0,0,3
North Melbourne,"Cunnington, Ben",20,7,4,13,1,1,0,6
North Melbourne,"Firrito, Michael",11,4,1,7,1,0,0,3
North Melbourne,"Gibson, Sam",18,13,5,5,0,1,0,1
North Melbourne,"Goldstein, Todd",23,10,7,13,0,0,32,1
North Melbourne,"Greenwood, Levi",11,7,1,4,0,1,0,1
North Melbourne,"Grima, Nathan",29,21,12,8,0,0,0,4
North Melbourne,"Harper, Kieran",5,4,1,1,0,2,0,1
North Melbourne,"Harvey, Brent",29,19,6,10,4,0,0,2
North Melbourne,"Macmillan, Jamie",22,15,6,7,0,0,0,3
North Melbourne,"McMahon, Scott",19,12,9,7,0,0,0,3
North Melbourne,"Petrie, Drew",23,16,14,7,2,3,1,2
North Melbourne,"Swallow, Andrew",27,15,4,12,0,0,0,6
North Melbourne,"Tarrant, Robbie",12,10,4,2,0,3,1,2
North Melbourne,"Thomas, Lindsay",16,10,6,6,2,2,0,7
North Melbourne,"Thompson, Scott",20,12,10,8,0,0,0,4
North Melbourne,"Wells, Daniel",22,17,8,5,1,1,0,2
North Melbourne,"Wright, Sam",14,11,2,3,0,0,0,4
North Melbourne,"Ziebell, Jack",16,12,4,4,0,0,0,3
North Melbourne,"Adams, Leigh",26,14,4,12,3,2,0,2
North Melbourne,"Anthony, Liam",18,7,2,11,0,1,0,2
North Melbourne,"Atley, Shaun",23,12,6,11,0,1,0,3
North Melbourne,"Bastinac, Ryan",25,12,4,13,2,0,0,0
North Melbourne,"Cunnington, Ben",5,1,2,4,0,0,0,3
North Melbourne,"Firrito, Michael",12,3,4,9,0,0,0,1
North Melbourne,"Gibson, Sam",6,4,0,2,0,0,0,0
North Melbourne,"Goldstein, Todd",13,7,6,6,0,0,33,2
North Melbourne,"Grima, Nathan",18,14,11,4,0,0,0,0
North Melbourne,"Hansen, Lachlan",9,8,4,1,1,2,0,0
North Melbourne,"Harper, Kieran",9,4,2,5,1,2,0,4
North Melbourne,"Harvey, Brent",19,8,2,11,1,0,0,2
North Melbourne,"Macmillan, Jamie",10,5,2,5,0,1,0,0
North Melbourne,"McMahon, Scott",14,10,5,4,0,0,0,5
North Melbourne,"Petrie, Drew",12,10,8,2,2,1,3,3
North Melbourne,"Swallow, Andrew",19,8,3,11,0,0,0,4
North Melbourne,"Tarrant, Robbie",11,11,8,0,4,2,0,1
North Melbourne,"Thomas, Lindsay",15,14,6,1,3,2,0,3
North Melbourne,"Thompson, Scott",14,4,4,10,0,0,0,1
North Melbourne,"Wells, Daniel",31,25,5,6,0,1,1,1
North Melbourne,"Wright, Sam",24,11,6,13,0,0,0,2
North Melbourne,"Ziebell, Jack",19,17,4,2,0,1,0,2
North Melbourne,"Adams, Leigh",32,17,6,15,2,0,0,6
North Melbourne,"Anthony, Liam",28,14,9,14,0,0,0,4
North Melbourne,"Atley, Shaun",12,9,3,3,0,0,0,1
North Melbourne,"Bastinac, Ryan",22,12,4,10,1,3,0,1
North Melbourne,"Campbell, Matt",6,3,1,3,0,0,0,0
North Melbourne,"Delaney, Luke",14,5,5,9,0,0,0,1
North Melbourne,"Firrito, Michael",14,7,4,7,0,0,0,5
North Melbourne,"Gibson, Sam",25,12,12,13,0,0,0,3
North Melbourne,"Goldstein, Todd",18,7,5,11,0,0,41,2
North Melbourne,"Grima, Nathan",14,7,6,7,0,0,0,2
North Melbourne,"Hansen, Lachlan",13,11,5,2,3,0,0,1
North Melbourne,"Harper, Kieran",7,4,2,3,1,0,0,4
North Melbourne,"Harvey, Brent",15,8,2,7,1,0,0,2
North Melbourne,"Macmillan, Jamie",20,12,3,8,1,0,0,4
North Melbourne,"McMahon, Scott",18,13,6,5,0,0,0,1
North Melbourne,"Petrie, Drew",11,8,9,3,4,0,1,3
North Melbourne,"Swallow, Andrew",27,10,8,17,1,1,0,13
North Melbourne,"Tarrant, Robbie",4,3,1,1,1,1,0,1
North Melbourne,"Thomas, Lindsay",10,8,4,2,3,2,0,2
North Melbourne,"Wells, Daniel",34,24,3,10,2,0,0,4
North Melbourne,"Wright, Sam",10,6,3,4,1,0,0,2
North Melbourne,"Ziebell, Jack",24,19,9,5,0,0,0,2
North Melbourne,"Adams, Leigh",19,10,4,9,0,0,0,3
North Melbourne,"Anthony, Liam",21,11,6,10,0,1,0,1
North Melbourne,"Atley, Shaun",18,9,5,9,0,0,0,0
North Melbourne,"Bastinac, Ryan",18,6,4,12,0,0,0,1
North Melbourne,"Campbell, Matt",9,5,1,4,0,0,0,5
North Melbourne,"Delaney, Luke",7,2,1,5,0,0,0,3
North Melbourne,"Firrito, Michael",13,4,2,9,0,0,0,0
North Melbourne,"Gibson, Sam",14,9,6,5,0,0,0,6
North Melbourne,"Goldstein, Todd",8,5,1,3,0,0,21,3
North Melbourne,"Grima, Nathan",15,8,8,7,0,0,0,4
North Melbourne,"Hansen, Lachlan",8,5,3,3,1,0,0,3
North Melbourne,"Harper, Kieran",0,0,0,0,0,0,0,0
North Melbourne,"Harvey, Brent",23,14,6,9,3,1,0,1
North Melbourne,"Macmillan, Jamie",15,8,3,7,0,0,0,3
North Melbourne,"McMahon, Scott",18,12,8,6,0,0,0,2
North Melbourne,"Petrie, Drew",9,6,3,3,0,0,5,3
North Melbourne,"Swallow, Andrew",25,15,4,10,1,0,1,14
North Melbourne,"Tarrant, Robbie",13,11,7,2,4,2,0,1
North Melbourne,"Thomas, Lindsay",11,11,5,0,3,1,0,3
North Melbourne,"Wells, Daniel",19,15,4,4,0,1,0,2
North Melbourne,"Wright, Sam",14,8,4,6,0,0,0,2
North Melbourne,"Ziebell, Jack",19,12,3,7,1,0,0,2
North Melbourne,"Adams, Leigh",17,12,4,5,1,0,0,3
North Melbourne,"Anthony, Liam",23,10,3,13,0,0,0,2
North Melbourne,"Atley, Shaun",16,9,2,7,1,0,0,2
North Melbourne,"Bastinac, Ryan",12,11,5,1,1,1,0,1
North Melbourne,"Campbell, Matt",7,1,1,6,0,0,0,0
North Melbourne,"Firrito, Michael",20,9,7,11,0,0,0,0
North Melbourne,"Gibson, Sam",18,13,7,5,0,1,0,0
North Melbourne,"Goldstein, Todd",8,1,1,7,0,0,38,0
North Melbourne,"Grima, Nathan",15,9,7,6,0,0,0,3
North Melbourne,"Hansen, Lachlan",11,7,5,4,4,0,1,0
North Melbourne,"Harper, Kieran",10,10,2,0,3,0,0,1
North Melbourne,"Harvey, Brent",20,12,8,8,1,0,0,1
North Melbourne,"Macmillan, Jamie",9,4,2,5,0,1,0,1
North Melbourne,"McMahon, Scott",6,5,2,1,0,0,0,2
North Melbourne,"Petrie, Drew",13,9,7,4,7,0,4,2
North Melbourne,"Swallow, Andrew",22,14,0,8,1,0,0,7
North Melbourne,"Tarrant, Robbie",8,5,0,3,1,1,0,3
North Melbourne,"Thomas, Lindsay",7,6,2,1,3,0,0,5
North Melbourne,"Thompson, Scott",16,7,5,9,0,0,0,1
North Melbourne,"Wells, Daniel",26,18,2,8,1,1,2,5
North Melbourne,"Wright, Sam",18,13,8,5,0,0,0,1
North Melbourne,"Ziebell, Jack",21,15,1,6,0,0,0,6
North Melbourne,"Adams, Leigh",20,12,5,8,0,0,0,3
North Melbourne,"Anthony, Liam",26,13,9,13,2,0,0,3
North Melbourne,"Atley, Shaun",16,6,2,10,0,1,0,0
North Melbourne,"Bastinac, Ryan",29,16,1,13,0,0,0,3
North Melbourne,"Campbell, Matt",8,3,1,5,1,0,0,1
North Melbourne,"Cunnington, Ben",18,8,4,10,0,1,0,6
North Melbourne,"Firrito, Michael",11,9,2,2,0,0,0,1
North Melbourne,"Gibson, Sam",24,16,6,8,0,0,0,2
North Melbourne,"Goldstein, Todd",8,4,0,4,0,1,47,5
North Melbourne,"Grima, Nathan",23,12,10,11,0,0,0,1
North Melbourne,"Hansen, Lachlan",12,6,2,6,1,0,0,3
North Melbourne,"Harper, Kieran",13,7,3,6,2,0,1,1
North Melbourne,"Harvey, Brent",24,16,6,8,1,1,0,4
North Melbourne,"Macmillan, Jamie",14,11,3,3,1,0,0,2
North Melbourne,"McMahon, Scott",18,11,9,7,0,0,0,4
North Melbourne,"Petrie, Drew",13,12,7,1,7,1,1,6
North Melbourne,"Swallow, Andrew",29,11,1,18,0,2,1,5
North Melbourne,"Tarrant, Robbie",9,4,2,5,0,0,0,1
North Melbourne,"Thomas, Lindsay",12,10,1,2,0,0,0,2
North Melbourne,"Thompson, Scott",17,8,5,9,0,0,0,3
North Melbourne,"Wells, Daniel",19,12,2,7,0,1,0,4
North Melbourne,"Wright, Sam",20,9,5,11,0,0,0,1
North Melbourne,"Adams, Leigh",9,6,0,3,2,0,0,3
North Melbourne,"Anthony, Liam",28,12,5,16,1,2,0,3
North Melbourne,"Atley, Shaun",19,9,1,10,0,0,0,2
North Melbourne,"Bastinac, Ryan",29,12,7,17,1,1,0,1
North Melbourne,"Campbell, Matt",11,7,1,4,0,1,0,1
North Melbourne,"Cunnington, Ben",26,5,1,21,0,0,0,8
North Melbourne,"Firrito, Michael",20,10,5,10,0,0,0,0
North Melbourne,"Gibson, Sam",36,23,8,13,0,0,0,4
North Melbourne,"Goldstein, Todd",22,6,3,16,0,0,48,0
North Melbourne,"Grima, Nathan",20,9,5,11,0,0,0,1
North Melbourne,"Hansen, Lachlan",4,3,2,1,0,0,2,5
North Melbourne,"Harper, Kieran",6,5,1,1,1,3,0,2
North Melbourne,"Harvey, Brent",30,12,6,18,2,0,0,2
North Melbourne,"Macmillan, Jamie",24,13,8,11,1,0,0,0
North Melbourne,"McMahon, Scott",9,7,4,2,0,0,0,1
North Melbourne,"Petrie, Drew",13,10,7,3,4,0,1,0
North Melbourne,"Swallow, Andrew",32,14,3,18,1,0,0,17
North Melbourne,"Tarrant, Robbie",16,10,4,6,4,1,0,2
North Melbourne,"Thomas, Lindsay",8,6,2,2,2,0,0,3
North Melbourne,"Thompson, Scott",17,3,3,14,0,0,0,3
North Melbourne,"Wells, Daniel",26,9,2,17,0,1,0,3
North Melbourne,"Wright, Sam",24,15,7,9,0,2,0,0
North Melbourne,"Anthony, Liam",28,15,6,13,2,0,0,0
North Melbourne,"Atley, Shaun",18,9,6,9,0,0,0,3
North Melbourne,"Bastinac, Ryan",31,17,4,14,0,0,0,6
North Melbourne,"Campbell, Matt",11,6,3,5,0,1,0,3
North Melbourne,"Cunnington, Ben",27,9,2,18,0,0,0,4
North Melbourne,"Firrito, Michael",23,8,5,15,0,0,0,1
North Melbourne,"Garlett, Cruize",22,10,4,12,1,0,0,9
North Melbourne,"Gibson, Sam",26,15,6,11,1,0,0,4
North Melbourne,"Goldstein, Todd",9,5,3,4,0,0,37,6
North Melbourne,"Grima, Nathan",16,6,4,10,0,0,0,2
North Melbourne,"Hansen, Lachlan",14,10,9,4,1,0,1,2
North Melbourne,"Harper, Kieran",12,9,2,3,2,0,0,7
North Melbourne,"Harvey, Brent",32,16,7,16,1,0,0,2
North Melbourne,"Macmillan, Jamie",13,2,3,11,0,0,0,1
North Melbourne,"McMahon, Scott",15,9,3,6,0,0,0,2
North Melbourne,"Mullett, Aaron",8,5,3,3,0,0,0,0
North Melbourne,"Petrie, Drew",14,10,5,4,5,2,0,0
North Melbourne,"Swallow, Andrew",26,12,3,14,0,0,0,6
North Melbourne,"Tarrant, Robbie",13,9,6,4,3,0,0,1
North Melbourne,"Thompson, Scott",14,9,3,5,0,0,0,1
North Melbourne,"Wells, Daniel",17,13,2,4,2,0,0,2
North Melbourne,"Wright, Sam",15,8,6,7,0,0,0,5
North Melbourne,"Adams, Leigh",4,2,0,2,0,1,0,0
North Melbourne,"Anthony, Liam",27,17,5,10,0,0,0,6
North Melbourne,"Atley, Shaun",21,12,3,9,0,0,0,3
North Melbourne,"Bastinac, Ryan",25,12,5,13,0,0,0,2
North Melbourne,"Campbell, Matt",13,6,1,7,0,0,0,4
North Melbourne,"Cunnington, Ben",22,13,2,9,0,0,0,4
North Melbourne,"Firrito, Michael",21,13,7,8,0,0,0,3
North Melbourne,"Garlett, Cruize",21,12,3,9,2,2,0,3
North Melbourne,"Gibson, Sam",26,13,8,13,2,0,0,3
North Melbourne,"Goldstein, Todd",9,4,2,5,0,0,34,3
North Melbourne,"Grima, Nathan",14,6,7,8,0,0,0,4
North Melbourne,"Hansen, Lachlan",15,10,6,5,3,0,0,1
North Melbourne,"Harper, Kieran",11,5,3,6,0,2,0,2
North Melbourne,"Harvey, Brent",21,9,5,12,3,1,0,6
North Melbourne,"Macmillan, Jamie",10,6,2,4,0,1,0,1
North Melbourne,"McMahon, Scott",22,19,8,3,0,0,0,3
North Melbourne,"Petrie, Drew",14,10,9,4,0,0,3,0
North Melbourne,"Swallow, Andrew",24,7,4,17,0,1,0,7
North Melbourne,"Tarrant, Robbie",9,4,3,5,3,0,0,3
North Melbourne,"Thompson, Scott",19,11,9,8,0,0,0,2
North Melbourne,"Wells, Daniel",7,5,2,2,1,0,0,0
North Melbourne,"Wright, Sam",32,22,12,10,1,0,0,1
North Melbourne,"Anthony, Liam",21,16,10,5,0,1,1,4
North Melbourne,"Atley, Shaun",17,10,3,7,0,0,0,1
North Melbourne,"Bastinac, Ryan",25,16,9,9,0,1,0,2
North Melbourne,"Campbell, Matt",2,2,2,0,0,0,0,0
North Melbourne,"Cunnington, Ben",24,9,4,15,0,0,0,11
North Melbourne,"Delaney, Luke",11,7,6,4,0,0,0,1
North Melbourne,"Firrito, Michael",17,10,5,7,0,0,0,1
North Melbourne,"Garlett, Cruize",15,6,2,9,1,1,0,2
North Melbourne,"Gibson, Sam",28,22,13,6,0,0,0,1
North Melbourne,"Goldstein, Todd",18,10,3,8,0,2,40,2
North Melbourne,"Hansen, Lachlan",10,9,5,1,2,0,0,1
North Melbourne,"Harper, Kieran",9,5,2,4,0,1,0,6
North Melbourne,"Harvey, Brent",33,22,11,11,0,0,0,3
North Melbourne,"Macmillan, Jamie",18,9,7,9,0,1,0,2
North Melbourne,"McMahon, Scott",16,11,5,5,0,0,0,0
North Melbourne,"Petrie, Drew",12,9,8,3,3,1,4,3
North Melbourne,"Swallow, Andrew",24,12,5,12,0,0,0,5
North Melbourne,"Tarrant, Robbie",10,8,5,2,3,2,0,3
North Melbourne,"Thomas, Lindsay",6,5,3,1,3,0,0,4
North Melbourne,"Thompson, Scott",22,13,4,9,0,0,0,1
North Melbourne,"Wright, Sam",19,12,5,7,0,0,0,0
North Melbourne,"Ziebell, Jack",22,15,6,7,1,0,1,4
North Melbourne,"Anthony, Liam",25,11,8,14,0,1,0,3
North Melbourne,"Atley, Shaun",16,6,2,10,0,0,0,1
North Melbourne,"Bastinac, Ryan",21,10,4,11,1,0,0,2
North Melbourne,"Campbell, Matt",3,2,0,1,0,0,0,1
North Melbourne,"Cunnington, Ben",20,8,2,12,0,0,0,10
North Melbourne,"Delaney, Luke",10,5,4,5,0,0,0,3
North Melbourne,"Firrito, Michael",18,7,6,11,0,0,0,0
North Melbourne,"Garlett, Cruize",23,13,2,10,0,0,0,3
North Melbourne,"Gibson, Sam",14,7,3,7,2,0,0,3
North Melbourne,"Goldstein, Todd",2,2,0,0,0,0,8,3
North Melbourne,"Hansen, Lachlan",8,6,3,2,3,0,1,4
North Melbourne,"Harper, Kieran",5,4,0,1,1,0,0,5
North Melbourne,"Harvey, Brent",17,9,5,8,1,1,0,1
North Melbourne,"Macmillan, Jamie",20,11,7,9,1,0,0,4
North Melbourne,"McMahon, Scott",16,7,3,9,0,0,0,4
North Melbourne,"Petrie, Drew",8,6,3,2,0,0,6,0
North Melbourne,"Swallow, Andrew",30,15,4,15,0,1,0,13
North Melbourne,"Tarrant, Robbie",15,11,5,4,0,2,0,2
North Melbourne,"Thomas, Lindsay",11,10,2,1,3,1,0,2
North Melbourne,"Thompson, Scott",12,6,5,6,0,0,0,4
North Melbourne,"Wright, Sam",17,8,3,9,0,0,0,0
North Melbourne,"Ziebell, Jack",17,10,2,7,0,0,0,7
North Melbourne,"Anthony, Liam",27,15,8,12,0,1,1,6
North Melbourne,"Atley, Shaun",17,10,4,7,0,0,0,3
North Melbourne,"Bastinac, Ryan",31,15,6,16,0,0,0,2
North Melbourne,"Campbell, Matt",20,13,4,7,3,0,0,5
North Melbourne,"Cunnington, Ben",33,17,4,16,0,0,0,3
North Melbourne,"Delaney, Luke",20,11,8,9,1,0,0,4
North Melbourne,"Firrito, Michael",25,10,5,15,0,0,0,2
North Melbourne,"Garlett, Cruize",8,3,1,5,0,0,0,6
North Melbourne,"Gibson, Sam",32,22,13,10,1,1,0,0
North Melbourne,"Goldstein, Todd",8,2,2,6,0,0,30,3
North Melbourne,"Hansen, Lachlan",1,1,0,0,0,0,0,0
North Melbourne,"Harper, Kieran",6,5,2,1,4,0,0,0
North Melbourne,"Harvey, Brent",19,9,7,10,2,1,0,1
North Melbourne,"Macmillan, Jamie",16,13,6,3,0,0,0,2
North Melbourne,"McMahon, Scott",17,12,6,5,0,0,0,2
North Melbourne,"Mullett, Aaron",26,20,10,6,0,2,0,1
North Melbourne,"Petrie, Drew",16,13,7,3,2,3,1,1
North Melbourne,"Swallow, Andrew",17,9,5,8,1,0,0,2
North Melbourne,"Tarrant, Robbie",10,5,2,5,0,0,0,2
North Melbourne,"Thomas, Lindsay",12,10,2,2,2,0,0,4
North Melbourne,"Thompson, Scott",39,18,13,21,0,0,0,1
North Melbourne,"Ziebell, Jack",18,7,2,11,0,0,0,2
North Melbourne,"Anthony, Liam",12,8,4,4,0,0,0,0
North Melbourne,"Atley, Shaun",12,7,3,5,0,0,0,2
North Melbourne,"Bastinac, Ryan",12,7,3,5,0,0,0,5
North Melbourne,"Campbell, Matt",10,6,1,4,3,0,0,1
North Melbourne,"Cunnington, Ben",22,5,4,17,1,0,1,1
North Melbourne,"Firrito, Michael",12,6,4,6,0,0,0,1
North Melbourne,"Gibson, Sam",14,8,4,6,0,1,0,1
North Melbourne,"Goldstein, Todd",5,4,1,1,0,0,24,6
North Melbourne,"Grima, Nathan",5,3,1,2,0,0,0,1
North Melbourne,"Hansen, Lachlan",10,10,7,0,1,2,2,0
North Melbourne,"Harper, Kieran",6,5,1,1,0,0,0,0
North Melbourne,"Harvey, Brent",13,10,1,3,3,1,0,1
North Melbourne,"Macmillan, Jamie",14,6,2,8,0,0,0,2
North Melbourne,"McMahon, Scott",10,5,2,5,0,0,0,0
North Melbourne,"Petrie, Drew",14,9,5,5,1,0,2,1
North Melbourne,"Swallow, Andrew",31,17,4,14,0,2,0,4
North Melbourne,"Tarrant, Robbie",6,3,1,3,0,0,0,1
North Melbourne,"Thomas, Lindsay",9,5,0,4,0,2,0,1
North Melbourne,"Thompson, Scott",19,13,4,6,0,0,0,1
North Melbourne,"Wells, Daniel",13,8,1,5,0,2,0,4
North Melbourne,"Wright, Sam",10,6,1,4,0,0,0,1
North Melbourne,"Ziebell, Jack",30,19,3,11,0,0,0,2
Port Adelaide,"Boak, Travis",19,8,0,11,1,0,0,3
Port Adelaide,"Broadbent, Matthew",16,10,4,6,0,3,0,4
Port Adelaide,"Butcher, John",8,5,2,3,2,0,0,0
Port Adelaide,"Carlile, Alipate",9,8,3,1,0,0,1,0
Port Adelaide,"Cassisi, Domenic",21,12,2,9,0,0,0,6
Port Adelaide,"Chaplin, Troy",15,9,3,6,0,0,0,3
Port Adelaide,"Cornes, Kane",27,12,5,15,0,0,0,4
Port Adelaide,"Ebert, Brad",21,14,5,7,2,0,0,12
Port Adelaide,"Hartlett, Hamish",26,21,5,5,1,1,0,3
Port Adelaide,"Jacobs, Ben",12,5,2,7,0,0,0,0
Port Adelaide,"McCarthy, John",23,15,6,8,1,0,1,4
Port Adelaide,"OShea, Cameron",15,8,5,7,0,0,0,2
Port Adelaide,"Pearce, Danyle",9,7,0,2,0,0,0,2
Port Adelaide,"Redden, Jarrad",12,6,3,6,0,0,21,1
Port Adelaide,"Rodan, David",11,3,1,8,1,0,0,0
Port Adelaide,"Schulz, Jay",9,8,6,1,2,1,0,5
Port Adelaide,"Stewart, Daniel",12,9,4,3,1,2,14,2
Port Adelaide,"Stewart, Paul",11,10,7,1,0,0,0,1
Port Adelaide,"Surjan, Jacob",14,7,5,7,0,0,0,4
Port Adelaide,"Thomas, Matt",17,6,1,11,0,2,0,10
Port Adelaide,"Westhoff, Justin",9,6,3,3,2,1,3,2
Port Adelaide,"Wingard, Chad",16,3,3,13,0,0,0,2
Port Adelaide,"Boak, Travis",19,16,2,3,0,0,0,1
Port Adelaide,"Broadbent, Matthew",20,14,5,6,0,1,0,3
Port Adelaide,"Carlile, Alipate",6,2,2,4,0,0,0,0
Port Adelaide,"Cassisi, Domenic",21,12,4,9,0,0,0,5
Port Adelaide,"Chaplin, Troy",10,6,4,4,0,0,0,3
Port Adelaide,"Cornes, Kane",27,18,9,9,0,0,0,2
Port Adelaide,"Ebert, Brad",19,10,6,9,1,0,0,2
Port Adelaide,"Hartlett, Hamish",17,9,4,8,0,1,0,3
Port Adelaide,"Jacobs, Ben",14,8,4,6,0,0,0,2
Port Adelaide,"McCarthy, John",20,10,3,10,1,1,0,3
Port Adelaide,"OShea, Cameron",6,2,1,4,0,0,0,1
Port Adelaide,"Pearce, Danyle",21,12,1,9,0,0,0,3
Port Adelaide,"Redden, Jarrad",11,3,2,8,1,0,18,1
Port Adelaide,"Rodan, David",19,9,5,10,0,0,0,1
Port Adelaide,"Schulz, Jay",14,11,7,3,4,1,0,0
Port Adelaide,"Stewart, Daniel",7,4,2,3,0,0,6,0
Port Adelaide,"Stewart, Paul",17,8,5,9,1,1,0,0
Port Adelaide,"Surjan, Jacob",17,5,2,12,0,0,0,3
Port Adelaide,"Thomas, Matt",9,2,1,7,1,0,0,7
Port Adelaide,"Trengove, Jackson",15,9,4,6,0,0,1,5
Port Adelaide,"Westhoff, Justin",15,11,8,4,3,0,0,2
Port Adelaide,"Wingard, Chad",6,4,1,2,1,1,0,1
Port Adelaide,"Boak, Travis",20,14,5,6,0,0,0,5
Port Adelaide,"Broadbent, Matthew",19,14,5,5,1,0,0,1
Port Adelaide,"Carlile, Alipate",13,6,4,7,0,0,0,0
Port Adelaide,"Cassisi, Domenic",26,11,4,15,0,1,0,7
Port Adelaide,"Chaplin, Troy",18,14,11,4,0,0,0,1
Port Adelaide,"Cornes, Kane",24,14,8,10,0,0,0,4
Port Adelaide,"Ebert, Brad",22,18,12,4,2,2,0,3
Port Adelaide,"Gray, Robbie",12,7,2,5,0,4,1,5
Port Adelaide,"Hartlett, Hamish",24,14,4,10,0,2,0,3
Port Adelaide,"Jacobs, Ben",17,10,4,7,0,0,0,3
Port Adelaide,"McCarthy, John",21,15,6,6,0,0,0,2
Port Adelaide,"OShea, Cameron",4,1,1,3,0,0,0,0
Port Adelaide,"Pearce, Danyle",17,12,1,5,0,0,0,2
Port Adelaide,"Redden, Jarrad",16,3,1,13,0,0,26,0
Port Adelaide,"Schulz, Jay",9,5,4,4,2,0,0,2
Port Adelaide,"Stewart, Daniel",13,10,6,3,3,0,6,1
Port Adelaide,"Stewart, Paul",21,12,6,9,0,1,0,3
Port Adelaide,"Surjan, Jacob",13,8,4,5,1,0,0,1
Port Adelaide,"Thomas, Matt",14,7,5,7,1,0,0,2
Port Adelaide,"Trengove, Jackson",25,12,11,13,0,0,0,0
Port Adelaide,"Westhoff, Justin",24,13,7,11,2,0,0,1
Port Adelaide,"Wingard, Chad",9,6,2,3,0,1,2,4
Port Adelaide,"Boak, Travis",31,18,7,13,0,1,0,1
Port Adelaide,"Broadbent, Matthew",15,8,5,7,0,1,0,4
Port Adelaide,"Butcher, John",8,5,3,3,1,0,0,1
Port Adelaide,"Carlile, Alipate",12,7,4,5,0,0,0,0
Port Adelaide,"Cassisi, Domenic",23,8,6,15,0,0,0,8
Port Adelaide,"Chaplin, Troy",10,8,4,2,0,0,0,5
Port Adelaide,"Cornes, Kane",37,19,6,18,0,1,0,2
Port Adelaide,"Ebert, Brad",21,12,7,9,1,2,1,4
Port Adelaide,"Gray, Robbie",17,6,4,11,2,0,0,4
Port Adelaide,"Hartlett, Hamish",24,14,6,10,0,0,0,6
Port Adelaide,"Jacobs, Ben",21,6,2,15,0,0,0,2
Port Adelaide,"McCarthy, John",30,16,6,14,0,0,0,0
Port Adelaide,"Pearce, Danyle",24,16,0,8,0,2,0,1
Port Adelaide,"Pfeiffer, Darren",20,8,4,12,1,0,0,3
Port Adelaide,"Renouf, Brent",8,3,2,5,0,0,17,2
Port Adelaide,"Schulz, Jay",10,8,8,2,2,1,0,0
Port Adelaide,"Stewart, Daniel",11,5,5,6,1,2,7,0
Port Adelaide,"Stewart, Paul",17,12,2,5,1,0,0,0
Port Adelaide,"Surjan, Jacob",20,10,7,10,0,0,0,4
Port Adelaide,"Trengove, Jackson",15,7,4,8,0,0,0,3
Port Adelaide,"Westhoff, Justin",18,9,7,9,1,0,1,1
Port Adelaide,"Wingard, Chad",6,2,1,4,0,1,1,1
Port Adelaide,"Boak, Travis",25,9,4,16,0,0,0,4
Port Adelaide,"Broadbent, Matthew",14,10,6,4,2,1,0,0
Port Adelaide,"Butcher, John",11,8,4,3,4,0,0,2
Port Adelaide,"Carlile, Alipate",12,7,5,5,0,0,0,3
Port Adelaide,"Cassisi, Domenic",12,4,5,8,0,0,0,7
Port Adelaide,"Chaplin, Troy",22,13,11,9,0,0,0,2
Port Adelaide,"Cornes, Kane",27,12,10,15,0,0,0,1
Port Adelaide,"Ebert, Brad",15,14,7,1,2,0,2,4
Port Adelaide,"Hartlett, Hamish",15,9,1,6,0,0,0,1
Port Adelaide,"Jacobs, Ben",15,8,5,7,1,0,0,1
Port Adelaide,"McCarthy, John",16,10,7,6,0,0,0,1
Port Adelaide,"Pearce, Danyle",19,12,2,7,0,1,0,1
Port Adelaide,"Pfeiffer, Darren",15,8,3,7,0,0,0,2
Port Adelaide,"Renouf, Brent",12,4,0,8,0,0,16,3
Port Adelaide,"Rodan, David",18,10,3,8,0,0,0,5
Port Adelaide,"Schulz, Jay",6,5,6,1,1,1,0,0
Port Adelaide,"Stewart, Paul",11,6,2,5,0,0,0,5
Port Adelaide,"Surjan, Jacob",10,6,1,4,0,0,0,2
Port Adelaide,"Trengove, Jackson",13,8,4,5,0,0,4,4
Port Adelaide,"Westhoff, Justin",16,13,9,3,4,1,0,3
Port Adelaide,"Wingard, Chad",14,8,1,6,0,2,0,2
Port Adelaide,"Young, Aaron",4,2,1,2,0,0,0,1
Port Adelaide,"Boak, Travis",25,15,3,10,0,1,0,6
Port Adelaide,"Broadbent, Matthew",14,10,5,4,2,0,0,0
Port Adelaide,"Butcher, John",10,5,2,5,1,0,0,1
Port Adelaide,"Carlile, Alipate",6,5,1,1,0,0,1,2
Port Adelaide,"Cassisi, Domenic",20,12,4,8,0,0,0,10
Port Adelaide,"Chaplin, Troy",17,12,5,5,0,0,1,1
Port Adelaide,"Cornes, Kane",16,7,4,9,0,0,0,2
Port Adelaide,"Ebert, Brad",30,12,4,18,0,0,1,4
Port Adelaide,"Hartlett, Hamish",24,16,5,8,0,0,0,8
Port Adelaide,"Hitchcock, Cameron",1,1,0,0,0,0,0,1
Port Adelaide,"Jacobs, Ben",23,12,3,11,1,0,0,2
Port Adelaide,"Logan, Tom",12,9,6,3,0,0,0,4
Port Adelaide,"McCarthy, John",17,11,6,6,0,1,0,5
Port Adelaide,"Pfeiffer, Darren",9,1,1,8,0,0,0,1
Port Adelaide,"Renouf, Brent",15,6,8,9,2,1,19,1
Port Adelaide,"Rodan, David",16,6,0,10,0,1,0,7
Port Adelaide,"Stewart, Daniel",7,5,3,2,1,1,3,1
Port Adelaide,"Stewart, Paul",10,5,3,5,0,0,0,1
Port Adelaide,"Surjan, Jacob",11,8,7,3,0,0,0,3
Port Adelaide,"Trengove, Jackson",15,6,2,9,0,0,0,4
Port Adelaide,"Westhoff, Justin",17,8,3,9,0,0,2,0
Port Adelaide,"Young, Aaron",6,5,2,1,1,0,0,2
Port Adelaide,"Boak, Travis",23,9,2,14,0,0,0,5
Port Adelaide,"Broadbent, Matthew",17,5,2,12,2,1,1,6
Port Adelaide,"Butcher, John",8,4,2,4,2,1,0,1
Port Adelaide,"Carlile, Alipate",19,5,6,14,0,0,0,1
Port Adelaide,"Cassisi, Domenic",20,11,1,9,0,0,0,4
Port Adelaide,"Chaplin, Troy",25,18,8,7,0,0,0,1
Port Adelaide,"Cornes, Kane",24,15,4,9,0,1,0,3
Port Adelaide,"Ebert, Brad",22,12,6,10,1,0,1,11
Port Adelaide,"Ebert, Brett",6,4,2,2,0,0,0,1
Port Adelaide,"Hartlett, Hamish",15,3,4,12,0,0,0,6
Port Adelaide,"Jacobs, Ben",19,9,4,10,0,0,0,0
Port Adelaide,"Logan, Tom",21,9,7,12,0,0,0,4
Port Adelaide,"McCarthy, John",30,19,6,11,0,1,0,3
Port Adelaide,"Phillips, Simon",6,1,0,5,0,0,0,2
Port Adelaide,"Renouf, Brent",11,4,4,7,0,0,21,3
Port Adelaide,"Rodan, David",17,8,1,9,0,0,1,6
Port Adelaide,"Stewart, Daniel",8,5,3,3,0,0,9,1
Port Adelaide,"Stewart, Paul",16,10,5,6,1,0,0,6
Port Adelaide,"Surjan, Jacob",10,5,3,5,0,0,0,5
Port Adelaide,"Trengove, Jackson",23,12,8,11,0,0,0,1
Port Adelaide,"Westhoff, Justin",12,9,4,3,1,0,3,4
Port Adelaide,"Young, Aaron",11,5,1,6,0,0,0,2
Port Adelaide,"Boak, Travis",16,9,3,7,0,1,0,5
Port Adelaide,"Broadbent, Matthew",21,14,2,7,1,0,0,1
Port Adelaide,"Butcher, John",2,2,0,0,0,0,0,3
Port Adelaide,"Carlile, Alipate",17,8,1,9,0,0,0,1
Port Adelaide,"Cassisi, Domenic",18,9,5,9,0,0,0,3
Port Adelaide,"Chaplin, Troy",13,8,5,5,0,0,0,0
Port Adelaide,"Cornes, Kane",13,6,3,7,1,1,0,3
Port Adelaide,"Ebert, Brad",22,10,3,12,0,0,0,6
Port Adelaide,"Ebert, Brett",11,9,6,2,1,0,0,5
Port Adelaide,"Hartlett, Hamish",19,13,3,6,0,0,0,4
Port Adelaide,"Jacobs, Ben",17,7,5,10,1,0,0,4
Port Adelaide,"McCarthy, John",21,13,4,8,1,2,0,5
Port Adelaide,"Pearce, Danyle",30,22,2,8,0,0,0,3
Port Adelaide,"Pfeiffer, Darren",20,11,8,9,0,1,0,5
Port Adelaide,"Renouf, Brent",8,4,3,4,0,0,42,0
Port Adelaide,"Schulz, Jay",12,11,9,1,7,0,0,0
Port Adelaide,"Stewart, Paul",5,5,3,0,1,0,0,4
Port Adelaide,"Surjan, Jacob",18,9,6,9,0,0,0,1
Port Adelaide,"Thomas, Matt",16,8,5,8,0,2,0,6
Port Adelaide,"Trengove, Jackson",11,4,3,7,0,0,2,4
Port Adelaide,"Westhoff, Justin",8,5,4,3,1,1,6,4
Port Adelaide,"Wingard, Chad",10,4,1,6,0,0,1,3
Port Adelaide,"Boak, Travis",28,16,4,12,3,0,0,0
Port Adelaide,"Broadbent, Matthew",25,16,5,9,2,0,1,6
Port Adelaide,"Carlile, Alipate",10,3,2,7,0,0,0,1
Port Adelaide,"Cassisi, Domenic",15,7,1,8,0,0,0,2
Port Adelaide,"Chaplin, Troy",15,10,5,5,0,0,0,1
Port Adelaide,"Cornes, Kane",24,10,4,14,2,0,0,3
Port Adelaide,"Ebert, Brad",29,20,2,9,2,1,1,7
Port Adelaide,"Ebert, Brett",13,8,4,5,2,0,0,3
Port Adelaide,"Hartlett, Hamish",22,9,6,13,0,0,0,5
Port Adelaide,"Jacobs, Ben",21,7,4,14,0,0,0,1
Port Adelaide,"McCarthy, John",19,10,2,9,1,1,0,4
Port Adelaide,"Pearce, Danyle",28,18,4,10,1,1,0,4
Port Adelaide,"Pfeiffer, Darren",8,5,0,3,0,0,0,2
Port Adelaide,"Renouf, Brent",8,2,4,6,0,0,42,1
Port Adelaide,"Schulz, Jay",14,12,8,2,1,5,0,5
Port Adelaide,"Stewart, Daniel",3,3,1,0,1,0,5,3
Port Adelaide,"Stewart, Paul",8,5,4,3,0,0,0,3
Port Adelaide,"Surjan, Jacob",12,8,3,4,0,0,0,1
Port Adelaide,"Thomas, Matt",16,5,3,11,0,0,1,3
Port Adelaide,"Trengove, Jackson",20,10,6,10,1,0,0,6
Port Adelaide,"Westhoff, Justin",14,12,5,2,1,1,5,1
Port Adelaide,"Wingard, Chad",14,6,0,8,0,2,1,6
Port Adelaide,"Boak, Travis",18,10,2,8,0,0,0,3
Port Adelaide,"Broadbent, Matthew",31,25,6,6,2,1,1,3
Port Adelaide,"Carlile, Alipate",9,5,1,4,0,0,0,4
Port Adelaide,"Cassisi, Domenic",13,10,2,3,0,0,0,3
Port Adelaide,"Chaplin, Troy",18,13,8,5,0,0,0,1
Port Adelaide,"Cornes, Kane",28,15,7,13,0,1,0,6
Port Adelaide,"Ebert, Brad",20,12,3,8,0,0,0,14
Port Adelaide,"Ebert, Brett",18,12,4,6,1,1,0,4
Port Adelaide,"Hartlett, Hamish",26,16,4,10,3,1,0,9
Port Adelaide,"Jacobs, Ben",18,12,5,6,0,0,0,1
Port Adelaide,"Moore, Andrew",2,2,0,0,0,0,0,0
Port Adelaide,"Pearce, Danyle",19,18,3,1,1,2,0,7
Port Adelaide,"Pfeiffer, Darren",13,10,6,3,0,0,0,3
Port Adelaide,"Redden, Jarrad",14,4,0,10,0,0,15,4
Port Adelaide,"Renouf, Brent",6,5,1,1,0,1,24,1
Port Adelaide,"Schulz, Jay",13,10,7,3,3,0,0,2
Port Adelaide,"Stewart, Paul",17,7,2,10,1,1,0,3
Port Adelaide,"Surjan, Jacob",6,4,3,2,0,0,0,1
Port Adelaide,"Thomas, Matt",19,5,4,14,1,0,0,4
Port Adelaide,"Trengove, Jackson",16,11,7,5,0,0,0,0
Port Adelaide,"Westhoff, Justin",14,8,3,6,1,1,0,6
Port Adelaide,"Wingard, Chad",17,9,1,8,1,1,1,3
Port Adelaide,"Broadbent, Matthew",25,16,8,9,0,1,0,3
Port Adelaide,"Carlile, Alipate",9,7,3,2,0,0,0,2
Port Adelaide,"Cassisi, Domenic",10,8,0,2,0,0,0,2
Port Adelaide,"Chaplin, Troy",7,6,3,1,0,0,0,1
Port Adelaide,"Cornes, Kane",29,19,10,10,0,0,0,4
Port Adelaide,"Ebert, Brad",23,16,5,7,0,0,0,10
Port Adelaide,"Ebert, Brett",15,10,4,5,0,1,0,1
Port Adelaide,"Hartlett, Hamish",12,8,3,4,0,0,0,9
Port Adelaide,"Hitchcock, Cameron",3,2,1,1,1,0,0,0
Port Adelaide,"Jacobs, Ben",15,11,4,4,0,0,0,3
Port Adelaide,"McCarthy, John",18,9,6,9,0,0,0,2
Port Adelaide,"Moore, Andrew",21,10,5,11,1,0,0,3
Port Adelaide,"Pearce, Danyle",15,11,1,4,0,0,0,4
Port Adelaide,"Pfeiffer, Darren",15,5,3,10,0,0,0,0
Port Adelaide,"Redden, Jarrad",9,4,4,5,0,0,9,0
Port Adelaide,"Renouf, Brent",7,4,2,3,0,0,39,4
Port Adelaide,"Schulz, Jay",11,7,5,4,3,1,0,3
Port Adelaide,"Stewart, Paul",8,5,1,3,2,0,0,3
Port Adelaide,"Surjan, Jacob",13,9,1,4,0,0,0,2
Port Adelaide,"Trengove, Jackson",9,3,3,6,0,0,5,6
Port Adelaide,"Westhoff, Justin",14,10,5,4,1,0,1,2
Port Adelaide,"Wingard, Chad",10,3,2,7,1,0,0,4
Port Adelaide,"Broadbent, Matthew",26,18,5,8,1,1,0,4
Port Adelaide,"Cassisi, Domenic",14,8,1,6,0,0,0,4
Port Adelaide,"Chaplin, Troy",19,13,7,6,0,0,0,4
Port Adelaide,"Cornes, Kane",25,10,2,15,0,0,0,3
Port Adelaide,"Ebert, Brad",23,10,2,13,1,0,0,7
Port Adelaide,"Ebert, Brett",12,8,8,4,2,2,0,3
Port Adelaide,"Hartlett, Hamish",11,3,1,8,0,1,0,1
Port Adelaide,"Jacobs, Ben",17,12,4,5,0,0,0,2
Port Adelaide,"Logan, Tom",10,2,2,8,0,0,0,0
Port Adelaide,"McCarthy, John",24,18,6,6,0,2,0,3
Port Adelaide,"Moore, Andrew",12,8,4,4,1,0,0,3
Port Adelaide,"Pearce, Danyle",24,14,0,10,0,0,0,2
Port Adelaide,"Pfeiffer, Darren",18,10,4,8,0,0,0,0
Port Adelaide,"Redden, Jarrad",7,2,2,5,0,0,16,2
Port Adelaide,"Renouf, Brent",4,1,1,3,0,0,8,3
Port Adelaide,"Schulz, Jay",13,10,6,3,3,1,0,6
Port Adelaide,"Stewart, Paul",16,8,3,8,0,0,0,1
Port Adelaide,"Surjan, Jacob",11,4,2,7,0,0,0,2
Port Adelaide,"Thomas, Matt",10,6,1,4,0,0,0,6
Port Adelaide,"Trengove, Jackson",6,1,3,5,0,0,0,3
Port Adelaide,"Westhoff, Justin",18,12,7,6,0,0,0,5
Port Adelaide,"Wingard, Chad",6,2,1,4,0,0,1,2
Port Adelaide,"Broadbent, Matthew",21,12,2,9,0,1,0,4
Port Adelaide,"Butcher, John",8,5,0,3,0,2,0,5
Port Adelaide,"Carlile, Alipate",13,7,0,6,0,0,0,3
Port Adelaide,"Chaplin, Troy",14,7,7,7,0,0,2,3
Port Adelaide,"Cornes, Kane",24,12,4,12,1,0,0,3
Port Adelaide,"Ebert, Brad",21,12,2,9,0,1,0,8
Port Adelaide,"Ebert, Brett",4,3,2,1,1,0,0,2
Port Adelaide,"Jacobs, Ben",14,8,5,6,0,0,0,3
Port Adelaide,"Jonas, Tom",14,6,2,8,0,0,0,1
Port Adelaide,"Lobbe, Matthew",7,4,1,3,2,0,32,9
Port Adelaide,"Logan, Tom",22,10,3,12,0,0,0,1
Port Adelaide,"McCarthy, John",26,17,7,9,0,0,0,6
Port Adelaide,"Moore, Andrew",20,11,2,9,0,0,0,11
Port Adelaide,"OShea, Cameron",10,7,4,3,0,0,0,2
Port Adelaide,"Pearce, Danyle",25,21,2,4,0,0,0,2
Port Adelaide,"Pfeiffer, Darren",10,4,0,6,1,0,0,3
Port Adelaide,"Renouf, Brent",4,1,2,3,0,0,25,2
Port Adelaide,"Rodan, David",16,7,1,9,0,0,0,6
Port Adelaide,"Stewart, Paul",13,9,3,4,0,1,0,3
Port Adelaide,"Westhoff, Justin",10,4,2,6,2,0,0,2
Port Adelaide,"Wingard, Chad",13,6,0,7,1,1,0,5
Port Adelaide,"Young, Aaron",6,2,2,4,0,1,0,1
Port Adelaide,"Boak, Travis",25,13,1,12,1,3,0,5
Port Adelaide,"Broadbent, Matthew",14,10,4,4,0,0,1,3
Port Adelaide,"Butcher, John",4,2,1,2,1,1,0,2
Port Adelaide,"Carlile, Alipate",11,8,5,3,0,0,0,0
Port Adelaide,"Chaplin, Troy",22,15,10,7,0,1,0,5
Port Adelaide,"Cornes, Kane",17,8,2,9,0,0,0,3
Port Adelaide,"Ebert, Brad",20,12,5,8,0,1,1,4
Port Adelaide,"Ebert, Brett",7,6,2,1,1,0,0,1
Port Adelaide,"Jacobs, Ben",5,2,2,3,0,0,0,3
Port Adelaide,"Jonas, Tom",11,5,2,6,0,0,0,3
Port Adelaide,"Lobbe, Matthew",13,8,4,5,0,1,12,4
Port Adelaide,"Logan, Tom",10,6,6,4,0,0,0,3
Port Adelaide,"McCarthy, John",16,8,1,8,0,0,0,2
Port Adelaide,"Moore, Andrew",14,9,2,5,0,0,1,4
Port Adelaide,"Pearce, Danyle",15,9,0,6,0,0,0,4
Port Adelaide,"Pfeiffer, Darren",18,11,5,7,0,1,0,4
Port Adelaide,"Stewart, Paul",14,12,8,2,4,0,0,3
Port Adelaide,"Surjan, Jacob",8,5,2,3,0,0,0,2
Port Adelaide,"Trengove, Jackson",9,4,3,5,0,0,5,3
Port Adelaide,"Westhoff, Justin",15,11,7,4,0,0,3,1
Port Adelaide,"Wingard, Chad",6,2,2,4,1,0,0,1
Port Adelaide,"Young, Aaron",9,5,3,4,0,0,0,2
Port Adelaide,"Boak, Travis",29,11,4,18,0,1,0,4
Port Adelaide,"Broadbent, Matthew",26,14,1,12,0,1,1,1
Port Adelaide,"Carlile, Alipate",18,10,4,8,0,0,0,1
Port Adelaide,"Chaplin, Troy",12,8,4,4,0,0,0,2
Port Adelaide,"Cornes, Kane",25,8,4,17,0,0,0,2
Port Adelaide,"Ebert, Brad",25,15,4,10,0,1,0,6
Port Adelaide,"Ebert, Brett",21,12,6,9,3,1,0,1
Port Adelaide,"Jonas, Tom",4,0,0,4,0,0,0,2
Port Adelaide,"Lobbe, Matthew",6,3,2,3,0,0,9,4
Port Adelaide,"Logan, Tom",19,10,5,9,0,1,0,1
Port Adelaide,"McCarthy, John",20,14,6,6,1,1,1,0
Port Adelaide,"Moore, Andrew",18,8,3,10,0,1,0,7
Port Adelaide,"Pearce, Danyle",27,18,2,9,0,0,0,1
Port Adelaide,"Pfeiffer, Darren",21,10,3,11,0,0,0,0
Port Adelaide,"Redden, Jarrad",15,4,4,11,0,0,18,3
Port Adelaide,"Stewart, Daniel",13,10,6,3,2,1,0,0
Port Adelaide,"Stewart, Paul",15,9,7,6,1,1,0,2
Port Adelaide,"Thomas, Matt",15,8,5,7,1,0,0,3
Port Adelaide,"Trengove, Jackson",19,6,2,13,0,0,0,1
Port Adelaide,"Westhoff, Justin",20,12,5,8,3,0,1,2
Port Adelaide,"Wingard, Chad",6,3,1,3,0,0,1,0
Port Adelaide,"Young, Aaron",12,3,0,9,0,1,0,0
Port Adelaide,"Boak, Travis",28,17,1,11,1,2,0,0
Port Adelaide,"Broadbent, Matthew",19,10,1,9,1,0,0,2
Port Adelaide,"Carlile, Alipate",16,9,4,7,0,0,1,0
Port Adelaide,"Cassisi, Domenic",30,13,4,17,0,0,0,5
Port Adelaide,"Chaplin, Troy",19,11,6,8,0,0,0,2
Port Adelaide,"Cornes, Kane",23,10,3,13,0,0,0,2
Port Adelaide,"Ebert, Brad",26,16,7,10,0,1,0,4
Port Adelaide,"Ebert, Brett",13,9,8,4,1,1,0,0
Port Adelaide,"Jonas, Tom",12,6,3,6,0,0,0,3
Port Adelaide,"Lobbe, Matthew",13,6,2,7,1,0,18,1
Port Adelaide,"Logan, Tom",21,9,5,12,0,0,0,1
Port Adelaide,"McCarthy, John",9,6,2,3,0,0,0,2
Port Adelaide,"Moore, Andrew",11,5,1,6,0,0,0,3
Port Adelaide,"Pearce, Danyle",26,17,3,9,0,0,0,1
Port Adelaide,"Pittard, Jasper",3,0,1,3,0,0,0,0
Port Adelaide,"Stewart, Daniel",9,6,2,3,1,1,8,0
Port Adelaide,"Stewart, Paul",15,11,5,4,5,0,0,2
Port Adelaide,"Thomas, Matt",14,5,0,9,0,1,0,3
Port Adelaide,"Trengove, Jackson",9,6,1,3,0,0,0,2
Port Adelaide,"Westhoff, Justin",22,13,7,9,0,1,6,2
Port Adelaide,"Wingard, Chad",16,4,1,12,1,0,0,3
Port Adelaide,"Young, Aaron",6,2,0,4,1,0,0,3
Port Adelaide,"Boak, Travis",22,13,1,9,1,1,0,5
Port Adelaide,"Broadbent, Matthew",18,10,2,8,0,0,0,5
Port Adelaide,"Carlile, Alipate",15,11,3,4,0,0,0,1
Port Adelaide,"Cassisi, Domenic",25,7,5,18,0,0,0,5
Port Adelaide,"Chaplin, Troy",13,5,4,8,0,0,1,2
Port Adelaide,"Cornes, Kane",31,15,6,16,1,0,0,2
Port Adelaide,"Ebert, Brad",18,9,3,9,0,1,0,4
Port Adelaide,"Ebert, Brett",10,7,5,3,2,2,0,2
Port Adelaide,"Jonas, Tom",11,7,2,4,0,0,0,6
Port Adelaide,"Lobbe, Matthew",13,6,4,7,0,0,22,6
Port Adelaide,"Logan, Tom",13,4,1,9,0,0,0,1
Port Adelaide,"McCarthy, John",20,9,1,11,0,0,2,5
Port Adelaide,"Moore, Andrew",22,10,2,12,0,0,0,2
Port Adelaide,"Pearce, Danyle",22,14,4,8,0,0,0,2
Port Adelaide,"Pfeiffer, Darren",19,7,5,12,0,0,0,1
Port Adelaide,"Stewart, Daniel",8,7,6,1,1,1,0,0
Port Adelaide,"Stewart, Paul",10,5,5,5,0,0,0,2
Port Adelaide,"Thomas, Matt",13,4,3,9,0,0,0,3
Port Adelaide,"Trengove, Jackson",12,5,1,7,0,1,2,2
Port Adelaide,"Westhoff, Justin",20,10,4,10,1,1,4,3
Port Adelaide,"Wingard, Chad",19,8,3,11,0,0,0,0
Port Adelaide,"Young, Aaron",7,3,1,4,0,0,0,0
Port Adelaide,"Boak, Travis",20,12,3,8,0,1,0,2
Port Adelaide,"Broadbent, Matthew",19,12,8,7,0,0,1,2
Port Adelaide,"Carlile, Alipate",16,4,3,12,0,0,0,1
Port Adelaide,"Cassisi, Domenic",17,9,4,8,0,0,0,3
Port Adelaide,"Cornes, Kane",28,16,7,12,0,0,0,1
Port Adelaide,"Ebert, Brad",26,15,3,11,1,0,0,5
Port Adelaide,"Ebert, Brett",10,8,4,2,3,1,0,1
Port Adelaide,"Hartlett, Hamish",27,16,5,11,1,0,0,0
Port Adelaide,"Jonas, Tom",17,6,2,11,0,0,0,3
Port Adelaide,"Lobbe, Matthew",12,5,4,7,0,0,17,4
Port Adelaide,"Logan, Tom",10,7,5,3,0,0,0,0
Port Adelaide,"McCarthy, John",15,8,4,7,0,0,0,3
Port Adelaide,"Moore, Andrew",11,5,5,6,1,0,0,2
Port Adelaide,"Pearce, Danyle",24,17,1,7,0,0,0,4
Port Adelaide,"Schulz, Jay",6,4,2,2,2,1,0,2
Port Adelaide,"Stewart, Daniel",7,6,5,1,0,3,0,0
Port Adelaide,"Stewart, Paul",15,10,5,5,1,0,0,1
Port Adelaide,"Thomas, Matt",25,12,9,13,0,2,0,1
Port Adelaide,"Trengove, Jackson",18,8,5,10,0,0,0,0
Port Adelaide,"Westhoff, Justin",20,11,7,9,1,2,2,2
Port Adelaide,"Wingard, Chad",15,4,3,11,0,0,0,2
Port Adelaide,"Young, Aaron",0,0,0,0,0,0,0,1
Port Adelaide,"Blee, Nathan",5,2,1,3,0,0,0,0
Port Adelaide,"Boak, Travis",32,17,2,15,1,0,0,3
Port Adelaide,"Broadbent, Matthew",14,7,2,7,2,1,1,1
Port Adelaide,"Cassisi, Domenic",15,12,3,3,0,0,0,6
Port Adelaide,"Chaplin, Troy",6,3,1,3,0,0,0,0
Port Adelaide,"Cornes, Kane",22,10,3,12,0,0,0,3
Port Adelaide,"Ebert, Brad",27,12,5,15,1,0,0,2
Port Adelaide,"Ebert, Brett",11,9,5,2,2,2,0,0
Port Adelaide,"Hartlett, Hamish",16,12,5,4,0,0,0,2
Port Adelaide,"Lobbe, Matthew",9,6,3,3,1,1,15,3
Port Adelaide,"Logan, Tom",17,7,6,10,0,0,0,1
Port Adelaide,"McCarthy, John",6,2,0,4,0,0,0,1
Port Adelaide,"Moore, Andrew",8,3,2,5,0,0,0,2
Port Adelaide,"Pearce, Danyle",26,17,0,9,0,1,0,0
Port Adelaide,"Pfeiffer, Darren",7,2,3,5,0,0,0,2
Port Adelaide,"Redden, Jarrad",10,5,1,5,0,0,13,6
Port Adelaide,"Rodan, David",13,6,3,7,0,0,0,1
Port Adelaide,"Schulz, Jay",14,9,8,5,4,1,0,1
Port Adelaide,"Stewart, Paul",13,8,4,5,1,0,0,1
Port Adelaide,"Thomas, Matt",15,5,5,10,0,0,0,3
Port Adelaide,"Trengove, Jackson",12,7,7,5,0,0,1,2
Port Adelaide,"Westhoff, Justin",14,8,6,6,1,1,2,2
Port Adelaide,"Blee, Nathan",9,5,3,4,0,0,0,1
Port Adelaide,"Broadbent, Matthew",21,14,6,7,0,0,2,1
Port Adelaide,"Carlile, Alipate",13,7,3,6,0,0,0,0
Port Adelaide,"Cassisi, Domenic",23,13,6,10,0,1,1,1
Port Adelaide,"Cornes, Kane",32,16,10,16,0,1,0,5
Port Adelaide,"Ebert, Brad",20,11,6,9,0,1,0,4
Port Adelaide,"Ebert, Brett",15,12,8,3,1,2,0,1
Port Adelaide,"Jonas, Tom",10,7,4,3,0,0,0,2
Port Adelaide,"Lobbe, Matthew",10,4,2,6,0,0,10,0
Port Adelaide,"McCarthy, John",22,11,5,11,0,0,0,2
Port Adelaide,"Moore, Andrew",16,7,1,9,0,0,0,1
Port Adelaide,"Pearce, Danyle",24,20,6,4,1,0,0,4
Port Adelaide,"Pfeiffer, Darren",10,5,3,5,0,0,1,3
Port Adelaide,"Rodan, David",13,7,1,6,0,0,0,1
Port Adelaide,"Schulz, Jay",12,9,6,3,2,4,0,3
Port Adelaide,"Stewart, Daniel",6,5,4,1,0,1,2,1
Port Adelaide,"Stewart, Paul",6,3,3,3,0,0,0,0
Port Adelaide,"Thomas, Matt",12,5,3,7,0,0,0,5
Port Adelaide,"Trengove, Jackson",18,11,7,7,0,0,0,2
Port Adelaide,"Westhoff, Justin",24,12,9,12,1,0,2,2
Port Adelaide,"Wingard, Chad",11,9,4,2,1,1,1,3
Port Adelaide,"Young, Aaron",12,6,5,6,0,0,0,6
Port Adelaide,"Blee, Nathan",2,1,0,1,0,0,0,0
Port Adelaide,"Boak, Travis",24,16,2,8,1,0,0,9
Port Adelaide,"Broadbent, Matthew",18,11,3,7,3,0,1,1
Port Adelaide,"Carlile, Alipate",18,15,6,3,0,0,0,0
Port Adelaide,"Cassisi, Domenic",21,12,4,9,0,0,0,4
Port Adelaide,"Cornes, Kane",28,12,5,16,0,0,0,4
Port Adelaide,"Ebert, Brad",32,24,3,8,0,0,0,4
Port Adelaide,"Ebert, Brett",9,5,2,4,1,0,0,3
Port Adelaide,"Jonas, Tom",9,4,1,5,0,0,0,3
Port Adelaide,"Lobbe, Matthew",10,4,1,6,1,0,29,5
Port Adelaide,"Logan, Tom",13,8,1,5,0,0,0,3
Port Adelaide,"McCarthy, John",10,5,2,5,0,0,0,1
Port Adelaide,"Pearce, Danyle",10,8,2,2,0,1,0,0
Port Adelaide,"Pfeiffer, Darren",10,7,2,3,0,0,0,1
Port Adelaide,"Rodan, David",10,6,2,4,0,0,0,1
Port Adelaide,"Schulz, Jay",14,11,8,3,2,3,0,3
Port Adelaide,"Stewart, Paul",9,6,3,3,1,0,0,1
Port Adelaide,"Thomas, Matt",9,6,3,3,1,2,0,4
Port Adelaide,"Trengove, Jackson",11,8,0,3,0,1,5,3
Port Adelaide,"Westhoff, Justin",9,6,0,3,2,0,14,9
Port Adelaide,"Wingard, Chad",27,16,5,11,1,0,1,0
Port Adelaide,"Young, Aaron",12,5,1,7,1,0,0,2
Port Adelaide,"Blee, Nathan",11,5,2,6,0,0,0,1
Port Adelaide,"Boak, Travis",21,16,1,5,0,0,0,5
Port Adelaide,"Broadbent, Matthew",23,14,3,9,2,0,0,3
Port Adelaide,"Carlile, Alipate",7,5,1,2,0,0,0,4
Port Adelaide,"Cassisi, Domenic",21,7,3,14,0,1,0,3
Port Adelaide,"Cornes, Kane",29,18,8,11,0,1,0,2
Port Adelaide,"Ebert, Brad",22,15,3,7,3,2,0,3
Port Adelaide,"Ebert, Brett",16,11,6,5,2,2,0,1
Port Adelaide,"Hartlett, Hamish",19,5,3,14,0,0,0,6
Port Adelaide,"Jonas, Tom",7,6,5,1,0,0,0,0
Port Adelaide,"Logan, Tom",19,5,7,14,0,0,1,1
Port Adelaide,"McCarthy, John",9,3,2,6,0,0,0,3
Port Adelaide,"Pearce, Danyle",19,16,1,3,1,1,0,2
Port Adelaide,"Pfeiffer, Darren",9,3,0,6,0,0,0,1
Port Adelaide,"Redden, Jarrad",9,1,2,8,0,0,29,6
Port Adelaide,"Rodan, David",9,4,1,5,1,0,0,1
Port Adelaide,"Schulz, Jay",14,11,12,3,4,1,0,1
Port Adelaide,"Thomas, Matt",14,5,7,9,1,0,0,3
Port Adelaide,"Trengove, Jackson",9,1,2,8,0,0,1,2
Port Adelaide,"Westhoff, Justin",15,10,4,5,0,0,6,2
Port Adelaide,"Wingard, Chad",16,9,4,7,1,0,0,4
Port Adelaide,"Young, Aaron",13,8,6,5,1,0,0,4
Richmond,"Conca, Reece",8,6,2,2,0,0,0,3
Richmond,"Cotchin, Trent",27,17,1,10,2,0,1,8
Richmond,"Deledio, Brett",21,11,5,10,0,0,1,7
Richmond,"Edwards, Shane",12,6,0,6,0,1,0,4
Richmond,"Ellis, Brandon",9,6,2,3,0,0,0,2
Richmond,"Foley, Nathan",25,14,3,11,0,0,0,4
Richmond,"Grigg, Shaun",20,14,2,6,2,0,0,0
Richmond,"Grimes, Dylan",11,9,2,2,0,0,0,2
Richmond,"Houli, Bachar",20,9,5,11,0,0,0,1
Richmond,"Jackson, Daniel",17,11,4,6,0,0,0,1
Richmond,"Maric, Addam",12,6,2,6,0,1,0,2
Richmond,"Maric, Ivan",18,8,5,10,0,0,25,0
Richmond,"Martin, Dustin",16,11,2,5,2,1,1,4
Richmond,"Miller, Brad",9,4,5,5,0,1,1,3
Richmond,"Morris, Steven",9,1,1,8,0,0,0,2
Richmond,"Nahas, Robin",8,6,1,2,1,1,0,5
Richmond,"Newman, Chris",14,9,3,5,0,0,0,5
Richmond,"Post, Jayden",9,5,3,4,0,0,0,1
Richmond,"Rance, Alex",21,11,3,10,0,0,0,1
Richmond,"Riewoldt, Jack",16,11,3,5,4,3,0,5
Richmond,"Tuck, Shane",15,1,3,14,0,0,0,2
Richmond,"Vickery, Ty",3,2,1,1,1,0,9,3
Richmond,"Batchelor, Jake",23,13,9,10,0,0,0,2
Richmond,"Conca, Reece",21,14,9,7,1,1,1,0
Richmond,"Cotchin, Trent",26,14,4,12,0,0,0,2
Richmond,"Deledio, Brett",35,17,5,18,2,1,2,5
Richmond,"Edwards, Shane",17,8,2,9,1,1,0,0
Richmond,"Ellis, Brandon",18,10,5,8,0,0,0,0
Richmond,"Foley, Nathan",14,7,3,7,0,0,0,7
Richmond,"Grigg, Shaun",30,12,8,18,0,1,3,1
Richmond,"Grimes, Dylan",20,14,12,6,0,0,0,2
Richmond,"Houli, Bachar",26,16,9,10,0,1,0,6
Richmond,"Jackson, Daniel",18,11,4,7,0,0,0,1
Richmond,"King, Jake",4,2,1,2,0,0,0,0
Richmond,"Maric, Ivan",11,4,4,7,0,1,18,2
Richmond,"Martin, Dustin",21,13,4,8,0,1,0,3
Richmond,"Miller, Brad",7,5,5,2,4,1,0,0
Richmond,"Morris, Steven",21,10,5,11,0,0,0,2
Richmond,"Nahas, Robin",12,3,3,9,0,0,0,3
Richmond,"Newman, Chris",25,18,15,7,0,0,0,2
Richmond,"Rance, Alex",34,21,17,13,0,0,0,0
Richmond,"Riewoldt, Jack",12,8,2,4,0,3,0,0
Richmond,"Tuck, Shane",25,11,5,14,0,0,1,6
Richmond,"Vickery, Ty",7,3,2,4,0,2,8,3
Richmond,"Batchelor, Jake",14,8,6,6,0,0,0,3
Richmond,"Conca, Reece",29,16,8,13,2,0,0,5
Richmond,"Cotchin, Trent",22,14,5,8,3,1,0,4
Richmond,"Deledio, Brett",27,14,7,13,2,0,2,2
Richmond,"Edwards, Shane",16,8,0,8,0,1,0,4
Richmond,"Ellis, Brandon",17,7,5,10,0,0,0,3
Richmond,"Foley, Nathan",28,16,6,12,0,2,0,8
Richmond,"Grigg, Shaun",37,19,12,18,1,0,0,2
Richmond,"Grimes, Dylan",18,9,9,9,0,0,0,2
Richmond,"Houli, Bachar",29,13,7,16,1,0,0,1
Richmond,"Jackson, Daniel",21,12,7,9,1,0,0,3
Richmond,"Maric, Addam",2,1,0,1,0,0,0,0
Richmond,"Maric, Ivan",13,2,3,11,1,0,24,6
Richmond,"Martin, Dustin",19,13,2,6,1,0,0,1
Richmond,"Miller, Brad",10,5,4,5,3,0,0,1
Richmond,"Morris, Steven",18,3,3,15,0,0,0,3
Richmond,"Nahas, Robin",21,16,4,5,2,2,0,4
Richmond,"Newman, Chris",20,14,4,6,0,0,0,2
Richmond,"Rance, Alex",17,11,9,6,0,0,0,3
Richmond,"Riewoldt, Jack",14,8,6,6,1,3,0,1
Richmond,"Tuck, Shane",30,15,6,15,1,1,1,11
Richmond,"Vickery, Ty",5,4,1,1,1,0,4,2
Richmond,"Batchelor, Jake",23,10,6,13,0,0,0,3
Richmond,"Conca, Reece",21,11,5,10,0,1,1,5
Richmond,"Cotchin, Trent",24,14,3,10,0,0,0,9
Richmond,"Deledio, Brett",31,19,4,12,0,1,0,2
Richmond,"Ellis, Brandon",19,11,3,8,0,1,0,5
Richmond,"Foley, Nathan",24,8,4,16,1,0,0,5
Richmond,"Grigg, Shaun",28,13,5,15,1,0,1,2
Richmond,"Grimes, Dylan",14,7,6,7,0,0,0,1
Richmond,"Houli, Bachar",22,10,5,12,0,0,0,1
Richmond,"Jackson, Daniel",14,6,1,8,1,1,1,4
Richmond,"Maric, Addam",7,2,0,5,0,0,0,2
Richmond,"Maric, Ivan",15,5,1,10,1,0,38,1
Richmond,"Martin, Dustin",23,10,5,13,0,2,0,7
Richmond,"Miller, Brad",8,3,3,5,0,1,1,1
Richmond,"Morris, Steven",17,2,1,15,0,0,0,5
Richmond,"Nahas, Robin",16,11,2,5,2,0,0,2
Richmond,"Newman, Chris",23,14,7,9,0,1,0,2
Richmond,"Rance, Alex",19,11,4,8,0,0,0,1
Richmond,"Riewoldt, Jack",11,4,3,7,1,0,0,2
Richmond,"Tuck, Shane",27,11,5,16,0,0,0,9
Richmond,"Vickery, Ty",8,3,2,5,1,0,5,3
Richmond,"White, Matt",3,2,0,1,1,0,0,1
Richmond,"Batchelor, Jake",16,9,8,7,0,0,0,2
Richmond,"Conca, Reece",14,8,1,6,0,0,0,3
Richmond,"Cotchin, Trent",29,17,6,12,1,1,0,2
Richmond,"Dea, Matt",2,0,0,2,0,0,0,1
Richmond,"Deledio, Brett",26,15,8,11,0,1,1,2
Richmond,"Ellis, Brandon",12,5,2,7,1,0,0,1
Richmond,"Foley, Nathan",27,12,7,15,0,0,0,7
Richmond,"Grigg, Shaun",26,12,8,14,0,0,0,1
Richmond,"Grimes, Dylan",13,6,7,7,0,0,0,1
Richmond,"Houli, Bachar",18,14,5,4,0,0,0,4
Richmond,"Jackson, Daniel",14,8,6,6,2,0,1,1
Richmond,"Maric, Ivan",12,6,6,6,1,0,26,4
Richmond,"Martin, Dustin",26,17,3,9,2,3,0,3
Richmond,"Miller, Brad",8,7,5,1,3,1,0,2
Richmond,"Morris, Steven",9,6,2,3,0,0,0,5
Richmond,"Nahas, Robin",12,3,2,9,0,0,0,6
Richmond,"Newman, Chris",23,13,7,10,0,0,0,0
Richmond,"Rance, Alex",14,9,6,5,0,0,0,2
Richmond,"Riewoldt, Jack",15,12,5,3,2,3,0,3
Richmond,"Tuck, Shane",17,9,2,8,0,0,0,6
Richmond,"Vickery, Ty",12,7,6,5,2,2,2,2
Richmond,"White, Matt",3,3,2,0,0,0,0,0
Richmond,"Batchelor, Jake",20,10,5,10,0,0,0,1
Richmond,"Conca, Reece",20,10,5,10,1,0,0,2
Richmond,"Cotchin, Trent",18,8,2,10,0,0,0,4
Richmond,"Dea, Matt",18,6,4,12,0,0,0,3
Richmond,"Deledio, Brett",24,15,3,9,1,1,3,6
Richmond,"Edwards, Shane",8,6,0,2,0,1,0,2
Richmond,"Ellis, Brandon",18,6,3,12,0,1,0,1
Richmond,"Foley, Nathan",19,9,1,10,0,0,0,7
Richmond,"Grigg, Shaun",25,11,4,14,0,0,4,3
Richmond,"Grimes, Dylan",17,11,5,6,0,0,0,1
Richmond,"Houli, Bachar",23,10,1,13,0,0,0,2
Richmond,"King, Jake",12,6,3,6,2,0,0,1
Richmond,"Maric, Ivan",20,13,5,7,0,1,46,4
Richmond,"Martin, Dustin",24,13,7,11,0,2,0,1
Richmond,"Miller, Brad",10,6,4,4,1,0,0,3
Richmond,"Morris, Steven",21,11,5,10,0,0,0,1
Richmond,"Nahas, Robin",19,12,3,7,3,1,0,4
Richmond,"Newman, Chris",11,8,6,3,1,0,0,2
Richmond,"Rance, Alex",24,14,4,10,0,0,0,3
Richmond,"Riewoldt, Jack",12,11,6,1,4,2,0,3
Richmond,"Tuck, Shane",28,11,5,17,0,2,0,5
Richmond,"Vickery, Ty",4,2,2,2,0,0,4,1
Richmond,"Batchelor, Jake",14,6,3,8,0,0,0,2
Richmond,"Conca, Reece",17,10,4,7,1,0,0,5
Richmond,"Cotchin, Trent",27,15,2,12,0,0,1,5
Richmond,"Dea, Matt",14,3,3,11,0,0,0,3
Richmond,"Deledio, Brett",25,13,5,12,1,1,1,4
Richmond,"Edwards, Shane",20,7,4,13,0,0,1,1
Richmond,"Ellis, Brandon",3,0,0,3,0,0,0,0
Richmond,"Foley, Nathan",25,11,1,14,0,1,0,8
Richmond,"Grigg, Shaun",26,18,7,8,3,0,1,1
Richmond,"Grimes, Dylan",24,18,13,6,0,0,0,2
Richmond,"Houli, Bachar",26,11,5,15,0,0,0,2
Richmond,"Jackson, Daniel",18,10,10,8,0,0,0,3
Richmond,"King, Jake",8,6,4,2,0,0,0,1
Richmond,"Maric, Ivan",17,8,4,9,1,1,28,3
Richmond,"Martin, Dustin",24,13,2,11,1,1,1,4
Richmond,"Miller, Brad",10,9,8,1,2,0,3,1
Richmond,"Morris, Steven",18,11,6,7,0,0,0,2
Richmond,"Nahas, Robin",16,10,5,6,0,1,0,6
Richmond,"Newman, Chris",25,16,5,9,0,0,0,1
Richmond,"Rance, Alex",27,20,12,7,0,0,0,1
Richmond,"Riewoldt, Jack",9,8,5,1,4,4,1,3
Richmond,"Tuck, Shane",24,10,6,14,0,0,0,8
Richmond,"Batchelor, Jake",14,11,9,3,0,1,0,1
Richmond,"Conca, Reece",14,8,7,6,0,1,0,1
Richmond,"Cotchin, Trent",29,20,7,9,3,1,0,6
Richmond,"Dea, Matt",9,2,3,7,0,0,0,1
Richmond,"Deledio, Brett",35,19,7,16,1,2,2,10
Richmond,"Edwards, Shane",17,9,4,8,3,1,0,4
Richmond,"Ellis, Brandon",10,5,2,5,0,1,0,3
Richmond,"Foley, Nathan",24,9,6,15,0,1,0,2
Richmond,"Grigg, Shaun",30,21,9,9,2,1,2,1
Richmond,"Grimes, Dylan",8,4,3,4,0,0,0,0
Richmond,"Houli, Bachar",16,11,4,5,0,0,0,2
Richmond,"Jackson, Daniel",22,12,3,10,1,2,0,3
Richmond,"King, Jake",9,6,2,3,0,1,0,3
Richmond,"Maric, Ivan",22,11,9,11,0,0,29,4
Richmond,"Martin, Dustin",21,13,2,8,2,3,0,2
Richmond,"Miller, Brad",13,9,5,4,1,1,0,3
Richmond,"Morris, Steven",8,6,3,2,0,0,0,2
Richmond,"Nahas, Robin",13,5,3,8,1,0,0,5
Richmond,"Newman, Chris",8,5,3,3,0,0,0,3
Richmond,"Rance, Alex",14,9,4,5,0,0,0,5
Richmond,"Riewoldt, Jack",8,3,2,5,1,0,0,3
Richmond,"Tuck, Shane",26,12,7,14,0,0,0,0
Richmond,"Conca, Reece",21,15,3,6,0,0,0,1
Richmond,"Cotchin, Trent",31,19,5,12,1,0,0,3
Richmond,"Dea, Matt",13,10,6,3,0,0,0,0
Richmond,"Deledio, Brett",32,13,7,19,1,0,1,8
Richmond,"Edwards, Shane",21,9,5,12,2,1,0,0
Richmond,"Ellis, Brandon",17,7,2,10,0,1,0,1
Richmond,"Foley, Nathan",27,16,4,11,0,1,0,10
Richmond,"Griffiths, Ben",16,6,0,10,0,0,0,0
Richmond,"Grigg, Shaun",24,14,3,10,0,0,2,6
Richmond,"Houli, Bachar",19,14,6,5,0,0,0,0
Richmond,"Jackson, Daniel",16,9,1,7,2,0,0,5
Richmond,"King, Jake",13,8,3,5,3,0,0,4
Richmond,"Maric, Addam",8,2,2,6,0,0,0,1
Richmond,"Maric, Ivan",18,9,5,9,1,0,27,7
Richmond,"Martin, Dustin",32,11,3,21,2,0,0,2
Richmond,"Morris, Steven",11,4,3,7,1,0,0,3
Richmond,"Nahas, Robin",13,10,4,3,1,2,0,1
Richmond,"Newman, Chris",23,15,7,8,0,1,0,1
Richmond,"Rance, Alex",18,8,7,10,0,0,0,2
Richmond,"Riewoldt, Jack",16,13,7,3,6,2,1,7
Richmond,"Tuck, Shane",35,15,8,20,1,0,0,10
Richmond,"Vickery, Ty",6,5,2,1,0,1,11,5
Richmond,"Batchelor, Jake",22,12,5,10,0,0,0,4
Richmond,"Conca, Reece",19,9,3,10,0,0,0,1
Richmond,"Cotchin, Trent",29,14,1,15,0,1,0,6
Richmond,"Deledio, Brett",29,16,6,13,1,2,1,1
Richmond,"Edwards, Shane",18,6,2,12,2,0,0,1
Richmond,"Ellis, Brandon",16,8,3,8,1,1,0,0
Richmond,"Foley, Nathan",20,8,3,12,0,1,0,0
Richmond,"Griffiths, Ben",10,3,2,7,0,0,0,1
Richmond,"Grigg, Shaun",26,14,9,12,0,0,1,2
Richmond,"Houli, Bachar",15,8,4,7,0,0,0,2
Richmond,"Jackson, Daniel",15,7,3,8,0,0,0,3
Richmond,"King, Jake",11,5,5,6,0,0,0,1
Richmond,"Maric, Addam",4,3,1,1,0,0,0,2
Richmond,"Maric, Ivan",20,8,7,12,1,0,33,4
Richmond,"Martin, Dustin",26,12,0,14,1,2,1,0
Richmond,"Morris, Steven",20,11,4,9,0,0,0,0
Richmond,"Nahas, Robin",18,8,2,10,2,1,0,4
Richmond,"Newman, Chris",19,15,6,4,0,0,0,2
Richmond,"Rance, Alex",18,9,6,9,0,0,0,1
Richmond,"Riewoldt, Jack",20,15,9,5,8,3,0,3
Richmond,"Tuck, Shane",24,9,3,15,1,0,0,2
Richmond,"Vickery, Ty",16,9,3,7,1,0,7,0
Richmond,"Batchelor, Jake",10,6,3,4,0,0,0,2
Richmond,"Conca, Reece",16,10,1,6,0,0,0,4
Richmond,"Cotchin, Trent",30,22,6,8,1,2,0,3
Richmond,"Dea, Matt",16,10,5,6,0,0,0,2
Richmond,"Deledio, Brett",15,11,1,4,0,0,0,9
Richmond,"Edwards, Shane",16,8,0,8,3,1,0,5
Richmond,"Ellis, Brandon",18,10,3,8,0,0,0,2
Richmond,"Griffiths, Ben",8,1,2,7,0,0,0,4
Richmond,"Grigg, Shaun",24,16,2,8,0,1,4,3
Richmond,"Houli, Bachar",20,11,5,9,0,0,0,4
Richmond,"Jackson, Daniel",20,12,1,8,0,2,0,12
Richmond,"Maric, Addam",16,7,2,9,0,0,0,1
Richmond,"Maric, Ivan",11,7,2,4,0,0,44,5
Richmond,"Martin, Dustin",20,11,1,9,1,0,0,2
Richmond,"Morris, Steven",19,11,1,8,0,0,0,1
Richmond,"Nahas, Robin",12,8,3,4,1,1,0,6
Richmond,"Newman, Chris",16,13,4,3,0,0,0,1
Richmond,"OHanlon, Brett",8,6,2,2,0,0,0,1
Richmond,"Rance, Alex",16,6,1,10,0,0,0,4
Richmond,"Riewoldt, Jack",12,7,3,5,1,2,1,3
Richmond,"Tuck, Shane",29,15,3,14,1,0,3,8
Richmond,"Vickery, Ty",12,6,2,6,1,0,9,2
Richmond,"Batchelor, Jake",7,5,1,2,0,0,0,2
Richmond,"Conca, Reece",22,12,3,10,0,1,0,5
Richmond,"Connors, Daniel",12,11,6,1,3,1,0,1
Richmond,"Cotchin, Trent",25,15,1,10,1,0,0,3
Richmond,"Dea, Matt",15,6,4,9,0,0,0,2
Richmond,"Deledio, Brett",30,19,3,11,1,1,2,2
Richmond,"Edwards, Shane",16,14,1,2,2,4,0,1
Richmond,"Ellis, Brandon",19,15,4,4,0,0,0,2
Richmond,"Griffiths, Ben",7,4,1,3,0,0,0,2
Richmond,"Grigg, Shaun",22,14,2,8,0,1,0,4
Richmond,"Houli, Bachar",27,12,3,15,0,0,0,1
Richmond,"Jackson, Daniel",17,11,2,6,1,3,0,3
Richmond,"King, Jake",10,6,3,4,0,1,0,1
Richmond,"Maric, Ivan",16,12,4,4,0,0,34,6
Richmond,"Martin, Dustin",19,12,2,7,0,3,1,7
Richmond,"Miller, Brad",10,5,4,5,0,0,5,2
Richmond,"Nahas, Robin",13,10,1,3,0,1,0,6
Richmond,"Newman, Chris",9,8,1,1,0,0,0,7
Richmond,"OHanlon, Brett",1,0,0,1,0,0,0,1
Richmond,"Rance, Alex",16,9,2,7,0,0,0,1
Richmond,"Riewoldt, Jack",9,6,1,3,3,0,0,3
Richmond,"Tuck, Shane",29,14,4,15,0,1,1,6
Richmond,"Connors, Daniel",5,3,1,2,1,1,0,2
Richmond,"Cotchin, Trent",25,15,3,10,1,0,0,7
Richmond,"Dea, Matt",14,8,8,6,0,0,0,3
Richmond,"Deledio, Brett",29,14,7,15,1,1,1,3
Richmond,"Edwards, Shane",23,9,1,14,2,0,1,4
Richmond,"Ellis, Brandon",13,7,3,6,0,0,0,2
Richmond,"Elton, Todd",4,3,2,1,0,1,0,4
Richmond,"Griffiths, Ben",17,11,7,6,0,0,0,1
Richmond,"Grigg, Shaun",23,14,5,9,1,0,2,3
Richmond,"Grimes, Dylan",20,15,10,5,0,0,0,3
Richmond,"Houli, Bachar",15,9,3,6,0,0,0,0
Richmond,"Jackson, Daniel",30,16,7,14,0,0,0,4
Richmond,"King, Jake",13,7,4,6,0,0,0,2
Richmond,"Maric, Ivan",17,8,8,9,0,1,39,4
Richmond,"Martin, Dustin",23,15,4,8,3,1,0,5
Richmond,"Miller, Brad",11,6,4,5,0,0,6,3
Richmond,"Morris, Steven",15,9,1,6,0,0,0,3
Richmond,"Nahas, Robin",12,7,3,5,1,0,0,3
Richmond,"Newman, Chris",18,13,6,5,0,0,0,1
Richmond,"Rance, Alex",8,4,2,4,0,0,0,2
Richmond,"Riewoldt, Jack",10,8,3,2,3,0,0,5
Richmond,"Tuck, Shane",31,15,6,16,0,2,4,9
Richmond,"Batchelor, Jake",8,4,4,4,0,0,0,1
Richmond,"Conca, Reece",23,12,1,11,0,1,0,6
Richmond,"Cotchin, Trent",28,13,2,15,0,0,0,8
Richmond,"Dea, Matt",10,4,4,6,0,0,0,1
Richmond,"Deledio, Brett",23,15,5,8,2,0,0,5
Richmond,"Derickx, Tom",6,2,0,4,0,0,11,5
Richmond,"Edwards, Shane",21,7,4,14,1,2,0,3
Richmond,"Ellis, Brandon",21,9,2,12,0,1,0,3
Richmond,"Griffiths, Ben",12,7,1,5,0,0,1,0
Richmond,"Grigg, Shaun",35,18,6,17,1,1,1,2
Richmond,"Houli, Bachar",27,17,6,10,0,1,0,3
Richmond,"Maric, Addam",4,3,2,1,0,1,0,1
Richmond,"Maric, Ivan",18,6,4,12,0,1,22,5
Richmond,"McGuane, Luke",13,8,4,5,2,2,1,3
Richmond,"Morris, Steven",18,13,4,5,0,0,0,1
Richmond,"Nahas, Robin",18,8,3,10,4,1,0,2
Richmond,"Newman, Chris",15,10,5,5,0,0,0,4
Richmond,"OHanlon, Brett",11,7,5,4,0,1,0,3
Richmond,"Rance, Alex",13,9,4,4,0,0,0,2
Richmond,"Riewoldt, Jack",16,12,7,4,1,5,0,4
Richmond,"Tuck, Shane",23,8,7,15,1,1,2,9
Richmond,"White, Matt",16,9,3,7,1,2,0,2
Richmond,"Batchelor, Jake",11,6,1,5,0,0,0,1
Richmond,"Conca, Reece",23,13,3,10,0,0,0,1
Richmond,"Cotchin, Trent",38,20,10,18,0,1,0,4
Richmond,"Dea, Matt",12,7,4,5,0,0,0,3
Richmond,"Deledio, Brett",36,24,8,12,0,1,0,5
Richmond,"Derickx, Tom",7,3,2,4,0,0,2,0
Richmond,"Edwards, Shane",17,9,2,8,0,3,0,2
Richmond,"Ellis, Brandon",24,17,12,7,0,0,0,2
Richmond,"Graham, Angus",11,6,3,5,1,0,19,2
Richmond,"Grigg, Shaun",24,13,8,11,0,0,1,2
Richmond,"Houli, Bachar",21,17,10,4,0,0,0,0
Richmond,"Maric, Addam",21,10,3,11,1,0,0,3
Richmond,"McGuane, Luke",11,7,4,4,2,0,0,5
Richmond,"Moore, Kelvin",19,13,11,6,0,0,0,0
Richmond,"Morris, Steven",18,13,6,5,0,0,0,3
Richmond,"Nahas, Robin",13,10,1,3,4,1,0,5
Richmond,"Newman, Chris",12,7,4,5,0,0,0,1
Richmond,"OHanlon, Brett",11,6,5,5,0,0,0,4
Richmond,"Rance, Alex",18,11,10,7,0,0,0,5
Richmond,"Riewoldt, Jack",16,14,6,2,5,2,1,3
Richmond,"Tuck, Shane",24,13,4,11,0,0,0,5
Richmond,"Webberley, Jeromey",4,2,1,2,0,0,0,1
Richmond,"Conca, Reece",21,15,2,6,0,0,0,5
Richmond,"Cotchin, Trent",24,18,3,6,1,1,0,5
Richmond,"Dea, Matt",10,3,4,7,0,0,0,1
Richmond,"Deledio, Brett",31,16,6,15,0,0,1,2
Richmond,"Edwards, Shane",16,7,7,9,2,1,0,1
Richmond,"Ellis, Brandon",21,12,5,9,0,1,0,0
Richmond,"Grigg, Shaun",20,12,6,8,0,1,3,0
Richmond,"Houli, Bachar",10,8,3,2,1,0,0,4
Richmond,"Jackson, Daniel",23,15,4,8,0,3,0,5
Richmond,"Maric, Addam",7,4,3,3,0,0,0,3
Richmond,"Maric, Ivan",15,6,2,9,0,0,34,4
Richmond,"Martin, Dustin",22,13,3,9,2,2,0,4
Richmond,"McGuane, Luke",12,7,2,5,0,2,2,6
Richmond,"Moore, Kelvin",14,9,5,5,0,0,0,1
Richmond,"Morris, Steven",23,10,4,13,0,0,0,3
Richmond,"Nahas, Robin",8,5,1,3,3,0,0,2
Richmond,"Newman, Chris",15,9,1,6,0,0,0,2
Richmond,"OHanlon, Brett",3,1,1,2,0,0,0,0
Richmond,"Post, Jayden",14,5,4,9,0,0,0,0
Richmond,"Rance, Alex",25,16,9,9,0,0,0,0
Richmond,"Riewoldt, Jack",12,8,6,4,3,2,0,3
Richmond,"Tuck, Shane",26,14,4,12,2,0,0,4
Richmond,"Conca, Reece",14,7,4,7,0,0,0,3
Richmond,"Cotchin, Trent",24,18,4,6,3,0,0,3
Richmond,"Dea, Matt",11,5,3,6,0,0,0,2
Richmond,"Deledio, Brett",22,16,3,6,0,1,3,7
Richmond,"Edwards, Shane",18,8,1,10,0,3,0,8
Richmond,"Ellis, Brandon",20,13,1,7,0,1,0,3
Richmond,"Grigg, Shaun",22,13,2,9,1,0,1,4
Richmond,"Houli, Bachar",17,9,3,8,0,0,0,5
Richmond,"Jackson, Daniel",19,11,3,8,0,0,0,2
Richmond,"King, Jake",14,8,2,6,0,0,0,5
Richmond,"Maric, Addam",2,2,0,0,0,0,0,3
Richmond,"Maric, Ivan",15,7,2,8,0,0,49,3
Richmond,"Martin, Dustin",19,13,1,6,3,1,0,5
Richmond,"McGuane, Luke",7,3,2,4,1,0,4,3
Richmond,"Moore, Kelvin",6,2,2,4,0,0,0,1
Richmond,"Morris, Steven",9,7,2,2,0,1,0,1
Richmond,"Nahas, Robin",9,6,1,3,2,1,0,7
Richmond,"Newman, Chris",9,6,1,3,1,0,0,3
Richmond,"Post, Jayden",5,4,4,1,0,0,0,0
Richmond,"Rance, Alex",14,11,3,3,0,0,0,6
Richmond,"Riewoldt, Jack",11,8,4,3,0,2,0,1
Richmond,"Tuck, Shane",31,16,3,15,2,1,1,5
Richmond,"Conca, Reece",29,17,7,12,0,0,0,5
Richmond,"Cotchin, Trent",21,18,3,3,1,1,0,7
Richmond,"Deledio, Brett",33,23,6,10,1,0,1,3
Richmond,"Edwards, Shane",23,9,4,14,1,2,0,1
Richmond,"Ellis, Brandon",13,8,5,5,0,0,0,1
Richmond,"Griffiths, Ben",6,4,4,2,0,0,0,0
Richmond,"Grigg, Shaun",26,17,9,9,2,0,2,1
Richmond,"Helbig, Brad",4,3,1,1,0,0,0,1
Richmond,"Houli, Bachar",20,16,7,4,1,0,0,4
Richmond,"Jackson, Daniel",18,11,4,7,2,0,1,6
Richmond,"King, Jake",14,7,7,7,0,0,0,4
Richmond,"Maric, Ivan",16,7,3,9,1,0,41,6
Richmond,"Martin, Dustin",24,18,0,6,1,0,0,2
Richmond,"McGuane, Luke",10,4,1,6,3,0,2,5
Richmond,"Morris, Steven",11,4,3,7,0,0,0,0
Richmond,"Nahas, Robin",11,5,3,6,3,2,0,2
Richmond,"Newman, Chris",8,7,2,1,0,0,0,0
Richmond,"Post, Jayden",10,5,3,5,0,0,0,1
Richmond,"Rance, Alex",14,8,7,6,0,0,0,1
Richmond,"Riewoldt, Jack",14,11,8,3,2,3,1,0
Richmond,"Tuck, Shane",24,11,1,13,1,0,1,4
Richmond,"White, Matt",16,8,5,8,1,0,0,2
Richmond,"Conca, Reece",17,9,5,8,0,0,0,2
Richmond,"Cotchin, Trent",35,22,7,13,3,1,0,4
Richmond,"Deledio, Brett",31,16,4,15,0,1,1,7
Richmond,"Edwards, Shane",22,13,4,9,4,4,0,3
Richmond,"Ellis, Brandon",13,7,5,6,0,0,0,1
Richmond,"Griffiths, Ben",4,3,2,1,0,0,0,1
Richmond,"Grigg, Shaun",27,20,11,7,2,2,0,0
Richmond,"Helbig, Brad",6,4,3,2,0,0,0,1
Richmond,"Houli, Bachar",25,19,7,6,0,0,0,0
Richmond,"Jackson, Daniel",16,12,7,4,0,0,0,1
Richmond,"King, Jake",20,12,6,8,2,1,0,0
Richmond,"Maric, Ivan",11,5,6,6,0,0,29,2
Richmond,"Martin, Dustin",30,12,6,18,1,0,0,0
Richmond,"McGuane, Luke",13,8,5,5,3,1,2,1
Richmond,"Morris, Steven",15,11,7,4,0,0,0,3
Richmond,"Nahas, Robin",9,4,2,5,1,0,0,3
Richmond,"Newman, Chris",22,18,10,4,1,1,0,2
Richmond,"Post, Jayden",6,5,4,1,0,0,0,0
Richmond,"Rance, Alex",19,12,8,7,0,0,0,3
Richmond,"Riewoldt, Jack",20,16,9,4,5,2,0,0
Richmond,"Tuck, Shane",21,9,7,12,0,2,0,3
Richmond,"White, Matt",12,5,2,7,0,0,0,1
Richmond,"Cotchin, Trent",32,16,1,16,0,1,0,4
Richmond,"Deledio, Brett",14,7,1,7,2,0,0,7
Richmond,"Edwards, Shane",13,8,2,5,1,0,0,6
Richmond,"Ellis, Brandon",11,7,5,4,0,0,0,3
Richmond,"Griffiths, Ben",3,2,2,1,0,0,0,0
Richmond,"Grigg, Shaun",25,16,6,9,0,1,0,3
Richmond,"Helbig, Brad",13,7,4,6,0,0,0,2
Richmond,"Houli, Bachar",23,10,3,13,0,0,0,2
Richmond,"Jackson, Daniel",16,6,3,10,0,0,0,4
Richmond,"King, Jake",15,7,6,8,3,0,0,2
Richmond,"Maric, Ivan",16,5,4,11,0,0,18,3
Richmond,"Martin, Dustin",22,15,2,7,0,0,0,3
Richmond,"McGuane, Luke",11,5,2,6,0,3,1,3
Richmond,"Morris, Steven",16,11,6,5,0,0,0,2
Richmond,"Nahas, Robin",13,7,4,6,1,0,0,2
Richmond,"Newman, Chris",18,10,5,8,0,1,0,2
Richmond,"OHanlon, Brett",8,2,1,6,1,0,0,1
Richmond,"Post, Jayden",19,5,8,14,0,0,0,1
Richmond,"Rance, Alex",11,5,3,6,0,0,0,3
Richmond,"Riewoldt, Jack",10,6,2,4,2,0,0,1
Richmond,"Tuck, Shane",28,12,9,16,0,0,0,8
Richmond,"White, Matt",20,8,3,12,1,0,0,5
Richmond,"Astbury, David",4,2,2,2,1,0,0,2
Richmond,"Batchelor, Jake",18,13,6,5,0,0,0,3
Richmond,"Cotchin, Trent",31,24,10,7,0,5,0,5
Richmond,"Dea, Matt",13,9,4,4,0,0,0,0
Richmond,"Deledio, Brett",33,18,4,15,1,1,1,3
Richmond,"Edwards, Shane",22,6,3,16,2,0,0,0
Richmond,"Grigg, Shaun",21,10,4,11,1,0,0,1
Richmond,"Helbig, Brad",16,4,4,12,0,0,0,0
Richmond,"Houli, Bachar",26,11,5,15,0,1,0,3
Richmond,"Jackson, Daniel",17,6,1,11,0,1,0,1
Richmond,"Maric, Ivan",19,10,7,9,0,1,17,3
Richmond,"Martin, Dustin",25,16,10,9,1,0,0,4
Richmond,"McGuane, Luke",10,6,5,4,2,1,1,3
Richmond,"Morris, Steven",19,10,6,9,0,0,0,1
Richmond,"Nahas, Robin",13,6,4,7,1,0,0,4
Richmond,"Newman, Chris",21,14,7,7,0,1,0,4
Richmond,"OHanlon, Brett",14,9,5,5,1,3,0,0
Richmond,"Post, Jayden",18,8,6,10,0,0,0,1
Richmond,"Rance, Alex",17,11,7,6,0,0,0,1
Richmond,"Riewoldt, Jack",17,12,10,5,3,5,2,2
Richmond,"Tuck, Shane",33,21,11,12,0,1,0,2
Richmond,"White, Matt",5,3,1,2,0,0,0,0
Richmond,"Astbury, David",8,4,3,4,1,0,0,2
Richmond,"Batchelor, Jake",15,8,4,7,0,0,0,1
Richmond,"Cotchin, Trent",31,19,6,12,0,0,0,5
Richmond,"Dea, Matt",8,5,1,3,0,0,0,1
Richmond,"Deledio, Brett",23,8,5,15,0,0,0,2
Richmond,"Edwards, Shane",19,10,3,9,3,0,0,6
Richmond,"Ellis, Brandon",18,13,8,5,0,0,0,1
Richmond,"Grigg, Shaun",20,11,5,9,1,1,0,2
Richmond,"Helbig, Brad",2,0,0,2,0,0,0,0
Richmond,"Houli, Bachar",26,15,4,11,0,0,0,1
Richmond,"Jackson, Daniel",24,11,3,13,0,1,0,4
Richmond,"Maric, Ivan",13,11,1,2,0,0,31,3
Richmond,"Martin, Dustin",11,6,4,5,0,1,0,1
Richmond,"McGuane, Luke",9,5,6,4,2,1,0,2
Richmond,"Morris, Steven",20,9,5,11,0,1,0,3
Richmond,"Nahas, Robin",17,10,3,7,1,2,0,1
Richmond,"Newman, Chris",12,10,5,2,0,0,0,4
Richmond,"OHanlon, Brett",7,6,2,1,0,0,0,4
Richmond,"Post, Jayden",13,6,6,7,1,0,0,2
Richmond,"Rance, Alex",18,11,8,7,0,0,0,1
Richmond,"Riewoldt, Jack",11,10,7,1,6,2,1,2
Richmond,"Tuck, Shane",26,14,8,12,1,0,0,2
St Kilda,"Armitage, David",10,3,1,7,0,0,0,8
St Kilda,"Blake, Jason",15,12,8,3,0,0,0,1
St Kilda,"Cripps, Jamie",6,5,2,1,0,0,0,6
St Kilda,"Dal Santo, Nick",28,20,3,8,2,0,1,4
St Kilda,"Dempster, Sean",19,13,7,6,0,0,0,1
St Kilda,"Fisher, Sam",19,15,7,4,0,0,0,0
St Kilda,"Geary, Jarryn",23,14,6,9,0,0,0,1
St Kilda,"Gilbert, Sam",18,12,10,6,0,1,0,1
St Kilda,"Goddard, Brendon",29,19,6,10,0,0,0,1
St Kilda,"Hayes, Lenny",16,8,2,8,0,2,1,11
St Kilda,"Jones, Clinton",14,6,4,8,1,0,0,6
St Kilda,"Koschitzke, Justin",6,5,4,1,3,0,2,2
St Kilda,"McEvoy, Ben",12,9,10,3,0,0,25,1
St Kilda,"Milera, Terry",17,10,6,7,1,0,0,3
St Kilda,"Milne, Stephen",12,10,4,2,2,2,0,1
St Kilda,"Montagna, Leigh",16,13,4,3,1,0,0,3
St Kilda,"Peake, Brett",11,6,5,5,0,0,0,4
St Kilda,"Polo, Dean",16,8,5,8,0,0,0,2
St Kilda,"Ray, Farren",2,1,0,1,0,0,0,0
St Kilda,"Riewoldt, Nick",16,13,5,3,2,1,0,2
St Kilda,"Stanley, Rhys",11,8,6,3,1,0,11,4
St Kilda,"Steven, Jack",22,15,9,7,0,0,0,9
St Kilda,"Armitage, David",22,11,2,11,2,0,0,10
St Kilda,"Blake, Jason",18,10,7,8,0,0,0,3
St Kilda,"Cripps, Jamie",6,5,3,1,1,1,0,1
St Kilda,"Dal Santo, Nick",26,13,1,13,0,0,2,6
St Kilda,"Dempster, Sean",20,15,5,5,0,0,0,1
St Kilda,"Fisher, Sam",25,19,9,6,0,0,1,3
St Kilda,"Geary, Jarryn",17,11,4,6,1,0,0,4
St Kilda,"Gilbert, Sam",19,11,6,8,1,0,0,2
St Kilda,"Goddard, Brendon",33,19,9,14,1,2,0,5
St Kilda,"Hayes, Lenny",27,13,2,14,0,1,0,4
St Kilda,"Jones, Clinton",24,10,1,14,1,0,0,7
St Kilda,"Koschitzke, Justin",12,6,4,6,2,0,3,5
St Kilda,"Ledger, Tom",8,4,1,4,0,0,0,4
St Kilda,"McEvoy, Ben",14,5,6,9,1,0,27,1
St Kilda,"Milera, Terry",15,12,6,3,2,2,0,3
St Kilda,"Milne, Stephen",10,9,4,1,2,2,0,3
St Kilda,"Montagna, Leigh",25,16,6,9,0,0,0,5
St Kilda,"Newnes, Jack",9,5,3,4,0,0,0,1
St Kilda,"Riewoldt, Nick",21,15,11,6,4,2,1,4
St Kilda,"Simpkin, Tom",14,11,4,3,0,0,0,2
St Kilda,"Stanley, Rhys",18,13,7,5,2,1,6,2
St Kilda,"Steven, Jack",22,11,5,11,1,1,0,6
St Kilda,"Armitage, David",19,9,1,10,1,0,1,8
St Kilda,"Blake, Jason",16,9,8,7,0,0,1,5
St Kilda,"Cripps, Jamie",7,6,4,1,0,0,0,1
St Kilda,"Dal Santo, Nick",23,10,1,13,1,2,1,3
St Kilda,"Dempster, Sean",23,18,14,5,0,0,0,5
St Kilda,"Fisher, Sam",20,13,6,7,0,0,0,1
St Kilda,"Geary, Jarryn",23,19,5,4,0,1,0,4
St Kilda,"Gilbert, Sam",7,3,0,4,0,1,0,2
St Kilda,"Goddard, Brendon",23,12,10,11,2,1,1,3
St Kilda,"Hayes, Lenny",30,14,7,16,0,1,0,8
St Kilda,"Jones, Clinton",24,12,6,12,0,0,0,3
St Kilda,"Koschitzke, Justin",10,8,6,2,1,0,1,1
St Kilda,"McEvoy, Ben",9,5,5,4,1,0,18,3
St Kilda,"Milera, Terry",15,8,5,7,0,0,0,2
St Kilda,"Milne, Stephen",13,12,4,1,3,1,0,1
St Kilda,"Montagna, Leigh",27,19,7,8,1,0,0,4
St Kilda,"Newnes, Jack",15,11,8,4,0,0,0,2
St Kilda,"Polo, Dean",17,13,4,4,1,0,0,1
St Kilda,"Riewoldt, Nick",13,7,6,6,2,2,1,2
St Kilda,"Simpkin, Tom",20,17,9,3,0,0,0,5
St Kilda,"Stanley, Rhys",14,10,6,4,1,3,8,4
St Kilda,"Steven, Jack",24,13,6,11,1,0,0,1
St Kilda,"Armitage, David",16,10,4,6,0,1,0,4
St Kilda,"Blake, Jason",20,9,5,11,0,0,0,2
St Kilda,"Cripps, Jamie",4,4,1,0,1,1,0,1
St Kilda,"Dal Santo, Nick",18,8,3,10,1,0,1,4
St Kilda,"Dempster, Sean",13,8,5,5,0,0,1,5
St Kilda,"Fisher, Sam",17,9,6,8,0,1,0,2
St Kilda,"Geary, Jarryn",23,15,5,8,0,0,0,2
St Kilda,"Gilbert, Sam",19,12,6,7,2,0,0,5
St Kilda,"Goddard, Brendon",27,19,4,8,0,2,0,1
St Kilda,"Hayes, Lenny",30,13,3,17,0,1,0,7
St Kilda,"Jones, Clinton",23,10,3,13,0,0,0,9
St Kilda,"Koschitzke, Justin",14,8,8,6,3,0,2,1
St Kilda,"McEvoy, Ben",11,8,5,3,1,0,15,5
St Kilda,"Milera, Terry",15,7,5,8,0,1,0,0
St Kilda,"Milne, Stephen",9,7,0,2,1,1,0,3
St Kilda,"Montagna, Leigh",24,16,3,8,0,0,0,3
St Kilda,"Newnes, Jack",12,6,2,6,0,0,0,1
St Kilda,"Polo, Dean",15,6,4,9,0,0,1,1
St Kilda,"Riewoldt, Nick",16,11,6,5,1,1,1,1
St Kilda,"Simpkin, Tom",10,4,0,6,0,0,0,3
St Kilda,"Stanley, Rhys",8,5,4,3,1,1,7,1
St Kilda,"Steven, Jack",21,14,4,7,0,1,0,3
St Kilda,"Armitage, David",28,16,4,12,0,0,0,9
St Kilda,"Blake, Jason",8,3,2,5,0,0,0,4
St Kilda,"Cripps, Jamie",12,8,0,4,0,0,0,5
St Kilda,"Dal Santo, Nick",29,16,0,13,0,1,0,4
St Kilda,"Dempster, Sean",13,12,5,1,0,0,0,3
St Kilda,"Fisher, Sam",23,14,5,9,0,0,0,0
St Kilda,"Geary, Jarryn",6,2,2,4,0,0,0,0
St Kilda,"Gilbert, Sam",10,5,2,5,0,0,0,3
St Kilda,"Goddard, Brendon",15,10,1,5,0,2,0,4
St Kilda,"Gram, Jason",21,10,2,11,0,0,0,4
St Kilda,"Hayes, Lenny",25,18,3,7,1,0,1,8
St Kilda,"Jones, Clinton",11,6,0,5,0,0,0,11
St Kilda,"Maister, Beau",5,4,4,1,3,1,0,2
St Kilda,"McEvoy, Ben",14,8,3,6,0,0,27,3
St Kilda,"Milera, Terry",12,7,0,5,0,0,1,6
St Kilda,"Milne, Stephen",11,10,4,1,2,3,0,3
St Kilda,"Montagna, Leigh",21,9,0,12,1,0,0,7
St Kilda,"Polo, Dean",9,6,1,3,0,0,1,2
St Kilda,"Riewoldt, Nick",13,8,3,5,2,3,0,5
St Kilda,"Simpkin, Tom",9,5,1,4,0,0,0,3
St Kilda,"Stanley, Rhys",12,9,6,3,1,0,6,1
St Kilda,"Steven, Jack",18,14,2,4,2,0,0,11
St Kilda,"Armitage, David",11,7,2,4,0,1,0,2
St Kilda,"Blake, Jason",15,5,5,10,0,0,18,3
St Kilda,"Dal Santo, Nick",14,10,2,4,0,0,0,4
St Kilda,"Dempster, Sean",9,7,4,2,0,0,0,3
St Kilda,"Fisher, Sam",14,11,4,3,1,0,0,0
St Kilda,"Geary, Jarryn",15,6,4,9,0,0,0,1
St Kilda,"Gilbert, Sam",17,10,4,7,0,0,0,5
St Kilda,"Goddard, Brendon",26,17,6,9,0,0,1,0
St Kilda,"Gram, Jason",24,14,6,10,0,0,0,1
St Kilda,"Hayes, Lenny",24,14,3,10,0,0,1,7
St Kilda,"Jones, Clinton",17,5,2,12,0,0,0,4
St Kilda,"Koschitzke, Justin",14,8,7,6,5,0,7,0
St Kilda,"Milera, Terry",9,7,2,2,1,0,1,3
St Kilda,"Milne, Stephen",11,7,3,4,1,1,0,4
St Kilda,"Montagna, Leigh",17,12,5,5,0,0,0,5
St Kilda,"Polo, Dean",17,11,8,6,0,0,0,2
St Kilda,"Riewoldt, Nick",14,10,5,4,3,2,0,4
St Kilda,"Saad, Ahmed",5,2,0,3,1,0,0,2
St Kilda,"Simpkin, Tom",14,7,2,7,0,0,0,2
St Kilda,"Siposs, Arryn",11,8,4,3,0,0,0,3
St Kilda,"Stanley, Rhys",7,4,2,3,1,1,7,4
St Kilda,"Steven, Jack",21,12,2,9,0,2,0,3
St Kilda,"Armitage, David",21,17,5,4,2,0,0,3
St Kilda,"Blake, Jason",15,8,5,7,0,0,0,4
St Kilda,"Dal Santo, Nick",21,14,6,7,0,0,0,10
St Kilda,"Dempster, Sean",22,12,11,10,0,0,0,1
St Kilda,"Geary, Jarryn",12,6,1,6,0,0,0,1
St Kilda,"Gilbert, Sam",10,8,1,2,0,0,0,4
St Kilda,"Goddard, Brendon",24,18,5,6,1,0,0,0
St Kilda,"Gram, Jason",22,17,8,5,0,1,0,2
St Kilda,"Hayes, Lenny",22,8,4,14,1,0,1,8
St Kilda,"Jones, Clinton",16,7,3,9,0,0,0,4
St Kilda,"Koschitzke, Justin",11,6,4,5,1,0,9,2
St Kilda,"Maister, Beau",8,5,2,3,0,0,0,1
St Kilda,"Milera, Terry",14,11,1,3,3,3,0,2
St Kilda,"Milne, Stephen",13,11,4,2,4,0,0,2
St Kilda,"Montagna, Leigh",24,16,4,8,0,0,0,7
St Kilda,"Ray, Farren",27,18,8,9,1,0,0,2
St Kilda,"Riewoldt, Nick",12,10,7,2,1,3,0,2
St Kilda,"Saad, Ahmed",10,3,0,7,2,0,0,3
St Kilda,"Simpkin, Tom",11,6,6,5,0,0,0,0
St Kilda,"Siposs, Arryn",4,3,3,1,0,0,0,0
St Kilda,"Stanley, Rhys",9,5,3,4,2,1,15,5
St Kilda,"Steven, Jack",19,14,4,5,1,0,0,3
St Kilda,"Armitage, David",13,8,6,5,1,1,0,3
St Kilda,"Blake, Jason",15,3,2,12,0,0,8,1
St Kilda,"Cripps, Jamie",12,5,3,7,2,0,0,1
St Kilda,"Dal Santo, Nick",23,13,2,10,1,1,1,3
St Kilda,"Dempster, Sean",14,12,4,2,0,0,0,1
St Kilda,"Geary, Jarryn",14,6,2,8,0,0,0,1
St Kilda,"Gilbert, Sam",15,11,2,4,1,0,0,4
St Kilda,"Goddard, Brendon",22,13,5,9,0,0,2,5
St Kilda,"Gram, Jason",21,11,5,10,0,0,0,1
St Kilda,"Hayes, Lenny",28,10,5,18,0,0,0,3
St Kilda,"Jones, Clinton",15,8,2,7,0,0,0,6
St Kilda,"Koschitzke, Justin",10,9,5,1,0,0,8,2
St Kilda,"Maister, Beau",5,4,2,1,0,0,0,1
St Kilda,"Milera, Terry",10,5,3,5,1,0,2,1
St Kilda,"Milne, Stephen",16,12,4,4,1,3,0,1
St Kilda,"Montagna, Leigh",26,15,2,11,0,2,0,2
St Kilda,"Ray, Farren",17,8,3,9,0,1,0,2
St Kilda,"Riewoldt, Nick",15,11,9,4,4,1,1,2
St Kilda,"Saad, Ahmed",8,5,1,3,1,1,0,3
St Kilda,"Simpkin, Tom",7,6,0,1,0,0,0,1
St Kilda,"Stanley, Rhys",1,1,1,0,0,0,2,0
St Kilda,"Steven, Jack",18,9,2,9,1,1,0,5
St Kilda,"Armitage, David",29,21,8,8,0,0,0,3
St Kilda,"Blake, Jason",13,7,5,6,1,0,31,3
St Kilda,"Cripps, Jamie",10,5,1,5,1,1,0,6
St Kilda,"Dal Santo, Nick",25,15,2,10,2,0,2,6
St Kilda,"Dempster, Sean",17,10,6,7,0,0,0,2
St Kilda,"Geary, Jarryn",4,3,2,1,0,0,0,1
St Kilda,"Gilbert, Sam",8,3,3,5,0,0,0,4
St Kilda,"Goddard, Brendon",25,14,4,11,0,0,0,3
St Kilda,"Gram, Jason",17,9,3,8,0,1,0,0
St Kilda,"Gwilt, James",19,14,4,5,0,1,0,1
St Kilda,"Hayes, Lenny",27,12,3,15,0,0,3,5
St Kilda,"Jones, Clinton",18,4,7,14,0,0,0,1
St Kilda,"Koschitzke, Justin",7,5,2,2,0,1,9,4
St Kilda,"Milera, Terry",15,10,4,5,1,2,0,2
St Kilda,"Milne, Stephen",12,10,4,2,3,1,0,3
St Kilda,"Montagna, Leigh",25,19,7,6,1,2,0,6
St Kilda,"Ray, Farren",20,12,8,8,0,1,0,3
St Kilda,"Riewoldt, Nick",16,11,7,5,2,2,1,5
St Kilda,"Saad, Ahmed",11,7,0,4,2,3,0,11
St Kilda,"Simpkin, Tom",14,9,7,5,0,0,0,3
St Kilda,"Siposs, Arryn",6,6,2,0,1,0,0,1
St Kilda,"Steven, Jack",24,12,4,12,2,0,0,6
St Kilda,"Armitage, David",22,15,6,7,2,0,0,2
St Kilda,"Blake, Jason",17,6,5,11,0,1,4,6
St Kilda,"Cripps, Jamie",3,2,2,1,0,1,0,0
St Kilda,"Dal Santo, Nick",22,16,3,6,1,0,0,1
St Kilda,"Dempster, Sean",13,10,5,3,0,0,0,1
St Kilda,"Gilbert, Sam",25,10,4,15,0,0,0,0
St Kilda,"Goddard, Brendon",25,17,7,8,1,0,1,4
St Kilda,"Gram, Jason",22,11,6,11,2,0,0,6
St Kilda,"Gwilt, James",4,3,1,1,0,0,0,2
St Kilda,"Hayes, Lenny",24,8,1,16,0,0,0,3
St Kilda,"Jones, Clinton",19,6,3,13,0,0,0,4
St Kilda,"Koschitzke, Justin",11,7,4,4,1,1,7,1
St Kilda,"Milera, Terry",11,7,4,4,2,1,0,4
St Kilda,"Milne, Stephen",14,10,5,4,1,4,0,1
St Kilda,"Montagna, Leigh",21,13,2,8,0,0,0,5
St Kilda,"Newnes, Jack",18,6,2,12,0,0,0,3
St Kilda,"Ray, Farren",18,10,1,8,0,0,0,2
St Kilda,"Riewoldt, Nick",17,12,9,5,3,2,0,1
St Kilda,"Saad, Ahmed",14,8,3,6,3,1,0,1
St Kilda,"Simpkin, Tom",7,7,4,0,0,0,0,1
St Kilda,"Siposs, Arryn",12,8,3,4,0,1,0,3
St Kilda,"Steven, Jack",15,8,4,7,0,0,0,4
St Kilda,"Armitage, David",27,17,4,10,0,0,0,4
St Kilda,"Blake, Jason",21,6,4,15,1,0,28,8
St Kilda,"Clarke, Raphael",13,9,5,4,1,0,0,1
St Kilda,"Dal Santo, Nick",25,10,2,15,1,1,2,3
St Kilda,"Dempster, Sean",23,13,7,10,0,0,0,1
St Kilda,"Gilbert, Sam",18,9,4,9,0,2,0,3
St Kilda,"Goddard, Brendon",23,12,3,11,0,0,0,4
St Kilda,"Gram, Jason",30,16,9,14,0,2,0,0
St Kilda,"Gwilt, James",13,8,4,5,0,0,0,3
St Kilda,"Hayes, Lenny",23,13,2,10,0,0,3,5
St Kilda,"Jones, Clinton",18,4,1,14,0,0,0,4
St Kilda,"Koschitzke, Justin",10,8,3,2,3,1,9,0
St Kilda,"Milera, Terry",14,8,4,6,1,0,0,2
St Kilda,"Milne, Stephen",15,11,6,4,2,3,0,3
St Kilda,"Montagna, Leigh",24,19,7,5,0,1,0,2
St Kilda,"Newnes, Jack",13,10,1,3,0,0,0,2
St Kilda,"Riewoldt, Nick",21,16,8,5,7,2,0,2
St Kilda,"Saad, Ahmed",8,6,4,2,2,0,0,4
St Kilda,"Schneider, Adam",7,6,3,1,0,0,0,0
St Kilda,"Simpkin, Tom",13,9,7,4,0,0,0,0
St Kilda,"Siposs, Arryn",20,10,9,10,1,3,0,6
St Kilda,"Steven, Jack",21,12,6,9,2,1,0,1
St Kilda,"Armitage, David",23,11,5,12,1,1,0,6
St Kilda,"Blake, Jason",2,1,0,1,0,0,3,0
St Kilda,"Clarke, Raphael",13,8,4,5,0,0,0,1
St Kilda,"Dal Santo, Nick",34,16,5,18,2,0,0,5
St Kilda,"Dempster, Sean",19,16,7,3,0,0,0,1
St Kilda,"Fisher, Sam",18,10,5,8,0,0,0,3
St Kilda,"Geary, Jarryn",9,3,2,6,0,0,0,1
St Kilda,"Gilbert, Sam",20,10,3,10,0,0,0,5
St Kilda,"Goddard, Brendon",16,11,2,5,1,1,3,3
St Kilda,"Gram, Jason",17,10,5,7,0,1,0,2
St Kilda,"Gwilt, James",16,11,3,5,0,0,0,3
St Kilda,"Hayes, Lenny",24,9,2,15,0,0,0,5
St Kilda,"Jones, Clinton",19,4,2,15,0,0,0,11
St Kilda,"Koschitzke, Justin",8,3,3,5,0,1,3,3
St Kilda,"McEvoy, Ben",9,2,2,7,0,0,19,5
St Kilda,"Milera, Terry",10,7,1,3,0,1,0,3
St Kilda,"Milne, Stephen",13,8,4,5,3,3,0,2
St Kilda,"Montagna, Leigh",29,13,5,16,2,0,0,8
St Kilda,"Riewoldt, Nick",9,5,5,4,2,1,0,1
St Kilda,"Schneider, Adam",19,9,4,10,2,0,0,6
St Kilda,"Siposs, Arryn",14,8,5,6,2,1,0,3
St Kilda,"Steven, Jack",24,18,6,6,1,1,0,2
St Kilda,"Armitage, David",25,21,11,4,2,1,0,2
St Kilda,"Blake, Jason",9,5,4,4,0,0,0,0
St Kilda,"Clarke, Raphael",10,6,4,4,0,0,0,4
St Kilda,"Dal Santo, Nick",22,9,4,13,0,1,1,6
St Kilda,"Dempster, Sean",10,9,4,1,0,0,0,2
St Kilda,"Fisher, Sam",16,10,6,6,0,0,0,1
St Kilda,"Geary, Jarryn",27,15,8,12,0,1,0,2
St Kilda,"Gilbert, Sam",13,8,2,5,0,0,0,9
St Kilda,"Goddard, Brendon",20,12,5,8,0,0,1,1
St Kilda,"Gram, Jason",12,9,2,3,1,0,0,5
St Kilda,"Gwilt, James",13,10,4,3,0,0,0,1
St Kilda,"Hayes, Lenny",29,15,5,14,2,0,0,5
St Kilda,"Koschitzke, Justin",3,0,0,3,0,0,0,1
St Kilda,"McEvoy, Ben",18,8,7,10,1,0,25,4
St Kilda,"Milera, Terry",6,3,0,3,1,0,0,2
St Kilda,"Milne, Stephen",14,13,3,1,2,1,0,0
St Kilda,"Montagna, Leigh",21,10,3,11,2,1,0,2
St Kilda,"Riewoldt, Nick",10,7,4,3,1,1,0,0
St Kilda,"Saad, Ahmed",7,3,1,4,0,2,0,1
St Kilda,"Schneider, Adam",18,10,8,8,1,0,0,4
St Kilda,"Stanley, Rhys",13,9,6,4,0,1,2,0
St Kilda,"Steven, Jack",25,14,3,11,2,1,0,3
St Kilda,"Armitage, David",20,15,8,5,0,1,0,4
St Kilda,"Dal Santo, Nick",27,16,5,11,0,0,0,5
St Kilda,"Dempster, Sean",20,15,7,5,0,0,0,3
St Kilda,"Fisher, Sam",21,14,9,7,0,0,0,1
St Kilda,"Geary, Jarryn",12,6,4,6,0,0,0,4
St Kilda,"Gilbert, Sam",11,10,4,1,1,0,0,2
St Kilda,"Gram, Jason",20,14,9,6,1,0,0,5
St Kilda,"Gwilt, James",11,8,1,3,0,0,0,0
St Kilda,"Hayes, Lenny",23,10,3,13,0,0,0,5
St Kilda,"Jones, Clinton",19,9,7,10,0,0,0,5
St Kilda,"Koschitzke, Justin",10,8,4,2,2,0,3,1
St Kilda,"Maister, Beau",17,15,9,2,2,0,0,0
St Kilda,"McEvoy, Ben",12,8,8,4,0,0,18,5
St Kilda,"Milne, Stephen",12,10,4,2,5,1,0,2
St Kilda,"Montagna, Leigh",20,12,5,8,0,0,0,4
St Kilda,"Ray, Farren",4,3,3,1,0,0,0,0
St Kilda,"Riewoldt, Nick",24,17,11,7,4,1,0,4
St Kilda,"Saad, Ahmed",15,10,1,5,2,1,0,4
St Kilda,"Schneider, Adam",11,5,4,6,2,0,0,6
St Kilda,"Simpkin, Tom",19,11,7,8,0,0,0,1
St Kilda,"Siposs, Arryn",17,12,6,5,2,1,0,1
St Kilda,"Steven, Jack",15,10,3,5,0,0,0,1
St Kilda,"Armitage, David",20,15,6,5,2,0,0,4
St Kilda,"Dal Santo, Nick",16,11,1,5,0,1,0,4
St Kilda,"Dempster, Sean",18,12,7,6,0,0,0,1
St Kilda,"Dunell, Sam",8,5,4,3,0,0,1,3
St Kilda,"Fisher, Sam",5,3,0,2,0,0,0,2
St Kilda,"Geary, Jarryn",17,7,3,10,0,0,0,2
St Kilda,"Gilbert, Sam",18,13,6,5,1,1,0,5
St Kilda,"Gram, Jason",16,9,4,7,0,0,0,2
St Kilda,"Gwilt, James",14,8,2,6,0,0,0,0
St Kilda,"Hayes, Lenny",29,15,2,14,0,0,1,6
St Kilda,"Jones, Clinton",28,9,5,19,0,0,0,9
St Kilda,"Koschitzke, Justin",12,8,3,4,0,0,7,3
St Kilda,"Maister, Beau",4,3,0,1,0,0,0,0
St Kilda,"McEvoy, Ben",15,6,4,9,0,0,35,4
St Kilda,"Milne, Stephen",16,13,5,3,3,2,0,3
St Kilda,"Montagna, Leigh",21,16,1,5,2,0,0,7
St Kilda,"Ray, Farren",22,11,7,11,0,0,0,1
St Kilda,"Riewoldt, Nick",11,8,2,3,2,0,0,2
St Kilda,"Saad, Ahmed",9,6,2,3,4,0,0,4
St Kilda,"Schneider, Adam",15,13,3,2,0,2,0,6
St Kilda,"Simpkin, Tom",9,7,2,2,0,0,0,2
St Kilda,"Siposs, Arryn",17,14,8,3,2,2,0,0
St Kilda,"Armitage, David",17,11,3,6,0,1,0,4
St Kilda,"Dal Santo, Nick",20,8,2,12,1,0,0,5
St Kilda,"Dempster, Sean",19,14,9,5,0,1,0,2
St Kilda,"Dunell, Sam",4,3,3,1,1,0,0,1
St Kilda,"Fisher, Sam",16,9,10,7,0,0,0,2
St Kilda,"Geary, Jarryn",12,4,3,8,0,0,0,2
St Kilda,"Gilbert, Sam",17,9,3,8,1,0,0,8
St Kilda,"Goddard, Brendon",21,9,4,12,0,0,0,3
St Kilda,"Gram, Jason",16,10,2,6,0,1,0,0
St Kilda,"Gwilt, James",20,16,2,4,0,0,0,1
St Kilda,"Hayes, Lenny",18,10,2,8,0,0,1,7
St Kilda,"Jones, Clinton",16,6,0,10,0,0,0,5
St Kilda,"Koschitzke, Justin",6,5,5,1,1,1,6,4
St Kilda,"McEvoy, Ben",10,3,3,7,0,0,28,6
St Kilda,"Milne, Stephen",10,8,3,2,5,0,0,5
St Kilda,"Montagna, Leigh",23,16,2,7,0,0,0,4
St Kilda,"Riewoldt, Nick",12,11,4,1,0,3,0,4
St Kilda,"Saad, Ahmed",4,3,0,1,1,1,0,2
St Kilda,"Schneider, Adam",16,10,2,6,0,4,0,2
St Kilda,"Simpkin, Tom",8,7,3,1,0,0,1,1
St Kilda,"Siposs, Arryn",4,4,4,0,0,0,0,1
St Kilda,"Steven, Jack",19,15,2,4,0,0,0,4
St Kilda,"Armitage, David",20,11,4,9,0,0,0,4
St Kilda,"Dal Santo, Nick",28,13,2,15,2,0,0,3
St Kilda,"Dempster, Sean",19,14,7,5,0,0,0,2
St Kilda,"Dunell, Sam",13,8,5,5,0,0,0,0
St Kilda,"Fisher, Sam",22,15,9,7,0,0,0,3
St Kilda,"Geary, Jarryn",21,11,3,10,0,0,0,6
St Kilda,"Gilbert, Sam",16,8,5,8,0,0,1,2
St Kilda,"Goddard, Brendon",33,16,3,17,0,0,0,9
St Kilda,"Gram, Jason",23,17,7,6,0,0,0,2
St Kilda,"Gwilt, James",14,11,7,3,0,0,0,1
St Kilda,"Hayes, Lenny",28,13,5,15,3,2,0,7
St Kilda,"Jones, Clinton",10,4,4,6,0,0,0,11
St Kilda,"Koschitzke, Justin",10,6,7,4,2,2,1,2
St Kilda,"Maister, Beau",11,7,5,4,0,3,7,5
St Kilda,"McEvoy, Ben",13,5,8,8,0,0,27,4
St Kilda,"Milne, Stephen",11,10,4,1,1,3,0,1
St Kilda,"Montagna, Leigh",32,21,8,11,1,1,0,2
St Kilda,"Riewoldt, Nick",20,16,14,4,4,3,0,2
St Kilda,"Saad, Ahmed",11,8,2,3,0,2,0,4
St Kilda,"Schneider, Adam",9,6,5,3,2,0,0,2
St Kilda,"Simpkin, Tom",16,10,7,6,0,0,0,1
St Kilda,"Steven, Jack",19,8,1,11,1,0,0,4
St Kilda,"Armitage, David",17,12,5,5,1,0,0,3
St Kilda,"Dal Santo, Nick",25,14,4,11,2,1,0,7
St Kilda,"Dempster, Sean",23,10,5,13,0,0,0,1
St Kilda,"Dunell, Sam",9,4,3,5,0,0,0,1
St Kilda,"Fisher, Sam",16,13,8,3,0,0,0,3
St Kilda,"Geary, Jarryn",24,14,5,10,0,0,0,2
St Kilda,"Gilbert, Sam",13,5,6,8,0,1,2,2
St Kilda,"Goddard, Brendon",26,18,8,8,0,1,0,1
St Kilda,"Gram, Jason",17,14,5,3,0,0,0,3
St Kilda,"Gwilt, James",15,10,3,5,0,0,0,1
St Kilda,"Hayes, Lenny",28,15,7,13,0,0,2,5
St Kilda,"Jones, Clinton",16,6,4,10,0,1,0,6
St Kilda,"Koschitzke, Justin",5,4,3,1,1,0,4,0
St Kilda,"McEvoy, Ben",16,6,7,10,1,0,29,6
St Kilda,"Milne, Stephen",15,12,3,3,3,1,0,3
St Kilda,"Montagna, Leigh",27,13,4,14,0,0,0,5
St Kilda,"Polo, Dean",10,3,3,7,0,0,0,1
St Kilda,"Ray, Farren",16,10,6,6,0,0,0,4
St Kilda,"Riewoldt, Nick",12,9,6,3,2,1,1,3
St Kilda,"Saad, Ahmed",13,11,5,2,3,0,0,1
St Kilda,"Simpkin, Tom",13,5,3,8,0,0,0,3
St Kilda,"Steven, Jack",20,11,3,9,0,0,0,5
St Kilda,"Armitage, David",20,13,4,7,0,1,0,4
St Kilda,"Cripps, Jamie",16,5,1,11,2,0,0,4
St Kilda,"Dal Santo, Nick",30,18,4,12,0,2,1,3
St Kilda,"Dempster, Sean",18,12,7,6,0,0,0,3
St Kilda,"Dunell, Sam",13,5,5,8,0,0,0,2
St Kilda,"Fisher, Sam",17,9,6,8,0,0,0,2
St Kilda,"Geary, Jarryn",25,12,5,13,0,0,0,2
St Kilda,"Gilbert, Sam",15,5,4,10,0,0,0,5
St Kilda,"Goddard, Brendon",24,13,8,11,1,2,0,4
St Kilda,"Gram, Jason",22,15,2,7,0,0,0,3
St Kilda,"Gwilt, James",15,11,4,4,0,0,0,4
St Kilda,"Hayes, Lenny",24,11,2,13,0,0,0,7
St Kilda,"Koschitzke, Justin",13,6,7,7,2,1,6,5
St Kilda,"Ledger, Tom",14,8,0,6,0,0,0,0
St Kilda,"Maister, Beau",17,13,12,4,5,0,4,1
St Kilda,"McEvoy, Ben",7,3,2,4,0,0,39,2
St Kilda,"Milne, Stephen",12,7,1,5,2,1,0,3
St Kilda,"Montagna, Leigh",29,16,3,13,0,0,0,7
St Kilda,"Riewoldt, Nick",4,3,3,1,1,0,0,1
St Kilda,"Saad, Ahmed",8,4,2,4,2,1,0,3
St Kilda,"Simpkin, Tom",7,5,4,2,0,0,0,3
St Kilda,"Steven, Jack",24,13,4,11,1,0,0,1
St Kilda,"Armitage, David",21,13,6,8,1,0,0,6
St Kilda,"Cripps, Jamie",13,7,7,6,0,2,0,0
St Kilda,"Dal Santo, Nick",20,7,3,13,0,1,1,3
St Kilda,"Dempster, Sean",13,6,7,7,0,0,0,2
St Kilda,"Fisher, Sam",16,14,5,2,0,0,0,5
St Kilda,"Geary, Jarryn",21,14,7,7,1,0,0,0
St Kilda,"Gilbert, Sam",17,7,2,10,0,1,3,2
St Kilda,"Goddard, Brendon",30,21,10,9,1,1,0,3
St Kilda,"Gram, Jason",31,17,9,14,0,0,0,2
St Kilda,"Gwilt, James",11,8,1,3,0,0,0,0
St Kilda,"Hayes, Lenny",26,9,1,17,0,1,3,5
St Kilda,"Koschitzke, Justin",1,0,0,1,0,0,1,0
St Kilda,"Maister, Beau",8,8,4,0,0,0,1,1
St Kilda,"McEvoy, Ben",14,9,7,5,0,0,29,4
St Kilda,"Milne, Stephen",10,8,3,2,4,3,0,0
St Kilda,"Montagna, Leigh",23,15,8,8,0,0,0,5
St Kilda,"Ray, Farren",15,9,6,6,0,1,0,3
St Kilda,"Saad, Ahmed",11,8,4,3,3,0,0,2
St Kilda,"Schneider, Adam",12,7,6,5,1,0,0,2
St Kilda,"Simpkin, Tom",7,3,1,4,0,0,0,3
St Kilda,"Stanley, Rhys",6,4,2,2,0,2,0,0
St Kilda,"Steven, Jack",13,9,3,4,0,1,0,2
St Kilda,"Cripps, Jamie",14,7,4,7,2,0,0,3
St Kilda,"Dal Santo, Nick",24,15,3,9,1,0,1,5
St Kilda,"Dempster, Sean",29,25,16,4,0,1,0,2
St Kilda,"Geary, Jarryn",27,13,4,14,0,1,0,4
St Kilda,"Gilbert, Sam",15,10,6,5,0,0,0,2
St Kilda,"Goddard, Brendon",23,15,8,8,3,0,0,3
St Kilda,"Gwilt, James",19,13,4,6,0,0,0,3
St Kilda,"Hayes, Lenny",11,5,2,6,0,0,0,3
St Kilda,"Ledger, Tom",21,9,3,12,1,0,0,1
St Kilda,"Maister, Beau",13,8,4,5,3,1,1,0
St Kilda,"McEvoy, Ben",8,4,5,4,1,0,22,5
St Kilda,"Milera, Terry",14,9,5,5,3,0,0,2
St Kilda,"Milne, Stephen",15,13,7,2,5,2,0,1
St Kilda,"Montagna, Leigh",28,16,9,12,2,0,0,5
St Kilda,"Newnes, Jack",14,13,6,1,1,0,0,6
St Kilda,"Ray, Farren",24,15,7,9,0,1,1,4
St Kilda,"Ross, Sebastian",8,5,0,3,0,0,0,4
St Kilda,"Saad, Ahmed",14,10,5,4,1,2,0,5
St Kilda,"Simpkin, Tom",13,8,6,5,0,0,0,1
St Kilda,"Siposs, Arryn",24,15,10,9,1,0,1,0
St Kilda,"Stanley, Rhys",13,10,7,3,1,3,4,0
St Kilda,"Steven, Jack",23,9,4,14,0,0,0,3
St Kilda,"Armitage, David",25,19,5,6,2,0,0,5
St Kilda,"Cripps, Jamie",14,10,7,4,0,1,0,4
St Kilda,"Dal Santo, Nick",13,4,3,9,0,0,0,7
St Kilda,"Dempster, Sean",15,11,6,4,0,0,0,0
St Kilda,"Geary, Jarryn",20,8,3,12,0,0,0,1
St Kilda,"Goddard, Brendon",22,15,13,7,1,1,1,3
St Kilda,"Gram, Jason",26,16,6,10,2,0,0,5
St Kilda,"Gwilt, James",22,12,4,10,0,0,0,1
St Kilda,"Hayes, Lenny",22,12,5,10,0,0,0,6
St Kilda,"Ledger, Tom",10,7,1,3,0,0,0,2
St Kilda,"Maister, Beau",8,7,7,1,2,2,3,1
St Kilda,"McEvoy, Ben",14,6,3,8,1,0,22,2
St Kilda,"Milera, Terry",10,7,3,3,3,1,0,4
St Kilda,"Milne, Stephen",10,7,2,3,1,0,0,2
St Kilda,"Montagna, Leigh",15,9,5,6,0,1,0,6
St Kilda,"Newnes, Jack",5,4,2,1,0,0,0,4
St Kilda,"Ray, Farren",24,12,6,12,0,0,0,0
St Kilda,"Saad, Ahmed",8,3,0,5,1,1,0,2
St Kilda,"Simpkin, Tom",8,5,7,3,0,0,1,1
St Kilda,"Siposs, Arryn",16,11,4,5,0,0,0,1
St Kilda,"Stanley, Rhys",9,4,6,5,1,1,6,2
St Kilda,"Steven, Jack",18,9,1,9,2,0,0,7
Sydney,"Bird, Craig",27,15,8,12,2,2,0,7
Sydney,"Bolton, Jude",25,12,2,13,1,0,1,6
Sydney,"Cunningham, Harry",4,4,2,0,0,0,0,1
Sydney,"Everitt, Andrejs",13,6,1,7,1,2,0,6
Sydney,"Goodes, Adam",21,13,6,8,0,1,1,2
Sydney,"Grundy, Heath",16,12,10,4,0,0,0,3
Sydney,"Hannebery, Dan",10,5,3,5,0,0,0,3
Sydney,"Jack, Kieren",30,20,2,10,1,1,0,7
Sydney,"Jetta, Lewis",20,11,8,9,2,0,0,3
Sydney,"Johnson, Alex",19,17,8,2,0,1,0,0
Sydney,"Kennedy, Josh",27,13,2,14,2,0,0,4
Sydney,"Malceski, Nick",18,15,6,3,0,0,0,5
Sydney,"Mattner, Martin",14,9,7,5,0,0,0,1
Sydney,"McGlynn, Ben",14,7,4,7,1,0,0,5
Sydney,"McVeigh, Jarrad",22,12,4,10,1,1,0,1
Sydney,"Mumford, Shane",11,4,5,7,1,0,35,4
Sydney,"Parker, Luke",17,7,3,10,0,0,0,1
Sydney,"Reid, Sam",19,8,6,11,0,2,0,3
Sydney,"Richards, Ted",15,12,10,3,0,0,0,3
Sydney,"Roberts-Thomson, Lewis",11,5,2,6,1,0,6,1
Sydney,"Rohan, Gary",16,6,3,10,1,2,0,7
Sydney,"Smith, Nick",19,11,5,8,0,0,0,6
Sydney,"Bird, Craig",16,7,1,9,0,0,0,10
Sydney,"Bolton, Jude",16,7,1,9,0,1,2,3
Sydney,"Goodes, Adam",18,9,3,9,2,0,1,5
Sydney,"Grundy, Heath",21,13,6,8,0,0,0,1
Sydney,"Hannebery, Dan",12,6,1,6,0,0,0,3
Sydney,"Jack, Kieren",18,12,4,6,0,0,0,3
Sydney,"Jetta, Lewis",13,9,2,4,3,1,0,3
Sydney,"Johnson, Alex",24,14,7,10,0,0,0,3
Sydney,"Kennedy, Josh",36,21,8,15,0,1,0,4
Sydney,"Malceski, Nick",26,16,4,10,1,0,0,1
Sydney,"Mattner, Martin",11,8,2,3,0,0,0,5
Sydney,"McGlynn, Ben",16,10,1,6,1,3,0,5
Sydney,"McVeigh, Jarrad",23,15,3,8,1,0,0,3
Sydney,"OKeefe, Ryan",2,2,1,0,1,0,0,1
Sydney,"Parker, Luke",13,6,3,7,0,0,0,5
Sydney,"Reid, Sam",12,10,3,2,3,2,0,1
Sydney,"Richards, Ted",11,7,3,4,0,0,0,3
Sydney,"Roberts-Thomson, Lewis",12,7,4,5,1,0,4,2
Sydney,"Rohan, Gary",12,4,2,8,1,0,0,3
Sydney,"Seaby, Mark",13,3,2,10,0,0,18,3
Sydney,"Shaw, Rhyce",10,9,1,1,0,0,0,4
Sydney,"Smith, Nick",14,6,1,8,0,0,0,3
Sydney,"Bird, Craig",15,11,5,4,2,0,0,6
Sydney,"Bolton, Jude",13,4,1,9,1,0,1,3
Sydney,"Everitt, Andrejs",8,3,0,5,0,0,0,1
Sydney,"Goodes, Adam",16,12,4,4,2,3,0,6
Sydney,"Grundy, Heath",18,11,2,7,0,0,0,0
Sydney,"Hannebery, Dan",36,15,5,21,0,0,0,2
Sydney,"Jack, Kieren",17,12,2,5,0,1,0,5
Sydney,"Jetta, Lewis",11,7,0,4,3,1,0,3
Sydney,"Johnson, Alex",8,5,2,3,0,0,0,3
Sydney,"Kennedy, Josh",27,11,2,16,0,0,0,7
Sydney,"Malceski, Nick",21,15,5,6,0,0,0,3
Sydney,"Mattner, Martin",8,6,2,2,0,0,0,2
Sydney,"McGlynn, Ben",8,6,2,2,1,0,0,3
Sydney,"McVeigh, Jarrad",19,14,2,5,1,0,0,2
Sydney,"Mumford, Shane",11,3,2,8,1,0,40,3
Sydney,"OKeefe, Ryan",15,6,1,9,2,0,0,2
Sydney,"Parker, Luke",30,12,4,18,0,1,0,2
Sydney,"Reid, Sam",9,5,4,4,1,0,0,0
Sydney,"Richards, Ted",14,3,6,11,0,0,0,3
Sydney,"Rohan, Gary",10,4,2,6,0,0,0,5
Sydney,"Shaw, Rhyce",11,5,1,6,0,0,0,2
Sydney,"White, Jesse",9,8,4,1,2,0,6,2
Sydney,"Armstrong, Tony",8,4,2,4,1,0,0,0
Sydney,"Bird, Craig",17,9,4,8,0,1,0,11
Sydney,"Bolton, Jude",16,5,1,11,2,0,0,2
Sydney,"Everitt, Andrejs",13,8,2,5,3,0,0,3
Sydney,"Grundy, Heath",12,6,6,6,0,0,0,0
Sydney,"Hannebery, Dan",10,4,1,6,0,0,0,2
Sydney,"Jack, Kieren",26,15,5,11,0,1,0,3
Sydney,"Jetta, Lewis",13,9,4,4,3,0,0,2
Sydney,"Johnson, Alex",15,12,4,3,0,0,0,2
Sydney,"Kennedy, Josh",27,16,2,11,1,0,0,4
Sydney,"Malceski, Nick",21,16,1,5,1,0,0,4
Sydney,"Mattner, Martin",10,7,3,3,0,0,0,3
Sydney,"McGlynn, Ben",15,11,2,4,3,3,0,2
Sydney,"McVeigh, Jarrad",24,18,4,6,1,0,0,4
Sydney,"OKeefe, Ryan",16,10,1,6,1,0,0,2
Sydney,"Parker, Luke",29,15,4,14,0,0,0,5
Sydney,"Reid, Sam",7,2,1,5,0,2,0,3
Sydney,"Richards, Ted",13,9,7,4,0,0,0,4
Sydney,"Rohan, Gary",1,1,1,0,1,0,0,0
Sydney,"Seaby, Mark",11,3,0,8,0,0,34,3
Sydney,"Shaw, Rhyce",15,8,1,7,0,0,0,2
Sydney,"White, Jesse",13,7,5,6,0,0,13,3
Sydney,"Bird, Craig",26,15,2,11,2,0,0,7
Sydney,"Bolton, Jude",20,10,4,10,2,0,0,5
Sydney,"Everitt, Andrejs",13,6,2,7,0,1,0,1
Sydney,"Goodes, Adam",21,12,7,9,3,1,1,2
Sydney,"Grundy, Heath",21,12,6,9,0,0,0,1
Sydney,"Hannebery, Dan",30,17,6,13,1,0,0,4
Sydney,"Jack, Kieren",17,8,2,9,1,0,0,7
Sydney,"Jetta, Lewis",9,9,2,0,1,2,0,5
Sydney,"Johnson, Alex",14,8,6,6,0,0,0,5
Sydney,"Kennedy, Josh",27,12,6,15,3,0,0,11
Sydney,"Malceski, Nick",8,6,3,2,0,0,0,1
Sydney,"Mattner, Martin",19,15,4,4,0,0,0,4
Sydney,"McGlynn, Ben",11,10,3,1,0,0,0,5
Sydney,"McVeigh, Jarrad",25,13,3,12,1,1,0,3
Sydney,"OKeefe, Ryan",21,14,4,7,2,0,0,4
Sydney,"Parker, Luke",22,10,3,12,0,0,0,4
Sydney,"Reid, Sam",5,3,3,2,0,1,0,2
Sydney,"Richards, Ted",17,6,6,11,0,0,0,2
Sydney,"Roberts-Thomson, Lewis",11,6,3,5,0,0,2,1
Sydney,"Seaby, Mark",10,4,1,6,0,1,35,4
Sydney,"Shaw, Rhyce",6,4,1,2,0,0,0,3
Sydney,"Smith, Nick",14,5,0,9,0,1,0,3
Sydney,"Bird, Craig",12,7,1,5,0,0,0,8
Sydney,"Bolton, Jude",18,11,3,7,1,1,0,13
Sydney,"Everitt, Andrejs",1,0,0,1,0,0,0,0
Sydney,"Goodes, Adam",14,11,6,3,5,1,0,4
Sydney,"Grundy, Heath",14,7,4,7,0,0,0,1
Sydney,"Hannebery, Dan",25,12,3,13,0,0,0,5
Sydney,"Jack, Kieren",15,8,1,7,2,0,0,11
Sydney,"Jetta, Lewis",27,24,7,3,2,2,0,4
Sydney,"Johnson, Alex",13,7,4,6,0,0,0,2
Sydney,"Kennedy, Josh",26,15,4,11,1,0,0,7
Sydney,"Malceski, Nick",21,18,3,3,0,0,0,3
Sydney,"Mattner, Martin",7,4,3,3,0,0,0,5
Sydney,"McGlynn, Ben",10,7,1,3,0,1,0,5
Sydney,"McVeigh, Jarrad",21,9,5,12,0,1,0,3
Sydney,"OKeefe, Ryan",19,13,4,6,3,0,0,6
Sydney,"Parker, Luke",22,10,5,12,0,1,0,7
Sydney,"Reid, Sam",6,4,4,2,0,1,0,1
Sydney,"Richards, Ted",14,7,1,7,0,0,0,2
Sydney,"Roberts-Thomson, Lewis",9,6,3,3,0,0,1,0
Sydney,"Seaby, Mark",16,4,3,12,0,0,27,3
Sydney,"Shaw, Rhyce",13,10,1,3,0,0,0,2
Sydney,"Smith, Nick",10,3,1,7,0,0,0,7
Sydney,"Bird, Craig",12,8,1,4,0,0,0,4
Sydney,"Bolton, Jude",19,11,4,8,0,1,0,5
Sydney,"Dennis-Lane, Trent",5,5,4,0,1,1,0,4
Sydney,"Everitt, Andrejs",9,8,2,1,1,1,1,3
Sydney,"Grundy, Heath",7,3,2,4,1,0,0,2
Sydney,"Hannebery, Dan",18,11,7,7,1,2,0,5
Sydney,"Jack, Kieren",20,13,4,7,0,0,0,1
Sydney,"Jetta, Lewis",17,11,3,6,0,0,0,3
Sydney,"Johnson, Alex",13,8,5,5,0,0,0,3
Sydney,"Kennedy, Josh",21,9,3,12,2,0,0,4
Sydney,"Malceski, Nick",16,13,4,3,0,0,1,4
Sydney,"Mattner, Martin",14,9,3,5,0,0,0,2
Sydney,"McGlynn, Ben",11,7,3,4,1,0,0,5
Sydney,"McVeigh, Jarrad",20,12,7,8,0,0,0,1
Sydney,"OKeefe, Ryan",19,16,5,3,0,1,0,2
Sydney,"Parker, Luke",14,8,3,6,0,0,0,1
Sydney,"Reid, Sam",5,1,1,4,0,0,0,1
Sydney,"Richards, Ted",8,4,1,4,0,0,0,2
Sydney,"Seaby, Mark",9,4,3,5,1,0,18,6
Sydney,"Shaw, Rhyce",10,6,1,4,0,0,0,4
Sydney,"Smith, Nick",13,9,3,4,0,0,0,7
Sydney,"White, Jesse",7,4,3,3,0,0,9,2
Sydney,"Bird, Craig",5,1,0,4,0,0,0,2
Sydney,"Bolton, Jude",21,10,2,11,0,1,0,4
Sydney,"Dennis-Lane, Trent",9,8,5,1,2,0,0,4
Sydney,"Grundy, Heath",12,9,7,3,0,0,0,2
Sydney,"Hannebery, Dan",33,16,7,17,0,1,0,9
Sydney,"Jack, Kieren",33,19,4,14,3,1,0,5
Sydney,"Jetta, Lewis",21,18,5,3,3,0,0,2
Sydney,"Johnson, Alex",10,8,5,2,0,1,0,2
Sydney,"Kennedy, Josh",19,8,1,11,3,0,0,7
Sydney,"Malceski, Nick",19,16,3,3,0,2,0,3
Sydney,"Mattner, Martin",20,14,8,6,1,0,0,4
Sydney,"McGlynn, Ben",17,11,8,6,2,0,0,3
Sydney,"McVeigh, Jarrad",20,11,1,9,0,0,0,4
Sydney,"OKeefe, Ryan",34,15,4,19,1,0,0,4
Sydney,"Parker, Luke",18,12,7,6,3,0,0,3
Sydney,"Pyke, Mike",12,3,0,9,0,1,24,5
Sydney,"Reid, Sam",14,5,5,9,1,1,0,3
Sydney,"Richards, Ted",13,4,4,9,0,0,0,4
Sydney,"Roberts-Thomson, Lewis",20,11,8,9,0,0,6,6
Sydney,"Shaw, Rhyce",20,15,4,5,0,1,0,1
Sydney,"Smith, Nick",11,6,3,5,0,0,0,1
Sydney,"Walsh, Tommy",14,9,6,5,2,1,0,4
Sydney,"Bird, Craig",21,12,4,9,0,0,0,3
Sydney,"Bolton, Jude",17,4,4,13,1,0,0,1
Sydney,"Dennis-Lane, Trent",3,1,1,2,0,0,0,1
Sydney,"Grundy, Heath",16,9,4,7,0,0,0,0
Sydney,"Hannebery, Dan",20,11,6,9,0,0,0,5
Sydney,"Jack, Kieren",26,15,1,11,2,0,0,6
Sydney,"Jetta, Lewis",10,8,4,2,3,1,0,4
Sydney,"Johnson, Alex",10,6,2,4,0,1,0,3
Sydney,"Kennedy, Josh",24,9,1,15,1,0,0,8
Sydney,"Malceski, Nick",19,11,2,8,0,1,0,5
Sydney,"Mattner, Martin",12,6,1,6,0,1,0,2
Sydney,"McGlynn, Ben",21,14,9,7,2,2,1,3
Sydney,"McVeigh, Jarrad",28,15,7,13,0,1,0,4
Sydney,"OKeefe, Ryan",27,18,2,9,0,0,0,7
Sydney,"Parker, Luke",17,2,3,15,0,1,0,1
Sydney,"Pyke, Mike",14,5,3,9,0,0,29,6
Sydney,"Reid, Sam",7,5,3,2,2,0,0,2
Sydney,"Richards, Ted",19,8,8,11,0,0,0,0
Sydney,"Roberts-Thomson, Lewis",9,4,3,5,1,1,8,1
Sydney,"Shaw, Rhyce",17,10,4,7,0,0,0,0
Sydney,"Smith, Nick",15,6,3,9,0,0,0,1
Sydney,"Walsh, Tommy",1,1,0,0,0,0,0,0
Sydney,"Armstrong, Tony",9,6,1,3,0,0,0,1
Sydney,"Bird, Craig",16,10,0,6,0,0,0,2
Sydney,"Bolton, Jude",41,19,9,22,2,0,0,4
Sydney,"Dennis-Lane, Trent",8,7,4,1,3,1,0,1
Sydney,"Grundy, Heath",19,15,2,4,0,0,0,2
Sydney,"Hannebery, Dan",35,20,5,15,0,1,0,4
Sydney,"Jack, Kieren",34,22,4,12,2,0,0,5
Sydney,"Jetta, Lewis",17,11,3,6,4,0,0,3
Sydney,"Johnson, Alex",22,10,6,12,0,0,0,1
Sydney,"Kennedy, Josh",28,10,0,18,1,1,0,3
Sydney,"Mattner, Martin",11,6,1,5,0,1,0,6
Sydney,"McGlynn, Ben",16,9,6,7,3,1,0,2
Sydney,"McVeigh, Jarrad",23,14,4,9,0,2,0,3
Sydney,"Mumford, Shane",7,1,1,6,0,0,15,3
Sydney,"OKeefe, Ryan",25,14,1,11,1,0,0,1
Sydney,"Parker, Luke",19,6,4,13,0,0,1,3
Sydney,"Pyke, Mike",9,4,3,5,0,0,40,2
Sydney,"Reid, Sam",11,7,3,4,2,1,0,0
Sydney,"Richards, Ted",23,15,7,8,0,0,0,3
Sydney,"Roberts-Thomson, Lewis",7,5,3,2,2,0,0,2
Sydney,"Shaw, Rhyce",30,20,6,10,0,0,0,5
Sydney,"Smith, Nick",17,9,1,8,0,0,0,3
Sydney,"Armstrong, Tony",24,12,3,12,0,0,0,2
Sydney,"Bird, Craig",24,10,2,14,0,0,0,7
Sydney,"Bolton, Jude",28,4,4,24,1,0,0,9
Sydney,"Dennis-Lane, Trent",9,6,3,3,0,0,0,2
Sydney,"Everitt, Andrejs",16,9,1,7,1,0,3,2
Sydney,"Grundy, Heath",23,16,10,7,0,0,0,0
Sydney,"Hannebery, Dan",14,6,4,8,0,1,0,2
Sydney,"Jack, Kieren",21,9,2,12,2,0,0,6
Sydney,"Jetta, Lewis",22,21,6,1,3,3,0,4
Sydney,"Johnson, Alex",15,10,3,5,0,0,0,6
Sydney,"Kennedy, Josh",26,12,3,14,0,0,0,7
Sydney,"Malceski, Nick",6,2,1,4,0,0,0,3
Sydney,"Mattner, Martin",16,9,1,7,0,1,0,4
Sydney,"McVeigh, Jarrad",25,10,1,15,1,0,0,3
Sydney,"Mumford, Shane",8,5,4,3,1,0,18,4
Sydney,"OKeefe, Ryan",27,13,4,14,0,0,0,7
Sydney,"Pyke, Mike",12,3,2,9,0,0,14,2
Sydney,"Reid, Sam",8,6,5,2,2,1,0,5
Sydney,"Richards, Ted",16,9,4,7,0,0,0,2
Sydney,"Roberts-Thomson, Lewis",7,5,4,2,1,1,0,4
Sydney,"Shaw, Rhyce",23,21,2,2,1,0,0,5
Sydney,"Smith, Nick",18,7,5,11,0,1,0,4
Sydney,"Armstrong, Tony",13,11,6,2,1,0,0,1
Sydney,"Bird, Craig",15,12,6,3,0,0,0,3
Sydney,"Bolton, Jude",23,11,1,12,1,0,0,7
Sydney,"Everitt, Andrejs",6,3,3,3,1,0,0,0
Sydney,"Goodes, Adam",7,3,2,4,0,1,0,0
Sydney,"Grundy, Heath",20,11,2,9,0,0,0,2
Sydney,"Hannebery, Dan",19,7,4,12,0,0,0,1
Sydney,"Jack, Kieren",20,12,2,8,2,0,0,9
Sydney,"Jetta, Lewis",15,9,2,6,1,0,0,2
Sydney,"Johnson, Alex",18,11,7,7,0,0,0,5
Sydney,"Kennedy, Josh",21,9,2,12,1,1,0,3
Sydney,"Mattner, Martin",18,12,3,6,0,0,0,3
Sydney,"McGlynn, Ben",17,10,2,7,2,2,0,3
Sydney,"McVeigh, Jarrad",21,13,2,8,0,1,0,0
Sydney,"Mumford, Shane",10,3,1,7,0,0,23,6
Sydney,"OKeefe, Ryan",26,14,2,12,0,1,0,5
Sydney,"Pyke, Mike",10,6,4,4,1,0,13,2
Sydney,"Reid, Sam",8,6,2,2,2,0,0,5
Sydney,"Richards, Ted",18,10,8,8,0,0,0,0
Sydney,"Roberts-Thomson, Lewis",4,3,1,1,0,1,0,1
Sydney,"Shaw, Rhyce",25,16,6,9,0,0,0,1
Sydney,"Smith, Nick",19,10,6,9,0,0,0,5
Sydney,"Armstrong, Tony",22,12,7,10,0,1,0,2
Sydney,"Bird, Craig",9,6,1,3,0,2,0,2
Sydney,"Bolton, Jude",24,10,3,14,0,1,0,8
Sydney,"Everitt, Andrejs",13,6,1,7,1,1,0,1
Sydney,"Goodes, Adam",15,8,4,7,2,2,0,2
Sydney,"Grundy, Heath",23,14,8,9,0,0,0,2
Sydney,"Hannebery, Dan",29,11,4,18,1,1,0,5
Sydney,"Jack, Kieren",33,20,3,13,2,2,0,6
Sydney,"Jetta, Lewis",23,14,5,9,3,1,0,3
Sydney,"Johnson, Alex",12,5,2,7,0,0,0,2
Sydney,"Kennedy, Josh",27,9,3,18,2,1,0,7
Sydney,"Mattner, Martin",13,3,5,10,0,0,0,3
Sydney,"McGlynn, Ben",17,11,6,6,2,0,0,3
Sydney,"McVeigh, Jarrad",37,25,8,12,0,1,0,7
Sydney,"Mumford, Shane",15,4,6,11,1,1,19,7
Sydney,"OKeefe, Ryan",36,16,4,20,0,0,0,6
Sydney,"Pyke, Mike",10,2,2,8,1,1,16,2
Sydney,"Reid, Sam",15,7,1,8,2,0,0,0
Sydney,"Richards, Ted",11,9,4,2,0,0,0,1
Sydney,"Roberts-Thomson, Lewis",14,9,6,5,2,1,0,1
Sydney,"Shaw, Rhyce",19,13,2,6,0,0,0,2
Sydney,"Smith, Nick",18,7,5,11,0,0,0,5
Sydney,"Armstrong, Tony",3,2,1,1,0,0,0,1
Sydney,"Bird, Craig",12,7,2,5,0,0,0,2
Sydney,"Bolton, Jude",19,4,3,15,0,1,0,5
Sydney,"Everitt, Andrejs",14,8,3,6,0,2,0,5
Sydney,"Goodes, Adam",22,14,13,8,3,1,0,5
Sydney,"Grundy, Heath",19,12,2,7,0,0,0,0
Sydney,"Hannebery, Dan",21,11,4,10,1,0,0,1
Sydney,"Jack, Kieren",23,15,3,8,0,2,0,2
Sydney,"Jetta, Lewis",19,13,4,6,1,0,0,1
Sydney,"Johnson, Alex",10,6,1,4,0,0,0,4
Sydney,"Kennedy, Josh",30,11,4,19,0,0,0,2
Sydney,"Malceski, Nick",29,19,6,10,0,1,0,2
Sydney,"McGlynn, Ben",11,6,2,5,1,0,0,4
Sydney,"McVeigh, Jarrad",34,18,7,16,2,0,0,5
Sydney,"Mumford, Shane",10,4,3,6,0,1,23,4
Sydney,"OKeefe, Ryan",20,3,2,17,1,0,0,7
Sydney,"Pyke, Mike",7,1,3,6,1,0,23,6
Sydney,"Reid, Sam",11,9,6,2,6,1,0,2
Sydney,"Richards, Ted",15,9,7,6,0,0,0,1
Sydney,"Roberts-Thomson, Lewis",12,8,4,4,0,1,0,0
Sydney,"Shaw, Rhyce",22,16,3,6,0,1,0,1
Sydney,"Smith, Nick",18,5,3,13,0,0,0,0
Sydney,"Bird, Craig",22,9,2,13,1,0,0,0
Sydney,"Bolton, Jude",17,10,4,7,3,0,0,6
Sydney,"Everitt, Andrejs",8,7,2,1,1,1,0,3
Sydney,"Goodes, Adam",17,12,3,5,1,0,0,3
Sydney,"Grundy, Heath",22,13,4,9,0,0,0,0
Sydney,"Hannebery, Dan",42,14,4,28,0,0,0,2
Sydney,"Jack, Kieren",29,14,1,15,0,0,0,11
Sydney,"Jetta, Lewis",16,10,2,6,4,2,0,3
Sydney,"Johnson, Alex",18,8,4,10,0,0,0,1
Sydney,"Kennedy, Josh",27,9,0,18,1,1,0,6
Sydney,"Malceski, Nick",15,10,3,5,0,0,0,3
Sydney,"Mattner, Martin",18,8,3,10,0,0,0,2
Sydney,"McGlynn, Ben",18,11,5,7,1,2,0,2
Sydney,"McVeigh, Jarrad",28,18,7,10,1,1,0,0
Sydney,"Mumford, Shane",12,5,4,7,0,1,29,4
Sydney,"OKeefe, Ryan",39,21,3,18,0,1,1,9
Sydney,"Pyke, Mike",13,5,4,8,1,1,16,3
Sydney,"Reid, Sam",15,10,5,5,3,1,0,2
Sydney,"Richards, Ted",11,7,6,4,0,0,0,1
Sydney,"Roberts-Thomson, Lewis",6,3,2,3,1,0,0,0
Sydney,"Shaw, Rhyce",14,8,1,6,0,0,0,2
Sydney,"Smith, Nick",13,7,3,6,0,0,0,3
Sydney,"Bird, Craig",18,7,1,11,1,0,0,2
Sydney,"Bolton, Jude",19,10,3,9,2,1,0,4
Sydney,"Everitt, Andrejs",2,2,0,0,0,0,0,0
Sydney,"Goodes, Adam",14,4,1,10,2,0,0,2
Sydney,"Grundy, Heath",17,9,6,8,1,0,0,0
Sydney,"Hannebery, Dan",19,7,2,12,0,1,0,2
Sydney,"Jack, Kieren",21,14,4,7,2,1,0,3
Sydney,"Jetta, Lewis",14,10,3,4,1,0,0,3
Sydney,"Johnson, Alex",18,12,6,6,0,0,0,2
Sydney,"Kennedy, Josh",35,7,3,28,1,1,1,1
Sydney,"Malceski, Nick",24,18,3,6,0,0,0,4
Sydney,"Mattner, Martin",10,8,3,2,0,0,0,0
Sydney,"McGlynn, Ben",15,11,4,4,1,3,0,2
Sydney,"McVeigh, Jarrad",28,15,4,13,1,0,0,6
Sydney,"Mumford, Shane",7,3,4,4,0,1,23,1
Sydney,"OKeefe, Ryan",25,12,6,13,1,0,0,2
Sydney,"Pyke, Mike",8,3,3,5,0,2,34,4
Sydney,"Reid, Sam",5,4,4,1,1,2,0,2
Sydney,"Richards, Ted",13,10,6,3,0,0,0,1
Sydney,"Roberts-Thomson, Lewis",7,2,2,5,1,0,3,4
Sydney,"Shaw, Rhyce",25,17,6,8,0,0,0,3
Sydney,"Smith, Nick",15,8,5,7,0,0,0,3
Sydney,"Bird, Craig",18,6,5,12,1,0,0,5
Sydney,"Bolton, Jude",23,12,7,11,3,2,0,7
Sydney,"Dennis-Lane, Trent",11,7,3,4,2,1,0,5
Sydney,"Goodes, Adam",15,11,2,4,3,2,0,2
Sydney,"Grundy, Heath",22,14,5,8,0,0,0,0
Sydney,"Hannebery, Dan",21,12,8,9,1,0,0,3
Sydney,"Jack, Kieren",29,20,5,9,2,0,0,5
Sydney,"Jetta, Lewis",16,7,3,9,1,0,0,3
Sydney,"Johnson, Alex",10,6,4,4,0,0,0,2
Sydney,"Kennedy, Josh",33,9,4,24,1,0,0,3
Sydney,"Malceski, Nick",15,12,3,3,0,0,0,3
Sydney,"Mattner, Martin",7,4,3,3,0,0,0,2
Sydney,"McGlynn, Ben",16,11,3,5,0,1,0,2
Sydney,"McVeigh, Jarrad",23,17,5,6,1,1,0,2
Sydney,"OKeefe, Ryan",36,15,3,21,0,2,0,8
Sydney,"Parker, Luke",12,5,1,7,0,1,0,5
Sydney,"Pyke, Mike",9,4,2,5,0,0,47,2
Sydney,"Reid, Sam",2,0,0,2,0,0,0,1
Sydney,"Richards, Ted",14,9,7,5,0,0,0,2
Sydney,"Roberts-Thomson, Lewis",12,8,3,4,4,0,2,6
Sydney,"Shaw, Rhyce",22,16,2,6,0,0,0,2
Sydney,"Smith, Nick",17,10,4,7,0,0,0,3
Sydney,"Bird, Craig",11,7,3,4,1,1,0,0
Sydney,"Bolton, Jude",15,5,2,10,0,0,0,2
Sydney,"Dennis-Lane, Trent",2,1,0,1,0,0,0,1
Sydney,"Goodes, Adam",20,14,7,6,1,0,0,2
Sydney,"Grundy, Heath",19,17,7,2,0,0,0,2
Sydney,"Hannebery, Dan",31,10,3,21,2,1,0,2
Sydney,"Jack, Kieren",26,16,0,10,1,0,0,8
Sydney,"Jetta, Lewis",15,6,1,9,1,1,0,1
Sydney,"Johnson, Alex",12,8,5,4,0,0,0,2
Sydney,"Kennedy, Josh",23,10,2,13,0,0,0,0
Sydney,"Malceski, Nick",16,12,2,4,1,1,0,4
Sydney,"Mattner, Martin",12,11,3,1,0,0,0,5
Sydney,"McGlynn, Ben",22,14,3,8,3,2,0,2
Sydney,"McVeigh, Jarrad",28,14,6,14,1,0,0,2
Sydney,"Mumford, Shane",11,6,4,5,1,0,27,5
Sydney,"OKeefe, Ryan",18,9,2,9,0,0,0,11
Sydney,"Parker, Luke",14,6,2,8,0,0,0,0
Sydney,"Pyke, Mike",9,2,1,7,0,1,20,3
Sydney,"Richards, Ted",15,8,7,7,0,0,0,1
Sydney,"Roberts-Thomson, Lewis",10,3,3,7,2,0,0,1
Sydney,"Shaw, Rhyce",16,8,2,8,0,0,0,3
Sydney,"Smith, Nick",14,7,1,7,0,0,0,3
Sydney,"Armstrong, Tony",4,3,1,1,0,1,0,1
Sydney,"Bird, Craig",16,7,2,9,1,1,0,1
Sydney,"Dennis-Lane, Trent",6,2,1,4,1,0,0,7
Sydney,"Goodes, Adam",15,9,4,6,1,1,1,1
Sydney,"Grundy, Heath",11,5,1,6,0,0,0,1
Sydney,"Hannebery, Dan",14,5,1,9,0,0,0,2
Sydney,"Jack, Kieren",28,13,1,15,0,1,0,7
Sydney,"Jetta, Lewis",16,12,3,4,0,1,0,5
Sydney,"Johnson, Alex",13,10,4,3,0,0,0,2
Sydney,"Kennedy, Josh",40,23,3,17,1,1,0,8
Sydney,"Malceski, Nick",17,14,2,3,0,0,0,8
Sydney,"Mattner, Martin",13,12,4,1,0,0,0,1
Sydney,"McGlynn, Ben",10,4,1,6,1,1,0,4
Sydney,"McVeigh, Jarrad",19,9,0,10,0,1,0,2
Sydney,"Mumford, Shane",14,0,3,14,0,0,45,4
Sydney,"OKeefe, Ryan",28,20,5,8,1,1,1,8
Sydney,"Parker, Luke",20,13,1,7,0,0,0,9
Sydney,"Pyke, Mike",7,4,3,3,1,0,21,0
Sydney,"Richards, Ted",13,6,1,7,0,0,0,1
Sydney,"Roberts-Thomson, Lewis",12,7,1,5,2,1,0,3
Sydney,"Shaw, Rhyce",23,11,3,12,0,0,0,3
Sydney,"Smith, Nick",14,9,2,5,0,0,0,3
Sydney,"Bird, Craig",22,12,4,10,0,1,0,3
Sydney,"Goodes, Adam",22,19,11,3,3,1,0,5
Sydney,"Grundy, Heath",22,15,7,7,0,0,0,1
Sydney,"Hannebery, Dan",24,11,3,13,2,0,0,2
Sydney,"Jack, Kieren",29,15,4,14,1,1,0,6
Sydney,"Jetta, Lewis",13,10,3,3,1,0,0,2
Sydney,"Johnson, Alex",15,5,3,10,0,0,0,2
Sydney,"Kennedy, Josh",34,14,3,20,1,0,0,4
Sydney,"Malceski, Nick",16,12,3,4,0,0,0,0
Sydney,"Mattner, Martin",17,11,6,6,0,0,0,2
Sydney,"McGlynn, Ben",14,12,2,2,2,1,0,4
Sydney,"McVeigh, Jarrad",24,13,4,11,1,0,0,7
Sydney,"Morton, Mitch",4,2,2,2,1,0,0,0
Sydney,"Mumford, Shane",10,6,4,4,3,0,31,3
Sydney,"OKeefe, Ryan",25,12,2,13,2,0,0,9
Sydney,"Parker, Luke",26,14,5,12,1,1,0,3
Sydney,"Pyke, Mike",8,4,7,4,3,0,10,2
Sydney,"Reid, Sam",8,4,1,4,2,1,0,0
Sydney,"Richards, Ted",13,7,6,6,0,0,0,3
Sydney,"Roberts-Thomson, Lewis",12,6,5,6,3,2,2,2
Sydney,"Shaw, Rhyce",16,12,2,4,0,0,0,1
Sydney,"Smith, Nick",18,10,5,8,0,0,0,6
Sydney,"Bird, Craig",23,7,2,16,0,0,0,4
Sydney,"Goodes, Adam",15,10,5,5,2,2,0,0
Sydney,"Grundy, Heath",20,12,7,8,0,0,0,1
Sydney,"Hannebery, Dan",29,11,2,18,0,0,0,2
Sydney,"Jack, Kieren",21,14,2,7,1,0,0,3
Sydney,"Jetta, Lewis",13,7,0,6,0,0,0,1
Sydney,"Johnson, Alex",8,4,3,4,0,0,0,4
Sydney,"Kennedy, Josh",35,16,0,19,1,0,0,6
Sydney,"Malceski, Nick",26,20,2,6,1,0,0,4
Sydney,"Mattner, Martin",16,6,2,10,0,0,0,3
Sydney,"McGlynn, Ben",17,8,4,9,1,1,0,4
Sydney,"McVeigh, Jarrad",19,9,1,10,1,0,0,3
Sydney,"Morton, Mitch",5,3,2,2,0,0,0,0
Sydney,"Mumford, Shane",7,4,2,3,2,0,31,8
Sydney,"OKeefe, Ryan",30,18,2,12,2,0,1,12
Sydney,"Parker, Luke",14,6,3,8,0,0,0,1
Sydney,"Pyke, Mike",10,4,5,6,0,1,21,3
Sydney,"Reid, Sam",11,7,3,4,2,2,0,2
Sydney,"Richards, Ted",11,5,3,6,0,0,0,5
Sydney,"Roberts-Thomson, Lewis",4,3,3,1,1,0,0,1
Sydney,"Shaw, Rhyce",27,21,5,6,0,0,0,4
Sydney,"Smith, Nick",12,7,2,5,0,0,0,10
Sydney,"Armstrong, Tony",21,14,1,7,0,0,0,2
Sydney,"Bird, Craig",16,6,1,10,0,1,0,4
Sydney,"Bolton, Jude",17,7,5,10,1,1,0,6
Sydney,"Goodes, Adam",19,15,7,4,2,1,0,2
Sydney,"Grundy, Heath",20,6,1,14,0,0,0,2
Sydney,"Hannebery, Dan",15,6,2,9,0,0,0,4
Sydney,"Jack, Kieren",25,17,3,8,1,0,0,1
Sydney,"Jetta, Lewis",12,8,2,4,0,0,0,5
Sydney,"Johnson, Alex",17,6,6,11,0,0,0,2
Sydney,"Kennedy, Josh",24,14,5,10,1,2,0,3
Sydney,"Malceski, Nick",17,10,2,7,0,0,0,3
Sydney,"Mattner, Martin",18,8,5,10,0,0,0,6
Sydney,"McGlynn, Ben",16,6,5,10,1,0,0,3
Sydney,"McVeigh, Jarrad",32,16,4,16,2,1,0,2
Sydney,"Mumford, Shane",14,6,4,8,1,0,29,6
Sydney,"OKeefe, Ryan",13,7,2,6,1,0,0,9
Sydney,"Parker, Luke",9,2,1,7,0,0,0,0
Sydney,"Pyke, Mike",10,3,4,7,0,0,2,1
Sydney,"Richards, Ted",20,9,3,11,0,0,0,1
Sydney,"Roberts-Thomson, Lewis",12,6,3,6,0,0,1,1
Sydney,"Shaw, Rhyce",16,8,1,8,0,0,0,3
Sydney,"Walsh, Tommy",9,3,1,6,1,1,0,2
Sydney,"Bird, Craig",17,7,3,10,0,0,0,2
Sydney,"Bolton, Jude",14,6,2,8,0,0,0,7
Sydney,"Goodes, Adam",22,13,7,9,3,0,0,3
Sydney,"Hannebery, Dan",27,10,3,17,0,0,0,4
Sydney,"Jack, Kieren",21,16,3,5,0,0,0,5
Sydney,"Jetta, Lewis",16,12,4,4,2,1,0,2
Sydney,"Johnson, Alex",11,7,5,4,0,0,0,2
Sydney,"Kennedy, Josh",35,13,6,22,1,1,0,7
Sydney,"Malceski, Nick",20,16,5,4,0,0,0,4
Sydney,"Mattner, Martin",21,17,6,4,0,0,0,2
Sydney,"McGlynn, Ben",13,10,4,3,1,1,0,2
Sydney,"McVeigh, Jarrad",22,7,5,15,0,0,0,3
Sydney,"Morton, Mitch",14,6,5,8,2,1,0,4
Sydney,"Mumford, Shane",8,0,0,8,0,0,25,6
Sydney,"OKeefe, Ryan",37,26,4,11,0,1,1,8
Sydney,"Parker, Luke",2,1,0,1,1,0,0,1
Sydney,"Pyke, Mike",8,4,4,4,0,0,9,2
Sydney,"Reid, Sam",11,4,2,7,1,0,0,4
Sydney,"Richards, Ted",20,11,4,9,0,0,0,1
Sydney,"Roberts-Thomson, Lewis",8,6,2,2,0,0,0,1
Sydney,"Shaw, Rhyce",27,14,6,13,0,0,0,2
Sydney,"Smith, Nick",16,9,2,7,0,0,0,3
Sydney,"Bird, Craig",18,12,5,6,1,2,0,4
Sydney,"Bolton, Jude",18,5,3,13,2,0,0,3
Sydney,"Goodes, Adam",25,21,9,4,1,2,0,4
Sydney,"Grundy, Heath",16,10,5,6,0,0,0,0
Sydney,"Hannebery, Dan",33,11,3,22,0,0,0,5
Sydney,"Jack, Kieren",25,11,0,14,0,2,0,6
Sydney,"Jetta, Lewis",16,10,5,6,3,0,0,1
Sydney,"Johnson, Alex",11,6,2,5,0,0,0,2
Sydney,"Kennedy, Josh",30,13,4,17,2,2,0,5
Sydney,"Malceski, Nick",14,10,3,4,0,0,0,3
Sydney,"Mattner, Martin",11,7,2,4,0,0,0,1
Sydney,"McVeigh, Jarrad",30,18,7,12,0,1,0,1
Sydney,"Morton, Mitch",8,6,2,2,0,1,0,7
Sydney,"Mumford, Shane",14,3,3,11,1,0,32,4
Sydney,"OKeefe, Ryan",34,20,5,14,1,0,0,11
Sydney,"Parker, Luke",3,3,2,0,0,0,0,0
Sydney,"Pyke, Mike",10,6,3,4,0,1,16,0
Sydney,"Reid, Sam",4,2,3,2,0,0,0,1
Sydney,"Richards, Ted",10,7,4,3,0,0,0,0
Sydney,"Roberts-Thomson, Lewis",10,6,4,4,2,1,0,5
Sydney,"Shaw, Rhyce",27,23,7,4,0,0,0,0
Sydney,"Smith, Nick",10,5,3,5,0,1,0,4
Sydney,"Bird, Craig",19,10,4,9,0,1,0,6
Sydney,"Bolton, Jude",13,6,2,7,0,0,0,7
Sydney,"Goodes, Adam",14,7,2,7,1,0,0,6
Sydney,"Grundy, Heath",14,7,3,7,0,0,0,2
Sydney,"Hannebery, Dan",29,12,4,17,1,0,0,5
Sydney,"Jack, Kieren",14,9,3,5,2,0,0,9
Sydney,"Jetta, Lewis",12,12,3,0,0,1,0,1
Sydney,"Johnson, Alex",15,10,4,5,0,1,0,3
Sydney,"Kennedy, Josh",26,14,2,12,2,1,0,4
Sydney,"Malceski, Nick",17,14,2,3,2,0,0,7
Sydney,"Mattner, Martin",11,5,1,6,0,0,0,6
Sydney,"McVeigh, Jarrad",21,17,7,4,2,0,0,9
Sydney,"Morton, Mitch",11,6,2,5,2,0,0,4
Sydney,"Mumford, Shane",6,3,2,3,0,0,14,3
Sydney,"OKeefe, Ryan",28,15,3,13,0,0,0,15
Sydney,"Parker, Luke",3,2,0,1,0,0,0,2
Sydney,"Pyke, Mike",16,7,6,9,0,0,29,3
Sydney,"Reid, Sam",13,6,3,7,1,1,0,3
Sydney,"Richards, Ted",11,7,2,4,0,0,0,5
Sydney,"Roberts-Thomson, Lewis",14,6,7,8,1,1,1,4
Sydney,"Shaw, Rhyce",15,9,3,6,0,0,0,2
Sydney,"Smith, Nick",11,6,4,5,0,0,0,4
West Coast,"Cox, Dean",16,10,4,6,2,0,22,5
West Coast,"Darling, Jack",13,7,5,6,1,2,0,9
West Coast,"Embley, Andrew",12,7,0,5,1,0,0,3
West Coast,"Gaff, Andrew",23,15,3,8,1,1,0,0
West Coast,"Glass, Darren",5,3,1,2,0,0,0,4
West Coast,"Hams, Ashton",12,6,2,6,2,0,0,0
West Coast,"Hill, Josh",7,6,4,1,3,0,0,1
West Coast,"Hurn, Shannon",21,15,6,6,0,0,0,1
West Coast,"Kennedy, Josh",11,10,8,1,7,1,0,0
West Coast,"Kerr, Daniel",7,2,0,5,0,0,0,2
West Coast,"Lynch, Quinten",20,13,11,7,1,1,0,2
West Coast,"Mackenzie, Eric",8,6,1,2,0,0,0,2
West Coast,"Masten, Chris",16,7,2,9,1,0,0,7
West Coast,"Naitanui, Nic",12,5,1,7,1,0,23,3
West Coast,"Priddis, Matt",33,11,2,22,0,0,0,3
West Coast,"Rosa, Matt",31,23,10,8,0,0,0,3
West Coast,"Schofield, Will",16,9,7,7,1,0,0,3
West Coast,"Selwood, Adam",10,7,4,3,0,0,0,5
West Coast,"Selwood, Scott",27,16,9,11,0,0,0,0
West Coast,"Shuey, Luke",24,13,0,11,0,1,0,4
West Coast,"Smith, Ashley",12,5,1,7,0,0,0,2
West Coast,"Waters, Beau",16,10,7,6,0,0,0,5
West Coast,"Cox, Dean",16,10,7,6,0,2,20,5
West Coast,"Darling, Jack",16,12,8,4,4,2,0,4
West Coast,"Embley, Andrew",3,1,0,2,0,0,0,3
West Coast,"Gaff, Andrew",33,19,7,14,1,0,0,1
West Coast,"Glass, Darren",22,9,9,13,0,0,0,1
West Coast,"Hams, Ashton",10,3,0,7,3,0,0,2
West Coast,"Hill, Josh",13,10,3,3,3,2,0,10
West Coast,"Hurn, Shannon",31,23,12,8,0,0,0,5
West Coast,"Kennedy, Josh",10,8,5,2,1,4,0,2
West Coast,"Kerr, Daniel",26,13,2,13,1,0,0,1
West Coast,"Lynch, Quinten",13,12,3,1,4,0,1,1
West Coast,"Mackenzie, Eric",11,6,5,5,0,0,0,1
West Coast,"Masten, Chris",34,20,3,14,0,1,0,5
West Coast,"Naitanui, Nic",12,4,3,8,1,1,22,3
West Coast,"Priddis, Matt",30,9,4,21,0,0,0,4
West Coast,"Rosa, Matt",22,13,5,9,0,0,0,3
West Coast,"Schofield, Will",16,12,4,4,0,0,0,1
West Coast,"Selwood, Adam",27,13,8,14,1,0,0,1
West Coast,"Selwood, Scott",34,13,5,21,3,0,0,4
West Coast,"Shuey, Luke",26,12,5,14,1,1,0,9
West Coast,"Smith, Ashley",21,11,3,10,0,0,0,1
West Coast,"Waters, Beau",21,20,7,1,2,0,0,2
West Coast,"Brown, Mitch",13,4,5,9,0,0,0,0
West Coast,"Cox, Dean",14,9,2,5,1,1,14,2
West Coast,"Dalziell, Bradd",16,6,5,10,1,0,0,0
West Coast,"Darling, Jack",9,6,5,3,1,0,0,2
West Coast,"Gaff, Andrew",27,16,4,11,0,0,0,4
West Coast,"Hams, Ashton",8,8,2,0,1,2,0,4
West Coast,"Hill, Josh",12,9,6,3,1,1,0,4
West Coast,"Hurn, Shannon",22,15,7,7,0,0,0,1
West Coast,"Kennedy, Josh",6,4,3,2,2,1,0,1
West Coast,"Kerr, Daniel",13,6,2,7,0,0,0,0
West Coast,"Lynch, Quinten",12,10,9,2,3,1,1,1
West Coast,"Mackenzie, Eric",14,8,7,6,0,0,0,1
West Coast,"Masten, Chris",30,19,5,11,3,0,0,3
West Coast,"McGinnity, Patrick",7,5,2,2,1,0,0,3
West Coast,"Naitanui, Nic",14,4,2,10,2,0,26,1
West Coast,"Schofield, Will",20,10,9,10,0,1,0,1
West Coast,"Selwood, Adam",25,11,7,14,0,0,0,1
West Coast,"Selwood, Scott",31,15,10,16,1,2,0,9
West Coast,"Shuey, Luke",25,15,6,10,5,1,0,1
West Coast,"Smith, Ashley",19,11,6,8,1,0,0,0
West Coast,"Stevens, Koby",19,10,7,9,0,0,0,3
West Coast,"Waters, Beau",19,11,8,8,0,0,0,3
West Coast,"Cox, Dean",17,9,4,8,0,1,22,1
West Coast,"Darling, Jack",9,9,6,0,2,2,0,4
West Coast,"Gaff, Andrew",24,16,3,8,0,0,0,1
West Coast,"Glass, Darren",13,6,8,7,0,0,0,2
West Coast,"Hams, Ashton",13,7,4,6,0,1,0,3
West Coast,"Hill, Josh",7,5,3,2,1,1,0,1
West Coast,"Hurn, Shannon",7,5,0,2,0,0,0,2
West Coast,"Kennedy, Josh",8,8,6,0,1,3,0,1
West Coast,"Kerr, Daniel",33,18,5,15,1,2,0,1
West Coast,"Lynch, Quinten",7,5,2,2,0,2,1,0
West Coast,"Mackenzie, Eric",27,18,11,9,0,0,0,2
West Coast,"Masten, Chris",20,12,5,8,0,0,0,3
West Coast,"McGinnity, Patrick",3,2,0,1,0,0,0,2
West Coast,"Naitanui, Nic",15,7,1,8,0,0,26,2
West Coast,"Priddis, Matt",20,7,3,13,0,0,0,6
West Coast,"Rosa, Matt",19,13,7,6,0,0,0,3
West Coast,"Schofield, Will",15,7,4,8,0,0,0,2
West Coast,"Selwood, Adam",8,7,4,1,0,0,0,0
West Coast,"Selwood, Scott",26,13,2,13,0,1,0,3
West Coast,"Shuey, Luke",18,14,5,4,0,1,0,6
West Coast,"Smith, Ashley",19,10,1,9,0,0,0,1
West Coast,"Waters, Beau",26,15,10,11,0,0,0,2
West Coast,"Brown, Mitch",1,0,0,1,0,0,0,0
West Coast,"Butler, Sam",12,8,3,4,0,0,0,4
West Coast,"Cox, Dean",10,5,7,5,1,1,16,1
West Coast,"Darling, Jack",15,10,5,5,4,0,0,2
West Coast,"Gaff, Andrew",30,15,9,15,0,1,0,0
West Coast,"Glass, Darren",8,5,5,3,0,0,0,0
West Coast,"Hams, Ashton",11,5,1,6,2,0,0,2
West Coast,"Hill, Josh",14,8,4,6,3,0,0,1
West Coast,"Hurn, Shannon",12,9,2,3,0,0,0,0
West Coast,"Kennedy, Josh",3,3,3,0,1,1,0,1
West Coast,"Kerr, Daniel",28,12,1,16,0,0,0,4
West Coast,"Lynch, Quinten",18,12,6,6,2,1,0,2
West Coast,"Masten, Chris",21,8,0,13,2,0,0,3
West Coast,"Naitanui, Nic",14,5,5,9,0,0,26,5
West Coast,"Priddis, Matt",24,13,2,11,0,0,0,8
West Coast,"Rosa, Matt",19,11,4,8,0,0,0,3
West Coast,"Schofield, Will",11,7,5,4,0,0,0,2
West Coast,"Selwood, Adam",6,3,0,3,0,0,0,3
West Coast,"Selwood, Scott",22,9,3,13,1,0,0,10
West Coast,"Shuey, Luke",12,6,1,6,0,0,0,4
West Coast,"Smith, Ashley",12,7,2,5,0,0,0,2
West Coast,"Waters, Beau",18,12,5,6,0,0,0,4
West Coast,"Brennan, Jacob",11,9,2,2,0,0,0,0
West Coast,"Butler, Sam",18,16,5,2,0,0,0,2
West Coast,"Cox, Dean",21,13,5,8,1,0,32,0
West Coast,"Darling, Jack",7,7,4,0,1,2,0,1
West Coast,"Gaff, Andrew",19,12,4,7,0,1,0,1
West Coast,"Glass, Darren",14,6,6,8,0,0,0,2
West Coast,"Hams, Ashton",10,6,2,4,1,2,0,2
West Coast,"Hill, Josh",15,11,7,4,4,1,0,4
West Coast,"Hurn, Shannon",24,23,9,1,2,0,0,1
West Coast,"Kerr, Daniel",12,4,0,8,0,0,0,2
West Coast,"Lycett, Scott",7,3,3,4,1,0,4,2
West Coast,"Lynch, Quinten",9,6,3,3,1,2,3,1
West Coast,"Mackenzie, Eric",15,8,6,7,0,0,1,0
West Coast,"Masten, Chris",13,12,2,1,1,2,0,2
West Coast,"McGinnity, Patrick",9,6,3,3,0,2,0,4
West Coast,"Priddis, Matt",29,14,4,15,0,1,0,4
West Coast,"Rosa, Matt",24,13,7,11,1,1,0,2
West Coast,"Selwood, Adam",11,8,3,3,0,0,0,2
West Coast,"Selwood, Scott",35,15,8,20,1,0,0,4
West Coast,"Sheppard, Brad",3,3,1,0,1,0,0,1
West Coast,"Shuey, Luke",20,14,4,6,2,2,0,7
West Coast,"Waters, Beau",26,14,7,12,0,0,0,2
West Coast,"Brennan, Jacob",13,10,4,3,1,0,0,3
West Coast,"Brown, Mitch",6,2,2,4,0,0,0,2
West Coast,"Butler, Sam",12,9,3,3,0,0,0,3
West Coast,"Cox, Dean",21,15,8,6,0,1,32,4
West Coast,"Darling, Jack",8,6,3,2,1,0,0,0
West Coast,"Gaff, Andrew",25,12,7,13,0,0,0,2
West Coast,"Glass, Darren",13,5,4,8,0,0,0,3
West Coast,"Hill, Josh",13,8,6,5,1,0,0,4
West Coast,"Hurn, Shannon",14,13,4,1,0,2,0,5
West Coast,"Kerr, Daniel",19,8,3,11,1,0,0,2
West Coast,"Lycett, Scott",5,2,1,3,0,1,2,0
West Coast,"Lynch, Quinten",11,11,9,0,0,0,0,4
West Coast,"Mackenzie, Eric",15,11,10,4,0,0,1,1
West Coast,"Masten, Chris",18,13,6,5,0,1,0,4
West Coast,"McGinnity, Patrick",18,10,6,8,1,0,0,3
West Coast,"Neates, Ryan",5,2,2,3,0,0,0,1
West Coast,"Priddis, Matt",4,1,0,3,0,0,0,2
West Coast,"Rosa, Matt",18,11,9,7,0,0,0,3
West Coast,"Selwood, Scott",17,6,3,11,0,0,0,8
West Coast,"Sheppard, Brad",18,13,6,5,0,0,0,4
West Coast,"Shuey, Luke",23,14,4,9,0,1,0,4
West Coast,"Waters, Beau",18,11,5,7,2,2,0,4
West Coast,"Brennan, Jacob",9,5,1,4,0,0,0,3
West Coast,"Butler, Sam",20,15,7,5,0,0,0,0
West Coast,"Cox, Dean",15,10,7,5,5,0,22,1
West Coast,"Darling, Jack",12,10,9,2,1,1,0,3
West Coast,"Gaff, Andrew",25,17,11,8,1,0,0,1
West Coast,"Glass, Darren",9,2,2,7,0,0,0,5
West Coast,"Hill, Josh",7,7,4,0,1,2,0,2
West Coast,"Hurn, Shannon",18,14,7,4,0,1,0,1
West Coast,"Kerr, Daniel",17,7,3,10,0,0,0,4
West Coast,"Lynch, Quinten",15,11,5,4,1,1,5,4
West Coast,"Mackenzie, Eric",11,7,7,4,0,0,0,1
West Coast,"Masten, Chris",24,16,7,8,0,1,0,2
West Coast,"McGinnity, Patrick",12,7,6,5,1,0,0,4
West Coast,"Naitanui, Nic",14,6,5,8,2,0,22,4
West Coast,"Rosa, Matt",26,10,6,16,0,0,0,4
West Coast,"Schofield, Will",13,8,4,5,1,0,0,3
West Coast,"Selwood, Adam",9,8,3,1,0,1,0,5
West Coast,"Selwood, Scott",31,14,7,17,0,1,0,2
West Coast,"Sheppard, Brad",19,11,5,8,1,0,0,2
West Coast,"Shuey, Luke",25,17,10,8,2,2,0,3
West Coast,"Stevens, Koby",5,4,2,1,0,0,0,2
West Coast,"Waters, Beau",27,20,10,7,2,1,0,1
West Coast,"Brennan, Jacob",3,3,1,0,0,0,0,1
West Coast,"Butler, Sam",13,9,7,4,0,0,0,1
West Coast,"Cox, Dean",15,7,8,8,0,1,20,3
West Coast,"Darling, Jack",12,6,6,6,2,1,0,2
West Coast,"Gaff, Andrew",29,25,7,4,0,2,0,2
West Coast,"Glass, Darren",16,7,8,9,0,0,0,1
West Coast,"Hill, Josh",18,14,4,4,3,4,0,6
West Coast,"Hurn, Shannon",18,14,5,4,0,1,0,2
West Coast,"Kerr, Daniel",12,8,2,4,0,1,1,1
West Coast,"Lynch, Quinten",22,19,11,3,1,3,2,2
West Coast,"Mackenzie, Eric",15,6,9,9,0,0,1,3
West Coast,"Masten, Chris",25,14,9,11,0,1,0,4
West Coast,"McGinnity, Patrick",9,3,2,6,0,1,0,6
West Coast,"Naitanui, Nic",11,5,5,6,1,1,23,3
West Coast,"Priddis, Matt",28,10,5,18,1,0,0,5
West Coast,"Rosa, Matt",43,23,13,20,1,0,0,2
West Coast,"Schofield, Will",10,7,4,3,1,0,0,1
West Coast,"Selwood, Adam",18,12,4,6,0,0,0,1
West Coast,"Selwood, Scott",18,4,4,14,0,0,0,6
West Coast,"Sheppard, Brad",17,12,10,5,0,1,0,6
West Coast,"Shuey, Luke",26,15,2,11,1,0,0,5
West Coast,"Waters, Beau",25,19,10,6,0,0,0,4
West Coast,"Brennan, Jacob",10,9,5,1,0,1,0,1
West Coast,"Cox, Dean",13,10,4,3,2,0,31,3
West Coast,"Darling, Jack",12,8,5,4,1,2,0,4
West Coast,"Gaff, Andrew",24,16,4,8,0,0,0,1
West Coast,"Glass, Darren",18,3,6,15,0,0,0,2
West Coast,"Hams, Ashton",5,3,0,2,1,0,0,0
West Coast,"Hill, Josh",8,4,2,4,1,1,0,3
West Coast,"Hurn, Shannon",20,17,4,3,2,0,0,1
West Coast,"Kerr, Daniel",18,9,0,9,0,0,0,1
West Coast,"Lynch, Quinten",9,6,4,3,1,0,2,1
West Coast,"Mackenzie, Eric",11,4,4,7,0,0,0,1
West Coast,"Masten, Chris",27,14,4,13,1,0,0,3
West Coast,"McGinnity, Patrick",4,3,4,1,0,1,0,6
West Coast,"Naitanui, Nic",11,5,0,6,0,0,41,2
West Coast,"Priddis, Matt",27,11,2,16,3,0,0,6
West Coast,"Rosa, Matt",26,18,4,8,0,0,0,2
West Coast,"Schofield, Will",11,8,1,3,1,0,1,6
West Coast,"Selwood, Adam",16,9,6,7,0,0,0,6
West Coast,"Selwood, Scott",22,9,2,13,1,0,0,3
West Coast,"Sheppard, Brad",14,7,1,7,0,0,0,1
West Coast,"Swift, Tom",25,10,3,15,1,0,0,6
West Coast,"Waters, Beau",21,15,8,6,0,0,0,1
West Coast,"Brennan, Jacob",10,9,1,1,1,0,0,3
West Coast,"Cox, Dean",14,8,4,6,2,1,30,1
West Coast,"Darling, Jack",11,10,4,1,3,2,0,6
West Coast,"Gaff, Andrew",27,18,1,9,0,0,0,4
West Coast,"Glass, Darren",10,6,3,4,0,0,0,4
West Coast,"Hams, Ashton",8,6,2,2,1,3,0,4
West Coast,"Hill, Josh",12,10,3,2,0,3,0,4
West Coast,"Hurn, Shannon",11,10,3,1,0,1,0,8
West Coast,"Kerr, Daniel",21,9,0,12,1,0,0,6
West Coast,"Lynch, Quinten",1,1,1,0,1,0,0,0
West Coast,"Mackenzie, Eric",6,2,2,4,0,0,1,3
West Coast,"Masten, Chris",19,12,3,7,0,0,0,5
West Coast,"McGinnity, Patrick",14,13,4,1,0,0,0,3
West Coast,"Naitanui, Nic",25,10,5,15,0,2,31,7
West Coast,"Priddis, Matt",30,7,2,23,0,0,0,5
West Coast,"Rosa, Matt",23,12,5,11,0,2,0,3
West Coast,"Schofield, Will",17,9,5,8,1,0,0,0
West Coast,"Selwood, Adam",11,3,1,8,0,0,0,1
West Coast,"Selwood, Scott",33,13,2,20,0,0,0,5
West Coast,"Sheppard, Brad",12,10,6,2,0,1,0,3
West Coast,"Shuey, Luke",21,16,2,5,0,1,0,5
West Coast,"Swift, Tom",10,5,1,5,0,0,0,1
West Coast,"Brennan, Jacob",11,7,3,4,0,1,0,2
West Coast,"Brown, Mitch",8,5,3,3,0,0,0,0
West Coast,"Cox, Dean",15,7,5,8,0,0,29,0
West Coast,"Darling, Jack",12,8,5,4,2,0,0,2
West Coast,"Gaff, Andrew",21,15,3,6,0,0,0,4
West Coast,"Glass, Darren",11,3,5,8,0,0,0,2
West Coast,"Hams, Ashton",14,7,6,7,2,1,0,6
West Coast,"Hill, Josh",8,6,3,2,2,0,0,5
West Coast,"Hurn, Shannon",21,14,6,7,0,0,0,3
West Coast,"Kerr, Daniel",29,18,2,11,1,0,0,2
West Coast,"Lynch, Quinten",16,10,7,6,2,1,0,3
West Coast,"Mackenzie, Eric",13,8,2,5,0,0,0,0
West Coast,"Masten, Chris",23,12,6,11,1,0,0,1
West Coast,"McGinnity, Patrick",9,2,1,7,0,0,0,3
West Coast,"Naitanui, Nic",11,4,3,7,1,2,15,3
West Coast,"Priddis, Matt",26,7,2,19,0,0,0,5
West Coast,"Rosa, Matt",22,8,5,14,0,0,0,4
West Coast,"Selwood, Scott",17,8,3,9,0,0,0,3
West Coast,"Sheppard, Brad",16,11,7,5,1,0,0,2
West Coast,"Shuey, Luke",25,15,4,10,0,1,0,3
West Coast,"Swift, Tom",8,3,0,5,0,0,0,1
West Coast,"Waters, Beau",29,19,14,10,0,0,0,4
West Coast,"Brennan, Jacob",18,12,6,6,0,1,0,5
West Coast,"Brown, Mitch",14,4,4,10,0,0,0,2
West Coast,"Cox, Dean",19,11,8,8,2,0,27,2
West Coast,"Darling, Jack",12,11,11,1,3,0,0,3
West Coast,"Gaff, Andrew",25,20,7,5,1,3,0,1
West Coast,"Glass, Darren",17,4,7,13,0,0,0,2
West Coast,"Hams, Ashton",14,9,5,5,2,1,0,2
West Coast,"Hill, Josh",17,11,7,6,2,1,0,3
West Coast,"Hurn, Shannon",25,19,6,6,1,0,0,2
West Coast,"Kerr, Daniel",30,17,7,13,1,0,0,1
West Coast,"Lynch, Quinten",17,11,6,6,4,2,0,1
West Coast,"Mackenzie, Eric",12,9,7,3,0,0,0,1
West Coast,"Masten, Chris",33,20,6,13,0,0,0,4
West Coast,"McGinnity, Patrick",20,12,7,8,1,0,0,3
West Coast,"Naitanui, Nic",11,6,4,5,2,1,25,1
West Coast,"Newman, Murray",13,9,5,4,2,2,0,0
West Coast,"Priddis, Matt",32,10,4,22,0,0,0,4
West Coast,"Rosa, Matt",28,14,8,14,0,0,0,5
West Coast,"Selwood, Scott",26,10,6,16,1,1,0,2
West Coast,"Sheppard, Brad",15,9,3,6,0,1,0,2
West Coast,"Shuey, Luke",32,18,10,14,3,1,0,4
West Coast,"Waters, Beau",26,17,8,9,0,1,0,3
West Coast,"Brennan, Jacob",10,7,4,3,0,0,0,3
West Coast,"Butler, Sam",22,16,4,6,0,1,0,5
West Coast,"Cox, Dean",21,16,15,5,3,1,24,1
West Coast,"Darling, Jack",7,6,1,1,2,0,0,2
West Coast,"Gaff, Andrew",17,11,1,6,0,0,0,0
West Coast,"Glass, Darren",10,4,6,6,0,0,0,2
West Coast,"Hams, Ashton",7,3,2,4,0,0,0,3
West Coast,"Hill, Josh",10,9,3,1,1,1,0,2
West Coast,"Hurn, Shannon",14,10,4,4,0,0,0,3
West Coast,"Kerr, Daniel",31,22,5,9,1,2,0,2
West Coast,"Lynch, Quinten",16,12,5,4,3,3,0,1
West Coast,"Mackenzie, Eric",13,8,2,5,0,0,1,2
West Coast,"Masten, Chris",18,8,2,10,1,0,0,2
West Coast,"McGinnity, Patrick",14,4,1,10,0,0,0,1
West Coast,"Naitanui, Nic",12,6,3,6,0,1,24,6
West Coast,"Newman, Murray",7,5,2,2,0,0,0,2
West Coast,"Priddis, Matt",34,10,4,24,1,1,0,11
West Coast,"Rosa, Matt",24,13,6,11,0,1,0,3
West Coast,"Schofield, Will",21,15,11,6,0,1,0,0
West Coast,"Selwood, Scott",16,6,3,10,0,0,0,5
West Coast,"Shuey, Luke",23,12,3,11,0,1,0,4
West Coast,"Stevens, Koby",4,1,0,3,0,0,0,2
West Coast,"Brennan, Jacob",13,11,2,2,0,1,0,2
West Coast,"Brown, Mitch",9,5,3,4,0,0,0,0
West Coast,"Butler, Sam",15,12,8,3,0,0,0,3
West Coast,"Cox, Dean",13,8,4,5,1,1,21,1
West Coast,"Darling, Jack",5,5,4,0,2,1,0,0
West Coast,"Gaff, Andrew",26,17,7,9,0,0,0,1
West Coast,"Glass, Darren",16,6,6,10,0,0,0,5
West Coast,"Hurn, Shannon",18,18,4,0,0,0,0,5
West Coast,"Kerr, Daniel",31,20,2,11,0,0,0,3
West Coast,"Mackenzie, Eric",15,8,4,7,0,0,0,3
West Coast,"Masten, Chris",19,14,7,5,3,0,0,3
West Coast,"McGinnity, Patrick",7,2,2,5,0,0,0,2
West Coast,"Naitanui, Nic",6,2,1,4,1,0,26,2
West Coast,"Newman, Murray",10,5,2,5,1,1,0,2
West Coast,"Priddis, Matt",25,7,0,18,0,0,0,14
West Coast,"Rosa, Matt",24,16,7,8,0,0,3,0
West Coast,"Schofield, Will",10,7,2,3,0,2,0,2
West Coast,"Selwood, Adam",16,9,7,7,0,0,0,1
West Coast,"Selwood, Scott",25,17,3,8,1,0,0,8
West Coast,"Sheppard, Brad",13,8,3,5,1,0,0,1
West Coast,"Stevens, Koby",6,4,3,2,0,0,0,3
West Coast,"Swift, Tom",13,9,4,4,0,1,0,7
West Coast,"Brennan, Jacob",13,8,5,5,0,0,0,2
West Coast,"Butler, Sam",21,16,9,5,0,0,0,2
West Coast,"Cox, Dean",15,8,6,7,0,0,27,2
West Coast,"Darling, Jack",8,5,3,3,2,2,0,0
West Coast,"Gaff, Andrew",33,22,6,11,0,0,0,0
West Coast,"Glass, Darren",11,6,3,5,0,0,1,4
West Coast,"Hams, Ashton",9,8,3,1,3,1,0,1
West Coast,"Hurn, Shannon",14,13,6,1,0,0,0,3
West Coast,"Kerr, Daniel",23,13,3,10,1,0,0,2
West Coast,"Lynch, Quinten",8,4,2,4,1,0,1,2
West Coast,"Mackenzie, Eric",9,8,5,1,0,0,1,3
West Coast,"Masten, Chris",14,5,3,9,1,0,0,2
West Coast,"McGinnity, Patrick",12,10,3,2,1,2,0,6
West Coast,"Naitanui, Nic",16,5,3,11,1,1,19,6
West Coast,"Newman, Murray",4,3,2,1,0,1,0,1
West Coast,"Priddis, Matt",27,8,3,19,0,0,0,7
West Coast,"Rosa, Matt",14,6,4,8,0,1,0,1
West Coast,"Schofield, Will",14,9,5,5,0,1,0,1
West Coast,"Selwood, Adam",18,7,3,11,0,0,0,3
West Coast,"Selwood, Scott",21,10,6,11,0,0,0,3
West Coast,"Sheppard, Brad",16,10,4,6,1,0,0,1
West Coast,"Waters, Beau",17,10,7,7,0,0,0,2
West Coast,"Butler, Sam",13,11,5,2,0,0,0,2
West Coast,"Cox, Dean",18,11,8,7,2,1,16,1
West Coast,"Darling, Jack",18,10,8,8,5,1,0,3
West Coast,"Gaff, Andrew",30,17,2,13,1,2,0,2
West Coast,"Glass, Darren",16,8,7,8,0,0,1,2
West Coast,"Hams, Ashton",13,9,5,4,3,1,0,4
West Coast,"Hill, Josh",8,6,2,2,4,1,0,1
West Coast,"Hurn, Shannon",19,17,8,2,2,0,0,3
West Coast,"Kerr, Daniel",4,1,1,3,0,0,0,2
West Coast,"Lynch, Quinten",12,8,5,4,1,1,3,5
West Coast,"Mackenzie, Eric",10,5,5,5,0,0,0,0
West Coast,"Masten, Chris",29,16,7,13,1,0,0,3
West Coast,"McGinnity, Patrick",13,8,2,5,1,0,0,2
West Coast,"Naitanui, Nic",15,7,5,8,3,0,36,5
West Coast,"Priddis, Matt",29,11,0,18,1,0,0,5
West Coast,"Rosa, Matt",28,17,5,11,0,0,1,7
West Coast,"Schofield, Will",17,11,9,6,0,0,0,0
West Coast,"Selwood, Adam",18,11,4,7,0,0,0,1
West Coast,"Selwood, Scott",16,8,6,8,1,0,0,8
West Coast,"Sheppard, Brad",9,2,0,7,1,0,0,1
West Coast,"Shuey, Luke",22,10,2,12,1,0,0,6
West Coast,"Waters, Beau",30,19,8,11,1,0,0,4
West Coast,"Brown, Mitch",9,4,4,5,0,0,0,3
West Coast,"Butler, Sam",18,12,2,6,0,0,0,2
West Coast,"Cox, Dean",9,8,2,1,0,1,28,2
West Coast,"Darling, Jack",7,6,3,1,2,0,0,3
West Coast,"Gaff, Andrew",21,13,5,8,0,1,0,3
West Coast,"Hams, Ashton",12,6,3,6,1,0,0,4
West Coast,"Hill, Josh",7,5,3,2,0,1,0,2
West Coast,"Hurn, Shannon",5,5,2,0,1,1,0,2
West Coast,"Kerr, Daniel",36,15,4,21,0,0,0,2
West Coast,"Lynch, Quinten",10,6,5,4,1,0,0,1
West Coast,"Mackenzie, Eric",5,2,1,3,0,0,4,3
West Coast,"Masten, Chris",20,12,2,8,0,1,0,5
West Coast,"McGinnity, Patrick",16,9,2,7,0,1,0,3
West Coast,"Naitanui, Nic",8,3,1,5,1,0,25,2
West Coast,"Priddis, Matt",19,4,5,15,0,0,0,8
West Coast,"Schofield, Will",9,6,6,3,0,0,4,3
West Coast,"Selwood, Adam",18,10,5,8,0,0,0,2
West Coast,"Selwood, Scott",23,14,8,9,0,0,0,6
West Coast,"Sheppard, Brad",4,2,1,2,0,0,0,0
West Coast,"Shuey, Luke",11,5,2,6,0,1,0,3
West Coast,"Swift, Tom",5,4,2,1,0,0,0,1
West Coast,"Waters, Beau",23,12,7,11,0,0,0,4
West Coast,"Brennan, Jacob",7,5,2,2,0,0,0,6
West Coast,"Cox, Dean",23,13,8,10,3,0,45,1
West Coast,"Darling, Jack",9,5,2,4,1,0,0,4
West Coast,"Embley, Andrew",9,5,2,4,0,0,0,3
West Coast,"Gaff, Andrew",18,14,2,4,2,1,0,2
West Coast,"Glass, Darren",11,7,3,4,0,0,0,0
West Coast,"Hams, Ashton",8,1,2,7,0,1,0,2
West Coast,"Hill, Josh",9,5,3,4,0,0,0,2
West Coast,"Hurn, Shannon",16,15,3,1,0,0,0,1
West Coast,"Kerr, Daniel",29,18,3,11,1,0,0,4
West Coast,"Lynch, Quinten",11,8,6,3,3,0,0,0
West Coast,"Mackenzie, Eric",9,7,6,2,0,0,0,2
West Coast,"Masten, Chris",13,6,2,7,1,0,0,5
West Coast,"McGinnity, Patrick",15,5,1,10,0,0,0,4
West Coast,"Naitanui, Nic",18,7,5,11,2,1,22,4
West Coast,"Priddis, Matt",24,11,1,13,2,0,0,3
West Coast,"Schofield, Will",9,7,3,2,0,0,0,1
West Coast,"Selwood, Adam",14,11,2,3,0,0,0,3
West Coast,"Selwood, Scott",22,13,1,9,0,0,0,4
West Coast,"Shuey, Luke",27,18,4,9,1,0,0,2
West Coast,"Swift, Tom",7,2,0,5,0,1,0,1
West Coast,"Waters, Beau",13,12,6,1,0,0,0,0
West Coast,"Brennan, Jacob",14,13,3,1,0,0,0,4
West Coast,"Cox, Dean",20,11,9,9,0,0,24,0
West Coast,"Dalziell, Bradd",8,4,2,4,0,1,0,3
West Coast,"Darling, Jack",14,12,6,2,3,2,0,2
West Coast,"Embley, Andrew",22,12,7,10,0,0,0,0
West Coast,"Gaff, Andrew",20,7,4,13,0,0,0,0
West Coast,"Glass, Darren",15,3,4,12,0,0,0,4
West Coast,"Hams, Ashton",10,4,4,6,0,0,0,2
West Coast,"Hill, Josh",15,11,3,4,1,1,0,2
West Coast,"Hurn, Shannon",14,12,6,2,2,1,0,1
West Coast,"Kerr, Daniel",19,10,4,9,1,0,0,0
West Coast,"Lynch, Quinten",13,8,8,5,0,2,2,0
West Coast,"Mackenzie, Eric",8,5,3,3,0,0,0,3
West Coast,"Masten, Chris",22,13,5,9,2,0,0,3
West Coast,"McGinnity, Patrick",11,7,3,4,1,0,0,6
West Coast,"Naitanui, Nic",9,4,0,5,3,0,19,2
West Coast,"Priddis, Matt",26,7,3,19,0,0,0,5
West Coast,"Schofield, Will",16,9,7,7,0,0,1,1
West Coast,"Selwood, Adam",4,2,1,2,0,0,0,0
West Coast,"Selwood, Scott",34,16,9,18,1,1,0,7
West Coast,"Shuey, Luke",25,15,1,10,0,2,0,1
West Coast,"Waters, Beau",23,16,7,7,0,0,0,0
West Coast,"Butler, Sam",25,17,7,8,1,2,0,2
West Coast,"Cox, Dean",14,8,4,6,1,0,28,1
West Coast,"Darling, Jack",8,7,6,1,1,2,0,3
West Coast,"Embley, Andrew",19,13,3,6,1,0,0,1
West Coast,"Gaff, Andrew",27,17,5,10,1,0,0,1
West Coast,"Glass, Darren",10,5,4,5,0,0,0,1
West Coast,"Hill, Josh",5,5,2,0,1,0,0,2
West Coast,"Hurn, Shannon",17,13,3,4,1,0,0,2
West Coast,"Kennedy, Josh",8,7,4,1,1,1,0,1
West Coast,"Kerr, Daniel",36,16,2,20,1,1,0,4
West Coast,"Mackenzie, Eric",7,2,3,5,0,0,0,2
West Coast,"Masten, Chris",15,9,1,6,1,1,0,1
West Coast,"McGinnity, Patrick",14,10,5,4,0,0,0,3
West Coast,"Naitanui, Nic",17,11,5,6,1,3,30,0
West Coast,"Priddis, Matt",29,9,5,20,0,0,0,6
West Coast,"Rosa, Matt",17,6,3,11,0,1,0,1
West Coast,"Schofield, Will",9,5,3,4,1,0,1,2
West Coast,"Selwood, Adam",13,6,2,7,1,0,0,2
West Coast,"Selwood, Scott",23,9,3,14,0,0,0,2
West Coast,"Shuey, Luke",27,15,4,12,2,3,0,4
West Coast,"Strijk, Andrew",4,2,0,2,0,0,0,0
West Coast,"Waters, Beau",18,10,3,8,0,0,0,1
West Coast,"Brennan, Jacob",5,3,1,2,0,0,0,2
West Coast,"Brown, Mitch",9,2,1,7,0,0,0,1
West Coast,"Butler, Sam",15,10,3,5,0,0,0,3
West Coast,"Cox, Dean",13,9,4,4,0,1,28,1
West Coast,"Darling, Jack",22,15,9,7,3,1,0,5
West Coast,"Embley, Andrew",28,20,5,8,0,2,0,1
West Coast,"Gaff, Andrew",15,7,3,8,1,0,0,1
West Coast,"Glass, Darren",7,3,3,4,0,0,0,3
West Coast,"Hill, Josh",9,7,3,2,1,0,0,5
West Coast,"Hurn, Shannon",22,18,3,4,0,0,0,3
West Coast,"Kennedy, Josh",8,5,6,3,0,1,0,3
West Coast,"Kerr, Daniel",21,11,2,10,0,0,0,2
West Coast,"Masten, Chris",23,12,2,11,0,0,0,4
West Coast,"McGinnity, Patrick",14,4,3,10,2,0,0,6
West Coast,"Naitanui, Nic",11,3,3,8,0,0,24,9
West Coast,"Priddis, Matt",27,10,2,17,0,1,0,4
West Coast,"Schofield, Will",11,6,8,5,2,0,0,3
West Coast,"Selwood, Adam",9,7,2,2,0,0,0,4
West Coast,"Selwood, Scott",35,15,5,20,0,0,0,5
West Coast,"Shuey, Luke",27,15,5,12,0,0,0,4
West Coast,"Strijk, Andrew",5,4,2,1,0,1,0,4
West Coast,"Waters, Beau",23,14,7,9,1,0,0,1
West Coast,"Brennan, Jacob",9,6,2,3,0,0,0,2
West Coast,"Butler, Sam",22,16,8,6,0,0,0,0
West Coast,"Cox, Dean",16,12,5,4,1,1,39,0
West Coast,"Darling, Jack",11,11,8,0,4,2,0,2
West Coast,"Embley, Andrew",22,21,11,1,4,0,1,0
West Coast,"Gaff, Andrew",26,15,3,11,0,0,0,1
West Coast,"Glass, Darren",17,12,8,5,0,0,0,0
West Coast,"Hill, Josh",12,11,9,1,1,1,0,1
West Coast,"Hurn, Shannon",18,15,7,3,1,0,0,2
West Coast,"Kennedy, Josh",10,7,5,3,4,2,0,3
West Coast,"Kerr, Daniel",28,16,2,12,1,1,0,2
West Coast,"Lynch, Quinten",14,12,4,2,3,0,1,0
West Coast,"Mackenzie, Eric",7,6,4,1,1,0,0,2
West Coast,"Masten, Chris",25,16,10,9,1,1,0,1
West Coast,"McGinnity, Patrick",8,5,1,3,1,0,0,4
West Coast,"Naitanui, Nic",13,3,4,10,1,1,20,3
West Coast,"Priddis, Matt",29,9,4,20,0,0,0,3
West Coast,"Schofield, Will",8,6,4,2,0,1,1,3
West Coast,"Selwood, Adam",11,6,2,5,0,0,0,0
West Coast,"Selwood, Scott",28,9,6,19,0,0,0,2
West Coast,"Shuey, Luke",21,14,3,7,1,3,0,6
West Coast,"Waters, Beau",3,3,2,0,0,0,0,1
West Coast,"Brennan, Jacob",5,3,2,2,0,0,0,2
West Coast,"Butler, Sam",19,10,3,9,0,0,0,4
West Coast,"Cox, Dean",17,10,6,7,1,0,31,1
West Coast,"Darling, Jack",9,6,5,3,2,0,0,2
West Coast,"Embley, Andrew",24,18,3,6,0,0,0,5
West Coast,"Gaff, Andrew",26,18,6,8,0,1,0,1
West Coast,"Glass, Darren",12,5,6,7,0,0,1,3
West Coast,"Hill, Josh",14,10,8,4,2,2,0,4
West Coast,"Hurn, Shannon",14,12,2,2,0,0,0,0
West Coast,"Kennedy, Josh",10,6,3,4,1,0,0,1
West Coast,"Kerr, Daniel",29,18,1,11,1,1,0,3
West Coast,"Lynch, Quinten",9,4,1,5,0,0,2,2
West Coast,"Mackenzie, Eric",4,2,2,2,0,0,0,2
West Coast,"Masten, Chris",20,8,5,12,0,0,0,3
West Coast,"McGinnity, Patrick",14,7,1,7,1,0,0,6
West Coast,"Naitanui, Nic",12,4,2,8,1,0,18,2
West Coast,"Priddis, Matt",23,10,3,13,0,0,0,4
West Coast,"Rosa, Matt",9,4,3,5,0,0,0,1
West Coast,"Schofield, Will",11,8,5,3,0,1,0,0
West Coast,"Selwood, Adam",10,5,2,5,0,0,0,1
West Coast,"Selwood, Scott",15,3,0,12,0,1,0,8
West Coast,"Shuey, Luke",23,13,5,10,0,0,0,4
Western Bulldogs,"Addison, Dylan",12,3,4,9,0,0,0,3
Western Bulldogs,"Boyd, Matthew",38,20,6,18,0,0,1,1
Western Bulldogs,"Cooney, Adam",19,12,1,7,1,0,0,5
Western Bulldogs,"Cross, Daniel",28,6,4,22,0,0,3,3
Western Bulldogs,"Dahlhaus, Luke",19,12,3,7,2,1,0,5
Western Bulldogs,"Dickson, Tory",12,6,3,6,0,1,0,0
Western Bulldogs,"Giansiracusa, Daniel",22,15,5,7,1,4,0,3
Western Bulldogs,"Grant, Jarrad",8,5,3,3,0,1,0,1
Western Bulldogs,"Hargrave, Ryan",24,13,7,11,0,0,0,0
Western Bulldogs,"Higgins, Shaun",21,12,4,9,2,1,0,3
Western Bulldogs,"Howard, Christian",11,7,3,4,0,0,0,1
Western Bulldogs,"Jones, Liam",15,10,4,5,1,3,0,1
Western Bulldogs,"Lake, Brian",8,5,3,3,0,0,0,1
Western Bulldogs,"Liberatore, Tom",27,12,4,15,0,0,0,7
Western Bulldogs,"Markovic, Lukas",11,7,3,4,0,0,0,1
Western Bulldogs,"Minson, Will",20,10,9,10,0,0,16,1
Western Bulldogs,"Murphy, Robert",19,12,3,7,0,0,0,2
Western Bulldogs,"Picken, Liam",15,9,3,6,1,0,0,5
Western Bulldogs,"Roughead, Jordan",10,3,2,7,0,0,11,3
Western Bulldogs,"Smith, Clay",13,10,2,3,4,0,0,3
Western Bulldogs,"Wallis, Mitch",18,8,2,10,0,0,0,2
Western Bulldogs,"Wood, Easton",14,7,3,7,0,0,0,1
Western Bulldogs,"Addison, Dylan",12,7,3,5,0,0,0,3
Western Bulldogs,"Boyd, Matthew",28,12,8,16,2,1,0,6
Western Bulldogs,"Cooney, Adam",23,11,4,12,0,0,0,2
Western Bulldogs,"Cross, Daniel",25,6,5,19,0,0,4,6
Western Bulldogs,"Dahlhaus, Luke",22,9,3,13,0,0,0,3
Western Bulldogs,"Dickson, Tory",8,3,2,5,0,0,0,0
Western Bulldogs,"Djerrkura, Nathan",15,11,5,4,1,1,0,3
Western Bulldogs,"Giansiracusa, Daniel",20,14,5,6,1,1,0,1
Western Bulldogs,"Grant, Jarrad",13,7,3,6,1,0,0,5
Western Bulldogs,"Griffen, Ryan",31,20,4,11,0,0,0,3
Western Bulldogs,"Hargrave, Ryan",26,16,7,10,0,0,0,1
Western Bulldogs,"Higgins, Shaun",23,13,6,10,0,2,0,3
Western Bulldogs,"Jones, Liam",8,7,4,1,2,1,0,0
Western Bulldogs,"Lake, Brian",23,16,10,7,0,0,0,0
Western Bulldogs,"Liberatore, Tom",13,7,3,6,0,0,0,4
Western Bulldogs,"Markovic, Lukas",16,11,9,5,0,0,0,2
Western Bulldogs,"Minson, Will",11,5,2,6,0,0,19,1
Western Bulldogs,"Murphy, Robert",26,19,8,7,0,0,0,4
Western Bulldogs,"Picken, Liam",28,9,5,19,1,0,0,4
Western Bulldogs,"Roughead, Jordan",10,6,3,4,1,0,8,4
Western Bulldogs,"Smith, Clay",14,9,4,5,0,1,0,3
Western Bulldogs,"Wood, Easton",14,8,4,6,0,0,0,2
Western Bulldogs,"Addison, Dylan",18,12,6,6,0,1,0,2
Western Bulldogs,"Boyd, Matthew",39,21,8,18,0,0,0,6
Western Bulldogs,"Cooney, Adam",23,15,1,8,1,0,0,4
Western Bulldogs,"Cordy, Ayce",9,3,3,6,0,0,2,7
Western Bulldogs,"Cross, Daniel",23,5,2,18,0,1,2,4
Western Bulldogs,"Dahlhaus, Luke",22,12,3,10,0,1,0,2
Western Bulldogs,"Djerrkura, Nathan",6,3,1,3,1,0,0,2
Western Bulldogs,"Giansiracusa, Daniel",9,5,1,4,1,1,0,1
Western Bulldogs,"Grant, Jarrad",13,5,4,8,0,1,0,5
Western Bulldogs,"Griffen, Ryan",18,13,2,5,1,0,0,2
Western Bulldogs,"Hargrave, Ryan",19,12,5,7,0,1,0,1
Western Bulldogs,"Higgins, Shaun",22,13,8,9,0,1,0,1
Western Bulldogs,"Jones, Liam",6,4,2,2,1,0,0,2
Western Bulldogs,"Lake, Brian",18,13,9,5,0,0,0,1
Western Bulldogs,"Liberatore, Tom",6,3,2,3,0,0,0,2
Western Bulldogs,"Markovic, Lukas",7,4,3,3,0,0,0,0
Western Bulldogs,"Minson, Will",20,8,2,12,0,0,28,1
Western Bulldogs,"Murphy, Robert",14,7,2,7,0,0,0,1
Western Bulldogs,"Picken, Liam",23,9,5,14,0,0,0,4
Western Bulldogs,"Roughead, Jordan",13,6,6,7,0,0,7,4
Western Bulldogs,"Smith, Clay",12,7,3,5,0,0,0,2
Western Bulldogs,"Wood, Easton",12,5,5,7,0,0,0,0
Western Bulldogs,"Addison, Dylan",18,12,7,6,0,0,0,1
Western Bulldogs,"Austin, Mark",11,4,2,7,0,0,0,2
Western Bulldogs,"Boyd, Matthew",19,9,2,10,0,0,3,7
Western Bulldogs,"Cooney, Adam",26,15,2,11,2,0,0,4
Western Bulldogs,"Cordy, Ayce",7,2,2,5,0,0,3,2
Western Bulldogs,"Cross, Daniel",28,12,6,16,0,0,7,3
Western Bulldogs,"Dahlhaus, Luke",23,13,2,10,1,2,0,3
Western Bulldogs,"Djerrkura, Nathan",15,6,4,9,1,0,0,4
Western Bulldogs,"Giansiracusa, Daniel",10,7,1,3,2,0,0,0
Western Bulldogs,"Grant, Jarrad",10,6,4,4,2,1,0,5
Western Bulldogs,"Griffen, Ryan",16,11,1,5,1,1,0,3
Western Bulldogs,"Hargrave, Ryan",26,17,9,9,0,0,0,4
Western Bulldogs,"Higgins, Shaun",7,4,1,3,0,1,0,0
Western Bulldogs,"Jones, Liam",14,11,7,3,1,1,0,2
Western Bulldogs,"Minson, Will",11,6,2,5,0,0,40,6
Western Bulldogs,"Murphy, Robert",24,20,5,4,0,0,0,0
Western Bulldogs,"Picken, Liam",20,8,3,12,0,1,0,13
Western Bulldogs,"Roughead, Jordan",9,6,7,3,1,0,0,3
Western Bulldogs,"Sherman, Justin",21,10,0,11,1,0,0,3
Western Bulldogs,"Veszpremi, Patrick",19,7,4,12,0,0,0,1
Western Bulldogs,"Wallis, Mitch",22,8,0,14,1,1,0,7
Western Bulldogs,"Wood, Easton",12,9,4,3,0,0,0,2
Western Bulldogs,"Addison, Dylan",18,8,5,10,0,0,0,3
Western Bulldogs,"Austin, Mark",12,5,4,7,0,0,0,3
Western Bulldogs,"Boyd, Matthew",35,16,3,19,1,1,1,3
Western Bulldogs,"Cooney, Adam",27,12,2,15,2,1,0,2
Western Bulldogs,"Cordy, Ayce",13,6,6,7,1,0,11,2
Western Bulldogs,"Cross, Daniel",34,9,5,25,0,0,0,4
Western Bulldogs,"Dahlhaus, Luke",17,9,0,8,2,0,0,2
Western Bulldogs,"Djerrkura, Nathan",13,8,7,5,1,0,0,5
Western Bulldogs,"Grant, Jarrad",15,11,4,4,1,2,0,2
Western Bulldogs,"Griffen, Ryan",37,16,7,21,1,1,0,2
Western Bulldogs,"Higgins, Shaun",18,10,3,8,2,2,0,6
Western Bulldogs,"Jones, Liam",9,6,5,3,1,1,0,1
Western Bulldogs,"Lake, Brian",22,15,7,7,0,0,0,3
Western Bulldogs,"Liberatore, Tom",14,10,4,4,0,0,0,1
Western Bulldogs,"Minson, Will",17,6,3,11,0,0,30,6
Western Bulldogs,"Murphy, Robert",16,12,1,4,0,0,0,3
Western Bulldogs,"Picken, Liam",25,9,3,16,1,0,1,7
Western Bulldogs,"Roughead, Jordan",2,1,2,1,0,0,6,0
Western Bulldogs,"Sherman, Justin",24,12,7,12,1,3,0,4
Western Bulldogs,"Veszpremi, Patrick",15,7,3,8,0,0,0,0
Western Bulldogs,"Wallis, Mitch",25,10,5,15,1,0,0,6
Western Bulldogs,"Wood, Easton",13,10,3,3,0,0,0,3
Western Bulldogs,"Addison, Dylan",10,7,6,3,0,0,0,6
Western Bulldogs,"Austin, Mark",11,3,3,8,0,0,0,1
Western Bulldogs,"Boyd, Matthew",29,13,4,16,1,0,0,2
Western Bulldogs,"Cooney, Adam",20,10,2,10,0,0,0,1
Western Bulldogs,"Cross, Daniel",31,15,7,16,0,0,0,6
Western Bulldogs,"Dahlhaus, Luke",12,7,0,5,0,2,0,3
Western Bulldogs,"Djerrkura, Nathan",12,7,5,5,0,0,0,2
Western Bulldogs,"Giansiracusa, Daniel",11,8,3,3,3,0,0,0
Western Bulldogs,"Griffen, Ryan",33,25,5,8,2,2,0,7
Western Bulldogs,"Hargrave, Ryan",24,14,11,10,1,1,0,0
Western Bulldogs,"Higgins, Shaun",17,12,5,5,2,0,0,4
Western Bulldogs,"Jones, Liam",11,6,3,5,0,0,1,1
Western Bulldogs,"Lake, Brian",20,14,9,6,1,0,0,3
Western Bulldogs,"Liberatore, Tom",24,12,3,12,0,0,0,4
Western Bulldogs,"Minson, Will",13,7,4,6,0,0,33,5
Western Bulldogs,"Murphy, Robert",24,11,2,13,0,0,0,4
Western Bulldogs,"Picken, Liam",12,3,0,9,0,1,0,8
Western Bulldogs,"Roughead, Jordan",12,6,4,6,0,0,16,2
Western Bulldogs,"Sherman, Justin",24,12,5,12,0,1,0,4
Western Bulldogs,"Veszpremi, Patrick",17,8,3,9,0,1,0,3
Western Bulldogs,"Wallis, Mitch",7,3,0,4,0,0,0,2
Western Bulldogs,"Wood, Easton",19,8,5,11,1,0,0,1
Western Bulldogs,"Addison, Dylan",13,8,6,5,0,0,0,2
Western Bulldogs,"Austin, Mark",10,5,3,5,0,0,0,1
Western Bulldogs,"Boyd, Matthew",44,32,7,12,0,2,2,4
Western Bulldogs,"Cordy, Ayce",12,6,4,6,1,1,0,4
Western Bulldogs,"Cross, Daniel",19,12,5,7,1,0,0,5
Western Bulldogs,"Dahlhaus, Luke",23,8,2,15,0,1,0,3
Western Bulldogs,"Dickson, Tory",12,8,5,4,4,1,0,8
Western Bulldogs,"Giansiracusa, Daniel",14,11,5,3,3,0,0,2
Western Bulldogs,"Grant, Jarrad",13,7,3,6,0,1,0,4
Western Bulldogs,"Griffen, Ryan",31,23,4,8,0,0,0,6
Western Bulldogs,"Hargrave, Ryan",23,15,7,8,0,0,0,2
Western Bulldogs,"Higgins, Shaun",10,5,2,5,2,2,0,3
Western Bulldogs,"Lake, Brian",26,18,12,8,0,0,0,2
Western Bulldogs,"Liberatore, Tom",22,10,3,12,0,0,0,4
Western Bulldogs,"Minson, Will",9,4,3,5,0,0,34,2
Western Bulldogs,"Murphy, Robert",21,16,5,5,1,0,0,0
Western Bulldogs,"Picken, Liam",16,4,3,12,0,0,0,4
Western Bulldogs,"Roughead, Jordan",6,2,2,4,0,0,4,8
Western Bulldogs,"Sherman, Justin",21,13,2,8,2,3,0,2
Western Bulldogs,"Smith, Clay",1,1,0,0,0,0,0,4
Western Bulldogs,"Veszpremi, Patrick",24,11,3,13,0,0,0,3
Western Bulldogs,"Wallis, Mitch",28,11,4,17,1,0,0,8
Western Bulldogs,"Addison, Dylan",10,7,1,3,0,0,0,4
Western Bulldogs,"Austin, Mark",11,7,7,4,0,0,0,2
Western Bulldogs,"Boyd, Matthew",29,19,6,10,0,1,3,7
Western Bulldogs,"Cordy, Ayce",7,5,3,2,1,2,6,3
Western Bulldogs,"Cross, Daniel",26,11,4,15,0,0,1,6
Western Bulldogs,"Dahlhaus, Luke",16,12,0,4,1,2,0,5
Western Bulldogs,"Dickson, Tory",18,12,3,6,0,1,0,4
Western Bulldogs,"Giansiracusa, Daniel",18,15,2,3,1,1,0,2
Western Bulldogs,"Grant, Jarrad",16,8,3,8,1,1,0,2
Western Bulldogs,"Griffen, Ryan",26,13,3,13,0,0,1,7
Western Bulldogs,"Hargrave, Ryan",16,11,5,5,0,0,0,1
Western Bulldogs,"Higgins, Shaun",16,12,3,4,1,2,0,5
Western Bulldogs,"Jones, Liam",6,3,1,3,1,0,0,4
Western Bulldogs,"Lake, Brian",24,21,9,3,0,2,0,2
Western Bulldogs,"Liberatore, Tom",24,16,3,8,1,1,0,6
Western Bulldogs,"Minson, Will",15,5,2,10,0,0,33,3
Western Bulldogs,"Murphy, Robert",11,11,3,0,0,0,0,0
Western Bulldogs,"Picken, Liam",9,5,2,4,1,0,0,9
Western Bulldogs,"Sherman, Justin",13,6,0,7,0,0,0,4
Western Bulldogs,"Skinner, Zephaniah",5,3,0,2,1,0,0,2
Western Bulldogs,"Smith, Clay",13,7,3,6,0,0,0,4
Western Bulldogs,"Wallis, Mitch",25,11,3,14,0,1,0,5
Western Bulldogs,"Austin, Mark",7,3,3,4,0,0,0,2
Western Bulldogs,"Boyd, Matthew",34,15,5,19,0,0,0,3
Western Bulldogs,"Cooney, Adam",21,11,2,10,0,0,0,1
Western Bulldogs,"Cross, Daniel",17,7,2,10,0,0,2,4
Western Bulldogs,"Dahlhaus, Luke",19,10,4,9,0,0,0,3
Western Bulldogs,"Dickson, Tory",14,6,3,8,1,0,0,5
Western Bulldogs,"Giansiracusa, Daniel",11,10,3,1,3,0,0,6
Western Bulldogs,"Griffen, Ryan",25,15,4,10,0,0,0,2
Western Bulldogs,"Hargrave, Ryan",19,10,5,9,0,0,0,1
Western Bulldogs,"Higgins, Shaun",13,6,2,7,3,0,0,4
Western Bulldogs,"Jones, Liam",13,11,5,2,1,2,0,1
Western Bulldogs,"Lake, Brian",15,11,4,4,0,0,0,1
Western Bulldogs,"Liberatore, Tom",24,11,4,13,1,0,0,4
Western Bulldogs,"Minson, Will",20,11,0,9,0,0,32,2
Western Bulldogs,"Murphy, Robert",29,14,2,15,0,0,0,0
Western Bulldogs,"Pearce, Daniel",9,4,2,5,0,0,0,2
Western Bulldogs,"Picken, Liam",14,9,1,5,0,1,0,5
Western Bulldogs,"Roughead, Jordan",14,8,3,6,0,3,4,5
Western Bulldogs,"Sherman, Justin",14,7,2,7,0,0,0,1
Western Bulldogs,"Skinner, Zephaniah",3,2,0,1,1,1,0,1
Western Bulldogs,"Veszpremi, Patrick",9,4,2,5,0,1,0,2
Western Bulldogs,"Wallis, Mitch",24,10,4,14,1,0,0,5
Western Bulldogs,"Addison, Dylan",15,8,7,7,0,0,0,1
Western Bulldogs,"Austin, Mark",9,6,2,3,0,0,0,2
Western Bulldogs,"Boyd, Matthew",29,27,2,2,0,1,1,3
Western Bulldogs,"Cooney, Adam",25,12,0,13,0,0,0,3
Western Bulldogs,"Cordy, Ayce",8,5,1,3,1,1,0,0
Western Bulldogs,"Cross, Daniel",17,9,0,8,0,0,1,2
Western Bulldogs,"Dahlhaus, Luke",12,9,2,3,0,2,0,4
Western Bulldogs,"Dickson, Tory",16,3,1,13,0,0,0,5
Western Bulldogs,"Giansiracusa, Daniel",10,4,0,6,0,0,0,3
Western Bulldogs,"Griffen, Ryan",26,18,2,8,0,1,0,6
Western Bulldogs,"Hargrave, Ryan",14,9,2,5,0,0,0,0
Western Bulldogs,"Higgins, Shaun",19,9,4,10,0,0,0,2
Western Bulldogs,"Lake, Brian",16,13,3,3,0,0,0,0
Western Bulldogs,"Liberatore, Tom",12,5,0,7,0,0,0,6
Western Bulldogs,"Minson, Will",11,7,1,4,0,0,48,2
Western Bulldogs,"Murphy, Robert",12,9,1,3,0,0,0,4
Western Bulldogs,"Pearce, Daniel",2,1,0,1,0,0,0,0
Western Bulldogs,"Picken, Liam",21,9,2,12,2,0,0,1
Western Bulldogs,"Roughead, Jordan",13,8,3,5,0,2,14,1
Western Bulldogs,"Veszpremi, Patrick",12,8,3,4,1,2,0,0
Western Bulldogs,"Wallis, Mitch",23,7,1,16,1,0,0,2
Western Bulldogs,"Wood, Easton",5,4,2,1,0,0,0,1
Western Bulldogs,"Addison, Dylan",19,12,8,7,0,0,0,1
Western Bulldogs,"Austin, Mark",14,7,3,7,0,0,0,0
Western Bulldogs,"Boyd, Matthew",34,26,6,8,0,0,0,5
Western Bulldogs,"Cooney, Adam",18,13,4,5,1,0,0,1
Western Bulldogs,"Cordy, Ayce",8,6,6,2,2,2,0,2
Western Bulldogs,"Cross, Daniel",26,12,6,14,0,0,1,4
Western Bulldogs,"Dahlhaus, Luke",17,11,5,6,1,2,0,6
Western Bulldogs,"Dickson, Tory",13,8,7,5,4,1,0,3
Western Bulldogs,"Giansiracusa, Daniel",24,17,7,7,1,2,0,4
Western Bulldogs,"Griffen, Ryan",26,10,4,16,1,0,0,4
Western Bulldogs,"Higgins, Shaun",20,8,3,12,1,2,0,5
Western Bulldogs,"Howard, Christian",20,12,6,8,0,0,0,5
Western Bulldogs,"Jones, Liam",9,7,4,2,1,1,0,3
Western Bulldogs,"Lake, Brian",23,20,15,3,0,0,0,1
Western Bulldogs,"Liberatore, Tom",17,10,1,7,0,0,0,5
Western Bulldogs,"Minson, Will",9,3,2,6,0,2,24,1
Western Bulldogs,"Murphy, Robert",32,23,6,9,0,0,0,4
Western Bulldogs,"Picken, Liam",18,14,8,4,0,1,0,2
Western Bulldogs,"Roughead, Jordan",17,10,6,7,1,1,9,5
Western Bulldogs,"Smith, Clay",3,3,0,0,0,0,0,1
Western Bulldogs,"Wallis, Mitch",29,8,6,21,0,1,0,1
Western Bulldogs,"Wood, Easton",20,12,9,8,0,0,0,2
Western Bulldogs,"Addison, Dylan",11,6,4,5,0,0,0,3
Western Bulldogs,"Austin, Mark",13,7,6,6,0,0,0,1
Western Bulldogs,"Boyd, Matthew",20,11,4,9,0,1,1,2
Western Bulldogs,"Campbell, Tom",11,4,4,7,0,0,28,1
Western Bulldogs,"Cooney, Adam",12,8,4,4,0,3,0,4
Western Bulldogs,"Cordy, Ayce",8,4,2,4,0,0,0,3
Western Bulldogs,"Cross, Daniel",24,12,7,12,1,0,1,3
Western Bulldogs,"Dahlhaus, Luke",20,8,1,12,0,2,0,4
Western Bulldogs,"Dickson, Tory",18,7,5,11,1,1,0,5
Western Bulldogs,"Giansiracusa, Daniel",14,7,2,7,2,0,0,3
Western Bulldogs,"Griffen, Ryan",22,11,1,11,0,0,0,8
Western Bulldogs,"Higgins, Shaun",22,15,6,7,1,1,0,2
Western Bulldogs,"Howard, Christian",25,17,3,8,0,1,0,1
Western Bulldogs,"Jones, Liam",4,3,2,1,0,0,0,1
Western Bulldogs,"Lake, Brian",17,13,11,4,0,0,0,0
Western Bulldogs,"Liberatore, Tom",29,12,3,17,0,0,0,3
Western Bulldogs,"Murphy, Robert",18,14,2,4,1,0,0,0
Western Bulldogs,"Picken, Liam",13,4,0,9,0,0,0,11
Western Bulldogs,"Roughead, Jordan",12,5,4,7,1,1,17,4
Western Bulldogs,"Smith, Clay",12,7,3,5,0,0,0,5
Western Bulldogs,"Wallis, Mitch",17,7,1,10,0,0,0,5
Western Bulldogs,"Wood, Easton",19,11,5,8,0,1,0,0
Western Bulldogs,"Addison, Dylan",9,6,5,3,0,0,0,1
Western Bulldogs,"Boyd, Matthew",34,22,7,12,1,1,1,3
Western Bulldogs,"Campbell, Tom",7,5,3,2,1,0,11,1
Western Bulldogs,"Cooney, Adam",16,10,5,6,0,1,0,0
Western Bulldogs,"Cross, Daniel",20,8,6,12,0,0,1,5
Western Bulldogs,"Dahlhaus, Luke",20,12,7,8,0,0,0,8
Western Bulldogs,"Dickson, Tory",13,4,2,9,0,0,0,8
Western Bulldogs,"Griffen, Ryan",19,8,2,11,0,0,0,4
Western Bulldogs,"Hargrave, Ryan",20,9,5,11,0,0,0,1
Western Bulldogs,"Higgins, Shaun",26,17,6,9,0,0,0,2
Western Bulldogs,"Howard, Christian",7,5,4,2,0,0,0,1
Western Bulldogs,"Jones, Liam",9,6,4,3,0,0,0,1
Western Bulldogs,"Lake, Brian",18,14,7,4,0,0,0,0
Western Bulldogs,"Liberatore, Tom",24,13,6,11,2,0,0,3
Western Bulldogs,"Markovic, Lukas",13,9,4,4,0,0,0,2
Western Bulldogs,"Minson, Will",14,7,3,7,3,1,18,2
Western Bulldogs,"Murphy, Robert",8,7,2,1,0,0,0,1
Western Bulldogs,"Picken, Liam",15,9,2,6,0,0,0,6
Western Bulldogs,"Roughead, Jordan",4,2,2,2,0,1,2,1
Western Bulldogs,"Sherman, Justin",11,4,2,7,0,1,0,2
Western Bulldogs,"Smith, Clay",18,13,6,5,1,1,0,3
Western Bulldogs,"Wood, Easton",14,9,7,5,0,0,0,0
Western Bulldogs,"Austin, Mark",9,6,3,3,0,0,0,3
Western Bulldogs,"Boyd, Matthew",35,20,9,15,0,0,0,4
Western Bulldogs,"Campbell, Tom",6,4,3,2,0,0,9,1
Western Bulldogs,"Cordy, Ayce",5,2,2,3,0,0,0,2
Western Bulldogs,"Cross, Daniel",26,13,9,13,0,0,2,6
Western Bulldogs,"Dahlhaus, Luke",18,12,3,6,2,1,0,1
Western Bulldogs,"Dickson, Tory",15,9,4,6,3,1,0,2
Western Bulldogs,"Djerrkura, Nathan",17,7,5,10,0,0,0,4
Western Bulldogs,"Gilbee, Lindsay",22,14,8,8,0,0,0,0
Western Bulldogs,"Griffen, Ryan",16,9,0,7,1,0,0,5
Western Bulldogs,"Higgins, Shaun",23,11,4,12,1,0,0,2
Western Bulldogs,"Howard, Christian",16,10,3,6,0,1,0,2
Western Bulldogs,"Lake, Brian",17,13,9,4,0,0,0,4
Western Bulldogs,"Liberatore, Tom",25,14,6,11,0,0,0,1
Western Bulldogs,"Markovic, Lukas",7,7,5,0,0,0,0,3
Western Bulldogs,"Minson, Will",19,10,7,9,1,1,34,5
Western Bulldogs,"Picken, Liam",19,11,7,8,0,0,0,6
Western Bulldogs,"Sherman, Justin",12,9,6,3,0,2,0,1
Western Bulldogs,"Smith, Clay",17,11,3,6,0,0,0,5
Western Bulldogs,"Tutt, Jason",4,4,2,0,0,0,0,2
Western Bulldogs,"Wallis, Mitch",27,11,6,16,0,0,0,2
Western Bulldogs,"Wood, Easton",16,9,7,7,0,0,0,0
Western Bulldogs,"Boyd, Matthew",37,21,7,16,0,1,0,4
Western Bulldogs,"Cordy, Ayce",8,7,5,1,1,1,0,1
Western Bulldogs,"Cross, Daniel",26,10,10,16,0,0,0,5
Western Bulldogs,"Dahlhaus, Luke",14,8,5,6,0,0,0,3
Western Bulldogs,"Dickson, Tory",13,12,6,1,1,2,0,3
Western Bulldogs,"Djerrkura, Nathan",14,9,4,5,0,0,0,2
Western Bulldogs,"Gilbee, Lindsay",15,9,4,6,0,0,0,1
Western Bulldogs,"Griffen, Ryan",22,15,4,7,0,0,0,10
Western Bulldogs,"Hargrave, Ryan",18,11,3,7,0,0,0,3
Western Bulldogs,"Higgins, Shaun",18,14,6,4,3,0,0,6
Western Bulldogs,"Howard, Christian",10,6,5,4,0,0,0,0
Western Bulldogs,"Lake, Brian",18,12,8,6,0,0,1,0
Western Bulldogs,"Liberatore, Tom",17,5,4,12,0,0,0,4
Western Bulldogs,"Markovic, Lukas",3,1,1,2,0,0,0,0
Western Bulldogs,"Minson, Will",8,3,3,5,0,0,38,3
Western Bulldogs,"Murphy, Robert",24,18,3,6,0,0,0,2
Western Bulldogs,"Picken, Liam",21,13,4,8,0,0,0,1
Western Bulldogs,"Sherman, Justin",10,4,3,6,0,0,0,1
Western Bulldogs,"Smith, Clay",14,11,4,3,0,1,2,7
Western Bulldogs,"Tutt, Jason",6,3,2,3,0,0,0,0
Western Bulldogs,"Wallis, Mitch",19,9,10,10,0,0,0,5
Western Bulldogs,"Williams, Tom",12,11,8,1,1,1,0,0
Western Bulldogs,"Austin, Mark",10,4,4,6,0,0,0,0
Western Bulldogs,"Boyd, Matthew",25,12,4,13,0,0,1,2
Western Bulldogs,"Cordy, Ayce",8,4,5,4,0,0,3,3
Western Bulldogs,"Cross, Daniel",26,14,10,12,0,0,0,1
Western Bulldogs,"Dahlhaus, Luke",11,10,1,1,4,1,0,4
Western Bulldogs,"Djerrkura, Nathan",2,2,2,0,0,0,0,3
Western Bulldogs,"Giansiracusa, Daniel",11,7,6,4,1,1,0,5
Western Bulldogs,"Gilbee, Lindsay",17,9,5,8,0,0,0,2
Western Bulldogs,"Grant, Jarrad",18,11,8,7,2,2,0,1
Western Bulldogs,"Griffen, Ryan",28,19,6,9,0,2,0,3
Western Bulldogs,"Higgins, Shaun",7,6,4,1,1,2,0,3
Western Bulldogs,"Howard, Christian",18,12,6,6,0,2,0,3
Western Bulldogs,"Lake, Brian",15,12,11,3,0,0,0,3
Western Bulldogs,"Liberatore, Tom",28,17,9,11,0,0,0,0
Western Bulldogs,"Minson, Will",16,5,2,11,0,0,54,1
Western Bulldogs,"Murphy, Robert",18,14,9,4,0,0,0,0
Western Bulldogs,"Pearce, Daniel",10,8,6,2,0,0,0,1
Western Bulldogs,"Picken, Liam",15,6,2,9,1,0,0,13
Western Bulldogs,"Tutt, Jason",12,9,7,3,1,0,0,3
Western Bulldogs,"Veszpremi, Patrick",18,16,6,2,0,0,0,1
Western Bulldogs,"Wallis, Mitch",26,12,5,14,0,0,0,5
Western Bulldogs,"Williams, Tom",12,6,3,6,2,1,1,1
Western Bulldogs,"Boyd, Matthew",27,13,4,14,0,0,0,5
Western Bulldogs,"Cross, Daniel",9,2,0,7,0,0,0,2
Western Bulldogs,"Dahlhaus, Luke",13,12,4,1,0,1,0,8
Western Bulldogs,"Dickson, Tory",15,6,1,9,2,0,0,2
Western Bulldogs,"Giansiracusa, Daniel",15,7,5,8,2,0,0,1
Western Bulldogs,"Gilbee, Lindsay",18,9,2,9,1,0,0,0
Western Bulldogs,"Grant, Jarrad",13,5,5,8,0,0,0,2
Western Bulldogs,"Griffen, Ryan",23,8,3,15,0,1,0,0
Western Bulldogs,"Howard, Christian",15,5,4,10,0,0,0,1
Western Bulldogs,"Jones, Liam",4,1,0,3,0,0,2,2
Western Bulldogs,"Lake, Brian",14,11,5,3,0,1,0,2
Western Bulldogs,"Liberatore, Tom",21,10,4,11,0,0,0,3
Western Bulldogs,"Minson, Will",14,9,3,5,0,0,31,4
Western Bulldogs,"Murphy, Robert",19,16,8,3,0,0,0,0
Western Bulldogs,"Pearce, Daniel",9,3,2,6,0,0,0,2
Western Bulldogs,"Picken, Liam",23,12,6,11,0,0,0,2
Western Bulldogs,"Roughead, Jordan",10,4,5,6,0,0,5,2
Western Bulldogs,"Smith, Clay",11,6,3,5,0,0,0,6
Western Bulldogs,"Tutt, Jason",12,5,1,7,1,0,0,1
Western Bulldogs,"Veszpremi, Patrick",10,8,3,2,0,0,0,1
Western Bulldogs,"Wallis, Mitch",22,8,4,14,0,0,0,3
Western Bulldogs,"Williams, Tom",15,8,7,7,0,1,0,2
Western Bulldogs,"Addison, Dylan",21,13,7,8,2,3,0,3
Western Bulldogs,"Boyd, Matthew",34,14,0,20,0,0,1,8
Western Bulldogs,"Campbell, Tom",7,4,1,3,1,0,15,1
Western Bulldogs,"Dickson, Tory",17,7,3,10,2,0,0,5
Western Bulldogs,"Djerrkura, Nathan",3,1,0,2,0,1,0,0
Western Bulldogs,"Giansiracusa, Daniel",22,9,5,13,1,3,0,5
Western Bulldogs,"Grant, Jarrad",13,7,5,6,1,0,0,2
Western Bulldogs,"Griffen, Ryan",29,10,4,19,0,1,2,7
Western Bulldogs,"Howard, Christian",14,5,3,9,0,0,0,0
Western Bulldogs,"Johannisen, Jason",17,9,4,8,0,0,0,2
Western Bulldogs,"Lake, Brian",8,7,3,1,0,0,0,4
Western Bulldogs,"Liberatore, Tom",24,12,5,12,0,0,0,8
Western Bulldogs,"Minson, Will",12,6,0,6,0,2,34,5
Western Bulldogs,"Murphy, Robert",20,11,1,9,0,0,0,2
Western Bulldogs,"Pearce, Daniel",17,11,7,6,0,0,0,0
Western Bulldogs,"Picken, Liam",20,12,4,8,0,0,0,5
Western Bulldogs,"Roughead, Jordan",17,10,8,7,0,0,0,2
Western Bulldogs,"Skinner, Zephaniah",8,2,0,6,0,0,1,2
Western Bulldogs,"Smith, Clay",13,8,2,5,0,1,0,9
Western Bulldogs,"Talia, Michael",7,7,2,0,1,0,0,1
Western Bulldogs,"Tutt, Jason",10,6,2,4,0,1,0,1
Western Bulldogs,"Wallis, Mitch",25,11,6,14,0,0,0,1
Western Bulldogs,"Addison, Dylan",11,5,2,6,1,0,0,0
Western Bulldogs,"Boyd, Matthew",33,11,4,22,0,0,1,3
Western Bulldogs,"Campbell, Tom",5,4,1,1,0,0,3,2
Western Bulldogs,"Dickson, Tory",19,12,3,7,1,1,0,3
Western Bulldogs,"Djerrkura, Nathan",10,7,9,3,0,0,0,3
Western Bulldogs,"Giansiracusa, Daniel",14,7,6,7,3,0,0,0
Western Bulldogs,"Grant, Jarrad",17,11,8,6,0,0,0,1
Western Bulldogs,"Hargrave, Ryan",15,7,2,8,0,0,0,0
Western Bulldogs,"Hooper, Andrew",10,3,0,7,1,1,0,0
Western Bulldogs,"Johannisen, Jason",12,8,3,4,0,0,0,1
Western Bulldogs,"Jong, Lin",16,9,3,7,0,0,0,2
Western Bulldogs,"Lake, Brian",15,13,12,2,2,2,0,2
Western Bulldogs,"Minson, Will",8,2,3,6,0,0,25,3
Western Bulldogs,"Murphy, Robert",20,16,3,4,0,0,0,0
Western Bulldogs,"Picken, Liam",23,11,1,12,0,1,0,3
Western Bulldogs,"Roberts, Fletcher",8,7,3,1,0,0,0,0
Western Bulldogs,"Roughead, Jordan",8,4,2,4,0,0,0,1
Western Bulldogs,"Sherman, Justin",11,5,0,6,0,0,0,2
Western Bulldogs,"Skinner, Zephaniah",12,7,3,5,2,1,4,1
Western Bulldogs,"Smith, Clay",20,12,6,8,1,0,1,5
Western Bulldogs,"Talia, Michael",13,5,3,8,0,0,0,1
Western Bulldogs,"Wallis, Mitch",21,8,4,13,1,0,0,5
Western Bulldogs,"Addison, Dylan",12,7,4,5,4,0,0,3
Western Bulldogs,"Boyd, Matthew",35,13,7,22,0,0,0,1
Western Bulldogs,"Cooney, Adam",6,3,2,3,0,0,0,1
Western Bulldogs,"Cordy, Ayce",3,1,1,2,1,0,2,3
Western Bulldogs,"Dickson, Tory",12,7,3,5,3,0,0,5
Western Bulldogs,"Djerrkura, Nathan",8,8,2,0,0,2,0,0
Western Bulldogs,"Giansiracusa, Daniel",18,11,4,7,2,0,0,1
Western Bulldogs,"Griffen, Ryan",47,24,4,23,0,1,0,1
Western Bulldogs,"Higgins, Shaun",14,7,3,7,0,0,0,2
Western Bulldogs,"Johannisen, Jason",20,12,2,8,1,0,0,0
Western Bulldogs,"Jong, Lin",17,10,3,7,0,0,0,2
Western Bulldogs,"Lake, Brian",14,11,11,3,1,1,0,0
Western Bulldogs,"Markovic, Lukas",9,6,4,3,0,0,0,0
Western Bulldogs,"Minson, Will",13,5,2,8,0,0,38,3
Western Bulldogs,"Murphy, Robert",17,12,4,5,0,0,0,1
Western Bulldogs,"Picken, Liam",13,8,3,5,1,0,0,2
Western Bulldogs,"Roberts, Fletcher",13,9,4,4,0,0,0,1
Western Bulldogs,"Roughead, Jordan",10,6,6,4,0,0,0,0
Western Bulldogs,"Skinner, Zephaniah",8,3,3,5,0,1,1,0
Western Bulldogs,"Smith, Clay",23,12,6,11,0,1,1,9
Western Bulldogs,"Wallis, Mitch",18,6,3,12,0,0,0,3
Western Bulldogs,"Wood, Easton",12,6,3,6,0,0,0,2
Western Bulldogs,"Addison, Dylan",13,4,3,9,0,1,0,2
Western Bulldogs,"Boyd, Matthew",46,15,4,31,0,0,1,3
Western Bulldogs,"Campbell, Tom",8,1,4,7,0,0,7,0
Western Bulldogs,"Cooney, Adam",28,16,4,12,1,0,0,2
Western Bulldogs,"Dickson, Tory",14,6,2,8,0,0,0,4
Western Bulldogs,"Djerrkura, Nathan",16,8,8,8,0,0,0,3
Western Bulldogs,"Giansiracusa, Daniel",13,7,3,6,1,2,0,0
Western Bulldogs,"Grant, Jarrad",8,6,2,2,3,1,0,0
Western Bulldogs,"Griffen, Ryan",37,10,4,27,1,0,1,3
Western Bulldogs,"Higgins, Shaun",22,13,8,9,1,0,0,2
Western Bulldogs,"Howard, Christian",28,13,6,15,2,1,0,2
Western Bulldogs,"Jong, Lin",24,11,6,13,1,0,0,0
Western Bulldogs,"Markovic, Lukas",13,7,3,6,0,0,0,2
Western Bulldogs,"Minson, Will",19,11,4,8,0,0,30,4
Western Bulldogs,"Murphy, Robert",23,14,1,9,0,0,0,1
Western Bulldogs,"Picken, Liam",17,9,3,8,0,0,0,6
Western Bulldogs,"Roughead, Jordan",9,4,2,5,0,0,1,2
Western Bulldogs,"Skinner, Zephaniah",17,8,4,9,1,1,0,0
Western Bulldogs,"Smith, Clay",14,7,5,7,0,0,0,5
Western Bulldogs,"Talia, Michael",11,4,4,7,0,0,0,1
Western Bulldogs,"Wallis, Mitch",29,11,2,18,0,0,0,8
Western Bulldogs,"Wood, Easton",16,10,7,6,0,0,0,2
Western Bulldogs,"Addison, Dylan",10,4,3,6,0,0,0,2
Western Bulldogs,"Boyd, Matthew",37,12,5,25,1,0,0,5
Western Bulldogs,"Campbell, Tom",14,4,1,10,1,0,16,3
Western Bulldogs,"Cooney, Adam",29,14,5,15,1,1,0,7
Western Bulldogs,"Dickson, Tory",8,3,3,5,1,0,0,2
Western Bulldogs,"Djerrkura, Nathan",12,7,4,5,0,0,0,3
Western Bulldogs,"Grant, Jarrad",14,7,5,7,1,1,0,3
Western Bulldogs,"Griffen, Ryan",27,9,2,18,0,1,0,3
Western Bulldogs,"Higgins, Shaun",23,8,3,15,2,0,0,2
Western Bulldogs,"Howard, Christian",16,10,6,6,0,0,0,0
Western Bulldogs,"Jong, Lin",11,2,1,9,0,0,0,0
Western Bulldogs,"Lake, Brian",12,9,2,3,0,1,0,1
Western Bulldogs,"Markovic, Lukas",14,11,6,3,0,0,0,3
Western Bulldogs,"Minson, Will",13,8,0,5,0,0,28,7
Western Bulldogs,"Murphy, Robert",25,19,7,6,0,0,0,4
Western Bulldogs,"Picken, Liam",24,14,3,10,1,1,0,2
Western Bulldogs,"Roughead, Jordan",19,7,9,12,0,0,1,1
Western Bulldogs,"Skinner, Zephaniah",2,1,1,1,0,0,0,1
Western Bulldogs,"Smith, Clay",22,11,5,11,0,0,0,4
Western Bulldogs,"Talia, Michael",23,14,9,9,0,0,0,1
Western Bulldogs,"Wallis, Mitch",19,8,2,11,1,0,0,4
Western Bulldogs,"Wood, Easton",20,13,11,7,0,0,0,1
